STNAME,CTYNAME,YEAR,AGEGRP,TOT_POP,TOT_MALE,TOT_FEMALE
Kentucky,Adair County,1,0,18656,9208,9448
Kentucky,Adair County,1,1,1169,594,575
Kentucky,Adair County,1,2,1127,585,542
Kentucky,Adair County,1,3,1132,589,543
Kentucky,Adair County,1,4,1609,819,790
Kentucky,Adair County,1,5,1405,705,700
Kentucky,Adair County,1,6,1038,542,496
Kentucky,Adair County,1,7,979,485,494
Kentucky,Adair County,1,8,1125,573,552
Kentucky,Adair County,1,9,1159,568,591
Kentucky,Adair County,1,10,1398,668,730
Kentucky,Adair County,1,11,1281,623,658
Kentucky,Adair County,1,12,1225,618,607
Kentucky,Adair County,1,13,1150,566,584
Kentucky,Adair County,1,14,903,452,451
Kentucky,Adair County,1,15,758,354,404
Kentucky,Adair County,1,16,515,230,285
Kentucky,Adair County,1,17,371,142,229
Kentucky,Adair County,1,18,312,95,217
Kentucky,Adair County,2,0,18659,9209,9450
Kentucky,Adair County,2,1,1170,595,575
Kentucky,Adair County,2,2,1129,586,543
Kentucky,Adair County,2,3,1133,589,544
Kentucky,Adair County,2,4,1608,818,790
Kentucky,Adair County,2,5,1405,705,700
Kentucky,Adair County,2,6,1038,542,496
Kentucky,Adair County,2,7,980,485,495
Kentucky,Adair County,2,8,1126,574,552
Kentucky,Adair County,2,9,1159,568,591
Kentucky,Adair County,2,10,1397,668,729
Kentucky,Adair County,2,11,1281,623,658
Kentucky,Adair County,2,12,1225,618,607
Kentucky,Adair County,2,13,1150,566,584
Kentucky,Adair County,2,14,903,452,451
Kentucky,Adair County,2,15,757,353,404
Kentucky,Adair County,2,16,515,230,285
Kentucky,Adair County,2,17,371,142,229
Kentucky,Adair County,2,18,312,95,217
Kentucky,Adair County,3,0,18757,9262,9495
Kentucky,Adair County,3,1,1143,575,568
Kentucky,Adair County,3,2,1124,582,542
Kentucky,Adair County,3,3,1130,586,544
Kentucky,Adair County,3,4,1638,834,804
Kentucky,Adair County,3,5,1482,747,735
Kentucky,Adair County,3,6,1038,545,493
Kentucky,Adair County,3,7,978,488,490
Kentucky,Adair County,3,8,1112,566,546
Kentucky,Adair County,3,9,1159,569,590
Kentucky,Adair County,3,10,1394,667,727
Kentucky,Adair County,3,11,1293,627,666
Kentucky,Adair County,3,12,1232,625,607
Kentucky,Adair County,3,13,1151,561,590
Kentucky,Adair County,3,14,919,464,455
Kentucky,Adair County,3,15,752,348,404
Kentucky,Adair County,3,16,523,235,288
Kentucky,Adair County,3,17,375,148,227
Kentucky,Adair County,3,18,314,95,219
Kentucky,Adair County,4,0,18987,9370,9617
Kentucky,Adair County,4,1,1090,566,524
Kentucky,Adair County,4,2,1167,615,552
Kentucky,Adair County,4,3,1126,580,546
Kentucky,Adair County,4,4,1608,825,783
Kentucky,Adair County,4,5,1619,798,821
Kentucky,Adair County,4,6,1057,554,503
Kentucky,Adair County,4,7,984,481,503
Kentucky,Adair County,4,8,1048,535,513
Kentucky,Adair County,4,9,1172,579,593
Kentucky,Adair County,4,10,1375,664,711
Kentucky,Adair County,4,11,1364,647,717
Kentucky,Adair County,4,12,1249,638,611
Kentucky,Adair County,4,13,1193,574,619
Kentucky,Adair County,4,14,944,484,460
Kentucky,Adair County,4,15,739,333,406
Kentucky,Adair County,4,16,550,246,304
Kentucky,Adair County,4,17,378,153,225
Kentucky,Adair County,4,18,324,98,226
Kentucky,Adair County,5,0,18934,9345,9589
Kentucky,Adair County,5,1,1039,536,503
Kentucky,Adair County,5,2,1135,608,527
Kentucky,Adair County,5,3,1132,583,549
Kentucky,Adair County,5,4,1552,788,764
Kentucky,Adair County,5,5,1668,834,834
Kentucky,Adair County,5,6,1057,553,504
Kentucky,Adair County,5,7,1024,490,534
Kentucky,Adair County,5,8,1011,513,498
Kentucky,Adair County,5,9,1134,566,568
Kentucky,Adair County,5,10,1339,650,689
Kentucky,Adair County,5,11,1380,657,723
Kentucky,Adair County,5,12,1250,629,621
Kentucky,Adair County,5,13,1211,584,627
Kentucky,Adair County,5,14,993,510,483
Kentucky,Adair County,5,15,746,341,405
Kentucky,Adair County,5,16,563,255,308
Kentucky,Adair County,5,17,360,141,219
Kentucky,Adair County,5,18,340,107,233
Kentucky,Adair County,6,0,19124,9470,9654
Kentucky,Adair County,6,1,1003,531,472
Kentucky,Adair County,6,2,1135,607,528
Kentucky,Adair County,6,3,1158,595,563
Kentucky,Adair County,6,4,1598,832,766
Kentucky,Adair County,6,5,1694,845,849
Kentucky,Adair County,6,6,1099,570,529
Kentucky,Adair County,6,7,1029,487,542
Kentucky,Adair County,6,8,1001,500,501
Kentucky,Adair County,6,9,1117,565,552
Kentucky,Adair County,6,10,1323,657,666
Kentucky,Adair County,6,11,1392,660,732
Kentucky,Adair County,6,12,1262,609,653
Kentucky,Adair County,6,13,1240,611,629
Kentucky,Adair County,6,14,998,512,486
Kentucky,Adair County,6,15,788,366,422
Kentucky,Adair County,6,16,578,260,318
Kentucky,Adair County,6,17,362,146,216
Kentucky,Adair County,6,18,347,117,230
Kentucky,Adair County,7,0,19262,9502,9760
Kentucky,Adair County,7,1,1019,530,489
Kentucky,Adair County,7,2,1125,592,533
Kentucky,Adair County,7,3,1162,585,577
Kentucky,Adair County,7,4,1618,846,772
Kentucky,Adair County,7,5,1669,838,831
Kentucky,Adair County,7,6,1117,560,557
Kentucky,Adair County,7,7,1039,505,534
Kentucky,Adair County,7,8,992,485,507
Kentucky,Adair County,7,9,1135,594,541
Kentucky,Adair County,7,10,1280,639,641
Kentucky,Adair County,7,11,1401,647,754
Kentucky,Adair County,7,12,1277,611,666
Kentucky,Adair County,7,13,1232,619,613
Kentucky,Adair County,7,14,1055,529,526
Kentucky,Adair County,7,15,802,392,410
Kentucky,Adair County,7,16,596,255,341
Kentucky,Adair County,7,17,380,157,223
Kentucky,Adair County,7,18,363,118,245
Kentucky,Adair County,8,0,19162,9499,9663
Kentucky,Adair County,8,1,1020,550,470
Kentucky,Adair County,8,2,1085,575,510
Kentucky,Adair County,8,3,1165,598,567
Kentucky,Adair County,8,4,1550,825,725
Kentucky,Adair County,8,5,1537,780,757
Kentucky,Adair County,8,6,1126,557,569
Kentucky,Adair County,8,7,1019,501,518
Kentucky,Adair County,8,8,1007,487,520
Kentucky,Adair County,8,9,1118,574,544
Kentucky,Adair County,8,10,1245,628,617
Kentucky,Adair County,8,11,1401,646,755
Kentucky,Adair County,8,12,1342,653,689
Kentucky,Adair County,8,13,1220,610,610
Kentucky,Adair County,8,14,1116,551,565
Kentucky,Adair County,8,15,837,411,426
Kentucky,Adair County,8,16,623,277,346
Kentucky,Adair County,8,17,388,165,223
Kentucky,Adair County,8,18,363,111,252
Kentucky,Adair County,9,0,19259,9529,9730
Kentucky,Adair County,9,1,1029,559,470
Kentucky,Adair County,9,2,1046,541,505
Kentucky,Adair County,9,3,1138,591,547
Kentucky,Adair County,9,4,1588,845,743
Kentucky,Adair County,9,5,1523,775,748
Kentucky,Adair County,9,6,1160,559,601
Kentucky,Adair County,9,7,1000,498,502
Kentucky,Adair County,9,8,1035,506,529
Kentucky,Adair County,9,9,1088,546,542
Kentucky,Adair County,9,10,1208,622,586
Kentucky,Adair County,9,11,1381,635,746
Kentucky,Adair County,9,12,1383,649,734
Kentucky,Adair County,9,13,1256,643,613
Kentucky,Adair County,9,14,1147,548,599
Kentucky,Adair County,9,15,856,433,423
Kentucky,Adair County,9,16,627,273,354
Kentucky,Adair County,9,17,411,178,233
Kentucky,Adair County,9,18,383,128,255
Kentucky,Adair County,10,0,19287,9573,9714
Kentucky,Adair County,10,1,1069,566,503
Kentucky,Adair County,10,2,1015,526,489
Kentucky,Adair County,10,3,1141,608,533
Kentucky,Adair County,10,4,1531,814,717
Kentucky,Adair County,10,5,1485,762,723
Kentucky,Adair County,10,6,1202,591,611
Kentucky,Adair County,10,7,980,510,470
Kentucky,Adair County,10,8,1058,516,542
Kentucky,Adair County,10,9,1038,497,541
Kentucky,Adair County,10,10,1203,611,592
Kentucky,Adair County,10,11,1365,656,709
Kentucky,Adair County,10,12,1410,661,749
Kentucky,Adair County,10,13,1274,642,632
Kentucky,Adair County,10,14,1156,558,598
Kentucky,Adair County,10,15,914,457,457
Kentucky,Adair County,10,16,639,288,351
Kentucky,Adair County,10,17,426,183,243
Kentucky,Adair County,10,18,381,127,254
Kentucky,Adair County,11,0,19199,9503,9696
Kentucky,Adair County,11,1,1028,525,503
Kentucky,Adair County,11,2,977,521,456
Kentucky,Adair County,11,3,1126,589,537
Kentucky,Adair County,11,4,1523,803,720
Kentucky,Adair County,11,5,1461,754,707
Kentucky,Adair County,11,6,1231,623,608
Kentucky,Adair County,11,7,1011,500,511
Kentucky,Adair County,11,8,1027,495,532
Kentucky,Adair County,11,9,1017,490,527
Kentucky,Adair County,11,10,1173,603,570
Kentucky,Adair County,11,11,1325,634,691
Kentucky,Adair County,11,12,1414,660,754
Kentucky,Adair County,11,13,1282,620,662
Kentucky,Adair County,11,14,1196,596,600
Kentucky,Adair County,11,15,914,456,458
Kentucky,Adair County,11,16,655,296,359
Kentucky,Adair County,11,17,441,199,242
Kentucky,Adair County,11,18,398,139,259
Kentucky,Adair County,12,0,19202,9570,9632
Kentucky,Adair County,12,1,991,516,475
Kentucky,Adair County,12,2,1009,545,464
Kentucky,Adair County,12,3,1096,573,523
Kentucky,Adair County,12,4,1507,803,704
Kentucky,Adair County,12,5,1458,752,706
Kentucky,Adair County,12,6,1219,639,580
Kentucky,Adair County,12,7,1032,502,530
Kentucky,Adair County,12,8,1007,496,511
Kentucky,Adair County,12,9,990,466,524
Kentucky,Adair County,12,10,1199,621,578
Kentucky,Adair County,12,11,1298,636,662
Kentucky,Adair County,12,12,1407,640,767
Kentucky,Adair County,12,13,1294,639,655
Kentucky,Adair County,12,14,1192,593,599
Kentucky,Adair County,12,15,963,481,482
Kentucky,Adair County,12,16,675,319,356
Kentucky,Adair County,12,17,458,204,254
Kentucky,Adair County,12,18,407,145,262
Kentucky,Allen County,1,0,19956,9805,10151
Kentucky,Allen County,1,1,1346,667,679
Kentucky,Allen County,1,2,1323,668,655
Kentucky,Allen County,1,3,1331,707,624
Kentucky,Allen County,1,4,1421,692,729
Kentucky,Allen County,1,5,1133,577,556
Kentucky,Allen County,1,6,1142,537,605
Kentucky,Allen County,1,7,1161,576,585
Kentucky,Allen County,1,8,1353,712,641
Kentucky,Allen County,1,9,1368,668,700
Kentucky,Allen County,1,10,1474,685,789
Kentucky,Allen County,1,11,1428,760,668
Kentucky,Allen County,1,12,1293,626,667
Kentucky,Allen County,1,13,1252,594,658
Kentucky,Allen County,1,14,979,480,499
Kentucky,Allen County,1,15,763,370,393
Kentucky,Allen County,1,16,572,272,300
Kentucky,Allen County,1,17,341,133,208
Kentucky,Allen County,1,18,276,81,195
Kentucky,Allen County,2,0,19958,9806,10152
Kentucky,Allen County,2,1,1345,667,678
Kentucky,Allen County,2,2,1322,668,654
Kentucky,Allen County,2,3,1331,707,624
Kentucky,Allen County,2,4,1422,692,730
Kentucky,Allen County,2,5,1134,578,556
Kentucky,Allen County,2,6,1143,537,606
Kentucky,Allen County,2,7,1159,575,584
Kentucky,Allen County,2,8,1353,712,641
Kentucky,Allen County,2,9,1368,668,700
Kentucky,Allen County,2,10,1478,687,791
Kentucky,Allen County,2,11,1429,761,668
Kentucky,Allen County,2,12,1292,626,666
Kentucky,Allen County,2,13,1250,592,658
Kentucky,Allen County,2,14,979,480,499
Kentucky,Allen County,2,15,763,370,393
Kentucky,Allen County,2,16,572,272,300
Kentucky,Allen County,2,17,341,133,208
Kentucky,Allen County,2,18,277,81,196
Kentucky,Allen County,3,0,20037,9856,10181
Kentucky,Allen County,3,1,1340,668,672
Kentucky,Allen County,3,2,1337,675,662
Kentucky,Allen County,3,3,1341,709,632
Kentucky,Allen County,3,4,1398,688,710
Kentucky,Allen County,3,5,1154,584,570
Kentucky,Allen County,3,6,1139,536,603
Kentucky,Allen County,3,7,1155,572,583
Kentucky,Allen County,3,8,1351,711,640
Kentucky,Allen County,3,9,1368,667,701
Kentucky,Allen County,3,10,1491,702,789
Kentucky,Allen County,3,11,1440,764,676
Kentucky,Allen County,3,12,1295,627,668
Kentucky,Allen County,3,13,1263,601,662
Kentucky,Allen County,3,14,986,479,507
Kentucky,Allen County,3,15,771,378,393
Kentucky,Allen County,3,16,579,274,305
Kentucky,Allen County,3,17,349,139,210
Kentucky,Allen County,3,18,280,82,198
Kentucky,Allen County,4,0,20176,9922,10254
Kentucky,Allen County,4,1,1301,638,663
Kentucky,Allen County,4,2,1362,678,684
Kentucky,Allen County,4,3,1379,717,662
Kentucky,Allen County,4,4,1334,685,649
Kentucky,Allen County,4,5,1213,608,605
Kentucky,Allen County,4,6,1159,558,601
Kentucky,Allen County,4,7,1139,573,566
Kentucky,Allen County,4,8,1325,695,630
Kentucky,Allen County,4,9,1345,651,694
Kentucky,Allen County,4,10,1497,716,781
Kentucky,Allen County,4,11,1483,768,715
Kentucky,Allen County,4,12,1293,633,660
Kentucky,Allen County,4,13,1305,619,686
Kentucky,Allen County,4,14,1004,473,531
Kentucky,Allen County,4,15,792,391,401
Kentucky,Allen County,4,16,588,276,312
Kentucky,Allen County,4,17,366,153,213
Kentucky,Allen County,4,18,291,90,201
Kentucky,Allen County,5,0,20232,9981,10251
Kentucky,Allen County,5,1,1270,641,629
Kentucky,Allen County,5,2,1340,683,657
Kentucky,Allen County,5,3,1430,732,698
Kentucky,Allen County,5,4,1271,661,610
Kentucky,Allen County,5,5,1249,617,632
Kentucky,Allen County,5,6,1146,575,571
Kentucky,Allen County,5,7,1138,552,586
Kentucky,Allen County,5,8,1281,666,615
Kentucky,Allen County,5,9,1360,674,686
Kentucky,Allen County,5,10,1468,688,780
Kentucky,Allen County,5,11,1505,752,753
Kentucky,Allen County,5,12,1329,679,650
Kentucky,Allen County,5,13,1264,613,651
Kentucky,Allen County,5,14,1098,509,589
Kentucky,Allen County,5,15,825,409,416
Kentucky,Allen County,5,16,594,280,314
Kentucky,Allen County,5,17,358,145,213
Kentucky,Allen County,5,18,306,105,201
Kentucky,Allen County,6,0,20316,10019,10297
Kentucky,Allen County,6,1,1321,669,652
Kentucky,Allen County,6,2,1326,685,641
Kentucky,Allen County,6,3,1431,723,708
Kentucky,Allen County,6,4,1239,653,586
Kentucky,Allen County,6,5,1289,616,673
Kentucky,Allen County,6,6,1147,597,550
Kentucky,Allen County,6,7,1156,561,595
Kentucky,Allen County,6,8,1241,629,612
Kentucky,Allen County,6,9,1364,693,671
Kentucky,Allen County,6,10,1435,682,753
Kentucky,Allen County,6,11,1471,707,764
Kentucky,Allen County,6,12,1367,709,658
Kentucky,Allen County,6,13,1285,625,660
Kentucky,Allen County,6,14,1109,509,600
Kentucky,Allen County,6,15,842,416,426
Kentucky,Allen County,6,16,618,278,340
Kentucky,Allen County,6,17,366,158,208
Kentucky,Allen County,6,18,309,109,200
Kentucky,Allen County,7,0,20493,10159,10334
Kentucky,Allen County,7,1,1318,685,633
Kentucky,Allen County,7,2,1339,682,657
Kentucky,Allen County,7,3,1431,748,683
Kentucky,Allen County,7,4,1223,664,559
Kentucky,Allen County,7,5,1262,595,667
Kentucky,Allen County,7,6,1223,629,594
Kentucky,Allen County,7,7,1167,562,605
Kentucky,Allen County,7,8,1187,589,598
Kentucky,Allen County,7,9,1363,708,655
Kentucky,Allen County,7,10,1393,665,728
Kentucky,Allen County,7,11,1496,707,789
Kentucky,Allen County,7,12,1399,741,658
Kentucky,Allen County,7,13,1295,618,677
Kentucky,Allen County,7,14,1177,559,618
Kentucky,Allen County,7,15,869,431,438
Kentucky,Allen County,7,16,633,285,348
Kentucky,Allen County,7,17,396,175,221
Kentucky,Allen County,7,18,322,116,206
Kentucky,Allen County,8,0,20660,10204,10456
Kentucky,Allen County,8,1,1310,680,630
Kentucky,Allen County,8,2,1361,677,684
Kentucky,Allen County,8,3,1372,711,661
Kentucky,Allen County,8,4,1265,671,594
Kentucky,Allen County,8,5,1288,632,656
Kentucky,Allen County,8,6,1281,642,639
Kentucky,Allen County,8,7,1160,567,593
Kentucky,Allen County,8,8,1165,564,601
Kentucky,Allen County,8,9,1339,699,640
Kentucky,Allen County,8,10,1390,668,722
Kentucky,Allen County,8,11,1527,727,800
Kentucky,Allen County,8,12,1455,758,697
Kentucky,Allen County,8,13,1275,612,663
Kentucky,Allen County,8,14,1204,565,639
Kentucky,Allen County,8,15,898,434,464
Kentucky,Allen County,8,16,639,299,340
Kentucky,Allen County,8,17,426,195,231
Kentucky,Allen County,8,18,305,103,202
Kentucky,Allen County,9,0,20721,10234,10487
Kentucky,Allen County,9,1,1285,683,602
Kentucky,Allen County,9,2,1371,673,698
Kentucky,Allen County,9,3,1358,690,668
Kentucky,Allen County,9,4,1302,694,608
Kentucky,Allen County,9,5,1181,601,580
Kentucky,Allen County,9,6,1363,665,698
Kentucky,Allen County,9,7,1166,570,596
Kentucky,Allen County,9,8,1150,557,593
Kentucky,Allen County,9,9,1325,669,656
Kentucky,Allen County,9,10,1355,663,692
Kentucky,Allen County,9,11,1536,745,791
Kentucky,Allen County,9,12,1470,763,707
Kentucky,Allen County,9,13,1272,614,658
Kentucky,Allen County,9,14,1236,592,644
Kentucky,Allen County,9,15,941,431,510
Kentucky,Allen County,9,16,639,299,340
Kentucky,Allen County,9,17,435,206,229
Kentucky,Allen County,9,18,336,119,217
Kentucky,Allen County,10,0,20903,10349,10554
Kentucky,Allen County,10,1,1271,656,615
Kentucky,Allen County,10,2,1380,699,681
Kentucky,Allen County,10,3,1341,693,648
Kentucky,Allen County,10,4,1335,702,633
Kentucky,Allen County,10,5,1138,584,554
Kentucky,Allen County,10,6,1407,677,730
Kentucky,Allen County,10,7,1154,575,579
Kentucky,Allen County,10,8,1199,581,618
Kentucky,Allen County,10,9,1275,653,622
Kentucky,Allen County,10,10,1426,700,726
Kentucky,Allen County,10,11,1494,723,771
Kentucky,Allen County,10,12,1520,762,758
Kentucky,Allen County,10,13,1306,657,649
Kentucky,Allen County,10,14,1209,592,617
Kentucky,Allen County,10,15,1019,466,553
Kentucky,Allen County,10,16,671,313,358
Kentucky,Allen County,10,17,438,198,240
Kentucky,Allen County,10,18,320,118,202
Kentucky,Allen County,11,0,21122,10452,10670
Kentucky,Allen County,11,1,1262,644,618
Kentucky,Allen County,11,2,1379,710,669
Kentucky,Allen County,11,3,1361,695,666
Kentucky,Allen County,11,4,1330,693,637
Kentucky,Allen County,11,5,1098,573,525
Kentucky,Allen County,11,6,1475,721,754
Kentucky,Allen County,11,7,1209,607,602
Kentucky,Allen County,11,8,1190,579,611
Kentucky,Allen County,11,9,1252,621,631
Kentucky,Allen County,11,10,1458,721,737
Kentucky,Allen County,11,11,1476,731,745
Kentucky,Allen County,11,12,1492,721,771
Kentucky,Allen County,11,13,1398,717,681
Kentucky,Allen County,11,14,1238,597,641
Kentucky,Allen County,11,15,1027,469,558
Kentucky,Allen County,11,16,711,343,368
Kentucky,Allen County,11,17,439,188,251
Kentucky,Allen County,11,18,327,122,205
Kentucky,Allen County,12,0,21315,10575,10740
Kentucky,Allen County,12,1,1271,666,605
Kentucky,Allen County,12,2,1383,711,672
Kentucky,Allen County,12,3,1420,722,698
Kentucky,Allen County,12,4,1298,695,603
Kentucky,Allen County,12,5,1118,576,542
Kentucky,Allen County,12,6,1446,698,748
Kentucky,Allen County,12,7,1275,654,621
Kentucky,Allen County,12,8,1223,592,631
Kentucky,Allen County,12,9,1231,613,618
Kentucky,Allen County,12,10,1425,727,698
Kentucky,Allen County,12,11,1444,707,737
Kentucky,Allen County,12,12,1525,723,802
Kentucky,Allen County,12,13,1405,731,674
Kentucky,Allen County,12,14,1254,585,669
Kentucky,Allen County,12,15,1087,509,578
Kentucky,Allen County,12,16,728,354,374
Kentucky,Allen County,12,17,446,189,257
Kentucky,Allen County,12,18,336,123,213
Kentucky,Anderson County,1,0,21421,10468,10953
Kentucky,Anderson County,1,1,1433,747,686
Kentucky,Anderson County,1,2,1451,734,717
Kentucky,Anderson County,1,3,1591,832,759
Kentucky,Anderson County,1,4,1469,759,710
Kentucky,Anderson County,1,5,1065,522,543
Kentucky,Anderson County,1,6,1221,545,676
Kentucky,Anderson County,1,7,1404,693,711
Kentucky,Anderson County,1,8,1628,808,820
Kentucky,Anderson County,1,9,1587,798,789
Kentucky,Anderson County,1,10,1776,850,926
Kentucky,Anderson County,1,11,1538,764,774
Kentucky,Anderson County,1,12,1462,724,738
Kentucky,Anderson County,1,13,1217,566,651
Kentucky,Anderson County,1,14,866,431,435
Kentucky,Anderson County,1,15,635,297,338
Kentucky,Anderson County,1,16,432,182,250
Kentucky,Anderson County,1,17,340,138,202
Kentucky,Anderson County,1,18,306,78,228
Kentucky,Anderson County,2,0,21462,10486,10976
Kentucky,Anderson County,2,1,1434,748,686
Kentucky,Anderson County,2,2,1454,736,718
Kentucky,Anderson County,2,3,1595,833,762
Kentucky,Anderson County,2,4,1473,760,713
Kentucky,Anderson County,2,5,1067,523,544
Kentucky,Anderson County,2,6,1220,544,676
Kentucky,Anderson County,2,7,1406,694,712
Kentucky,Anderson County,2,8,1629,808,821
Kentucky,Anderson County,2,9,1592,800,792
Kentucky,Anderson County,2,10,1781,852,929
Kentucky,Anderson County,2,11,1539,765,774
Kentucky,Anderson County,2,12,1466,726,740
Kentucky,Anderson County,2,13,1224,569,655
Kentucky,Anderson County,2,14,869,433,436
Kentucky,Anderson County,2,15,635,297,338
Kentucky,Anderson County,2,16,432,182,250
Kentucky,Anderson County,2,17,340,138,202
Kentucky,Anderson County,2,18,306,78,228
Kentucky,Anderson County,3,0,21470,10496,10974
Kentucky,Anderson County,3,1,1407,740,667
Kentucky,Anderson County,3,2,1453,734,719
Kentucky,Anderson County,3,3,1597,837,760
Kentucky,Anderson County,3,4,1477,763,714
Kentucky,Anderson County,3,5,1081,530,551
Kentucky,Anderson County,3,6,1224,546,678
Kentucky,Anderson County,3,7,1406,692,714
Kentucky,Anderson County,3,8,1623,806,817
Kentucky,Anderson County,3,9,1592,789,803
Kentucky,Anderson County,3,10,1773,855,918
Kentucky,Anderson County,3,11,1548,769,779
Kentucky,Anderson County,3,12,1467,733,734
Kentucky,Anderson County,3,13,1246,578,668
Kentucky,Anderson County,3,14,866,432,434
Kentucky,Anderson County,3,15,636,293,343
Kentucky,Anderson County,3,16,429,184,245
Kentucky,Anderson County,3,17,338,134,204
Kentucky,Anderson County,3,18,307,81,226
Kentucky,Anderson County,4,0,21564,10536,11028
Kentucky,Anderson County,4,1,1354,733,621
Kentucky,Anderson County,4,2,1484,764,720
Kentucky,Anderson County,4,3,1586,810,776
Kentucky,Anderson County,4,4,1474,754,720
Kentucky,Anderson County,4,5,1111,536,575
Kentucky,Anderson County,4,6,1202,555,647
Kentucky,Anderson County,4,7,1380,681,699
Kentucky,Anderson County,4,8,1584,781,803
Kentucky,Anderson County,4,9,1629,790,839
Kentucky,Anderson County,4,10,1739,843,896
Kentucky,Anderson County,4,11,1598,790,808
Kentucky,Anderson County,4,12,1464,747,717
Kentucky,Anderson County,4,13,1332,615,717
Kentucky,Anderson County,4,14,877,433,444
Kentucky,Anderson County,4,15,651,287,364
Kentucky,Anderson County,4,16,450,204,246
Kentucky,Anderson County,4,17,338,126,212
Kentucky,Anderson County,4,18,311,87,224
Kentucky,Anderson County,5,0,21694,10631,11063
Kentucky,Anderson County,5,1,1322,715,607
Kentucky,Anderson County,5,2,1519,802,717
Kentucky,Anderson County,5,3,1529,780,749
Kentucky,Anderson County,5,4,1481,777,704
Kentucky,Anderson County,5,5,1179,572,607
Kentucky,Anderson County,5,6,1210,582,628
Kentucky,Anderson County,5,7,1274,623,651
Kentucky,Anderson County,5,8,1513,749,764
Kentucky,Anderson County,5,9,1663,815,848
Kentucky,Anderson County,5,10,1726,841,885
Kentucky,Anderson County,5,11,1646,790,856
Kentucky,Anderson County,5,12,1484,764,720
Kentucky,Anderson County,5,13,1318,598,720
Kentucky,Anderson County,5,14,987,477,510
Kentucky,Anderson County,5,15,697,307,390
Kentucky,Anderson County,5,16,471,214,257
Kentucky,Anderson County,5,17,341,134,207
Kentucky,Anderson County,5,18,334,91,243
Kentucky,Anderson County,6,0,21747,10637,11110
Kentucky,Anderson County,6,1,1305,696,609
Kentucky,Anderson County,6,2,1490,786,704
Kentucky,Anderson County,6,3,1519,770,749
Kentucky,Anderson County,6,4,1455,747,708
Kentucky,Anderson County,6,5,1199,608,591
Kentucky,Anderson County,6,6,1186,566,620
Kentucky,Anderson County,6,7,1256,608,648
Kentucky,Anderson County,6,8,1454,715,739
Kentucky,Anderson County,6,9,1697,832,865
Kentucky,Anderson County,6,10,1684,817,867
Kentucky,Anderson County,6,11,1714,824,890
Kentucky,Anderson County,6,12,1493,765,728
Kentucky,Anderson County,6,13,1323,614,709
Kentucky,Anderson County,6,14,1022,479,543
Kentucky,Anderson County,6,15,757,352,405
Kentucky,Anderson County,6,16,496,227,269
Kentucky,Anderson County,6,17,346,133,213
Kentucky,Anderson County,6,18,351,98,253
Kentucky,Anderson County,7,0,21868,10669,11199
Kentucky,Anderson County,7,1,1306,690,616
Kentucky,Anderson County,7,2,1513,789,724
Kentucky,Anderson County,7,3,1536,786,750
Kentucky,Anderson County,7,4,1436,738,698
Kentucky,Anderson County,7,5,1214,604,610
Kentucky,Anderson County,7,6,1193,583,610
Kentucky,Anderson County,7,7,1265,588,677
Kentucky,Anderson County,7,8,1414,699,715
Kentucky,Anderson County,7,9,1668,821,847
Kentucky,Anderson County,7,10,1633,802,831
Kentucky,Anderson County,7,11,1752,835,917
Kentucky,Anderson County,7,12,1501,752,749
Kentucky,Anderson County,7,13,1354,652,702
Kentucky,Anderson County,7,14,1094,506,588
Kentucky,Anderson County,7,15,768,364,404
Kentucky,Anderson County,7,16,515,232,283
Kentucky,Anderson County,7,17,342,131,211
Kentucky,Anderson County,7,18,364,97,267
Kentucky,Anderson County,8,0,21920,10683,11237
Kentucky,Anderson County,8,1,1320,692,628
Kentucky,Anderson County,8,2,1498,779,719
Kentucky,Anderson County,8,3,1494,767,727
Kentucky,Anderson County,8,4,1452,745,707
Kentucky,Anderson County,8,5,1249,632,617
Kentucky,Anderson County,8,6,1202,566,636
Kentucky,Anderson County,8,7,1263,608,655
Kentucky,Anderson County,8,8,1376,667,709
Kentucky,Anderson County,8,9,1623,792,831
Kentucky,Anderson County,8,10,1591,781,810
Kentucky,Anderson County,8,11,1770,858,912
Kentucky,Anderson County,8,12,1526,751,775
Kentucky,Anderson County,8,13,1362,679,683
Kentucky,Anderson County,8,14,1154,523,631
Kentucky,Anderson County,8,15,774,367,407
Kentucky,Anderson County,8,16,554,243,311
Kentucky,Anderson County,8,17,336,131,205
Kentucky,Anderson County,8,18,376,102,274
Kentucky,Anderson County,9,0,22191,10813,11378
Kentucky,Anderson County,9,1,1376,711,665
Kentucky,Anderson County,9,2,1482,782,700
Kentucky,Anderson County,9,3,1512,784,728
Kentucky,Anderson County,9,4,1423,726,697
Kentucky,Anderson County,9,5,1256,639,617
Kentucky,Anderson County,9,6,1290,595,695
Kentucky,Anderson County,9,7,1292,612,680
Kentucky,Anderson County,9,8,1364,666,698
Kentucky,Anderson County,9,9,1573,769,804
Kentucky,Anderson County,9,10,1622,788,834
Kentucky,Anderson County,9,11,1750,853,897
Kentucky,Anderson County,9,12,1575,777,798
Kentucky,Anderson County,9,13,1359,683,676
Kentucky,Anderson County,9,14,1227,555,672
Kentucky,Anderson County,9,15,773,367,406
Kentucky,Anderson County,9,16,574,249,325
Kentucky,Anderson County,9,17,366,151,215
Kentucky,Anderson County,9,18,377,106,271
Kentucky,Anderson County,10,0,22545,11060,11485
Kentucky,Anderson County,10,1,1456,771,685
Kentucky,Anderson County,10,2,1454,777,677
Kentucky,Anderson County,10,3,1597,835,762
Kentucky,Anderson County,10,4,1406,720,686
Kentucky,Anderson County,10,5,1250,639,611
Kentucky,Anderson County,10,6,1391,660,731
Kentucky,Anderson County,10,7,1290,608,682
Kentucky,Anderson County,10,8,1357,664,693
Kentucky,Anderson County,10,9,1540,751,789
Kentucky,Anderson County,10,10,1678,829,849
Kentucky,Anderson County,10,11,1702,837,865
Kentucky,Anderson County,10,12,1611,783,828
Kentucky,Anderson County,10,13,1388,716,672
Kentucky,Anderson County,10,14,1210,536,674
Kentucky,Anderson County,10,15,870,402,468
Kentucky,Anderson County,10,16,597,269,328
Kentucky,Anderson County,10,17,375,159,216
Kentucky,Anderson County,10,18,373,104,269
Kentucky,Anderson County,11,0,22641,11110,11531
Kentucky,Anderson County,11,1,1385,747,638
Kentucky,Anderson County,11,2,1451,766,685
Kentucky,Anderson County,11,3,1613,836,777
Kentucky,Anderson County,11,4,1402,739,663
Kentucky,Anderson County,11,5,1189,589,600
Kentucky,Anderson County,11,6,1456,693,763
Kentucky,Anderson County,11,7,1284,620,664
Kentucky,Anderson County,11,8,1376,662,714
Kentucky,Anderson County,11,9,1502,733,769
Kentucky,Anderson County,11,10,1689,836,853
Kentucky,Anderson County,11,11,1663,818,845
Kentucky,Anderson County,11,12,1689,821,868
Kentucky,Anderson County,11,13,1383,710,673
Kentucky,Anderson County,11,14,1235,565,670
Kentucky,Anderson County,11,15,919,412,507
Kentucky,Anderson County,11,16,624,280,344
Kentucky,Anderson County,11,17,406,185,221
Kentucky,Anderson County,11,18,375,98,277
Kentucky,Anderson County,12,0,22747,11138,11609
Kentucky,Anderson County,12,1,1388,731,657
Kentucky,Anderson County,12,2,1418,742,676
Kentucky,Anderson County,12,3,1641,846,795
Kentucky,Anderson County,12,4,1384,723,661
Kentucky,Anderson County,12,5,1171,592,579
Kentucky,Anderson County,12,6,1440,701,739
Kentucky,Anderson County,12,7,1332,628,704
Kentucky,Anderson County,12,8,1385,658,727
Kentucky,Anderson County,12,9,1454,705,749
Kentucky,Anderson County,12,10,1675,839,836
Kentucky,Anderson County,12,11,1634,808,826
Kentucky,Anderson County,12,12,1713,828,885
Kentucky,Anderson County,12,13,1402,713,689
Kentucky,Anderson County,12,14,1253,593,660
Kentucky,Anderson County,12,15,1013,458,555
Kentucky,Anderson County,12,16,634,282,352
Kentucky,Anderson County,12,17,433,201,232
Kentucky,Anderson County,12,18,377,90,287
Kentucky,Ballard County,1,0,8249,4096,4153
Kentucky,Ballard County,1,1,431,237,194
Kentucky,Ballard County,1,2,498,275,223
Kentucky,Ballard County,1,3,557,277,280
Kentucky,Ballard County,1,4,543,284,259
Kentucky,Ballard County,1,5,406,206,200
Kentucky,Ballard County,1,6,405,223,182
Kentucky,Ballard County,1,7,477,236,241
Kentucky,Ballard County,1,8,538,272,266
Kentucky,Ballard County,1,9,565,276,289
Kentucky,Ballard County,1,10,581,288,293
Kentucky,Ballard County,1,11,656,321,335
Kentucky,Ballard County,1,12,590,297,293
Kentucky,Ballard County,1,13,552,273,279
Kentucky,Ballard County,1,14,462,216,246
Kentucky,Ballard County,1,15,348,168,180
Kentucky,Ballard County,1,16,262,117,145
Kentucky,Ballard County,1,17,207,79,128
Kentucky,Ballard County,1,18,171,51,120
Kentucky,Ballard County,2,0,8246,4094,4152
Kentucky,Ballard County,2,1,431,237,194
Kentucky,Ballard County,2,2,498,275,223
Kentucky,Ballard County,2,3,557,277,280
Kentucky,Ballard County,2,4,543,284,259
Kentucky,Ballard County,2,5,406,206,200
Kentucky,Ballard County,2,6,405,223,182
Kentucky,Ballard County,2,7,477,236,241
Kentucky,Ballard County,2,8,538,272,266
Kentucky,Ballard County,2,9,565,276,289
Kentucky,Ballard County,2,10,580,287,293
Kentucky,Ballard County,2,11,656,321,335
Kentucky,Ballard County,2,12,590,297,293
Kentucky,Ballard County,2,13,552,273,279
Kentucky,Ballard County,2,14,462,216,246
Kentucky,Ballard County,2,15,348,168,180
Kentucky,Ballard County,2,16,262,117,145
Kentucky,Ballard County,2,17,205,78,127
Kentucky,Ballard County,2,18,171,51,120
Kentucky,Ballard County,3,0,8260,4099,4161
Kentucky,Ballard County,3,1,437,238,199
Kentucky,Ballard County,3,2,501,272,229
Kentucky,Ballard County,3,3,561,286,275
Kentucky,Ballard County,3,4,531,275,256
Kentucky,Ballard County,3,5,411,206,205
Kentucky,Ballard County,3,6,413,227,186
Kentucky,Ballard County,3,7,472,234,238
Kentucky,Ballard County,3,8,533,269,264
Kentucky,Ballard County,3,9,566,278,288
Kentucky,Ballard County,3,10,582,289,293
Kentucky,Ballard County,3,11,651,319,332
Kentucky,Ballard County,3,12,596,302,294
Kentucky,Ballard County,3,13,549,268,281
Kentucky,Ballard County,3,14,466,221,245
Kentucky,Ballard County,3,15,353,167,186
Kentucky,Ballard County,3,16,260,117,143
Kentucky,Ballard County,3,17,207,80,127
Kentucky,Ballard County,3,18,171,51,120
Kentucky,Ballard County,4,0,8269,4104,4165
Kentucky,Ballard County,4,1,460,242,218
Kentucky,Ballard County,4,2,483,250,233
Kentucky,Ballard County,4,3,562,297,265
Kentucky,Ballard County,4,4,521,269,252
Kentucky,Ballard County,4,5,422,202,220
Kentucky,Ballard County,4,6,431,237,194
Kentucky,Ballard County,4,7,447,229,218
Kentucky,Ballard County,4,8,511,252,259
Kentucky,Ballard County,4,9,559,278,281
Kentucky,Ballard County,4,10,587,295,292
Kentucky,Ballard County,4,11,622,298,324
Kentucky,Ballard County,4,12,618,316,302
Kentucky,Ballard County,4,13,562,279,283
Kentucky,Ballard County,4,14,467,228,239
Kentucky,Ballard County,4,15,369,173,196
Kentucky,Ballard County,4,16,271,128,143
Kentucky,Ballard County,4,17,213,81,132
Kentucky,Ballard County,4,18,164,50,114
Kentucky,Ballard County,5,0,8285,4123,4162
Kentucky,Ballard County,5,1,473,248,225
Kentucky,Ballard County,5,2,483,254,229
Kentucky,Ballard County,5,3,578,306,272
Kentucky,Ballard County,5,4,524,276,248
Kentucky,Ballard County,5,5,439,228,211
Kentucky,Ballard County,5,6,431,213,218
Kentucky,Ballard County,5,7,451,235,216
Kentucky,Ballard County,5,8,493,258,235
Kentucky,Ballard County,5,9,574,276,298
Kentucky,Ballard County,5,10,549,278,271
Kentucky,Ballard County,5,11,597,283,314
Kentucky,Ballard County,5,12,635,318,317
Kentucky,Ballard County,5,13,537,271,266
Kentucky,Ballard County,5,14,488,229,259
Kentucky,Ballard County,5,15,371,176,195
Kentucky,Ballard County,5,16,271,131,140
Kentucky,Ballard County,5,17,211,81,130
Kentucky,Ballard County,5,18,180,62,118
Kentucky,Ballard County,6,0,8252,4094,4158
Kentucky,Ballard County,6,1,450,236,214
Kentucky,Ballard County,6,2,499,260,239
Kentucky,Ballard County,6,3,552,302,250
Kentucky,Ballard County,6,4,526,269,257
Kentucky,Ballard County,6,5,433,233,200
Kentucky,Ballard County,6,6,437,225,212
Kentucky,Ballard County,6,7,439,217,222
Kentucky,Ballard County,6,8,474,246,228
Kentucky,Ballard County,6,9,582,276,306
Kentucky,Ballard County,6,10,547,276,271
Kentucky,Ballard County,6,11,587,275,312
Kentucky,Ballard County,6,12,649,317,332
Kentucky,Ballard County,6,13,546,284,262
Kentucky,Ballard County,6,14,489,225,264
Kentucky,Ballard County,6,15,373,172,201
Kentucky,Ballard County,6,16,279,130,149
Kentucky,Ballard County,6,17,207,85,122
Kentucky,Ballard County,6,18,183,66,117
Kentucky,Ballard County,7,0,8188,4061,4127
Kentucky,Ballard County,7,1,440,235,205
Kentucky,Ballard County,7,2,462,244,218
Kentucky,Ballard County,7,3,556,300,256
Kentucky,Ballard County,7,4,534,264,270
Kentucky,Ballard County,7,5,423,233,190
Kentucky,Ballard County,7,6,436,214,222
Kentucky,Ballard County,7,7,427,212,215
Kentucky,Ballard County,7,8,484,256,228
Kentucky,Ballard County,7,9,547,262,285
Kentucky,Ballard County,7,10,540,265,275
Kentucky,Ballard County,7,11,547,271,276
Kentucky,Ballard County,7,12,649,309,340
Kentucky,Ballard County,7,13,562,284,278
Kentucky,Ballard County,7,14,492,235,257
Kentucky,Ballard County,7,15,401,182,219
Kentucky,Ballard County,7,16,282,136,146
Kentucky,Ballard County,7,17,216,89,127
Kentucky,Ballard County,7,18,190,70,120
Kentucky,Ballard County,8,0,8216,4065,4151
Kentucky,Ballard County,8,1,444,229,215
Kentucky,Ballard County,8,2,501,254,247
Kentucky,Ballard County,8,3,539,294,245
Kentucky,Ballard County,8,4,538,273,265
Kentucky,Ballard County,8,5,412,221,191
Kentucky,Ballard County,8,6,437,206,231
Kentucky,Ballard County,8,7,416,215,201
Kentucky,Ballard County,8,8,499,261,238
Kentucky,Ballard County,8,9,535,257,278
Kentucky,Ballard County,8,10,536,257,279
Kentucky,Ballard County,8,11,547,272,275
Kentucky,Ballard County,8,12,650,313,337
Kentucky,Ballard County,8,13,567,283,284
Kentucky,Ballard County,8,14,495,248,247
Kentucky,Ballard County,8,15,401,188,213
Kentucky,Ballard County,8,16,295,128,167
Kentucky,Ballard County,8,17,210,97,113
Kentucky,Ballard County,8,18,194,69,125
Kentucky,Ballard County,9,0,8046,3991,4055
Kentucky,Ballard County,9,1,409,202,207
Kentucky,Ballard County,9,2,500,254,246
Kentucky,Ballard County,9,3,504,258,246
Kentucky,Ballard County,9,4,529,294,235
Kentucky,Ballard County,9,5,403,225,178
Kentucky,Ballard County,9,6,410,189,221
Kentucky,Ballard County,9,7,424,226,198
Kentucky,Ballard County,9,8,478,253,225
Kentucky,Ballard County,9,9,501,245,256
Kentucky,Ballard County,9,10,529,264,265
Kentucky,Ballard County,9,11,556,273,283
Kentucky,Ballard County,9,12,599,287,312
Kentucky,Ballard County,9,13,594,297,297
Kentucky,Ballard County,9,14,512,248,264
Kentucky,Ballard County,9,15,383,177,206
Kentucky,Ballard County,9,16,307,133,174
Kentucky,Ballard County,9,17,204,95,109
Kentucky,Ballard County,9,18,204,71,133
Kentucky,Ballard County,10,0,8018,3999,4019
Kentucky,Ballard County,10,1,424,223,201
Kentucky,Ballard County,10,2,486,257,229
Kentucky,Ballard County,10,3,477,246,231
Kentucky,Ballard County,10,4,525,296,229
Kentucky,Ballard County,10,5,429,236,193
Kentucky,Ballard County,10,6,426,213,213
Kentucky,Ballard County,10,7,414,210,204
Kentucky,Ballard County,10,8,448,229,219
Kentucky,Ballard County,10,9,497,257,240
Kentucky,Ballard County,10,10,542,260,282
Kentucky,Ballard County,10,11,524,264,260
Kentucky,Ballard County,10,12,578,270,308
Kentucky,Ballard County,10,13,606,307,299
Kentucky,Ballard County,10,14,512,250,262
Kentucky,Ballard County,10,15,414,182,232
Kentucky,Ballard County,10,16,307,135,172
Kentucky,Ballard County,10,17,190,87,103
Kentucky,Ballard County,10,18,219,77,142
Kentucky,Ballard County,11,0,7992,3983,4009
Kentucky,Ballard County,11,1,409,220,189
Kentucky,Ballard County,11,2,478,250,228
Kentucky,Ballard County,11,3,505,261,244
Kentucky,Ballard County,11,4,514,287,227
Kentucky,Ballard County,11,5,402,220,182
Kentucky,Ballard County,11,6,428,221,207
Kentucky,Ballard County,11,7,433,216,217
Kentucky,Ballard County,11,8,446,215,231
Kentucky,Ballard County,11,9,477,257,220
Kentucky,Ballard County,11,10,543,259,284
Kentucky,Ballard County,11,11,511,254,257
Kentucky,Ballard County,11,12,552,260,292
Kentucky,Ballard County,11,13,620,303,317
Kentucky,Ballard County,11,14,522,269,253
Kentucky,Ballard County,11,15,427,179,248
Kentucky,Ballard County,11,16,308,141,167
Kentucky,Ballard County,11,17,204,95,109
Kentucky,Ballard County,11,18,213,76,137
Kentucky,Ballard County,12,0,7888,3922,3966
Kentucky,Ballard County,12,1,393,204,189
Kentucky,Ballard County,12,2,446,237,209
Kentucky,Ballard County,12,3,480,238,242
Kentucky,Ballard County,12,4,514,293,221
Kentucky,Ballard County,12,5,410,208,202
Kentucky,Ballard County,12,6,414,224,190
Kentucky,Ballard County,12,7,412,211,201
Kentucky,Ballard County,12,8,425,199,226
Kentucky,Ballard County,12,9,487,253,234
Kentucky,Ballard County,12,10,522,262,260
Kentucky,Ballard County,12,11,509,245,264
Kentucky,Ballard County,12,12,530,260,270
Kentucky,Ballard County,12,13,619,300,319
Kentucky,Ballard County,12,14,526,268,258
Kentucky,Ballard County,12,15,451,200,251
Kentucky,Ballard County,12,16,331,145,186
Kentucky,Ballard County,12,17,207,100,107
Kentucky,Ballard County,12,18,212,75,137
Kentucky,Barren County,1,0,42173,20464,21709
Kentucky,Barren County,1,1,2756,1369,1387
Kentucky,Barren County,1,2,2760,1393,1367
Kentucky,Barren County,1,3,2889,1487,1402
Kentucky,Barren County,1,4,2812,1468,1344
Kentucky,Barren County,1,5,2238,1145,1093
Kentucky,Barren County,1,6,2605,1308,1297
Kentucky,Barren County,1,7,2433,1155,1278
Kentucky,Barren County,1,8,2742,1412,1330
Kentucky,Barren County,1,9,2842,1369,1473
Kentucky,Barren County,1,10,3136,1557,1579
Kentucky,Barren County,1,11,3193,1527,1666
Kentucky,Barren County,1,12,2720,1343,1377
Kentucky,Barren County,1,13,2547,1237,1310
Kentucky,Barren County,1,14,1998,928,1070
Kentucky,Barren County,1,15,1545,694,851
Kentucky,Barren County,1,16,1240,498,742
Kentucky,Barren County,1,17,880,318,562
Kentucky,Barren County,1,18,837,256,581
Kentucky,Barren County,2,0,42161,20459,21702
Kentucky,Barren County,2,1,2756,1369,1387
Kentucky,Barren County,2,2,2760,1393,1367
Kentucky,Barren County,2,3,2888,1487,1401
Kentucky,Barren County,2,4,2812,1468,1344
Kentucky,Barren County,2,5,2234,1143,1091
Kentucky,Barren County,2,6,2605,1308,1297
Kentucky,Barren County,2,7,2433,1155,1278
Kentucky,Barren County,2,8,2742,1412,1330
Kentucky,Barren County,2,9,2840,1369,1471
Kentucky,Barren County,2,10,3135,1556,1579
Kentucky,Barren County,2,11,3192,1526,1666
Kentucky,Barren County,2,12,2720,1343,1377
Kentucky,Barren County,2,13,2546,1237,1309
Kentucky,Barren County,2,14,1997,927,1070
Kentucky,Barren County,2,15,1545,694,851
Kentucky,Barren County,2,16,1240,498,742
Kentucky,Barren County,2,17,880,318,562
Kentucky,Barren County,2,18,836,256,580
Kentucky,Barren County,3,0,42116,20426,21690
Kentucky,Barren County,3,1,2715,1343,1372
Kentucky,Barren County,3,2,2768,1408,1360
Kentucky,Barren County,3,3,2884,1477,1407
Kentucky,Barren County,3,4,2791,1459,1332
Kentucky,Barren County,3,5,2257,1157,1100
Kentucky,Barren County,3,6,2574,1291,1283
Kentucky,Barren County,3,7,2440,1159,1281
Kentucky,Barren County,3,8,2718,1392,1326
Kentucky,Barren County,3,9,2821,1354,1467
Kentucky,Barren County,3,10,3131,1562,1569
Kentucky,Barren County,3,11,3186,1526,1660
Kentucky,Barren County,3,12,2749,1356,1393
Kentucky,Barren County,3,13,2571,1248,1323
Kentucky,Barren County,3,14,1990,929,1061
Kentucky,Barren County,3,15,1562,698,864
Kentucky,Barren County,3,16,1233,492,741
Kentucky,Barren County,3,17,884,321,563
Kentucky,Barren County,3,18,842,254,588
Kentucky,Barren County,4,0,42321,20545,21776
Kentucky,Barren County,4,1,2651,1279,1372
Kentucky,Barren County,4,2,2763,1417,1346
Kentucky,Barren County,4,3,2873,1456,1417
Kentucky,Barren County,4,4,2780,1465,1315
Kentucky,Barren County,4,5,2363,1192,1171
Kentucky,Barren County,4,6,2468,1249,1219
Kentucky,Barren County,4,7,2520,1209,1311
Kentucky,Barren County,4,8,2649,1354,1295
Kentucky,Barren County,4,9,2812,1339,1473
Kentucky,Barren County,4,10,3107,1559,1548
Kentucky,Barren County,4,11,3208,1544,1664
Kentucky,Barren County,4,12,2832,1403,1429
Kentucky,Barren County,4,13,2679,1308,1371
Kentucky,Barren County,4,14,1975,934,1041
Kentucky,Barren County,4,15,1650,737,913
Kentucky,Barren County,4,16,1226,499,727
Kentucky,Barren County,4,17,915,338,577
Kentucky,Barren County,4,18,850,263,587
Kentucky,Barren County,5,0,42607,20732,21875
Kentucky,Barren County,5,1,2637,1316,1321
Kentucky,Barren County,5,2,2793,1423,1370
Kentucky,Barren County,5,3,2889,1474,1415
Kentucky,Barren County,5,4,2770,1448,1322
Kentucky,Barren County,5,5,2425,1235,1190
Kentucky,Barren County,5,6,2451,1242,1209
Kentucky,Barren County,5,7,2582,1276,1306
Kentucky,Barren County,5,8,2574,1280,1294
Kentucky,Barren County,5,9,2837,1376,1461
Kentucky,Barren County,5,10,3020,1496,1524
Kentucky,Barren County,5,11,3261,1578,1683
Kentucky,Barren County,5,12,2880,1424,1456
Kentucky,Barren County,5,13,2630,1275,1355
Kentucky,Barren County,5,14,2136,1038,1098
Kentucky,Barren County,5,15,1690,740,950
Kentucky,Barren County,5,16,1243,521,722
Kentucky,Barren County,5,17,923,328,595
Kentucky,Barren County,5,18,866,262,604
Kentucky,Barren County,6,0,42937,20852,22085
Kentucky,Barren County,6,1,2689,1355,1334
Kentucky,Barren County,6,2,2863,1467,1396
Kentucky,Barren County,6,3,2843,1426,1417
Kentucky,Barren County,6,4,2759,1436,1323
Kentucky,Barren County,6,5,2464,1238,1226
Kentucky,Barren County,6,6,2449,1241,1208
Kentucky,Barren County,6,7,2658,1305,1353
Kentucky,Barren County,6,8,2553,1251,1302
Kentucky,Barren County,6,9,2820,1397,1423
Kentucky,Barren County,6,10,2977,1483,1494
Kentucky,Barren County,6,11,3227,1551,1676
Kentucky,Barren County,6,12,2958,1441,1517
Kentucky,Barren County,6,13,2635,1278,1357
Kentucky,Barren County,6,14,2186,1061,1125
Kentucky,Barren County,6,15,1773,777,996
Kentucky,Barren County,6,16,1250,545,705
Kentucky,Barren County,6,17,946,332,614
Kentucky,Barren County,6,18,887,268,619
Kentucky,Barren County,7,0,43034,20855,22179
Kentucky,Barren County,7,1,2718,1362,1356
Kentucky,Barren County,7,2,2876,1462,1414
Kentucky,Barren County,7,3,2827,1395,1432
Kentucky,Barren County,7,4,2697,1402,1295
Kentucky,Barren County,7,5,2489,1268,1221
Kentucky,Barren County,7,6,2444,1220,1224
Kentucky,Barren County,7,7,2697,1342,1355
Kentucky,Barren County,7,8,2516,1215,1301
Kentucky,Barren County,7,9,2775,1409,1366
Kentucky,Barren County,7,10,2908,1414,1494
Kentucky,Barren County,7,11,3190,1548,1642
Kentucky,Barren County,7,12,3059,1481,1578
Kentucky,Barren County,7,13,2655,1281,1374
Kentucky,Barren County,7,14,2283,1105,1178
Kentucky,Barren County,7,15,1800,793,1007
Kentucky,Barren County,7,16,1241,542,699
Kentucky,Barren County,7,17,967,340,627
Kentucky,Barren County,7,18,892,276,616
Kentucky,Barren County,8,0,43546,21115,22431
Kentucky,Barren County,8,1,2785,1423,1362
Kentucky,Barren County,8,2,2853,1438,1415
Kentucky,Barren County,8,3,2899,1446,1453
Kentucky,Barren County,8,4,2691,1387,1304
Kentucky,Barren County,8,5,2552,1310,1242
Kentucky,Barren County,8,6,2529,1254,1275
Kentucky,Barren County,8,7,2730,1368,1362
Kentucky,Barren County,8,8,2568,1221,1347
Kentucky,Barren County,8,9,2769,1427,1342
Kentucky,Barren County,8,10,2836,1366,1470
Kentucky,Barren County,8,11,3164,1547,1617
Kentucky,Barren County,8,12,3162,1498,1664
Kentucky,Barren County,8,13,2694,1320,1374
Kentucky,Barren County,8,14,2404,1154,1250
Kentucky,Barren County,8,15,1773,790,983
Kentucky,Barren County,8,16,1266,549,717
Kentucky,Barren County,8,17,976,356,620
Kentucky,Barren County,8,18,895,261,634
Kentucky,Barren County,9,0,43763,21191,22572
Kentucky,Barren County,9,1,2810,1422,1388
Kentucky,Barren County,9,2,2798,1382,1416
Kentucky,Barren County,9,3,2912,1497,1415
Kentucky,Barren County,9,4,2684,1368,1316
Kentucky,Barren County,9,5,2595,1358,1237
Kentucky,Barren County,9,6,2666,1311,1355
Kentucky,Barren County,9,7,2573,1270,1303
Kentucky,Barren County,9,8,2640,1289,1351
Kentucky,Barren County,9,9,2740,1381,1359
Kentucky,Barren County,9,10,2821,1345,1476
Kentucky,Barren County,9,11,3123,1532,1591
Kentucky,Barren County,9,12,3168,1493,1675
Kentucky,Barren County,9,13,2763,1350,1413
Kentucky,Barren County,9,14,2506,1189,1317
Kentucky,Barren County,9,15,1763,804,959
Kentucky,Barren County,9,16,1347,584,763
Kentucky,Barren County,9,17,923,342,581
Kentucky,Barren County,9,18,931,274,657
Kentucky,Barren County,10,0,43746,21182,22564
Kentucky,Barren County,10,1,2852,1449,1403
Kentucky,Barren County,10,2,2772,1387,1385
Kentucky,Barren County,10,3,2967,1494,1473
Kentucky,Barren County,10,4,2659,1370,1289
Kentucky,Barren County,10,5,2468,1281,1187
Kentucky,Barren County,10,6,2739,1363,1376
Kentucky,Barren County,10,7,2551,1273,1278
Kentucky,Barren County,10,8,2648,1299,1349
Kentucky,Barren County,10,9,2620,1298,1322
Kentucky,Barren County,10,10,2832,1365,1467
Kentucky,Barren County,10,11,3014,1454,1560
Kentucky,Barren County,10,12,3180,1522,1658
Kentucky,Barren County,10,13,2826,1382,1444
Kentucky,Barren County,10,14,2471,1156,1315
Kentucky,Barren County,10,15,1893,874,1019
Kentucky,Barren County,10,16,1396,588,808
Kentucky,Barren County,10,17,936,364,572
Kentucky,Barren County,10,18,922,263,659
Kentucky,Barren County,11,0,44115,21357,22758
Kentucky,Barren County,11,1,2934,1500,1434
Kentucky,Barren County,11,2,2740,1391,1349
Kentucky,Barren County,11,3,2977,1491,1486
Kentucky,Barren County,11,4,2672,1360,1312
Kentucky,Barren County,11,5,2452,1251,1201
Kentucky,Barren County,11,6,2796,1419,1377
Kentucky,Barren County,11,7,2513,1238,1275
Kentucky,Barren County,11,8,2762,1375,1387
Kentucky,Barren County,11,9,2615,1269,1346
Kentucky,Barren County,11,10,2848,1404,1444
Kentucky,Barren County,11,11,2945,1418,1527
Kentucky,Barren County,11,12,3162,1512,1650
Kentucky,Barren County,11,13,2904,1399,1505
Kentucky,Barren County,11,14,2482,1170,1312
Kentucky,Barren County,11,15,1955,898,1057
Kentucky,Barren County,11,16,1460,614,846
Kentucky,Barren County,11,17,954,385,569
Kentucky,Barren County,11,18,944,263,681
Kentucky,Barren County,12,0,44249,21418,22831
Kentucky,Barren County,12,1,2882,1494,1388
Kentucky,Barren County,12,2,2822,1436,1386
Kentucky,Barren County,12,3,2986,1503,1483
Kentucky,Barren County,12,4,2610,1309,1301
Kentucky,Barren County,12,5,2463,1239,1224
Kentucky,Barren County,12,6,2859,1465,1394
Kentucky,Barren County,12,7,2472,1217,1255
Kentucky,Barren County,12,8,2826,1396,1430
Kentucky,Barren County,12,9,2573,1240,1333
Kentucky,Barren County,12,10,2821,1411,1410
Kentucky,Barren County,12,11,2846,1364,1482
Kentucky,Barren County,12,12,3128,1527,1601
Kentucky,Barren County,12,13,2992,1423,1569
Kentucky,Barren County,12,14,2477,1149,1328
Kentucky,Barren County,12,15,2055,945,1110
Kentucky,Barren County,12,16,1503,627,876
Kentucky,Barren County,12,17,964,387,577
Kentucky,Barren County,12,18,970,286,684
Kentucky,Bath County,1,0,11591,5751,5840
Kentucky,Bath County,1,1,820,420,400
Kentucky,Bath County,1,2,760,410,350
Kentucky,Bath County,1,3,801,403,398
Kentucky,Bath County,1,4,760,410,350
Kentucky,Bath County,1,5,577,288,289
Kentucky,Bath County,1,6,619,277,342
Kentucky,Bath County,1,7,694,343,351
Kentucky,Bath County,1,8,780,392,388
Kentucky,Bath County,1,9,796,389,407
Kentucky,Bath County,1,10,887,456,431
Kentucky,Bath County,1,11,850,434,416
Kentucky,Bath County,1,12,819,413,406
Kentucky,Bath County,1,13,722,350,372
Kentucky,Bath County,1,14,536,256,280
Kentucky,Bath County,1,15,467,226,241
Kentucky,Bath County,1,16,332,141,191
Kentucky,Bath County,1,17,196,82,114
Kentucky,Bath County,1,18,175,61,114
Kentucky,Bath County,2,0,11587,5748,5839
Kentucky,Bath County,2,1,820,420,400
Kentucky,Bath County,2,2,760,410,350
Kentucky,Bath County,2,3,799,401,398
Kentucky,Bath County,2,4,758,409,349
Kentucky,Bath County,2,5,577,288,289
Kentucky,Bath County,2,6,619,277,342
Kentucky,Bath County,2,7,694,343,351
Kentucky,Bath County,2,8,780,392,388
Kentucky,Bath County,2,9,796,389,407
Kentucky,Bath County,2,10,886,455,431
Kentucky,Bath County,2,11,851,435,416
Kentucky,Bath County,2,12,819,413,406
Kentucky,Bath County,2,13,722,350,372
Kentucky,Bath County,2,14,536,256,280
Kentucky,Bath County,2,15,467,226,241
Kentucky,Bath County,2,16,332,141,191
Kentucky,Bath County,2,17,196,82,114
Kentucky,Bath County,2,18,175,61,114
Kentucky,Bath County,3,0,11618,5764,5854
Kentucky,Bath County,3,1,813,417,396
Kentucky,Bath County,3,2,754,409,345
Kentucky,Bath County,3,3,809,406,403
Kentucky,Bath County,3,4,754,411,343
Kentucky,Bath County,3,5,585,286,299
Kentucky,Bath County,3,6,618,281,337
Kentucky,Bath County,3,7,691,339,352
Kentucky,Bath County,3,8,776,389,387
Kentucky,Bath County,3,9,793,387,406
Kentucky,Bath County,3,10,894,455,439
Kentucky,Bath County,3,11,857,442,415
Kentucky,Bath County,3,12,827,416,411
Kentucky,Bath County,3,13,727,350,377
Kentucky,Bath County,3,14,538,260,278
Kentucky,Bath County,3,15,469,227,242
Kentucky,Bath County,3,16,338,146,192
Kentucky,Bath County,3,17,200,83,117
Kentucky,Bath County,3,18,175,60,115
Kentucky,Bath County,4,0,11715,5788,5927
Kentucky,Bath County,4,1,808,419,389
Kentucky,Bath County,4,2,767,403,364
Kentucky,Bath County,4,3,835,417,418
Kentucky,Bath County,4,4,729,401,328
Kentucky,Bath County,4,5,618,288,330
Kentucky,Bath County,4,6,630,309,321
Kentucky,Bath County,4,7,709,333,376
Kentucky,Bath County,4,8,767,394,373
Kentucky,Bath County,4,9,781,381,400
Kentucky,Bath County,4,10,869,429,440
Kentucky,Bath County,4,11,860,447,413
Kentucky,Bath County,4,12,848,419,429
Kentucky,Bath County,4,13,750,355,395
Kentucky,Bath County,4,14,538,267,271
Kentucky,Bath County,4,15,469,227,242
Kentucky,Bath County,4,16,347,153,194
Kentucky,Bath County,4,17,216,85,131
Kentucky,Bath County,4,18,174,61,113
Kentucky,Bath County,5,0,11780,5847,5933
Kentucky,Bath County,5,1,767,419,348
Kentucky,Bath County,5,2,786,400,386
Kentucky,Bath County,5,3,856,442,414
Kentucky,Bath County,5,4,760,402,358
Kentucky,Bath County,5,5,662,323,339
Kentucky,Bath County,5,6,571,296,275
Kentucky,Bath County,5,7,684,305,379
Kentucky,Bath County,5,8,754,389,365
Kentucky,Bath County,5,9,822,400,422
Kentucky,Bath County,5,10,849,423,426
Kentucky,Bath County,5,11,838,431,407
Kentucky,Bath County,5,12,884,438,446
Kentucky,Bath County,5,13,742,364,378
Kentucky,Bath County,5,14,585,280,305
Kentucky,Bath County,5,15,453,218,235
Kentucky,Bath County,5,16,344,154,190
Kentucky,Bath County,5,17,247,101,146
Kentucky,Bath County,5,18,176,62,114
Kentucky,Bath County,6,0,11975,5914,6061
Kentucky,Bath County,6,1,794,418,376
Kentucky,Bath County,6,2,832,430,402
Kentucky,Bath County,6,3,864,458,406
Kentucky,Bath County,6,4,792,416,376
Kentucky,Bath County,6,5,667,320,347
Kentucky,Bath County,6,6,586,280,306
Kentucky,Bath County,6,7,704,317,387
Kentucky,Bath County,6,8,731,383,348
Kentucky,Bath County,6,9,800,381,419
Kentucky,Bath County,6,10,846,415,431
Kentucky,Bath County,6,11,857,441,416
Kentucky,Bath County,6,12,873,431,442
Kentucky,Bath County,6,13,768,388,380
Kentucky,Bath County,6,14,622,293,329
Kentucky,Bath County,6,15,449,211,238
Kentucky,Bath County,6,16,362,167,195
Kentucky,Bath County,6,17,240,101,139
Kentucky,Bath County,6,18,188,64,124
Kentucky,Bath County,7,0,12130,6007,6123
Kentucky,Bath County,7,1,791,427,364
Kentucky,Bath County,7,2,864,445,419
Kentucky,Bath County,7,3,887,470,417
Kentucky,Bath County,7,4,790,416,374
Kentucky,Bath County,7,5,690,331,359
Kentucky,Bath County,7,6,597,289,308
Kentucky,Bath County,7,7,665,289,376
Kentucky,Bath County,7,8,763,396,367
Kentucky,Bath County,7,9,813,396,417
Kentucky,Bath County,7,10,831,407,424
Kentucky,Bath County,7,11,885,452,433
Kentucky,Bath County,7,12,853,430,423
Kentucky,Bath County,7,13,788,393,395
Kentucky,Bath County,7,14,627,299,328
Kentucky,Bath County,7,15,470,220,250
Kentucky,Bath County,7,16,383,180,203
Kentucky,Bath County,7,17,236,95,141
Kentucky,Bath County,7,18,197,72,125
Kentucky,Bath County,8,0,12203,6068,6135
Kentucky,Bath County,8,1,800,430,370
Kentucky,Bath County,8,2,876,471,405
Kentucky,Bath County,8,3,867,460,407
Kentucky,Bath County,8,4,774,398,376
Kentucky,Bath County,8,5,711,361,350
Kentucky,Bath County,8,6,633,314,319
Kentucky,Bath County,8,7,653,290,363
Kentucky,Bath County,8,8,733,359,374
Kentucky,Bath County,8,9,824,415,409
Kentucky,Bath County,8,10,818,398,420
Kentucky,Bath County,8,11,914,467,447
Kentucky,Bath County,8,12,839,430,409
Kentucky,Bath County,8,13,800,395,405
Kentucky,Bath County,8,14,658,311,347
Kentucky,Bath County,8,15,452,209,243
Kentucky,Bath County,8,16,391,192,199
Kentucky,Bath County,8,17,257,98,159
Kentucky,Bath County,8,18,203,70,133
Kentucky,Bath County,9,0,12246,6079,6167
Kentucky,Bath County,9,1,843,433,410
Kentucky,Bath County,9,2,868,465,403
Kentucky,Bath County,9,3,865,452,413
Kentucky,Bath County,9,4,791,413,378
Kentucky,Bath County,9,5,697,358,339
Kentucky,Bath County,9,6,685,326,359
Kentucky,Bath County,9,7,638,298,340
Kentucky,Bath County,9,8,739,354,385
Kentucky,Bath County,9,9,780,414,366
Kentucky,Bath County,9,10,840,403,437
Kentucky,Bath County,9,11,851,413,438
Kentucky,Bath County,9,12,843,445,398
Kentucky,Bath County,9,13,812,402,410
Kentucky,Bath County,9,14,685,323,362
Kentucky,Bath County,9,15,455,218,237
Kentucky,Bath County,9,16,367,177,190
Kentucky,Bath County,9,17,269,112,157
Kentucky,Bath County,9,18,218,73,145
Kentucky,Bath County,10,0,12381,6152,6229
Kentucky,Bath County,10,1,884,452,432
Kentucky,Bath County,10,2,831,454,377
Kentucky,Bath County,10,3,901,463,438
Kentucky,Bath County,10,4,805,433,372
Kentucky,Bath County,10,5,709,368,341
Kentucky,Bath County,10,6,725,353,372
Kentucky,Bath County,10,7,604,279,325
Kentucky,Bath County,10,8,739,338,401
Kentucky,Bath County,10,9,763,407,356
Kentucky,Bath County,10,10,849,405,444
Kentucky,Bath County,10,11,864,431,433
Kentucky,Bath County,10,12,843,438,405
Kentucky,Bath County,10,13,826,404,422
Kentucky,Bath County,10,14,680,330,350
Kentucky,Bath County,10,15,503,235,268
Kentucky,Bath County,10,16,362,167,195
Kentucky,Bath County,10,17,258,108,150
Kentucky,Bath County,10,18,235,87,148
Kentucky,Bath County,11,0,12444,6141,6303
Kentucky,Bath County,11,1,883,454,429
Kentucky,Bath County,11,2,845,435,410
Kentucky,Bath County,11,3,914,467,447
Kentucky,Bath County,11,4,805,430,375
Kentucky,Bath County,11,5,708,361,347
Kentucky,Bath County,11,6,737,358,379
Kentucky,Bath County,11,7,598,271,327
Kentucky,Bath County,11,8,733,330,403
Kentucky,Bath County,11,9,768,408,360
Kentucky,Bath County,11,10,837,402,435
Kentucky,Bath County,11,11,862,426,436
Kentucky,Bath County,11,12,851,447,404
Kentucky,Bath County,11,13,810,383,427
Kentucky,Bath County,11,14,708,358,350
Kentucky,Bath County,11,15,527,248,279
Kentucky,Bath County,11,16,366,169,197
Kentucky,Bath County,11,17,257,107,150
Kentucky,Bath County,11,18,235,87,148
Kentucky,Bath County,12,0,12500,6177,6323
Kentucky,Bath County,12,1,901,464,437
Kentucky,Bath County,12,2,860,447,413
Kentucky,Bath County,12,3,902,465,437
Kentucky,Bath County,12,4,800,422,378
Kentucky,Bath County,12,5,696,345,351
Kentucky,Bath County,12,6,778,379,399
Kentucky,Bath County,12,7,610,301,309
Kentucky,Bath County,12,8,722,307,415
Kentucky,Bath County,12,9,731,399,332
Kentucky,Bath County,12,10,829,394,435
Kentucky,Bath County,12,11,864,422,442
Kentucky,Bath County,12,12,873,454,419
Kentucky,Bath County,12,13,810,404,406
Kentucky,Bath County,12,14,718,352,366
Kentucky,Bath County,12,15,535,257,278
Kentucky,Bath County,12,16,378,169,209
Kentucky,Bath County,12,17,263,109,154
Kentucky,Bath County,12,18,230,87,143
Kentucky,Bell County,1,0,28691,13937,14754
Kentucky,Bell County,1,1,1589,777,812
Kentucky,Bell County,1,2,1648,868,780
Kentucky,Bell County,1,3,1797,930,867
Kentucky,Bell County,1,4,1986,1027,959
Kentucky,Bell County,1,5,1764,883,881
Kentucky,Bell County,1,6,1617,827,790
Kentucky,Bell County,1,7,1717,854,863
Kentucky,Bell County,1,8,1837,916,921
Kentucky,Bell County,1,9,1967,916,1051
Kentucky,Bell County,1,10,2212,1128,1084
Kentucky,Bell County,1,11,2103,1045,1058
Kentucky,Bell County,1,12,1988,941,1047
Kentucky,Bell County,1,13,1958,953,1005
Kentucky,Bell County,1,14,1549,714,835
Kentucky,Bell County,1,15,1101,494,607
Kentucky,Bell County,1,16,761,314,447
Kentucky,Bell County,1,17,588,218,370
Kentucky,Bell County,1,18,509,132,377
Kentucky,Bell County,2,0,28691,13937,14754
Kentucky,Bell County,2,1,1589,777,812
Kentucky,Bell County,2,2,1648,868,780
Kentucky,Bell County,2,3,1797,930,867
Kentucky,Bell County,2,4,1986,1027,959
Kentucky,Bell County,2,5,1764,883,881
Kentucky,Bell County,2,6,1617,827,790
Kentucky,Bell County,2,7,1717,854,863
Kentucky,Bell County,2,8,1837,916,921
Kentucky,Bell County,2,9,1967,916,1051
Kentucky,Bell County,2,10,2212,1128,1084
Kentucky,Bell County,2,11,2103,1045,1058
Kentucky,Bell County,2,12,1988,941,1047
Kentucky,Bell County,2,13,1958,953,1005
Kentucky,Bell County,2,14,1549,714,835
Kentucky,Bell County,2,15,1101,494,607
Kentucky,Bell County,2,16,761,314,447
Kentucky,Bell County,2,17,588,218,370
Kentucky,Bell County,2,18,509,132,377
Kentucky,Bell County,3,0,28709,13955,14754
Kentucky,Bell County,3,1,1599,783,816
Kentucky,Bell County,3,2,1642,861,781
Kentucky,Bell County,3,3,1783,925,858
Kentucky,Bell County,3,4,1961,1016,945
Kentucky,Bell County,3,5,1805,910,895
Kentucky,Bell County,3,6,1626,826,800
Kentucky,Bell County,3,7,1709,851,858
Kentucky,Bell County,3,8,1829,921,908
Kentucky,Bell County,3,9,1970,922,1048
Kentucky,Bell County,3,10,2200,1120,1080
Kentucky,Bell County,3,11,2109,1040,1069
Kentucky,Bell County,3,12,1984,944,1040
Kentucky,Bell County,3,13,1971,958,1013
Kentucky,Bell County,3,14,1539,709,830
Kentucky,Bell County,3,15,1128,504,624
Kentucky,Bell County,3,16,759,317,442
Kentucky,Bell County,3,17,590,217,373
Kentucky,Bell County,3,18,505,131,374
Kentucky,Bell County,4,0,28658,13967,14691
Kentucky,Bell County,4,1,1657,817,840
Kentucky,Bell County,4,2,1639,833,806
Kentucky,Bell County,4,3,1767,929,838
Kentucky,Bell County,4,4,1880,985,895
Kentucky,Bell County,4,5,1897,978,919
Kentucky,Bell County,4,6,1654,821,833
Kentucky,Bell County,4,7,1663,832,831
Kentucky,Bell County,4,8,1772,903,869
Kentucky,Bell County,4,9,1954,927,1027
Kentucky,Bell County,4,10,2110,1071,1039
Kentucky,Bell County,4,11,2144,1044,1100
Kentucky,Bell County,4,12,1973,952,1021
Kentucky,Bell County,4,13,1986,964,1022
Kentucky,Bell County,4,14,1495,690,805
Kentucky,Bell County,4,15,1205,533,672
Kentucky,Bell County,4,16,770,337,433
Kentucky,Bell County,4,17,600,216,384
Kentucky,Bell County,4,18,492,135,357
Kentucky,Bell County,5,0,28284,13830,14454
Kentucky,Bell County,5,1,1645,837,808
Kentucky,Bell County,5,2,1662,821,841
Kentucky,Bell County,5,3,1727,897,830
Kentucky,Bell County,5,4,1744,939,805
Kentucky,Bell County,5,5,1865,974,891
Kentucky,Bell County,5,6,1626,819,807
Kentucky,Bell County,5,7,1631,831,800
Kentucky,Bell County,5,8,1747,855,892
Kentucky,Bell County,5,9,1907,940,967
Kentucky,Bell County,5,10,2035,1021,1014
Kentucky,Bell County,5,11,2086,1025,1061
Kentucky,Bell County,5,12,1984,949,1035
Kentucky,Bell County,5,13,1913,937,976
Kentucky,Bell County,5,14,1574,727,847
Kentucky,Bell County,5,15,1255,572,683
Kentucky,Bell County,5,16,796,339,457
Kentucky,Bell County,5,17,581,204,377
Kentucky,Bell County,5,18,506,143,363
Kentucky,Bell County,6,0,28031,13698,14333
Kentucky,Bell County,6,1,1666,874,792
Kentucky,Bell County,6,2,1633,790,843
Kentucky,Bell County,6,3,1691,901,790
Kentucky,Bell County,6,4,1695,895,800
Kentucky,Bell County,6,5,1837,963,874
Kentucky,Bell County,6,6,1653,807,846
Kentucky,Bell County,6,7,1625,833,792
Kentucky,Bell County,6,8,1668,802,866
Kentucky,Bell County,6,9,1884,957,927
Kentucky,Bell County,6,10,1942,934,1008
Kentucky,Bell County,6,11,2086,1031,1055
Kentucky,Bell County,6,12,1977,955,1022
Kentucky,Bell County,6,13,1894,920,974
Kentucky,Bell County,6,14,1588,741,847
Kentucky,Bell County,6,15,1288,582,706
Kentucky,Bell County,6,16,806,353,453
Kentucky,Bell County,6,17,576,209,367
Kentucky,Bell County,6,18,522,151,371
Kentucky,Bell County,7,0,27826,13587,14239
Kentucky,Bell County,7,1,1675,878,797
Kentucky,Bell County,7,2,1599,789,810
Kentucky,Bell County,7,3,1629,854,775
Kentucky,Bell County,7,4,1645,862,783
Kentucky,Bell County,7,5,1849,952,897
Kentucky,Bell County,7,6,1637,798,839
Kentucky,Bell County,7,7,1600,840,760
Kentucky,Bell County,7,8,1660,806,854
Kentucky,Bell County,7,9,1878,952,926
Kentucky,Bell County,7,10,1869,904,965
Kentucky,Bell County,7,11,2077,1029,1048
Kentucky,Bell County,7,12,1977,961,1016
Kentucky,Bell County,7,13,1846,878,968
Kentucky,Bell County,7,14,1675,779,896
Kentucky,Bell County,7,15,1275,574,701
Kentucky,Bell County,7,16,827,360,467
Kentucky,Bell County,7,17,574,200,374
Kentucky,Bell County,7,18,534,171,363
Kentucky,Bell County,8,0,27370,13404,13966
Kentucky,Bell County,8,1,1650,860,790
Kentucky,Bell County,8,2,1532,761,771
Kentucky,Bell County,8,3,1585,843,742
Kentucky,Bell County,8,4,1602,849,753
Kentucky,Bell County,8,5,1757,914,843
Kentucky,Bell County,8,6,1665,816,849
Kentucky,Bell County,8,7,1580,828,752
Kentucky,Bell County,8,8,1599,779,820
Kentucky,Bell County,8,9,1771,895,876
Kentucky,Bell County,8,10,1850,876,974
Kentucky,Bell County,8,11,2030,1021,1009
Kentucky,Bell County,8,12,1983,972,1011
Kentucky,Bell County,8,13,1836,870,966
Kentucky,Bell County,8,14,1716,805,911
Kentucky,Bell County,8,15,1273,573,700
Kentucky,Bell County,8,16,836,367,469
Kentucky,Bell County,8,17,543,197,346
Kentucky,Bell County,8,18,562,178,384
Kentucky,Bell County,9,0,27204,13310,13894
Kentucky,Bell County,9,1,1679,861,818
Kentucky,Bell County,9,2,1518,762,756
Kentucky,Bell County,9,3,1553,785,768
Kentucky,Bell County,9,4,1595,852,743
Kentucky,Bell County,9,5,1660,860,800
Kentucky,Bell County,9,6,1764,895,869
Kentucky,Bell County,9,7,1560,791,769
Kentucky,Bell County,9,8,1556,787,769
Kentucky,Bell County,9,9,1673,835,838
Kentucky,Bell County,9,10,1839,882,957
Kentucky,Bell County,9,11,1948,975,973
Kentucky,Bell County,9,12,2036,979,1057
Kentucky,Bell County,9,13,1840,874,966
Kentucky,Bell County,9,14,1747,845,902
Kentucky,Bell County,9,15,1252,554,698
Kentucky,Bell County,9,16,886,389,497
Kentucky,Bell County,9,17,547,213,334
Kentucky,Bell County,9,18,551,171,380
Kentucky,Bell County,10,0,26863,13148,13715
Kentucky,Bell County,10,1,1620,801,819
Kentucky,Bell County,10,2,1472,772,700
Kentucky,Bell County,10,3,1603,785,818
Kentucky,Bell County,10,4,1547,815,732
Kentucky,Bell County,10,5,1609,856,753
Kentucky,Bell County,10,6,1820,908,912
Kentucky,Bell County,10,7,1528,790,738
Kentucky,Bell County,10,8,1505,766,739
Kentucky,Bell County,10,9,1632,789,843
Kentucky,Bell County,10,10,1783,885,898
Kentucky,Bell County,10,11,1867,917,950
Kentucky,Bell County,10,12,1987,966,1021
Kentucky,Bell County,10,13,1847,881,966
Kentucky,Bell County,10,14,1693,828,865
Kentucky,Bell County,10,15,1320,580,740
Kentucky,Bell County,10,16,911,417,494
Kentucky,Bell County,10,17,557,215,342
Kentucky,Bell County,10,18,562,177,385
Kentucky,Bell County,11,0,26487,12989,13498
Kentucky,Bell County,11,1,1547,768,779
Kentucky,Bell County,11,2,1532,799,733
Kentucky,Bell County,11,3,1568,774,794
Kentucky,Bell County,11,4,1515,822,693
Kentucky,Bell County,11,5,1568,845,723
Kentucky,Bell County,11,6,1761,877,884
Kentucky,Bell County,11,7,1520,793,727
Kentucky,Bell County,11,8,1477,749,728
Kentucky,Bell County,11,9,1568,762,806
Kentucky,Bell County,11,10,1774,897,877
Kentucky,Bell County,11,11,1811,848,963
Kentucky,Bell County,11,12,1934,955,979
Kentucky,Bell County,11,13,1830,875,955
Kentucky,Bell County,11,14,1666,809,857
Kentucky,Bell County,11,15,1346,589,757
Kentucky,Bell County,11,16,950,427,523
Kentucky,Bell County,11,17,557,220,337
Kentucky,Bell County,11,18,563,180,383
Kentucky,Bell County,12,0,26032,12745,13287
Kentucky,Bell County,12,1,1530,761,769
Kentucky,Bell County,12,2,1493,786,707
Kentucky,Bell County,12,3,1493,740,753
Kentucky,Bell County,12,4,1517,824,693
Kentucky,Bell County,12,5,1543,820,723
Kentucky,Bell County,12,6,1738,872,866
Kentucky,Bell County,12,7,1499,776,723
Kentucky,Bell County,12,8,1418,711,707
Kentucky,Bell County,12,9,1515,744,771
Kentucky,Bell County,12,10,1720,857,863
Kentucky,Bell County,12,11,1725,820,905
Kentucky,Bell County,12,12,1898,936,962
Kentucky,Bell County,12,13,1809,869,940
Kentucky,Bell County,12,14,1635,768,867
Kentucky,Bell County,12,15,1417,629,788
Kentucky,Bell County,12,16,952,429,523
Kentucky,Bell County,12,17,577,227,350
Kentucky,Bell County,12,18,553,176,377
Kentucky,Boone County,1,0,118811,58782,60029
Kentucky,Boone County,1,1,9019,4509,4510
Kentucky,Boone County,1,2,9906,5047,4859
Kentucky,Boone County,1,3,9392,4844,4548
Kentucky,Boone County,1,4,7927,4166,3761
Kentucky,Boone County,1,5,6281,3147,3134
Kentucky,Boone County,1,6,7488,3716,3772
Kentucky,Boone County,1,7,8215,4008,4207
Kentucky,Boone County,1,8,9164,4542,4622
Kentucky,Boone County,1,9,9194,4658,4536
Kentucky,Boone County,1,10,9270,4620,4650
Kentucky,Boone County,1,11,8509,4193,4316
Kentucky,Boone County,1,12,7177,3487,3690
Kentucky,Boone County,1,13,5956,2847,3109
Kentucky,Boone County,1,14,4018,1942,2076
Kentucky,Boone County,1,15,2788,1269,1519
Kentucky,Boone County,1,16,2014,886,1128
Kentucky,Boone County,1,17,1427,552,875
Kentucky,Boone County,1,18,1066,349,717
Kentucky,Boone County,2,0,118810,58781,60029
Kentucky,Boone County,2,1,9022,4511,4511
Kentucky,Boone County,2,2,9907,5048,4859
Kentucky,Boone County,2,3,9392,4844,4548
Kentucky,Boone County,2,4,7926,4165,3761
Kentucky,Boone County,2,5,6282,3148,3134
Kentucky,Boone County,2,6,7489,3717,3772
Kentucky,Boone County,2,7,8218,4009,4209
Kentucky,Boone County,2,8,9164,4542,4622
Kentucky,Boone County,2,9,9195,4659,4536
Kentucky,Boone County,2,10,9267,4617,4650
Kentucky,Boone County,2,11,8508,4192,4316
Kentucky,Boone County,2,12,7176,3487,3689
Kentucky,Boone County,2,13,5956,2847,3109
Kentucky,Boone County,2,14,4017,1941,2076
Kentucky,Boone County,2,15,2786,1268,1518
Kentucky,Boone County,2,16,2013,886,1127
Kentucky,Boone County,2,17,1426,551,875
Kentucky,Boone County,2,18,1066,349,717
Kentucky,Boone County,3,0,119373,59089,60284
Kentucky,Boone County,3,1,9026,4515,4511
Kentucky,Boone County,3,2,9913,5061,4852
Kentucky,Boone County,3,3,9440,4885,4555
Kentucky,Boone County,3,4,7992,4189,3803
Kentucky,Boone County,3,5,6309,3181,3128
Kentucky,Boone County,3,6,7489,3712,3777
Kentucky,Boone County,3,7,8276,4033,4243
Kentucky,Boone County,3,8,9077,4502,4575
Kentucky,Boone County,3,9,9260,4693,4567
Kentucky,Boone County,3,10,9270,4631,4639
Kentucky,Boone County,3,11,8579,4229,4350
Kentucky,Boone County,3,12,7230,3518,3712
Kentucky,Boone County,3,13,6050,2882,3168
Kentucky,Boone County,3,14,4074,1968,2106
Kentucky,Boone County,3,15,2824,1285,1539
Kentucky,Boone County,3,16,2022,887,1135
Kentucky,Boone County,3,17,1454,564,890
Kentucky,Boone County,3,18,1088,354,734
Kentucky,Boone County,4,0,121710,60250,61460
Kentucky,Boone County,4,1,9094,4540,4554
Kentucky,Boone County,4,2,9986,5085,4901
Kentucky,Boone County,4,3,9734,5056,4678
Kentucky,Boone County,4,4,8135,4251,3884
Kentucky,Boone County,4,5,6528,3338,3190
Kentucky,Boone County,4,6,7510,3712,3798
Kentucky,Boone County,4,7,8475,4117,4358
Kentucky,Boone County,4,8,8775,4293,4482
Kentucky,Boone County,4,9,9540,4825,4715
Kentucky,Boone County,4,10,9299,4680,4619
Kentucky,Boone County,4,11,8826,4339,4487
Kentucky,Boone County,4,12,7415,3658,3757
Kentucky,Boone County,4,13,6412,3051,3361
Kentucky,Boone County,4,14,4283,2065,2218
Kentucky,Boone County,4,15,2991,1376,1615
Kentucky,Boone County,4,16,2026,886,1140
Kentucky,Boone County,4,17,1521,596,925
Kentucky,Boone County,4,18,1160,382,778
Kentucky,Boone County,5,0,123412,61077,62335
Kentucky,Boone County,5,1,8952,4490,4462
Kentucky,Boone County,5,2,9922,5052,4870
Kentucky,Boone County,5,3,9967,5126,4841
Kentucky,Boone County,5,4,8244,4294,3950
Kentucky,Boone County,5,5,6837,3497,3340
Kentucky,Boone County,5,6,7414,3707,3707
Kentucky,Boone County,5,7,8454,4112,4342
Kentucky,Boone County,5,8,8602,4200,4402
Kentucky,Boone County,5,9,9631,4878,4753
Kentucky,Boone County,5,10,9382,4722,4660
Kentucky,Boone County,5,11,8928,4364,4564
Kentucky,Boone County,5,12,7711,3807,3904
Kentucky,Boone County,5,13,6391,3062,3329
Kentucky,Boone County,5,14,4795,2293,2502
Kentucky,Boone County,5,15,3259,1508,1751
Kentucky,Boone County,5,16,2092,915,1177
Kentucky,Boone County,5,17,1563,624,939
Kentucky,Boone County,5,18,1268,426,842
Kentucky,Boone County,6,0,125022,61887,63135
Kentucky,Boone County,6,1,8962,4532,4430
Kentucky,Boone County,6,2,9818,4993,4825
Kentucky,Boone County,6,3,10088,5133,4955
Kentucky,Boone County,6,4,8319,4344,3975
Kentucky,Boone County,6,5,7044,3611,3433
Kentucky,Boone County,6,6,7355,3691,3664
Kentucky,Boone County,6,7,8465,4134,4331
Kentucky,Boone County,6,8,8562,4195,4367
Kentucky,Boone County,6,9,9627,4893,4734
Kentucky,Boone County,6,10,9362,4662,4700
Kentucky,Boone County,6,11,8983,4438,4545
Kentucky,Boone County,6,12,8042,3978,4064
Kentucky,Boone County,6,13,6598,3157,3441
Kentucky,Boone County,6,14,5125,2444,2681
Kentucky,Boone County,6,15,3496,1627,1869
Kentucky,Boone County,6,16,2219,967,1252
Kentucky,Boone County,6,17,1569,631,938
Kentucky,Boone County,6,18,1388,457,931
Kentucky,Boone County,7,0,126677,62604,64073
Kentucky,Boone County,7,1,8898,4444,4454
Kentucky,Boone County,7,2,9635,4882,4753
Kentucky,Boone County,7,3,10165,5191,4974
Kentucky,Boone County,7,4,8559,4485,4074
Kentucky,Boone County,7,5,7178,3651,3527
Kentucky,Boone County,7,6,7443,3688,3755
Kentucky,Boone County,7,7,8486,4171,4315
Kentucky,Boone County,7,8,8695,4244,4451
Kentucky,Boone County,7,9,9415,4793,4622
Kentucky,Boone County,7,10,9335,4645,4690
Kentucky,Boone County,7,11,9171,4532,4639
Kentucky,Boone County,7,12,8236,4095,4141
Kentucky,Boone County,7,13,6796,3250,3546
Kentucky,Boone County,7,14,5558,2647,2911
Kentucky,Boone County,7,15,3619,1675,1944
Kentucky,Boone County,7,16,2405,1068,1337
Kentucky,Boone County,7,17,1603,661,942
Kentucky,Boone County,7,18,1480,482,998
Kentucky,Boone County,8,0,128161,63254,64907
Kentucky,Boone County,8,1,8829,4417,4412
Kentucky,Boone County,8,2,9688,4868,4820
Kentucky,Boone County,8,3,10244,5186,5058
Kentucky,Boone County,8,4,8717,4551,4166
Kentucky,Boone County,8,5,7308,3753,3555
Kentucky,Boone County,8,6,7629,3789,3840
Kentucky,Boone County,8,7,8258,4091,4167
Kentucky,Boone County,8,8,8780,4284,4496
Kentucky,Boone County,8,9,9236,4619,4617
Kentucky,Boone County,8,10,9344,4705,4639
Kentucky,Boone County,8,11,9239,4602,4637
Kentucky,Boone County,8,12,8465,4161,4304
Kentucky,Boone County,8,13,7011,3363,3648
Kentucky,Boone County,8,14,5852,2757,3095
Kentucky,Boone County,8,15,3843,1807,2036
Kentucky,Boone County,8,16,2520,1125,1395
Kentucky,Boone County,8,17,1623,656,967
Kentucky,Boone County,8,18,1575,520,1055
Kentucky,Boone County,9,0,129503,64080,65423
Kentucky,Boone County,9,1,8743,4385,4358
Kentucky,Boone County,9,2,9546,4811,4735
Kentucky,Boone County,9,3,10262,5234,5028
Kentucky,Boone County,9,4,8958,4690,4268
Kentucky,Boone County,9,5,7363,3795,3568
Kentucky,Boone County,9,6,7746,3867,3879
Kentucky,Boone County,9,7,8123,4069,4054
Kentucky,Boone County,9,8,9091,4406,4685
Kentucky,Boone County,9,9,8835,4397,4438
Kentucky,Boone County,9,10,9557,4817,4740
Kentucky,Boone County,9,11,9234,4645,4589
Kentucky,Boone County,9,12,8708,4296,4412
Kentucky,Boone County,9,13,7165,3461,3704
Kentucky,Boone County,9,14,6203,2887,3316
Kentucky,Boone County,9,15,4040,1905,2135
Kentucky,Boone County,9,16,2671,1202,1469
Kentucky,Boone County,9,17,1639,660,979
Kentucky,Boone County,9,18,1619,553,1066
Kentucky,Boone County,10,0,130952,64769,66183
Kentucky,Boone County,10,1,8743,4443,4300
Kentucky,Boone County,10,2,9519,4804,4715
Kentucky,Boone County,10,3,10280,5284,4996
Kentucky,Boone County,10,4,9058,4613,4445
Kentucky,Boone County,10,5,7471,3879,3592
Kentucky,Boone County,10,6,7913,3928,3985
Kentucky,Boone County,10,7,8298,4195,4103
Kentucky,Boone County,10,8,9037,4404,4633
Kentucky,Boone County,10,9,8672,4279,4393
Kentucky,Boone County,10,10,9557,4817,4740
Kentucky,Boone County,10,11,9236,4617,4619
Kentucky,Boone County,10,12,8692,4263,4429
Kentucky,Boone County,10,13,7466,3616,3850
Kentucky,Boone County,10,14,6189,2907,3282
Kentucky,Boone County,10,15,4515,2092,2423
Kentucky,Boone County,10,16,2947,1359,1588
Kentucky,Boone County,10,17,1686,692,994
Kentucky,Boone County,10,18,1673,577,1096
Kentucky,Boone County,11,0,131901,65338,66563
Kentucky,Boone County,11,1,8612,4391,4221
Kentucky,Boone County,11,2,9464,4837,4627
Kentucky,Boone County,11,3,10195,5212,4983
Kentucky,Boone County,11,4,9202,4722,4480
Kentucky,Boone County,11,5,7531,3894,3637
Kentucky,Boone County,11,6,8040,4099,3941
Kentucky,Boone County,11,7,8161,4084,4077
Kentucky,Boone County,11,8,9144,4487,4657
Kentucky,Boone County,11,9,8717,4300,4417
Kentucky,Boone County,11,10,9404,4726,4678
Kentucky,Boone County,11,11,9125,4536,4589
Kentucky,Boone County,11,12,8766,4302,4464
Kentucky,Boone County,11,13,7652,3738,3914
Kentucky,Boone County,11,14,6314,2920,3394
Kentucky,Boone County,11,15,4856,2283,2573
Kentucky,Boone County,11,16,3179,1451,1728
Kentucky,Boone County,11,17,1804,746,1058
Kentucky,Boone County,11,18,1735,610,1125
Kentucky,Boone County,12,0,133581,66161,67420
Kentucky,Boone County,12,1,8649,4411,4238
Kentucky,Boone County,12,2,9545,4871,4674
Kentucky,Boone County,12,3,10086,5127,4959
Kentucky,Boone County,12,4,9363,4829,4534
Kentucky,Boone County,12,5,7645,3925,3720
Kentucky,Boone County,12,6,8025,4154,3871
Kentucky,Boone County,12,7,8292,4108,4184
Kentucky,Boone County,12,8,9196,4572,4624
Kentucky,Boone County,12,9,8904,4373,4531
Kentucky,Boone County,12,10,9308,4690,4618
Kentucky,Boone County,12,11,8997,4448,4549
Kentucky,Boone County,12,12,8919,4362,4557
Kentucky,Boone County,12,13,7849,3854,3995
Kentucky,Boone County,12,14,6471,2995,3476
Kentucky,Boone County,12,15,5254,2444,2810
Kentucky,Boone County,12,16,3333,1516,1817
Kentucky,Boone County,12,17,1962,856,1106
Kentucky,Boone County,12,18,1783,626,1157
Kentucky,Bourbon County,1,0,19985,9742,10243
Kentucky,Bourbon County,1,1,1239,601,638
Kentucky,Bourbon County,1,2,1300,663,637
Kentucky,Bourbon County,1,3,1394,729,665
Kentucky,Bourbon County,1,4,1334,728,606
Kentucky,Bourbon County,1,5,1033,540,493
Kentucky,Bourbon County,1,6,1043,524,519
Kentucky,Bourbon County,1,7,1114,560,554
Kentucky,Bourbon County,1,8,1336,640,696
Kentucky,Bourbon County,1,9,1399,670,729
Kentucky,Bourbon County,1,10,1584,774,810
Kentucky,Bourbon County,1,11,1504,740,764
Kentucky,Bourbon County,1,12,1361,650,711
Kentucky,Bourbon County,1,13,1295,626,669
Kentucky,Bourbon County,1,14,975,467,508
Kentucky,Bourbon County,1,15,738,328,410
Kentucky,Bourbon County,1,16,583,244,339
Kentucky,Bourbon County,1,17,379,147,232
Kentucky,Bourbon County,1,18,374,111,263
Kentucky,Bourbon County,2,0,20008,9757,10251
Kentucky,Bourbon County,2,1,1240,603,637
Kentucky,Bourbon County,2,2,1303,666,637
Kentucky,Bourbon County,2,3,1396,730,666
Kentucky,Bourbon County,2,4,1335,728,607
Kentucky,Bourbon County,2,5,1037,542,495
Kentucky,Bourbon County,2,6,1044,524,520
Kentucky,Bourbon County,2,7,1115,560,555
Kentucky,Bourbon County,2,8,1338,642,696
Kentucky,Bourbon County,2,9,1398,670,728
Kentucky,Bourbon County,2,10,1589,775,814
Kentucky,Bourbon County,2,11,1505,741,764
Kentucky,Bourbon County,2,12,1365,653,712
Kentucky,Bourbon County,2,13,1295,626,669
Kentucky,Bourbon County,2,14,976,467,509
Kentucky,Bourbon County,2,15,736,328,408
Kentucky,Bourbon County,2,16,583,244,339
Kentucky,Bourbon County,2,17,379,147,232
Kentucky,Bourbon County,2,18,374,111,263
Kentucky,Bourbon County,3,0,19965,9727,10238
Kentucky,Bourbon County,3,1,1224,596,628
Kentucky,Bourbon County,3,2,1300,665,635
Kentucky,Bourbon County,3,3,1395,730,665
Kentucky,Bourbon County,3,4,1332,727,605
Kentucky,Bourbon County,3,5,1040,542,498
Kentucky,Bourbon County,3,6,1049,527,522
Kentucky,Bourbon County,3,7,1119,559,560
Kentucky,Bourbon County,3,8,1325,636,689
Kentucky,Bourbon County,3,9,1393,667,726
Kentucky,Bourbon County,3,10,1583,767,816
Kentucky,Bourbon County,3,11,1502,743,759
Kentucky,Bourbon County,3,12,1363,646,717
Kentucky,Bourbon County,3,13,1298,623,675
Kentucky,Bourbon County,3,14,971,468,503
Kentucky,Bourbon County,3,15,743,331,412
Kentucky,Bourbon County,3,16,578,242,336
Kentucky,Bourbon County,3,17,374,145,229
Kentucky,Bourbon County,3,18,376,113,263
Kentucky,Bourbon County,4,0,20051,9786,10265
Kentucky,Bourbon County,4,1,1208,606,602
Kentucky,Bourbon County,4,2,1313,653,660
Kentucky,Bourbon County,4,3,1385,732,653
Kentucky,Bourbon County,4,4,1337,726,611
Kentucky,Bourbon County,4,5,1108,564,544
Kentucky,Bourbon County,4,6,1035,537,498
Kentucky,Bourbon County,4,7,1084,523,561
Kentucky,Bourbon County,4,8,1293,629,664
Kentucky,Bourbon County,4,9,1399,672,727
Kentucky,Bourbon County,4,10,1550,748,802
Kentucky,Bourbon County,4,11,1521,765,756
Kentucky,Bourbon County,4,12,1392,645,747
Kentucky,Bourbon County,4,13,1351,652,699
Kentucky,Bourbon County,4,14,964,483,481
Kentucky,Bourbon County,4,15,765,338,427
Kentucky,Bourbon County,4,16,586,240,346
Kentucky,Bourbon County,4,17,366,149,217
Kentucky,Bourbon County,4,18,394,124,270
Kentucky,Bourbon County,5,0,20050,9787,10263
Kentucky,Bourbon County,5,1,1227,645,582
Kentucky,Bourbon County,5,2,1302,650,652
Kentucky,Bourbon County,5,3,1322,687,635
Kentucky,Bourbon County,5,4,1308,706,602
Kentucky,Bourbon County,5,5,1125,566,559
Kentucky,Bourbon County,5,6,1068,553,515
Kentucky,Bourbon County,5,7,1077,520,557
Kentucky,Bourbon County,5,8,1261,617,644
Kentucky,Bourbon County,5,9,1395,659,736
Kentucky,Bourbon County,5,10,1484,708,776
Kentucky,Bourbon County,5,11,1560,781,779
Kentucky,Bourbon County,5,12,1398,658,740
Kentucky,Bourbon County,5,13,1292,622,670
Kentucky,Bourbon County,5,14,1041,513,528
Kentucky,Bourbon County,5,15,814,373,441
Kentucky,Bourbon County,5,16,577,237,340
Kentucky,Bourbon County,5,17,408,171,237
Kentucky,Bourbon County,5,18,391,121,270
Kentucky,Bourbon County,6,0,20026,9792,10234
Kentucky,Bourbon County,6,1,1193,642,551
Kentucky,Bourbon County,6,2,1284,634,650
Kentucky,Bourbon County,6,3,1317,679,638
Kentucky,Bourbon County,6,4,1306,698,608
Kentucky,Bourbon County,6,5,1181,617,564
Kentucky,Bourbon County,6,6,1049,527,522
Kentucky,Bourbon County,6,7,1071,520,551
Kentucky,Bourbon County,6,8,1210,599,611
Kentucky,Bourbon County,6,9,1409,664,745
Kentucky,Bourbon County,6,10,1400,670,730
Kentucky,Bourbon County,6,11,1570,792,778
Kentucky,Bourbon County,6,12,1426,676,750
Kentucky,Bourbon County,6,13,1272,607,665
Kentucky,Bourbon County,6,14,1068,520,548
Kentucky,Bourbon County,6,15,865,396,469
Kentucky,Bourbon County,6,16,591,248,343
Kentucky,Bourbon County,6,17,427,182,245
Kentucky,Bourbon County,6,18,387,121,266
Kentucky,Bourbon County,7,0,20055,9778,10277
Kentucky,Bourbon County,7,1,1172,606,566
Kentucky,Bourbon County,7,2,1264,629,635
Kentucky,Bourbon County,7,3,1313,660,653
Kentucky,Bourbon County,7,4,1259,666,593
Kentucky,Bourbon County,7,5,1218,655,563
Kentucky,Bourbon County,7,6,1047,521,526
Kentucky,Bourbon County,7,7,1087,537,550
Kentucky,Bourbon County,7,8,1174,594,580
Kentucky,Bourbon County,7,9,1381,649,732
Kentucky,Bourbon County,7,10,1366,652,714
Kentucky,Bourbon County,7,11,1566,776,790
Kentucky,Bourbon County,7,12,1441,695,746
Kentucky,Bourbon County,7,13,1294,611,683
Kentucky,Bourbon County,7,14,1146,560,586
Kentucky,Bourbon County,7,15,876,396,480
Kentucky,Bourbon County,7,16,606,259,347
Kentucky,Bourbon County,7,17,441,178,263
Kentucky,Bourbon County,7,18,404,134,270
Kentucky,Bourbon County,8,0,20166,9835,10331
Kentucky,Bourbon County,8,1,1194,646,548
Kentucky,Bourbon County,8,2,1282,635,647
Kentucky,Bourbon County,8,3,1299,659,640
Kentucky,Bourbon County,8,4,1242,658,584
Kentucky,Bourbon County,8,5,1236,684,552
Kentucky,Bourbon County,8,6,1146,548,598
Kentucky,Bourbon County,8,7,1052,530,522
Kentucky,Bourbon County,8,8,1136,545,591
Kentucky,Bourbon County,8,9,1367,637,730
Kentucky,Bourbon County,8,10,1344,643,701
Kentucky,Bourbon County,8,11,1540,758,782
Kentucky,Bourbon County,8,12,1436,701,735
Kentucky,Bourbon County,8,13,1312,613,699
Kentucky,Bourbon County,8,14,1195,566,629
Kentucky,Bourbon County,8,15,875,412,463
Kentucky,Bourbon County,8,16,641,272,369
Kentucky,Bourbon County,8,17,453,186,267
Kentucky,Bourbon County,8,18,416,142,274
Kentucky,Bourbon County,9,0,20130,9808,10322
Kentucky,Bourbon County,9,1,1191,637,554
Kentucky,Bourbon County,9,2,1260,632,628
Kentucky,Bourbon County,9,3,1304,646,658
Kentucky,Bourbon County,9,4,1230,649,581
Kentucky,Bourbon County,9,5,1197,662,535
Kentucky,Bourbon County,9,6,1167,576,591
Kentucky,Bourbon County,9,7,1072,532,540
Kentucky,Bourbon County,9,8,1129,542,587
Kentucky,Bourbon County,9,9,1272,607,665
Kentucky,Bourbon County,9,10,1359,651,708
Kentucky,Bourbon County,9,11,1525,726,799
Kentucky,Bourbon County,9,12,1417,714,703
Kentucky,Bourbon County,9,13,1345,627,718
Kentucky,Bourbon County,9,14,1231,575,656
Kentucky,Bourbon County,9,15,868,425,443
Kentucky,Bourbon County,9,16,667,277,390
Kentucky,Bourbon County,9,17,475,186,289
Kentucky,Bourbon County,9,18,421,144,277
Kentucky,Bourbon County,10,0,20092,9795,10297
Kentucky,Bourbon County,10,1,1145,593,552
Kentucky,Bourbon County,10,2,1302,682,620
Kentucky,Bourbon County,10,3,1315,661,654
Kentucky,Bourbon County,10,4,1208,625,583
Kentucky,Bourbon County,10,5,1171,627,544
Kentucky,Bourbon County,10,6,1179,589,590
Kentucky,Bourbon County,10,7,1074,546,528
Kentucky,Bourbon County,10,8,1128,539,589
Kentucky,Bourbon County,10,9,1239,584,655
Kentucky,Bourbon County,10,10,1378,654,724
Kentucky,Bourbon County,10,11,1437,687,750
Kentucky,Bourbon County,10,12,1454,734,720
Kentucky,Bourbon County,10,13,1319,620,699
Kentucky,Bourbon County,10,14,1182,556,626
Kentucky,Bourbon County,10,15,942,460,482
Kentucky,Bourbon County,10,16,684,293,391
Kentucky,Bourbon County,10,17,475,180,295
Kentucky,Bourbon County,10,18,460,165,295
Kentucky,Bourbon County,11,0,20116,9798,10318
Kentucky,Bourbon County,11,1,1176,605,571
Kentucky,Bourbon County,11,2,1268,671,597
Kentucky,Bourbon County,11,3,1335,672,663
Kentucky,Bourbon County,11,4,1210,625,585
Kentucky,Bourbon County,11,5,1151,627,524
Kentucky,Bourbon County,11,6,1279,642,637
Kentucky,Bourbon County,11,7,1016,490,526
Kentucky,Bourbon County,11,8,1086,527,559
Kentucky,Bourbon County,11,9,1220,582,638
Kentucky,Bourbon County,11,10,1384,636,748
Kentucky,Bourbon County,11,11,1348,652,696
Kentucky,Bourbon County,11,12,1490,748,742
Kentucky,Bourbon County,11,13,1343,640,703
Kentucky,Bourbon County,11,14,1169,545,624
Kentucky,Bourbon County,11,15,954,459,495
Kentucky,Bourbon County,11,16,730,316,414
Kentucky,Bourbon County,11,17,471,182,289
Kentucky,Bourbon County,11,18,486,179,307
Kentucky,Bourbon County,12,0,19788,9672,10116
Kentucky,Bourbon County,12,1,1142,596,546
Kentucky,Bourbon County,12,2,1219,661,558
Kentucky,Bourbon County,12,3,1309,654,655
Kentucky,Bourbon County,12,4,1197,622,575
Kentucky,Bourbon County,12,5,1115,589,526
Kentucky,Bourbon County,12,6,1208,617,591
Kentucky,Bourbon County,12,7,1066,519,547
Kentucky,Bourbon County,12,8,1066,534,532
Kentucky,Bourbon County,12,9,1146,560,586
Kentucky,Bourbon County,12,10,1313,593,720
Kentucky,Bourbon County,12,11,1298,621,677
Kentucky,Bourbon County,12,12,1473,724,749
Kentucky,Bourbon County,12,13,1339,648,691
Kentucky,Bourbon County,12,14,1150,541,609
Kentucky,Bourbon County,12,15,1027,489,538
Kentucky,Bourbon County,12,16,720,316,404
Kentucky,Bourbon County,12,17,492,195,297
Kentucky,Bourbon County,12,18,508,193,315
Kentucky,Boyd County,1,0,49542,24622,24920
Kentucky,Boyd County,1,1,2906,1484,1422
Kentucky,Boyd County,1,2,2909,1534,1375
Kentucky,Boyd County,1,3,2911,1440,1471
Kentucky,Boyd County,1,4,3003,1565,1438
Kentucky,Boyd County,1,5,2489,1253,1236
Kentucky,Boyd County,1,6,3026,1561,1465
Kentucky,Boyd County,1,7,3085,1664,1421
Kentucky,Boyd County,1,8,3234,1731,1503
Kentucky,Boyd County,1,9,3410,1808,1602
Kentucky,Boyd County,1,10,3641,1850,1791
Kentucky,Boyd County,1,11,3949,1932,2017
Kentucky,Boyd County,1,12,3569,1739,1830
Kentucky,Boyd County,1,13,3168,1567,1601
Kentucky,Boyd County,1,14,2413,1173,1240
Kentucky,Boyd County,1,15,2049,895,1154
Kentucky,Boyd County,1,16,1588,656,932
Kentucky,Boyd County,1,17,1193,464,729
Kentucky,Boyd County,1,18,999,306,693
Kentucky,Boyd County,2,0,49534,24619,24915
Kentucky,Boyd County,2,1,2906,1484,1422
Kentucky,Boyd County,2,2,2909,1534,1375
Kentucky,Boyd County,2,3,2910,1440,1470
Kentucky,Boyd County,2,4,3001,1564,1437
Kentucky,Boyd County,2,5,2489,1253,1236
Kentucky,Boyd County,2,6,3026,1561,1465
Kentucky,Boyd County,2,7,3085,1664,1421
Kentucky,Boyd County,2,8,3234,1731,1503
Kentucky,Boyd County,2,9,3410,1808,1602
Kentucky,Boyd County,2,10,3638,1849,1789
Kentucky,Boyd County,2,11,3947,1931,2016
Kentucky,Boyd County,2,12,3569,1739,1830
Kentucky,Boyd County,2,13,3168,1567,1601
Kentucky,Boyd County,2,14,2413,1173,1240
Kentucky,Boyd County,2,15,2049,895,1154
Kentucky,Boyd County,2,16,1588,656,932
Kentucky,Boyd County,2,17,1193,464,729
Kentucky,Boyd County,2,18,999,306,693
Kentucky,Boyd County,3,0,49602,24650,24952
Kentucky,Boyd County,3,1,2878,1468,1410
Kentucky,Boyd County,3,2,2921,1529,1392
Kentucky,Boyd County,3,3,2914,1448,1466
Kentucky,Boyd County,3,4,2964,1542,1422
Kentucky,Boyd County,3,5,2538,1283,1255
Kentucky,Boyd County,3,6,3022,1560,1462
Kentucky,Boyd County,3,7,3105,1674,1431
Kentucky,Boyd County,3,8,3228,1729,1499
Kentucky,Boyd County,3,9,3423,1810,1613
Kentucky,Boyd County,3,10,3631,1847,1784
Kentucky,Boyd County,3,11,3930,1922,2008
Kentucky,Boyd County,3,12,3596,1754,1842
Kentucky,Boyd County,3,13,3199,1583,1616
Kentucky,Boyd County,3,14,2417,1171,1246
Kentucky,Boyd County,3,15,2049,897,1152
Kentucky,Boyd County,3,16,1580,655,925
Kentucky,Boyd County,3,17,1198,467,731
Kentucky,Boyd County,3,18,1009,311,698
Kentucky,Boyd County,4,0,49407,24535,24872
Kentucky,Boyd County,4,1,2818,1411,1407
Kentucky,Boyd County,4,2,2935,1508,1427
Kentucky,Boyd County,4,3,2891,1447,1444
Kentucky,Boyd County,4,4,2837,1486,1351
Kentucky,Boyd County,4,5,2695,1382,1313
Kentucky,Boyd County,4,6,2928,1489,1439
Kentucky,Boyd County,4,7,3119,1688,1431
Kentucky,Boyd County,4,8,3105,1659,1446
Kentucky,Boyd County,4,9,3400,1795,1605
Kentucky,Boyd County,4,10,3522,1826,1696
Kentucky,Boyd County,4,11,3870,1904,1966
Kentucky,Boyd County,4,12,3673,1783,1890
Kentucky,Boyd County,4,13,3328,1642,1686
Kentucky,Boyd County,4,14,2452,1172,1280
Kentucky,Boyd County,4,15,2041,907,1134
Kentucky,Boyd County,4,16,1571,646,925
Kentucky,Boyd County,4,17,1195,471,724
Kentucky,Boyd County,4,18,1027,319,708
Kentucky,Boyd County,5,0,49224,24518,24706
Kentucky,Boyd County,5,1,2809,1431,1378
Kentucky,Boyd County,5,2,2911,1502,1409
Kentucky,Boyd County,5,3,2883,1470,1413
Kentucky,Boyd County,5,4,2804,1459,1345
Kentucky,Boyd County,5,5,2733,1437,1296
Kentucky,Boyd County,5,6,2789,1376,1413
Kentucky,Boyd County,5,7,3225,1727,1498
Kentucky,Boyd County,5,8,3037,1618,1419
Kentucky,Boyd County,5,9,3361,1787,1574
Kentucky,Boyd County,5,10,3471,1812,1659
Kentucky,Boyd County,5,11,3709,1840,1869
Kentucky,Boyd County,5,12,3736,1808,1928
Kentucky,Boyd County,5,13,3285,1618,1667
Kentucky,Boyd County,5,14,2608,1255,1353
Kentucky,Boyd County,5,15,2078,943,1135
Kentucky,Boyd County,5,16,1594,658,936
Kentucky,Boyd County,5,17,1159,449,710
Kentucky,Boyd County,5,18,1032,328,704
Kentucky,Boyd County,6,0,48880,24332,24548
Kentucky,Boyd County,6,1,2792,1417,1375
Kentucky,Boyd County,6,2,2858,1447,1411
Kentucky,Boyd County,6,3,2818,1470,1348
Kentucky,Boyd County,6,4,2788,1432,1356
Kentucky,Boyd County,6,5,2692,1397,1295
Kentucky,Boyd County,6,6,2732,1371,1361
Kentucky,Boyd County,6,7,3169,1668,1501
Kentucky,Boyd County,6,8,3004,1620,1384
Kentucky,Boyd County,6,9,3343,1775,1568
Kentucky,Boyd County,6,10,3397,1767,1630
Kentucky,Boyd County,6,11,3611,1814,1797
Kentucky,Boyd County,6,12,3784,1838,1946
Kentucky,Boyd County,6,13,3263,1568,1695
Kentucky,Boyd County,6,14,2693,1320,1373
Kentucky,Boyd County,6,15,2115,976,1139
Kentucky,Boyd County,6,16,1629,679,950
Kentucky,Boyd County,6,17,1145,429,716
Kentucky,Boyd County,6,18,1047,344,703
Kentucky,Boyd County,7,0,48798,24354,24444
Kentucky,Boyd County,7,1,2907,1531,1376
Kentucky,Boyd County,7,2,2867,1428,1439
Kentucky,Boyd County,7,3,2805,1480,1325
Kentucky,Boyd County,7,4,2728,1374,1354
Kentucky,Boyd County,7,5,2700,1376,1324
Kentucky,Boyd County,7,6,2818,1467,1351
Kentucky,Boyd County,7,7,3098,1632,1466
Kentucky,Boyd County,7,8,3031,1650,1381
Kentucky,Boyd County,7,9,3243,1713,1530
Kentucky,Boyd County,7,10,3265,1702,1563
Kentucky,Boyd County,7,11,3537,1787,1750
Kentucky,Boyd County,7,12,3749,1813,1936
Kentucky,Boyd County,7,13,3240,1534,1706
Kentucky,Boyd County,7,14,2828,1400,1428
Kentucky,Boyd County,7,15,2111,993,1118
Kentucky,Boyd County,7,16,1651,698,953
Kentucky,Boyd County,7,17,1155,430,725
Kentucky,Boyd County,7,18,1065,346,719
Kentucky,Boyd County,8,0,48471,24188,24283
Kentucky,Boyd County,8,1,2951,1515,1436
Kentucky,Boyd County,8,2,2792,1414,1378
Kentucky,Boyd County,8,3,2827,1512,1315
Kentucky,Boyd County,8,4,2687,1356,1331
Kentucky,Boyd County,8,5,2641,1357,1284
Kentucky,Boyd County,8,6,2843,1470,1373
Kentucky,Boyd County,8,7,3040,1601,1439
Kentucky,Boyd County,8,8,3008,1625,1383
Kentucky,Boyd County,8,9,3166,1673,1493
Kentucky,Boyd County,8,10,3214,1667,1547
Kentucky,Boyd County,8,11,3454,1750,1704
Kentucky,Boyd County,8,12,3644,1753,1891
Kentucky,Boyd County,8,13,3314,1574,1740
Kentucky,Boyd County,8,14,2889,1427,1462
Kentucky,Boyd County,8,15,2087,1003,1084
Kentucky,Boyd County,8,16,1653,700,953
Kentucky,Boyd County,8,17,1170,441,729
Kentucky,Boyd County,8,18,1091,350,741
Kentucky,Boyd County,9,0,48121,23923,24198
Kentucky,Boyd County,9,1,2900,1495,1405
Kentucky,Boyd County,9,2,2785,1378,1407
Kentucky,Boyd County,9,3,2873,1503,1370
Kentucky,Boyd County,9,4,2666,1372,1294
Kentucky,Boyd County,9,5,2478,1282,1196
Kentucky,Boyd County,9,6,2975,1568,1407
Kentucky,Boyd County,9,7,2857,1478,1379
Kentucky,Boyd County,9,8,3033,1620,1413
Kentucky,Boyd County,9,9,3026,1582,1444
Kentucky,Boyd County,9,10,3241,1671,1570
Kentucky,Boyd County,9,11,3382,1732,1650
Kentucky,Boyd County,9,12,3534,1699,1835
Kentucky,Boyd County,9,13,3381,1594,1787
Kentucky,Boyd County,9,14,2996,1476,1520
Kentucky,Boyd County,9,15,2111,999,1112
Kentucky,Boyd County,9,16,1630,705,925
Kentucky,Boyd County,9,17,1162,430,732
Kentucky,Boyd County,9,18,1091,339,752
Kentucky,Boyd County,10,0,47808,23798,24010
Kentucky,Boyd County,10,1,2854,1451,1403
Kentucky,Boyd County,10,2,2759,1368,1391
Kentucky,Boyd County,10,3,2868,1465,1403
Kentucky,Boyd County,10,4,2637,1381,1256
Kentucky,Boyd County,10,5,2432,1242,1190
Kentucky,Boyd County,10,6,2995,1603,1392
Kentucky,Boyd County,10,7,2794,1443,1351
Kentucky,Boyd County,10,8,3108,1667,1441
Kentucky,Boyd County,10,9,2901,1518,1383
Kentucky,Boyd County,10,10,3157,1639,1518
Kentucky,Boyd County,10,11,3318,1724,1594
Kentucky,Boyd County,10,12,3454,1672,1782
Kentucky,Boyd County,10,13,3437,1622,1815
Kentucky,Boyd County,10,14,2911,1429,1482
Kentucky,Boyd County,10,15,2271,1061,1210
Kentucky,Boyd County,10,16,1646,729,917
Kentucky,Boyd County,10,17,1159,438,721
Kentucky,Boyd County,10,18,1107,346,761
Kentucky,Boyd County,11,0,47292,23518,23774
Kentucky,Boyd County,11,1,2785,1405,1380
Kentucky,Boyd County,11,2,2758,1388,1370
Kentucky,Boyd County,11,3,2833,1410,1423
Kentucky,Boyd County,11,4,2647,1436,1211
Kentucky,Boyd County,11,5,2392,1226,1166
Kentucky,Boyd County,11,6,2978,1622,1356
Kentucky,Boyd County,11,7,2746,1412,1334
Kentucky,Boyd County,11,8,3017,1597,1420
Kentucky,Boyd County,11,9,2870,1497,1373
Kentucky,Boyd County,11,10,3067,1587,1480
Kentucky,Boyd County,11,11,3223,1657,1566
Kentucky,Boyd County,11,12,3331,1635,1696
Kentucky,Boyd County,11,13,3462,1630,1832
Kentucky,Boyd County,11,14,2863,1366,1497
Kentucky,Boyd County,11,15,2360,1111,1249
Kentucky,Boyd County,11,16,1666,761,905
Kentucky,Boyd County,11,17,1179,428,751
Kentucky,Boyd County,11,18,1115,350,765
Kentucky,Boyd County,12,0,46718,23198,23520
Kentucky,Boyd County,12,1,2619,1302,1317
Kentucky,Boyd County,12,2,2737,1399,1338
Kentucky,Boyd County,12,3,2800,1367,1433
Kentucky,Boyd County,12,4,2634,1448,1186
Kentucky,Boyd County,12,5,2331,1178,1153
Kentucky,Boyd County,12,6,2833,1536,1297
Kentucky,Boyd County,12,7,2771,1457,1314
Kentucky,Boyd County,12,8,2973,1568,1405
Kentucky,Boyd County,12,9,2885,1526,1359
Kentucky,Boyd County,12,10,2973,1517,1456
Kentucky,Boyd County,12,11,3097,1573,1524
Kentucky,Boyd County,12,12,3292,1627,1665
Kentucky,Boyd County,12,13,3439,1604,1835
Kentucky,Boyd County,12,14,2862,1351,1511
Kentucky,Boyd County,12,15,2457,1166,1291
Kentucky,Boyd County,12,16,1711,791,920
Kentucky,Boyd County,12,17,1190,445,745
Kentucky,Boyd County,12,18,1114,343,771
Kentucky,Boyle County,1,0,28432,13833,14599
Kentucky,Boyle County,1,1,1519,751,768
Kentucky,Boyle County,1,2,1708,873,835
Kentucky,Boyle County,1,3,1748,881,867
Kentucky,Boyle County,1,4,2192,1117,1075
Kentucky,Boyle County,1,5,2032,1071,961
Kentucky,Boyle County,1,6,1487,817,670
Kentucky,Boyle County,1,7,1548,759,789
Kentucky,Boyle County,1,8,1752,914,838
Kentucky,Boyle County,1,9,1938,962,976
Kentucky,Boyle County,1,10,2069,1015,1054
Kentucky,Boyle County,1,11,2032,992,1040
Kentucky,Boyle County,1,12,1966,918,1048
Kentucky,Boyle County,1,13,1833,899,934
Kentucky,Boyle County,1,14,1356,609,747
Kentucky,Boyle County,1,15,1065,480,585
Kentucky,Boyle County,1,16,852,336,516
Kentucky,Boyle County,1,17,700,266,434
Kentucky,Boyle County,1,18,635,173,462
Kentucky,Boyle County,2,0,28443,13843,14600
Kentucky,Boyle County,2,1,1516,750,766
Kentucky,Boyle County,2,2,1709,874,835
Kentucky,Boyle County,2,3,1745,880,865
Kentucky,Boyle County,2,4,2194,1119,1075
Kentucky,Boyle County,2,5,2032,1073,959
Kentucky,Boyle County,2,6,1488,817,671
Kentucky,Boyle County,2,7,1547,760,787
Kentucky,Boyle County,2,8,1752,913,839
Kentucky,Boyle County,2,9,1937,961,976
Kentucky,Boyle County,2,10,2074,1016,1058
Kentucky,Boyle County,2,11,2040,996,1044
Kentucky,Boyle County,2,12,1970,921,1049
Kentucky,Boyle County,2,13,1833,900,933
Kentucky,Boyle County,2,14,1354,608,746
Kentucky,Boyle County,2,15,1065,480,585
Kentucky,Boyle County,2,16,853,336,517
Kentucky,Boyle County,2,17,700,266,434
Kentucky,Boyle County,2,18,634,173,461
Kentucky,Boyle County,3,0,28674,14021,14653
Kentucky,Boyle County,3,1,1532,761,771
Kentucky,Boyle County,3,2,1703,871,832
Kentucky,Boyle County,3,3,1754,882,872
Kentucky,Boyle County,3,4,2214,1135,1079
Kentucky,Boyle County,3,5,2063,1084,979
Kentucky,Boyle County,3,6,1524,853,671
Kentucky,Boyle County,3,7,1575,786,789
Kentucky,Boyle County,3,8,1756,915,841
Kentucky,Boyle County,3,9,1959,981,978
Kentucky,Boyle County,3,10,2094,1032,1062
Kentucky,Boyle County,3,11,2036,998,1038
Kentucky,Boyle County,3,12,1991,937,1054
Kentucky,Boyle County,3,13,1844,898,946
Kentucky,Boyle County,3,14,1370,621,749
Kentucky,Boyle County,3,15,1065,484,581
Kentucky,Boyle County,3,16,850,337,513
Kentucky,Boyle County,3,17,703,269,434
Kentucky,Boyle County,3,18,641,177,464
Kentucky,Boyle County,4,0,28800,14108,14692
Kentucky,Boyle County,4,1,1523,782,741
Kentucky,Boyle County,4,2,1654,834,820
Kentucky,Boyle County,4,3,1798,902,896
Kentucky,Boyle County,4,4,2213,1117,1096
Kentucky,Boyle County,4,5,2142,1114,1028
Kentucky,Boyle County,4,6,1534,894,640
Kentucky,Boyle County,4,7,1591,797,794
Kentucky,Boyle County,4,8,1708,880,828
Kentucky,Boyle County,4,9,1963,988,975
Kentucky,Boyle County,4,10,2070,1038,1032
Kentucky,Boyle County,4,11,1997,964,1033
Kentucky,Boyle County,4,12,1995,939,1056
Kentucky,Boyle County,4,13,1918,917,1001
Kentucky,Boyle County,4,14,1413,652,761
Kentucky,Boyle County,4,15,1086,501,585
Kentucky,Boyle County,4,16,834,331,503
Kentucky,Boyle County,4,17,698,267,431
Kentucky,Boyle County,4,18,663,191,472
Kentucky,Boyle County,5,0,29020,14241,14779
Kentucky,Boyle County,5,1,1505,789,716
Kentucky,Boyle County,5,2,1683,852,831
Kentucky,Boyle County,5,3,1807,895,912
Kentucky,Boyle County,5,4,2184,1088,1096
Kentucky,Boyle County,5,5,2264,1165,1099
Kentucky,Boyle County,5,6,1563,912,651
Kentucky,Boyle County,5,7,1570,815,755
Kentucky,Boyle County,5,8,1664,862,802
Kentucky,Boyle County,5,9,1932,991,941
Kentucky,Boyle County,5,10,2071,1031,1040
Kentucky,Boyle County,5,11,2010,961,1049
Kentucky,Boyle County,5,12,2015,962,1053
Kentucky,Boyle County,5,13,1873,878,995
Kentucky,Boyle County,5,14,1520,725,795
Kentucky,Boyle County,5,15,1142,505,637
Kentucky,Boyle County,5,16,830,339,491
Kentucky,Boyle County,5,17,701,263,438
Kentucky,Boyle County,5,18,686,208,478
Kentucky,Boyle County,6,0,29632,14754,14878
Kentucky,Boyle County,6,1,1519,799,720
Kentucky,Boyle County,6,2,1623,811,812
Kentucky,Boyle County,6,3,1822,925,897
Kentucky,Boyle County,6,4,2170,1067,1103
Kentucky,Boyle County,6,5,2470,1299,1171
Kentucky,Boyle County,6,6,1688,1024,664
Kentucky,Boyle County,6,7,1608,878,730
Kentucky,Boyle County,6,8,1723,900,823
Kentucky,Boyle County,6,9,1988,1057,931
Kentucky,Boyle County,6,10,2067,1049,1018
Kentucky,Boyle County,6,11,2011,955,1056
Kentucky,Boyle County,6,12,2015,969,1046
Kentucky,Boyle County,6,13,1869,878,991
Kentucky,Boyle County,6,14,1580,757,823
Kentucky,Boyle County,6,15,1182,526,656
Kentucky,Boyle County,6,16,863,359,504
Kentucky,Boyle County,6,17,698,269,429
Kentucky,Boyle County,6,18,736,232,504
Kentucky,Boyle County,7,0,29810,14868,14942
Kentucky,Boyle County,7,1,1636,860,776
Kentucky,Boyle County,7,2,1600,822,778
Kentucky,Boyle County,7,3,1791,922,869
Kentucky,Boyle County,7,4,2153,1037,1116
Kentucky,Boyle County,7,5,2520,1315,1205
Kentucky,Boyle County,7,6,1725,1059,666
Kentucky,Boyle County,7,7,1645,905,740
Kentucky,Boyle County,7,8,1658,856,802
Kentucky,Boyle County,7,9,1965,1073,892
Kentucky,Boyle County,7,10,1991,1015,976
Kentucky,Boyle County,7,11,2014,955,1059
Kentucky,Boyle County,7,12,2025,966,1059
Kentucky,Boyle County,7,13,1890,888,1002
Kentucky,Boyle County,7,14,1632,767,865
Kentucky,Boyle County,7,15,1188,523,665
Kentucky,Boyle County,7,16,902,395,507
Kentucky,Boyle County,7,17,710,270,440
Kentucky,Boyle County,7,18,765,240,525
Kentucky,Boyle County,8,0,29782,14894,14888
Kentucky,Boyle County,8,1,1612,850,762
Kentucky,Boyle County,8,2,1640,829,811
Kentucky,Boyle County,8,3,1731,910,821
Kentucky,Boyle County,8,4,2129,1039,1090
Kentucky,Boyle County,8,5,2575,1351,1224
Kentucky,Boyle County,8,6,1752,1060,692
Kentucky,Boyle County,8,7,1630,895,735
Kentucky,Boyle County,8,8,1711,893,818
Kentucky,Boyle County,8,9,1837,1009,828
Kentucky,Boyle County,8,10,1974,1015,959
Kentucky,Boyle County,8,11,1975,945,1030
Kentucky,Boyle County,8,12,2028,969,1059
Kentucky,Boyle County,8,13,1862,868,994
Kentucky,Boyle County,8,14,1716,811,905
Kentucky,Boyle County,8,15,1200,520,680
Kentucky,Boyle County,8,16,938,420,518
Kentucky,Boyle County,8,17,679,257,422
Kentucky,Boyle County,8,18,793,253,540
Kentucky,Boyle County,9,0,29965,14894,15071
Kentucky,Boyle County,9,1,1637,816,821
Kentucky,Boyle County,9,2,1668,856,812
Kentucky,Boyle County,9,3,1726,877,849
Kentucky,Boyle County,9,4,2161,1062,1099
Kentucky,Boyle County,9,5,2576,1352,1224
Kentucky,Boyle County,9,6,1782,1036,746
Kentucky,Boyle County,9,7,1627,929,698
Kentucky,Boyle County,9,8,1708,886,822
Kentucky,Boyle County,9,9,1796,974,822
Kentucky,Boyle County,9,10,1988,1027,961
Kentucky,Boyle County,9,11,1987,963,1024
Kentucky,Boyle County,9,12,1964,934,1030
Kentucky,Boyle County,9,13,1870,872,998
Kentucky,Boyle County,9,14,1788,818,970
Kentucky,Boyle County,9,15,1242,546,696
Kentucky,Boyle County,9,16,947,422,525
Kentucky,Boyle County,9,17,685,265,420
Kentucky,Boyle County,9,18,813,259,554
Kentucky,Boyle County,10,0,29972,14866,15106
Kentucky,Boyle County,10,1,1598,787,811
Kentucky,Boyle County,10,2,1619,863,756
Kentucky,Boyle County,10,3,1717,854,863
Kentucky,Boyle County,10,4,2181,1075,1106
Kentucky,Boyle County,10,5,2518,1312,1206
Kentucky,Boyle County,10,6,1859,1067,792
Kentucky,Boyle County,10,7,1664,976,688
Kentucky,Boyle County,10,8,1677,840,837
Kentucky,Boyle County,10,9,1731,916,815
Kentucky,Boyle County,10,10,1972,1048,924
Kentucky,Boyle County,10,11,1944,932,1012
Kentucky,Boyle County,10,12,1973,934,1039
Kentucky,Boyle County,10,13,1883,901,982
Kentucky,Boyle County,10,14,1774,787,987
Kentucky,Boyle County,10,15,1344,615,729
Kentucky,Boyle County,10,16,994,428,566
Kentucky,Boyle County,10,17,686,267,419
Kentucky,Boyle County,10,18,838,264,574
Kentucky,Boyle County,11,0,30082,14952,15130
Kentucky,Boyle County,11,1,1603,802,801
Kentucky,Boyle County,11,2,1603,874,729
Kentucky,Boyle County,11,3,1734,873,861
Kentucky,Boyle County,11,4,2193,1086,1107
Kentucky,Boyle County,11,5,2481,1294,1187
Kentucky,Boyle County,11,6,1910,1103,807
Kentucky,Boyle County,11,7,1700,989,711
Kentucky,Boyle County,11,8,1656,838,818
Kentucky,Boyle County,11,9,1731,901,830
Kentucky,Boyle County,11,10,1958,1038,920
Kentucky,Boyle County,11,11,1892,908,984
Kentucky,Boyle County,11,12,1946,923,1023
Kentucky,Boyle County,11,13,1906,904,1002
Kentucky,Boyle County,11,14,1779,802,977
Kentucky,Boyle County,11,15,1420,649,771
Kentucky,Boyle County,11,16,1013,426,587
Kentucky,Boyle County,11,17,708,277,431
Kentucky,Boyle County,11,18,849,265,584
Kentucky,Boyle County,12,0,30060,14985,15075
Kentucky,Boyle County,12,1,1563,804,759
Kentucky,Boyle County,12,2,1684,889,795
Kentucky,Boyle County,12,3,1673,867,806
Kentucky,Boyle County,12,4,2160,1086,1074
Kentucky,Boyle County,12,5,2432,1247,1185
Kentucky,Boyle County,12,6,1935,1104,831
Kentucky,Boyle County,12,7,1716,985,731
Kentucky,Boyle County,12,8,1688,898,790
Kentucky,Boyle County,12,9,1708,882,826
Kentucky,Boyle County,12,10,1898,1002,896
Kentucky,Boyle County,12,11,1843,900,943
Kentucky,Boyle County,12,12,1964,935,1029
Kentucky,Boyle County,12,13,1904,907,997
Kentucky,Boyle County,12,14,1783,814,969
Kentucky,Boyle County,12,15,1481,666,815
Kentucky,Boyle County,12,16,1056,440,616
Kentucky,Boyle County,12,17,717,289,428
Kentucky,Boyle County,12,18,855,270,585
Kentucky,Bracken County,1,0,8488,4228,4260
Kentucky,Bracken County,1,1,569,309,260
Kentucky,Bracken County,1,2,619,312,307
Kentucky,Bracken County,1,3,608,302,306
Kentucky,Bracken County,1,4,583,295,288
Kentucky,Bracken County,1,5,466,221,245
Kentucky,Bracken County,1,6,450,229,221
Kentucky,Bracken County,1,7,494,249,245
Kentucky,Bracken County,1,8,555,281,274
Kentucky,Bracken County,1,9,586,301,285
Kentucky,Bracken County,1,10,698,329,369
Kentucky,Bracken County,1,11,638,340,298
Kentucky,Bracken County,1,12,581,293,288
Kentucky,Bracken County,1,13,482,243,239
Kentucky,Bracken County,1,14,362,177,185
Kentucky,Bracken County,1,15,305,144,161
Kentucky,Bracken County,1,16,214,98,116
Kentucky,Bracken County,1,17,154,59,95
Kentucky,Bracken County,1,18,124,46,78
Kentucky,Bracken County,2,0,8486,4227,4259
Kentucky,Bracken County,2,1,569,309,260
Kentucky,Bracken County,2,2,619,312,307
Kentucky,Bracken County,2,3,608,302,306
Kentucky,Bracken County,2,4,583,295,288
Kentucky,Bracken County,2,5,466,221,245
Kentucky,Bracken County,2,6,450,229,221
Kentucky,Bracken County,2,7,494,249,245
Kentucky,Bracken County,2,8,555,281,274
Kentucky,Bracken County,2,9,586,301,285
Kentucky,Bracken County,2,10,697,329,368
Kentucky,Bracken County,2,11,637,339,298
Kentucky,Bracken County,2,12,581,293,288
Kentucky,Bracken County,2,13,482,243,239
Kentucky,Bracken County,2,14,362,177,185
Kentucky,Bracken County,2,15,305,144,161
Kentucky,Bracken County,2,16,214,98,116
Kentucky,Bracken County,2,17,154,59,95
Kentucky,Bracken County,2,18,124,46,78
Kentucky,Bracken County,3,0,8513,4240,4273
Kentucky,Bracken County,3,1,566,303,263
Kentucky,Bracken County,3,2,623,317,306
Kentucky,Bracken County,3,3,600,296,304
Kentucky,Bracken County,3,4,583,295,288
Kentucky,Bracken County,3,5,470,225,245
Kentucky,Bracken County,3,6,454,230,224
Kentucky,Bracken County,3,7,497,252,245
Kentucky,Bracken County,3,8,551,281,270
Kentucky,Bracken County,3,9,590,304,286
Kentucky,Bracken County,3,10,688,324,364
Kentucky,Bracken County,3,11,643,339,304
Kentucky,Bracken County,3,12,585,298,287
Kentucky,Bracken County,3,13,488,244,244
Kentucky,Bracken County,3,14,364,178,186
Kentucky,Bracken County,3,15,310,145,165
Kentucky,Bracken County,3,16,214,98,116
Kentucky,Bracken County,3,17,158,63,95
Kentucky,Bracken County,3,18,129,48,81
Kentucky,Bracken County,4,0,8510,4270,4240
Kentucky,Bracken County,4,1,563,293,270
Kentucky,Bracken County,4,2,600,324,276
Kentucky,Bracken County,4,3,598,292,306
Kentucky,Bracken County,4,4,558,287,271
Kentucky,Bracken County,4,5,508,252,256
Kentucky,Bracken County,4,6,466,231,235
Kentucky,Bracken County,4,7,502,253,249
Kentucky,Bracken County,4,8,502,260,242
Kentucky,Bracken County,4,9,612,322,290
Kentucky,Bracken County,4,10,649,307,342
Kentucky,Bracken County,4,11,658,345,313
Kentucky,Bracken County,4,12,585,307,278
Kentucky,Bracken County,4,13,514,252,262
Kentucky,Bracken County,4,14,372,187,185
Kentucky,Bracken County,4,15,319,144,175
Kentucky,Bracken County,4,16,210,98,112
Kentucky,Bracken County,4,17,161,71,90
Kentucky,Bracken County,4,18,133,45,88
Kentucky,Bracken County,5,0,8462,4222,4240
Kentucky,Bracken County,5,1,511,272,239
Kentucky,Bracken County,5,2,596,308,288
Kentucky,Bracken County,5,3,597,299,298
Kentucky,Bracken County,5,4,564,296,268
Kentucky,Bracken County,5,5,515,246,269
Kentucky,Bracken County,5,6,471,235,236
Kentucky,Bracken County,5,7,482,238,244
Kentucky,Bracken County,5,8,488,242,246
Kentucky,Bracken County,5,9,585,302,283
Kentucky,Bracken County,5,10,636,314,322
Kentucky,Bracken County,5,11,671,338,333
Kentucky,Bracken County,5,12,598,313,285
Kentucky,Bracken County,5,13,519,270,249
Kentucky,Bracken County,5,14,403,195,208
Kentucky,Bracken County,5,15,316,147,169
Kentucky,Bracken County,5,16,215,96,119
Kentucky,Bracken County,5,17,160,68,92
Kentucky,Bracken County,5,18,135,43,92
Kentucky,Bracken County,6,0,8423,4237,4186
Kentucky,Bracken County,6,1,506,271,235
Kentucky,Bracken County,6,2,600,325,275
Kentucky,Bracken County,6,3,592,307,285
Kentucky,Bracken County,6,4,531,279,252
Kentucky,Bracken County,6,5,510,248,262
Kentucky,Bracken County,6,6,479,240,239
Kentucky,Bracken County,6,7,456,228,228
Kentucky,Bracken County,6,8,481,241,240
Kentucky,Bracken County,6,9,582,302,280
Kentucky,Bracken County,6,10,631,313,318
Kentucky,Bracken County,6,11,668,325,343
Kentucky,Bracken County,6,12,601,313,288
Kentucky,Bracken County,6,13,554,295,259
Kentucky,Bracken County,6,14,394,190,204
Kentucky,Bracken County,6,15,322,149,173
Kentucky,Bracken County,6,16,220,99,121
Kentucky,Bracken County,6,17,162,71,91
Kentucky,Bracken County,6,18,134,41,93
Kentucky,Bracken County,7,0,8359,4198,4161
Kentucky,Bracken County,7,1,511,276,235
Kentucky,Bracken County,7,2,591,312,279
Kentucky,Bracken County,7,3,591,305,286
Kentucky,Bracken County,7,4,519,269,250
Kentucky,Bracken County,7,5,465,218,247
Kentucky,Bracken County,7,6,482,245,237
Kentucky,Bracken County,7,7,478,243,235
Kentucky,Bracken County,7,8,478,246,232
Kentucky,Bracken County,7,9,553,280,273
Kentucky,Bracken County,7,10,587,296,291
Kentucky,Bracken County,7,11,684,326,358
Kentucky,Bracken County,7,12,602,320,282
Kentucky,Bracken County,7,13,564,287,277
Kentucky,Bracken County,7,14,413,204,209
Kentucky,Bracken County,7,15,328,163,165
Kentucky,Bracken County,7,16,220,95,125
Kentucky,Bracken County,7,17,165,69,96
Kentucky,Bracken County,7,18,128,44,84
Kentucky,Bracken County,8,0,8290,4144,4146
Kentucky,Bracken County,8,1,531,270,261
Kentucky,Bracken County,8,2,555,292,263
Kentucky,Bracken County,8,3,585,296,289
Kentucky,Bracken County,8,4,516,267,249
Kentucky,Bracken County,8,5,440,207,233
Kentucky,Bracken County,8,6,494,258,236
Kentucky,Bracken County,8,7,474,246,228
Kentucky,Bracken County,8,8,486,247,239
Kentucky,Bracken County,8,9,507,251,256
Kentucky,Bracken County,8,10,595,302,293
Kentucky,Bracken County,8,11,651,308,343
Kentucky,Bracken County,8,12,609,328,281
Kentucky,Bracken County,8,13,575,287,288
Kentucky,Bracken County,8,14,444,219,225
Kentucky,Bracken County,8,15,304,152,152
Kentucky,Bracken County,8,16,236,105,131
Kentucky,Bracken County,8,17,156,64,92
Kentucky,Bracken County,8,18,132,45,87
Kentucky,Bracken County,9,0,8368,4184,4184
Kentucky,Bracken County,9,1,549,288,261
Kentucky,Bracken County,9,2,574,294,280
Kentucky,Bracken County,9,3,572,289,283
Kentucky,Bracken County,9,4,527,268,259
Kentucky,Bracken County,9,5,449,223,226
Kentucky,Bracken County,9,6,496,250,246
Kentucky,Bracken County,9,7,508,263,245
Kentucky,Bracken County,9,8,498,249,249
Kentucky,Bracken County,9,9,488,240,248
Kentucky,Bracken County,9,10,584,303,281
Kentucky,Bracken County,9,11,603,291,312
Kentucky,Bracken County,9,12,646,339,307
Kentucky,Bracken County,9,13,557,282,275
Kentucky,Bracken County,9,14,476,226,250
Kentucky,Bracken County,9,15,303,156,147
Kentucky,Bracken County,9,16,252,106,146
Kentucky,Bracken County,9,17,148,64,84
Kentucky,Bracken County,9,18,138,53,85
Kentucky,Bracken County,10,0,8285,4151,4134
Kentucky,Bracken County,10,1,533,270,263
Kentucky,Bracken County,10,2,539,284,255
Kentucky,Bracken County,10,3,564,287,277
Kentucky,Bracken County,10,4,515,273,242
Kentucky,Bracken County,10,5,428,220,208
Kentucky,Bracken County,10,6,510,245,265
Kentucky,Bracken County,10,7,497,265,232
Kentucky,Bracken County,10,8,470,234,236
Kentucky,Bracken County,10,9,488,241,247
Kentucky,Bracken County,10,10,562,285,277
Kentucky,Bracken County,10,11,604,297,307
Kentucky,Bracken County,10,12,646,329,317
Kentucky,Bracken County,10,13,581,301,280
Kentucky,Bracken County,10,14,495,248,247
Kentucky,Bracken County,10,15,323,156,167
Kentucky,Bracken County,10,16,242,105,137
Kentucky,Bracken County,10,17,152,62,90
Kentucky,Bracken County,10,18,136,49,87
Kentucky,Bracken County,11,0,8278,4148,4130
Kentucky,Bracken County,11,1,505,255,250
Kentucky,Bracken County,11,2,539,279,260
Kentucky,Bracken County,11,3,568,293,275
Kentucky,Bracken County,11,4,500,268,232
Kentucky,Bracken County,11,5,432,228,204
Kentucky,Bracken County,11,6,515,248,267
Kentucky,Bracken County,11,7,468,239,229
Kentucky,Bracken County,11,8,493,251,242
Kentucky,Bracken County,11,9,474,242,232
Kentucky,Bracken County,11,10,547,270,277
Kentucky,Bracken County,11,11,616,309,307
Kentucky,Bracken County,11,12,637,316,321
Kentucky,Bracken County,11,13,595,312,283
Kentucky,Bracken County,11,14,506,253,253
Kentucky,Bracken County,11,15,334,162,172
Kentucky,Bracken County,11,16,244,105,139
Kentucky,Bracken County,11,17,169,68,101
Kentucky,Bracken County,11,18,136,50,86
Kentucky,Bracken County,12,0,8303,4158,4145
Kentucky,Bracken County,12,1,492,243,249
Kentucky,Bracken County,12,2,543,293,250
Kentucky,Bracken County,12,3,574,297,277
Kentucky,Bracken County,12,4,518,267,251
Kentucky,Bracken County,12,5,444,233,211
Kentucky,Bracken County,12,6,479,224,255
Kentucky,Bracken County,12,7,448,233,215
Kentucky,Bracken County,12,8,516,268,248
Kentucky,Bracken County,12,9,503,255,248
Kentucky,Bracken County,12,10,517,256,261
Kentucky,Bracken County,12,11,587,296,291
Kentucky,Bracken County,12,12,666,328,338
Kentucky,Bracken County,12,13,588,309,279
Kentucky,Bracken County,12,14,523,250,273
Kentucky,Bracken County,12,15,356,175,181
Kentucky,Bracken County,12,16,250,119,131
Kentucky,Bracken County,12,17,165,66,99
Kentucky,Bracken County,12,18,134,46,88
Kentucky,Breathitt County,1,0,13878,6934,6944
Kentucky,Breathitt County,1,1,846,431,415
Kentucky,Breathitt County,1,2,775,411,364
Kentucky,Breathitt County,1,3,878,464,414
Kentucky,Breathitt County,1,4,1103,598,505
Kentucky,Breathitt County,1,5,782,413,369
Kentucky,Breathitt County,1,6,775,400,375
Kentucky,Breathitt County,1,7,877,448,429
Kentucky,Breathitt County,1,8,900,437,463
Kentucky,Breathitt County,1,9,973,471,502
Kentucky,Breathitt County,1,10,1096,556,540
Kentucky,Breathitt County,1,11,1072,542,530
Kentucky,Breathitt County,1,12,1030,486,544
Kentucky,Breathitt County,1,13,905,465,440
Kentucky,Breathitt County,1,14,665,312,353
Kentucky,Breathitt County,1,15,457,194,263
Kentucky,Breathitt County,1,16,372,169,203
Kentucky,Breathitt County,1,17,221,95,126
Kentucky,Breathitt County,1,18,151,42,109
Kentucky,Breathitt County,2,0,13876,6933,6943
Kentucky,Breathitt County,2,1,846,431,415
Kentucky,Breathitt County,2,2,775,411,364
Kentucky,Breathitt County,2,3,878,464,414
Kentucky,Breathitt County,2,4,1103,598,505
Kentucky,Breathitt County,2,5,782,413,369
Kentucky,Breathitt County,2,6,775,400,375
Kentucky,Breathitt County,2,7,877,448,429
Kentucky,Breathitt County,2,8,900,437,463
Kentucky,Breathitt County,2,9,973,471,502
Kentucky,Breathitt County,2,10,1096,556,540
Kentucky,Breathitt County,2,11,1072,542,530
Kentucky,Breathitt County,2,12,1030,486,544
Kentucky,Breathitt County,2,13,904,465,439
Kentucky,Breathitt County,2,14,664,311,353
Kentucky,Breathitt County,2,15,457,194,263
Kentucky,Breathitt County,2,16,372,169,203
Kentucky,Breathitt County,2,17,221,95,126
Kentucky,Breathitt County,2,18,151,42,109
Kentucky,Breathitt County,3,0,13857,6916,6941
Kentucky,Breathitt County,3,1,838,427,411
Kentucky,Breathitt County,3,2,780,415,365
Kentucky,Breathitt County,3,3,865,456,409
Kentucky,Breathitt County,3,4,1083,590,493
Kentucky,Breathitt County,3,5,801,422,379
Kentucky,Breathitt County,3,6,782,403,379
Kentucky,Breathitt County,3,7,866,441,425
Kentucky,Breathitt County,3,8,905,439,466
Kentucky,Breathitt County,3,9,964,465,499
Kentucky,Breathitt County,3,10,1093,551,542
Kentucky,Breathitt County,3,11,1074,544,530
Kentucky,Breathitt County,3,12,1041,493,548
Kentucky,Breathitt County,3,13,904,461,443
Kentucky,Breathitt County,3,14,655,308,347
Kentucky,Breathitt County,3,15,471,199,272
Kentucky,Breathitt County,3,16,358,162,196
Kentucky,Breathitt County,3,17,224,96,128
Kentucky,Breathitt County,3,18,153,44,109
Kentucky,Breathitt County,4,0,13789,6897,6892
Kentucky,Breathitt County,4,1,803,423,380
Kentucky,Breathitt County,4,2,817,436,381
Kentucky,Breathitt County,4,3,821,426,395
Kentucky,Breathitt County,4,4,1014,568,446
Kentucky,Breathitt County,4,5,842,433,409
Kentucky,Breathitt County,4,6,768,385,383
Kentucky,Breathitt County,4,7,852,442,410
Kentucky,Breathitt County,4,8,908,446,462
Kentucky,Breathitt County,4,9,934,454,480
Kentucky,Breathitt County,4,10,1083,539,544
Kentucky,Breathitt County,4,11,1070,541,529
Kentucky,Breathitt County,4,12,1053,507,546
Kentucky,Breathitt County,4,13,941,472,469
Kentucky,Breathitt County,4,14,634,303,331
Kentucky,Breathitt County,4,15,532,233,299
Kentucky,Breathitt County,4,16,329,139,190
Kentucky,Breathitt County,4,17,240,103,137
Kentucky,Breathitt County,4,18,148,47,101
Kentucky,Breathitt County,5,0,13612,6821,6791
Kentucky,Breathitt County,5,1,807,431,376
Kentucky,Breathitt County,5,2,803,422,381
Kentucky,Breathitt County,5,3,750,386,364
Kentucky,Breathitt County,5,4,968,550,418
Kentucky,Breathitt County,5,5,848,449,399
Kentucky,Breathitt County,5,6,739,356,383
Kentucky,Breathitt County,5,7,846,443,403
Kentucky,Breathitt County,5,8,881,452,429
Kentucky,Breathitt County,5,9,929,444,485
Kentucky,Breathitt County,5,10,1065,530,535
Kentucky,Breathitt County,5,11,1068,540,528
Kentucky,Breathitt County,5,12,1016,492,524
Kentucky,Breathitt County,5,13,948,472,476
Kentucky,Breathitt County,5,14,689,335,354
Kentucky,Breathitt County,5,15,536,237,299
Kentucky,Breathitt County,5,16,332,134,198
Kentucky,Breathitt County,5,17,234,96,138
Kentucky,Breathitt County,5,18,153,52,101
Kentucky,Breathitt County,6,0,13527,6778,6749
Kentucky,Breathitt County,6,1,812,448,364
Kentucky,Breathitt County,6,2,811,415,396
Kentucky,Breathitt County,6,3,725,384,341
Kentucky,Breathitt County,6,4,916,509,407
Kentucky,Breathitt County,6,5,890,461,429
Kentucky,Breathitt County,6,6,714,345,369
Kentucky,Breathitt County,6,7,865,457,408
Kentucky,Breathitt County,6,8,889,457,432
Kentucky,Breathitt County,6,9,922,450,472
Kentucky,Breathitt County,6,10,1012,495,517
Kentucky,Breathitt County,6,11,1053,542,511
Kentucky,Breathitt County,6,12,1040,497,543
Kentucky,Breathitt County,6,13,914,452,462
Kentucky,Breathitt County,6,14,725,350,375
Kentucky,Breathitt County,6,15,512,231,281
Kentucky,Breathitt County,6,16,333,136,197
Kentucky,Breathitt County,6,17,235,91,144
Kentucky,Breathitt County,6,18,159,58,101
Kentucky,Breathitt County,7,0,13366,6694,6672
Kentucky,Breathitt County,7,1,816,441,375
Kentucky,Breathitt County,7,2,768,393,375
Kentucky,Breathitt County,7,3,713,380,333
Kentucky,Breathitt County,7,4,861,477,384
Kentucky,Breathitt County,7,5,878,460,418
Kentucky,Breathitt County,7,6,763,392,371
Kentucky,Breathitt County,7,7,810,412,398
Kentucky,Breathitt County,7,8,875,438,437
Kentucky,Breathitt County,7,9,912,451,461
Kentucky,Breathitt County,7,10,954,461,493
Kentucky,Breathitt County,7,11,1049,534,515
Kentucky,Breathitt County,7,12,1036,500,536
Kentucky,Breathitt County,7,13,928,448,480
Kentucky,Breathitt County,7,14,741,372,369
Kentucky,Breathitt County,7,15,531,242,289
Kentucky,Breathitt County,7,16,338,142,196
Kentucky,Breathitt County,7,17,233,93,140
Kentucky,Breathitt County,7,18,160,58,102
Kentucky,Breathitt County,8,0,13363,6700,6663
Kentucky,Breathitt County,8,1,815,439,376
Kentucky,Breathitt County,8,2,762,390,372
Kentucky,Breathitt County,8,3,708,373,335
Kentucky,Breathitt County,8,4,823,464,359
Kentucky,Breathitt County,8,5,851,442,409
Kentucky,Breathitt County,8,6,831,429,402
Kentucky,Breathitt County,8,7,781,407,374
Kentucky,Breathitt County,8,8,876,446,430
Kentucky,Breathitt County,8,9,898,434,464
Kentucky,Breathitt County,8,10,925,446,479
Kentucky,Breathitt County,8,11,1073,543,530
Kentucky,Breathitt County,8,12,1005,506,499
Kentucky,Breathitt County,8,13,941,442,499
Kentucky,Breathitt County,8,14,786,400,386
Kentucky,Breathitt County,8,15,540,247,293
Kentucky,Breathitt County,8,16,336,137,199
Kentucky,Breathitt County,8,17,245,103,142
Kentucky,Breathitt County,8,18,167,52,115
Kentucky,Breathitt County,9,0,13177,6589,6588
Kentucky,Breathitt County,9,1,804,426,378
Kentucky,Breathitt County,9,2,728,364,364
Kentucky,Breathitt County,9,3,717,392,325
Kentucky,Breathitt County,9,4,799,437,362
Kentucky,Breathitt County,9,5,802,421,381
Kentucky,Breathitt County,9,6,844,439,405
Kentucky,Breathitt County,9,7,753,377,376
Kentucky,Breathitt County,9,8,853,436,417
Kentucky,Breathitt County,9,9,887,442,445
Kentucky,Breathitt County,9,10,890,427,463
Kentucky,Breathitt County,9,11,1055,544,511
Kentucky,Breathitt County,9,12,998,500,498
Kentucky,Breathitt County,9,13,951,457,494
Kentucky,Breathitt County,9,14,799,388,411
Kentucky,Breathitt County,9,15,519,245,274
Kentucky,Breathitt County,9,16,376,153,223
Kentucky,Breathitt County,9,17,222,86,136
Kentucky,Breathitt County,9,18,180,55,125
Kentucky,Breathitt County,10,0,12929,6459,6470
Kentucky,Breathitt County,10,1,785,407,378
Kentucky,Breathitt County,10,2,682,354,328
Kentucky,Breathitt County,10,3,706,370,336
Kentucky,Breathitt County,10,4,723,401,322
Kentucky,Breathitt County,10,5,779,408,371
Kentucky,Breathitt County,10,6,856,451,405
Kentucky,Breathitt County,10,7,718,350,368
Kentucky,Breathitt County,10,8,805,404,401
Kentucky,Breathitt County,10,9,852,440,412
Kentucky,Breathitt County,10,10,877,424,453
Kentucky,Breathitt County,10,11,1047,533,514
Kentucky,Breathitt County,10,12,984,500,484
Kentucky,Breathitt County,10,13,945,451,494
Kentucky,Breathitt County,10,14,812,395,417
Kentucky,Breathitt County,10,15,572,267,305
Kentucky,Breathitt County,10,16,380,164,216
Kentucky,Breathitt County,10,17,221,79,142
Kentucky,Breathitt County,10,18,185,61,124
Kentucky,Breathitt County,11,0,12787,6394,6393
Kentucky,Breathitt County,11,1,810,397,413
Kentucky,Breathitt County,11,2,679,377,302
Kentucky,Breathitt County,11,3,705,361,344
Kentucky,Breathitt County,11,4,695,393,302
Kentucky,Breathitt County,11,5,719,378,341
Kentucky,Breathitt County,11,6,863,442,421
Kentucky,Breathitt County,11,7,692,350,342
Kentucky,Breathitt County,11,8,793,402,391
Kentucky,Breathitt County,11,9,843,435,408
Kentucky,Breathitt County,11,10,891,432,459
Kentucky,Breathitt County,11,11,970,481,489
Kentucky,Breathitt County,11,12,970,502,468
Kentucky,Breathitt County,11,13,964,460,504
Kentucky,Breathitt County,11,14,801,388,413
Kentucky,Breathitt County,11,15,593,278,315
Kentucky,Breathitt County,11,16,371,164,207
Kentucky,Breathitt County,11,17,230,87,143
Kentucky,Breathitt County,11,18,198,67,131
Kentucky,Breathitt County,12,0,12630,6312,6318
Kentucky,Breathitt County,12,1,784,389,395
Kentucky,Breathitt County,12,2,700,384,316
Kentucky,Breathitt County,12,3,673,346,327
Kentucky,Breathitt County,12,4,690,387,303
Kentucky,Breathitt County,12,5,674,344,330
Kentucky,Breathitt County,12,6,834,424,410
Kentucky,Breathitt County,12,7,716,379,337
Kentucky,Breathitt County,12,8,769,389,380
Kentucky,Breathitt County,12,9,848,426,422
Kentucky,Breathitt County,12,10,866,425,441
Kentucky,Breathitt County,12,11,900,441,459
Kentucky,Breathitt County,12,12,983,517,466
Kentucky,Breathitt County,12,13,954,451,503
Kentucky,Breathitt County,12,14,807,385,422
Kentucky,Breathitt County,12,15,604,285,319
Kentucky,Breathitt County,12,16,404,181,223
Kentucky,Breathitt County,12,17,232,90,142
Kentucky,Breathitt County,12,18,192,69,123
Kentucky,Breckinridge County,1,0,20059,10000,10059
Kentucky,Breckinridge County,1,1,1221,617,604
Kentucky,Breckinridge County,1,2,1324,697,627
Kentucky,Breckinridge County,1,3,1471,702,769
Kentucky,Breckinridge County,1,4,1299,675,624
Kentucky,Breckinridge County,1,5,985,527,458
Kentucky,Breckinridge County,1,6,1046,544,502
Kentucky,Breckinridge County,1,7,1091,543,548
Kentucky,Breckinridge County,1,8,1161,569,592
Kentucky,Breckinridge County,1,9,1287,637,650
Kentucky,Breckinridge County,1,10,1570,773,797
Kentucky,Breckinridge County,1,11,1594,809,785
Kentucky,Breckinridge County,1,12,1495,747,748
Kentucky,Breckinridge County,1,13,1384,707,677
Kentucky,Breckinridge County,1,14,1033,512,521
Kentucky,Breckinridge County,1,15,827,399,428
Kentucky,Breckinridge County,1,16,578,257,321
Kentucky,Breckinridge County,1,17,384,176,208
Kentucky,Breckinridge County,1,18,309,109,200
Kentucky,Breckinridge County,2,0,20053,9999,10054
Kentucky,Breckinridge County,2,1,1221,617,604
Kentucky,Breckinridge County,2,2,1322,697,625
Kentucky,Breckinridge County,2,3,1471,702,769
Kentucky,Breckinridge County,2,4,1299,675,624
Kentucky,Breckinridge County,2,5,985,527,458
Kentucky,Breckinridge County,2,6,1048,546,502
Kentucky,Breckinridge County,2,7,1090,543,547
Kentucky,Breckinridge County,2,8,1159,568,591
Kentucky,Breckinridge County,2,9,1286,637,649
Kentucky,Breckinridge County,2,10,1572,773,799
Kentucky,Breckinridge County,2,11,1595,810,785
Kentucky,Breckinridge County,2,12,1493,745,748
Kentucky,Breckinridge County,2,13,1384,708,676
Kentucky,Breckinridge County,2,14,1031,511,520
Kentucky,Breckinridge County,2,15,827,399,428
Kentucky,Breckinridge County,2,16,577,256,321
Kentucky,Breckinridge County,2,17,384,176,208
Kentucky,Breckinridge County,2,18,309,109,200
Kentucky,Breckinridge County,3,0,20043,9999,10044
Kentucky,Breckinridge County,3,1,1202,609,593
Kentucky,Breckinridge County,3,2,1321,693,628
Kentucky,Breckinridge County,3,3,1453,698,755
Kentucky,Breckinridge County,3,4,1311,679,632
Kentucky,Breckinridge County,3,5,982,523,459
Kentucky,Breckinridge County,3,6,1047,544,503
Kentucky,Breckinridge County,3,7,1101,549,552
Kentucky,Breckinridge County,3,8,1149,570,579
Kentucky,Breckinridge County,3,9,1274,628,646
Kentucky,Breckinridge County,3,10,1564,766,798
Kentucky,Breckinridge County,3,11,1607,814,793
Kentucky,Breckinridge County,3,12,1502,756,746
Kentucky,Breckinridge County,3,13,1388,709,679
Kentucky,Breckinridge County,3,14,1042,517,525
Kentucky,Breckinridge County,3,15,820,396,424
Kentucky,Breckinridge County,3,16,583,258,325
Kentucky,Breckinridge County,3,17,386,178,208
Kentucky,Breckinridge County,3,18,311,112,199
Kentucky,Breckinridge County,4,0,20272,10132,10140
Kentucky,Breckinridge County,4,1,1202,610,592
Kentucky,Breckinridge County,4,2,1352,704,648
Kentucky,Breckinridge County,4,3,1436,701,735
Kentucky,Breckinridge County,4,4,1324,678,646
Kentucky,Breckinridge County,4,5,1029,557,472
Kentucky,Breckinridge County,4,6,1040,524,516
Kentucky,Breckinridge County,4,7,1144,581,563
Kentucky,Breckinridge County,4,8,1147,597,550
Kentucky,Breckinridge County,4,9,1264,604,660
Kentucky,Breckinridge County,4,10,1519,737,782
Kentucky,Breckinridge County,4,11,1636,829,807
Kentucky,Breckinridge County,4,12,1535,787,748
Kentucky,Breckinridge County,4,13,1458,741,717
Kentucky,Breckinridge County,4,14,1080,537,543
Kentucky,Breckinridge County,4,15,803,387,416
Kentucky,Breckinridge County,4,16,593,265,328
Kentucky,Breckinridge County,4,17,386,176,210
Kentucky,Breckinridge County,4,18,324,117,207
Kentucky,Breckinridge County,5,0,20074,10053,10021
Kentucky,Breckinridge County,5,1,1154,612,542
Kentucky,Breckinridge County,5,2,1324,679,645
Kentucky,Breckinridge County,5,3,1419,713,706
Kentucky,Breckinridge County,5,4,1308,652,656
Kentucky,Breckinridge County,5,5,1053,561,492
Kentucky,Breckinridge County,5,6,982,500,482
Kentucky,Breckinridge County,5,7,1162,589,573
Kentucky,Breckinridge County,5,8,1084,574,510
Kentucky,Breckinridge County,5,9,1283,609,674
Kentucky,Breckinridge County,5,10,1445,706,739
Kentucky,Breckinridge County,5,11,1597,791,806
Kentucky,Breckinridge County,5,12,1533,793,740
Kentucky,Breckinridge County,5,13,1446,731,715
Kentucky,Breckinridge County,5,14,1156,585,571
Kentucky,Breckinridge County,5,15,842,407,435
Kentucky,Breckinridge County,5,16,584,268,316
Kentucky,Breckinridge County,5,17,385,169,216
Kentucky,Breckinridge County,5,18,317,114,203
Kentucky,Breckinridge County,6,0,20042,10090,9952
Kentucky,Breckinridge County,6,1,1127,615,512
Kentucky,Breckinridge County,6,2,1301,654,647
Kentucky,Breckinridge County,6,3,1419,754,665
Kentucky,Breckinridge County,6,4,1311,642,669
Kentucky,Breckinridge County,6,5,1099,580,519
Kentucky,Breckinridge County,6,6,961,517,444
Kentucky,Breckinridge County,6,7,1144,592,552
Kentucky,Breckinridge County,6,8,1072,553,519
Kentucky,Breckinridge County,6,9,1262,603,659
Kentucky,Breckinridge County,6,10,1389,688,701
Kentucky,Breckinridge County,6,11,1594,792,802
Kentucky,Breckinridge County,6,12,1550,782,768
Kentucky,Breckinridge County,6,13,1438,730,708
Kentucky,Breckinridge County,6,14,1162,579,583
Kentucky,Breckinridge County,6,15,884,435,449
Kentucky,Breckinridge County,6,16,608,290,318
Kentucky,Breckinridge County,6,17,396,162,234
Kentucky,Breckinridge County,6,18,325,122,203
Kentucky,Breckinridge County,7,0,19883,9960,9923
Kentucky,Breckinridge County,7,1,1110,598,512
Kentucky,Breckinridge County,7,2,1257,609,648
Kentucky,Breckinridge County,7,3,1372,750,622
Kentucky,Breckinridge County,7,4,1285,631,654
Kentucky,Breckinridge County,7,5,1073,577,496
Kentucky,Breckinridge County,7,6,973,523,450
Kentucky,Breckinridge County,7,7,1100,558,542
Kentucky,Breckinridge County,7,8,1092,548,544
Kentucky,Breckinridge County,7,9,1193,569,624
Kentucky,Breckinridge County,7,10,1335,656,679
Kentucky,Breckinridge County,7,11,1613,806,807
Kentucky,Breckinridge County,7,12,1538,773,765
Kentucky,Breckinridge County,7,13,1450,715,735
Kentucky,Breckinridge County,7,14,1231,627,604
Kentucky,Breckinridge County,7,15,886,432,454
Kentucky,Breckinridge County,7,16,654,309,345
Kentucky,Breckinridge County,7,17,397,155,242
Kentucky,Breckinridge County,7,18,324,124,200
Kentucky,Breckinridge County,8,0,19979,9994,9985
Kentucky,Breckinridge County,8,1,1104,578,526
Kentucky,Breckinridge County,8,2,1257,625,632
Kentucky,Breckinridge County,8,3,1359,733,626
Kentucky,Breckinridge County,8,4,1317,640,677
Kentucky,Breckinridge County,8,5,1083,605,478
Kentucky,Breckinridge County,8,6,1021,534,487
Kentucky,Breckinridge County,8,7,1084,546,538
Kentucky,Breckinridge County,8,8,1128,563,565
Kentucky,Breckinridge County,8,9,1139,574,565
Kentucky,Breckinridge County,8,10,1309,627,682
Kentucky,Breckinridge County,8,11,1547,771,776
Kentucky,Breckinridge County,8,12,1576,800,776
Kentucky,Breckinridge County,8,13,1454,707,747
Kentucky,Breckinridge County,8,14,1266,643,623
Kentucky,Breckinridge County,8,15,931,446,485
Kentucky,Breckinridge County,8,16,640,302,338
Kentucky,Breckinridge County,8,17,407,169,238
Kentucky,Breckinridge County,8,18,357,131,226
Kentucky,Breckinridge County,9,0,19982,10024,9958
Kentucky,Breckinridge County,9,1,1178,617,561
Kentucky,Breckinridge County,9,2,1222,630,592
Kentucky,Breckinridge County,9,3,1353,707,646
Kentucky,Breckinridge County,9,4,1293,651,642
Kentucky,Breckinridge County,9,5,1051,563,488
Kentucky,Breckinridge County,9,6,1048,559,489
Kentucky,Breckinridge County,9,7,1019,518,501
Kentucky,Breckinridge County,9,8,1166,574,592
Kentucky,Breckinridge County,9,9,1099,569,530
Kentucky,Breckinridge County,9,10,1270,597,673
Kentucky,Breckinridge County,9,11,1519,751,768
Kentucky,Breckinridge County,9,12,1577,809,768
Kentucky,Breckinridge County,9,13,1471,736,735
Kentucky,Breckinridge County,9,14,1337,670,667
Kentucky,Breckinridge County,9,15,954,473,481
Kentucky,Breckinridge County,9,16,643,295,348
Kentucky,Breckinridge County,9,17,423,179,244
Kentucky,Breckinridge County,9,18,359,126,233
Kentucky,Breckinridge County,10,0,20131,10124,10007
Kentucky,Breckinridge County,10,1,1199,620,579
Kentucky,Breckinridge County,10,2,1223,635,588
Kentucky,Breckinridge County,10,3,1371,686,685
Kentucky,Breckinridge County,10,4,1312,700,612
Kentucky,Breckinridge County,10,5,1026,551,475
Kentucky,Breckinridge County,10,6,1090,567,523
Kentucky,Breckinridge County,10,7,979,509,470
Kentucky,Breckinridge County,10,8,1197,596,601
Kentucky,Breckinridge County,10,9,1089,576,513
Kentucky,Breckinridge County,10,10,1290,601,689
Kentucky,Breckinridge County,10,11,1477,739,738
Kentucky,Breckinridge County,10,12,1578,794,784
Kentucky,Breckinridge County,10,13,1473,746,727
Kentucky,Breckinridge County,10,14,1331,658,673
Kentucky,Breckinridge County,10,15,1019,508,511
Kentucky,Breckinridge County,10,16,686,319,367
Kentucky,Breckinridge County,10,17,416,183,233
Kentucky,Breckinridge County,10,18,375,136,239
Kentucky,Breckinridge County,11,0,20309,10202,10107
Kentucky,Breckinridge County,11,1,1233,638,595
Kentucky,Breckinridge County,11,2,1204,640,564
Kentucky,Breckinridge County,11,3,1352,659,693
Kentucky,Breckinridge County,11,4,1280,707,573
Kentucky,Breckinridge County,11,5,1057,542,515
Kentucky,Breckinridge County,11,6,1106,580,526
Kentucky,Breckinridge County,11,7,1005,512,493
Kentucky,Breckinridge County,11,8,1216,620,596
Kentucky,Breckinridge County,11,9,1165,610,555
Kentucky,Breckinridge County,11,10,1277,597,680
Kentucky,Breckinridge County,11,11,1403,704,699
Kentucky,Breckinridge County,11,12,1584,797,787
Kentucky,Breckinridge County,11,13,1501,745,756
Kentucky,Breckinridge County,11,14,1335,666,669
Kentucky,Breckinridge County,11,15,1054,515,539
Kentucky,Breckinridge County,11,16,724,333,391
Kentucky,Breckinridge County,11,17,433,201,232
Kentucky,Breckinridge County,11,18,380,136,244
Kentucky,Breckinridge County,12,0,20477,10268,10209
Kentucky,Breckinridge County,12,1,1253,642,611
Kentucky,Breckinridge County,12,2,1190,623,567
Kentucky,Breckinridge County,12,3,1337,650,687
Kentucky,Breckinridge County,12,4,1264,691,573
Kentucky,Breckinridge County,12,5,1089,555,534
Kentucky,Breckinridge County,12,6,1145,613,532
Kentucky,Breckinridge County,12,7,1036,543,493
Kentucky,Breckinridge County,12,8,1177,588,589
Kentucky,Breckinridge County,12,9,1193,616,577
Kentucky,Breckinridge County,12,10,1231,595,636
Kentucky,Breckinridge County,12,11,1386,676,710
Kentucky,Breckinridge County,12,12,1602,806,796
Kentucky,Breckinridge County,12,13,1527,764,763
Kentucky,Breckinridge County,12,14,1355,653,702
Kentucky,Breckinridge County,12,15,1109,557,552
Kentucky,Breckinridge County,12,16,742,344,398
Kentucky,Breckinridge County,12,17,463,212,251
Kentucky,Breckinridge County,12,18,378,140,238
Kentucky,Bullitt County,1,0,74319,36782,37537
Kentucky,Bullitt County,1,1,4647,2338,2309
Kentucky,Bullitt County,1,2,5163,2661,2502
Kentucky,Bullitt County,1,3,5576,2804,2772
Kentucky,Bullitt County,1,4,5296,2753,2543
Kentucky,Bullitt County,1,5,4052,2062,1990
Kentucky,Bullitt County,1,6,4456,2201,2255
Kentucky,Bullitt County,1,7,4729,2328,2401
Kentucky,Bullitt County,1,8,5413,2659,2754
Kentucky,Bullitt County,1,9,5589,2786,2803
Kentucky,Bullitt County,1,10,6165,3064,3101
Kentucky,Bullitt County,1,11,5795,2877,2918
Kentucky,Bullitt County,1,12,4785,2358,2427
Kentucky,Bullitt County,1,13,4366,2118,2248
Kentucky,Bullitt County,1,14,3198,1577,1621
Kentucky,Bullitt County,1,15,2162,997,1165
Kentucky,Bullitt County,1,16,1473,650,823
Kentucky,Bullitt County,1,17,863,359,504
Kentucky,Bullitt County,1,18,591,190,401
Kentucky,Bullitt County,2,0,74308,36775,37533
Kentucky,Bullitt County,2,1,4648,2339,2309
Kentucky,Bullitt County,2,2,5163,2661,2502
Kentucky,Bullitt County,2,3,5576,2804,2772
Kentucky,Bullitt County,2,4,5293,2750,2543
Kentucky,Bullitt County,2,5,4052,2062,1990
Kentucky,Bullitt County,2,6,4456,2201,2255
Kentucky,Bullitt County,2,7,4730,2328,2402
Kentucky,Bullitt County,2,8,5411,2658,2753
Kentucky,Bullitt County,2,9,5587,2785,2802
Kentucky,Bullitt County,2,10,6166,3065,3101
Kentucky,Bullitt County,2,11,5796,2877,2919
Kentucky,Bullitt County,2,12,4783,2357,2426
Kentucky,Bullitt County,2,13,4364,2116,2248
Kentucky,Bullitt County,2,14,3195,1576,1619
Kentucky,Bullitt County,2,15,2161,997,1164
Kentucky,Bullitt County,2,16,1473,650,823
Kentucky,Bullitt County,2,17,863,359,504
Kentucky,Bullitt County,2,18,591,190,401
Kentucky,Bullitt County,3,0,74500,36867,37633
Kentucky,Bullitt County,3,1,4626,2344,2282
Kentucky,Bullitt County,3,2,5154,2645,2509
Kentucky,Bullitt County,3,3,5579,2792,2787
Kentucky,Bullitt County,3,4,5264,2742,2522
Kentucky,Bullitt County,3,5,4113,2097,2016
Kentucky,Bullitt County,3,6,4463,2200,2263
Kentucky,Bullitt County,3,7,4759,2345,2414
Kentucky,Bullitt County,3,8,5357,2624,2733
Kentucky,Bullitt County,3,9,5601,2794,2807
Kentucky,Bullitt County,3,10,6154,3052,3102
Kentucky,Bullitt County,3,11,5823,2901,2922
Kentucky,Bullitt County,3,12,4816,2371,2445
Kentucky,Bullitt County,3,13,4414,2147,2267
Kentucky,Bullitt County,3,14,3223,1585,1638
Kentucky,Bullitt County,3,15,2184,1014,1170
Kentucky,Bullitt County,3,16,1493,657,836
Kentucky,Bullitt County,3,17,873,362,511
Kentucky,Bullitt County,3,18,604,195,409
Kentucky,Bullitt County,4,0,75195,37211,37984
Kentucky,Bullitt County,4,1,4483,2285,2198
Kentucky,Bullitt County,4,2,5106,2638,2468
Kentucky,Bullitt County,4,3,5577,2789,2788
Kentucky,Bullitt County,4,4,5145,2703,2442
Kentucky,Bullitt County,4,5,4350,2189,2161
Kentucky,Bullitt County,4,6,4412,2153,2259
Kentucky,Bullitt County,4,7,4869,2437,2432
Kentucky,Bullitt County,4,8,5111,2505,2606
Kentucky,Bullitt County,4,9,5727,2856,2871
Kentucky,Bullitt County,4,10,6067,2987,3080
Kentucky,Bullitt County,4,11,5880,2942,2938
Kentucky,Bullitt County,4,12,5016,2450,2566
Kentucky,Bullitt County,4,13,4638,2247,2391
Kentucky,Bullitt County,4,14,3364,1654,1710
Kentucky,Bullitt County,4,15,2285,1064,1221
Kentucky,Bullitt County,4,16,1563,694,869
Kentucky,Bullitt County,4,17,929,397,532
Kentucky,Bullitt County,4,18,673,221,452
Kentucky,Bullitt County,5,0,75902,37616,38286
Kentucky,Bullitt County,5,1,4322,2217,2105
Kentucky,Bullitt County,5,2,5074,2620,2454
Kentucky,Bullitt County,5,3,5541,2809,2732
Kentucky,Bullitt County,5,4,5135,2661,2474
Kentucky,Bullitt County,5,5,4555,2323,2232
Kentucky,Bullitt County,5,6,4372,2142,2230
Kentucky,Bullitt County,5,7,4883,2434,2449
Kentucky,Bullitt County,5,8,5019,2443,2576
Kentucky,Bullitt County,5,9,5787,2896,2891
Kentucky,Bullitt County,5,10,5992,2934,3058
Kentucky,Bullitt County,5,11,5937,3000,2937
Kentucky,Bullitt County,5,12,5263,2577,2686
Kentucky,Bullitt County,5,13,4523,2171,2352
Kentucky,Bullitt County,5,14,3712,1842,1870
Kentucky,Bullitt County,5,15,2451,1146,1305
Kentucky,Bullitt County,5,16,1611,723,888
Kentucky,Bullitt County,5,17,987,420,567
Kentucky,Bullitt County,5,18,738,258,480
Kentucky,Bullitt County,6,0,76878,38214,38664
Kentucky,Bullitt County,6,1,4189,2221,1968
Kentucky,Bullitt County,6,2,5026,2595,2431
Kentucky,Bullitt County,6,3,5565,2828,2737
Kentucky,Bullitt County,6,4,5128,2600,2528
Kentucky,Bullitt County,6,5,4746,2441,2305
Kentucky,Bullitt County,6,6,4455,2224,2231
Kentucky,Bullitt County,6,7,4932,2443,2489
Kentucky,Bullitt County,6,8,5049,2479,2570
Kentucky,Bullitt County,6,9,5728,2862,2866
Kentucky,Bullitt County,6,10,5927,2907,3020
Kentucky,Bullitt County,6,11,6054,3061,2993
Kentucky,Bullitt County,6,12,5499,2711,2788
Kentucky,Bullitt County,6,13,4536,2176,2360
Kentucky,Bullitt County,6,14,3845,1892,1953
Kentucky,Bullitt County,6,15,2681,1281,1400
Kentucky,Bullitt County,6,16,1670,751,919
Kentucky,Bullitt County,6,17,1057,450,607
Kentucky,Bullitt County,6,18,791,292,499
Kentucky,Bullitt County,7,0,78023,38680,39343
Kentucky,Bullitt County,7,1,4213,2211,2002
Kentucky,Bullitt County,7,2,4974,2556,2418
Kentucky,Bullitt County,7,3,5510,2833,2677
Kentucky,Bullitt County,7,4,5086,2552,2534
Kentucky,Bullitt County,7,5,4883,2491,2392
Kentucky,Bullitt County,7,6,4699,2359,2340
Kentucky,Bullitt County,7,7,5000,2461,2539
Kentucky,Bullitt County,7,8,5076,2478,2598
Kentucky,Bullitt County,7,9,5656,2806,2850
Kentucky,Bullitt County,7,10,5750,2836,2914
Kentucky,Bullitt County,7,11,6244,3129,3115
Kentucky,Bullitt County,7,12,5632,2757,2875
Kentucky,Bullitt County,7,13,4658,2284,2374
Kentucky,Bullitt County,7,14,4035,1958,2077
Kentucky,Bullitt County,7,15,2871,1384,1487
Kentucky,Bullitt County,7,16,1772,798,974
Kentucky,Bullitt County,7,17,1139,481,658
Kentucky,Bullitt County,7,18,825,306,519
Kentucky,Bullitt County,8,0,78677,38976,39701
Kentucky,Bullitt County,8,1,4164,2229,1935
Kentucky,Bullitt County,8,2,4939,2520,2419
Kentucky,Bullitt County,8,3,5479,2800,2679
Kentucky,Bullitt County,8,4,5043,2528,2515
Kentucky,Bullitt County,8,5,4812,2482,2330
Kentucky,Bullitt County,8,6,4920,2462,2458
Kentucky,Bullitt County,8,7,4961,2414,2547
Kentucky,Bullitt County,8,8,5082,2492,2590
Kentucky,Bullitt County,8,9,5596,2750,2846
Kentucky,Bullitt County,8,10,5670,2828,2842
Kentucky,Bullitt County,8,11,6276,3120,3156
Kentucky,Bullitt County,8,12,5794,2873,2921
Kentucky,Bullitt County,8,13,4715,2294,2421
Kentucky,Bullitt County,8,14,4218,2032,2186
Kentucky,Bullitt County,8,15,3016,1459,1557
Kentucky,Bullitt County,8,16,1920,860,1060
Kentucky,Bullitt County,8,17,1167,496,671
Kentucky,Bullitt County,8,18,905,337,568
Kentucky,Bullitt County,9,0,79222,39319,39903
Kentucky,Bullitt County,9,1,4141,2198,1943
Kentucky,Bullitt County,9,2,4963,2542,2421
Kentucky,Bullitt County,9,3,5331,2699,2632
Kentucky,Bullitt County,9,4,5068,2593,2475
Kentucky,Bullitt County,9,5,4667,2428,2239
Kentucky,Bullitt County,9,6,5162,2594,2568
Kentucky,Bullitt County,9,7,4926,2389,2537
Kentucky,Bullitt County,9,8,5205,2613,2592
Kentucky,Bullitt County,9,9,5319,2591,2728
Kentucky,Bullitt County,9,10,5770,2911,2859
Kentucky,Bullitt County,9,11,6181,3024,3157
Kentucky,Bullitt County,9,12,5868,2921,2947
Kentucky,Bullitt County,9,13,4837,2356,2481
Kentucky,Bullitt County,9,14,4452,2149,2303
Kentucky,Bullitt County,9,15,3123,1486,1637
Kentucky,Bullitt County,9,16,2007,927,1080
Kentucky,Bullitt County,9,17,1228,526,702
Kentucky,Bullitt County,9,18,974,372,602
Kentucky,Bullitt County,10,0,80269,39857,40412
Kentucky,Bullitt County,10,1,4256,2242,2014
Kentucky,Bullitt County,10,2,4874,2496,2378
Kentucky,Bullitt County,10,3,5385,2733,2652
Kentucky,Bullitt County,10,4,5063,2619,2444
Kentucky,Bullitt County,10,5,4666,2401,2265
Kentucky,Bullitt County,10,6,5292,2646,2646
Kentucky,Bullitt County,10,7,4978,2412,2566
Kentucky,Bullitt County,10,8,5371,2711,2660
Kentucky,Bullitt County,10,9,5230,2558,2672
Kentucky,Bullitt County,10,10,5807,2931,2876
Kentucky,Bullitt County,10,11,6104,2979,3125
Kentucky,Bullitt County,10,12,5929,2953,2976
Kentucky,Bullitt County,10,13,5108,2505,2603
Kentucky,Bullitt County,10,14,4369,2087,2282
Kentucky,Bullitt County,10,15,3421,1646,1775
Kentucky,Bullitt County,10,16,2141,990,1151
Kentucky,Bullitt County,10,17,1232,541,691
Kentucky,Bullitt County,10,18,1043,407,636
Kentucky,Bullitt County,11,0,81009,40305,40704
Kentucky,Bullitt County,11,1,4273,2219,2054
Kentucky,Bullitt County,11,2,4818,2540,2278
Kentucky,Bullitt County,11,3,5303,2705,2598
Kentucky,Bullitt County,11,4,5064,2624,2440
Kentucky,Bullitt County,11,5,4582,2322,2260
Kentucky,Bullitt County,11,6,5497,2792,2705
Kentucky,Bullitt County,11,7,4986,2462,2524
Kentucky,Bullitt County,11,8,5417,2709,2708
Kentucky,Bullitt County,11,9,5306,2633,2673
Kentucky,Bullitt County,11,10,5766,2875,2891
Kentucky,Bullitt County,11,11,5984,2931,3053
Kentucky,Bullitt County,11,12,6009,2996,3013
Kentucky,Bullitt County,11,13,5310,2592,2718
Kentucky,Bullitt County,11,14,4401,2087,2314
Kentucky,Bullitt County,11,15,3507,1685,1822
Kentucky,Bullitt County,11,16,2373,1122,1251
Kentucky,Bullitt County,11,17,1312,580,732
Kentucky,Bullitt County,11,18,1101,431,670
Kentucky,Bullitt County,12,0,81676,40599,41077
Kentucky,Bullitt County,12,1,4249,2184,2065
Kentucky,Bullitt County,12,2,4722,2484,2238
Kentucky,Bullitt County,12,3,5312,2694,2618
Kentucky,Bullitt County,12,4,5056,2637,2419
Kentucky,Bullitt County,12,5,4491,2278,2213
Kentucky,Bullitt County,12,6,5602,2830,2772
Kentucky,Bullitt County,12,7,5071,2552,2519
Kentucky,Bullitt County,12,8,5439,2697,2742
Kentucky,Bullitt County,12,9,5428,2687,2741
Kentucky,Bullitt County,12,10,5671,2827,2844
Kentucky,Bullitt County,12,11,5856,2908,2948
Kentucky,Bullitt County,12,12,6109,3013,3096
Kentucky,Bullitt County,12,13,5454,2632,2822
Kentucky,Bullitt County,12,14,4436,2157,2279
Kentucky,Bullitt County,12,15,3655,1707,1948
Kentucky,Bullitt County,12,16,2559,1228,1331
Kentucky,Bullitt County,12,17,1431,628,803
Kentucky,Bullitt County,12,18,1135,456,679
Kentucky,Butler County,1,0,12690,6358,6332
Kentucky,Butler County,1,1,799,421,378
Kentucky,Butler County,1,2,808,416,392
Kentucky,Butler County,1,3,822,418,404
Kentucky,Butler County,1,4,778,436,342
Kentucky,Butler County,1,5,755,370,385
Kentucky,Butler County,1,6,811,415,396
Kentucky,Butler County,1,7,764,389,375
Kentucky,Butler County,1,8,792,411,381
Kentucky,Butler County,1,9,818,413,405
Kentucky,Butler County,1,10,957,495,462
Kentucky,Butler County,1,11,960,465,495
Kentucky,Butler County,1,12,871,420,451
Kentucky,Butler County,1,13,750,369,381
Kentucky,Butler County,1,14,687,353,334
Kentucky,Butler County,1,15,477,226,251
Kentucky,Butler County,1,16,360,161,199
Kentucky,Butler County,1,17,252,108,144
Kentucky,Butler County,1,18,229,72,157
Kentucky,Butler County,2,0,12697,6360,6337
Kentucky,Butler County,2,1,800,421,379
Kentucky,Butler County,2,2,809,416,393
Kentucky,Butler County,2,3,822,418,404
Kentucky,Butler County,2,4,778,436,342
Kentucky,Butler County,2,5,755,370,385
Kentucky,Butler County,2,6,813,416,397
Kentucky,Butler County,2,7,765,389,376
Kentucky,Butler County,2,8,792,411,381
Kentucky,Butler County,2,9,818,413,405
Kentucky,Butler County,2,10,957,495,462
Kentucky,Butler County,2,11,962,466,496
Kentucky,Butler County,2,12,871,420,451
Kentucky,Butler County,2,13,750,369,381
Kentucky,Butler County,2,14,687,353,334
Kentucky,Butler County,2,15,477,226,251
Kentucky,Butler County,2,16,360,161,199
Kentucky,Butler County,2,17,252,108,144
Kentucky,Butler County,2,18,229,72,157
Kentucky,Butler County,3,0,12735,6379,6356
Kentucky,Butler County,3,1,799,424,375
Kentucky,Butler County,3,2,812,415,397
Kentucky,Butler County,3,3,829,425,404
Kentucky,Butler County,3,4,769,424,345
Kentucky,Butler County,3,5,758,375,383
Kentucky,Butler County,3,6,804,409,395
Kentucky,Butler County,3,7,778,396,382
Kentucky,Butler County,3,8,796,416,380
Kentucky,Butler County,3,9,816,412,404
Kentucky,Butler County,3,10,963,496,467
Kentucky,Butler County,3,11,950,459,491
Kentucky,Butler County,3,12,890,435,455
Kentucky,Butler County,3,13,744,366,378
Kentucky,Butler County,3,14,691,353,338
Kentucky,Butler County,3,15,487,228,259
Kentucky,Butler County,3,16,363,164,199
Kentucky,Butler County,3,17,254,109,145
Kentucky,Butler County,3,18,232,73,159
Kentucky,Butler County,4,0,12718,6342,6376
Kentucky,Butler County,4,1,808,408,400
Kentucky,Butler County,4,2,798,407,391
Kentucky,Butler County,4,3,809,414,395
Kentucky,Butler County,4,4,765,411,354
Kentucky,Butler County,4,5,734,375,359
Kentucky,Butler County,4,6,788,391,397
Kentucky,Butler County,4,7,792,404,388
Kentucky,Butler County,4,8,781,408,373
Kentucky,Butler County,4,9,821,412,409
Kentucky,Butler County,4,10,943,477,466
Kentucky,Butler County,4,11,924,445,479
Kentucky,Butler County,4,12,939,466,473
Kentucky,Butler County,4,13,771,386,385
Kentucky,Butler County,4,14,691,344,347
Kentucky,Butler County,4,15,515,239,276
Kentucky,Butler County,4,16,362,173,189
Kentucky,Butler County,4,17,244,106,138
Kentucky,Butler County,4,18,233,76,157
Kentucky,Butler County,5,0,12738,6368,6370
Kentucky,Butler County,5,1,784,400,384
Kentucky,Butler County,5,2,850,441,409
Kentucky,Butler County,5,3,815,410,405
Kentucky,Butler County,5,4,758,413,345
Kentucky,Butler County,5,5,709,373,336
Kentucky,Butler County,5,6,805,392,413
Kentucky,Butler County,5,7,782,391,391
Kentucky,Butler County,5,8,756,390,366
Kentucky,Butler County,5,9,847,443,404
Kentucky,Butler County,5,10,894,441,453
Kentucky,Butler County,5,11,905,450,455
Kentucky,Butler County,5,12,944,456,488
Kentucky,Butler County,5,13,783,402,381
Kentucky,Butler County,5,14,722,353,369
Kentucky,Butler County,5,15,532,259,273
Kentucky,Butler County,5,16,373,181,192
Kentucky,Butler County,5,17,238,94,144
Kentucky,Butler County,5,18,241,79,162
Kentucky,Butler County,6,0,12704,6359,6345
Kentucky,Butler County,6,1,772,387,385
Kentucky,Butler County,6,2,827,434,393
Kentucky,Butler County,6,3,826,419,407
Kentucky,Butler County,6,4,748,404,344
Kentucky,Butler County,6,5,662,346,316
Kentucky,Butler County,6,6,767,372,395
Kentucky,Butler County,6,7,830,416,414
Kentucky,Butler County,6,8,762,403,359
Kentucky,Butler County,6,9,844,448,396
Kentucky,Butler County,6,10,833,404,429
Kentucky,Butler County,6,11,910,467,443
Kentucky,Butler County,6,12,950,456,494
Kentucky,Butler County,6,13,819,407,412
Kentucky,Butler County,6,14,727,361,366
Kentucky,Butler County,6,15,560,288,272
Kentucky,Butler County,6,16,386,175,211
Kentucky,Butler County,6,17,243,102,141
Kentucky,Butler County,6,18,238,70,168
Kentucky,Butler County,7,0,12736,6394,6342
Kentucky,Butler County,7,1,803,422,381
Kentucky,Butler County,7,2,793,406,387
Kentucky,Butler County,7,3,814,421,393
Kentucky,Butler County,7,4,754,400,354
Kentucky,Butler County,7,5,665,340,325
Kentucky,Butler County,7,6,749,357,392
Kentucky,Butler County,7,7,849,440,409
Kentucky,Butler County,7,8,760,396,364
Kentucky,Butler County,7,9,846,456,390
Kentucky,Butler County,7,10,798,392,406
Kentucky,Butler County,7,11,953,488,465
Kentucky,Butler County,7,12,937,460,477
Kentucky,Butler County,7,13,833,408,425
Kentucky,Butler County,7,14,709,351,358
Kentucky,Butler County,7,15,581,297,284
Kentucky,Butler County,7,16,393,181,212
Kentucky,Butler County,7,17,249,107,142
Kentucky,Butler County,7,18,250,72,178
Kentucky,Butler County,8,0,12734,6387,6347
Kentucky,Butler County,8,1,804,425,379
Kentucky,Butler County,8,2,792,416,376
Kentucky,Butler County,8,3,818,415,403
Kentucky,Butler County,8,4,770,411,359
Kentucky,Butler County,8,5,623,320,303
Kentucky,Butler County,8,6,755,367,388
Kentucky,Butler County,8,7,810,411,399
Kentucky,Butler County,8,8,786,405,381
Kentucky,Butler County,8,9,808,428,380
Kentucky,Butler County,8,10,806,413,393
Kentucky,Butler County,8,11,954,483,471
Kentucky,Butler County,8,12,904,438,466
Kentucky,Butler County,8,13,881,435,446
Kentucky,Butler County,8,14,714,353,361
Kentucky,Butler County,8,15,600,302,298
Kentucky,Butler County,8,16,395,177,218
Kentucky,Butler County,8,17,252,119,133
Kentucky,Butler County,8,18,262,69,193
Kentucky,Butler County,9,0,12686,6387,6299
Kentucky,Butler County,9,1,772,403,369
Kentucky,Butler County,9,2,776,409,367
Kentucky,Butler County,9,3,810,410,400
Kentucky,Butler County,9,4,764,411,353
Kentucky,Butler County,9,5,599,292,307
Kentucky,Butler County,9,6,753,400,353
Kentucky,Butler County,9,7,780,391,389
Kentucky,Butler County,9,8,806,421,385
Kentucky,Butler County,9,9,805,420,385
Kentucky,Butler County,9,10,811,409,402
Kentucky,Butler County,9,11,939,470,469
Kentucky,Butler County,9,12,890,442,448
Kentucky,Butler County,9,13,922,454,468
Kentucky,Butler County,9,14,725,365,360
Kentucky,Butler County,9,15,603,303,300
Kentucky,Butler County,9,16,424,195,229
Kentucky,Butler County,9,17,258,121,137
Kentucky,Butler County,9,18,249,71,178
Kentucky,Butler County,10,0,12778,6418,6360
Kentucky,Butler County,10,1,793,411,382
Kentucky,Butler County,10,2,783,406,377
Kentucky,Butler County,10,3,840,437,403
Kentucky,Butler County,10,4,748,407,341
Kentucky,Butler County,10,5,605,292,313
Kentucky,Butler County,10,6,784,413,371
Kentucky,Butler County,10,7,759,380,379
Kentucky,Butler County,10,8,840,431,409
Kentucky,Butler County,10,9,777,406,371
Kentucky,Butler County,10,10,841,438,403
Kentucky,Butler County,10,11,899,426,473
Kentucky,Butler County,10,12,889,451,438
Kentucky,Butler County,10,13,915,438,477
Kentucky,Butler County,10,14,748,379,369
Kentucky,Butler County,10,15,618,303,315
Kentucky,Butler County,10,16,431,201,230
Kentucky,Butler County,10,17,263,126,137
Kentucky,Butler County,10,18,245,73,172
Kentucky,Butler County,11,0,12743,6409,6334
Kentucky,Butler County,11,1,813,432,381
Kentucky,Butler County,11,2,785,401,384
Kentucky,Butler County,11,3,789,409,380
Kentucky,Butler County,11,4,739,399,340
Kentucky,Butler County,11,5,620,308,312
Kentucky,Butler County,11,6,754,388,366
Kentucky,Butler County,11,7,767,374,393
Kentucky,Butler County,11,8,829,437,392
Kentucky,Butler County,11,9,785,413,372
Kentucky,Butler County,11,10,833,445,388
Kentucky,Butler County,11,11,844,396,448
Kentucky,Butler County,11,12,897,455,442
Kentucky,Butler County,11,13,927,447,480
Kentucky,Butler County,11,14,771,384,387
Kentucky,Butler County,11,15,600,300,300
Kentucky,Butler County,11,16,466,226,240
Kentucky,Butler County,11,17,265,112,153
Kentucky,Butler County,11,18,259,83,176
Kentucky,Butler County,12,0,12879,6459,6420
Kentucky,Butler County,12,1,792,403,389
Kentucky,Butler County,12,2,823,421,402
Kentucky,Butler County,12,3,787,419,368
Kentucky,Butler County,12,4,754,410,344
Kentucky,Butler County,12,5,642,319,323
Kentucky,Butler County,12,6,763,381,382
Kentucky,Butler County,12,7,787,382,405
Kentucky,Butler County,12,8,831,440,391
Kentucky,Butler County,12,9,797,423,374
Kentucky,Butler County,12,10,815,424,391
Kentucky,Butler County,12,11,790,381,409
Kentucky,Butler County,12,12,959,481,478
Kentucky,Butler County,12,13,913,441,472
Kentucky,Butler County,12,14,803,402,401
Kentucky,Butler County,12,15,589,291,298
Kentucky,Butler County,12,16,499,242,257
Kentucky,Butler County,12,17,280,118,162
Kentucky,Butler County,12,18,255,81,174
Kentucky,Caldwell County,1,0,12984,6258,6726
Kentucky,Caldwell County,1,1,788,402,386
Kentucky,Caldwell County,1,2,762,351,411
Kentucky,Caldwell County,1,3,797,417,380
Kentucky,Caldwell County,1,4,841,445,396
Kentucky,Caldwell County,1,5,657,319,338
Kentucky,Caldwell County,1,6,684,326,358
Kentucky,Caldwell County,1,7,660,299,361
Kentucky,Caldwell County,1,8,868,443,425
Kentucky,Caldwell County,1,9,794,416,378
Kentucky,Caldwell County,1,10,934,462,472
Kentucky,Caldwell County,1,11,979,479,500
Kentucky,Caldwell County,1,12,959,459,500
Kentucky,Caldwell County,1,13,947,449,498
Kentucky,Caldwell County,1,14,721,351,370
Kentucky,Caldwell County,1,15,566,271,295
Kentucky,Caldwell County,1,16,428,160,268
Kentucky,Caldwell County,1,17,308,119,189
Kentucky,Caldwell County,1,18,291,90,201
Kentucky,Caldwell County,2,0,12989,6260,6729
Kentucky,Caldwell County,2,1,788,402,386
Kentucky,Caldwell County,2,2,762,351,411
Kentucky,Caldwell County,2,3,797,417,380
Kentucky,Caldwell County,2,4,842,445,397
Kentucky,Caldwell County,2,5,657,319,338
Kentucky,Caldwell County,2,6,684,326,358
Kentucky,Caldwell County,2,7,660,299,361
Kentucky,Caldwell County,2,8,868,443,425
Kentucky,Caldwell County,2,9,794,416,378
Kentucky,Caldwell County,2,10,934,462,472
Kentucky,Caldwell County,2,11,979,479,500
Kentucky,Caldwell County,2,12,959,459,500
Kentucky,Caldwell County,2,13,948,449,499
Kentucky,Caldwell County,2,14,723,352,371
Kentucky,Caldwell County,2,15,566,271,295
Kentucky,Caldwell County,2,16,429,161,268
Kentucky,Caldwell County,2,17,308,119,189
Kentucky,Caldwell County,2,18,291,90,201
Kentucky,Caldwell County,3,0,13010,6274,6736
Kentucky,Caldwell County,3,1,792,400,392
Kentucky,Caldwell County,3,2,760,352,408
Kentucky,Caldwell County,3,3,800,422,378
Kentucky,Caldwell County,3,4,840,448,392
Kentucky,Caldwell County,3,5,663,324,339
Kentucky,Caldwell County,3,6,689,328,361
Kentucky,Caldwell County,3,7,655,296,359
Kentucky,Caldwell County,3,8,854,431,423
Kentucky,Caldwell County,3,9,807,427,380
Kentucky,Caldwell County,3,10,928,456,472
Kentucky,Caldwell County,3,11,981,477,504
Kentucky,Caldwell County,3,12,958,459,499
Kentucky,Caldwell County,3,13,947,455,492
Kentucky,Caldwell County,3,14,727,351,376
Kentucky,Caldwell County,3,15,572,273,299
Kentucky,Caldwell County,3,16,428,162,266
Kentucky,Caldwell County,3,17,313,122,191
Kentucky,Caldwell County,3,18,296,91,205
Kentucky,Caldwell County,4,0,13027,6333,6694
Kentucky,Caldwell County,4,1,806,417,389
Kentucky,Caldwell County,4,2,765,374,391
Kentucky,Caldwell County,4,3,816,424,392
Kentucky,Caldwell County,4,4,778,424,354
Kentucky,Caldwell County,4,5,690,331,359
Kentucky,Caldwell County,4,6,681,336,345
Kentucky,Caldwell County,4,7,657,304,353
Kentucky,Caldwell County,4,8,795,393,402
Kentucky,Caldwell County,4,9,865,466,399
Kentucky,Caldwell County,4,10,887,431,456
Kentucky,Caldwell County,4,11,967,472,495
Kentucky,Caldwell County,4,12,970,466,504
Kentucky,Caldwell County,4,13,962,478,484
Kentucky,Caldwell County,4,14,738,344,394
Kentucky,Caldwell County,4,15,587,276,311
Kentucky,Caldwell County,4,16,444,178,266
Kentucky,Caldwell County,4,17,316,125,191
Kentucky,Caldwell County,4,18,303,94,209
Kentucky,Caldwell County,5,0,12992,6297,6695
Kentucky,Caldwell County,5,1,802,406,396
Kentucky,Caldwell County,5,2,791,395,396
Kentucky,Caldwell County,5,3,812,418,394
Kentucky,Caldwell County,5,4,784,423,361
Kentucky,Caldwell County,5,5,699,352,347
Kentucky,Caldwell County,5,6,674,322,352
Kentucky,Caldwell County,5,7,665,316,349
Kentucky,Caldwell County,5,8,758,373,385
Kentucky,Caldwell County,5,9,903,460,443
Kentucky,Caldwell County,5,10,846,421,425
Kentucky,Caldwell County,5,11,925,461,464
Kentucky,Caldwell County,5,12,984,465,519
Kentucky,Caldwell County,5,13,913,443,470
Kentucky,Caldwell County,5,14,781,361,420
Kentucky,Caldwell County,5,15,596,281,315
Kentucky,Caldwell County,5,16,446,188,258
Kentucky,Caldwell County,5,17,324,119,205
Kentucky,Caldwell County,5,18,289,93,196
Kentucky,Caldwell County,6,0,12887,6226,6661
Kentucky,Caldwell County,6,1,776,393,383
Kentucky,Caldwell County,6,2,790,394,396
Kentucky,Caldwell County,6,3,815,413,402
Kentucky,Caldwell County,6,4,772,412,360
Kentucky,Caldwell County,6,5,717,372,345
Kentucky,Caldwell County,6,6,646,306,340
Kentucky,Caldwell County,6,7,657,318,339
Kentucky,Caldwell County,6,8,754,351,403
Kentucky,Caldwell County,6,9,875,443,432
Kentucky,Caldwell County,6,10,819,410,409
Kentucky,Caldwell County,6,11,929,470,459
Kentucky,Caldwell County,6,12,969,455,514
Kentucky,Caldwell County,6,13,890,427,463
Kentucky,Caldwell County,6,14,800,372,428
Kentucky,Caldwell County,6,15,622,291,331
Kentucky,Caldwell County,6,16,437,199,238
Kentucky,Caldwell County,6,17,339,118,221
Kentucky,Caldwell County,6,18,280,82,198
Kentucky,Caldwell County,7,0,12848,6216,6632
Kentucky,Caldwell County,7,1,793,407,386
Kentucky,Caldwell County,7,2,819,407,412
Kentucky,Caldwell County,7,3,786,394,392
Kentucky,Caldwell County,7,4,755,388,367
Kentucky,Caldwell County,7,5,743,390,353
Kentucky,Caldwell County,7,6,669,316,353
Kentucky,Caldwell County,7,7,647,318,329
Kentucky,Caldwell County,7,8,714,330,384
Kentucky,Caldwell County,7,9,866,442,424
Kentucky,Caldwell County,7,10,788,405,383
Kentucky,Caldwell County,7,11,895,450,445
Kentucky,Caldwell County,7,12,959,457,502
Kentucky,Caldwell County,7,13,894,423,471
Kentucky,Caldwell County,7,14,827,392,435
Kentucky,Caldwell County,7,15,622,284,338
Kentucky,Caldwell County,7,16,445,210,235
Kentucky,Caldwell County,7,17,342,115,227
Kentucky,Caldwell County,7,18,284,88,196
Kentucky,Caldwell County,8,0,12748,6175,6573
Kentucky,Caldwell County,8,1,767,395,372
Kentucky,Caldwell County,8,2,814,412,402
Kentucky,Caldwell County,8,3,782,387,395
Kentucky,Caldwell County,8,4,757,401,356
Kentucky,Caldwell County,8,5,733,384,349
Kentucky,Caldwell County,8,6,710,339,371
Kentucky,Caldwell County,8,7,648,315,333
Kentucky,Caldwell County,8,8,684,317,367
Kentucky,Caldwell County,8,9,843,423,420
Kentucky,Caldwell County,8,10,779,405,374
Kentucky,Caldwell County,8,11,868,419,449
Kentucky,Caldwell County,8,12,956,462,494
Kentucky,Caldwell County,8,13,894,424,470
Kentucky,Caldwell County,8,14,850,397,453
Kentucky,Caldwell County,8,15,611,290,321
Kentucky,Caldwell County,8,16,438,204,234
Kentucky,Caldwell County,8,17,331,116,215
Kentucky,Caldwell County,8,18,283,85,198
Kentucky,Caldwell County,9,0,12634,6122,6512
Kentucky,Caldwell County,9,1,746,380,366
Kentucky,Caldwell County,9,2,795,383,412
Kentucky,Caldwell County,9,3,765,376,389
Kentucky,Caldwell County,9,4,761,401,360
Kentucky,Caldwell County,9,5,680,354,326
Kentucky,Caldwell County,9,6,742,360,382
Kentucky,Caldwell County,9,7,642,319,323
Kentucky,Caldwell County,9,8,659,307,352
Kentucky,Caldwell County,9,9,802,405,397
Kentucky,Caldwell County,9,10,829,434,395
Kentucky,Caldwell County,9,11,818,401,417
Kentucky,Caldwell County,9,12,934,452,482
Kentucky,Caldwell County,9,13,890,426,464
Kentucky,Caldwell County,9,14,849,409,440
Kentucky,Caldwell County,9,15,632,287,345
Kentucky,Caldwell County,9,16,463,212,251
Kentucky,Caldwell County,9,17,328,120,208
Kentucky,Caldwell County,9,18,299,96,203
Kentucky,Caldwell County,10,0,12666,6132,6534
Kentucky,Caldwell County,10,1,756,398,358
Kentucky,Caldwell County,10,2,774,390,384
Kentucky,Caldwell County,10,3,811,408,403
Kentucky,Caldwell County,10,4,736,384,352
Kentucky,Caldwell County,10,5,662,342,320
Kentucky,Caldwell County,10,6,764,354,410
Kentucky,Caldwell County,10,7,662,309,353
Kentucky,Caldwell County,10,8,667,328,339
Kentucky,Caldwell County,10,9,788,385,403
Kentucky,Caldwell County,10,10,850,433,417
Kentucky,Caldwell County,10,11,767,382,385
Kentucky,Caldwell County,10,12,909,451,458
Kentucky,Caldwell County,10,13,906,427,479
Kentucky,Caldwell County,10,14,818,392,426
Kentucky,Caldwell County,10,15,662,294,368
Kentucky,Caldwell County,10,16,470,221,249
Kentucky,Caldwell County,10,17,328,123,205
Kentucky,Caldwell County,10,18,336,111,225
Kentucky,Caldwell County,11,0,12716,6135,6581
Kentucky,Caldwell County,11,1,720,374,346
Kentucky,Caldwell County,11,2,797,409,388
Kentucky,Caldwell County,11,3,804,402,402
Kentucky,Caldwell County,11,4,775,390,385
Kentucky,Caldwell County,11,5,653,335,318
Kentucky,Caldwell County,11,6,797,383,414
Kentucky,Caldwell County,11,7,668,301,367
Kentucky,Caldwell County,11,8,670,331,339
Kentucky,Caldwell County,11,9,762,372,390
Kentucky,Caldwell County,11,10,840,427,413
Kentucky,Caldwell County,11,11,772,382,390
Kentucky,Caldwell County,11,12,890,444,446
Kentucky,Caldwell County,11,13,895,431,464
Kentucky,Caldwell County,11,14,807,376,431
Kentucky,Caldwell County,11,15,682,303,379
Kentucky,Caldwell County,11,16,492,224,268
Kentucky,Caldwell County,11,17,329,137,192
Kentucky,Caldwell County,11,18,363,114,249
Kentucky,Caldwell County,12,0,12747,6188,6559
Kentucky,Caldwell County,12,1,743,395,348
Kentucky,Caldwell County,12,2,800,403,397
Kentucky,Caldwell County,12,3,847,435,412
Kentucky,Caldwell County,12,4,731,369,362
Kentucky,Caldwell County,12,5,632,311,321
Kentucky,Caldwell County,12,6,815,416,399
Kentucky,Caldwell County,12,7,701,324,377
Kentucky,Caldwell County,12,8,673,336,337
Kentucky,Caldwell County,12,9,701,335,366
Kentucky,Caldwell County,12,10,845,433,412
Kentucky,Caldwell County,12,11,782,391,391
Kentucky,Caldwell County,12,12,863,425,438
Kentucky,Caldwell County,12,13,895,439,456
Kentucky,Caldwell County,12,14,812,366,446
Kentucky,Caldwell County,12,15,709,329,380
Kentucky,Caldwell County,12,16,475,207,268
Kentucky,Caldwell County,12,17,342,156,186
Kentucky,Caldwell County,12,18,381,118,263
Kentucky,Calloway County,1,0,37191,17925,19266
Kentucky,Calloway County,1,1,1942,966,976
Kentucky,Calloway County,1,2,1778,908,870
Kentucky,Calloway County,1,3,1832,909,923
Kentucky,Calloway County,1,4,3307,1472,1835
Kentucky,Calloway County,1,5,5635,2677,2958
Kentucky,Calloway County,1,6,2486,1323,1163
Kentucky,Calloway County,1,7,1953,1054,899
Kentucky,Calloway County,1,8,1867,916,951
Kentucky,Calloway County,1,9,1969,971,998
Kentucky,Calloway County,1,10,2263,1121,1142
Kentucky,Calloway County,1,11,2249,1042,1207
Kentucky,Calloway County,1,12,2173,1024,1149
Kentucky,Calloway County,1,13,2117,1039,1078
Kentucky,Calloway County,1,14,1853,897,956
Kentucky,Calloway County,1,15,1347,629,718
Kentucky,Calloway County,1,16,954,453,501
Kentucky,Calloway County,1,17,743,297,446
Kentucky,Calloway County,1,18,723,227,496
Kentucky,Calloway County,2,0,37190,17924,19266
Kentucky,Calloway County,2,1,1942,966,976
Kentucky,Calloway County,2,2,1778,908,870
Kentucky,Calloway County,2,3,1832,909,923
Kentucky,Calloway County,2,4,3307,1472,1835
Kentucky,Calloway County,2,5,5634,2676,2958
Kentucky,Calloway County,2,6,2486,1323,1163
Kentucky,Calloway County,2,7,1953,1054,899
Kentucky,Calloway County,2,8,1867,916,951
Kentucky,Calloway County,2,9,1969,971,998
Kentucky,Calloway County,2,10,2263,1121,1142
Kentucky,Calloway County,2,11,2249,1042,1207
Kentucky,Calloway County,2,12,2173,1024,1149
Kentucky,Calloway County,2,13,2117,1039,1078
Kentucky,Calloway County,2,14,1853,897,956
Kentucky,Calloway County,2,15,1347,629,718
Kentucky,Calloway County,2,16,954,453,501
Kentucky,Calloway County,2,17,743,297,446
Kentucky,Calloway County,2,18,723,227,496
Kentucky,Calloway County,3,0,37348,18000,19348
Kentucky,Calloway County,3,1,1963,980,983
Kentucky,Calloway County,3,2,1791,911,880
Kentucky,Calloway County,3,3,1847,918,929
Kentucky,Calloway County,3,4,3310,1472,1838
Kentucky,Calloway County,3,5,5696,2711,2985
Kentucky,Calloway County,3,6,2483,1320,1163
Kentucky,Calloway County,3,7,1986,1064,922
Kentucky,Calloway County,3,8,1856,912,944
Kentucky,Calloway County,3,9,1969,970,999
Kentucky,Calloway County,3,10,2257,1120,1137
Kentucky,Calloway County,3,11,2256,1047,1209
Kentucky,Calloway County,3,12,2185,1027,1158
Kentucky,Calloway County,3,13,2129,1044,1085
Kentucky,Calloway County,3,14,1849,893,956
Kentucky,Calloway County,3,15,1352,632,720
Kentucky,Calloway County,3,16,962,455,507
Kentucky,Calloway County,3,17,732,292,440
Kentucky,Calloway County,3,18,725,232,493
Kentucky,Calloway County,4,0,37667,18159,19508
Kentucky,Calloway County,4,1,1963,981,982
Kentucky,Calloway County,4,2,1809,918,891
Kentucky,Calloway County,4,3,1862,926,936
Kentucky,Calloway County,4,4,3257,1444,1813
Kentucky,Calloway County,4,5,5911,2780,3131
Kentucky,Calloway County,4,6,2450,1316,1134
Kentucky,Calloway County,4,7,2091,1118,973
Kentucky,Calloway County,4,8,1800,897,903
Kentucky,Calloway County,4,9,2007,988,1019
Kentucky,Calloway County,4,10,2232,1106,1126
Kentucky,Calloway County,4,11,2268,1070,1198
Kentucky,Calloway County,4,12,2210,1044,1166
Kentucky,Calloway County,4,13,2150,1036,1114
Kentucky,Calloway County,4,14,1818,880,938
Kentucky,Calloway County,4,15,1387,655,732
Kentucky,Calloway County,4,16,1026,481,545
Kentucky,Calloway County,4,17,705,281,424
Kentucky,Calloway County,4,18,721,238,483
Kentucky,Calloway County,5,0,38046,18317,19729
Kentucky,Calloway County,5,1,1983,992,991
Kentucky,Calloway County,5,2,1885,951,934
Kentucky,Calloway County,5,3,1844,925,919
Kentucky,Calloway County,5,4,3289,1451,1838
Kentucky,Calloway County,5,5,6065,2866,3199
Kentucky,Calloway County,5,6,2399,1273,1126
Kentucky,Calloway County,5,7,2162,1145,1017
Kentucky,Calloway County,5,8,1779,889,890
Kentucky,Calloway County,5,9,2023,1000,1023
Kentucky,Calloway County,5,10,2153,1054,1099
Kentucky,Calloway County,5,11,2299,1089,1210
Kentucky,Calloway County,5,12,2227,1066,1161
Kentucky,Calloway County,5,13,2093,975,1118
Kentucky,Calloway County,5,14,1940,966,974
Kentucky,Calloway County,5,15,1447,659,788
Kentucky,Calloway County,5,16,1049,492,557
Kentucky,Calloway County,5,17,693,289,404
Kentucky,Calloway County,5,18,716,235,481
Kentucky,Calloway County,6,0,38425,18492,19933
Kentucky,Calloway County,6,1,1993,988,1005
Kentucky,Calloway County,6,2,1912,962,950
Kentucky,Calloway County,6,3,1836,932,904
Kentucky,Calloway County,6,4,3413,1475,1938
Kentucky,Calloway County,6,5,6113,2922,3191
Kentucky,Calloway County,6,6,2432,1263,1169
Kentucky,Calloway County,6,7,2134,1112,1022
Kentucky,Calloway County,6,8,1799,931,868
Kentucky,Calloway County,6,9,2051,1019,1032
Kentucky,Calloway County,6,10,2082,1010,1072
Kentucky,Calloway County,6,11,2289,1113,1176
Kentucky,Calloway County,6,12,2272,1062,1210
Kentucky,Calloway County,6,13,2091,986,1105
Kentucky,Calloway County,6,14,1948,964,984
Kentucky,Calloway County,6,15,1561,712,849
Kentucky,Calloway County,6,16,1063,502,561
Kentucky,Calloway County,6,17,720,295,425
Kentucky,Calloway County,6,18,716,244,472
Kentucky,Calloway County,7,0,38452,18614,19838
Kentucky,Calloway County,7,1,2018,1017,1001
Kentucky,Calloway County,7,2,1921,971,950
Kentucky,Calloway County,7,3,1840,934,906
Kentucky,Calloway County,7,4,3302,1444,1858
Kentucky,Calloway County,7,5,5959,2894,3065
Kentucky,Calloway County,7,6,2497,1279,1218
Kentucky,Calloway County,7,7,2085,1085,1000
Kentucky,Calloway County,7,8,1879,971,908
Kentucky,Calloway County,7,9,2011,1011,1000
Kentucky,Calloway County,7,10,2057,1014,1043
Kentucky,Calloway County,7,11,2331,1143,1188
Kentucky,Calloway County,7,12,2275,1065,1210
Kentucky,Calloway County,7,13,2124,1008,1116
Kentucky,Calloway County,7,14,1990,968,1022
Kentucky,Calloway County,7,15,1610,743,867
Kentucky,Calloway County,7,16,1086,508,578
Kentucky,Calloway County,7,17,745,319,426
Kentucky,Calloway County,7,18,722,240,482
Kentucky,Calloway County,8,0,38656,18816,19840
Kentucky,Calloway County,8,1,1985,1007,978
Kentucky,Calloway County,8,2,1928,974,954
Kentucky,Calloway County,8,3,1865,956,909
Kentucky,Calloway County,8,4,3331,1479,1852
Kentucky,Calloway County,8,5,5887,2930,2957
Kentucky,Calloway County,8,6,2535,1286,1249
Kentucky,Calloway County,8,7,2126,1084,1042
Kentucky,Calloway County,8,8,1951,1013,938
Kentucky,Calloway County,8,9,1953,994,959
Kentucky,Calloway County,8,10,2059,1011,1048
Kentucky,Calloway County,8,11,2319,1138,1181
Kentucky,Calloway County,8,12,2270,1073,1197
Kentucky,Calloway County,8,13,2212,1041,1171
Kentucky,Calloway County,8,14,2020,975,1045
Kentucky,Calloway County,8,15,1617,775,842
Kentucky,Calloway County,8,16,1131,510,621
Kentucky,Calloway County,8,17,754,335,419
Kentucky,Calloway County,8,18,713,235,478
Kentucky,Calloway County,9,0,38733,18875,19858
Kentucky,Calloway County,9,1,1952,979,973
Kentucky,Calloway County,9,2,1970,995,975
Kentucky,Calloway County,9,3,1841,957,884
Kentucky,Calloway County,9,4,3290,1481,1809
Kentucky,Calloway County,9,5,5735,2825,2910
Kentucky,Calloway County,9,6,2611,1312,1299
Kentucky,Calloway County,9,7,2084,1098,986
Kentucky,Calloway County,9,8,2046,1028,1018
Kentucky,Calloway County,9,9,1904,993,911
Kentucky,Calloway County,9,10,2130,1048,1082
Kentucky,Calloway County,9,11,2249,1117,1132
Kentucky,Calloway County,9,12,2318,1112,1206
Kentucky,Calloway County,9,13,2259,1055,1204
Kentucky,Calloway County,9,14,2045,983,1062
Kentucky,Calloway County,9,15,1632,763,869
Kentucky,Calloway County,9,16,1155,531,624
Kentucky,Calloway County,9,17,799,348,451
Kentucky,Calloway County,9,18,713,250,463
Kentucky,Calloway County,10,0,38832,18922,19910
Kentucky,Calloway County,10,1,1956,962,994
Kentucky,Calloway County,10,2,1987,1029,958
Kentucky,Calloway County,10,3,1870,937,933
Kentucky,Calloway County,10,4,3231,1462,1769
Kentucky,Calloway County,10,5,5648,2780,2868
Kentucky,Calloway County,10,6,2626,1346,1280
Kentucky,Calloway County,10,7,2097,1091,1006
Kentucky,Calloway County,10,8,2060,1037,1023
Kentucky,Calloway County,10,9,1855,968,887
Kentucky,Calloway County,10,10,2144,1064,1080
Kentucky,Calloway County,10,11,2195,1077,1118
Kentucky,Calloway County,10,12,2369,1140,1229
Kentucky,Calloway County,10,13,2286,1086,1200
Kentucky,Calloway County,10,14,2031,965,1066
Kentucky,Calloway County,10,15,1726,838,888
Kentucky,Calloway County,10,16,1177,519,658
Kentucky,Calloway County,10,17,839,363,476
Kentucky,Calloway County,10,18,735,258,477
Kentucky,Calloway County,11,0,38964,18930,20034
Kentucky,Calloway County,11,1,1943,940,1003
Kentucky,Calloway County,11,2,1986,1030,956
Kentucky,Calloway County,11,3,1934,978,956
Kentucky,Calloway County,11,4,3249,1471,1778
Kentucky,Calloway County,11,5,5574,2735,2839
Kentucky,Calloway County,11,6,2600,1340,1260
Kentucky,Calloway County,11,7,2059,1040,1019
Kentucky,Calloway County,11,8,2083,1058,1025
Kentucky,Calloway County,11,9,1891,980,911
Kentucky,Calloway County,11,10,2126,1062,1064
Kentucky,Calloway County,11,11,2180,1063,1117
Kentucky,Calloway County,11,12,2332,1125,1207
Kentucky,Calloway County,11,13,2360,1100,1260
Kentucky,Calloway County,11,14,2040,979,1061
Kentucky,Calloway County,11,15,1731,851,880
Kentucky,Calloway County,11,16,1259,541,718
Kentucky,Calloway County,11,17,823,349,474
Kentucky,Calloway County,11,18,794,288,506
Kentucky,Calloway County,12,0,39001,18944,20057
Kentucky,Calloway County,12,1,1882,905,977
Kentucky,Calloway County,12,2,1954,1026,928
Kentucky,Calloway County,12,3,1979,1014,965
Kentucky,Calloway County,12,4,3255,1469,1786
Kentucky,Calloway County,12,5,5444,2646,2798
Kentucky,Calloway County,12,6,2537,1331,1206
Kentucky,Calloway County,12,7,2127,1068,1059
Kentucky,Calloway County,12,8,2109,1059,1050
Kentucky,Calloway County,12,9,1933,1000,933
Kentucky,Calloway County,12,10,2086,1062,1024
Kentucky,Calloway County,12,11,2148,1044,1104
Kentucky,Calloway County,12,12,2394,1163,1231
Kentucky,Calloway County,12,13,2341,1087,1254
Kentucky,Calloway County,12,14,2083,990,1093
Kentucky,Calloway County,12,15,1788,872,916
Kentucky,Calloway County,12,16,1276,553,723
Kentucky,Calloway County,12,17,850,356,494
Kentucky,Calloway County,12,18,815,299,516
Kentucky,Campbell County,1,0,90336,44269,46067
Kentucky,Campbell County,1,1,5783,2944,2839
Kentucky,Campbell County,1,2,5560,2848,2712
Kentucky,Campbell County,1,3,5731,2926,2805
Kentucky,Campbell County,1,4,6538,3331,3207
Kentucky,Campbell County,1,5,6973,3445,3528
Kentucky,Campbell County,1,6,6667,3401,3266
Kentucky,Campbell County,1,7,5834,2963,2871
Kentucky,Campbell County,1,8,5446,2726,2720
Kentucky,Campbell County,1,9,5911,2968,2943
Kentucky,Campbell County,1,10,6769,3355,3414
Kentucky,Campbell County,1,11,6874,3387,3487
Kentucky,Campbell County,1,12,5883,2889,2994
Kentucky,Campbell County,1,13,4810,2314,2496
Kentucky,Campbell County,1,14,3460,1570,1890
Kentucky,Campbell County,1,15,2650,1152,1498
Kentucky,Campbell County,1,16,2164,923,1241
Kentucky,Campbell County,1,17,1769,668,1101
Kentucky,Campbell County,1,18,1514,459,1055
Kentucky,Campbell County,2,0,90338,44270,46068
Kentucky,Campbell County,2,1,5783,2944,2839
Kentucky,Campbell County,2,2,5560,2848,2712
Kentucky,Campbell County,2,3,5731,2926,2805
Kentucky,Campbell County,2,4,6538,3331,3207
Kentucky,Campbell County,2,5,6973,3445,3528
Kentucky,Campbell County,2,6,6667,3401,3266
Kentucky,Campbell County,2,7,5834,2963,2871
Kentucky,Campbell County,2,8,5446,2726,2720
Kentucky,Campbell County,2,9,5913,2969,2944
Kentucky,Campbell County,2,10,6769,3355,3414
Kentucky,Campbell County,2,11,6874,3387,3487
Kentucky,Campbell County,2,12,5883,2889,2994
Kentucky,Campbell County,2,13,4810,2314,2496
Kentucky,Campbell County,2,14,3460,1570,1890
Kentucky,Campbell County,2,15,2650,1152,1498
Kentucky,Campbell County,2,16,2164,923,1241
Kentucky,Campbell County,2,17,1769,668,1101
Kentucky,Campbell County,2,18,1514,459,1055
Kentucky,Campbell County,3,0,90623,44386,46237
Kentucky,Campbell County,3,1,5783,2926,2857
Kentucky,Campbell County,3,2,5561,2856,2705
Kentucky,Campbell County,3,3,5752,2932,2820
Kentucky,Campbell County,3,4,6553,3333,3220
Kentucky,Campbell County,3,5,7007,3467,3540
Kentucky,Campbell County,3,6,6694,3413,3281
Kentucky,Campbell County,3,7,5896,2986,2910
Kentucky,Campbell County,3,8,5418,2713,2705
Kentucky,Campbell County,3,9,5914,2965,2949
Kentucky,Campbell County,3,10,6741,3342,3399
Kentucky,Campbell County,3,11,6907,3403,3504
Kentucky,Campbell County,3,12,5939,2914,3025
Kentucky,Campbell County,3,13,4881,2347,2534
Kentucky,Campbell County,3,14,3464,1578,1886
Kentucky,Campbell County,3,15,2661,1157,1504
Kentucky,Campbell County,3,16,2151,917,1234
Kentucky,Campbell County,3,17,1775,674,1101
Kentucky,Campbell County,3,18,1526,463,1063
Kentucky,Campbell County,4,0,91241,44730,46511
Kentucky,Campbell County,4,1,5705,2926,2779
Kentucky,Campbell County,4,2,5522,2865,2657
Kentucky,Campbell County,4,3,5792,2972,2820
Kentucky,Campbell County,4,4,6442,3280,3162
Kentucky,Campbell County,4,5,7061,3461,3600
Kentucky,Campbell County,4,6,6736,3425,3311
Kentucky,Campbell County,4,7,6059,3072,2987
Kentucky,Campbell County,4,8,5244,2611,2633
Kentucky,Campbell County,4,9,5929,2950,2979
Kentucky,Campbell County,4,10,6505,3225,3280
Kentucky,Campbell County,4,11,7060,3476,3584
Kentucky,Campbell County,4,12,6211,3044,3167
Kentucky,Campbell County,4,13,5208,2497,2711
Kentucky,Campbell County,4,14,3516,1630,1886
Kentucky,Campbell County,4,15,2727,1191,1536
Kentucky,Campbell County,4,16,2149,921,1228
Kentucky,Campbell County,4,17,1782,685,1097
Kentucky,Campbell County,4,18,1593,499,1094
Kentucky,Campbell County,5,0,91246,44755,46491
Kentucky,Campbell County,5,1,5726,2932,2794
Kentucky,Campbell County,5,2,5511,2848,2663
Kentucky,Campbell County,5,3,5746,2923,2823
Kentucky,Campbell County,5,4,6239,3173,3066
Kentucky,Campbell County,5,5,7002,3469,3533
Kentucky,Campbell County,5,6,6757,3441,3316
Kentucky,Campbell County,5,7,6149,3126,3023
Kentucky,Campbell County,5,8,5195,2583,2612
Kentucky,Campbell County,5,9,5837,2899,2938
Kentucky,Campbell County,5,10,6283,3101,3182
Kentucky,Campbell County,5,11,7037,3464,3573
Kentucky,Campbell County,5,12,6428,3134,3294
Kentucky,Campbell County,5,13,5204,2515,2689
Kentucky,Campbell County,5,14,3818,1790,2028
Kentucky,Campbell County,5,15,2847,1255,1592
Kentucky,Campbell County,5,16,2098,890,1208
Kentucky,Campbell County,5,17,1720,678,1042
Kentucky,Campbell County,5,18,1649,534,1115
Kentucky,Campbell County,6,0,91423,44951,46472
Kentucky,Campbell County,6,1,5589,2918,2671
Kentucky,Campbell County,6,2,5527,2822,2705
Kentucky,Campbell County,6,3,5667,2896,2771
Kentucky,Campbell County,6,4,6277,3194,3083
Kentucky,Campbell County,6,5,6859,3455,3404
Kentucky,Campbell County,6,6,6774,3406,3368
Kentucky,Campbell County,6,7,6282,3190,3092
Kentucky,Campbell County,6,8,5332,2648,2684
Kentucky,Campbell County,6,9,5693,2863,2830
Kentucky,Campbell County,6,10,6068,2992,3076
Kentucky,Campbell County,6,11,7004,3459,3545
Kentucky,Campbell County,6,12,6557,3186,3371
Kentucky,Campbell County,6,13,5376,2596,2780
Kentucky,Campbell County,6,14,4000,1912,2088
Kentucky,Campbell County,6,15,2968,1318,1650
Kentucky,Campbell County,6,16,2106,864,1242
Kentucky,Campbell County,6,17,1701,701,1000
Kentucky,Campbell County,6,18,1643,531,1112
Kentucky,Campbell County,7,0,91971,45143,46828
Kentucky,Campbell County,7,1,5539,2908,2631
Kentucky,Campbell County,7,2,5545,2793,2752
Kentucky,Campbell County,7,3,5553,2839,2714
Kentucky,Campbell County,7,4,6317,3151,3166
Kentucky,Campbell County,7,5,6840,3506,3334
Kentucky,Campbell County,7,6,6828,3384,3444
Kentucky,Campbell County,7,7,6430,3282,3148
Kentucky,Campbell County,7,8,5421,2685,2736
Kentucky,Campbell County,7,9,5524,2773,2751
Kentucky,Campbell County,7,10,5978,2980,2998
Kentucky,Campbell County,7,11,6838,3356,3482
Kentucky,Campbell County,7,12,6697,3263,3434
Kentucky,Campbell County,7,13,5572,2701,2871
Kentucky,Campbell County,7,14,4286,2034,2252
Kentucky,Campbell County,7,15,3012,1345,1667
Kentucky,Campbell County,7,16,2188,898,1290
Kentucky,Campbell County,7,17,1678,689,989
Kentucky,Campbell County,7,18,1725,556,1169
Kentucky,Campbell County,8,0,92124,45287,46837
Kentucky,Campbell County,8,1,5452,2835,2617
Kentucky,Campbell County,8,2,5650,2846,2804
Kentucky,Campbell County,8,3,5431,2814,2617
Kentucky,Campbell County,8,4,6219,3086,3133
Kentucky,Campbell County,8,5,6629,3441,3188
Kentucky,Campbell County,8,6,6977,3479,3498
Kentucky,Campbell County,8,7,6395,3247,3148
Kentucky,Campbell County,8,8,5622,2813,2809
Kentucky,Campbell County,8,9,5422,2692,2730
Kentucky,Campbell County,8,10,5855,2944,2911
Kentucky,Campbell County,8,11,6660,3252,3408
Kentucky,Campbell County,8,12,6773,3293,3480
Kentucky,Campbell County,8,13,5830,2849,2981
Kentucky,Campbell County,8,14,4559,2171,2388
Kentucky,Campbell County,8,15,3048,1370,1678
Kentucky,Campbell County,8,16,2158,894,1264
Kentucky,Campbell County,8,17,1699,679,1020
Kentucky,Campbell County,8,18,1745,582,1163
Kentucky,Campbell County,9,0,92257,45226,47031
Kentucky,Campbell County,9,1,5362,2771,2591
Kentucky,Campbell County,9,2,5450,2761,2689
Kentucky,Campbell County,9,3,5351,2744,2607
Kentucky,Campbell County,9,4,6240,3080,3160
Kentucky,Campbell County,9,5,6481,3322,3159
Kentucky,Campbell County,9,6,7078,3511,3567
Kentucky,Campbell County,9,7,6434,3252,3182
Kentucky,Campbell County,9,8,5891,2961,2930
Kentucky,Campbell County,9,9,5219,2561,2658
Kentucky,Campbell County,9,10,5849,2965,2884
Kentucky,Campbell County,9,11,6414,3101,3313
Kentucky,Campbell County,9,12,6873,3349,3524
Kentucky,Campbell County,9,13,6030,2936,3094
Kentucky,Campbell County,9,14,4841,2293,2548
Kentucky,Campbell County,9,15,3098,1423,1675
Kentucky,Campbell County,9,16,2250,931,1319
Kentucky,Campbell County,9,17,1637,644,993
Kentucky,Campbell County,9,18,1759,621,1138
Kentucky,Campbell County,10,0,92878,45494,47384
Kentucky,Campbell County,10,1,5345,2721,2624
Kentucky,Campbell County,10,2,5459,2774,2685
Kentucky,Campbell County,10,3,5297,2702,2595
Kentucky,Campbell County,10,4,6287,3079,3208
Kentucky,Campbell County,10,5,6416,3200,3216
Kentucky,Campbell County,10,6,7387,3762,3625
Kentucky,Campbell County,10,7,6378,3249,3129
Kentucky,Campbell County,10,8,6024,3043,2981
Kentucky,Campbell County,10,9,5124,2508,2616
Kentucky,Campbell County,10,10,5755,2900,2855
Kentucky,Campbell County,10,11,6182,3015,3167
Kentucky,Campbell County,10,12,6879,3383,3496
Kentucky,Campbell County,10,13,6261,2999,3262
Kentucky,Campbell County,10,14,4880,2299,2581
Kentucky,Campbell County,10,15,3401,1591,1810
Kentucky,Campbell County,10,16,2373,1004,1369
Kentucky,Campbell County,10,17,1657,647,1010
Kentucky,Campbell County,10,18,1773,618,1155
Kentucky,Campbell County,11,0,93464,45769,47695
Kentucky,Campbell County,11,1,5364,2687,2677
Kentucky,Campbell County,11,2,5441,2772,2669
Kentucky,Campbell County,11,3,5381,2728,2653
Kentucky,Campbell County,11,4,6211,3042,3169
Kentucky,Campbell County,11,5,6440,3244,3196
Kentucky,Campbell County,11,6,7339,3710,3629
Kentucky,Campbell County,11,7,6474,3296,3178
Kentucky,Campbell County,11,8,6124,3097,3027
Kentucky,Campbell County,11,9,5220,2550,2670
Kentucky,Campbell County,11,10,5594,2837,2757
Kentucky,Campbell County,11,11,6027,2959,3068
Kentucky,Campbell County,11,12,6876,3382,3494
Kentucky,Campbell County,11,13,6395,3072,3323
Kentucky,Campbell County,11,14,5057,2368,2689
Kentucky,Campbell County,11,15,3566,1685,1881
Kentucky,Campbell County,11,16,2480,1060,1420
Kentucky,Campbell County,11,17,1666,627,1039
Kentucky,Campbell County,11,18,1809,653,1156
Kentucky,Campbell County,12,0,93584,45917,47667
Kentucky,Campbell County,12,1,5400,2750,2650
Kentucky,Campbell County,12,2,5404,2757,2647
Kentucky,Campbell County,12,3,5411,2734,2677
Kentucky,Campbell County,12,4,5990,2924,3066
Kentucky,Campbell County,12,5,6268,3140,3128
Kentucky,Campbell County,12,6,7154,3690,3464
Kentucky,Campbell County,12,7,6617,3318,3299
Kentucky,Campbell County,12,8,6257,3166,3091
Kentucky,Campbell County,12,9,5370,2676,2694
Kentucky,Campbell County,12,10,5449,2744,2705
Kentucky,Campbell County,12,11,5859,2894,2965
Kentucky,Campbell County,12,12,6759,3302,3457
Kentucky,Campbell County,12,13,6578,3186,3392
Kentucky,Campbell County,12,14,5255,2475,2780
Kentucky,Campbell County,12,15,3778,1771,2007
Kentucky,Campbell County,12,16,2533,1104,1429
Kentucky,Campbell County,12,17,1736,660,1076
Kentucky,Campbell County,12,18,1766,626,1140
Kentucky,Carlisle County,1,0,5104,2492,2612
Kentucky,Carlisle County,1,1,323,160,163
Kentucky,Carlisle County,1,2,313,155,158
Kentucky,Carlisle County,1,3,314,151,163
Kentucky,Carlisle County,1,4,309,159,150
Kentucky,Carlisle County,1,5,254,133,121
Kentucky,Carlisle County,1,6,289,134,155
Kentucky,Carlisle County,1,7,277,143,134
Kentucky,Carlisle County,1,8,297,157,140
Kentucky,Carlisle County,1,9,327,158,169
Kentucky,Carlisle County,1,10,370,202,168
Kentucky,Carlisle County,1,11,373,185,188
Kentucky,Carlisle County,1,12,359,173,186
Kentucky,Carlisle County,1,13,334,171,163
Kentucky,Carlisle County,1,14,268,135,133
Kentucky,Carlisle County,1,15,222,110,112
Kentucky,Carlisle County,1,16,185,64,121
Kentucky,Carlisle County,1,17,147,56,91
Kentucky,Carlisle County,1,18,143,46,97
Kentucky,Carlisle County,2,0,5097,2489,2608
Kentucky,Carlisle County,2,1,323,160,163
Kentucky,Carlisle County,2,2,313,155,158
Kentucky,Carlisle County,2,3,313,151,162
Kentucky,Carlisle County,2,4,307,158,149
Kentucky,Carlisle County,2,5,253,132,121
Kentucky,Carlisle County,2,6,289,134,155
Kentucky,Carlisle County,2,7,277,143,134
Kentucky,Carlisle County,2,8,296,157,139
Kentucky,Carlisle County,2,9,327,158,169
Kentucky,Carlisle County,2,10,369,201,168
Kentucky,Carlisle County,2,11,373,185,188
Kentucky,Carlisle County,2,12,359,173,186
Kentucky,Carlisle County,2,13,334,171,163
Kentucky,Carlisle County,2,14,268,135,133
Kentucky,Carlisle County,2,15,222,110,112
Kentucky,Carlisle County,2,16,185,64,121
Kentucky,Carlisle County,2,17,147,56,91
Kentucky,Carlisle County,2,18,142,46,96
Kentucky,Carlisle County,3,0,5083,2485,2598
Kentucky,Carlisle County,3,1,316,154,162
Kentucky,Carlisle County,3,2,317,158,159
Kentucky,Carlisle County,3,3,310,152,158
Kentucky,Carlisle County,3,4,307,158,149
Kentucky,Carlisle County,3,5,250,128,122
Kentucky,Carlisle County,3,6,289,136,153
Kentucky,Carlisle County,3,7,281,142,139
Kentucky,Carlisle County,3,8,301,162,139
Kentucky,Carlisle County,3,9,325,154,171
Kentucky,Carlisle County,3,10,366,202,164
Kentucky,Carlisle County,3,11,376,188,188
Kentucky,Carlisle County,3,12,356,170,186
Kentucky,Carlisle County,3,13,340,171,169
Kentucky,Carlisle County,3,14,261,135,126
Kentucky,Carlisle County,3,15,220,111,109
Kentucky,Carlisle County,3,16,180,65,115
Kentucky,Carlisle County,3,17,148,54,94
Kentucky,Carlisle County,3,18,140,45,95
Kentucky,Carlisle County,4,0,5034,2471,2563
Kentucky,Carlisle County,4,1,301,157,144
Kentucky,Carlisle County,4,2,318,157,161
Kentucky,Carlisle County,4,3,307,149,158
Kentucky,Carlisle County,4,4,313,162,151
Kentucky,Carlisle County,4,5,252,125,127
Kentucky,Carlisle County,4,6,265,120,145
Kentucky,Carlisle County,4,7,282,142,140
Kentucky,Carlisle County,4,8,299,168,131
Kentucky,Carlisle County,4,9,305,137,168
Kentucky,Carlisle County,4,10,356,196,160
Kentucky,Carlisle County,4,11,380,196,184
Kentucky,Carlisle County,4,12,348,165,183
Kentucky,Carlisle County,4,13,355,172,183
Kentucky,Carlisle County,4,14,258,139,119
Kentucky,Carlisle County,4,15,225,112,113
Kentucky,Carlisle County,4,16,181,77,104
Kentucky,Carlisle County,4,17,146,46,100
Kentucky,Carlisle County,4,18,143,51,92
Kentucky,Carlisle County,5,0,5027,2444,2583
Kentucky,Carlisle County,5,1,306,157,149
Kentucky,Carlisle County,5,2,323,159,164
Kentucky,Carlisle County,5,3,315,150,165
Kentucky,Carlisle County,5,4,298,156,142
Kentucky,Carlisle County,5,5,283,131,152
Kentucky,Carlisle County,5,6,251,119,132
Kentucky,Carlisle County,5,7,281,136,145
Kentucky,Carlisle County,5,8,305,166,139
Kentucky,Carlisle County,5,9,295,144,151
Kentucky,Carlisle County,5,10,347,176,171
Kentucky,Carlisle County,5,11,365,196,169
Kentucky,Carlisle County,5,12,356,168,188
Kentucky,Carlisle County,5,13,337,165,172
Kentucky,Carlisle County,5,14,263,130,133
Kentucky,Carlisle County,5,15,229,119,110
Kentucky,Carlisle County,5,16,190,78,112
Kentucky,Carlisle County,5,17,140,45,95
Kentucky,Carlisle County,5,18,143,49,94
Kentucky,Carlisle County,6,0,4959,2407,2552
Kentucky,Carlisle County,6,1,289,140,149
Kentucky,Carlisle County,6,2,332,166,166
Kentucky,Carlisle County,6,3,315,148,167
Kentucky,Carlisle County,6,4,285,145,140
Kentucky,Carlisle County,6,5,267,122,145
Kentucky,Carlisle County,6,6,238,111,127
Kentucky,Carlisle County,6,7,291,141,150
Kentucky,Carlisle County,6,8,296,160,136
Kentucky,Carlisle County,6,9,308,155,153
Kentucky,Carlisle County,6,10,320,153,167
Kentucky,Carlisle County,6,11,360,205,155
Kentucky,Carlisle County,6,12,352,172,180
Kentucky,Carlisle County,6,13,327,157,170
Kentucky,Carlisle County,6,14,282,138,144
Kentucky,Carlisle County,6,15,229,121,108
Kentucky,Carlisle County,6,16,189,84,105
Kentucky,Carlisle County,6,17,131,41,90
Kentucky,Carlisle County,6,18,148,48,100
Kentucky,Carlisle County,7,0,4961,2416,2545
Kentucky,Carlisle County,7,1,300,147,153
Kentucky,Carlisle County,7,2,327,162,165
Kentucky,Carlisle County,7,3,320,157,163
Kentucky,Carlisle County,7,4,287,144,143
Kentucky,Carlisle County,7,5,265,125,140
Kentucky,Carlisle County,7,6,273,133,140
Kentucky,Carlisle County,7,7,295,142,153
Kentucky,Carlisle County,7,8,278,151,127
Kentucky,Carlisle County,7,9,306,155,151
Kentucky,Carlisle County,7,10,318,147,171
Kentucky,Carlisle County,7,11,351,200,151
Kentucky,Carlisle County,7,12,349,169,180
Kentucky,Carlisle County,7,13,330,158,172
Kentucky,Carlisle County,7,14,282,141,141
Kentucky,Carlisle County,7,15,222,114,108
Kentucky,Carlisle County,7,16,192,93,99
Kentucky,Carlisle County,7,17,129,42,87
Kentucky,Carlisle County,7,18,137,36,101
Kentucky,Carlisle County,8,0,4852,2369,2483
Kentucky,Carlisle County,8,1,315,161,154
Kentucky,Carlisle County,8,2,312,156,156
Kentucky,Carlisle County,8,3,287,148,139
Kentucky,Carlisle County,8,4,283,136,147
Kentucky,Carlisle County,8,5,266,132,134
Kentucky,Carlisle County,8,6,278,138,140
Kentucky,Carlisle County,8,7,269,130,139
Kentucky,Carlisle County,8,8,269,135,134
Kentucky,Carlisle County,8,9,292,153,139
Kentucky,Carlisle County,8,10,302,139,163
Kentucky,Carlisle County,8,11,340,188,152
Kentucky,Carlisle County,8,12,337,170,167
Kentucky,Carlisle County,8,13,334,153,181
Kentucky,Carlisle County,8,14,287,144,143
Kentucky,Carlisle County,8,15,226,119,107
Kentucky,Carlisle County,8,16,182,84,98
Kentucky,Carlisle County,8,17,139,53,86
Kentucky,Carlisle County,8,18,134,30,104
Kentucky,Carlisle County,9,0,4783,2343,2440
Kentucky,Carlisle County,9,1,325,166,159
Kentucky,Carlisle County,9,2,289,151,138
Kentucky,Carlisle County,9,3,295,148,147
Kentucky,Carlisle County,9,4,266,133,133
Kentucky,Carlisle County,9,5,250,129,121
Kentucky,Carlisle County,9,6,283,145,138
Kentucky,Carlisle County,9,7,254,121,133
Kentucky,Carlisle County,9,8,258,119,139
Kentucky,Carlisle County,9,9,308,168,140
Kentucky,Carlisle County,9,10,294,126,168
Kentucky,Carlisle County,9,11,318,175,143
Kentucky,Carlisle County,9,12,341,175,166
Kentucky,Carlisle County,9,13,322,148,174
Kentucky,Carlisle County,9,14,306,147,159
Kentucky,Carlisle County,9,15,214,114,100
Kentucky,Carlisle County,9,16,184,89,95
Kentucky,Carlisle County,9,17,144,61,83
Kentucky,Carlisle County,9,18,132,28,104
Kentucky,Carlisle County,10,0,4788,2347,2441
Kentucky,Carlisle County,10,1,332,173,159
Kentucky,Carlisle County,10,2,292,149,143
Kentucky,Carlisle County,10,3,316,168,148
Kentucky,Carlisle County,10,4,269,131,138
Kentucky,Carlisle County,10,5,230,119,111
Kentucky,Carlisle County,10,6,293,147,146
Kentucky,Carlisle County,10,7,250,123,127
Kentucky,Carlisle County,10,8,256,124,132
Kentucky,Carlisle County,10,9,293,153,140
Kentucky,Carlisle County,10,10,289,136,153
Kentucky,Carlisle County,10,11,329,162,167
Kentucky,Carlisle County,10,12,334,182,152
Kentucky,Carlisle County,10,13,328,154,174
Kentucky,Carlisle County,10,14,292,138,154
Kentucky,Carlisle County,10,15,227,112,115
Kentucky,Carlisle County,10,16,177,85,92
Kentucky,Carlisle County,10,17,146,60,86
Kentucky,Carlisle County,10,18,135,31,104
Kentucky,Carlisle County,11,0,4739,2337,2402
Kentucky,Carlisle County,11,1,319,178,141
Kentucky,Carlisle County,11,2,287,135,152
Kentucky,Carlisle County,11,3,300,164,136
Kentucky,Carlisle County,11,4,269,133,136
Kentucky,Carlisle County,11,5,215,110,105
Kentucky,Carlisle County,11,6,290,144,146
Kentucky,Carlisle County,11,7,237,118,119
Kentucky,Carlisle County,11,8,268,136,132
Kentucky,Carlisle County,11,9,285,147,138
Kentucky,Carlisle County,11,10,293,147,146
Kentucky,Carlisle County,11,11,303,140,163
Kentucky,Carlisle County,11,12,340,192,148
Kentucky,Carlisle County,11,13,322,158,164
Kentucky,Carlisle County,11,14,292,132,160
Kentucky,Carlisle County,11,15,249,115,134
Kentucky,Carlisle County,11,16,180,91,89
Kentucky,Carlisle County,11,17,148,61,87
Kentucky,Carlisle County,11,18,142,36,106
Kentucky,Carlisle County,12,0,4760,2358,2402
Kentucky,Carlisle County,12,1,312,174,138
Kentucky,Carlisle County,12,2,297,147,150
Kentucky,Carlisle County,12,3,310,158,152
Kentucky,Carlisle County,12,4,281,148,133
Kentucky,Carlisle County,12,5,216,104,112
Kentucky,Carlisle County,12,6,282,149,133
Kentucky,Carlisle County,12,7,257,129,128
Kentucky,Carlisle County,12,8,267,132,135
Kentucky,Carlisle County,12,9,276,147,129
Kentucky,Carlisle County,12,10,286,146,140
Kentucky,Carlisle County,12,11,299,142,157
Kentucky,Carlisle County,12,12,326,184,142
Kentucky,Carlisle County,12,13,323,159,164
Kentucky,Carlisle County,12,14,295,134,161
Kentucky,Carlisle County,12,15,250,113,137
Kentucky,Carlisle County,12,16,192,94,98
Kentucky,Carlisle County,12,17,151,61,90
Kentucky,Carlisle County,12,18,140,37,103
Kentucky,Carroll County,1,0,10811,5506,5305
Kentucky,Carroll County,1,1,805,413,392
Kentucky,Carroll County,1,2,697,348,349
Kentucky,Carroll County,1,3,749,382,367
Kentucky,Carroll County,1,4,742,402,340
Kentucky,Carroll County,1,5,615,331,284
Kentucky,Carroll County,1,6,761,404,357
Kentucky,Carroll County,1,7,646,335,311
Kentucky,Carroll County,1,8,747,406,341
Kentucky,Carroll County,1,9,717,355,362
Kentucky,Carroll County,1,10,833,436,397
Kentucky,Carroll County,1,11,794,421,373
Kentucky,Carroll County,1,12,674,337,337
Kentucky,Carroll County,1,13,636,307,329
Kentucky,Carroll County,1,14,471,239,232
Kentucky,Carroll County,1,15,305,149,156
Kentucky,Carroll County,1,16,272,123,149
Kentucky,Carroll County,1,17,197,72,125
Kentucky,Carroll County,1,18,150,46,104
Kentucky,Carroll County,2,0,10807,5504,5303
Kentucky,Carroll County,2,1,805,413,392
Kentucky,Carroll County,2,2,697,348,349
Kentucky,Carroll County,2,3,749,382,367
Kentucky,Carroll County,2,4,742,402,340
Kentucky,Carroll County,2,5,615,331,284
Kentucky,Carroll County,2,6,759,403,356
Kentucky,Carroll County,2,7,646,335,311
Kentucky,Carroll County,2,8,747,406,341
Kentucky,Carroll County,2,9,716,354,362
Kentucky,Carroll County,2,10,833,436,397
Kentucky,Carroll County,2,11,794,421,373
Kentucky,Carroll County,2,12,674,337,337
Kentucky,Carroll County,2,13,636,307,329
Kentucky,Carroll County,2,14,471,239,232
Kentucky,Carroll County,2,15,305,149,156
Kentucky,Carroll County,2,16,272,123,149
Kentucky,Carroll County,2,17,197,72,125
Kentucky,Carroll County,2,18,149,46,103
Kentucky,Carroll County,3,0,10806,5496,5310
Kentucky,Carroll County,3,1,810,415,395
Kentucky,Carroll County,3,2,703,354,349
Kentucky,Carroll County,3,3,741,374,367
Kentucky,Carroll County,3,4,728,394,334
Kentucky,Carroll County,3,5,617,333,284
Kentucky,Carroll County,3,6,753,396,357
Kentucky,Carroll County,3,7,651,337,314
Kentucky,Carroll County,3,8,743,400,343
Kentucky,Carroll County,3,9,706,354,352
Kentucky,Carroll County,3,10,828,431,397
Kentucky,Carroll County,3,11,793,422,371
Kentucky,Carroll County,3,12,685,344,341
Kentucky,Carroll County,3,13,636,307,329
Kentucky,Carroll County,3,14,479,244,235
Kentucky,Carroll County,3,15,307,151,156
Kentucky,Carroll County,3,16,275,122,153
Kentucky,Carroll County,3,17,200,72,128
Kentucky,Carroll County,3,18,151,46,105
Kentucky,Carroll County,4,0,10994,5551,5443
Kentucky,Carroll County,4,1,831,428,403
Kentucky,Carroll County,4,2,726,354,372
Kentucky,Carroll County,4,3,757,387,370
Kentucky,Carroll County,4,4,739,385,354
Kentucky,Carroll County,4,5,660,353,307
Kentucky,Carroll County,4,6,742,384,358
Kentucky,Carroll County,4,7,698,363,335
Kentucky,Carroll County,4,8,719,375,344
Kentucky,Carroll County,4,9,696,358,338
Kentucky,Carroll County,4,10,808,413,395
Kentucky,Carroll County,4,11,816,430,386
Kentucky,Carroll County,4,12,708,360,348
Kentucky,Carroll County,4,13,655,313,342
Kentucky,Carroll County,4,14,497,255,242
Kentucky,Carroll County,4,15,307,150,157
Kentucky,Carroll County,4,16,264,115,149
Kentucky,Carroll County,4,17,204,76,128
Kentucky,Carroll County,4,18,167,52,115
Kentucky,Carroll County,5,0,10874,5473,5401
Kentucky,Carroll County,5,1,811,395,416
Kentucky,Carroll County,5,2,724,371,353
Kentucky,Carroll County,5,3,739,387,352
Kentucky,Carroll County,5,4,737,376,361
Kentucky,Carroll County,5,5,664,358,306
Kentucky,Carroll County,5,6,655,341,314
Kentucky,Carroll County,5,7,723,378,345
Kentucky,Carroll County,5,8,635,325,310
Kentucky,Carroll County,5,9,713,359,354
Kentucky,Carroll County,5,10,768,396,372
Kentucky,Carroll County,5,11,845,432,413
Kentucky,Carroll County,5,12,727,372,355
Kentucky,Carroll County,5,13,652,308,344
Kentucky,Carroll County,5,14,535,276,259
Kentucky,Carroll County,5,15,319,156,163
Kentucky,Carroll County,5,16,258,113,145
Kentucky,Carroll County,5,17,197,81,116
Kentucky,Carroll County,5,18,172,49,123
Kentucky,Carroll County,6,0,10838,5476,5362
Kentucky,Carroll County,6,1,826,407,419
Kentucky,Carroll County,6,2,754,391,363
Kentucky,Carroll County,6,3,731,370,361
Kentucky,Carroll County,6,4,709,386,323
Kentucky,Carroll County,6,5,690,362,328
Kentucky,Carroll County,6,6,629,329,300
Kentucky,Carroll County,6,7,733,375,358
Kentucky,Carroll County,6,8,625,307,318
Kentucky,Carroll County,6,9,701,377,324
Kentucky,Carroll County,6,10,725,372,353
Kentucky,Carroll County,6,11,840,436,404
Kentucky,Carroll County,6,12,724,369,355
Kentucky,Carroll County,6,13,647,318,329
Kentucky,Carroll County,6,14,541,258,283
Kentucky,Carroll County,6,15,331,171,160
Kentucky,Carroll County,6,16,268,121,147
Kentucky,Carroll County,6,17,184,76,108
Kentucky,Carroll County,6,18,180,51,129
Kentucky,Carroll County,7,0,10738,5403,5335
Kentucky,Carroll County,7,1,791,397,394
Kentucky,Carroll County,7,2,794,411,383
Kentucky,Carroll County,7,3,696,328,368
Kentucky,Carroll County,7,4,696,378,318
Kentucky,Carroll County,7,5,695,364,331
Kentucky,Carroll County,7,6,611,320,291
Kentucky,Carroll County,7,7,741,396,345
Kentucky,Carroll County,7,8,608,301,307
Kentucky,Carroll County,7,9,691,362,329
Kentucky,Carroll County,7,10,685,344,341
Kentucky,Carroll County,7,11,809,413,396
Kentucky,Carroll County,7,12,721,375,346
Kentucky,Carroll County,7,13,646,311,335
Kentucky,Carroll County,7,14,550,262,288
Kentucky,Carroll County,7,15,356,180,176
Kentucky,Carroll County,7,16,275,124,151
Kentucky,Carroll County,7,17,187,84,103
Kentucky,Carroll County,7,18,186,53,133
Kentucky,Carroll County,8,0,10682,5395,5287
Kentucky,Carroll County,8,1,792,405,387
Kentucky,Carroll County,8,2,813,424,389
Kentucky,Carroll County,8,3,682,338,344
Kentucky,Carroll County,8,4,666,360,306
Kentucky,Carroll County,8,5,681,352,329
Kentucky,Carroll County,8,6,624,330,294
Kentucky,Carroll County,8,7,707,373,334
Kentucky,Carroll County,8,8,608,297,311
Kentucky,Carroll County,8,9,671,352,319
Kentucky,Carroll County,8,10,663,331,332
Kentucky,Carroll County,8,11,786,405,381
Kentucky,Carroll County,8,12,752,392,360
Kentucky,Carroll County,8,13,639,309,330
Kentucky,Carroll County,8,14,571,274,297
Kentucky,Carroll County,8,15,388,192,196
Kentucky,Carroll County,8,16,254,115,139
Kentucky,Carroll County,8,17,190,82,108
Kentucky,Carroll County,8,18,195,64,131
Kentucky,Carroll County,9,0,10614,5338,5276
Kentucky,Carroll County,9,1,815,415,400
Kentucky,Carroll County,9,2,798,401,397
Kentucky,Carroll County,9,3,675,343,332
Kentucky,Carroll County,9,4,667,341,326
Kentucky,Carroll County,9,5,637,316,321
Kentucky,Carroll County,9,6,648,360,288
Kentucky,Carroll County,9,7,660,343,317
Kentucky,Carroll County,9,8,644,324,320
Kentucky,Carroll County,9,9,652,328,324
Kentucky,Carroll County,9,10,634,328,306
Kentucky,Carroll County,9,11,753,387,366
Kentucky,Carroll County,9,12,754,390,364
Kentucky,Carroll County,9,13,670,332,338
Kentucky,Carroll County,9,14,555,259,296
Kentucky,Carroll County,9,15,405,201,204
Kentucky,Carroll County,9,16,249,111,138
Kentucky,Carroll County,9,17,197,85,112
Kentucky,Carroll County,9,18,201,74,127
Kentucky,Carroll County,10,0,10714,5407,5307
Kentucky,Carroll County,10,1,785,398,387
Kentucky,Carroll County,10,2,846,430,416
Kentucky,Carroll County,10,3,725,356,369
Kentucky,Carroll County,10,4,659,346,313
Kentucky,Carroll County,10,5,628,317,311
Kentucky,Carroll County,10,6,654,362,292
Kentucky,Carroll County,10,7,636,330,306
Kentucky,Carroll County,10,8,701,358,343
Kentucky,Carroll County,10,9,608,313,295
Kentucky,Carroll County,10,10,655,338,317
Kentucky,Carroll County,10,11,731,372,359
Kentucky,Carroll County,10,12,777,398,379
Kentucky,Carroll County,10,13,681,341,340
Kentucky,Carroll County,10,14,549,259,290
Kentucky,Carroll County,10,15,424,211,213
Kentucky,Carroll County,10,16,252,112,140
Kentucky,Carroll County,10,17,197,87,110
Kentucky,Carroll County,10,18,206,79,127
Kentucky,Carroll County,11,0,10712,5402,5310
Kentucky,Carroll County,11,1,772,389,383
Kentucky,Carroll County,11,2,835,422,413
Kentucky,Carroll County,11,3,740,372,368
Kentucky,Carroll County,11,4,661,337,324
Kentucky,Carroll County,11,5,622,328,294
Kentucky,Carroll County,11,6,695,380,315
Kentucky,Carroll County,11,7,589,299,290
Kentucky,Carroll County,11,8,707,363,344
Kentucky,Carroll County,11,9,597,294,303
Kentucky,Carroll County,11,10,664,354,310
Kentucky,Carroll County,11,11,706,362,344
Kentucky,Carroll County,11,12,778,396,382
Kentucky,Carroll County,11,13,694,346,348
Kentucky,Carroll County,11,14,550,263,287
Kentucky,Carroll County,11,15,432,204,228
Kentucky,Carroll County,11,16,264,126,138
Kentucky,Carroll County,11,17,203,92,111
Kentucky,Carroll County,11,18,203,75,128
Kentucky,Carroll County,12,0,10631,5345,5286
Kentucky,Carroll County,12,1,778,398,380
Kentucky,Carroll County,12,2,799,386,413
Kentucky,Carroll County,12,3,767,389,378
Kentucky,Carroll County,12,4,637,315,322
Kentucky,Carroll County,12,5,625,326,299
Kentucky,Carroll County,12,6,700,382,318
Kentucky,Carroll County,12,7,576,302,274
Kentucky,Carroll County,12,8,698,352,346
Kentucky,Carroll County,12,9,589,299,290
Kentucky,Carroll County,12,10,681,366,315
Kentucky,Carroll County,12,11,646,318,328
Kentucky,Carroll County,12,12,779,393,386
Kentucky,Carroll County,12,13,688,357,331
Kentucky,Carroll County,12,14,553,261,292
Kentucky,Carroll County,12,15,444,207,237
Kentucky,Carroll County,12,16,283,136,147
Kentucky,Carroll County,12,17,194,86,108
Kentucky,Carroll County,12,18,194,72,122
Kentucky,Carter County,1,0,27720,13803,13917
Kentucky,Carter County,1,1,1747,900,847
Kentucky,Carter County,1,2,1714,914,800
Kentucky,Carter County,1,3,1838,962,876
Kentucky,Carter County,1,4,2032,1061,971
Kentucky,Carter County,1,5,1718,839,879
Kentucky,Carter County,1,6,1628,835,793
Kentucky,Carter County,1,7,1691,880,811
Kentucky,Carter County,1,8,1774,891,883
Kentucky,Carter County,1,9,1822,896,926
Kentucky,Carter County,1,10,2025,988,1037
Kentucky,Carter County,1,11,2006,1020,986
Kentucky,Carter County,1,12,1805,881,924
Kentucky,Carter County,1,13,1801,878,923
Kentucky,Carter County,1,14,1382,651,731
Kentucky,Carter County,1,15,1091,522,569
Kentucky,Carter County,1,16,750,346,404
Kentucky,Carter County,1,17,496,194,302
Kentucky,Carter County,1,18,400,145,255
Kentucky,Carter County,2,0,27721,13804,13917
Kentucky,Carter County,2,1,1747,900,847
Kentucky,Carter County,2,2,1714,914,800
Kentucky,Carter County,2,3,1838,962,876
Kentucky,Carter County,2,4,2032,1061,971
Kentucky,Carter County,2,5,1718,839,879
Kentucky,Carter County,2,6,1629,835,794
Kentucky,Carter County,2,7,1690,881,809
Kentucky,Carter County,2,8,1773,890,883
Kentucky,Carter County,2,9,1823,897,926
Kentucky,Carter County,2,10,2025,988,1037
Kentucky,Carter County,2,11,2006,1020,986
Kentucky,Carter County,2,12,1805,881,924
Kentucky,Carter County,2,13,1802,878,924
Kentucky,Carter County,2,14,1382,651,731
Kentucky,Carter County,2,15,1091,522,569
Kentucky,Carter County,2,16,750,346,404
Kentucky,Carter County,2,17,496,194,302
Kentucky,Carter County,2,18,400,145,255
Kentucky,Carter County,3,0,27746,13825,13921
Kentucky,Carter County,3,1,1751,898,853
Kentucky,Carter County,3,2,1717,916,801
Kentucky,Carter County,3,3,1839,966,873
Kentucky,Carter County,3,4,1996,1039,957
Kentucky,Carter County,3,5,1748,856,892
Kentucky,Carter County,3,6,1613,832,781
Kentucky,Carter County,3,7,1700,886,814
Kentucky,Carter County,3,8,1749,883,866
Kentucky,Carter County,3,9,1841,907,934
Kentucky,Carter County,3,10,2007,983,1024
Kentucky,Carter County,3,11,2014,1026,988
Kentucky,Carter County,3,12,1817,886,931
Kentucky,Carter County,3,13,1800,879,921
Kentucky,Carter County,3,14,1389,650,739
Kentucky,Carter County,3,15,1100,528,572
Kentucky,Carter County,3,16,763,348,415
Kentucky,Carter County,3,17,502,198,304
Kentucky,Carter County,3,18,400,144,256
Kentucky,Carter County,4,0,27627,13706,13921
Kentucky,Carter County,4,1,1703,855,848
Kentucky,Carter County,4,2,1703,900,803
Kentucky,Carter County,4,3,1831,981,850
Kentucky,Carter County,4,4,1893,973,920
Kentucky,Carter County,4,5,1875,924,951
Kentucky,Carter County,4,6,1531,787,744
Kentucky,Carter County,4,7,1692,864,828
Kentucky,Carter County,4,8,1661,843,818
Kentucky,Carter County,4,9,1879,909,970
Kentucky,Carter County,4,10,1931,949,982
Kentucky,Carter County,4,11,2032,1043,989
Kentucky,Carter County,4,12,1829,891,938
Kentucky,Carter County,4,13,1835,898,937
Kentucky,Carter County,4,14,1400,640,760
Kentucky,Carter County,4,15,1132,539,593
Kentucky,Carter County,4,16,790,361,429
Kentucky,Carter County,4,17,507,204,303
Kentucky,Carter County,4,18,403,145,258
Kentucky,Carter County,5,0,27637,13635,14002
Kentucky,Carter County,5,1,1714,825,889
Kentucky,Carter County,5,2,1681,896,785
Kentucky,Carter County,5,3,1779,950,829
Kentucky,Carter County,5,4,1884,954,930
Kentucky,Carter County,5,5,1988,983,1005
Kentucky,Carter County,5,6,1465,744,721
Kentucky,Carter County,5,7,1638,840,798
Kentucky,Carter County,5,8,1678,819,859
Kentucky,Carter County,5,9,1852,896,956
Kentucky,Carter County,5,10,1887,966,921
Kentucky,Carter County,5,11,2000,1003,997
Kentucky,Carter County,5,12,1889,923,966
Kentucky,Carter County,5,13,1787,858,929
Kentucky,Carter County,5,14,1501,716,785
Kentucky,Carter County,5,15,1125,520,605
Kentucky,Carter County,5,16,836,377,459
Kentucky,Carter County,5,17,506,214,292
Kentucky,Carter County,5,18,427,151,276
Kentucky,Carter County,6,0,27600,13626,13974
Kentucky,Carter County,6,1,1684,846,838
Kentucky,Carter County,6,2,1703,908,795
Kentucky,Carter County,6,3,1723,927,796
Kentucky,Carter County,6,4,1847,929,918
Kentucky,Carter County,6,5,2053,1023,1030
Kentucky,Carter County,6,6,1474,746,728
Kentucky,Carter County,6,7,1632,829,803
Kentucky,Carter County,6,8,1640,792,848
Kentucky,Carter County,6,9,1804,887,917
Kentucky,Carter County,6,10,1877,932,945
Kentucky,Carter County,6,11,1958,986,972
Kentucky,Carter County,6,12,1934,952,982
Kentucky,Carter County,6,13,1750,832,918
Kentucky,Carter County,6,14,1549,745,804
Kentucky,Carter County,6,15,1151,528,623
Kentucky,Carter County,6,16,887,395,492
Kentucky,Carter County,6,17,500,221,279
Kentucky,Carter County,6,18,434,148,286
Kentucky,Carter County,7,0,27517,13606,13911
Kentucky,Carter County,7,1,1721,873,848
Kentucky,Carter County,7,2,1705,910,795
Kentucky,Carter County,7,3,1672,885,787
Kentucky,Carter County,7,4,1789,916,873
Kentucky,Carter County,7,5,1961,986,975
Kentucky,Carter County,7,6,1539,763,776
Kentucky,Carter County,7,7,1561,811,750
Kentucky,Carter County,7,8,1619,800,819
Kentucky,Carter County,7,9,1754,854,900
Kentucky,Carter County,7,10,1872,924,948
Kentucky,Carter County,7,11,1928,941,987
Kentucky,Carter County,7,12,1945,979,966
Kentucky,Carter County,7,13,1757,832,925
Kentucky,Carter County,7,14,1622,798,824
Kentucky,Carter County,7,15,1169,518,651
Kentucky,Carter County,7,16,915,417,498
Kentucky,Carter County,7,17,529,239,290
Kentucky,Carter County,7,18,459,160,299
Kentucky,Carter County,8,0,27439,13534,13905
Kentucky,Carter County,8,1,1765,900,865
Kentucky,Carter County,8,2,1675,871,804
Kentucky,Carter County,8,3,1666,884,782
Kentucky,Carter County,8,4,1753,887,866
Kentucky,Carter County,8,5,1870,942,928
Kentucky,Carter County,8,6,1598,791,807
Kentucky,Carter County,8,7,1540,788,752
Kentucky,Carter County,8,8,1585,806,779
Kentucky,Carter County,8,9,1690,821,869
Kentucky,Carter County,8,10,1866,910,956
Kentucky,Carter County,8,11,1902,918,984
Kentucky,Carter County,8,12,1976,1006,970
Kentucky,Carter County,8,13,1711,817,894
Kentucky,Carter County,8,14,1687,822,865
Kentucky,Carter County,8,15,1215,532,683
Kentucky,Carter County,8,16,931,430,501
Kentucky,Carter County,8,17,535,235,300
Kentucky,Carter County,8,18,474,174,300
Kentucky,Carter County,9,0,27304,13473,13831
Kentucky,Carter County,9,1,1754,885,869
Kentucky,Carter County,9,2,1623,828,795
Kentucky,Carter County,9,3,1691,883,808
Kentucky,Carter County,9,4,1734,912,822
Kentucky,Carter County,9,5,1728,872,856
Kentucky,Carter County,9,6,1677,851,826
Kentucky,Carter County,9,7,1471,743,728
Kentucky,Carter County,9,8,1599,814,785
Kentucky,Carter County,9,9,1626,794,832
Kentucky,Carter County,9,10,1904,916,988
Kentucky,Carter County,9,11,1853,898,955
Kentucky,Carter County,9,12,1963,1000,963
Kentucky,Carter County,9,13,1755,851,904
Kentucky,Carter County,9,14,1685,814,871
Kentucky,Carter County,9,15,1242,548,694
Kentucky,Carter County,9,16,956,435,521
Kentucky,Carter County,9,17,565,252,313
Kentucky,Carter County,9,18,478,177,301
Kentucky,Carter County,10,0,27214,13475,13739
Kentucky,Carter County,10,1,1792,939,853
Kentucky,Carter County,10,2,1631,802,829
Kentucky,Carter County,10,3,1681,911,770
Kentucky,Carter County,10,4,1730,910,820
Kentucky,Carter County,10,5,1692,871,821
Kentucky,Carter County,10,6,1703,843,860
Kentucky,Carter County,10,7,1402,718,684
Kentucky,Carter County,10,8,1578,814,764
Kentucky,Carter County,10,9,1614,782,832
Kentucky,Carter County,10,10,1876,896,980
Kentucky,Carter County,10,11,1796,893,903
Kentucky,Carter County,10,12,1913,961,952
Kentucky,Carter County,10,13,1793,876,917
Kentucky,Carter County,10,14,1641,777,864
Kentucky,Carter County,10,15,1343,622,721
Kentucky,Carter County,10,16,943,414,529
Kentucky,Carter County,10,17,598,263,335
Kentucky,Carter County,10,18,488,183,305
Kentucky,Carter County,11,0,27040,13318,13722
Kentucky,Carter County,11,1,1743,894,849
Kentucky,Carter County,11,2,1604,818,786
Kentucky,Carter County,11,3,1714,909,805
Kentucky,Carter County,11,4,1688,891,797
Kentucky,Carter County,11,5,1628,812,816
Kentucky,Carter County,11,6,1716,851,865
Kentucky,Carter County,11,7,1359,695,664
Kentucky,Carter County,11,8,1573,798,775
Kentucky,Carter County,11,9,1583,760,823
Kentucky,Carter County,11,10,1811,872,939
Kentucky,Carter County,11,11,1811,881,930
Kentucky,Carter County,11,12,1879,938,941
Kentucky,Carter County,11,13,1826,897,929
Kentucky,Carter County,11,14,1619,761,858
Kentucky,Carter County,11,15,1384,654,730
Kentucky,Carter County,11,16,964,424,540
Kentucky,Carter County,11,17,639,272,367
Kentucky,Carter County,11,18,499,191,308
Kentucky,Carter County,12,0,26797,13199,13598
Kentucky,Carter County,12,1,1627,840,787
Kentucky,Carter County,12,2,1625,823,802
Kentucky,Carter County,12,3,1712,908,804
Kentucky,Carter County,12,4,1661,864,797
Kentucky,Carter County,12,5,1602,807,795
Kentucky,Carter County,12,6,1673,852,821
Kentucky,Carter County,12,7,1407,679,728
Kentucky,Carter County,12,8,1502,772,730
Kentucky,Carter County,12,9,1595,801,794
Kentucky,Carter County,12,10,1727,833,894
Kentucky,Carter County,12,11,1794,873,921
Kentucky,Carter County,12,12,1832,883,949
Kentucky,Carter County,12,13,1834,911,923
Kentucky,Carter County,12,14,1621,761,860
Kentucky,Carter County,12,15,1451,699,752
Kentucky,Carter County,12,16,981,417,564
Kentucky,Carter County,12,17,646,277,369
Kentucky,Carter County,12,18,507,199,308
Kentucky,Casey County,1,0,15955,7787,8168
Kentucky,Casey County,1,1,995,511,484
Kentucky,Casey County,1,2,1002,507,495
Kentucky,Casey County,1,3,1084,547,537
Kentucky,Casey County,1,4,1018,524,494
Kentucky,Casey County,1,5,867,432,435
Kentucky,Casey County,1,6,964,456,508
Kentucky,Casey County,1,7,903,438,465
Kentucky,Casey County,1,8,1023,501,522
Kentucky,Casey County,1,9,1032,538,494
Kentucky,Casey County,1,10,1131,566,565
Kentucky,Casey County,1,11,1134,555,579
Kentucky,Casey County,1,12,1113,543,570
Kentucky,Casey County,1,13,1116,538,578
Kentucky,Casey County,1,14,859,427,432
Kentucky,Casey County,1,15,648,312,336
Kentucky,Casey County,1,16,456,204,252
Kentucky,Casey County,1,17,326,119,207
Kentucky,Casey County,1,18,284,69,215
Kentucky,Casey County,2,0,15960,7790,8170
Kentucky,Casey County,2,1,995,511,484
Kentucky,Casey County,2,2,1002,507,495
Kentucky,Casey County,2,3,1084,547,537
Kentucky,Casey County,2,4,1019,525,494
Kentucky,Casey County,2,5,867,432,435
Kentucky,Casey County,2,6,964,456,508
Kentucky,Casey County,2,7,903,438,465
Kentucky,Casey County,2,8,1023,501,522
Kentucky,Casey County,2,9,1034,539,495
Kentucky,Casey County,2,10,1130,565,565
Kentucky,Casey County,2,11,1133,555,578
Kentucky,Casey County,2,12,1113,543,570
Kentucky,Casey County,2,13,1118,539,579
Kentucky,Casey County,2,14,859,427,432
Kentucky,Casey County,2,15,648,312,336
Kentucky,Casey County,2,16,457,205,252
Kentucky,Casey County,2,17,326,119,207
Kentucky,Casey County,2,18,285,69,216
Kentucky,Casey County,3,0,15984,7800,8184
Kentucky,Casey County,3,1,986,502,484
Kentucky,Casey County,3,2,1000,508,492
Kentucky,Casey County,3,3,1086,546,540
Kentucky,Casey County,3,4,1018,525,493
Kentucky,Casey County,3,5,870,435,435
Kentucky,Casey County,3,6,962,456,506
Kentucky,Casey County,3,7,911,438,473
Kentucky,Casey County,3,8,1010,497,513
Kentucky,Casey County,3,9,1038,541,497
Kentucky,Casey County,3,10,1139,569,570
Kentucky,Casey County,3,11,1125,553,572
Kentucky,Casey County,3,12,1124,546,578
Kentucky,Casey County,3,13,1122,545,577
Kentucky,Casey County,3,14,874,432,442
Kentucky,Casey County,3,15,650,315,335
Kentucky,Casey County,3,16,455,205,250
Kentucky,Casey County,3,17,325,115,210
Kentucky,Casey County,3,18,289,72,217
Kentucky,Casey County,4,0,15911,7742,8169
Kentucky,Casey County,4,1,989,498,491
Kentucky,Casey County,4,2,971,499,472
Kentucky,Casey County,4,3,1077,537,540
Kentucky,Casey County,4,4,1013,522,491
Kentucky,Casey County,4,5,869,421,448
Kentucky,Casey County,4,6,912,421,491
Kentucky,Casey County,4,7,951,461,490
Kentucky,Casey County,4,8,959,475,484
Kentucky,Casey County,4,9,1047,551,496
Kentucky,Casey County,4,10,1129,555,574
Kentucky,Casey County,4,11,1096,539,557
Kentucky,Casey County,4,12,1131,557,574
Kentucky,Casey County,4,13,1130,558,572
Kentucky,Casey County,4,14,893,426,467
Kentucky,Casey County,4,15,667,323,344
Kentucky,Casey County,4,16,456,208,248
Kentucky,Casey County,4,17,332,115,217
Kentucky,Casey County,4,18,289,76,213
Kentucky,Casey County,5,0,16024,7835,8189
Kentucky,Casey County,5,1,1014,508,506
Kentucky,Casey County,5,2,966,501,465
Kentucky,Casey County,5,3,1086,545,541
Kentucky,Casey County,5,4,1008,529,479
Kentucky,Casey County,5,5,880,430,450
Kentucky,Casey County,5,6,902,423,479
Kentucky,Casey County,5,7,967,477,490
Kentucky,Casey County,5,8,949,463,486
Kentucky,Casey County,5,9,1075,571,504
Kentucky,Casey County,5,10,1082,523,559
Kentucky,Casey County,5,11,1103,557,546
Kentucky,Casey County,5,12,1128,554,574
Kentucky,Casey County,5,13,1105,552,553
Kentucky,Casey County,5,14,964,449,515
Kentucky,Casey County,5,15,678,327,351
Kentucky,Casey County,5,16,470,218,252
Kentucky,Casey County,5,17,347,124,223
Kentucky,Casey County,5,18,300,84,216
Kentucky,Casey County,6,0,16011,7830,8181
Kentucky,Casey County,6,1,989,490,499
Kentucky,Casey County,6,2,966,517,449
Kentucky,Casey County,6,3,1094,554,540
Kentucky,Casey County,6,4,989,493,496
Kentucky,Casey County,6,5,893,425,468
Kentucky,Casey County,6,6,886,425,461
Kentucky,Casey County,6,7,962,486,476
Kentucky,Casey County,6,8,920,451,469
Kentucky,Casey County,6,9,1095,562,533
Kentucky,Casey County,6,10,1085,535,550
Kentucky,Casey County,6,11,1087,565,522
Kentucky,Casey County,6,12,1126,547,579
Kentucky,Casey County,6,13,1074,531,543
Kentucky,Casey County,6,14,985,457,528
Kentucky,Casey County,6,15,719,341,378
Kentucky,Casey County,6,16,473,224,249
Kentucky,Casey County,6,17,362,140,222
Kentucky,Casey County,6,18,306,87,219
Kentucky,Casey County,7,0,15782,7707,8075
Kentucky,Casey County,7,1,964,488,476
Kentucky,Casey County,7,2,939,499,440
Kentucky,Casey County,7,3,1025,508,517
Kentucky,Casey County,7,4,937,463,474
Kentucky,Casey County,7,5,916,443,473
Kentucky,Casey County,7,6,905,444,461
Kentucky,Casey County,7,7,915,454,461
Kentucky,Casey County,7,8,920,460,460
Kentucky,Casey County,7,9,1030,518,512
Kentucky,Casey County,7,10,1048,547,501
Kentucky,Casey County,7,11,1098,551,547
Kentucky,Casey County,7,12,1100,544,556
Kentucky,Casey County,7,13,1055,506,549
Kentucky,Casey County,7,14,1032,484,548
Kentucky,Casey County,7,15,737,356,381
Kentucky,Casey County,7,16,487,217,270
Kentucky,Casey County,7,17,352,138,214
Kentucky,Casey County,7,18,322,87,235
Kentucky,Casey County,8,0,15749,7672,8077
Kentucky,Casey County,8,1,981,514,467
Kentucky,Casey County,8,2,952,484,468
Kentucky,Casey County,8,3,967,482,485
Kentucky,Casey County,8,4,951,472,479
Kentucky,Casey County,8,5,908,460,448
Kentucky,Casey County,8,6,921,438,483
Kentucky,Casey County,8,7,899,441,458
Kentucky,Casey County,8,8,893,452,441
Kentucky,Casey County,8,9,1025,496,529
Kentucky,Casey County,8,10,1018,537,481
Kentucky,Casey County,8,11,1115,555,560
Kentucky,Casey County,8,12,1061,522,539
Kentucky,Casey County,8,13,1062,510,552
Kentucky,Casey County,8,14,1041,492,549
Kentucky,Casey County,8,15,765,358,407
Kentucky,Casey County,8,16,512,233,279
Kentucky,Casey County,8,17,340,135,205
Kentucky,Casey County,8,18,338,91,247
Kentucky,Casey County,9,0,15775,7640,8135
Kentucky,Casey County,9,1,1005,498,507
Kentucky,Casey County,9,2,954,488,466
Kentucky,Casey County,9,3,958,487,471
Kentucky,Casey County,9,4,959,485,474
Kentucky,Casey County,9,5,916,456,460
Kentucky,Casey County,9,6,923,446,477
Kentucky,Casey County,9,7,862,426,436
Kentucky,Casey County,9,8,904,437,467
Kentucky,Casey County,9,9,960,459,501
Kentucky,Casey County,9,10,1049,549,500
Kentucky,Casey County,9,11,1101,542,559
Kentucky,Casey County,9,12,1041,520,521
Kentucky,Casey County,9,13,1063,507,556
Kentucky,Casey County,9,14,1066,514,552
Kentucky,Casey County,9,15,800,360,440
Kentucky,Casey County,9,16,532,241,291
Kentucky,Casey County,9,17,328,127,201
Kentucky,Casey County,9,18,354,98,256
Kentucky,Casey County,10,0,15818,7657,8161
Kentucky,Casey County,10,1,1031,516,515
Kentucky,Casey County,10,2,986,494,492
Kentucky,Casey County,10,3,951,489,462
Kentucky,Casey County,10,4,942,481,461
Kentucky,Casey County,10,5,894,450,444
Kentucky,Casey County,10,6,937,441,496
Kentucky,Casey County,10,7,873,416,457
Kentucky,Casey County,10,8,898,461,437
Kentucky,Casey County,10,9,934,434,500
Kentucky,Casey County,10,10,1047,536,511
Kentucky,Casey County,10,11,1060,524,536
Kentucky,Casey County,10,12,1038,529,509
Kentucky,Casey County,10,13,1064,505,559
Kentucky,Casey County,10,14,1036,503,533
Kentucky,Casey County,10,15,872,389,483
Kentucky,Casey County,10,16,549,245,304
Kentucky,Casey County,10,17,344,134,210
Kentucky,Casey County,10,18,362,110,252
Kentucky,Casey County,11,0,15926,7715,8211
Kentucky,Casey County,11,1,1028,500,528
Kentucky,Casey County,11,2,994,501,493
Kentucky,Casey County,11,3,998,530,468
Kentucky,Casey County,11,4,942,475,467
Kentucky,Casey County,11,5,857,419,438
Kentucky,Casey County,11,6,994,469,525
Kentucky,Casey County,11,7,841,425,416
Kentucky,Casey County,11,8,900,459,441
Kentucky,Casey County,11,9,922,431,491
Kentucky,Casey County,11,10,1053,529,524
Kentucky,Casey County,11,11,1055,538,517
Kentucky,Casey County,11,12,1039,521,518
Kentucky,Casey County,11,13,1076,512,564
Kentucky,Casey County,11,14,1003,479,524
Kentucky,Casey County,11,15,896,407,489
Kentucky,Casey County,11,16,608,268,340
Kentucky,Casey County,11,17,345,138,207
Kentucky,Casey County,11,18,375,114,261
Kentucky,Casey County,12,0,16159,7869,8290
Kentucky,Casey County,12,1,1029,510,519
Kentucky,Casey County,12,2,1020,514,506
Kentucky,Casey County,12,3,1038,564,474
Kentucky,Casey County,12,4,934,461,473
Kentucky,Casey County,12,5,848,411,437
Kentucky,Casey County,12,6,1054,502,552
Kentucky,Casey County,12,7,881,435,446
Kentucky,Casey County,12,8,910,480,430
Kentucky,Casey County,12,9,927,438,489
Kentucky,Casey County,12,10,1029,503,526
Kentucky,Casey County,12,11,1014,540,474
Kentucky,Casey County,12,12,1111,557,554
Kentucky,Casey County,12,13,1071,515,556
Kentucky,Casey County,12,14,1004,477,527
Kentucky,Casey County,12,15,924,428,496
Kentucky,Casey County,12,16,627,287,340
Kentucky,Casey County,12,17,369,142,227
Kentucky,Casey County,12,18,369,105,264
Kentucky,Christian County,1,0,73955,37482,36473
Kentucky,Christian County,1,1,7243,3704,3539
Kentucky,Christian County,1,2,6081,3121,2960
Kentucky,Christian County,1,3,5048,2610,2438
Kentucky,Christian County,1,4,4967,2738,2229
Kentucky,Christian County,1,5,8047,4898,3149
Kentucky,Christian County,1,6,6918,3645,3273
Kentucky,Christian County,1,7,5172,2570,2602
Kentucky,Christian County,1,8,4297,2121,2176
Kentucky,Christian County,1,9,4009,1982,2027
Kentucky,Christian County,1,10,4059,1927,2132
Kentucky,Christian County,1,11,3896,1864,2032
Kentucky,Christian County,1,12,3644,1757,1887
Kentucky,Christian County,1,13,2981,1376,1605
Kentucky,Christian County,1,14,2289,1027,1262
Kentucky,Christian County,1,15,1813,818,995
Kentucky,Christian County,1,16,1476,668,808
Kentucky,Christian County,1,17,1052,379,673
Kentucky,Christian County,1,18,963,277,686
Kentucky,Christian County,2,0,73940,37474,36466
Kentucky,Christian County,2,1,7240,3703,3537
Kentucky,Christian County,2,2,6079,3119,2960
Kentucky,Christian County,2,3,5044,2608,2436
Kentucky,Christian County,2,4,4966,2738,2228
Kentucky,Christian County,2,5,8047,4898,3149
Kentucky,Christian County,2,6,6917,3644,3273
Kentucky,Christian County,2,7,5168,2568,2600
Kentucky,Christian County,2,8,4297,2121,2176
Kentucky,Christian County,2,9,4007,1982,2025
Kentucky,Christian County,2,10,4058,1926,2132
Kentucky,Christian County,2,11,3897,1864,2033
Kentucky,Christian County,2,12,3644,1757,1887
Kentucky,Christian County,2,13,2981,1376,1605
Kentucky,Christian County,2,14,2288,1026,1262
Kentucky,Christian County,2,15,1815,819,996
Kentucky,Christian County,2,16,1477,669,808
Kentucky,Christian County,2,17,1052,379,673
Kentucky,Christian County,2,18,963,277,686
Kentucky,Christian County,3,0,74130,37702,36428
Kentucky,Christian County,3,1,7283,3726,3557
Kentucky,Christian County,3,2,6091,3120,2971
Kentucky,Christian County,3,3,5052,2604,2448
Kentucky,Christian County,3,4,5008,2807,2201
Kentucky,Christian County,3,5,8150,4986,3164
Kentucky,Christian County,3,6,6960,3700,3260
Kentucky,Christian County,3,7,5194,2594,2600
Kentucky,Christian County,3,8,4259,2105,2154
Kentucky,Christian County,3,9,3976,1965,2011
Kentucky,Christian County,3,10,4016,1907,2109
Kentucky,Christian County,3,11,3880,1856,2024
Kentucky,Christian County,3,12,3637,1760,1877
Kentucky,Christian County,3,13,2988,1382,1606
Kentucky,Christian County,3,14,2306,1039,1267
Kentucky,Christian County,3,15,1819,817,1002
Kentucky,Christian County,3,16,1478,668,810
Kentucky,Christian County,3,17,1060,384,676
Kentucky,Christian County,3,18,973,282,691
Kentucky,Christian County,4,0,73464,37534,35930
Kentucky,Christian County,4,1,7247,3717,3530
Kentucky,Christian County,4,2,6200,3172,3028
Kentucky,Christian County,4,3,5081,2602,2479
Kentucky,Christian County,4,4,4801,2764,2037
Kentucky,Christian County,4,5,7987,5011,2976
Kentucky,Christian County,4,6,6846,3657,3189
Kentucky,Christian County,4,7,5302,2635,2667
Kentucky,Christian County,4,8,4127,2089,2038
Kentucky,Christian County,4,9,3891,1902,1989
Kentucky,Christian County,4,10,3816,1792,2024
Kentucky,Christian County,4,11,3795,1819,1976
Kentucky,Christian County,4,12,3610,1731,1879
Kentucky,Christian County,4,13,3054,1421,1633
Kentucky,Christian County,4,14,2335,1055,1280
Kentucky,Christian County,4,15,1862,825,1037
Kentucky,Christian County,4,16,1447,641,806
Kentucky,Christian County,4,17,1083,408,675
Kentucky,Christian County,4,18,980,293,687
Kentucky,Christian County,5,0,74892,38844,36048
Kentucky,Christian County,5,1,7262,3716,3546
Kentucky,Christian County,5,2,6254,3174,3080
Kentucky,Christian County,5,3,5081,2628,2453
Kentucky,Christian County,5,4,4674,2690,1984
Kentucky,Christian County,5,5,8818,5689,3129
Kentucky,Christian County,5,6,7183,4007,3176
Kentucky,Christian County,5,7,5669,2894,2775
Kentucky,Christian County,5,8,4252,2196,2056
Kentucky,Christian County,5,9,3821,1915,1906
Kentucky,Christian County,5,10,3691,1696,1995
Kentucky,Christian County,5,11,3671,1782,1889
Kentucky,Christian County,5,12,3624,1719,1905
Kentucky,Christian County,5,13,3022,1431,1591
Kentucky,Christian County,5,14,2434,1100,1334
Kentucky,Christian County,5,15,1907,832,1075
Kentucky,Christian County,5,16,1447,652,795
Kentucky,Christian County,5,17,1087,425,662
Kentucky,Christian County,5,18,995,298,697
Kentucky,Christian County,6,0,73612,38511,35101
Kentucky,Christian County,6,1,6996,3580,3416
Kentucky,Christian County,6,2,6104,3132,2972
Kentucky,Christian County,6,3,5000,2590,2410
Kentucky,Christian County,6,4,4680,2696,1984
Kentucky,Christian County,6,5,8863,5885,2978
Kentucky,Christian County,6,6,6956,3948,3008
Kentucky,Christian County,6,7,5558,2879,2679
Kentucky,Christian County,6,8,4176,2112,2064
Kentucky,Christian County,6,9,3688,1888,1800
Kentucky,Christian County,6,10,3476,1621,1855
Kentucky,Christian County,6,11,3578,1697,1881
Kentucky,Christian County,6,12,3521,1666,1855
Kentucky,Christian County,6,13,3020,1452,1568
Kentucky,Christian County,6,14,2503,1128,1375
Kentucky,Christian County,6,15,1926,813,1113
Kentucky,Christian County,6,16,1492,675,817
Kentucky,Christian County,6,17,1052,443,609
Kentucky,Christian County,6,18,1023,306,717
Kentucky,Christian County,7,0,73282,38621,34661
Kentucky,Christian County,7,1,6894,3606,3288
Kentucky,Christian County,7,2,5868,3043,2825
Kentucky,Christian County,7,3,4963,2500,2463
Kentucky,Christian County,7,4,4564,2625,1939
Kentucky,Christian County,7,5,9172,6239,2933
Kentucky,Christian County,7,6,7056,4058,2998
Kentucky,Christian County,7,7,5466,2826,2640
Kentucky,Christian County,7,8,4211,2148,2063
Kentucky,Christian County,7,9,3531,1801,1730
Kentucky,Christian County,7,10,3348,1566,1782
Kentucky,Christian County,7,11,3537,1660,1877
Kentucky,Christian County,7,12,3414,1620,1794
Kentucky,Christian County,7,13,3067,1462,1605
Kentucky,Christian County,7,14,2594,1192,1402
Kentucky,Christian County,7,15,1955,823,1132
Kentucky,Christian County,7,16,1532,674,858
Kentucky,Christian County,7,17,1059,465,594
Kentucky,Christian County,7,18,1051,313,738
Kentucky,Christian County,8,0,73075,38774,34301
Kentucky,Christian County,8,1,6922,3551,3371
Kentucky,Christian County,8,2,5822,2993,2829
Kentucky,Christian County,8,3,4797,2462,2335
Kentucky,Christian County,8,4,4625,2683,1942
Kentucky,Christian County,8,5,9466,6559,2907
Kentucky,Christian County,8,6,7097,4130,2967
Kentucky,Christian County,8,7,5185,2702,2483
Kentucky,Christian County,8,8,4219,2158,2061
Kentucky,Christian County,8,9,3482,1770,1712
Kentucky,Christian County,8,10,3239,1537,1702
Kentucky,Christian County,8,11,3425,1605,1820
Kentucky,Christian County,8,12,3355,1593,1762
Kentucky,Christian County,8,13,3124,1490,1634
Kentucky,Christian County,8,14,2608,1190,1418
Kentucky,Christian County,8,15,2007,869,1138
Kentucky,Christian County,8,16,1525,664,861
Kentucky,Christian County,8,17,1080,472,608
Kentucky,Christian County,8,18,1097,346,751
Kentucky,Christian County,9,0,71796,38245,33551
Kentucky,Christian County,9,1,6815,3609,3206
Kentucky,Christian County,9,2,5506,2794,2712
Kentucky,Christian County,9,3,4707,2430,2277
Kentucky,Christian County,9,4,4658,2704,1954
Kentucky,Christian County,9,5,9339,6480,2859
Kentucky,Christian County,9,6,6864,4051,2813
Kentucky,Christian County,9,7,5002,2623,2379
Kentucky,Christian County,9,8,4122,2083,2039
Kentucky,Christian County,9,9,3274,1678,1596
Kentucky,Christian County,9,10,3230,1553,1677
Kentucky,Christian County,9,11,3318,1528,1790
Kentucky,Christian County,9,12,3337,1582,1755
Kentucky,Christian County,9,13,3144,1488,1656
Kentucky,Christian County,9,14,2669,1233,1436
Kentucky,Christian County,9,15,2043,910,1133
Kentucky,Christian County,9,16,1566,672,894
Kentucky,Christian County,9,17,1087,460,627
Kentucky,Christian County,9,18,1115,367,748
Kentucky,Christian County,10,0,71024,38004,33020
Kentucky,Christian County,10,1,6539,3480,3059
Kentucky,Christian County,10,2,5239,2639,2600
Kentucky,Christian County,10,3,4674,2421,2253
Kentucky,Christian County,10,4,4670,2740,1930
Kentucky,Christian County,10,5,9623,6710,2913
Kentucky,Christian County,10,6,6950,4133,2817
Kentucky,Christian County,10,7,4812,2544,2268
Kentucky,Christian County,10,8,3919,1975,1944
Kentucky,Christian County,10,9,3175,1586,1589
Kentucky,Christian County,10,10,3173,1554,1619
Kentucky,Christian County,10,11,3161,1439,1722
Kentucky,Christian County,10,12,3269,1580,1689
Kentucky,Christian County,10,13,3208,1505,1703
Kentucky,Christian County,10,14,2627,1220,1407
Kentucky,Christian County,10,15,2140,939,1201
Kentucky,Christian County,10,16,1623,693,930
Kentucky,Christian County,10,17,1091,462,629
Kentucky,Christian County,10,18,1131,384,747
Kentucky,Christian County,11,0,70712,37647,33065
Kentucky,Christian County,11,1,6628,3459,3169
Kentucky,Christian County,11,2,5266,2701,2565
Kentucky,Christian County,11,3,4596,2398,2198
Kentucky,Christian County,11,4,4650,2704,1946
Kentucky,Christian County,11,5,9351,6429,2922
Kentucky,Christian County,11,6,7017,4168,2849
Kentucky,Christian County,11,7,4721,2465,2256
Kentucky,Christian County,11,8,3964,2033,1931
Kentucky,Christian County,11,9,3162,1544,1618
Kentucky,Christian County,11,10,3117,1533,1584
Kentucky,Christian County,11,11,3022,1390,1632
Kentucky,Christian County,11,12,3287,1577,1710
Kentucky,Christian County,11,13,3145,1447,1698
Kentucky,Christian County,11,14,2638,1258,1380
Kentucky,Christian County,11,15,2221,979,1242
Kentucky,Christian County,11,16,1646,676,970
Kentucky,Christian County,11,17,1151,494,657
Kentucky,Christian County,11,18,1130,392,738
Kentucky,Christian County,12,0,70461,37354,33107
Kentucky,Christian County,12,1,6668,3463,3205
Kentucky,Christian County,12,2,5329,2782,2547
Kentucky,Christian County,12,3,4575,2353,2222
Kentucky,Christian County,12,4,4584,2669,1915
Kentucky,Christian County,12,5,8891,6115,2776
Kentucky,Christian County,12,6,7194,4260,2934
Kentucky,Christian County,12,7,4768,2483,2285
Kentucky,Christian County,12,8,3941,1981,1960
Kentucky,Christian County,12,9,3204,1562,1642
Kentucky,Christian County,12,10,3021,1466,1555
Kentucky,Christian County,12,11,2975,1369,1606
Kentucky,Christian County,12,12,3282,1542,1740
Kentucky,Christian County,12,13,3046,1413,1633
Kentucky,Christian County,12,14,2706,1288,1418
Kentucky,Christian County,12,15,2285,1023,1262
Kentucky,Christian County,12,16,1646,675,971
Kentucky,Christian County,12,17,1172,485,687
Kentucky,Christian County,12,18,1174,425,749
Kentucky,Clark County,1,0,35613,17394,18219
Kentucky,Clark County,1,1,2244,1177,1067
Kentucky,Clark County,1,2,2274,1235,1039
Kentucky,Clark County,1,3,2346,1176,1170
Kentucky,Clark County,1,4,2273,1188,1085
Kentucky,Clark County,1,5,1859,932,927
Kentucky,Clark County,1,6,2043,991,1052
Kentucky,Clark County,1,7,2292,1102,1190
Kentucky,Clark County,1,8,2596,1291,1305
Kentucky,Clark County,1,9,2427,1212,1215
Kentucky,Clark County,1,10,2764,1357,1407
Kentucky,Clark County,1,11,2714,1308,1406
Kentucky,Clark County,1,12,2424,1155,1269
Kentucky,Clark County,1,13,2311,1079,1232
Kentucky,Clark County,1,14,1591,775,816
Kentucky,Clark County,1,15,1228,545,683
Kentucky,Clark County,1,16,937,379,558
Kentucky,Clark County,1,17,677,285,392
Kentucky,Clark County,1,18,613,207,406
Kentucky,Clark County,2,0,35603,17386,18217
Kentucky,Clark County,2,1,2242,1175,1067
Kentucky,Clark County,2,2,2271,1232,1039
Kentucky,Clark County,2,3,2345,1175,1170
Kentucky,Clark County,2,4,2273,1188,1085
Kentucky,Clark County,2,5,1859,932,927
Kentucky,Clark County,2,6,2042,991,1051
Kentucky,Clark County,2,7,2292,1102,1190
Kentucky,Clark County,2,8,2595,1290,1305
Kentucky,Clark County,2,9,2426,1212,1214
Kentucky,Clark County,2,10,2764,1357,1407
Kentucky,Clark County,2,11,2714,1308,1406
Kentucky,Clark County,2,12,2424,1155,1269
Kentucky,Clark County,2,13,2311,1079,1232
Kentucky,Clark County,2,14,1591,775,816
Kentucky,Clark County,2,15,1227,544,683
Kentucky,Clark County,2,16,937,379,558
Kentucky,Clark County,2,17,677,285,392
Kentucky,Clark County,2,18,613,207,406
Kentucky,Clark County,3,0,35603,17388,18215
Kentucky,Clark County,3,1,2229,1168,1061
Kentucky,Clark County,3,2,2261,1228,1033
Kentucky,Clark County,3,3,2347,1179,1168
Kentucky,Clark County,3,4,2259,1185,1074
Kentucky,Clark County,3,5,1873,942,931
Kentucky,Clark County,3,6,2063,995,1068
Kentucky,Clark County,3,7,2277,1095,1182
Kentucky,Clark County,3,8,2562,1266,1296
Kentucky,Clark County,3,9,2431,1213,1218
Kentucky,Clark County,3,10,2756,1352,1404
Kentucky,Clark County,3,11,2720,1314,1406
Kentucky,Clark County,3,12,2425,1157,1268
Kentucky,Clark County,3,13,2325,1090,1235
Kentucky,Clark County,3,14,1606,780,826
Kentucky,Clark County,3,15,1236,554,682
Kentucky,Clark County,3,16,933,378,555
Kentucky,Clark County,3,17,684,280,404
Kentucky,Clark County,3,18,616,212,404
Kentucky,Clark County,4,0,35434,17277,18157
Kentucky,Clark County,4,1,2172,1121,1051
Kentucky,Clark County,4,2,2237,1223,1014
Kentucky,Clark County,4,3,2327,1162,1165
Kentucky,Clark County,4,4,2162,1133,1029
Kentucky,Clark County,4,5,1911,956,955
Kentucky,Clark County,4,6,1957,957,1000
Kentucky,Clark County,4,7,2203,1076,1127
Kentucky,Clark County,4,8,2454,1185,1269
Kentucky,Clark County,4,9,2499,1240,1259
Kentucky,Clark County,4,10,2672,1306,1366
Kentucky,Clark County,4,11,2754,1321,1433
Kentucky,Clark County,4,12,2466,1182,1284
Kentucky,Clark County,4,13,2413,1141,1272
Kentucky,Clark County,4,14,1646,797,849
Kentucky,Clark County,4,15,1292,594,698
Kentucky,Clark County,4,16,944,386,558
Kentucky,Clark County,4,17,707,272,435
Kentucky,Clark County,4,18,618,225,393
Kentucky,Clark County,5,0,35685,17410,18275
Kentucky,Clark County,5,1,2203,1129,1074
Kentucky,Clark County,5,2,2289,1233,1056
Kentucky,Clark County,5,3,2302,1166,1136
Kentucky,Clark County,5,4,2200,1167,1033
Kentucky,Clark County,5,5,1971,988,983
Kentucky,Clark County,5,6,1962,942,1020
Kentucky,Clark County,5,7,2098,1018,1080
Kentucky,Clark County,5,8,2417,1170,1247
Kentucky,Clark County,5,9,2569,1294,1275
Kentucky,Clark County,5,10,2595,1261,1334
Kentucky,Clark County,5,11,2747,1328,1419
Kentucky,Clark County,5,12,2547,1238,1309
Kentucky,Clark County,5,13,2331,1110,1221
Kentucky,Clark County,5,14,1827,869,958
Kentucky,Clark County,5,15,1362,624,738
Kentucky,Clark County,5,16,944,386,558
Kentucky,Clark County,5,17,696,262,434
Kentucky,Clark County,5,18,625,225,400
Kentucky,Clark County,6,0,35550,17337,18213
Kentucky,Clark County,6,1,2147,1105,1042
Kentucky,Clark County,6,2,2296,1208,1088
Kentucky,Clark County,6,3,2332,1208,1124
Kentucky,Clark County,6,4,2157,1127,1030
Kentucky,Clark County,6,5,2000,999,1001
Kentucky,Clark County,6,6,1943,980,963
Kentucky,Clark County,6,7,2068,984,1084
Kentucky,Clark County,6,8,2321,1106,1215
Kentucky,Clark County,6,9,2593,1310,1283
Kentucky,Clark County,6,10,2478,1189,1289
Kentucky,Clark County,6,11,2745,1351,1394
Kentucky,Clark County,6,12,2533,1217,1316
Kentucky,Clark County,6,13,2278,1083,1195
Kentucky,Clark County,6,14,1925,903,1022
Kentucky,Clark County,6,15,1440,667,773
Kentucky,Clark County,6,16,994,416,578
Kentucky,Clark County,6,17,693,264,429
Kentucky,Clark County,6,18,607,220,387
Kentucky,Clark County,7,0,35622,17382,18240
Kentucky,Clark County,7,1,2110,1100,1010
Kentucky,Clark County,7,2,2276,1195,1081
Kentucky,Clark County,7,3,2309,1203,1106
Kentucky,Clark County,7,4,2160,1107,1053
Kentucky,Clark County,7,5,2064,1040,1024
Kentucky,Clark County,7,6,1976,1001,975
Kentucky,Clark County,7,7,2067,994,1073
Kentucky,Clark County,7,8,2260,1078,1182
Kentucky,Clark County,7,9,2527,1257,1270
Kentucky,Clark County,7,10,2437,1178,1259
Kentucky,Clark County,7,11,2730,1326,1404
Kentucky,Clark County,7,12,2593,1252,1341
Kentucky,Clark County,7,13,2295,1078,1217
Kentucky,Clark County,7,14,2058,963,1095
Kentucky,Clark County,7,15,1428,690,738
Kentucky,Clark County,7,16,1002,417,585
Kentucky,Clark County,7,17,703,270,433
Kentucky,Clark County,7,18,627,233,394
Kentucky,Clark County,8,0,35660,17430,18230
Kentucky,Clark County,8,1,2193,1173,1020
Kentucky,Clark County,8,2,2239,1163,1076
Kentucky,Clark County,8,3,2278,1196,1082
Kentucky,Clark County,8,4,2149,1078,1071
Kentucky,Clark County,8,5,2078,1079,999
Kentucky,Clark County,8,6,2021,990,1031
Kentucky,Clark County,8,7,2034,989,1045
Kentucky,Clark County,8,8,2257,1094,1163
Kentucky,Clark County,8,9,2461,1203,1258
Kentucky,Clark County,8,10,2428,1186,1242
Kentucky,Clark County,8,11,2685,1318,1367
Kentucky,Clark County,8,12,2587,1231,1356
Kentucky,Clark County,8,13,2307,1094,1213
Kentucky,Clark County,8,14,2116,986,1130
Kentucky,Clark County,8,15,1449,707,742
Kentucky,Clark County,8,16,1030,437,593
Kentucky,Clark County,8,17,700,274,426
Kentucky,Clark County,8,18,648,232,416
Kentucky,Clark County,9,0,35851,17521,18330
Kentucky,Clark County,9,1,2238,1145,1093
Kentucky,Clark County,9,2,2219,1156,1063
Kentucky,Clark County,9,3,2259,1197,1062
Kentucky,Clark County,9,4,2155,1091,1064
Kentucky,Clark County,9,5,2045,1082,963
Kentucky,Clark County,9,6,2095,1043,1052
Kentucky,Clark County,9,7,2068,1011,1057
Kentucky,Clark County,9,8,2180,1056,1124
Kentucky,Clark County,9,9,2401,1155,1246
Kentucky,Clark County,9,10,2494,1227,1267
Kentucky,Clark County,9,11,2636,1287,1349
Kentucky,Clark County,9,12,2591,1232,1359
Kentucky,Clark County,9,13,2328,1108,1220
Kentucky,Clark County,9,14,2200,1036,1164
Kentucky,Clark County,9,15,1485,712,773
Kentucky,Clark County,9,16,1079,474,605
Kentucky,Clark County,9,17,709,278,431
Kentucky,Clark County,9,18,669,231,438
Kentucky,Clark County,10,0,35899,17579,18320
Kentucky,Clark County,10,1,2221,1152,1069
Kentucky,Clark County,10,2,2211,1164,1047
Kentucky,Clark County,10,3,2285,1192,1093
Kentucky,Clark County,10,4,2112,1092,1020
Kentucky,Clark County,10,5,2056,1081,975
Kentucky,Clark County,10,6,2136,1089,1047
Kentucky,Clark County,10,7,2093,1017,1076
Kentucky,Clark County,10,8,2042,995,1047
Kentucky,Clark County,10,9,2362,1116,1246
Kentucky,Clark County,10,10,2566,1289,1277
Kentucky,Clark County,10,11,2575,1241,1334
Kentucky,Clark County,10,12,2619,1251,1368
Kentucky,Clark County,10,13,2357,1125,1232
Kentucky,Clark County,10,14,2094,985,1109
Kentucky,Clark County,10,15,1628,765,863
Kentucky,Clark County,10,16,1124,506,618
Kentucky,Clark County,10,17,727,286,441
Kentucky,Clark County,10,18,691,233,458
Kentucky,Clark County,11,0,36180,17679,18501
Kentucky,Clark County,11,1,2222,1158,1064
Kentucky,Clark County,11,2,2209,1153,1056
Kentucky,Clark County,11,3,2331,1214,1117
Kentucky,Clark County,11,4,2073,1086,987
Kentucky,Clark County,11,5,2035,1048,987
Kentucky,Clark County,11,6,2289,1160,1129
Kentucky,Clark County,11,7,2113,1050,1063
Kentucky,Clark County,11,8,2071,998,1073
Kentucky,Clark County,11,9,2299,1085,1214
Kentucky,Clark County,11,10,2539,1275,1264
Kentucky,Clark County,11,11,2509,1197,1312
Kentucky,Clark County,11,12,2674,1285,1389
Kentucky,Clark County,11,13,2375,1127,1248
Kentucky,Clark County,11,14,2055,955,1100
Kentucky,Clark County,11,15,1734,798,936
Kentucky,Clark County,11,16,1185,546,639
Kentucky,Clark County,11,17,758,295,463
Kentucky,Clark County,11,18,709,249,460
Kentucky,Clark County,12,0,36263,17702,18561
Kentucky,Clark County,12,1,2193,1121,1072
Kentucky,Clark County,12,2,2175,1162,1013
Kentucky,Clark County,12,3,2320,1212,1108
Kentucky,Clark County,12,4,2094,1104,990
Kentucky,Clark County,12,5,2058,1054,1004
Kentucky,Clark County,12,6,2391,1207,1184
Kentucky,Clark County,12,7,2074,1030,1044
Kentucky,Clark County,12,8,2121,1027,1094
Kentucky,Clark County,12,9,2214,1056,1158
Kentucky,Clark County,12,10,2510,1239,1271
Kentucky,Clark County,12,11,2456,1166,1290
Kentucky,Clark County,12,12,2629,1281,1348
Kentucky,Clark County,12,13,2419,1138,1281
Kentucky,Clark County,12,14,2074,953,1121
Kentucky,Clark County,12,15,1840,832,1008
Kentucky,Clark County,12,16,1153,545,608
Kentucky,Clark County,12,17,806,317,489
Kentucky,Clark County,12,18,736,258,478
Kentucky,Clay County,1,0,21730,11611,10119
Kentucky,Clay County,1,1,1289,680,609
Kentucky,Clay County,1,2,1229,629,600
Kentucky,Clay County,1,3,1242,650,592
Kentucky,Clay County,1,4,1633,819,814
Kentucky,Clay County,1,5,1358,744,614
Kentucky,Clay County,1,6,1499,898,601
Kentucky,Clay County,1,7,1716,1060,656
Kentucky,Clay County,1,8,1692,1026,666
Kentucky,Clay County,1,9,1642,920,722
Kentucky,Clay County,1,10,1689,926,763
Kentucky,Clay County,1,11,1520,815,705
Kentucky,Clay County,1,12,1389,686,703
Kentucky,Clay County,1,13,1210,586,624
Kentucky,Clay County,1,14,922,446,476
Kentucky,Clay County,1,15,687,330,357
Kentucky,Clay County,1,16,469,215,254
Kentucky,Clay County,1,17,284,97,187
Kentucky,Clay County,1,18,260,84,176
Kentucky,Clay County,2,0,21729,11610,10119
Kentucky,Clay County,2,1,1288,679,609
Kentucky,Clay County,2,2,1229,629,600
Kentucky,Clay County,2,3,1242,650,592
Kentucky,Clay County,2,4,1633,819,814
Kentucky,Clay County,2,5,1358,744,614
Kentucky,Clay County,2,6,1499,898,601
Kentucky,Clay County,2,7,1716,1060,656
Kentucky,Clay County,2,8,1691,1026,665
Kentucky,Clay County,2,9,1642,920,722
Kentucky,Clay County,2,10,1689,926,763
Kentucky,Clay County,2,11,1520,815,705
Kentucky,Clay County,2,12,1389,686,703
Kentucky,Clay County,2,13,1210,586,624
Kentucky,Clay County,2,14,922,446,476
Kentucky,Clay County,2,15,688,330,358
Kentucky,Clay County,2,16,469,215,254
Kentucky,Clay County,2,17,284,97,187
Kentucky,Clay County,2,18,260,84,176
Kentucky,Clay County,3,0,21660,11542,10118
Kentucky,Clay County,3,1,1300,680,620
Kentucky,Clay County,3,2,1226,624,602
Kentucky,Clay County,3,3,1231,642,589
Kentucky,Clay County,3,4,1601,799,802
Kentucky,Clay County,3,5,1368,751,617
Kentucky,Clay County,3,6,1506,895,611
Kentucky,Clay County,3,7,1694,1049,645
Kentucky,Clay County,3,8,1680,1012,668
Kentucky,Clay County,3,9,1638,919,719
Kentucky,Clay County,3,10,1681,926,755
Kentucky,Clay County,3,11,1522,806,716
Kentucky,Clay County,3,12,1380,687,693
Kentucky,Clay County,3,13,1210,585,625
Kentucky,Clay County,3,14,925,449,476
Kentucky,Clay County,3,15,686,321,365
Kentucky,Clay County,3,16,477,220,257
Kentucky,Clay County,3,17,278,95,183
Kentucky,Clay County,3,18,257,82,175
Kentucky,Clay County,4,0,21591,11538,10053
Kentucky,Clay County,4,1,1332,681,651
Kentucky,Clay County,4,2,1231,625,606
Kentucky,Clay County,4,3,1195,639,556
Kentucky,Clay County,4,4,1479,738,741
Kentucky,Clay County,4,5,1420,787,633
Kentucky,Clay County,4,6,1565,930,635
Kentucky,Clay County,4,7,1631,1024,607
Kentucky,Clay County,4,8,1639,975,664
Kentucky,Clay County,4,9,1649,934,715
Kentucky,Clay County,4,10,1651,927,724
Kentucky,Clay County,4,11,1561,802,759
Kentucky,Clay County,4,12,1373,695,678
Kentucky,Clay County,4,13,1235,605,630
Kentucky,Clay County,4,14,934,453,481
Kentucky,Clay County,4,15,694,316,378
Kentucky,Clay County,4,16,490,231,259
Kentucky,Clay County,4,17,269,96,173
Kentucky,Clay County,4,18,243,80,163
Kentucky,Clay County,5,0,21518,11491,10027
Kentucky,Clay County,5,1,1317,675,642
Kentucky,Clay County,5,2,1233,624,609
Kentucky,Clay County,5,3,1195,658,537
Kentucky,Clay County,5,4,1400,699,701
Kentucky,Clay County,5,5,1446,795,651
Kentucky,Clay County,5,6,1559,928,631
Kentucky,Clay County,5,7,1640,1002,638
Kentucky,Clay County,5,8,1598,952,646
Kentucky,Clay County,5,9,1638,939,699
Kentucky,Clay County,5,10,1619,897,722
Kentucky,Clay County,5,11,1583,818,765
Kentucky,Clay County,5,12,1377,697,680
Kentucky,Clay County,5,13,1223,606,617
Kentucky,Clay County,5,14,975,455,520
Kentucky,Clay County,5,15,718,328,390
Kentucky,Clay County,5,16,478,230,248
Kentucky,Clay County,5,17,280,111,169
Kentucky,Clay County,5,18,239,77,162
Kentucky,Clay County,6,0,21186,11280,9906
Kentucky,Clay County,6,1,1271,662,609
Kentucky,Clay County,6,2,1227,624,603
Kentucky,Clay County,6,3,1161,638,523
Kentucky,Clay County,6,4,1311,665,646
Kentucky,Clay County,6,5,1403,742,661
Kentucky,Clay County,6,6,1518,914,604
Kentucky,Clay County,6,7,1615,964,651
Kentucky,Clay County,6,8,1558,924,634
Kentucky,Clay County,6,9,1600,914,686
Kentucky,Clay County,6,10,1577,869,708
Kentucky,Clay County,6,11,1538,791,747
Kentucky,Clay County,6,12,1401,710,691
Kentucky,Clay County,6,13,1228,619,609
Kentucky,Clay County,6,14,1014,470,544
Kentucky,Clay County,6,15,727,334,393
Kentucky,Clay County,6,16,492,229,263
Kentucky,Clay County,6,17,296,128,168
Kentucky,Clay County,6,18,249,83,166
Kentucky,Clay County,7,0,21081,11217,9864
Kentucky,Clay County,7,1,1300,676,624
Kentucky,Clay County,7,2,1204,621,583
Kentucky,Clay County,7,3,1180,642,538
Kentucky,Clay County,7,4,1237,640,597
Kentucky,Clay County,7,5,1388,742,646
Kentucky,Clay County,7,6,1506,906,600
Kentucky,Clay County,7,7,1596,965,631
Kentucky,Clay County,7,8,1531,899,632
Kentucky,Clay County,7,9,1557,890,667
Kentucky,Clay County,7,10,1548,843,705
Kentucky,Clay County,7,11,1576,822,754
Kentucky,Clay County,7,12,1359,684,675
Kentucky,Clay County,7,13,1271,634,637
Kentucky,Clay County,7,14,1039,475,564
Kentucky,Clay County,7,15,721,340,381
Kentucky,Clay County,7,16,518,229,289
Kentucky,Clay County,7,17,298,129,169
Kentucky,Clay County,7,18,252,80,172
Kentucky,Clay County,8,0,20974,11108,9866
Kentucky,Clay County,8,1,1319,661,658
Kentucky,Clay County,8,2,1186,610,576
Kentucky,Clay County,8,3,1156,613,543
Kentucky,Clay County,8,4,1207,628,579
Kentucky,Clay County,8,5,1345,716,629
Kentucky,Clay County,8,6,1538,929,609
Kentucky,Clay County,8,7,1534,943,591
Kentucky,Clay County,8,8,1534,890,644
Kentucky,Clay County,8,9,1526,874,652
Kentucky,Clay County,8,10,1505,807,698
Kentucky,Clay County,8,11,1578,837,741
Kentucky,Clay County,8,12,1363,683,680
Kentucky,Clay County,8,13,1290,639,651
Kentucky,Clay County,8,14,1042,481,561
Kentucky,Clay County,8,15,755,355,400
Kentucky,Clay County,8,16,522,221,301
Kentucky,Clay County,8,17,320,142,178
Kentucky,Clay County,8,18,254,79,175
Kentucky,Clay County,9,0,20626,10845,9781
Kentucky,Clay County,9,1,1299,656,643
Kentucky,Clay County,9,2,1184,595,589
Kentucky,Clay County,9,3,1147,603,544
Kentucky,Clay County,9,4,1179,624,555
Kentucky,Clay County,9,5,1205,649,556
Kentucky,Clay County,9,6,1597,944,653
Kentucky,Clay County,9,7,1534,918,616
Kentucky,Clay County,9,8,1422,838,584
Kentucky,Clay County,9,9,1455,803,652
Kentucky,Clay County,9,10,1498,799,699
Kentucky,Clay County,9,11,1505,815,690
Kentucky,Clay County,9,12,1389,678,711
Kentucky,Clay County,9,13,1275,629,646
Kentucky,Clay County,9,14,1085,510,575
Kentucky,Clay County,9,15,754,349,405
Kentucky,Clay County,9,16,523,214,309
Kentucky,Clay County,9,17,322,134,188
Kentucky,Clay County,9,18,253,87,166
Kentucky,Clay County,10,0,20251,10551,9700
Kentucky,Clay County,10,1,1273,609,664
Kentucky,Clay County,10,2,1160,583,577
Kentucky,Clay County,10,3,1098,581,517
Kentucky,Clay County,10,4,1187,635,552
Kentucky,Clay County,10,5,1114,598,516
Kentucky,Clay County,10,6,1603,918,685
Kentucky,Clay County,10,7,1507,900,607
Kentucky,Clay County,10,8,1352,763,589
Kentucky,Clay County,10,9,1397,749,648
Kentucky,Clay County,10,10,1464,806,658
Kentucky,Clay County,10,11,1457,777,680
Kentucky,Clay County,10,12,1423,689,734
Kentucky,Clay County,10,13,1246,624,622
Kentucky,Clay County,10,14,1064,507,557
Kentucky,Clay County,10,15,794,358,436
Kentucky,Clay County,10,16,547,232,315
Kentucky,Clay County,10,17,303,125,178
Kentucky,Clay County,10,18,262,97,165
Kentucky,Clay County,11,0,20088,10448,9640
Kentucky,Clay County,11,1,1239,587,652
Kentucky,Clay County,11,2,1146,592,554
Kentucky,Clay County,11,3,1129,576,553
Kentucky,Clay County,11,4,1157,621,536
Kentucky,Clay County,11,5,1046,586,460
Kentucky,Clay County,11,6,1608,888,720
Kentucky,Clay County,11,7,1466,903,563
Kentucky,Clay County,11,8,1378,759,619
Kentucky,Clay County,11,9,1348,728,620
Kentucky,Clay County,11,10,1444,797,647
Kentucky,Clay County,11,11,1413,746,667
Kentucky,Clay County,11,12,1414,687,727
Kentucky,Clay County,11,13,1280,617,663
Kentucky,Clay County,11,14,1064,531,533
Kentucky,Clay County,11,15,819,364,455
Kentucky,Clay County,11,16,549,238,311
Kentucky,Clay County,11,17,327,129,198
Kentucky,Clay County,11,18,261,99,162
Kentucky,Clay County,12,0,19901,10384,9517
Kentucky,Clay County,12,1,1177,558,619
Kentucky,Clay County,12,2,1145,593,552
Kentucky,Clay County,12,3,1096,549,547
Kentucky,Clay County,12,4,1147,614,533
Kentucky,Clay County,12,5,1007,563,444
Kentucky,Clay County,12,6,1559,880,679
Kentucky,Clay County,12,7,1495,925,570
Kentucky,Clay County,12,8,1407,793,614
Kentucky,Clay County,12,9,1314,726,588
Kentucky,Clay County,12,10,1421,773,648
Kentucky,Clay County,12,11,1356,699,657
Kentucky,Clay County,12,12,1434,716,718
Kentucky,Clay County,12,13,1244,609,635
Kentucky,Clay County,12,14,1108,540,568
Kentucky,Clay County,12,15,841,371,470
Kentucky,Clay County,12,16,554,249,305
Kentucky,Clay County,12,17,345,139,206
Kentucky,Clay County,12,18,251,87,164
Kentucky,Clinton County,1,0,10272,5138,5134
Kentucky,Clinton County,1,1,652,343,309
Kentucky,Clinton County,1,2,653,336,317
Kentucky,Clinton County,1,3,684,365,319
Kentucky,Clinton County,1,4,693,358,335
Kentucky,Clinton County,1,5,511,275,236
Kentucky,Clinton County,1,6,541,256,285
Kentucky,Clinton County,1,7,592,289,303
Kentucky,Clinton County,1,8,615,325,290
Kentucky,Clinton County,1,9,699,335,364
Kentucky,Clinton County,1,10,756,394,362
Kentucky,Clinton County,1,11,785,385,400
Kentucky,Clinton County,1,12,676,347,329
Kentucky,Clinton County,1,13,712,367,345
Kentucky,Clinton County,1,14,557,270,287
Kentucky,Clinton County,1,15,472,220,252
Kentucky,Clinton County,1,16,315,139,176
Kentucky,Clinton County,1,17,210,92,118
Kentucky,Clinton County,1,18,149,42,107
Kentucky,Clinton County,2,0,10267,5134,5133
Kentucky,Clinton County,2,1,651,342,309
Kentucky,Clinton County,2,2,652,335,317
Kentucky,Clinton County,2,3,683,364,319
Kentucky,Clinton County,2,4,693,358,335
Kentucky,Clinton County,2,5,511,275,236
Kentucky,Clinton County,2,6,541,256,285
Kentucky,Clinton County,2,7,592,289,303
Kentucky,Clinton County,2,8,615,325,290
Kentucky,Clinton County,2,9,698,334,364
Kentucky,Clinton County,2,10,756,394,362
Kentucky,Clinton County,2,11,784,385,399
Kentucky,Clinton County,2,12,676,347,329
Kentucky,Clinton County,2,13,712,367,345
Kentucky,Clinton County,2,14,557,270,287
Kentucky,Clinton County,2,15,472,220,252
Kentucky,Clinton County,2,16,315,139,176
Kentucky,Clinton County,2,17,210,92,118
Kentucky,Clinton County,2,18,149,42,107
Kentucky,Clinton County,3,0,10244,5121,5123
Kentucky,Clinton County,3,1,647,340,307
Kentucky,Clinton County,3,2,645,331,314
Kentucky,Clinton County,3,3,686,363,323
Kentucky,Clinton County,3,4,686,357,329
Kentucky,Clinton County,3,5,518,276,242
Kentucky,Clinton County,3,6,541,258,283
Kentucky,Clinton County,3,7,591,291,300
Kentucky,Clinton County,3,8,608,318,290
Kentucky,Clinton County,3,9,704,339,365
Kentucky,Clinton County,3,10,748,388,360
Kentucky,Clinton County,3,11,783,388,395
Kentucky,Clinton County,3,12,679,350,329
Kentucky,Clinton County,3,13,711,362,349
Kentucky,Clinton County,3,14,550,269,281
Kentucky,Clinton County,3,15,473,219,254
Kentucky,Clinton County,3,16,321,141,180
Kentucky,Clinton County,3,17,203,88,115
Kentucky,Clinton County,3,18,150,43,107
Kentucky,Clinton County,4,0,10158,5069,5089
Kentucky,Clinton County,4,1,635,319,316
Kentucky,Clinton County,4,2,621,334,287
Kentucky,Clinton County,4,3,673,342,331
Kentucky,Clinton County,4,4,657,356,301
Kentucky,Clinton County,4,5,531,274,257
Kentucky,Clinton County,4,6,541,257,284
Kentucky,Clinton County,4,7,587,293,294
Kentucky,Clinton County,4,8,568,291,277
Kentucky,Clinton County,4,9,714,350,364
Kentucky,Clinton County,4,10,749,389,360
Kentucky,Clinton County,4,11,759,374,385
Kentucky,Clinton County,4,12,696,358,338
Kentucky,Clinton County,4,13,717,358,359
Kentucky,Clinton County,4,14,545,273,272
Kentucky,Clinton County,4,15,467,217,250
Kentucky,Clinton County,4,16,347,154,193
Kentucky,Clinton County,4,17,192,81,111
Kentucky,Clinton County,4,18,159,49,110
Kentucky,Clinton County,5,0,10270,5103,5167
Kentucky,Clinton County,5,1,646,302,344
Kentucky,Clinton County,5,2,634,339,295
Kentucky,Clinton County,5,3,674,335,339
Kentucky,Clinton County,5,4,658,361,297
Kentucky,Clinton County,5,5,580,291,289
Kentucky,Clinton County,5,6,535,264,271
Kentucky,Clinton County,5,7,595,299,296
Kentucky,Clinton County,5,8,566,286,280
Kentucky,Clinton County,5,9,671,333,338
Kentucky,Clinton County,5,10,759,390,369
Kentucky,Clinton County,5,11,761,374,387
Kentucky,Clinton County,5,12,730,370,360
Kentucky,Clinton County,5,13,676,336,340
Kentucky,Clinton County,5,14,587,304,283
Kentucky,Clinton County,5,15,470,215,255
Kentucky,Clinton County,5,16,360,164,196
Kentucky,Clinton County,5,17,204,81,123
Kentucky,Clinton County,5,18,164,59,105
Kentucky,Clinton County,6,0,10175,5083,5092
Kentucky,Clinton County,6,1,595,290,305
Kentucky,Clinton County,6,2,635,342,293
Kentucky,Clinton County,6,3,672,329,343
Kentucky,Clinton County,6,4,639,353,286
Kentucky,Clinton County,6,5,585,290,295
Kentucky,Clinton County,6,6,517,269,248
Kentucky,Clinton County,6,7,590,284,306
Kentucky,Clinton County,6,8,564,283,281
Kentucky,Clinton County,6,9,648,337,311
Kentucky,Clinton County,6,10,745,369,376
Kentucky,Clinton County,6,11,750,379,371
Kentucky,Clinton County,6,12,760,382,378
Kentucky,Clinton County,6,13,654,331,323
Kentucky,Clinton County,6,14,599,309,290
Kentucky,Clinton County,6,15,487,217,270
Kentucky,Clinton County,6,16,358,170,188
Kentucky,Clinton County,6,17,210,80,130
Kentucky,Clinton County,6,18,167,69,98
Kentucky,Clinton County,7,0,10203,5064,5139
Kentucky,Clinton County,7,1,595,285,310
Kentucky,Clinton County,7,2,617,325,292
Kentucky,Clinton County,7,3,672,340,332
Kentucky,Clinton County,7,4,646,351,295
Kentucky,Clinton County,7,5,582,292,290
Kentucky,Clinton County,7,6,536,287,249
Kentucky,Clinton County,7,7,579,264,315
Kentucky,Clinton County,7,8,575,279,296
Kentucky,Clinton County,7,9,628,331,297
Kentucky,Clinton County,7,10,739,356,383
Kentucky,Clinton County,7,11,732,387,345
Kentucky,Clinton County,7,12,766,375,391
Kentucky,Clinton County,7,13,660,331,329
Kentucky,Clinton County,7,14,614,310,304
Kentucky,Clinton County,7,15,499,229,270
Kentucky,Clinton County,7,16,365,161,204
Kentucky,Clinton County,7,17,232,100,132
Kentucky,Clinton County,7,18,166,61,105
Kentucky,Clinton County,8,0,10183,5047,5136
Kentucky,Clinton County,8,1,595,273,322
Kentucky,Clinton County,8,2,645,339,306
Kentucky,Clinton County,8,3,639,334,305
Kentucky,Clinton County,8,4,663,359,304
Kentucky,Clinton County,8,5,571,288,283
Kentucky,Clinton County,8,6,550,291,259
Kentucky,Clinton County,8,7,586,270,316
Kentucky,Clinton County,8,8,578,281,297
Kentucky,Clinton County,8,9,607,318,289
Kentucky,Clinton County,8,10,705,342,363
Kentucky,Clinton County,8,11,720,375,345
Kentucky,Clinton County,8,12,759,365,394
Kentucky,Clinton County,8,13,661,328,333
Kentucky,Clinton County,8,14,655,329,326
Kentucky,Clinton County,8,15,467,223,244
Kentucky,Clinton County,8,16,394,168,226
Kentucky,Clinton County,8,17,229,99,130
Kentucky,Clinton County,8,18,159,65,94
Kentucky,Clinton County,9,0,10200,5039,5161
Kentucky,Clinton County,9,1,589,274,315
Kentucky,Clinton County,9,2,656,327,329
Kentucky,Clinton County,9,3,626,338,288
Kentucky,Clinton County,9,4,665,343,322
Kentucky,Clinton County,9,5,526,271,255
Kentucky,Clinton County,9,6,596,303,293
Kentucky,Clinton County,9,7,559,263,296
Kentucky,Clinton County,9,8,585,290,295
Kentucky,Clinton County,9,9,583,294,289
Kentucky,Clinton County,9,10,706,342,364
Kentucky,Clinton County,9,11,719,371,348
Kentucky,Clinton County,9,12,774,379,395
Kentucky,Clinton County,9,13,689,346,343
Kentucky,Clinton County,9,14,671,331,340
Kentucky,Clinton County,9,15,468,231,237
Kentucky,Clinton County,9,16,384,165,219
Kentucky,Clinton County,9,17,241,107,134
Kentucky,Clinton County,9,18,163,64,99
Kentucky,Clinton County,10,0,10212,5031,5181
Kentucky,Clinton County,10,1,598,275,323
Kentucky,Clinton County,10,2,642,308,334
Kentucky,Clinton County,10,3,629,341,288
Kentucky,Clinton County,10,4,641,338,303
Kentucky,Clinton County,10,5,527,270,257
Kentucky,Clinton County,10,6,625,309,316
Kentucky,Clinton County,10,7,528,251,277
Kentucky,Clinton County,10,8,603,298,305
Kentucky,Clinton County,10,9,581,297,284
Kentucky,Clinton County,10,10,685,337,348
Kentucky,Clinton County,10,11,720,366,354
Kentucky,Clinton County,10,12,777,388,389
Kentucky,Clinton County,10,13,714,355,359
Kentucky,Clinton County,10,14,626,307,319
Kentucky,Clinton County,10,15,520,265,255
Kentucky,Clinton County,10,16,382,163,219
Kentucky,Clinton County,10,17,245,103,142
Kentucky,Clinton County,10,18,169,60,109
Kentucky,Clinton County,11,0,10152,4987,5165
Kentucky,Clinton County,11,1,589,267,322
Kentucky,Clinton County,11,2,617,296,321
Kentucky,Clinton County,11,3,637,351,286
Kentucky,Clinton County,11,4,624,324,300
Kentucky,Clinton County,11,5,525,274,251
Kentucky,Clinton County,11,6,647,307,340
Kentucky,Clinton County,11,7,536,265,271
Kentucky,Clinton County,11,8,591,283,308
Kentucky,Clinton County,11,9,569,290,279
Kentucky,Clinton County,11,10,662,337,325
Kentucky,Clinton County,11,11,709,348,361
Kentucky,Clinton County,11,12,753,372,381
Kentucky,Clinton County,11,13,715,350,365
Kentucky,Clinton County,11,14,622,313,309
Kentucky,Clinton County,11,15,527,267,260
Kentucky,Clinton County,11,16,404,167,237
Kentucky,Clinton County,11,17,252,111,141
Kentucky,Clinton County,11,18,173,65,108
Kentucky,Clinton County,12,0,10218,5017,5201
Kentucky,Clinton County,12,1,601,286,315
Kentucky,Clinton County,12,2,612,283,329
Kentucky,Clinton County,12,3,632,344,288
Kentucky,Clinton County,12,4,620,331,289
Kentucky,Clinton County,12,5,531,271,260
Kentucky,Clinton County,12,6,644,308,336
Kentucky,Clinton County,12,7,575,293,282
Kentucky,Clinton County,12,8,595,279,316
Kentucky,Clinton County,12,9,589,292,297
Kentucky,Clinton County,12,10,617,326,291
Kentucky,Clinton County,12,11,713,329,384
Kentucky,Clinton County,12,12,740,387,353
Kentucky,Clinton County,12,13,731,349,382
Kentucky,Clinton County,12,14,619,315,304
Kentucky,Clinton County,12,15,550,271,279
Kentucky,Clinton County,12,16,410,178,232
Kentucky,Clinton County,12,17,263,112,151
Kentucky,Clinton County,12,18,176,63,113
Kentucky,Crittenden County,1,0,9315,4646,4669
Kentucky,Crittenden County,1,1,625,336,289
Kentucky,Crittenden County,1,2,570,280,290
Kentucky,Crittenden County,1,3,563,275,288
Kentucky,Crittenden County,1,4,554,286,268
Kentucky,Crittenden County,1,5,475,253,222
Kentucky,Crittenden County,1,6,513,260,253
Kentucky,Crittenden County,1,7,501,258,243
Kentucky,Crittenden County,1,8,566,299,267
Kentucky,Crittenden County,1,9,575,297,278
Kentucky,Crittenden County,1,10,701,329,372
Kentucky,Crittenden County,1,11,681,358,323
Kentucky,Crittenden County,1,12,673,325,348
Kentucky,Crittenden County,1,13,631,326,305
Kentucky,Crittenden County,1,14,591,281,310
Kentucky,Crittenden County,1,15,393,198,195
Kentucky,Crittenden County,1,16,292,143,149
Kentucky,Crittenden County,1,17,205,81,124
Kentucky,Crittenden County,1,18,206,61,145
Kentucky,Crittenden County,2,0,9315,4646,4669
Kentucky,Crittenden County,2,1,625,336,289
Kentucky,Crittenden County,2,2,570,280,290
Kentucky,Crittenden County,2,3,563,275,288
Kentucky,Crittenden County,2,4,554,286,268
Kentucky,Crittenden County,2,5,475,253,222
Kentucky,Crittenden County,2,6,513,260,253
Kentucky,Crittenden County,2,7,501,258,243
Kentucky,Crittenden County,2,8,566,299,267
Kentucky,Crittenden County,2,9,575,297,278
Kentucky,Crittenden County,2,10,701,329,372
Kentucky,Crittenden County,2,11,681,358,323
Kentucky,Crittenden County,2,12,673,325,348
Kentucky,Crittenden County,2,13,631,326,305
Kentucky,Crittenden County,2,14,591,281,310
Kentucky,Crittenden County,2,15,393,198,195
Kentucky,Crittenden County,2,16,292,143,149
Kentucky,Crittenden County,2,17,205,81,124
Kentucky,Crittenden County,2,18,206,61,145
Kentucky,Crittenden County,3,0,9297,4638,4659
Kentucky,Crittenden County,3,1,618,328,290
Kentucky,Crittenden County,3,2,568,281,287
Kentucky,Crittenden County,3,3,570,281,289
Kentucky,Crittenden County,3,4,554,285,269
Kentucky,Crittenden County,3,5,475,253,222
Kentucky,Crittenden County,3,6,509,259,250
Kentucky,Crittenden County,3,7,506,260,246
Kentucky,Crittenden County,3,8,564,297,267
Kentucky,Crittenden County,3,9,570,293,277
Kentucky,Crittenden County,3,10,694,328,366
Kentucky,Crittenden County,3,11,684,353,331
Kentucky,Crittenden County,3,12,676,333,343
Kentucky,Crittenden County,3,13,631,322,309
Kentucky,Crittenden County,3,14,579,279,300
Kentucky,Crittenden County,3,15,400,199,201
Kentucky,Crittenden County,3,16,288,141,147
Kentucky,Crittenden County,3,17,203,83,120
Kentucky,Crittenden County,3,18,208,63,145
Kentucky,Crittenden County,4,0,9249,4632,4617
Kentucky,Crittenden County,4,1,567,314,253
Kentucky,Crittenden County,4,2,581,288,293
Kentucky,Crittenden County,4,3,591,283,308
Kentucky,Crittenden County,4,4,534,267,267
Kentucky,Crittenden County,4,5,471,257,214
Kentucky,Crittenden County,4,6,498,254,244
Kentucky,Crittenden County,4,7,526,273,253
Kentucky,Crittenden County,4,8,539,292,247
Kentucky,Crittenden County,4,9,555,285,270
Kentucky,Crittenden County,4,10,664,323,341
Kentucky,Crittenden County,4,11,685,335,350
Kentucky,Crittenden County,4,12,688,355,333
Kentucky,Crittenden County,4,13,646,320,326
Kentucky,Crittenden County,4,14,558,279,279
Kentucky,Crittenden County,4,15,443,209,234
Kentucky,Crittenden County,4,16,284,140,144
Kentucky,Crittenden County,4,17,206,88,118
Kentucky,Crittenden County,4,18,213,70,143
Kentucky,Crittenden County,5,0,9220,4628,4592
Kentucky,Crittenden County,5,1,537,290,247
Kentucky,Crittenden County,5,2,610,313,297
Kentucky,Crittenden County,5,3,592,283,309
Kentucky,Crittenden County,5,4,516,260,256
Kentucky,Crittenden County,5,5,483,262,221
Kentucky,Crittenden County,5,6,457,237,220
Kentucky,Crittenden County,5,7,567,288,279
Kentucky,Crittenden County,5,8,525,283,242
Kentucky,Crittenden County,5,9,568,295,273
Kentucky,Crittenden County,5,10,617,311,306
Kentucky,Crittenden County,5,11,689,327,362
Kentucky,Crittenden County,5,12,704,368,336
Kentucky,Crittenden County,5,13,629,311,318
Kentucky,Crittenden County,5,14,567,291,276
Kentucky,Crittenden County,5,15,471,214,257
Kentucky,Crittenden County,5,16,285,143,142
Kentucky,Crittenden County,5,17,193,84,109
Kentucky,Crittenden County,5,18,210,68,142
Kentucky,Crittenden County,6,0,9178,4615,4563
Kentucky,Crittenden County,6,1,522,288,234
Kentucky,Crittenden County,6,2,609,320,289
Kentucky,Crittenden County,6,3,578,283,295
Kentucky,Crittenden County,6,4,528,267,261
Kentucky,Crittenden County,6,5,490,258,232
Kentucky,Crittenden County,6,6,444,236,208
Kentucky,Crittenden County,6,7,553,274,279
Kentucky,Crittenden County,6,8,542,289,253
Kentucky,Crittenden County,6,9,541,272,269
Kentucky,Crittenden County,6,10,614,326,288
Kentucky,Crittenden County,6,11,692,316,376
Kentucky,Crittenden County,6,12,698,369,329
Kentucky,Crittenden County,6,13,633,306,327
Kentucky,Crittenden County,6,14,556,289,267
Kentucky,Crittenden County,6,15,481,216,265
Kentucky,Crittenden County,6,16,284,149,135
Kentucky,Crittenden County,6,17,197,90,107
Kentucky,Crittenden County,6,18,216,67,149
Kentucky,Crittenden County,7,0,9175,4633,4542
Kentucky,Crittenden County,7,1,536,289,247
Kentucky,Crittenden County,7,2,599,314,285
Kentucky,Crittenden County,7,3,581,307,274
Kentucky,Crittenden County,7,4,542,279,263
Kentucky,Crittenden County,7,5,491,253,238
Kentucky,Crittenden County,7,6,467,255,212
Kentucky,Crittenden County,7,7,544,270,274
Kentucky,Crittenden County,7,8,558,292,266
Kentucky,Crittenden County,7,9,526,276,250
Kentucky,Crittenden County,7,10,578,297,281
Kentucky,Crittenden County,7,11,692,315,377
Kentucky,Crittenden County,7,12,664,352,312
Kentucky,Crittenden County,7,13,637,302,335
Kentucky,Crittenden County,7,14,572,298,274
Kentucky,Crittenden County,7,15,496,229,267
Kentucky,Crittenden County,7,16,277,140,137
Kentucky,Crittenden County,7,17,203,95,108
Kentucky,Crittenden County,7,18,212,70,142
Kentucky,Crittenden County,8,0,9168,4621,4547
Kentucky,Crittenden County,8,1,543,296,247
Kentucky,Crittenden County,8,2,630,347,283
Kentucky,Crittenden County,8,3,583,294,289
Kentucky,Crittenden County,8,4,524,266,258
Kentucky,Crittenden County,8,5,459,240,219
Kentucky,Crittenden County,8,6,508,272,236
Kentucky,Crittenden County,8,7,530,263,267
Kentucky,Crittenden County,8,8,534,280,254
Kentucky,Crittenden County,8,9,536,279,257
Kentucky,Crittenden County,8,10,581,294,287
Kentucky,Crittenden County,8,11,684,323,361
Kentucky,Crittenden County,8,12,650,340,310
Kentucky,Crittenden County,8,13,645,318,327
Kentucky,Crittenden County,8,14,570,285,285
Kentucky,Crittenden County,8,15,478,215,263
Kentucky,Crittenden County,8,16,312,149,163
Kentucky,Crittenden County,8,17,184,90,94
Kentucky,Crittenden County,8,18,217,70,147
Kentucky,Crittenden County,9,0,9131,4588,4543
Kentucky,Crittenden County,9,1,547,279,268
Kentucky,Crittenden County,9,2,578,320,258
Kentucky,Crittenden County,9,3,618,318,300
Kentucky,Crittenden County,9,4,553,280,273
Kentucky,Crittenden County,9,5,456,244,212
Kentucky,Crittenden County,9,6,497,264,233
Kentucky,Crittenden County,9,7,504,254,250
Kentucky,Crittenden County,9,8,558,289,269
Kentucky,Crittenden County,9,9,515,269,246
Kentucky,Crittenden County,9,10,570,284,286
Kentucky,Crittenden County,9,11,652,320,332
Kentucky,Crittenden County,9,12,648,315,333
Kentucky,Crittenden County,9,13,653,333,320
Kentucky,Crittenden County,9,14,580,284,296
Kentucky,Crittenden County,9,15,464,220,244
Kentucky,Crittenden County,9,16,354,166,188
Kentucky,Crittenden County,9,17,181,77,104
Kentucky,Crittenden County,9,18,203,72,131
Kentucky,Crittenden County,10,0,8999,4511,4488
Kentucky,Crittenden County,10,1,513,256,257
Kentucky,Crittenden County,10,2,560,294,266
Kentucky,Crittenden County,10,3,625,322,303
Kentucky,Crittenden County,10,4,536,273,263
Kentucky,Crittenden County,10,5,472,243,229
Kentucky,Crittenden County,10,6,500,271,229
Kentucky,Crittenden County,10,7,460,236,224
Kentucky,Crittenden County,10,8,558,286,272
Kentucky,Crittenden County,10,9,508,268,240
Kentucky,Crittenden County,10,10,558,282,276
Kentucky,Crittenden County,10,11,608,308,300
Kentucky,Crittenden County,10,12,656,304,352
Kentucky,Crittenden County,10,13,651,337,314
Kentucky,Crittenden County,10,14,558,267,291
Kentucky,Crittenden County,10,15,489,240,249
Kentucky,Crittenden County,10,16,368,166,202
Kentucky,Crittenden County,10,17,187,89,98
Kentucky,Crittenden County,10,18,192,69,123
Kentucky,Crittenden County,11,0,8896,4469,4427
Kentucky,Crittenden County,11,1,493,243,250
Kentucky,Crittenden County,11,2,530,278,252
Kentucky,Crittenden County,11,3,621,322,299
Kentucky,Crittenden County,11,4,524,289,235
Kentucky,Crittenden County,11,5,460,231,229
Kentucky,Crittenden County,11,6,491,269,222
Kentucky,Crittenden County,11,7,428,223,205
Kentucky,Crittenden County,11,8,551,274,277
Kentucky,Crittenden County,11,9,516,278,238
Kentucky,Crittenden County,11,10,529,263,266
Kentucky,Crittenden County,11,11,606,314,292
Kentucky,Crittenden County,11,12,661,299,362
Kentucky,Crittenden County,11,13,651,331,320
Kentucky,Crittenden County,11,14,575,273,302
Kentucky,Crittenden County,11,15,484,238,246
Kentucky,Crittenden County,11,16,388,172,216
Kentucky,Crittenden County,11,17,195,102,93
Kentucky,Crittenden County,11,18,193,70,123
Kentucky,Crittenden County,12,0,8806,4434,4372
Kentucky,Crittenden County,12,1,472,230,242
Kentucky,Crittenden County,12,2,520,288,232
Kentucky,Crittenden County,12,3,600,308,292
Kentucky,Crittenden County,12,4,523,290,233
Kentucky,Crittenden County,12,5,461,229,232
Kentucky,Crittenden County,12,6,484,251,233
Kentucky,Crittenden County,12,7,446,246,200
Kentucky,Crittenden County,12,8,514,250,264
Kentucky,Crittenden County,12,9,518,273,245
Kentucky,Crittenden County,12,10,531,272,259
Kentucky,Crittenden County,12,11,579,296,283
Kentucky,Crittenden County,12,12,655,299,356
Kentucky,Crittenden County,12,13,623,319,304
Kentucky,Crittenden County,12,14,588,284,304
Kentucky,Crittenden County,12,15,486,234,252
Kentucky,Crittenden County,12,16,412,188,224
Kentucky,Crittenden County,12,17,202,105,97
Kentucky,Crittenden County,12,18,192,72,120
Kentucky,Cumberland County,1,0,6856,3366,3490
Kentucky,Cumberland County,1,1,438,230,208
Kentucky,Cumberland County,1,2,411,207,204
Kentucky,Cumberland County,1,3,403,214,189
Kentucky,Cumberland County,1,4,464,229,235
Kentucky,Cumberland County,1,5,329,170,159
Kentucky,Cumberland County,1,6,347,173,174
Kentucky,Cumberland County,1,7,324,147,177
Kentucky,Cumberland County,1,8,379,177,202
Kentucky,Cumberland County,1,9,461,210,251
Kentucky,Cumberland County,1,10,506,257,249
Kentucky,Cumberland County,1,11,544,296,248
Kentucky,Cumberland County,1,12,478,226,252
Kentucky,Cumberland County,1,13,463,230,233
Kentucky,Cumberland County,1,14,401,190,211
Kentucky,Cumberland County,1,15,328,165,163
Kentucky,Cumberland County,1,16,253,126,127
Kentucky,Cumberland County,1,17,184,75,109
Kentucky,Cumberland County,1,18,143,44,99
Kentucky,Cumberland County,2,0,6849,3361,3488
Kentucky,Cumberland County,2,1,438,230,208
Kentucky,Cumberland County,2,2,411,207,204
Kentucky,Cumberland County,2,3,403,214,189
Kentucky,Cumberland County,2,4,464,229,235
Kentucky,Cumberland County,2,5,327,168,159
Kentucky,Cumberland County,2,6,347,173,174
Kentucky,Cumberland County,2,7,324,147,177
Kentucky,Cumberland County,2,8,379,177,202
Kentucky,Cumberland County,2,9,461,210,251
Kentucky,Cumberland County,2,10,505,257,248
Kentucky,Cumberland County,2,11,543,295,248
Kentucky,Cumberland County,2,12,477,226,251
Kentucky,Cumberland County,2,13,462,229,233
Kentucky,Cumberland County,2,14,401,190,211
Kentucky,Cumberland County,2,15,327,164,163
Kentucky,Cumberland County,2,16,253,126,127
Kentucky,Cumberland County,2,17,184,75,109
Kentucky,Cumberland County,2,18,143,44,99
Kentucky,Cumberland County,3,0,6864,3364,3500
Kentucky,Cumberland County,3,1,438,230,208
Kentucky,Cumberland County,3,2,410,210,200
Kentucky,Cumberland County,3,3,403,209,194
Kentucky,Cumberland County,3,4,453,224,229
Kentucky,Cumberland County,3,5,341,175,166
Kentucky,Cumberland County,3,6,350,172,178
Kentucky,Cumberland County,3,7,320,147,173
Kentucky,Cumberland County,3,8,374,176,198
Kentucky,Cumberland County,3,9,454,205,249
Kentucky,Cumberland County,3,10,513,260,253
Kentucky,Cumberland County,3,11,540,293,247
Kentucky,Cumberland County,3,12,484,231,253
Kentucky,Cumberland County,3,13,469,231,238
Kentucky,Cumberland County,3,14,400,189,211
Kentucky,Cumberland County,3,15,327,163,164
Kentucky,Cumberland County,3,16,257,126,131
Kentucky,Cumberland County,3,17,187,79,108
Kentucky,Cumberland County,3,18,144,44,100
Kentucky,Cumberland County,4,0,6870,3344,3526
Kentucky,Cumberland County,4,1,426,216,210
Kentucky,Cumberland County,4,2,419,224,195
Kentucky,Cumberland County,4,3,418,201,217
Kentucky,Cumberland County,4,4,431,217,214
Kentucky,Cumberland County,4,5,383,199,184
Kentucky,Cumberland County,4,6,347,161,186
Kentucky,Cumberland County,4,7,319,149,170
Kentucky,Cumberland County,4,8,356,169,187
Kentucky,Cumberland County,4,9,447,199,248
Kentucky,Cumberland County,4,10,507,248,259
Kentucky,Cumberland County,4,11,536,288,248
Kentucky,Cumberland County,4,12,482,240,242
Kentucky,Cumberland County,4,13,480,233,247
Kentucky,Cumberland County,4,14,397,190,207
Kentucky,Cumberland County,4,15,324,158,166
Kentucky,Cumberland County,4,16,265,128,137
Kentucky,Cumberland County,4,17,181,76,105
Kentucky,Cumberland County,4,18,152,48,104
Kentucky,Cumberland County,5,0,6855,3361,3494
Kentucky,Cumberland County,5,1,403,206,197
Kentucky,Cumberland County,5,2,418,218,200
Kentucky,Cumberland County,5,3,415,211,204
Kentucky,Cumberland County,5,4,416,219,197
Kentucky,Cumberland County,5,5,408,195,213
Kentucky,Cumberland County,5,6,344,173,171
Kentucky,Cumberland County,5,7,311,146,165
Kentucky,Cumberland County,5,8,349,171,178
Kentucky,Cumberland County,5,9,432,204,228
Kentucky,Cumberland County,5,10,485,226,259
Kentucky,Cumberland County,5,11,539,282,257
Kentucky,Cumberland County,5,12,509,257,252
Kentucky,Cumberland County,5,13,464,231,233
Kentucky,Cumberland County,5,14,417,201,216
Kentucky,Cumberland County,5,15,333,154,179
Kentucky,Cumberland County,5,16,275,139,136
Kentucky,Cumberland County,5,17,176,79,97
Kentucky,Cumberland County,5,18,161,49,112
Kentucky,Cumberland County,6,0,6790,3335,3455
Kentucky,Cumberland County,6,1,400,208,192
Kentucky,Cumberland County,6,2,420,219,201
Kentucky,Cumberland County,6,3,426,217,209
Kentucky,Cumberland County,6,4,380,215,165
Kentucky,Cumberland County,6,5,401,181,220
Kentucky,Cumberland County,6,6,315,158,157
Kentucky,Cumberland County,6,7,329,154,175
Kentucky,Cumberland County,6,8,345,166,179
Kentucky,Cumberland County,6,9,424,208,216
Kentucky,Cumberland County,6,10,450,205,245
Kentucky,Cumberland County,6,11,544,274,270
Kentucky,Cumberland County,6,12,510,273,237
Kentucky,Cumberland County,6,13,466,225,241
Kentucky,Cumberland County,6,14,413,198,215
Kentucky,Cumberland County,6,15,352,166,186
Kentucky,Cumberland County,6,16,267,131,136
Kentucky,Cumberland County,6,17,183,85,98
Kentucky,Cumberland County,6,18,165,52,113
Kentucky,Cumberland County,7,0,6722,3293,3429
Kentucky,Cumberland County,7,1,394,195,199
Kentucky,Cumberland County,7,2,404,221,183
Kentucky,Cumberland County,7,3,410,205,205
Kentucky,Cumberland County,7,4,382,202,180
Kentucky,Cumberland County,7,5,392,185,207
Kentucky,Cumberland County,7,6,322,157,165
Kentucky,Cumberland County,7,7,333,161,172
Kentucky,Cumberland County,7,8,333,158,175
Kentucky,Cumberland County,7,9,399,193,206
Kentucky,Cumberland County,7,10,431,195,236
Kentucky,Cumberland County,7,11,513,249,264
Kentucky,Cumberland County,7,12,537,290,247
Kentucky,Cumberland County,7,13,479,235,244
Kentucky,Cumberland County,7,14,413,200,213
Kentucky,Cumberland County,7,15,358,177,181
Kentucky,Cumberland County,7,16,259,121,138
Kentucky,Cumberland County,7,17,185,85,100
Kentucky,Cumberland County,7,18,178,64,114
Kentucky,Cumberland County,8,0,6737,3307,3430
Kentucky,Cumberland County,8,1,406,210,196
Kentucky,Cumberland County,8,2,420,225,195
Kentucky,Cumberland County,8,3,399,199,200
Kentucky,Cumberland County,8,4,372,198,174
Kentucky,Cumberland County,8,5,356,172,184
Kentucky,Cumberland County,8,6,348,166,182
Kentucky,Cumberland County,8,7,353,174,179
Kentucky,Cumberland County,8,8,334,154,180
Kentucky,Cumberland County,8,9,381,185,196
Kentucky,Cumberland County,8,10,432,199,233
Kentucky,Cumberland County,8,11,498,236,262
Kentucky,Cumberland County,8,12,553,301,252
Kentucky,Cumberland County,8,13,480,234,246
Kentucky,Cumberland County,8,14,431,209,222
Kentucky,Cumberland County,8,15,350,171,179
Kentucky,Cumberland County,8,16,268,121,147
Kentucky,Cumberland County,8,17,182,92,90
Kentucky,Cumberland County,8,18,174,61,113
Kentucky,Cumberland County,9,0,6731,3285,3446
Kentucky,Cumberland County,9,1,414,204,210
Kentucky,Cumberland County,9,2,407,222,185
Kentucky,Cumberland County,9,3,381,192,189
Kentucky,Cumberland County,9,4,366,186,180
Kentucky,Cumberland County,9,5,347,180,167
Kentucky,Cumberland County,9,6,364,168,196
Kentucky,Cumberland County,9,7,350,172,178
Kentucky,Cumberland County,9,8,334,161,173
Kentucky,Cumberland County,9,9,349,171,178
Kentucky,Cumberland County,9,10,423,193,230
Kentucky,Cumberland County,9,11,502,227,275
Kentucky,Cumberland County,9,12,567,303,264
Kentucky,Cumberland County,9,13,486,243,243
Kentucky,Cumberland County,9,14,462,227,235
Kentucky,Cumberland County,9,15,347,165,182
Kentucky,Cumberland County,9,16,278,121,157
Kentucky,Cumberland County,9,17,187,89,98
Kentucky,Cumberland County,9,18,167,61,106
Kentucky,Cumberland County,10,0,6710,3275,3435
Kentucky,Cumberland County,10,1,423,220,203
Kentucky,Cumberland County,10,2,408,205,203
Kentucky,Cumberland County,10,3,381,197,184
Kentucky,Cumberland County,10,4,356,180,176
Kentucky,Cumberland County,10,5,329,168,161
Kentucky,Cumberland County,10,6,395,178,217
Kentucky,Cumberland County,10,7,341,175,166
Kentucky,Cumberland County,10,8,321,157,164
Kentucky,Cumberland County,10,9,337,168,169
Kentucky,Cumberland County,10,10,405,189,216
Kentucky,Cumberland County,10,11,488,219,269
Kentucky,Cumberland County,10,12,564,291,273
Kentucky,Cumberland County,10,13,519,261,258
Kentucky,Cumberland County,10,14,446,229,217
Kentucky,Cumberland County,10,15,374,172,202
Kentucky,Cumberland County,10,16,275,112,163
Kentucky,Cumberland County,10,17,191,95,96
Kentucky,Cumberland County,10,18,157,59,98
Kentucky,Cumberland County,11,0,6693,3273,3420
Kentucky,Cumberland County,11,1,408,211,197
Kentucky,Cumberland County,11,2,418,207,211
Kentucky,Cumberland County,11,3,380,199,181
Kentucky,Cumberland County,11,4,360,174,186
Kentucky,Cumberland County,11,5,305,170,135
Kentucky,Cumberland County,11,6,391,169,222
Kentucky,Cumberland County,11,7,333,175,158
Kentucky,Cumberland County,11,8,345,173,172
Kentucky,Cumberland County,11,9,341,165,176
Kentucky,Cumberland County,11,10,397,195,202
Kentucky,Cumberland County,11,11,459,210,249
Kentucky,Cumberland County,11,12,557,275,282
Kentucky,Cumberland County,11,13,522,270,252
Kentucky,Cumberland County,11,14,462,225,237
Kentucky,Cumberland County,11,15,375,179,196
Kentucky,Cumberland County,11,16,298,130,168
Kentucky,Cumberland County,11,17,180,87,93
Kentucky,Cumberland County,11,18,162,59,103
Kentucky,Cumberland County,12,0,6614,3226,3388
Kentucky,Cumberland County,12,1,380,200,180
Kentucky,Cumberland County,12,2,411,205,206
Kentucky,Cumberland County,12,3,378,201,177
Kentucky,Cumberland County,12,4,337,155,182
Kentucky,Cumberland County,12,5,313,169,144
Kentucky,Cumberland County,12,6,376,169,207
Kentucky,Cumberland County,12,7,343,167,176
Kentucky,Cumberland County,12,8,337,171,166
Kentucky,Cumberland County,12,9,337,164,173
Kentucky,Cumberland County,12,10,409,195,214
Kentucky,Cumberland County,12,11,431,198,233
Kentucky,Cumberland County,12,12,526,258,268
Kentucky,Cumberland County,12,13,529,281,248
Kentucky,Cumberland County,12,14,485,235,250
Kentucky,Cumberland County,12,15,377,185,192
Kentucky,Cumberland County,12,16,299,134,165
Kentucky,Cumberland County,12,17,174,77,97
Kentucky,Cumberland County,12,18,172,62,110
Kentucky,Daviess County,1,0,96656,46912,49744
Kentucky,Daviess County,1,1,6689,3403,3286
Kentucky,Daviess County,1,2,6589,3397,3192
Kentucky,Daviess County,1,3,6464,3267,3197
Kentucky,Daviess County,1,4,6360,3215,3145
Kentucky,Daviess County,1,5,5807,2955,2852
Kentucky,Daviess County,1,6,6143,3058,3085
Kentucky,Daviess County,1,7,5806,2929,2877
Kentucky,Daviess County,1,8,6026,2955,3071
Kentucky,Daviess County,1,9,6087,3016,3071
Kentucky,Daviess County,1,10,7242,3532,3710
Kentucky,Daviess County,1,11,7250,3556,3694
Kentucky,Daviess County,1,12,6459,3095,3364
Kentucky,Daviess County,1,13,5616,2677,2939
Kentucky,Daviess County,1,14,4069,1898,2171
Kentucky,Daviess County,1,15,3345,1515,1830
Kentucky,Daviess County,1,16,2720,1109,1611
Kentucky,Daviess County,1,17,2036,765,1271
Kentucky,Daviess County,1,18,1948,570,1378
Kentucky,Daviess County,2,0,96641,46904,49737
Kentucky,Daviess County,2,1,6689,3403,3286
Kentucky,Daviess County,2,2,6586,3395,3191
Kentucky,Daviess County,2,3,6464,3267,3197
Kentucky,Daviess County,2,4,6357,3215,3142
Kentucky,Daviess County,2,5,5807,2955,2852
Kentucky,Daviess County,2,6,6144,3059,3085
Kentucky,Daviess County,2,7,5803,2928,2875
Kentucky,Daviess County,2,8,6028,2955,3073
Kentucky,Daviess County,2,9,6086,3015,3071
Kentucky,Daviess County,2,10,7239,3530,3709
Kentucky,Daviess County,2,11,7249,3556,3693
Kentucky,Daviess County,2,12,6458,3095,3363
Kentucky,Daviess County,2,13,5615,2675,2940
Kentucky,Daviess County,2,14,4069,1898,2171
Kentucky,Daviess County,2,15,3343,1514,1829
Kentucky,Daviess County,2,16,2720,1109,1611
Kentucky,Daviess County,2,17,2036,765,1271
Kentucky,Daviess County,2,18,1948,570,1378
Kentucky,Daviess County,3,0,96704,46938,49766
Kentucky,Daviess County,3,1,6679,3405,3274
Kentucky,Daviess County,3,2,6603,3397,3206
Kentucky,Daviess County,3,3,6441,3252,3189
Kentucky,Daviess County,3,4,6343,3220,3123
Kentucky,Daviess County,3,5,5831,2956,2875
Kentucky,Daviess County,3,6,6126,3060,3066
Kentucky,Daviess County,3,7,5854,2949,2905
Kentucky,Daviess County,3,8,5952,2910,3042
Kentucky,Daviess County,3,9,6107,3032,3075
Kentucky,Daviess County,3,10,7197,3506,3691
Kentucky,Daviess County,3,11,7268,3558,3710
Kentucky,Daviess County,3,12,6499,3123,3376
Kentucky,Daviess County,3,13,5653,2699,2954
Kentucky,Daviess County,3,14,4098,1908,2190
Kentucky,Daviess County,3,15,3338,1507,1831
Kentucky,Daviess County,3,16,2699,1109,1590
Kentucky,Daviess County,3,17,2054,772,1282
Kentucky,Daviess County,3,18,1962,575,1387
Kentucky,Daviess County,4,0,97159,47110,50049
Kentucky,Daviess County,4,1,6618,3380,3238
Kentucky,Daviess County,4,2,6671,3427,3244
Kentucky,Daviess County,4,3,6504,3298,3206
Kentucky,Daviess County,4,4,6222,3162,3060
Kentucky,Daviess County,4,5,6024,2980,3044
Kentucky,Daviess County,4,6,6021,3021,3000
Kentucky,Daviess County,4,7,6057,3030,3027
Kentucky,Daviess County,4,8,5674,2759,2915
Kentucky,Daviess County,4,9,6255,3132,3123
Kentucky,Daviess County,4,10,6867,3329,3538
Kentucky,Daviess County,4,11,7361,3585,3776
Kentucky,Daviess County,4,12,6658,3224,3434
Kentucky,Daviess County,4,13,5860,2803,3057
Kentucky,Daviess County,4,14,4208,1950,2258
Kentucky,Daviess County,4,15,3394,1516,1878
Kentucky,Daviess County,4,16,2649,1098,1551
Kentucky,Daviess County,4,17,2090,800,1290
Kentucky,Daviess County,4,18,2026,616,1410
Kentucky,Daviess County,5,0,97840,47413,50427
Kentucky,Daviess County,5,1,6613,3401,3212
Kentucky,Daviess County,5,2,6803,3455,3348
Kentucky,Daviess County,5,3,6653,3404,3249
Kentucky,Daviess County,5,4,6066,3066,3000
Kentucky,Daviess County,5,5,6144,3021,3123
Kentucky,Daviess County,5,6,5993,2981,3012
Kentucky,Daviess County,5,7,6113,3053,3060
Kentucky,Daviess County,5,8,5657,2775,2882
Kentucky,Daviess County,5,9,6314,3142,3172
Kentucky,Daviess County,5,10,6592,3225,3367
Kentucky,Daviess County,5,11,7346,3572,3774
Kentucky,Daviess County,5,12,6855,3324,3531
Kentucky,Daviess County,5,13,5763,2744,3019
Kentucky,Daviess County,5,14,4608,2129,2479
Kentucky,Daviess County,5,15,3472,1550,1922
Kentucky,Daviess County,5,16,2658,1120,1538
Kentucky,Daviess County,5,17,2128,802,1326
Kentucky,Daviess County,5,18,2062,649,1413
Kentucky,Daviess County,6,0,98294,47712,50582
Kentucky,Daviess County,6,1,6618,3398,3220
Kentucky,Daviess County,6,2,6886,3536,3350
Kentucky,Daviess County,6,3,6653,3367,3286
Kentucky,Daviess County,6,4,6082,3103,2979
Kentucky,Daviess County,6,5,6132,3041,3091
Kentucky,Daviess County,6,6,6037,2998,3039
Kentucky,Daviess County,6,7,6173,3063,3110
Kentucky,Daviess County,6,8,5737,2863,2874
Kentucky,Daviess County,6,9,6177,3075,3102
Kentucky,Daviess County,6,10,6382,3144,3238
Kentucky,Daviess County,6,11,7274,3524,3750
Kentucky,Daviess County,6,12,6975,3374,3601
Kentucky,Daviess County,6,13,5783,2764,3019
Kentucky,Daviess County,6,14,4931,2271,2660
Kentucky,Daviess County,6,15,3499,1571,1928
Kentucky,Daviess County,6,16,2725,1158,1567
Kentucky,Daviess County,6,17,2109,797,1312
Kentucky,Daviess County,6,18,2121,665,1456
Kentucky,Daviess County,7,0,98441,47746,50695
Kentucky,Daviess County,7,1,6574,3394,3180
Kentucky,Daviess County,7,2,6843,3482,3361
Kentucky,Daviess County,7,3,6646,3369,3277
Kentucky,Daviess County,7,4,6075,3088,2987
Kentucky,Daviess County,7,5,6155,3010,3145
Kentucky,Daviess County,7,6,6017,2977,3040
Kentucky,Daviess County,7,7,6214,3078,3136
Kentucky,Daviess County,7,8,5682,2873,2809
Kentucky,Daviess County,7,9,6120,3020,3100
Kentucky,Daviess County,7,10,6158,3065,3093
Kentucky,Daviess County,7,11,7209,3483,3726
Kentucky,Daviess County,7,12,7060,3383,3677
Kentucky,Daviess County,7,13,5991,2873,3118
Kentucky,Daviess County,7,14,5077,2340,2737
Kentucky,Daviess County,7,15,3550,1628,1922
Kentucky,Daviess County,7,16,2808,1211,1597
Kentucky,Daviess County,7,17,2080,791,1289
Kentucky,Daviess County,7,18,2182,681,1501
Kentucky,Daviess County,8,0,99485,48366,51119
Kentucky,Daviess County,8,1,6748,3482,3266
Kentucky,Daviess County,8,2,6870,3488,3382
Kentucky,Daviess County,8,3,6696,3435,3261
Kentucky,Daviess County,8,4,6192,3134,3058
Kentucky,Daviess County,8,5,6183,3097,3086
Kentucky,Daviess County,8,6,6331,3140,3191
Kentucky,Daviess County,8,7,6252,3089,3163
Kentucky,Daviess County,8,8,5824,2939,2885
Kentucky,Daviess County,8,9,6034,2961,3073
Kentucky,Daviess County,8,10,6087,3028,3059
Kentucky,Daviess County,8,11,7047,3411,3636
Kentucky,Daviess County,8,12,6995,3375,3620
Kentucky,Daviess County,8,13,6200,2928,3272
Kentucky,Daviess County,8,14,5282,2482,2800
Kentucky,Daviess County,8,15,3637,1662,1975
Kentucky,Daviess County,8,16,2846,1216,1630
Kentucky,Daviess County,8,17,2049,800,1249
Kentucky,Daviess County,8,18,2212,699,1513
Kentucky,Daviess County,9,0,100032,48777,51255
Kentucky,Daviess County,9,1,6846,3560,3286
Kentucky,Daviess County,9,2,6859,3522,3337
Kentucky,Daviess County,9,3,6804,3455,3349
Kentucky,Daviess County,9,4,6221,3161,3060
Kentucky,Daviess County,9,5,5988,3029,2959
Kentucky,Daviess County,9,6,6545,3269,3276
Kentucky,Daviess County,9,7,6160,3034,3126
Kentucky,Daviess County,9,8,6113,3065,3048
Kentucky,Daviess County,9,9,5794,2859,2935
Kentucky,Daviess County,9,10,6195,3111,3084
Kentucky,Daviess County,9,11,6764,3261,3503
Kentucky,Daviess County,9,12,7075,3376,3699
Kentucky,Daviess County,9,13,6302,3016,3286
Kentucky,Daviess County,9,14,5489,2607,2882
Kentucky,Daviess County,9,15,3736,1693,2043
Kentucky,Daviess County,9,16,2851,1232,1619
Kentucky,Daviess County,9,17,2041,811,1230
Kentucky,Daviess County,9,18,2249,716,1533
Kentucky,Daviess County,10,0,100461,49012,51449
Kentucky,Daviess County,10,1,6751,3529,3222
Kentucky,Daviess County,10,2,6845,3497,3348
Kentucky,Daviess County,10,3,6920,3497,3423
Kentucky,Daviess County,10,4,6319,3223,3096
Kentucky,Daviess County,10,5,5887,2977,2910
Kentucky,Daviess County,10,6,6707,3369,3338
Kentucky,Daviess County,10,7,6257,3036,3221
Kentucky,Daviess County,10,8,6105,3067,3038
Kentucky,Daviess County,10,9,5733,2864,2869
Kentucky,Daviess County,10,10,6251,3119,3132
Kentucky,Daviess County,10,11,6460,3145,3315
Kentucky,Daviess County,10,12,7052,3352,3700
Kentucky,Daviess County,10,13,6476,3122,3354
Kentucky,Daviess County,10,14,5388,2539,2849
Kentucky,Daviess County,10,15,4086,1848,2238
Kentucky,Daviess County,10,16,2893,1249,1644
Kentucky,Daviess County,10,17,2041,831,1210
Kentucky,Daviess County,10,18,2290,748,1542
Kentucky,Daviess County,11,0,100883,49245,51638
Kentucky,Daviess County,11,1,6815,3552,3263
Kentucky,Daviess County,11,2,6819,3490,3329
Kentucky,Daviess County,11,3,6959,3526,3433
Kentucky,Daviess County,11,4,6321,3215,3106
Kentucky,Daviess County,11,5,5877,2963,2914
Kentucky,Daviess County,11,6,6856,3458,3398
Kentucky,Daviess County,11,7,6174,3016,3158
Kentucky,Daviess County,11,8,6183,3074,3109
Kentucky,Daviess County,11,9,5750,2886,2864
Kentucky,Daviess County,11,10,6132,3059,3073
Kentucky,Daviess County,11,11,6299,3113,3186
Kentucky,Daviess County,11,12,6947,3289,3658
Kentucky,Daviess County,11,13,6660,3195,3465
Kentucky,Daviess County,11,14,5347,2522,2825
Kentucky,Daviess County,11,15,4409,1978,2431
Kentucky,Daviess County,11,16,2943,1296,1647
Kentucky,Daviess County,11,17,2126,883,1243
Kentucky,Daviess County,11,18,2266,730,1536
Kentucky,Daviess County,12,0,101511,49577,51934
Kentucky,Daviess County,12,1,6775,3515,3260
Kentucky,Daviess County,12,2,6862,3513,3349
Kentucky,Daviess County,12,3,6946,3523,3423
Kentucky,Daviess County,12,4,6412,3266,3146
Kentucky,Daviess County,12,5,5986,3014,2972
Kentucky,Daviess County,12,6,6902,3473,3429
Kentucky,Daviess County,12,7,6241,3053,3188
Kentucky,Daviess County,12,8,6313,3140,3173
Kentucky,Daviess County,12,9,5729,2910,2819
Kentucky,Daviess County,12,10,6032,2959,3073
Kentucky,Daviess County,12,11,6135,3072,3063
Kentucky,Daviess County,12,12,6928,3287,3641
Kentucky,Daviess County,12,13,6703,3180,3523
Kentucky,Daviess County,12,14,5509,2611,2898
Kentucky,Daviess County,12,15,4586,2080,2506
Kentucky,Daviess County,12,16,3028,1351,1677
Kentucky,Daviess County,12,17,2184,910,1274
Kentucky,Daviess County,12,18,2240,720,1520
Kentucky,Edmonson County,1,0,12161,6071,6090
Kentucky,Edmonson County,1,1,665,344,321
Kentucky,Edmonson County,1,2,713,337,376
Kentucky,Edmonson County,1,3,757,388,369
Kentucky,Edmonson County,1,4,901,514,387
Kentucky,Edmonson County,1,5,711,390,321
Kentucky,Edmonson County,1,6,635,298,337
Kentucky,Edmonson County,1,7,718,361,357
Kentucky,Edmonson County,1,8,792,388,404
Kentucky,Edmonson County,1,9,744,368,376
Kentucky,Edmonson County,1,10,886,451,435
Kentucky,Edmonson County,1,11,910,441,469
Kentucky,Edmonson County,1,12,850,432,418
Kentucky,Edmonson County,1,13,856,416,440
Kentucky,Edmonson County,1,14,724,360,364
Kentucky,Edmonson County,1,15,471,222,249
Kentucky,Edmonson County,1,16,369,184,185
Kentucky,Edmonson County,1,17,246,110,136
Kentucky,Edmonson County,1,18,213,67,146
Kentucky,Edmonson County,2,0,12177,6079,6098
Kentucky,Edmonson County,2,1,665,344,321
Kentucky,Edmonson County,2,2,715,338,377
Kentucky,Edmonson County,2,3,757,388,369
Kentucky,Edmonson County,2,4,900,513,387
Kentucky,Edmonson County,2,5,713,391,322
Kentucky,Edmonson County,2,6,635,298,337
Kentucky,Edmonson County,2,7,719,361,358
Kentucky,Edmonson County,2,8,792,388,404
Kentucky,Edmonson County,2,9,745,368,377
Kentucky,Edmonson County,2,10,888,452,436
Kentucky,Edmonson County,2,11,912,443,469
Kentucky,Edmonson County,2,12,856,435,421
Kentucky,Edmonson County,2,13,856,416,440
Kentucky,Edmonson County,2,14,724,360,364
Kentucky,Edmonson County,2,15,471,222,249
Kentucky,Edmonson County,2,16,371,185,186
Kentucky,Edmonson County,2,17,245,110,135
Kentucky,Edmonson County,2,18,213,67,146
Kentucky,Edmonson County,3,0,12228,6116,6112
Kentucky,Edmonson County,3,1,655,337,318
Kentucky,Edmonson County,3,2,708,336,372
Kentucky,Edmonson County,3,3,751,382,369
Kentucky,Edmonson County,3,4,910,527,383
Kentucky,Edmonson County,3,5,736,405,331
Kentucky,Edmonson County,3,6,637,303,334
Kentucky,Edmonson County,3,7,719,359,360
Kentucky,Edmonson County,3,8,790,388,402
Kentucky,Edmonson County,3,9,756,373,383
Kentucky,Edmonson County,3,10,887,451,436
Kentucky,Edmonson County,3,11,909,441,468
Kentucky,Edmonson County,3,12,867,442,425
Kentucky,Edmonson County,3,13,862,417,445
Kentucky,Edmonson County,3,14,720,359,361
Kentucky,Edmonson County,3,15,484,233,251
Kentucky,Edmonson County,3,16,371,183,188
Kentucky,Edmonson County,3,17,250,112,138
Kentucky,Edmonson County,3,18,216,68,148
Kentucky,Edmonson County,4,0,12229,6118,6111
Kentucky,Edmonson County,4,1,648,338,310
Kentucky,Edmonson County,4,2,698,340,358
Kentucky,Edmonson County,4,3,723,364,359
Kentucky,Edmonson County,4,4,895,518,377
Kentucky,Edmonson County,4,5,736,397,339
Kentucky,Edmonson County,4,6,639,312,327
Kentucky,Edmonson County,4,7,740,369,371
Kentucky,Edmonson County,4,8,769,388,381
Kentucky,Edmonson County,4,9,774,379,395
Kentucky,Edmonson County,4,10,856,429,427
Kentucky,Edmonson County,4,11,894,436,458
Kentucky,Edmonson County,4,12,882,449,433
Kentucky,Edmonson County,4,13,882,425,457
Kentucky,Edmonson County,4,14,707,345,362
Kentucky,Edmonson County,4,15,536,267,269
Kentucky,Edmonson County,4,16,363,169,194
Kentucky,Edmonson County,4,17,259,118,141
Kentucky,Edmonson County,4,18,228,75,153
Kentucky,Edmonson County,5,0,12091,6068,6023
Kentucky,Edmonson County,5,1,612,309,303
Kentucky,Edmonson County,5,2,673,338,335
Kentucky,Edmonson County,5,3,697,354,343
Kentucky,Edmonson County,5,4,857,495,362
Kentucky,Edmonson County,5,5,744,406,338
Kentucky,Edmonson County,5,6,625,314,311
Kentucky,Edmonson County,5,7,730,358,372
Kentucky,Edmonson County,5,8,726,380,346
Kentucky,Edmonson County,5,9,792,373,419
Kentucky,Edmonson County,5,10,817,411,406
Kentucky,Edmonson County,5,11,906,452,454
Kentucky,Edmonson County,5,12,898,451,447
Kentucky,Edmonson County,5,13,855,421,434
Kentucky,Edmonson County,5,14,730,353,377
Kentucky,Edmonson County,5,15,569,281,288
Kentucky,Edmonson County,5,16,356,159,197
Kentucky,Edmonson County,5,17,271,133,138
Kentucky,Edmonson County,5,18,233,80,153
Kentucky,Edmonson County,6,0,12058,6004,6054
Kentucky,Edmonson County,6,1,576,277,299
Kentucky,Edmonson County,6,2,661,341,320
Kentucky,Edmonson County,6,3,703,352,351
Kentucky,Edmonson County,6,4,839,471,368
Kentucky,Edmonson County,6,5,725,390,335
Kentucky,Edmonson County,6,6,629,314,315
Kentucky,Edmonson County,6,7,731,357,374
Kentucky,Edmonson County,6,8,727,369,358
Kentucky,Edmonson County,6,9,787,378,409
Kentucky,Edmonson County,6,10,761,370,391
Kentucky,Edmonson County,6,11,945,485,460
Kentucky,Edmonson County,6,12,903,439,464
Kentucky,Edmonson County,6,13,854,431,423
Kentucky,Edmonson County,6,14,756,357,399
Kentucky,Edmonson County,6,15,589,284,305
Kentucky,Edmonson County,6,16,366,168,198
Kentucky,Edmonson County,6,17,274,141,133
Kentucky,Edmonson County,6,18,232,80,152
Kentucky,Edmonson County,7,0,12007,6009,5998
Kentucky,Edmonson County,7,1,551,274,277
Kentucky,Edmonson County,7,2,657,334,323
Kentucky,Edmonson County,7,3,691,337,354
Kentucky,Edmonson County,7,4,798,455,343
Kentucky,Edmonson County,7,5,738,413,325
Kentucky,Edmonson County,7,6,674,343,331
Kentucky,Edmonson County,7,7,689,324,365
Kentucky,Edmonson County,7,8,727,377,350
Kentucky,Edmonson County,7,9,769,374,395
Kentucky,Edmonson County,7,10,728,357,371
Kentucky,Edmonson County,7,11,963,494,469
Kentucky,Edmonson County,7,12,903,437,466
Kentucky,Edmonson County,7,13,842,434,408
Kentucky,Edmonson County,7,14,786,377,409
Kentucky,Edmonson County,7,15,610,290,320
Kentucky,Edmonson County,7,16,381,175,206
Kentucky,Edmonson County,7,17,271,132,139
Kentucky,Edmonson County,7,18,229,82,147
Kentucky,Edmonson County,8,0,11991,6001,5990
Kentucky,Edmonson County,8,1,541,266,275
Kentucky,Edmonson County,8,2,629,326,303
Kentucky,Edmonson County,8,3,669,326,343
Kentucky,Edmonson County,8,4,806,455,351
Kentucky,Edmonson County,8,5,739,402,337
Kentucky,Edmonson County,8,6,644,331,313
Kentucky,Edmonson County,8,7,682,314,368
Kentucky,Edmonson County,8,8,730,379,351
Kentucky,Edmonson County,8,9,777,386,391
Kentucky,Edmonson County,8,10,732,350,382
Kentucky,Edmonson County,8,11,922,474,448
Kentucky,Edmonson County,8,12,901,439,462
Kentucky,Edmonson County,8,13,838,428,410
Kentucky,Edmonson County,8,14,838,413,425
Kentucky,Edmonson County,8,15,634,311,323
Kentucky,Edmonson County,8,16,409,189,220
Kentucky,Edmonson County,8,17,261,124,137
Kentucky,Edmonson County,8,18,239,88,151
Kentucky,Edmonson County,9,0,12076,6047,6029
Kentucky,Edmonson County,9,1,578,278,300
Kentucky,Edmonson County,9,2,612,324,288
Kentucky,Edmonson County,9,3,659,322,337
Kentucky,Edmonson County,9,4,764,441,323
Kentucky,Edmonson County,9,5,741,404,337
Kentucky,Edmonson County,9,6,680,351,329
Kentucky,Edmonson County,9,7,674,323,351
Kentucky,Edmonson County,9,8,753,380,373
Kentucky,Edmonson County,9,9,739,385,354
Kentucky,Edmonson County,9,10,776,362,414
Kentucky,Edmonson County,9,11,883,443,440
Kentucky,Edmonson County,9,12,913,450,463
Kentucky,Edmonson County,9,13,840,426,414
Kentucky,Edmonson County,9,14,865,418,447
Kentucky,Edmonson County,9,15,635,317,318
Kentucky,Edmonson County,9,16,451,212,239
Kentucky,Edmonson County,9,17,248,108,140
Kentucky,Edmonson County,9,18,265,103,162
Kentucky,Edmonson County,10,0,12226,6134,6092
Kentucky,Edmonson County,10,1,568,274,294
Kentucky,Edmonson County,10,2,627,324,303
Kentucky,Edmonson County,10,3,673,341,332
Kentucky,Edmonson County,10,4,759,434,325
Kentucky,Edmonson County,10,5,750,407,343
Kentucky,Edmonson County,10,6,734,369,365
Kentucky,Edmonson County,10,7,674,332,342
Kentucky,Edmonson County,10,8,767,381,386
Kentucky,Edmonson County,10,9,729,381,348
Kentucky,Edmonson County,10,10,812,380,432
Kentucky,Edmonson County,10,11,845,425,420
Kentucky,Edmonson County,10,12,947,474,473
Kentucky,Edmonson County,10,13,846,429,417
Kentucky,Edmonson County,10,14,834,408,426
Kentucky,Edmonson County,10,15,673,334,339
Kentucky,Edmonson County,10,16,468,218,250
Kentucky,Edmonson County,10,17,248,107,141
Kentucky,Edmonson County,10,18,272,116,156
Kentucky,Edmonson County,11,0,12249,6156,6093
Kentucky,Edmonson County,11,1,578,279,299
Kentucky,Edmonson County,11,2,619,319,300
Kentucky,Edmonson County,11,3,627,331,296
Kentucky,Edmonson County,11,4,760,439,321
Kentucky,Edmonson County,11,5,744,395,349
Kentucky,Edmonson County,11,6,771,396,375
Kentucky,Edmonson County,11,7,686,339,347
Kentucky,Edmonson County,11,8,740,364,376
Kentucky,Edmonson County,11,9,740,373,367
Kentucky,Edmonson County,11,10,790,376,414
Kentucky,Edmonson County,11,11,787,388,399
Kentucky,Edmonson County,11,12,981,512,469
Kentucky,Edmonson County,11,13,889,431,458
Kentucky,Edmonson County,11,14,817,414,403
Kentucky,Edmonson County,11,15,675,326,349
Kentucky,Edmonson County,11,16,503,237,266
Kentucky,Edmonson County,11,17,260,118,142
Kentucky,Edmonson County,11,18,282,119,163
Kentucky,Edmonson County,12,0,12150,6151,5999
Kentucky,Edmonson County,12,1,545,282,263
Kentucky,Edmonson County,12,2,597,312,285
Kentucky,Edmonson County,12,3,607,318,289
Kentucky,Edmonson County,12,4,730,413,317
Kentucky,Edmonson County,12,5,709,382,327
Kentucky,Edmonson County,12,6,754,403,351
Kentucky,Edmonson County,12,7,709,349,360
Kentucky,Edmonson County,12,8,716,349,367
Kentucky,Edmonson County,12,9,745,389,356
Kentucky,Edmonson County,12,10,794,384,410
Kentucky,Edmonson County,12,11,758,364,394
Kentucky,Edmonson County,12,12,1003,529,474
Kentucky,Edmonson County,12,13,882,428,454
Kentucky,Edmonson County,12,14,811,417,394
Kentucky,Edmonson County,12,15,707,344,363
Kentucky,Edmonson County,12,16,532,249,283
Kentucky,Edmonson County,12,17,266,118,148
Kentucky,Edmonson County,12,18,285,121,164
Kentucky,Elliott County,1,0,7852,4401,3451
Kentucky,Elliott County,1,1,444,226,218
Kentucky,Elliott County,1,2,419,219,200
Kentucky,Elliott County,1,3,462,265,197
Kentucky,Elliott County,1,4,442,245,197
Kentucky,Elliott County,1,5,450,268,182
Kentucky,Elliott County,1,6,546,367,179
Kentucky,Elliott County,1,7,566,344,222
Kentucky,Elliott County,1,8,612,387,225
Kentucky,Elliott County,1,9,542,337,205
Kentucky,Elliott County,1,10,586,340,246
Kentucky,Elliott County,1,11,586,314,272
Kentucky,Elliott County,1,12,584,326,258
Kentucky,Elliott County,1,13,479,258,221
Kentucky,Elliott County,1,14,396,201,195
Kentucky,Elliott County,1,15,293,136,157
Kentucky,Elliott County,1,16,200,86,114
Kentucky,Elliott County,1,17,139,50,89
Kentucky,Elliott County,1,18,106,32,74
Kentucky,Elliott County,2,0,7850,4400,3450
Kentucky,Elliott County,2,1,444,226,218
Kentucky,Elliott County,2,2,419,219,200
Kentucky,Elliott County,2,3,462,265,197
Kentucky,Elliott County,2,4,442,245,197
Kentucky,Elliott County,2,5,450,268,182
Kentucky,Elliott County,2,6,545,367,178
Kentucky,Elliott County,2,7,565,343,222
Kentucky,Elliott County,2,8,612,387,225
Kentucky,Elliott County,2,9,542,337,205
Kentucky,Elliott County,2,10,586,340,246
Kentucky,Elliott County,2,11,587,315,272
Kentucky,Elliott County,2,12,585,325,260
Kentucky,Elliott County,2,13,478,258,220
Kentucky,Elliott County,2,14,396,201,195
Kentucky,Elliott County,2,15,292,136,156
Kentucky,Elliott County,2,16,200,86,114
Kentucky,Elliott County,2,17,139,50,89
Kentucky,Elliott County,2,18,106,32,74
Kentucky,Elliott County,3,0,7843,4396,3447
Kentucky,Elliott County,3,1,438,225,213
Kentucky,Elliott County,3,2,420,218,202
Kentucky,Elliott County,3,3,468,266,202
Kentucky,Elliott County,3,4,437,242,195
Kentucky,Elliott County,3,5,463,277,186
Kentucky,Elliott County,3,6,536,362,174
Kentucky,Elliott County,3,7,562,344,218
Kentucky,Elliott County,3,8,604,376,228
Kentucky,Elliott County,3,9,546,341,205
Kentucky,Elliott County,3,10,586,341,245
Kentucky,Elliott County,3,11,584,315,269
Kentucky,Elliott County,3,12,588,325,263
Kentucky,Elliott County,3,13,479,257,222
Kentucky,Elliott County,3,14,390,200,190
Kentucky,Elliott County,3,15,293,136,157
Kentucky,Elliott County,3,16,204,88,116
Kentucky,Elliott County,3,17,142,52,90
Kentucky,Elliott County,3,18,103,31,72
Kentucky,Elliott County,4,0,7782,4372,3410
Kentucky,Elliott County,4,1,397,215,182
Kentucky,Elliott County,4,2,417,208,209
Kentucky,Elliott County,4,3,466,256,210
Kentucky,Elliott County,4,4,413,227,186
Kentucky,Elliott County,4,5,494,310,184
Kentucky,Elliott County,4,6,508,342,166
Kentucky,Elliott County,4,7,546,345,201
Kentucky,Elliott County,4,8,574,344,230
Kentucky,Elliott County,4,9,570,355,215
Kentucky,Elliott County,4,10,587,342,245
Kentucky,Elliott County,4,11,551,303,248
Kentucky,Elliott County,4,12,602,332,270
Kentucky,Elliott County,4,13,482,256,226
Kentucky,Elliott County,4,14,391,206,185
Kentucky,Elliott County,4,15,306,148,158
Kentucky,Elliott County,4,16,227,96,131
Kentucky,Elliott County,4,17,147,56,91
Kentucky,Elliott County,4,18,104,31,73
Kentucky,Elliott County,5,0,7633,4294,3339
Kentucky,Elliott County,5,1,359,192,167
Kentucky,Elliott County,5,2,398,198,200
Kentucky,Elliott County,5,3,446,235,211
Kentucky,Elliott County,5,4,414,235,179
Kentucky,Elliott County,5,5,480,301,179
Kentucky,Elliott County,5,6,508,347,161
Kentucky,Elliott County,5,7,515,337,178
Kentucky,Elliott County,5,8,565,331,234
Kentucky,Elliott County,5,9,576,364,212
Kentucky,Elliott County,5,10,567,333,234
Kentucky,Elliott County,5,11,511,289,222
Kentucky,Elliott County,5,12,583,309,274
Kentucky,Elliott County,5,13,481,262,219
Kentucky,Elliott County,5,14,423,218,205
Kentucky,Elliott County,5,15,312,153,159
Kentucky,Elliott County,5,16,230,97,133
Kentucky,Elliott County,5,17,145,59,86
Kentucky,Elliott County,5,18,120,34,86
Kentucky,Elliott County,6,0,7551,4269,3282
Kentucky,Elliott County,6,1,346,181,165
Kentucky,Elliott County,6,2,401,201,200
Kentucky,Elliott County,6,3,420,226,194
Kentucky,Elliott County,6,4,399,224,175
Kentucky,Elliott County,6,5,471,305,166
Kentucky,Elliott County,6,6,528,353,175
Kentucky,Elliott County,6,7,528,348,180
Kentucky,Elliott County,6,8,525,308,217
Kentucky,Elliott County,6,9,575,374,201
Kentucky,Elliott County,6,10,560,315,245
Kentucky,Elliott County,6,11,499,292,207
Kentucky,Elliott County,6,12,559,290,269
Kentucky,Elliott County,6,13,489,270,219
Kentucky,Elliott County,6,14,438,220,218
Kentucky,Elliott County,6,15,313,156,157
Kentucky,Elliott County,6,16,240,117,123
Kentucky,Elliott County,6,17,141,56,85
Kentucky,Elliott County,6,18,119,33,86
Kentucky,Elliott County,7,0,7532,4263,3269
Kentucky,Elliott County,7,1,339,175,164
Kentucky,Elliott County,7,2,408,205,203
Kentucky,Elliott County,7,3,424,218,206
Kentucky,Elliott County,7,4,386,221,165
Kentucky,Elliott County,7,5,455,300,155
Kentucky,Elliott County,7,6,523,354,169
Kentucky,Elliott County,7,7,511,338,173
Kentucky,Elliott County,7,8,519,299,220
Kentucky,Elliott County,7,9,571,370,201
Kentucky,Elliott County,7,10,535,327,208
Kentucky,Elliott County,7,11,503,285,218
Kentucky,Elliott County,7,12,553,284,269
Kentucky,Elliott County,7,13,505,277,228
Kentucky,Elliott County,7,14,445,226,219
Kentucky,Elliott County,7,15,328,167,161
Kentucky,Elliott County,7,16,255,124,131
Kentucky,Elliott County,7,17,153,61,92
Kentucky,Elliott County,7,18,119,32,87
Kentucky,Elliott County,8,0,7548,4246,3302
Kentucky,Elliott County,8,1,356,190,166
Kentucky,Elliott County,8,2,428,212,216
Kentucky,Elliott County,8,3,389,189,200
Kentucky,Elliott County,8,4,383,217,166
Kentucky,Elliott County,8,5,468,303,165
Kentucky,Elliott County,8,6,537,357,180
Kentucky,Elliott County,8,7,494,332,162
Kentucky,Elliott County,8,8,515,301,214
Kentucky,Elliott County,8,9,556,340,216
Kentucky,Elliott County,8,10,526,330,196
Kentucky,Elliott County,8,11,523,284,239
Kentucky,Elliott County,8,12,535,288,247
Kentucky,Elliott County,8,13,518,278,240
Kentucky,Elliott County,8,14,435,221,214
Kentucky,Elliott County,8,15,346,178,168
Kentucky,Elliott County,8,16,252,115,137
Kentucky,Elliott County,8,17,159,71,88
Kentucky,Elliott County,8,18,128,40,88
Kentucky,Elliott County,9,0,7491,4235,3256
Kentucky,Elliott County,9,1,363,194,169
Kentucky,Elliott County,9,2,399,207,192
Kentucky,Elliott County,9,3,382,188,194
Kentucky,Elliott County,9,4,384,211,173
Kentucky,Elliott County,9,5,434,279,155
Kentucky,Elliott County,9,6,553,375,178
Kentucky,Elliott County,9,7,477,328,149
Kentucky,Elliott County,9,8,514,312,202
Kentucky,Elliott County,9,9,539,314,225
Kentucky,Elliott County,9,10,548,347,201
Kentucky,Elliott County,9,11,507,277,230
Kentucky,Elliott County,9,12,496,272,224
Kentucky,Elliott County,9,13,525,278,247
Kentucky,Elliott County,9,14,445,227,218
Kentucky,Elliott County,9,15,345,177,168
Kentucky,Elliott County,9,16,266,127,139
Kentucky,Elliott County,9,17,173,75,98
Kentucky,Elliott County,9,18,141,47,94
Kentucky,Elliott County,10,0,7493,4243,3250
Kentucky,Elliott County,10,1,343,185,158
Kentucky,Elliott County,10,2,393,209,184
Kentucky,Elliott County,10,3,391,194,197
Kentucky,Elliott County,10,4,381,203,178
Kentucky,Elliott County,10,5,433,281,152
Kentucky,Elliott County,10,6,554,371,183
Kentucky,Elliott County,10,7,476,322,154
Kentucky,Elliott County,10,8,494,311,183
Kentucky,Elliott County,10,9,532,303,229
Kentucky,Elliott County,10,10,557,350,207
Kentucky,Elliott County,10,11,519,292,227
Kentucky,Elliott County,10,12,478,262,216
Kentucky,Elliott County,10,13,518,270,248
Kentucky,Elliott County,10,14,457,241,216
Kentucky,Elliott County,10,15,372,186,186
Kentucky,Elliott County,10,16,262,130,132
Kentucky,Elliott County,10,17,182,81,101
Kentucky,Elliott County,10,18,151,52,99
Kentucky,Elliott County,11,0,7499,4250,3249
Kentucky,Elliott County,11,1,346,188,158
Kentucky,Elliott County,11,2,378,190,188
Kentucky,Elliott County,11,3,394,192,202
Kentucky,Elliott County,11,4,381,208,173
Kentucky,Elliott County,11,5,439,283,156
Kentucky,Elliott County,11,6,556,381,175
Kentucky,Elliott County,11,7,482,325,157
Kentucky,Elliott County,11,8,496,312,184
Kentucky,Elliott County,11,9,517,296,221
Kentucky,Elliott County,11,10,549,353,196
Kentucky,Elliott County,11,11,517,293,224
Kentucky,Elliott County,11,12,467,259,208
Kentucky,Elliott County,11,13,498,250,248
Kentucky,Elliott County,11,14,468,253,215
Kentucky,Elliott County,11,15,394,188,206
Kentucky,Elliott County,11,16,266,129,137
Kentucky,Elliott County,11,17,188,99,89
Kentucky,Elliott County,11,18,163,51,112
Kentucky,Elliott County,12,0,7517,4283,3234
Kentucky,Elliott County,12,1,336,192,144
Kentucky,Elliott County,12,2,365,186,179
Kentucky,Elliott County,12,3,406,193,213
Kentucky,Elliott County,12,4,358,188,170
Kentucky,Elliott County,12,5,444,294,150
Kentucky,Elliott County,12,6,570,397,173
Kentucky,Elliott County,12,7,484,321,163
Kentucky,Elliott County,12,8,488,312,176
Kentucky,Elliott County,12,9,501,290,211
Kentucky,Elliott County,12,10,584,368,216
Kentucky,Elliott County,12,11,499,296,203
Kentucky,Elliott County,12,12,460,252,208
Kentucky,Elliott County,12,13,492,252,240
Kentucky,Elliott County,12,14,490,258,232
Kentucky,Elliott County,12,15,399,192,207
Kentucky,Elliott County,12,16,268,133,135
Kentucky,Elliott County,12,17,213,109,104
Kentucky,Elliott County,12,18,160,50,110
Kentucky,Estill County,1,0,14672,7233,7439
Kentucky,Estill County,1,1,856,447,409
Kentucky,Estill County,1,2,972,503,469
Kentucky,Estill County,1,3,922,462,460
Kentucky,Estill County,1,4,938,497,441
Kentucky,Estill County,1,5,713,364,349
Kentucky,Estill County,1,6,810,383,427
Kentucky,Estill County,1,7,917,486,431
Kentucky,Estill County,1,8,913,442,471
Kentucky,Estill County,1,9,1094,572,522
Kentucky,Estill County,1,10,1211,592,619
Kentucky,Estill County,1,11,1060,529,531
Kentucky,Estill County,1,12,1047,492,555
Kentucky,Estill County,1,13,972,472,500
Kentucky,Estill County,1,14,780,383,397
Kentucky,Estill County,1,15,589,270,319
Kentucky,Estill County,1,16,414,175,239
Kentucky,Estill County,1,17,248,90,158
Kentucky,Estill County,1,18,216,74,142
Kentucky,Estill County,2,0,14679,7239,7440
Kentucky,Estill County,2,1,856,447,409
Kentucky,Estill County,2,2,974,505,469
Kentucky,Estill County,2,3,924,464,460
Kentucky,Estill County,2,4,938,497,441
Kentucky,Estill County,2,5,714,365,349
Kentucky,Estill County,2,6,810,383,427
Kentucky,Estill County,2,7,917,486,431
Kentucky,Estill County,2,8,913,442,471
Kentucky,Estill County,2,9,1094,572,522
Kentucky,Estill County,2,10,1213,593,620
Kentucky,Estill County,2,11,1060,529,531
Kentucky,Estill County,2,12,1047,492,555
Kentucky,Estill County,2,13,972,472,500
Kentucky,Estill County,2,14,780,383,397
Kentucky,Estill County,2,15,589,270,319
Kentucky,Estill County,2,16,414,175,239
Kentucky,Estill County,2,17,248,90,158
Kentucky,Estill County,2,18,216,74,142
Kentucky,Estill County,3,0,14713,7257,7456
Kentucky,Estill County,3,1,853,452,401
Kentucky,Estill County,3,2,977,502,475
Kentucky,Estill County,3,3,931,468,463
Kentucky,Estill County,3,4,920,485,435
Kentucky,Estill County,3,5,724,373,351
Kentucky,Estill County,3,6,812,384,428
Kentucky,Estill County,3,7,916,484,432
Kentucky,Estill County,3,8,908,440,468
Kentucky,Estill County,3,9,1094,573,521
Kentucky,Estill County,3,10,1206,587,619
Kentucky,Estill County,3,11,1078,538,540
Kentucky,Estill County,3,12,1045,494,551
Kentucky,Estill County,3,13,984,473,511
Kentucky,Estill County,3,14,780,386,394
Kentucky,Estill County,3,15,590,271,319
Kentucky,Estill County,3,16,422,180,242
Kentucky,Estill County,3,17,251,89,162
Kentucky,Estill County,3,18,222,78,144
Kentucky,Estill County,4,0,14654,7238,7416
Kentucky,Estill County,4,1,849,455,394
Kentucky,Estill County,4,2,955,484,471
Kentucky,Estill County,4,3,941,481,460
Kentucky,Estill County,4,4,886,466,420
Kentucky,Estill County,4,5,756,392,364
Kentucky,Estill County,4,6,804,390,414
Kentucky,Estill County,4,7,921,473,448
Kentucky,Estill County,4,8,870,428,442
Kentucky,Estill County,4,9,1086,558,528
Kentucky,Estill County,4,10,1145,562,583
Kentucky,Estill County,4,11,1142,569,573
Kentucky,Estill County,4,12,993,483,510
Kentucky,Estill County,4,13,1034,486,548
Kentucky,Estill County,4,14,770,384,386
Kentucky,Estill County,4,15,604,281,323
Kentucky,Estill County,4,16,437,190,247
Kentucky,Estill County,4,17,248,83,165
Kentucky,Estill County,4,18,213,73,140
Kentucky,Estill County,5,0,14503,7141,7362
Kentucky,Estill County,5,1,821,412,409
Kentucky,Estill County,5,2,976,497,479
Kentucky,Estill County,5,3,925,481,444
Kentucky,Estill County,5,4,827,436,391
Kentucky,Estill County,5,5,774,393,381
Kentucky,Estill County,5,6,769,380,389
Kentucky,Estill County,5,7,896,455,441
Kentucky,Estill County,5,8,847,426,421
Kentucky,Estill County,5,9,1038,540,498
Kentucky,Estill County,5,10,1124,561,563
Kentucky,Estill County,5,11,1163,579,584
Kentucky,Estill County,5,12,986,466,520
Kentucky,Estill County,5,13,1007,473,534
Kentucky,Estill County,5,14,815,391,424
Kentucky,Estill County,5,15,630,303,327
Kentucky,Estill County,5,16,439,192,247
Kentucky,Estill County,5,17,266,93,173
Kentucky,Estill County,5,18,200,63,137
Kentucky,Estill County,6,0,14482,7115,7367
Kentucky,Estill County,6,1,794,403,391
Kentucky,Estill County,6,2,946,474,472
Kentucky,Estill County,6,3,924,474,450
Kentucky,Estill County,6,4,817,423,394
Kentucky,Estill County,6,5,798,416,382
Kentucky,Estill County,6,6,757,383,374
Kentucky,Estill County,6,7,879,435,444
Kentucky,Estill County,6,8,875,436,439
Kentucky,Estill County,6,9,982,518,464
Kentucky,Estill County,6,10,1109,559,550
Kentucky,Estill County,6,11,1160,579,581
Kentucky,Estill County,6,12,999,467,532
Kentucky,Estill County,6,13,1002,472,530
Kentucky,Estill County,6,14,830,390,440
Kentucky,Estill County,6,15,685,330,355
Kentucky,Estill County,6,16,436,189,247
Kentucky,Estill County,6,17,283,103,180
Kentucky,Estill County,6,18,206,64,142
Kentucky,Estill County,7,0,14441,7116,7325
Kentucky,Estill County,7,1,804,411,393
Kentucky,Estill County,7,2,897,439,458
Kentucky,Estill County,7,3,919,486,433
Kentucky,Estill County,7,4,832,425,407
Kentucky,Estill County,7,5,836,445,391
Kentucky,Estill County,7,6,746,372,374
Kentucky,Estill County,7,7,846,417,429
Kentucky,Estill County,7,8,879,458,421
Kentucky,Estill County,7,9,965,494,471
Kentucky,Estill County,7,10,1092,563,529
Kentucky,Estill County,7,11,1155,575,580
Kentucky,Estill County,7,12,979,467,512
Kentucky,Estill County,7,13,997,460,537
Kentucky,Estill County,7,14,859,401,458
Kentucky,Estill County,7,15,696,330,366
Kentucky,Estill County,7,16,448,204,244
Kentucky,Estill County,7,17,292,107,185
Kentucky,Estill County,7,18,199,62,137
Kentucky,Estill County,8,0,14373,7101,7272
Kentucky,Estill County,8,1,790,390,400
Kentucky,Estill County,8,2,867,450,417
Kentucky,Estill County,8,3,935,481,454
Kentucky,Estill County,8,4,838,431,407
Kentucky,Estill County,8,5,805,427,378
Kentucky,Estill County,8,6,770,390,380
Kentucky,Estill County,8,7,804,399,405
Kentucky,Estill County,8,8,901,475,426
Kentucky,Estill County,8,9,917,447,470
Kentucky,Estill County,8,10,1072,558,514
Kentucky,Estill County,8,11,1165,570,595
Kentucky,Estill County,8,12,1003,500,503
Kentucky,Estill County,8,13,956,444,512
Kentucky,Estill County,8,14,899,414,485
Kentucky,Estill County,8,15,677,328,349
Kentucky,Estill County,8,16,456,205,251
Kentucky,Estill County,8,17,316,126,190
Kentucky,Estill County,8,18,202,66,136
Kentucky,Estill County,9,0,14315,7036,7279
Kentucky,Estill County,9,1,799,378,421
Kentucky,Estill County,9,2,827,432,395
Kentucky,Estill County,9,3,937,474,463
Kentucky,Estill County,9,4,837,430,407
Kentucky,Estill County,9,5,770,399,371
Kentucky,Estill County,9,6,821,420,401
Kentucky,Estill County,9,7,780,410,370
Kentucky,Estill County,9,8,872,453,419
Kentucky,Estill County,9,9,874,415,459
Kentucky,Estill County,9,10,1070,550,520
Kentucky,Estill County,9,11,1100,551,549
Kentucky,Estill County,9,12,1085,533,552
Kentucky,Estill County,9,13,918,439,479
Kentucky,Estill County,9,14,930,415,515
Kentucky,Estill County,9,15,688,333,355
Kentucky,Estill County,9,16,484,213,271
Kentucky,Estill County,9,17,315,131,184
Kentucky,Estill County,9,18,208,60,148
Kentucky,Estill County,10,0,14178,6982,7196
Kentucky,Estill County,10,1,777,382,395
Kentucky,Estill County,10,2,822,415,407
Kentucky,Estill County,10,3,916,473,443
Kentucky,Estill County,10,4,812,421,391
Kentucky,Estill County,10,5,762,402,360
Kentucky,Estill County,10,6,864,429,435
Kentucky,Estill County,10,7,743,400,343
Kentucky,Estill County,10,8,847,433,414
Kentucky,Estill County,10,9,848,420,428
Kentucky,Estill County,10,10,1040,534,506
Kentucky,Estill County,10,11,1089,546,543
Kentucky,Estill County,10,12,1102,532,570
Kentucky,Estill County,10,13,907,423,484
Kentucky,Estill County,10,14,904,416,488
Kentucky,Estill County,10,15,727,335,392
Kentucky,Estill County,10,16,501,224,277
Kentucky,Estill County,10,17,304,132,172
Kentucky,Estill County,10,18,213,65,148
Kentucky,Estill County,11,0,14150,6991,7159
Kentucky,Estill County,11,1,769,383,386
Kentucky,Estill County,11,2,812,412,400
Kentucky,Estill County,11,3,913,461,452
Kentucky,Estill County,11,4,814,429,385
Kentucky,Estill County,11,5,752,386,366
Kentucky,Estill County,11,6,882,461,421
Kentucky,Estill County,11,7,738,410,328
Kentucky,Estill County,11,8,831,414,417
Kentucky,Estill County,11,9,873,431,442
Kentucky,Estill County,11,10,968,512,456
Kentucky,Estill County,11,11,1099,544,555
Kentucky,Estill County,11,12,1118,553,565
Kentucky,Estill County,11,13,896,405,491
Kentucky,Estill County,11,14,917,421,496
Kentucky,Estill County,11,15,734,335,399
Kentucky,Estill County,11,16,533,247,286
Kentucky,Estill County,11,17,292,120,172
Kentucky,Estill County,11,18,209,67,142
Kentucky,Estill County,12,0,14106,6966,7140
Kentucky,Estill County,12,1,780,386,394
Kentucky,Estill County,12,2,793,408,385
Kentucky,Estill County,12,3,905,457,448
Kentucky,Estill County,12,4,806,433,373
Kentucky,Estill County,12,5,716,363,353
Kentucky,Estill County,12,6,902,475,427
Kentucky,Estill County,12,7,760,403,357
Kentucky,Estill County,12,8,803,392,411
Kentucky,Estill County,12,9,872,455,417
Kentucky,Estill County,12,10,948,473,475
Kentucky,Estill County,12,11,1074,531,543
Kentucky,Estill County,12,12,1137,562,575
Kentucky,Estill County,12,13,898,422,476
Kentucky,Estill County,12,14,894,407,487
Kentucky,Estill County,12,15,772,352,420
Kentucky,Estill County,12,16,546,252,294
Kentucky,Estill County,12,17,298,125,173
Kentucky,Estill County,12,18,202,70,132
Kentucky,Fayette County,1,0,295803,145591,150212
Kentucky,Fayette County,1,1,19145,9796,9349
Kentucky,Fayette County,1,2,17746,9056,8690
Kentucky,Fayette County,1,3,16195,8297,7898
Kentucky,Fayette County,1,4,20711,10250,10461
Kentucky,Fayette County,1,5,30567,15282,15285
Kentucky,Fayette County,1,6,26373,13482,12891
Kentucky,Fayette County,1,7,22860,11884,10976
Kentucky,Fayette County,1,8,20455,10667,9788
Kentucky,Fayette County,1,9,18817,9568,9249
Kentucky,Fayette County,1,10,20277,9985,10292
Kentucky,Fayette County,1,11,19649,9423,10226
Kentucky,Fayette County,1,12,17623,8504,9119
Kentucky,Fayette County,1,13,14247,6644,7603
Kentucky,Fayette County,1,14,9750,4443,5307
Kentucky,Fayette County,1,15,7193,3165,4028
Kentucky,Fayette County,1,16,5512,2262,3250
Kentucky,Fayette County,1,17,4380,1551,2829
Kentucky,Fayette County,1,18,4303,1332,2971
Kentucky,Fayette County,2,0,295870,145626,150244
Kentucky,Fayette County,2,1,19158,9802,9356
Kentucky,Fayette County,2,2,17748,9056,8692
Kentucky,Fayette County,2,3,16196,8299,7897
Kentucky,Fayette County,2,4,20714,10251,10463
Kentucky,Fayette County,2,5,30578,15286,15292
Kentucky,Fayette County,2,6,26384,13492,12892
Kentucky,Fayette County,2,7,22867,11888,10979
Kentucky,Fayette County,2,8,20457,10669,9788
Kentucky,Fayette County,2,9,18821,9570,9251
Kentucky,Fayette County,2,10,20276,9985,10291
Kentucky,Fayette County,2,11,19654,9426,10228
Kentucky,Fayette County,2,12,17623,8503,9120
Kentucky,Fayette County,2,13,14247,6644,7603
Kentucky,Fayette County,2,14,9753,4444,5309
Kentucky,Fayette County,2,15,7198,3166,4032
Kentucky,Fayette County,2,16,5512,2262,3250
Kentucky,Fayette County,2,17,4380,1551,2829
Kentucky,Fayette County,2,18,4304,1332,2972
Kentucky,Fayette County,3,0,296848,146105,150743
Kentucky,Fayette County,3,1,19129,9778,9351
Kentucky,Fayette County,3,2,17806,9100,8706
Kentucky,Fayette County,3,3,16334,8349,7985
Kentucky,Fayette County,3,4,20721,10299,10422
Kentucky,Fayette County,3,5,30726,15313,15413
Kentucky,Fayette County,3,6,26212,13400,12812
Kentucky,Fayette County,3,7,23004,11966,11038
Kentucky,Fayette County,3,8,20478,10669,9809
Kentucky,Fayette County,3,9,18968,9660,9308
Kentucky,Fayette County,3,10,20203,9952,10251
Kentucky,Fayette County,3,11,19690,9456,10234
Kentucky,Fayette County,3,12,17760,8558,9202
Kentucky,Fayette County,3,13,14482,6754,7728
Kentucky,Fayette County,3,14,9790,4460,5330
Kentucky,Fayette County,3,15,7278,3208,4070
Kentucky,Fayette County,3,16,5526,2281,3245
Kentucky,Fayette County,3,17,4373,1560,2813
Kentucky,Fayette County,3,18,4368,1342,3026
Kentucky,Fayette County,4,0,301696,148321,153375
Kentucky,Fayette County,4,1,19296,9894,9402
Kentucky,Fayette County,4,2,18229,9283,8946
Kentucky,Fayette County,4,3,16766,8540,8226
Kentucky,Fayette County,4,4,20546,10330,10216
Kentucky,Fayette County,4,5,31759,15675,16084
Kentucky,Fayette County,4,6,25888,13202,12686
Kentucky,Fayette County,4,7,23727,12287,11440
Kentucky,Fayette County,4,8,20517,10583,9934
Kentucky,Fayette County,4,9,19526,10006,9520
Kentucky,Fayette County,4,10,19676,9760,9916
Kentucky,Fayette County,4,11,19940,9585,10355
Kentucky,Fayette County,4,12,18220,8699,9521
Kentucky,Fayette County,4,13,15468,7266,8202
Kentucky,Fayette County,4,14,10043,4567,5476
Kentucky,Fayette County,4,15,7596,3337,4259
Kentucky,Fayette County,4,16,5610,2350,3260
Kentucky,Fayette County,4,17,4337,1573,2764
Kentucky,Fayette County,4,18,4552,1384,3168
Kentucky,Fayette County,5,0,305947,150210,155737
Kentucky,Fayette County,5,1,19349,9865,9484
Kentucky,Fayette County,5,2,18654,9414,9240
Kentucky,Fayette County,5,3,17103,8756,8347
Kentucky,Fayette County,5,4,20239,10153,10086
Kentucky,Fayette County,5,5,32971,16303,16668
Kentucky,Fayette County,5,6,25331,12884,12447
Kentucky,Fayette County,5,7,24135,12417,11718
Kentucky,Fayette County,5,8,20726,10631,10095
Kentucky,Fayette County,5,9,19790,10071,9719
Kentucky,Fayette County,5,10,19407,9785,9622
Kentucky,Fayette County,5,11,20106,9701,10405
Kentucky,Fayette County,5,12,18674,8824,9850
Kentucky,Fayette County,5,13,15607,7372,8235
Kentucky,Fayette County,5,14,11120,5072,6048
Kentucky,Fayette County,5,15,8003,3483,4520
Kentucky,Fayette County,5,16,5747,2435,3312
Kentucky,Fayette County,5,17,4297,1595,2702
Kentucky,Fayette County,5,18,4688,1449,3239
Kentucky,Fayette County,6,0,309865,152078,157787
Kentucky,Fayette County,6,1,19419,9979,9440
Kentucky,Fayette County,6,2,18955,9515,9440
Kentucky,Fayette County,6,3,17409,8859,8550
Kentucky,Fayette County,6,4,20491,10238,10253
Kentucky,Fayette County,6,5,33706,16670,17036
Kentucky,Fayette County,6,6,24989,12769,12220
Kentucky,Fayette County,6,7,24365,12513,11852
Kentucky,Fayette County,6,8,21018,10772,10246
Kentucky,Fayette County,6,9,20043,10193,9850
Kentucky,Fayette County,6,10,19080,9601,9479
Kentucky,Fayette County,6,11,20068,9738,10330
Kentucky,Fayette County,6,12,18981,8974,10007
Kentucky,Fayette County,6,13,16006,7482,8524
Kentucky,Fayette County,6,14,11868,5478,6390
Kentucky,Fayette County,6,15,8422,3641,4781
Kentucky,Fayette County,6,16,5949,2531,3418
Kentucky,Fayette County,6,17,4312,1637,2675
Kentucky,Fayette County,6,18,4784,1488,3296
Kentucky,Fayette County,7,0,311784,153036,158748
Kentucky,Fayette County,7,1,19364,9863,9501
Kentucky,Fayette County,7,2,18958,9624,9334
Kentucky,Fayette County,7,3,17592,8940,8652
Kentucky,Fayette County,7,4,20555,10257,10298
Kentucky,Fayette County,7,5,33805,16816,16989
Kentucky,Fayette County,7,6,24846,12674,12172
Kentucky,Fayette County,7,7,24283,12405,11878
Kentucky,Fayette County,7,8,21287,10967,10320
Kentucky,Fayette County,7,9,19917,10066,9851
Kentucky,Fayette County,7,10,18701,9438,9263
Kentucky,Fayette County,7,11,20063,9785,10278
Kentucky,Fayette County,7,12,19039,8962,10077
Kentucky,Fayette County,7,13,16490,7716,8774
Kentucky,Fayette County,7,14,12752,5869,6883
Kentucky,Fayette County,7,15,8711,3805,4906
Kentucky,Fayette County,7,16,6190,2649,3541
Kentucky,Fayette County,7,17,4365,1687,2678
Kentucky,Fayette County,7,18,4866,1513,3353
Kentucky,Fayette County,8,0,315819,154984,160835
Kentucky,Fayette County,8,1,19473,9910,9563
Kentucky,Fayette County,8,2,18677,9580,9097
Kentucky,Fayette County,8,3,17874,9068,8806
Kentucky,Fayette County,8,4,21596,10687,10909
Kentucky,Fayette County,8,5,34165,17099,17066
Kentucky,Fayette County,8,6,25189,12847,12342
Kentucky,Fayette County,8,7,24062,12292,11770
Kentucky,Fayette County,8,8,21919,11123,10796
Kentucky,Fayette County,8,9,19813,10036,9777
Kentucky,Fayette County,8,10,18745,9472,9273
Kentucky,Fayette County,8,11,19745,9643,10102
Kentucky,Fayette County,8,12,19066,8940,10126
Kentucky,Fayette County,8,13,17101,8078,9023
Kentucky,Fayette County,8,14,13658,6281,7377
Kentucky,Fayette County,8,15,9021,3965,5056
Kentucky,Fayette County,8,16,6343,2666,3677
Kentucky,Fayette County,8,17,4428,1749,2679
Kentucky,Fayette County,8,18,4944,1548,3396
Kentucky,Fayette County,9,0,319644,156718,162926
Kentucky,Fayette County,9,1,19625,9998,9627
Kentucky,Fayette County,9,2,18817,9630,9187
Kentucky,Fayette County,9,3,18114,9230,8884
Kentucky,Fayette County,9,4,22078,10916,11162
Kentucky,Fayette County,9,5,34097,17034,17063
Kentucky,Fayette County,9,6,26093,13282,12811
Kentucky,Fayette County,9,7,23867,12179,11688
Kentucky,Fayette County,9,8,22185,11241,10944
Kentucky,Fayette County,9,9,19612,9892,9720
Kentucky,Fayette County,9,10,19034,9569,9465
Kentucky,Fayette County,9,11,19278,9469,9809
Kentucky,Fayette County,9,12,19317,9086,10231
Kentucky,Fayette County,9,13,17553,8228,9325
Kentucky,Fayette County,9,14,14473,6667,7806
Kentucky,Fayette County,9,15,9306,4114,5192
Kentucky,Fayette County,9,16,6689,2829,3860
Kentucky,Fayette County,9,17,4478,1761,2717
Kentucky,Fayette County,9,18,5028,1593,3435
Kentucky,Fayette County,10,0,321964,157905,164059
Kentucky,Fayette County,10,1,19597,10047,9550
Kentucky,Fayette County,10,2,18663,9500,9163
Kentucky,Fayette County,10,3,18513,9426,9087
Kentucky,Fayette County,10,4,22110,10946,11164
Kentucky,Fayette County,10,5,33690,16806,16884
Kentucky,Fayette County,10,6,27022,13794,13228
Kentucky,Fayette County,10,7,23527,12004,11523
Kentucky,Fayette County,10,8,22315,11269,11046
Kentucky,Fayette County,10,9,19772,9974,9798
Kentucky,Fayette County,10,10,19236,9605,9631
Kentucky,Fayette County,10,11,18961,9458,9503
Kentucky,Fayette County,10,12,19234,9038,10196
Kentucky,Fayette County,10,13,17835,8307,9528
Kentucky,Fayette County,10,14,14564,6700,7864
Kentucky,Fayette County,10,15,10296,4593,5703
Kentucky,Fayette County,10,16,7076,2975,4101
Kentucky,Fayette County,10,17,4550,1845,2705
Kentucky,Fayette County,10,18,5003,1618,3385
Kentucky,Fayette County,11,0,322426,158044,164382
Kentucky,Fayette County,11,1,19318,9948,9370
Kentucky,Fayette County,11,2,18626,9516,9110
Kentucky,Fayette County,11,3,18702,9536,9166
Kentucky,Fayette County,11,4,22139,10977,11162
Kentucky,Fayette County,11,5,33611,16600,17011
Kentucky,Fayette County,11,6,26697,13642,13055
Kentucky,Fayette County,11,7,22911,11648,11263
Kentucky,Fayette County,11,8,22327,11238,11089
Kentucky,Fayette County,11,9,19950,10118,9832
Kentucky,Fayette County,11,10,19266,9554,9712
Kentucky,Fayette County,11,11,18512,9283,9229
Kentucky,Fayette County,11,12,19187,9104,10083
Kentucky,Fayette County,11,13,18110,8392,9718
Kentucky,Fayette County,11,14,14921,6829,8092
Kentucky,Fayette County,11,15,10948,4936,6012
Kentucky,Fayette County,11,16,7480,3139,4341
Kentucky,Fayette County,11,17,4680,1906,2774
Kentucky,Fayette County,11,18,5041,1678,3363
Kentucky,Fayette County,12,0,323152,158164,164988
Kentucky,Fayette County,12,1,19113,9808,9305
Kentucky,Fayette County,12,2,18596,9540,9056
Kentucky,Fayette County,12,3,18684,9524,9160
Kentucky,Fayette County,12,4,22364,11072,11292
Kentucky,Fayette County,12,5,33212,16327,16885
Kentucky,Fayette County,12,6,26773,13656,13117
Kentucky,Fayette County,12,7,22684,11539,11145
Kentucky,Fayette County,12,8,22163,11070,11093
Kentucky,Fayette County,12,9,20216,10187,10029
Kentucky,Fayette County,12,10,19137,9500,9637
Kentucky,Fayette County,12,11,18170,9101,9069
Kentucky,Fayette County,12,12,19149,9198,9951
Kentucky,Fayette County,12,13,18071,8302,9769
Kentucky,Fayette County,12,14,15377,7069,8308
Kentucky,Fayette County,12,15,11670,5246,6424
Kentucky,Fayette County,12,16,7775,3306,4469
Kentucky,Fayette County,12,17,4858,1972,2886
Kentucky,Fayette County,12,18,5140,1747,3393
Kentucky,Fleming County,1,0,14348,7041,7307
Kentucky,Fleming County,1,1,914,462,452
Kentucky,Fleming County,1,2,921,448,473
Kentucky,Fleming County,1,3,1030,527,503
Kentucky,Fleming County,1,4,978,509,469
Kentucky,Fleming County,1,5,760,375,385
Kentucky,Fleming County,1,6,745,375,370
Kentucky,Fleming County,1,7,863,423,440
Kentucky,Fleming County,1,8,938,477,461
Kentucky,Fleming County,1,9,1047,499,548
Kentucky,Fleming County,1,10,1068,530,538
Kentucky,Fleming County,1,11,1050,540,510
Kentucky,Fleming County,1,12,996,488,508
Kentucky,Fleming County,1,13,920,437,483
Kentucky,Fleming County,1,14,707,345,362
Kentucky,Fleming County,1,15,533,267,266
Kentucky,Fleming County,1,16,383,158,225
Kentucky,Fleming County,1,17,282,109,173
Kentucky,Fleming County,1,18,213,72,141
Kentucky,Fleming County,2,0,14346,7040,7306
Kentucky,Fleming County,2,1,914,462,452
Kentucky,Fleming County,2,2,921,448,473
Kentucky,Fleming County,2,3,1030,527,503
Kentucky,Fleming County,2,4,978,509,469
Kentucky,Fleming County,2,5,760,374,386
Kentucky,Fleming County,2,6,746,376,370
Kentucky,Fleming County,2,7,863,423,440
Kentucky,Fleming County,2,8,938,477,461
Kentucky,Fleming County,2,9,1047,499,548
Kentucky,Fleming County,2,10,1068,530,538
Kentucky,Fleming County,2,11,1050,540,510
Kentucky,Fleming County,2,12,996,488,508
Kentucky,Fleming County,2,13,920,437,483
Kentucky,Fleming County,2,14,706,345,361
Kentucky,Fleming County,2,15,533,267,266
Kentucky,Fleming County,2,16,383,158,225
Kentucky,Fleming County,2,17,281,108,173
Kentucky,Fleming County,2,18,212,72,140
Kentucky,Fleming County,3,0,14400,7064,7336
Kentucky,Fleming County,3,1,918,467,451
Kentucky,Fleming County,3,2,926,447,479
Kentucky,Fleming County,3,3,1031,525,506
Kentucky,Fleming County,3,4,970,505,465
Kentucky,Fleming County,3,5,768,379,389
Kentucky,Fleming County,3,6,757,378,379
Kentucky,Fleming County,3,7,859,425,434
Kentucky,Fleming County,3,8,944,479,465
Kentucky,Fleming County,3,9,1040,498,542
Kentucky,Fleming County,3,10,1077,535,542
Kentucky,Fleming County,3,11,1040,531,509
Kentucky,Fleming County,3,12,1010,495,515
Kentucky,Fleming County,3,13,924,438,486
Kentucky,Fleming County,3,14,714,347,367
Kentucky,Fleming County,3,15,535,270,265
Kentucky,Fleming County,3,16,388,161,227
Kentucky,Fleming County,3,17,286,109,177
Kentucky,Fleming County,3,18,213,75,138
Kentucky,Fleming County,4,0,14483,7084,7399
Kentucky,Fleming County,4,1,943,493,450
Kentucky,Fleming County,4,2,944,444,500
Kentucky,Fleming County,4,3,1014,504,510
Kentucky,Fleming County,4,4,960,490,470
Kentucky,Fleming County,4,5,778,389,389
Kentucky,Fleming County,4,6,797,380,417
Kentucky,Fleming County,4,7,856,437,419
Kentucky,Fleming County,4,8,930,469,461
Kentucky,Fleming County,4,9,1010,498,512
Kentucky,Fleming County,4,10,1085,540,545
Kentucky,Fleming County,4,11,1015,510,505
Kentucky,Fleming County,4,12,1025,508,517
Kentucky,Fleming County,4,13,957,459,498
Kentucky,Fleming County,4,14,734,349,385
Kentucky,Fleming County,4,15,548,271,277
Kentucky,Fleming County,4,16,399,170,229
Kentucky,Fleming County,4,17,279,101,178
Kentucky,Fleming County,4,18,209,72,137
Kentucky,Fleming County,5,0,14525,7135,7390
Kentucky,Fleming County,5,1,944,512,432
Kentucky,Fleming County,5,2,943,443,500
Kentucky,Fleming County,5,3,1029,515,514
Kentucky,Fleming County,5,4,940,487,453
Kentucky,Fleming County,5,5,785,397,388
Kentucky,Fleming County,5,6,760,357,403
Kentucky,Fleming County,5,7,871,449,422
Kentucky,Fleming County,5,8,910,453,457
Kentucky,Fleming County,5,9,1031,501,530
Kentucky,Fleming County,5,10,1068,535,533
Kentucky,Fleming County,5,11,1032,506,526
Kentucky,Fleming County,5,12,1021,519,502
Kentucky,Fleming County,5,13,946,460,486
Kentucky,Fleming County,5,14,803,376,427
Kentucky,Fleming County,5,15,547,267,280
Kentucky,Fleming County,5,16,400,183,217
Kentucky,Fleming County,5,17,283,100,183
Kentucky,Fleming County,5,18,212,75,137
Kentucky,Fleming County,6,0,14536,7137,7399
Kentucky,Fleming County,6,1,975,518,457
Kentucky,Fleming County,6,2,918,443,475
Kentucky,Fleming County,6,3,1033,519,514
Kentucky,Fleming County,6,4,916,466,450
Kentucky,Fleming County,6,5,855,427,428
Kentucky,Fleming County,6,6,755,375,380
Kentucky,Fleming County,6,7,839,409,430
Kentucky,Fleming County,6,8,910,459,451
Kentucky,Fleming County,6,9,989,481,508
Kentucky,Fleming County,6,10,1066,533,533
Kentucky,Fleming County,6,11,1014,500,514
Kentucky,Fleming County,6,12,1021,497,524
Kentucky,Fleming County,6,13,939,468,471
Kentucky,Fleming County,6,14,832,394,438
Kentucky,Fleming County,6,15,570,283,287
Kentucky,Fleming County,6,16,399,190,209
Kentucky,Fleming County,6,17,281,93,188
Kentucky,Fleming County,6,18,224,82,142
Kentucky,Fleming County,7,0,14476,7119,7357
Kentucky,Fleming County,7,1,970,512,458
Kentucky,Fleming County,7,2,927,477,450
Kentucky,Fleming County,7,3,1041,527,514
Kentucky,Fleming County,7,4,898,455,443
Kentucky,Fleming County,7,5,828,408,420
Kentucky,Fleming County,7,6,782,371,411
Kentucky,Fleming County,7,7,813,387,426
Kentucky,Fleming County,7,8,890,453,437
Kentucky,Fleming County,7,9,927,457,470
Kentucky,Fleming County,7,10,1047,526,521
Kentucky,Fleming County,7,11,1022,506,516
Kentucky,Fleming County,7,12,1035,517,518
Kentucky,Fleming County,7,13,943,471,472
Kentucky,Fleming County,7,14,850,391,459
Kentucky,Fleming County,7,15,616,292,324
Kentucky,Fleming County,7,16,402,197,205
Kentucky,Fleming County,7,17,266,96,170
Kentucky,Fleming County,7,18,219,76,143
Kentucky,Fleming County,8,0,14578,7148,7430
Kentucky,Fleming County,8,1,987,492,495
Kentucky,Fleming County,8,2,977,517,460
Kentucky,Fleming County,8,3,1006,496,510
Kentucky,Fleming County,8,4,932,461,471
Kentucky,Fleming County,8,5,840,431,409
Kentucky,Fleming County,8,6,786,371,415
Kentucky,Fleming County,8,7,816,393,423
Kentucky,Fleming County,8,8,868,441,427
Kentucky,Fleming County,8,9,940,470,470
Kentucky,Fleming County,8,10,986,483,503
Kentucky,Fleming County,8,11,1042,518,524
Kentucky,Fleming County,8,12,1018,519,499
Kentucky,Fleming County,8,13,969,465,504
Kentucky,Fleming County,8,14,853,397,456
Kentucky,Fleming County,8,15,654,311,343
Kentucky,Fleming County,8,16,435,207,228
Kentucky,Fleming County,8,17,250,96,154
Kentucky,Fleming County,8,18,219,80,139
Kentucky,Fleming County,9,0,14481,7120,7361
Kentucky,Fleming County,9,1,966,478,488
Kentucky,Fleming County,9,2,954,524,430
Kentucky,Fleming County,9,3,1009,497,512
Kentucky,Fleming County,9,4,927,471,456
Kentucky,Fleming County,9,5,819,420,399
Kentucky,Fleming County,9,6,789,371,418
Kentucky,Fleming County,9,7,786,383,403
Kentucky,Fleming County,9,8,847,433,414
Kentucky,Fleming County,9,9,923,448,475
Kentucky,Fleming County,9,10,962,471,491
Kentucky,Fleming County,9,11,1073,539,534
Kentucky,Fleming County,9,12,966,484,482
Kentucky,Fleming County,9,13,969,469,500
Kentucky,Fleming County,9,14,893,427,466
Kentucky,Fleming County,9,15,658,303,355
Kentucky,Fleming County,9,16,450,212,238
Kentucky,Fleming County,9,17,274,109,165
Kentucky,Fleming County,9,18,216,81,135
Kentucky,Fleming County,10,0,14439,7064,7375
Kentucky,Fleming County,10,1,977,481,496
Kentucky,Fleming County,10,2,929,503,426
Kentucky,Fleming County,10,3,983,482,501
Kentucky,Fleming County,10,4,945,479,466
Kentucky,Fleming County,10,5,824,407,417
Kentucky,Fleming County,10,6,805,385,420
Kentucky,Fleming County,10,7,761,380,381
Kentucky,Fleming County,10,8,835,422,413
Kentucky,Fleming County,10,9,906,432,474
Kentucky,Fleming County,10,10,987,475,512
Kentucky,Fleming County,10,11,1014,515,499
Kentucky,Fleming County,10,12,966,464,502
Kentucky,Fleming County,10,13,980,486,494
Kentucky,Fleming County,10,14,852,413,439
Kentucky,Fleming County,10,15,715,326,389
Kentucky,Fleming County,10,16,446,212,234
Kentucky,Fleming County,10,17,276,117,159
Kentucky,Fleming County,10,18,238,85,153
Kentucky,Fleming County,11,0,14485,7113,7372
Kentucky,Fleming County,11,1,956,467,489
Kentucky,Fleming County,11,2,970,519,451
Kentucky,Fleming County,11,3,982,495,487
Kentucky,Fleming County,11,4,944,472,472
Kentucky,Fleming County,11,5,773,391,382
Kentucky,Fleming County,11,6,846,427,419
Kentucky,Fleming County,11,7,781,395,386
Kentucky,Fleming County,11,8,828,401,427
Kentucky,Fleming County,11,9,896,433,463
Kentucky,Fleming County,11,10,967,461,506
Kentucky,Fleming County,11,11,1028,524,504
Kentucky,Fleming County,11,12,963,486,477
Kentucky,Fleming County,11,13,976,455,521
Kentucky,Fleming County,11,14,837,418,419
Kentucky,Fleming County,11,15,721,329,392
Kentucky,Fleming County,11,16,479,227,252
Kentucky,Fleming County,11,17,291,124,167
Kentucky,Fleming County,11,18,247,89,158
Kentucky,Fleming County,12,0,14581,7137,7444
Kentucky,Fleming County,12,1,952,472,480
Kentucky,Fleming County,12,2,954,485,469
Kentucky,Fleming County,12,3,997,516,481
Kentucky,Fleming County,12,4,979,494,485
Kentucky,Fleming County,12,5,784,397,387
Kentucky,Fleming County,12,6,857,431,426
Kentucky,Fleming County,12,7,789,378,411
Kentucky,Fleming County,12,8,810,382,428
Kentucky,Fleming County,12,9,894,441,453
Kentucky,Fleming County,12,10,942,447,495
Kentucky,Fleming County,12,11,1024,524,500
Kentucky,Fleming County,12,12,981,482,499
Kentucky,Fleming County,12,13,994,490,504
Kentucky,Fleming County,12,14,832,408,424
Kentucky,Fleming County,12,15,718,325,393
Kentucky,Fleming County,12,16,533,247,286
Kentucky,Fleming County,12,17,292,128,164
Kentucky,Fleming County,12,18,249,90,159
Kentucky,Floyd County,1,0,39451,19295,20156
Kentucky,Floyd County,1,1,2465,1243,1222
Kentucky,Floyd County,1,2,2410,1306,1104
Kentucky,Floyd County,1,3,2430,1289,1141
Kentucky,Floyd County,1,4,2622,1382,1240
Kentucky,Floyd County,1,5,2267,1118,1149
Kentucky,Floyd County,1,6,2385,1178,1207
Kentucky,Floyd County,1,7,2599,1257,1342
Kentucky,Floyd County,1,8,2627,1282,1345
Kentucky,Floyd County,1,9,2678,1313,1365
Kentucky,Floyd County,1,10,2945,1373,1572
Kentucky,Floyd County,1,11,3128,1513,1615
Kentucky,Floyd County,1,12,2960,1462,1498
Kentucky,Floyd County,1,13,2584,1239,1345
Kentucky,Floyd County,1,14,1791,834,957
Kentucky,Floyd County,1,15,1398,661,737
Kentucky,Floyd County,1,16,947,418,529
Kentucky,Floyd County,1,17,669,260,409
Kentucky,Floyd County,1,18,546,167,379
Kentucky,Floyd County,2,0,39450,19295,20155
Kentucky,Floyd County,2,1,2465,1243,1222
Kentucky,Floyd County,2,2,2410,1306,1104
Kentucky,Floyd County,2,3,2430,1289,1141
Kentucky,Floyd County,2,4,2622,1382,1240
Kentucky,Floyd County,2,5,2267,1118,1149
Kentucky,Floyd County,2,6,2385,1178,1207
Kentucky,Floyd County,2,7,2599,1257,1342
Kentucky,Floyd County,2,8,2627,1282,1345
Kentucky,Floyd County,2,9,2678,1313,1365
Kentucky,Floyd County,2,10,2945,1373,1572
Kentucky,Floyd County,2,11,3128,1513,1615
Kentucky,Floyd County,2,12,2959,1462,1497
Kentucky,Floyd County,2,13,2584,1239,1345
Kentucky,Floyd County,2,14,1791,834,957
Kentucky,Floyd County,2,15,1398,661,737
Kentucky,Floyd County,2,16,947,418,529
Kentucky,Floyd County,2,17,669,260,409
Kentucky,Floyd County,2,18,546,167,379
Kentucky,Floyd County,3,0,39930,19474,20456
Kentucky,Floyd County,3,1,2464,1245,1219
Kentucky,Floyd County,3,2,2420,1303,1117
Kentucky,Floyd County,3,3,2416,1282,1134
Kentucky,Floyd County,3,4,2641,1404,1237
Kentucky,Floyd County,3,5,2379,1190,1189
Kentucky,Floyd County,3,6,2462,1197,1265
Kentucky,Floyd County,3,7,2693,1299,1394
Kentucky,Floyd County,3,8,2670,1293,1377
Kentucky,Floyd County,3,9,2730,1319,1411
Kentucky,Floyd County,3,10,2991,1393,1598
Kentucky,Floyd County,3,11,3120,1500,1620
Kentucky,Floyd County,3,12,2969,1458,1511
Kentucky,Floyd County,3,13,2617,1256,1361
Kentucky,Floyd County,3,14,1800,835,965
Kentucky,Floyd County,3,15,1396,658,738
Kentucky,Floyd County,3,16,947,416,531
Kentucky,Floyd County,3,17,672,262,410
Kentucky,Floyd County,3,18,543,164,379
Kentucky,Floyd County,4,0,39752,19424,20328
Kentucky,Floyd County,4,1,2476,1258,1218
Kentucky,Floyd County,4,2,2391,1281,1110
Kentucky,Floyd County,4,3,2373,1267,1106
Kentucky,Floyd County,4,4,2497,1365,1132
Kentucky,Floyd County,4,5,2470,1261,1209
Kentucky,Floyd County,4,6,2395,1138,1257
Kentucky,Floyd County,4,7,2660,1283,1377
Kentucky,Floyd County,4,8,2639,1289,1350
Kentucky,Floyd County,4,9,2694,1295,1399
Kentucky,Floyd County,4,10,2932,1394,1538
Kentucky,Floyd County,4,11,3054,1444,1610
Kentucky,Floyd County,4,12,2973,1438,1535
Kentucky,Floyd County,4,13,2767,1354,1413
Kentucky,Floyd County,4,14,1831,845,986
Kentucky,Floyd County,4,15,1420,654,766
Kentucky,Floyd County,4,16,961,427,534
Kentucky,Floyd County,4,17,681,270,411
Kentucky,Floyd County,4,18,538,161,377
Kentucky,Floyd County,5,0,39126,19148,19978
Kentucky,Floyd County,5,1,2444,1271,1173
Kentucky,Floyd County,5,2,2408,1274,1134
Kentucky,Floyd County,5,3,2338,1229,1109
Kentucky,Floyd County,5,4,2387,1326,1061
Kentucky,Floyd County,5,5,2423,1234,1189
Kentucky,Floyd County,5,6,2347,1119,1228
Kentucky,Floyd County,5,7,2571,1249,1322
Kentucky,Floyd County,5,8,2538,1237,1301
Kentucky,Floyd County,5,9,2642,1272,1370
Kentucky,Floyd County,5,10,2755,1331,1424
Kentucky,Floyd County,5,11,2962,1388,1574
Kentucky,Floyd County,5,12,2942,1414,1528
Kentucky,Floyd County,5,13,2751,1359,1392
Kentucky,Floyd County,5,14,1972,901,1071
Kentucky,Floyd County,5,15,1441,653,788
Kentucky,Floyd County,5,16,975,448,527
Kentucky,Floyd County,5,17,686,270,416
Kentucky,Floyd County,5,18,544,173,371
Kentucky,Floyd County,6,0,38474,18818,19656
Kentucky,Floyd County,6,1,2500,1267,1233
Kentucky,Floyd County,6,2,2369,1251,1118
Kentucky,Floyd County,6,3,2247,1191,1056
Kentucky,Floyd County,6,4,2302,1263,1039
Kentucky,Floyd County,6,5,2413,1230,1183
Kentucky,Floyd County,6,6,2264,1090,1174
Kentucky,Floyd County,6,7,2469,1228,1241
Kentucky,Floyd County,6,8,2438,1194,1244
Kentucky,Floyd County,6,9,2555,1253,1302
Kentucky,Floyd County,6,10,2668,1290,1378
Kentucky,Floyd County,6,11,2821,1323,1498
Kentucky,Floyd County,6,12,2955,1425,1530
Kentucky,Floyd County,6,13,2690,1296,1394
Kentucky,Floyd County,6,14,2066,947,1119
Kentucky,Floyd County,6,15,1461,663,798
Kentucky,Floyd County,6,16,1036,468,568
Kentucky,Floyd County,6,17,668,259,409
Kentucky,Floyd County,6,18,552,180,372
Kentucky,Floyd County,7,0,37998,18586,19412
Kentucky,Floyd County,7,1,2424,1280,1144
Kentucky,Floyd County,7,2,2326,1197,1129
Kentucky,Floyd County,7,3,2219,1191,1028
Kentucky,Floyd County,7,4,2254,1232,1022
Kentucky,Floyd County,7,5,2402,1236,1166
Kentucky,Floyd County,7,6,2194,1049,1145
Kentucky,Floyd County,7,7,2332,1157,1175
Kentucky,Floyd County,7,8,2436,1196,1240
Kentucky,Floyd County,7,9,2535,1226,1309
Kentucky,Floyd County,7,10,2581,1278,1303
Kentucky,Floyd County,7,11,2745,1273,1472
Kentucky,Floyd County,7,12,2919,1366,1553
Kentucky,Floyd County,7,13,2665,1301,1364
Kentucky,Floyd County,7,14,2156,985,1171
Kentucky,Floyd County,7,15,1506,675,831
Kentucky,Floyd County,7,16,1077,492,585
Kentucky,Floyd County,7,17,657,256,401
Kentucky,Floyd County,7,18,570,196,374
Kentucky,Floyd County,8,0,37531,18366,19165
Kentucky,Floyd County,8,1,2344,1248,1096
Kentucky,Floyd County,8,2,2279,1177,1102
Kentucky,Floyd County,8,3,2251,1203,1048
Kentucky,Floyd County,8,4,2188,1197,991
Kentucky,Floyd County,8,5,2249,1183,1066
Kentucky,Floyd County,8,6,2234,1056,1178
Kentucky,Floyd County,8,7,2226,1088,1138
Kentucky,Floyd County,8,8,2423,1212,1211
Kentucky,Floyd County,8,9,2455,1201,1254
Kentucky,Floyd County,8,10,2463,1196,1267
Kentucky,Floyd County,8,11,2740,1274,1466
Kentucky,Floyd County,8,12,2849,1334,1515
Kentucky,Floyd County,8,13,2700,1307,1393
Kentucky,Floyd County,8,14,2268,1065,1203
Kentucky,Floyd County,8,15,1517,676,841
Kentucky,Floyd County,8,16,1117,500,617
Kentucky,Floyd County,8,17,643,258,385
Kentucky,Floyd County,8,18,585,191,394
Kentucky,Floyd County,9,0,36968,18094,18874
Kentucky,Floyd County,9,1,2298,1231,1067
Kentucky,Floyd County,9,2,2189,1120,1069
Kentucky,Floyd County,9,3,2269,1206,1063
Kentucky,Floyd County,9,4,2130,1172,958
Kentucky,Floyd County,9,5,2135,1115,1020
Kentucky,Floyd County,9,6,2251,1080,1171
Kentucky,Floyd County,9,7,2138,1047,1091
Kentucky,Floyd County,9,8,2357,1170,1187
Kentucky,Floyd County,9,9,2378,1174,1204
Kentucky,Floyd County,9,10,2439,1176,1263
Kentucky,Floyd County,9,11,2662,1268,1394
Kentucky,Floyd County,9,12,2763,1277,1486
Kentucky,Floyd County,9,13,2664,1276,1388
Kentucky,Floyd County,9,14,2392,1150,1242
Kentucky,Floyd County,9,15,1532,685,847
Kentucky,Floyd County,9,16,1137,493,644
Kentucky,Floyd County,9,17,661,270,391
Kentucky,Floyd County,9,18,573,184,389
Kentucky,Floyd County,10,0,36296,17737,18559
Kentucky,Floyd County,10,1,2255,1174,1081
Kentucky,Floyd County,10,2,2167,1144,1023
Kentucky,Floyd County,10,3,2277,1200,1077
Kentucky,Floyd County,10,4,2064,1139,925
Kentucky,Floyd County,10,5,2005,1061,944
Kentucky,Floyd County,10,6,2214,1042,1172
Kentucky,Floyd County,10,7,2068,1014,1054
Kentucky,Floyd County,10,8,2249,1123,1126
Kentucky,Floyd County,10,9,2322,1125,1197
Kentucky,Floyd County,10,10,2410,1157,1253
Kentucky,Floyd County,10,11,2499,1203,1296
Kentucky,Floyd County,10,12,2676,1248,1428
Kentucky,Floyd County,10,13,2605,1217,1388
Kentucky,Floyd County,10,14,2412,1183,1229
Kentucky,Floyd County,10,15,1650,724,926
Kentucky,Floyd County,10,16,1162,499,663
Kentucky,Floyd County,10,17,697,303,394
Kentucky,Floyd County,10,18,564,181,383
Kentucky,Floyd County,11,0,35896,17576,18320
Kentucky,Floyd County,11,1,2158,1146,1012
Kentucky,Floyd County,11,2,2200,1153,1047
Kentucky,Floyd County,11,3,2241,1183,1058
Kentucky,Floyd County,11,4,2065,1162,903
Kentucky,Floyd County,11,5,1898,1029,869
Kentucky,Floyd County,11,6,2206,1047,1159
Kentucky,Floyd County,11,7,2026,985,1041
Kentucky,Floyd County,11,8,2209,1095,1114
Kentucky,Floyd County,11,9,2264,1123,1141
Kentucky,Floyd County,11,10,2380,1144,1236
Kentucky,Floyd County,11,11,2447,1172,1275
Kentucky,Floyd County,11,12,2560,1180,1380
Kentucky,Floyd County,11,13,2638,1245,1393
Kentucky,Floyd County,11,14,2380,1140,1240
Kentucky,Floyd County,11,15,1745,775,970
Kentucky,Floyd County,11,16,1194,507,687
Kentucky,Floyd County,11,17,718,309,409
Kentucky,Floyd County,11,18,567,181,386
Kentucky,Floyd County,12,0,35589,17362,18227
Kentucky,Floyd County,12,1,2093,1091,1002
Kentucky,Floyd County,12,2,2167,1161,1006
Kentucky,Floyd County,12,3,2224,1135,1089
Kentucky,Floyd County,12,4,2087,1164,923
Kentucky,Floyd County,12,5,1897,1024,873
Kentucky,Floyd County,12,6,2171,1044,1127
Kentucky,Floyd County,12,7,1945,952,993
Kentucky,Floyd County,12,8,2152,1061,1091
Kentucky,Floyd County,12,9,2274,1118,1156
Kentucky,Floyd County,12,10,2362,1136,1226
Kentucky,Floyd County,12,11,2375,1156,1219
Kentucky,Floyd County,12,12,2507,1151,1356
Kentucky,Floyd County,12,13,2629,1201,1428
Kentucky,Floyd County,12,14,2355,1121,1234
Kentucky,Floyd County,12,15,1806,815,991
Kentucky,Floyd County,12,16,1233,521,712
Kentucky,Floyd County,12,17,726,316,410
Kentucky,Floyd County,12,18,586,195,391
Kentucky,Franklin County,1,0,49285,23876,25409
Kentucky,Franklin County,1,1,2983,1535,1448
Kentucky,Franklin County,1,2,3016,1505,1511
Kentucky,Franklin County,1,3,2912,1492,1420
Kentucky,Franklin County,1,4,3347,1699,1648
Kentucky,Franklin County,1,5,3173,1598,1575
Kentucky,Franklin County,1,6,3138,1561,1577
Kentucky,Franklin County,1,7,3024,1474,1550
Kentucky,Franklin County,1,8,3221,1574,1647
Kentucky,Franklin County,1,9,3301,1717,1584
Kentucky,Franklin County,1,10,3731,1804,1927
Kentucky,Franklin County,1,11,3757,1797,1960
Kentucky,Franklin County,1,12,3648,1757,1891
Kentucky,Franklin County,1,13,3152,1469,1683
Kentucky,Franklin County,1,14,2230,1018,1212
Kentucky,Franklin County,1,15,1647,726,921
Kentucky,Franklin County,1,16,1235,544,691
Kentucky,Franklin County,1,17,918,346,572
Kentucky,Franklin County,1,18,852,260,592
Kentucky,Franklin County,2,0,49268,23867,25401
Kentucky,Franklin County,2,1,2983,1535,1448
Kentucky,Franklin County,2,2,3016,1505,1511
Kentucky,Franklin County,2,3,2911,1492,1419
Kentucky,Franklin County,2,4,3345,1698,1647
Kentucky,Franklin County,2,5,3172,1597,1575
Kentucky,Franklin County,2,6,3138,1561,1577
Kentucky,Franklin County,2,7,3024,1474,1550
Kentucky,Franklin County,2,8,3220,1574,1646
Kentucky,Franklin County,2,9,3301,1717,1584
Kentucky,Franklin County,2,10,3728,1802,1926
Kentucky,Franklin County,2,11,3756,1796,1960
Kentucky,Franklin County,2,12,3644,1755,1889
Kentucky,Franklin County,2,13,3149,1468,1681
Kentucky,Franklin County,2,14,2228,1016,1212
Kentucky,Franklin County,2,15,1648,727,921
Kentucky,Franklin County,2,16,1235,544,691
Kentucky,Franklin County,2,17,918,346,572
Kentucky,Franklin County,2,18,852,260,592
Kentucky,Franklin County,3,0,49253,23846,25407
Kentucky,Franklin County,3,1,2975,1532,1443
Kentucky,Franklin County,3,2,3011,1505,1506
Kentucky,Franklin County,3,3,2910,1491,1419
Kentucky,Franklin County,3,4,3356,1704,1652
Kentucky,Franklin County,3,5,3176,1595,1581
Kentucky,Franklin County,3,6,3114,1547,1567
Kentucky,Franklin County,3,7,3034,1480,1554
Kentucky,Franklin County,3,8,3199,1561,1638
Kentucky,Franklin County,3,9,3317,1720,1597
Kentucky,Franklin County,3,10,3708,1787,1921
Kentucky,Franklin County,3,11,3745,1797,1948
Kentucky,Franklin County,3,12,3641,1751,1890
Kentucky,Franklin County,3,13,3188,1487,1701
Kentucky,Franklin County,3,14,2219,1009,1210
Kentucky,Franklin County,3,15,1664,731,933
Kentucky,Franklin County,3,16,1234,543,691
Kentucky,Franklin County,3,17,912,347,565
Kentucky,Franklin County,3,18,850,259,591
Kentucky,Franklin County,4,0,49313,23939,25374
Kentucky,Franklin County,4,1,2906,1519,1387
Kentucky,Franklin County,4,2,2958,1497,1461
Kentucky,Franklin County,4,3,2906,1502,1404
Kentucky,Franklin County,4,4,3303,1677,1626
Kentucky,Franklin County,4,5,3252,1598,1654
Kentucky,Franklin County,4,6,3062,1546,1516
Kentucky,Franklin County,4,7,3059,1504,1555
Kentucky,Franklin County,4,8,3087,1487,1600
Kentucky,Franklin County,4,9,3371,1742,1629
Kentucky,Franklin County,4,10,3661,1769,1892
Kentucky,Franklin County,4,11,3738,1809,1929
Kentucky,Franklin County,4,12,3636,1735,1901
Kentucky,Franklin County,4,13,3365,1602,1763
Kentucky,Franklin County,4,14,2251,1020,1231
Kentucky,Franklin County,4,15,1731,763,968
Kentucky,Franklin County,4,16,1250,549,701
Kentucky,Franklin County,4,17,904,352,552
Kentucky,Franklin County,4,18,873,268,605
Kentucky,Franklin County,5,0,49453,23849,25604
Kentucky,Franklin County,5,1,2791,1417,1374
Kentucky,Franklin County,5,2,3045,1561,1484
Kentucky,Franklin County,5,3,2927,1472,1455
Kentucky,Franklin County,5,4,3315,1680,1635
Kentucky,Franklin County,5,5,3337,1629,1708
Kentucky,Franklin County,5,6,2978,1499,1479
Kentucky,Franklin County,5,7,3113,1531,1582
Kentucky,Franklin County,5,8,2990,1425,1565
Kentucky,Franklin County,5,9,3354,1695,1659
Kentucky,Franklin County,5,10,3606,1743,1863
Kentucky,Franklin County,5,11,3660,1769,1891
Kentucky,Franklin County,5,12,3653,1705,1948
Kentucky,Franklin County,5,13,3335,1599,1736
Kentucky,Franklin County,5,14,2492,1135,1357
Kentucky,Franklin County,5,15,1778,802,976
Kentucky,Franklin County,5,16,1265,541,724
Kentucky,Franklin County,5,17,893,366,527
Kentucky,Franklin County,5,18,921,280,641
Kentucky,Franklin County,6,0,49478,23877,25601
Kentucky,Franklin County,6,1,2810,1444,1366
Kentucky,Franklin County,6,2,3028,1562,1466
Kentucky,Franklin County,6,3,2945,1468,1477
Kentucky,Franklin County,6,4,3192,1609,1583
Kentucky,Franklin County,6,5,3390,1666,1724
Kentucky,Franklin County,6,6,2963,1482,1481
Kentucky,Franklin County,6,7,3088,1515,1573
Kentucky,Franklin County,6,8,2957,1420,1537
Kentucky,Franklin County,6,9,3386,1674,1712
Kentucky,Franklin County,6,10,3449,1700,1749
Kentucky,Franklin County,6,11,3659,1743,1916
Kentucky,Franklin County,6,12,3614,1690,1924
Kentucky,Franklin County,6,13,3378,1630,1748
Kentucky,Franklin County,6,14,2631,1198,1433
Kentucky,Franklin County,6,15,1851,842,1009
Kentucky,Franklin County,6,16,1288,552,736
Kentucky,Franklin County,6,17,922,393,529
Kentucky,Franklin County,6,18,927,289,638
Kentucky,Franklin County,7,0,49725,23957,25768
Kentucky,Franklin County,7,1,2853,1433,1420
Kentucky,Franklin County,7,2,3028,1569,1459
Kentucky,Franklin County,7,3,2911,1464,1447
Kentucky,Franklin County,7,4,3214,1613,1601
Kentucky,Franklin County,7,5,3449,1702,1747
Kentucky,Franklin County,7,6,3001,1479,1522
Kentucky,Franklin County,7,7,3123,1535,1588
Kentucky,Franklin County,7,8,2876,1396,1480
Kentucky,Franklin County,7,9,3355,1624,1731
Kentucky,Franklin County,7,10,3327,1688,1639
Kentucky,Franklin County,7,11,3641,1727,1914
Kentucky,Franklin County,7,12,3622,1690,1932
Kentucky,Franklin County,7,13,3419,1620,1799
Kentucky,Franklin County,7,14,2778,1289,1489
Kentucky,Franklin County,7,15,1901,856,1045
Kentucky,Franklin County,7,16,1329,573,756
Kentucky,Franklin County,7,17,943,401,542
Kentucky,Franklin County,7,18,955,298,657
Kentucky,Franklin County,8,0,50070,24167,25903
Kentucky,Franklin County,8,1,2873,1458,1415
Kentucky,Franklin County,8,2,2986,1550,1436
Kentucky,Franklin County,8,3,2935,1499,1436
Kentucky,Franklin County,8,4,3224,1616,1608
Kentucky,Franklin County,8,5,3408,1699,1709
Kentucky,Franklin County,8,6,3079,1504,1575
Kentucky,Franklin County,8,7,3134,1555,1579
Kentucky,Franklin County,8,8,2915,1397,1518
Kentucky,Franklin County,8,9,3253,1581,1672
Kentucky,Franklin County,8,10,3358,1714,1644
Kentucky,Franklin County,8,11,3661,1709,1952
Kentucky,Franklin County,8,12,3583,1676,1907
Kentucky,Franklin County,8,13,3454,1659,1795
Kentucky,Franklin County,8,14,2935,1364,1571
Kentucky,Franklin County,8,15,1970,872,1098
Kentucky,Franklin County,8,16,1408,622,786
Kentucky,Franklin County,8,17,948,386,562
Kentucky,Franklin County,8,18,946,306,640
Kentucky,Franklin County,9,0,50292,24260,26032
Kentucky,Franklin County,9,1,2887,1440,1447
Kentucky,Franklin County,9,2,2940,1541,1399
Kentucky,Franklin County,9,3,2968,1524,1444
Kentucky,Franklin County,9,4,3300,1642,1658
Kentucky,Franklin County,9,5,3292,1666,1626
Kentucky,Franklin County,9,6,3236,1591,1645
Kentucky,Franklin County,9,7,3068,1527,1541
Kentucky,Franklin County,9,8,3020,1466,1554
Kentucky,Franklin County,9,9,3142,1510,1632
Kentucky,Franklin County,9,10,3384,1728,1656
Kentucky,Franklin County,9,11,3625,1703,1922
Kentucky,Franklin County,9,12,3548,1666,1882
Kentucky,Franklin County,9,13,3439,1628,1811
Kentucky,Franklin County,9,14,3082,1421,1661
Kentucky,Franklin County,9,15,2031,894,1137
Kentucky,Franklin County,9,16,1445,633,812
Kentucky,Franklin County,9,17,952,380,572
Kentucky,Franklin County,9,18,933,300,633
Kentucky,Franklin County,10,0,50492,24331,26161
Kentucky,Franklin County,10,1,2943,1451,1492
Kentucky,Franklin County,10,2,2888,1477,1411
Kentucky,Franklin County,10,3,3025,1550,1475
Kentucky,Franklin County,10,4,3272,1633,1639
Kentucky,Franklin County,10,5,3170,1591,1579
Kentucky,Franklin County,10,6,3382,1698,1684
Kentucky,Franklin County,10,7,3008,1478,1530
Kentucky,Franklin County,10,8,3102,1529,1573
Kentucky,Franklin County,10,9,3044,1465,1579
Kentucky,Franklin County,10,10,3364,1698,1666
Kentucky,Franklin County,10,11,3579,1699,1880
Kentucky,Franklin County,10,12,3543,1683,1860
Kentucky,Franklin County,10,13,3428,1579,1849
Kentucky,Franklin County,10,14,3075,1439,1636
Kentucky,Franklin County,10,15,2237,975,1262
Kentucky,Franklin County,10,16,1492,667,825
Kentucky,Franklin County,10,17,987,399,588
Kentucky,Franklin County,10,18,953,320,633
Kentucky,Franklin County,11,0,50801,24578,26223
Kentucky,Franklin County,11,1,2944,1481,1463
Kentucky,Franklin County,11,2,2882,1471,1411
Kentucky,Franklin County,11,3,3065,1576,1489
Kentucky,Franklin County,11,4,3255,1608,1647
Kentucky,Franklin County,11,5,3146,1594,1552
Kentucky,Franklin County,11,6,3455,1729,1726
Kentucky,Franklin County,11,7,3078,1535,1543
Kentucky,Franklin County,11,8,3077,1529,1548
Kentucky,Franklin County,11,9,3052,1501,1551
Kentucky,Franklin County,11,10,3365,1661,1704
Kentucky,Franklin County,11,11,3439,1672,1767
Kentucky,Franklin County,11,12,3528,1655,1873
Kentucky,Franklin County,11,13,3425,1583,1842
Kentucky,Franklin County,11,14,3117,1463,1654
Kentucky,Franklin County,11,15,2386,1052,1334
Kentucky,Franklin County,11,16,1583,716,867
Kentucky,Franklin County,11,17,1025,417,608
Kentucky,Franklin County,11,18,979,335,644
Kentucky,Franklin County,12,0,50991,24651,26340
Kentucky,Franklin County,12,1,2928,1488,1440
Kentucky,Franklin County,12,2,2876,1453,1423
Kentucky,Franklin County,12,3,2990,1504,1486
Kentucky,Franklin County,12,4,3262,1615,1647
Kentucky,Franklin County,12,5,3065,1536,1529
Kentucky,Franklin County,12,6,3483,1774,1709
Kentucky,Franklin County,12,7,3040,1493,1547
Kentucky,Franklin County,12,8,3189,1572,1617
Kentucky,Franklin County,12,9,3035,1515,1520
Kentucky,Franklin County,12,10,3384,1666,1718
Kentucky,Franklin County,12,11,3378,1685,1693
Kentucky,Franklin County,12,12,3531,1638,1893
Kentucky,Franklin County,12,13,3449,1574,1875
Kentucky,Franklin County,12,14,3136,1459,1677
Kentucky,Franklin County,12,15,2556,1153,1403
Kentucky,Franklin County,12,16,1628,727,901
Kentucky,Franklin County,12,17,1056,439,617
Kentucky,Franklin County,12,18,1005,360,645
Kentucky,Fulton County,1,0,6813,3381,3432
Kentucky,Fulton County,1,1,399,205,194
Kentucky,Fulton County,1,2,364,192,172
Kentucky,Fulton County,1,3,369,189,180
Kentucky,Fulton County,1,4,384,210,174
Kentucky,Fulton County,1,5,431,245,186
Kentucky,Fulton County,1,6,436,226,210
Kentucky,Fulton County,1,7,407,226,181
Kentucky,Fulton County,1,8,380,228,152
Kentucky,Fulton County,1,9,446,219,227
Kentucky,Fulton County,1,10,469,219,250
Kentucky,Fulton County,1,11,541,271,270
Kentucky,Fulton County,1,12,507,258,249
Kentucky,Fulton County,1,13,457,197,260
Kentucky,Fulton County,1,14,365,166,199
Kentucky,Fulton County,1,15,273,113,160
Kentucky,Fulton County,1,16,227,103,124
Kentucky,Fulton County,1,17,180,65,115
Kentucky,Fulton County,1,18,178,49,129
Kentucky,Fulton County,2,0,6813,3381,3432
Kentucky,Fulton County,2,1,399,205,194
Kentucky,Fulton County,2,2,364,192,172
Kentucky,Fulton County,2,3,369,189,180
Kentucky,Fulton County,2,4,384,210,174
Kentucky,Fulton County,2,5,431,245,186
Kentucky,Fulton County,2,6,436,226,210
Kentucky,Fulton County,2,7,407,226,181
Kentucky,Fulton County,2,8,380,228,152
Kentucky,Fulton County,2,9,446,219,227
Kentucky,Fulton County,2,10,469,219,250
Kentucky,Fulton County,2,11,541,271,270
Kentucky,Fulton County,2,12,507,258,249
Kentucky,Fulton County,2,13,457,197,260
Kentucky,Fulton County,2,14,365,166,199
Kentucky,Fulton County,2,15,273,113,160
Kentucky,Fulton County,2,16,227,103,124
Kentucky,Fulton County,2,17,180,65,115
Kentucky,Fulton County,2,18,178,49,129
Kentucky,Fulton County,3,0,6807,3378,3429
Kentucky,Fulton County,3,1,398,203,195
Kentucky,Fulton County,3,2,361,189,172
Kentucky,Fulton County,3,3,369,186,183
Kentucky,Fulton County,3,4,385,212,173
Kentucky,Fulton County,3,5,435,244,191
Kentucky,Fulton County,3,6,438,231,207
Kentucky,Fulton County,3,7,407,222,185
Kentucky,Fulton County,3,8,379,225,154
Kentucky,Fulton County,3,9,447,221,226
Kentucky,Fulton County,3,10,473,222,251
Kentucky,Fulton County,3,11,533,267,266
Kentucky,Fulton County,3,12,513,261,252
Kentucky,Fulton County,3,13,447,195,252
Kentucky,Fulton County,3,14,372,168,204
Kentucky,Fulton County,3,15,275,116,159
Kentucky,Fulton County,3,16,222,102,120
Kentucky,Fulton County,3,17,176,64,112
Kentucky,Fulton County,3,18,177,50,127
Kentucky,Fulton County,4,0,6747,3359,3388
Kentucky,Fulton County,4,1,423,214,209
Kentucky,Fulton County,4,2,351,181,170
Kentucky,Fulton County,4,3,388,190,198
Kentucky,Fulton County,4,4,365,202,163
Kentucky,Fulton County,4,5,432,242,190
Kentucky,Fulton County,4,6,412,237,175
Kentucky,Fulton County,4,7,414,220,194
Kentucky,Fulton County,4,8,359,205,154
Kentucky,Fulton County,4,9,430,220,210
Kentucky,Fulton County,4,10,456,219,237
Kentucky,Fulton County,4,11,496,236,260
Kentucky,Fulton County,4,12,548,288,260
Kentucky,Fulton County,4,13,436,201,235
Kentucky,Fulton County,4,14,387,171,216
Kentucky,Fulton County,4,15,272,119,153
Kentucky,Fulton County,4,16,233,103,130
Kentucky,Fulton County,4,17,170,58,112
Kentucky,Fulton County,4,18,175,53,122
Kentucky,Fulton County,5,0,6564,3290,3274
Kentucky,Fulton County,5,1,420,222,198
Kentucky,Fulton County,5,2,340,181,159
Kentucky,Fulton County,5,3,371,183,188
Kentucky,Fulton County,5,4,349,194,155
Kentucky,Fulton County,5,5,401,224,177
Kentucky,Fulton County,5,6,409,236,173
Kentucky,Fulton County,5,7,420,227,193
Kentucky,Fulton County,5,8,342,188,154
Kentucky,Fulton County,5,9,389,203,186
Kentucky,Fulton County,5,10,450,219,231
Kentucky,Fulton County,5,11,459,206,253
Kentucky,Fulton County,5,12,541,282,259
Kentucky,Fulton County,5,13,426,203,223
Kentucky,Fulton County,5,14,407,185,222
Kentucky,Fulton County,5,15,279,121,158
Kentucky,Fulton County,5,16,235,104,131
Kentucky,Fulton County,5,17,157,60,97
Kentucky,Fulton County,5,18,169,52,117
Kentucky,Fulton County,6,0,6389,3183,3206
Kentucky,Fulton County,6,1,380,206,174
Kentucky,Fulton County,6,2,350,187,163
Kentucky,Fulton County,6,3,374,185,189
Kentucky,Fulton County,6,4,337,174,163
Kentucky,Fulton County,6,5,416,240,176
Kentucky,Fulton County,6,6,391,212,179
Kentucky,Fulton County,6,7,418,226,192
Kentucky,Fulton County,6,8,321,175,146
Kentucky,Fulton County,6,9,366,193,173
Kentucky,Fulton County,6,10,434,211,223
Kentucky,Fulton County,6,11,444,199,245
Kentucky,Fulton County,6,12,503,268,235
Kentucky,Fulton County,6,13,439,207,232
Kentucky,Fulton County,6,14,391,165,226
Kentucky,Fulton County,6,15,273,123,150
Kentucky,Fulton County,6,16,232,94,138
Kentucky,Fulton County,6,17,164,72,92
Kentucky,Fulton County,6,18,156,46,110
Kentucky,Fulton County,7,0,6266,3092,3174
Kentucky,Fulton County,7,1,376,193,183
Kentucky,Fulton County,7,2,366,194,172
Kentucky,Fulton County,7,3,352,178,174
Kentucky,Fulton County,7,4,324,170,154
Kentucky,Fulton County,7,5,401,226,175
Kentucky,Fulton County,7,6,399,213,186
Kentucky,Fulton County,7,7,416,226,190
Kentucky,Fulton County,7,8,318,165,153
Kentucky,Fulton County,7,9,333,182,151
Kentucky,Fulton County,7,10,431,204,227
Kentucky,Fulton County,7,11,408,179,229
Kentucky,Fulton County,7,12,483,250,233
Kentucky,Fulton County,7,13,438,213,225
Kentucky,Fulton County,7,14,399,168,231
Kentucky,Fulton County,7,15,280,129,151
Kentucky,Fulton County,7,16,225,90,135
Kentucky,Fulton County,7,17,164,66,98
Kentucky,Fulton County,7,18,153,46,107
Kentucky,Fulton County,8,0,6266,3103,3163
Kentucky,Fulton County,8,1,373,193,180
Kentucky,Fulton County,8,2,389,204,185
Kentucky,Fulton County,8,3,348,181,167
Kentucky,Fulton County,8,4,341,168,173
Kentucky,Fulton County,8,5,375,219,156
Kentucky,Fulton County,8,6,421,224,197
Kentucky,Fulton County,8,7,410,236,174
Kentucky,Fulton County,8,8,336,161,175
Kentucky,Fulton County,8,9,329,192,137
Kentucky,Fulton County,8,10,392,183,209
Kentucky,Fulton County,8,11,399,174,225
Kentucky,Fulton County,8,12,472,235,237
Kentucky,Fulton County,8,13,454,231,223
Kentucky,Fulton County,8,14,393,167,226
Kentucky,Fulton County,8,15,302,135,167
Kentucky,Fulton County,8,16,213,88,125
Kentucky,Fulton County,8,17,170,68,102
Kentucky,Fulton County,8,18,149,44,105
Kentucky,Fulton County,9,0,6185,3051,3134
Kentucky,Fulton County,9,1,369,191,178
Kentucky,Fulton County,9,2,371,194,177
Kentucky,Fulton County,9,3,326,172,154
Kentucky,Fulton County,9,4,335,161,174
Kentucky,Fulton County,9,5,366,211,155
Kentucky,Fulton County,9,6,424,216,208
Kentucky,Fulton County,9,7,383,227,156
Kentucky,Fulton County,9,8,353,173,180
Kentucky,Fulton County,9,9,315,169,146
Kentucky,Fulton County,9,10,377,199,178
Kentucky,Fulton County,9,11,411,179,232
Kentucky,Fulton County,9,12,435,203,232
Kentucky,Fulton County,9,13,481,242,239
Kentucky,Fulton County,9,14,385,172,213
Kentucky,Fulton County,9,15,335,149,186
Kentucky,Fulton County,9,16,214,92,122
Kentucky,Fulton County,9,17,156,63,93
Kentucky,Fulton County,9,18,149,38,111
Kentucky,Fulton County,10,0,6163,3038,3125
Kentucky,Fulton County,10,1,374,191,183
Kentucky,Fulton County,10,2,378,197,181
Kentucky,Fulton County,10,3,340,181,159
Kentucky,Fulton County,10,4,331,164,167
Kentucky,Fulton County,10,5,367,201,166
Kentucky,Fulton County,10,6,428,218,210
Kentucky,Fulton County,10,7,388,215,173
Kentucky,Fulton County,10,8,351,184,167
Kentucky,Fulton County,10,9,305,164,141
Kentucky,Fulton County,10,10,347,182,165
Kentucky,Fulton County,10,11,409,193,216
Kentucky,Fulton County,10,12,428,178,250
Kentucky,Fulton County,10,13,498,257,241
Kentucky,Fulton County,10,14,374,165,209
Kentucky,Fulton County,10,15,346,157,189
Kentucky,Fulton County,10,16,215,96,119
Kentucky,Fulton County,10,17,152,60,92
Kentucky,Fulton County,10,18,132,35,97
Kentucky,Fulton County,11,0,6066,3017,3049
Kentucky,Fulton County,11,1,359,186,173
Kentucky,Fulton County,11,2,386,208,178
Kentucky,Fulton County,11,3,339,180,159
Kentucky,Fulton County,11,4,319,159,160
Kentucky,Fulton County,11,5,332,189,143
Kentucky,Fulton County,11,6,443,228,215
Kentucky,Fulton County,11,7,371,205,166
Kentucky,Fulton County,11,8,365,196,169
Kentucky,Fulton County,11,9,297,150,147
Kentucky,Fulton County,11,10,341,192,149
Kentucky,Fulton County,11,11,386,177,209
Kentucky,Fulton County,11,12,421,182,239
Kentucky,Fulton County,11,13,480,245,235
Kentucky,Fulton County,11,14,396,177,219
Kentucky,Fulton County,11,15,336,145,191
Kentucky,Fulton County,11,16,217,101,116
Kentucky,Fulton County,11,17,147,56,91
Kentucky,Fulton County,11,18,131,41,90
Kentucky,Fulton County,12,0,5969,2992,2977
Kentucky,Fulton County,12,1,321,157,164
Kentucky,Fulton County,12,2,391,217,174
Kentucky,Fulton County,12,3,355,191,164
Kentucky,Fulton County,12,4,312,158,154
Kentucky,Fulton County,12,5,322,197,125
Kentucky,Fulton County,12,6,429,216,213
Kentucky,Fulton County,12,7,390,223,167
Kentucky,Fulton County,12,8,333,180,153
Kentucky,Fulton County,12,9,310,154,156
Kentucky,Fulton County,12,10,317,181,136
Kentucky,Fulton County,12,11,380,178,202
Kentucky,Fulton County,12,12,399,160,239
Kentucky,Fulton County,12,13,472,242,230
Kentucky,Fulton County,12,14,410,187,223
Kentucky,Fulton County,12,15,355,156,199
Kentucky,Fulton County,12,16,209,103,106
Kentucky,Fulton County,12,17,138,51,87
Kentucky,Fulton County,12,18,126,41,85
Kentucky,Gallatin County,1,0,8589,4308,4281
Kentucky,Gallatin County,1,1,604,295,309
Kentucky,Gallatin County,1,2,577,288,289
Kentucky,Gallatin County,1,3,691,383,308
Kentucky,Gallatin County,1,4,663,344,319
Kentucky,Gallatin County,1,5,478,242,236
Kentucky,Gallatin County,1,6,498,249,249
Kentucky,Gallatin County,1,7,506,255,251
Kentucky,Gallatin County,1,8,560,298,262
Kentucky,Gallatin County,1,9,662,317,345
Kentucky,Gallatin County,1,10,689,328,361
Kentucky,Gallatin County,1,11,645,338,307
Kentucky,Gallatin County,1,12,538,275,263
Kentucky,Gallatin County,1,13,499,258,241
Kentucky,Gallatin County,1,14,401,194,207
Kentucky,Gallatin County,1,15,246,125,121
Kentucky,Gallatin County,1,16,134,57,77
Kentucky,Gallatin County,1,17,106,34,72
Kentucky,Gallatin County,1,18,92,28,64
Kentucky,Gallatin County,2,0,8586,4306,4280
Kentucky,Gallatin County,2,1,604,295,309
Kentucky,Gallatin County,2,2,576,287,289
Kentucky,Gallatin County,2,3,691,383,308
Kentucky,Gallatin County,2,4,663,344,319
Kentucky,Gallatin County,2,5,478,242,236
Kentucky,Gallatin County,2,6,498,249,249
Kentucky,Gallatin County,2,7,504,254,250
Kentucky,Gallatin County,2,8,560,298,262
Kentucky,Gallatin County,2,9,662,317,345
Kentucky,Gallatin County,2,10,689,328,361
Kentucky,Gallatin County,2,11,645,338,307
Kentucky,Gallatin County,2,12,538,275,263
Kentucky,Gallatin County,2,13,499,258,241
Kentucky,Gallatin County,2,14,401,194,207
Kentucky,Gallatin County,2,15,246,125,121
Kentucky,Gallatin County,2,16,134,57,77
Kentucky,Gallatin County,2,17,106,34,72
Kentucky,Gallatin County,2,18,92,28,64
Kentucky,Gallatin County,3,0,8612,4317,4295
Kentucky,Gallatin County,3,1,597,293,304
Kentucky,Gallatin County,3,2,587,292,295
Kentucky,Gallatin County,3,3,683,376,307
Kentucky,Gallatin County,3,4,651,342,309
Kentucky,Gallatin County,3,5,494,246,248
Kentucky,Gallatin County,3,6,494,250,244
Kentucky,Gallatin County,3,7,500,253,247
Kentucky,Gallatin County,3,8,566,299,267
Kentucky,Gallatin County,3,9,657,319,338
Kentucky,Gallatin County,3,10,686,325,361
Kentucky,Gallatin County,3,11,654,336,318
Kentucky,Gallatin County,3,12,544,281,263
Kentucky,Gallatin County,3,13,507,260,247
Kentucky,Gallatin County,3,14,404,199,205
Kentucky,Gallatin County,3,15,251,125,126
Kentucky,Gallatin County,3,16,138,58,80
Kentucky,Gallatin County,3,17,105,35,70
Kentucky,Gallatin County,3,18,94,28,66
Kentucky,Gallatin County,4,0,8619,4335,4284
Kentucky,Gallatin County,4,1,579,289,290
Kentucky,Gallatin County,4,2,625,306,319
Kentucky,Gallatin County,4,3,673,371,302
Kentucky,Gallatin County,4,4,631,343,288
Kentucky,Gallatin County,4,5,522,254,268
Kentucky,Gallatin County,4,6,505,257,248
Kentucky,Gallatin County,4,7,485,249,236
Kentucky,Gallatin County,4,8,552,278,274
Kentucky,Gallatin County,4,9,618,309,309
Kentucky,Gallatin County,4,10,684,330,354
Kentucky,Gallatin County,4,11,673,341,332
Kentucky,Gallatin County,4,12,547,285,262
Kentucky,Gallatin County,4,13,513,256,257
Kentucky,Gallatin County,4,14,396,206,190
Kentucky,Gallatin County,4,15,263,130,133
Kentucky,Gallatin County,4,16,152,64,88
Kentucky,Gallatin County,4,17,101,38,63
Kentucky,Gallatin County,4,18,100,29,71
Kentucky,Gallatin County,5,0,8552,4301,4251
Kentucky,Gallatin County,5,1,551,279,272
Kentucky,Gallatin County,5,2,613,292,321
Kentucky,Gallatin County,5,3,662,343,319
Kentucky,Gallatin County,5,4,612,345,267
Kentucky,Gallatin County,5,5,522,263,259
Kentucky,Gallatin County,5,6,482,246,236
Kentucky,Gallatin County,5,7,506,259,247
Kentucky,Gallatin County,5,8,550,279,271
Kentucky,Gallatin County,5,9,580,290,290
Kentucky,Gallatin County,5,10,659,316,343
Kentucky,Gallatin County,5,11,683,354,329
Kentucky,Gallatin County,5,12,581,286,295
Kentucky,Gallatin County,5,13,485,255,230
Kentucky,Gallatin County,5,14,418,215,203
Kentucky,Gallatin County,5,15,299,144,155
Kentucky,Gallatin County,5,16,137,63,74
Kentucky,Gallatin County,5,17,108,40,68
Kentucky,Gallatin County,5,18,104,32,72
Kentucky,Gallatin County,6,0,8578,4305,4273
Kentucky,Gallatin County,6,1,558,279,279
Kentucky,Gallatin County,6,2,621,304,317
Kentucky,Gallatin County,6,3,637,335,302
Kentucky,Gallatin County,6,4,613,326,287
Kentucky,Gallatin County,6,5,533,278,255
Kentucky,Gallatin County,6,6,477,241,236
Kentucky,Gallatin County,6,7,497,251,246
Kentucky,Gallatin County,6,8,533,261,272
Kentucky,Gallatin County,6,9,595,299,296
Kentucky,Gallatin County,6,10,640,313,327
Kentucky,Gallatin County,6,11,699,353,346
Kentucky,Gallatin County,6,12,609,305,304
Kentucky,Gallatin County,6,13,463,244,219
Kentucky,Gallatin County,6,14,425,214,211
Kentucky,Gallatin County,6,15,318,159,159
Kentucky,Gallatin County,6,16,158,77,81
Kentucky,Gallatin County,6,17,109,38,71
Kentucky,Gallatin County,6,18,93,28,65
Kentucky,Gallatin County,7,0,8636,4345,4291
Kentucky,Gallatin County,7,1,566,292,274
Kentucky,Gallatin County,7,2,597,295,302
Kentucky,Gallatin County,7,3,612,300,312
Kentucky,Gallatin County,7,4,651,348,303
Kentucky,Gallatin County,7,5,540,291,249
Kentucky,Gallatin County,7,6,500,257,243
Kentucky,Gallatin County,7,7,497,238,259
Kentucky,Gallatin County,7,8,529,259,270
Kentucky,Gallatin County,7,9,575,298,277
Kentucky,Gallatin County,7,10,652,321,331
Kentucky,Gallatin County,7,11,696,349,347
Kentucky,Gallatin County,7,12,640,333,307
Kentucky,Gallatin County,7,13,481,242,239
Kentucky,Gallatin County,7,14,415,209,206
Kentucky,Gallatin County,7,15,330,174,156
Kentucky,Gallatin County,7,16,167,77,90
Kentucky,Gallatin County,7,17,93,34,59
Kentucky,Gallatin County,7,18,95,28,67
Kentucky,Gallatin County,8,0,8613,4361,4252
Kentucky,Gallatin County,8,1,529,267,262
Kentucky,Gallatin County,8,2,581,287,294
Kentucky,Gallatin County,8,3,607,298,309
Kentucky,Gallatin County,8,4,611,339,272
Kentucky,Gallatin County,8,5,556,286,270
Kentucky,Gallatin County,8,6,504,259,245
Kentucky,Gallatin County,8,7,484,235,249
Kentucky,Gallatin County,8,8,544,280,264
Kentucky,Gallatin County,8,9,536,289,247
Kentucky,Gallatin County,8,10,669,330,339
Kentucky,Gallatin County,8,11,710,355,355
Kentucky,Gallatin County,8,12,647,332,315
Kentucky,Gallatin County,8,13,514,272,242
Kentucky,Gallatin County,8,14,436,221,215
Kentucky,Gallatin County,8,15,313,158,155
Kentucky,Gallatin County,8,16,178,87,91
Kentucky,Gallatin County,8,17,98,37,61
Kentucky,Gallatin County,8,18,96,29,67
Kentucky,Gallatin County,9,0,8719,4387,4332
Kentucky,Gallatin County,9,1,558,276,282
Kentucky,Gallatin County,9,2,565,278,287
Kentucky,Gallatin County,9,3,627,310,317
Kentucky,Gallatin County,9,4,628,331,297
Kentucky,Gallatin County,9,5,525,277,248
Kentucky,Gallatin County,9,6,570,301,269
Kentucky,Gallatin County,9,7,502,248,254
Kentucky,Gallatin County,9,8,500,256,244
Kentucky,Gallatin County,9,9,549,283,266
Kentucky,Gallatin County,9,10,656,333,323
Kentucky,Gallatin County,9,11,695,340,355
Kentucky,Gallatin County,9,12,677,338,339
Kentucky,Gallatin County,9,13,530,282,248
Kentucky,Gallatin County,9,14,447,220,227
Kentucky,Gallatin County,9,15,307,158,149
Kentucky,Gallatin County,9,16,192,91,101
Kentucky,Gallatin County,9,17,96,35,61
Kentucky,Gallatin County,9,18,95,30,65
Kentucky,Gallatin County,10,0,8720,4416,4304
Kentucky,Gallatin County,10,1,568,286,282
Kentucky,Gallatin County,10,2,566,285,281
Kentucky,Gallatin County,10,3,635,325,310
Kentucky,Gallatin County,10,4,611,336,275
Kentucky,Gallatin County,10,5,538,282,256
Kentucky,Gallatin County,10,6,580,314,266
Kentucky,Gallatin County,10,7,491,237,254
Kentucky,Gallatin County,10,8,538,274,264
Kentucky,Gallatin County,10,9,550,277,273
Kentucky,Gallatin County,10,10,611,311,300
Kentucky,Gallatin County,10,11,639,310,329
Kentucky,Gallatin County,10,12,672,345,327
Kentucky,Gallatin County,10,13,550,276,274
Kentucky,Gallatin County,10,14,423,213,210
Kentucky,Gallatin County,10,15,336,169,167
Kentucky,Gallatin County,10,16,228,111,117
Kentucky,Gallatin County,10,17,87,37,50
Kentucky,Gallatin County,10,18,97,28,69
Kentucky,Gallatin County,11,0,8766,4432,4334
Kentucky,Gallatin County,11,1,567,276,291
Kentucky,Gallatin County,11,2,578,280,298
Kentucky,Gallatin County,11,3,630,325,305
Kentucky,Gallatin County,11,4,589,329,260
Kentucky,Gallatin County,11,5,503,272,231
Kentucky,Gallatin County,11,6,634,341,293
Kentucky,Gallatin County,11,7,496,241,255
Kentucky,Gallatin County,11,8,548,270,278
Kentucky,Gallatin County,11,9,527,267,260
Kentucky,Gallatin County,11,10,595,312,283
Kentucky,Gallatin County,11,11,653,318,335
Kentucky,Gallatin County,11,12,661,332,329
Kentucky,Gallatin County,11,13,588,297,291
Kentucky,Gallatin County,11,14,414,212,202
Kentucky,Gallatin County,11,15,349,170,179
Kentucky,Gallatin County,11,16,238,119,119
Kentucky,Gallatin County,11,17,110,49,61
Kentucky,Gallatin County,11,18,86,22,64
Kentucky,Gallatin County,12,0,8869,4501,4368
Kentucky,Gallatin County,12,1,559,287,272
Kentucky,Gallatin County,12,2,592,310,282
Kentucky,Gallatin County,12,3,593,299,294
Kentucky,Gallatin County,12,4,581,316,265
Kentucky,Gallatin County,12,5,546,288,258
Kentucky,Gallatin County,12,6,638,339,299
Kentucky,Gallatin County,12,7,503,263,240
Kentucky,Gallatin County,12,8,523,250,273
Kentucky,Gallatin County,12,9,540,279,261
Kentucky,Gallatin County,12,10,584,302,282
Kentucky,Gallatin County,12,11,685,341,344
Kentucky,Gallatin County,12,12,649,321,328
Kentucky,Gallatin County,12,13,619,312,307
Kentucky,Gallatin County,12,14,435,218,217
Kentucky,Gallatin County,12,15,358,166,192
Kentucky,Gallatin County,12,16,258,135,123
Kentucky,Gallatin County,12,17,123,47,76
Kentucky,Gallatin County,12,18,83,28,55
Kentucky,Garrard County,1,0,16912,8343,8569
Kentucky,Garrard County,1,1,1047,535,512
Kentucky,Garrard County,1,2,1069,527,542
Kentucky,Garrard County,1,3,1067,573,494
Kentucky,Garrard County,1,4,1134,585,549
Kentucky,Garrard County,1,5,801,411,390
Kentucky,Garrard County,1,6,877,406,471
Kentucky,Garrard County,1,7,1030,520,510
Kentucky,Garrard County,1,8,1161,594,567
Kentucky,Garrard County,1,9,1207,599,608
Kentucky,Garrard County,1,10,1408,709,699
Kentucky,Garrard County,1,11,1374,683,691
Kentucky,Garrard County,1,12,1209,586,623
Kentucky,Garrard County,1,13,1065,531,534
Kentucky,Garrard County,1,14,844,400,444
Kentucky,Garrard County,1,15,589,275,314
Kentucky,Garrard County,1,16,462,205,257
Kentucky,Garrard County,1,17,298,124,174
Kentucky,Garrard County,1,18,270,80,190
Kentucky,Garrard County,2,0,16905,8339,8566
Kentucky,Garrard County,2,1,1044,532,512
Kentucky,Garrard County,2,2,1069,527,542
Kentucky,Garrard County,2,3,1067,573,494
Kentucky,Garrard County,2,4,1134,585,549
Kentucky,Garrard County,2,5,801,411,390
Kentucky,Garrard County,2,6,875,406,469
Kentucky,Garrard County,2,7,1030,520,510
Kentucky,Garrard County,2,8,1161,594,567
Kentucky,Garrard County,2,9,1207,599,608
Kentucky,Garrard County,2,10,1408,709,699
Kentucky,Garrard County,2,11,1372,682,690
Kentucky,Garrard County,2,12,1209,586,623
Kentucky,Garrard County,2,13,1065,531,534
Kentucky,Garrard County,2,14,844,400,444
Kentucky,Garrard County,2,15,589,275,314
Kentucky,Garrard County,2,16,462,205,257
Kentucky,Garrard County,2,17,298,124,174
Kentucky,Garrard County,2,18,270,80,190
Kentucky,Garrard County,3,0,16941,8359,8582
Kentucky,Garrard County,3,1,1043,538,505
Kentucky,Garrard County,3,2,1066,523,543
Kentucky,Garrard County,3,3,1067,571,496
Kentucky,Garrard County,3,4,1120,579,541
Kentucky,Garrard County,3,5,802,409,393
Kentucky,Garrard County,3,6,886,413,473
Kentucky,Garrard County,3,7,1029,517,512
Kentucky,Garrard County,3,8,1146,587,559
Kentucky,Garrard County,3,9,1213,603,610
Kentucky,Garrard County,3,10,1406,704,702
Kentucky,Garrard County,3,11,1382,695,687
Kentucky,Garrard County,3,12,1221,590,631
Kentucky,Garrard County,3,13,1069,529,540
Kentucky,Garrard County,3,14,850,403,447
Kentucky,Garrard County,3,15,597,282,315
Kentucky,Garrard County,3,16,467,210,257
Kentucky,Garrard County,3,17,305,126,179
Kentucky,Garrard County,3,18,272,80,192
Kentucky,Garrard County,4,0,16868,8348,8520
Kentucky,Garrard County,4,1,997,529,468
Kentucky,Garrard County,4,2,1060,540,520
Kentucky,Garrard County,4,3,1078,552,526
Kentucky,Garrard County,4,4,1074,557,517
Kentucky,Garrard County,4,5,801,411,390
Kentucky,Garrard County,4,6,884,431,453
Kentucky,Garrard County,4,7,1034,507,527
Kentucky,Garrard County,4,8,1083,560,523
Kentucky,Garrard County,4,9,1189,596,593
Kentucky,Garrard County,4,10,1356,669,687
Kentucky,Garrard County,4,11,1416,721,695
Kentucky,Garrard County,4,12,1232,591,641
Kentucky,Garrard County,4,13,1105,547,558
Kentucky,Garrard County,4,14,872,412,460
Kentucky,Garrard County,4,15,621,301,320
Kentucky,Garrard County,4,16,477,221,256
Kentucky,Garrard County,4,17,315,125,190
Kentucky,Garrard County,4,18,274,78,196
Kentucky,Garrard County,5,0,17006,8410,8596
Kentucky,Garrard County,5,1,1004,556,448
Kentucky,Garrard County,5,2,1096,550,546
Kentucky,Garrard County,5,3,1065,552,513
Kentucky,Garrard County,5,4,1022,522,500
Kentucky,Garrard County,5,5,868,451,417
Kentucky,Garrard County,5,6,865,421,444
Kentucky,Garrard County,5,7,1029,489,540
Kentucky,Garrard County,5,8,1022,525,497
Kentucky,Garrard County,5,9,1216,613,603
Kentucky,Garrard County,5,10,1326,657,669
Kentucky,Garrard County,5,11,1411,708,703
Kentucky,Garrard County,5,12,1286,611,675
Kentucky,Garrard County,5,13,1104,564,540
Kentucky,Garrard County,5,14,927,433,494
Kentucky,Garrard County,5,15,664,311,353
Kentucky,Garrard County,5,16,490,232,258
Kentucky,Garrard County,5,17,311,127,184
Kentucky,Garrard County,5,18,300,88,212
Kentucky,Garrard County,6,0,16992,8354,8638
Kentucky,Garrard County,6,1,958,508,450
Kentucky,Garrard County,6,2,1086,540,546
Kentucky,Garrard County,6,3,1098,565,533
Kentucky,Garrard County,6,4,1006,521,485
Kentucky,Garrard County,6,5,875,442,433
Kentucky,Garrard County,6,6,847,434,413
Kentucky,Garrard County,6,7,998,459,539
Kentucky,Garrard County,6,8,1019,530,489
Kentucky,Garrard County,6,9,1149,563,586
Kentucky,Garrard County,6,10,1267,635,632
Kentucky,Garrard County,6,11,1461,732,729
Kentucky,Garrard County,6,12,1320,633,687
Kentucky,Garrard County,6,13,1116,548,568
Kentucky,Garrard County,6,14,935,454,481
Kentucky,Garrard County,6,15,716,329,387
Kentucky,Garrard County,6,16,511,243,268
Kentucky,Garrard County,6,17,315,135,180
Kentucky,Garrard County,6,18,315,83,232
Kentucky,Garrard County,7,0,16972,8364,8608
Kentucky,Garrard County,7,1,937,509,428
Kentucky,Garrard County,7,2,1080,555,525
Kentucky,Garrard County,7,3,1104,544,560
Kentucky,Garrard County,7,4,956,511,445
Kentucky,Garrard County,7,5,858,425,433
Kentucky,Garrard County,7,6,846,430,416
Kentucky,Garrard County,7,7,986,472,514
Kentucky,Garrard County,7,8,1035,527,508
Kentucky,Garrard County,7,9,1118,555,563
Kentucky,Garrard County,7,10,1237,611,626
Kentucky,Garrard County,7,11,1465,748,717
Kentucky,Garrard County,7,12,1322,649,673
Kentucky,Garrard County,7,13,1163,546,617
Kentucky,Garrard County,7,14,950,466,484
Kentucky,Garrard County,7,15,751,341,410
Kentucky,Garrard County,7,16,516,236,280
Kentucky,Garrard County,7,17,335,149,186
Kentucky,Garrard County,7,18,313,90,223
Kentucky,Garrard County,8,0,17207,8493,8714
Kentucky,Garrard County,8,1,981,521,460
Kentucky,Garrard County,8,2,1073,563,510
Kentucky,Garrard County,8,3,1128,563,565
Kentucky,Garrard County,8,4,971,509,462
Kentucky,Garrard County,8,5,912,457,455
Kentucky,Garrard County,8,6,864,437,427
Kentucky,Garrard County,8,7,958,454,504
Kentucky,Garrard County,8,8,1046,529,517
Kentucky,Garrard County,8,9,1096,569,527
Kentucky,Garrard County,8,10,1205,587,618
Kentucky,Garrard County,8,11,1453,724,729
Kentucky,Garrard County,8,12,1391,710,681
Kentucky,Garrard County,8,13,1192,549,643
Kentucky,Garrard County,8,14,986,478,508
Kentucky,Garrard County,8,15,755,349,406
Kentucky,Garrard County,8,16,520,237,283
Kentucky,Garrard County,8,17,356,161,195
Kentucky,Garrard County,8,18,320,96,224
Kentucky,Garrard County,9,0,17382,8562,8820
Kentucky,Garrard County,9,1,1026,537,489
Kentucky,Garrard County,9,2,1100,601,499
Kentucky,Garrard County,9,3,1134,597,537
Kentucky,Garrard County,9,4,953,473,480
Kentucky,Garrard County,9,5,888,450,438
Kentucky,Garrard County,9,6,921,451,470
Kentucky,Garrard County,9,7,958,458,500
Kentucky,Garrard County,9,8,1059,516,543
Kentucky,Garrard County,9,9,1057,537,520
Kentucky,Garrard County,9,10,1210,613,597
Kentucky,Garrard County,9,11,1402,680,722
Kentucky,Garrard County,9,12,1438,739,699
Kentucky,Garrard County,9,13,1224,567,657
Kentucky,Garrard County,9,14,1020,492,528
Kentucky,Garrard County,9,15,773,352,421
Kentucky,Garrard County,9,16,522,236,286
Kentucky,Garrard County,9,17,366,168,198
Kentucky,Garrard County,9,18,331,95,236
Kentucky,Garrard County,10,0,17449,8557,8892
Kentucky,Garrard County,10,1,997,509,488
Kentucky,Garrard County,10,2,1076,580,496
Kentucky,Garrard County,10,3,1101,559,542
Kentucky,Garrard County,10,4,1024,531,493
Kentucky,Garrard County,10,5,845,433,412
Kentucky,Garrard County,10,6,917,433,484
Kentucky,Garrard County,10,7,973,478,495
Kentucky,Garrard County,10,8,1067,507,560
Kentucky,Garrard County,10,9,1039,535,504
Kentucky,Garrard County,10,10,1225,625,600
Kentucky,Garrard County,10,11,1361,657,704
Kentucky,Garrard County,10,12,1447,730,717
Kentucky,Garrard County,10,13,1291,608,683
Kentucky,Garrard County,10,14,1026,500,526
Kentucky,Garrard County,10,15,798,360,438
Kentucky,Garrard County,10,16,549,241,308
Kentucky,Garrard County,10,17,370,165,205
Kentucky,Garrard County,10,18,343,106,237
Kentucky,Garrard County,11,0,17519,8635,8884
Kentucky,Garrard County,11,1,986,519,467
Kentucky,Garrard County,11,2,1070,580,490
Kentucky,Garrard County,11,3,1084,571,513
Kentucky,Garrard County,11,4,1017,533,484
Kentucky,Garrard County,11,5,864,438,426
Kentucky,Garrard County,11,6,983,465,518
Kentucky,Garrard County,11,7,951,478,473
Kentucky,Garrard County,11,8,1056,486,570
Kentucky,Garrard County,11,9,1048,549,499
Kentucky,Garrard County,11,10,1186,604,582
Kentucky,Garrard County,11,11,1320,656,664
Kentucky,Garrard County,11,12,1486,734,752
Kentucky,Garrard County,11,13,1295,615,680
Kentucky,Garrard County,11,14,1056,500,556
Kentucky,Garrard County,11,15,805,382,423
Kentucky,Garrard County,11,16,593,261,332
Kentucky,Garrard County,11,17,369,159,210
Kentucky,Garrard County,11,18,350,105,245
Kentucky,Garrard County,12,0,17666,8708,8958
Kentucky,Garrard County,12,1,1010,537,473
Kentucky,Garrard County,12,2,1096,602,494
Kentucky,Garrard County,12,3,1117,586,531
Kentucky,Garrard County,12,4,1023,537,486
Kentucky,Garrard County,12,5,828,437,391
Kentucky,Garrard County,12,6,993,460,533
Kentucky,Garrard County,12,7,973,489,484
Kentucky,Garrard County,12,8,1031,478,553
Kentucky,Garrard County,12,9,1058,541,517
Kentucky,Garrard County,12,10,1148,582,566
Kentucky,Garrard County,12,11,1300,642,658
Kentucky,Garrard County,12,12,1531,760,771
Kentucky,Garrard County,12,13,1316,648,668
Kentucky,Garrard County,12,14,1098,489,609
Kentucky,Garrard County,12,15,818,403,415
Kentucky,Garrard County,12,16,599,258,341
Kentucky,Garrard County,12,17,363,148,215
Kentucky,Garrard County,12,18,364,111,253
Kentucky,Grant County,1,0,24662,12301,12361
Kentucky,Grant County,1,1,1926,989,937
Kentucky,Grant County,1,2,1883,959,924
Kentucky,Grant County,1,3,1942,1005,937
Kentucky,Grant County,1,4,1822,950,872
Kentucky,Grant County,1,5,1425,735,690
Kentucky,Grant County,1,6,1541,783,758
Kentucky,Grant County,1,7,1695,844,851
Kentucky,Grant County,1,8,1667,818,849
Kentucky,Grant County,1,9,1823,928,895
Kentucky,Grant County,1,10,1875,928,947
Kentucky,Grant County,1,11,1751,855,896
Kentucky,Grant County,1,12,1431,711,720
Kentucky,Grant County,1,13,1233,602,631
Kentucky,Grant County,1,14,994,485,509
Kentucky,Grant County,1,15,665,319,346
Kentucky,Grant County,1,16,455,218,237
Kentucky,Grant County,1,17,275,111,164
Kentucky,Grant County,1,18,259,61,198
Kentucky,Grant County,2,0,24655,12297,12358
Kentucky,Grant County,2,1,1926,989,937
Kentucky,Grant County,2,2,1880,957,923
Kentucky,Grant County,2,3,1940,1003,937
Kentucky,Grant County,2,4,1823,951,872
Kentucky,Grant County,2,5,1424,734,690
Kentucky,Grant County,2,6,1541,783,758
Kentucky,Grant County,2,7,1693,843,850
Kentucky,Grant County,2,8,1667,818,849
Kentucky,Grant County,2,9,1821,927,894
Kentucky,Grant County,2,10,1876,929,947
Kentucky,Grant County,2,11,1751,855,896
Kentucky,Grant County,2,12,1430,711,719
Kentucky,Grant County,2,13,1234,602,632
Kentucky,Grant County,2,14,995,486,509
Kentucky,Grant County,2,15,665,319,346
Kentucky,Grant County,2,16,455,218,237
Kentucky,Grant County,2,17,275,111,164
Kentucky,Grant County,2,18,259,61,198
Kentucky,Grant County,3,0,24677,12302,12375
Kentucky,Grant County,3,1,1908,975,933
Kentucky,Grant County,3,2,1868,945,923
Kentucky,Grant County,3,3,1946,1006,940
Kentucky,Grant County,3,4,1802,940,862
Kentucky,Grant County,3,5,1448,751,697
Kentucky,Grant County,3,6,1526,778,748
Kentucky,Grant County,3,7,1699,845,854
Kentucky,Grant County,3,8,1652,804,848
Kentucky,Grant County,3,9,1837,932,905
Kentucky,Grant County,3,10,1869,933,936
Kentucky,Grant County,3,11,1762,863,899
Kentucky,Grant County,3,12,1438,714,724
Kentucky,Grant County,3,13,1238,599,639
Kentucky,Grant County,3,14,1007,495,512
Kentucky,Grant County,3,15,678,325,353
Kentucky,Grant County,3,16,458,221,237
Kentucky,Grant County,3,17,284,116,168
Kentucky,Grant County,3,18,257,60,197
Kentucky,Grant County,4,0,24765,12431,12334
Kentucky,Grant County,4,1,1869,972,897
Kentucky,Grant County,4,2,1865,940,925
Kentucky,Grant County,4,3,1970,1020,950
Kentucky,Grant County,4,4,1782,944,838
Kentucky,Grant County,4,5,1508,791,717
Kentucky,Grant County,4,6,1478,755,723
Kentucky,Grant County,4,7,1672,832,840
Kentucky,Grant County,4,8,1575,778,797
Kentucky,Grant County,4,9,1898,963,935
Kentucky,Grant County,4,10,1768,888,880
Kentucky,Grant County,4,11,1817,902,915
Kentucky,Grant County,4,12,1497,748,749
Kentucky,Grant County,4,13,1290,622,668
Kentucky,Grant County,4,14,1030,517,513
Kentucky,Grant County,4,15,722,342,380
Kentucky,Grant County,4,16,475,232,243
Kentucky,Grant County,4,17,291,121,170
Kentucky,Grant County,4,18,258,64,194
Kentucky,Grant County,5,0,24521,12297,12224
Kentucky,Grant County,5,1,1870,978,892
Kentucky,Grant County,5,2,1866,933,933
Kentucky,Grant County,5,3,1895,984,911
Kentucky,Grant County,5,4,1722,919,803
Kentucky,Grant County,5,5,1526,795,731
Kentucky,Grant County,5,6,1420,726,694
Kentucky,Grant County,5,7,1599,797,802
Kentucky,Grant County,5,8,1534,760,774
Kentucky,Grant County,5,9,1860,947,913
Kentucky,Grant County,5,10,1700,844,856
Kentucky,Grant County,5,11,1809,897,912
Kentucky,Grant County,5,12,1524,749,775
Kentucky,Grant County,5,13,1295,631,664
Kentucky,Grant County,5,14,1092,539,553
Kentucky,Grant County,5,15,756,364,392
Kentucky,Grant County,5,16,512,241,271
Kentucky,Grant County,5,17,275,123,152
Kentucky,Grant County,5,18,266,70,196
Kentucky,Grant County,6,0,24565,12283,12282
Kentucky,Grant County,6,1,1772,929,843
Kentucky,Grant County,6,2,1976,969,1007
Kentucky,Grant County,6,3,1824,929,895
Kentucky,Grant County,6,4,1706,916,790
Kentucky,Grant County,6,5,1563,809,754
Kentucky,Grant County,6,6,1454,745,709
Kentucky,Grant County,6,7,1587,805,782
Kentucky,Grant County,6,8,1518,740,778
Kentucky,Grant County,6,9,1780,901,879
Kentucky,Grant County,6,10,1713,873,840
Kentucky,Grant County,6,11,1775,866,909
Kentucky,Grant County,6,12,1568,771,797
Kentucky,Grant County,6,13,1322,639,683
Kentucky,Grant County,6,14,1077,535,542
Kentucky,Grant County,6,15,832,403,429
Kentucky,Grant County,6,16,529,244,285
Kentucky,Grant County,6,17,306,135,171
Kentucky,Grant County,6,18,263,74,189
Kentucky,Grant County,7,0,24829,12354,12475
Kentucky,Grant County,7,1,1824,940,884
Kentucky,Grant County,7,2,1967,986,981
Kentucky,Grant County,7,3,1900,939,961
Kentucky,Grant County,7,4,1695,890,805
Kentucky,Grant County,7,5,1556,802,754
Kentucky,Grant County,7,6,1456,766,690
Kentucky,Grant County,7,7,1556,760,796
Kentucky,Grant County,7,8,1558,784,774
Kentucky,Grant County,7,9,1753,860,893
Kentucky,Grant County,7,10,1712,863,849
Kentucky,Grant County,7,11,1796,891,905
Kentucky,Grant County,7,12,1627,784,843
Kentucky,Grant County,7,13,1310,641,669
Kentucky,Grant County,7,14,1118,557,561
Kentucky,Grant County,7,15,851,408,443
Kentucky,Grant County,7,16,542,257,285
Kentucky,Grant County,7,17,342,150,192
Kentucky,Grant County,7,18,266,76,190
Kentucky,Grant County,8,0,24736,12342,12394
Kentucky,Grant County,8,1,1829,966,863
Kentucky,Grant County,8,2,1875,921,954
Kentucky,Grant County,8,3,1820,896,924
Kentucky,Grant County,8,4,1771,913,858
Kentucky,Grant County,8,5,1531,824,707
Kentucky,Grant County,8,6,1486,768,718
Kentucky,Grant County,8,7,1500,768,732
Kentucky,Grant County,8,8,1584,787,797
Kentucky,Grant County,8,9,1627,800,827
Kentucky,Grant County,8,10,1754,881,873
Kentucky,Grant County,8,11,1757,864,893
Kentucky,Grant County,8,12,1676,809,867
Kentucky,Grant County,8,13,1336,673,663
Kentucky,Grant County,8,14,1146,554,592
Kentucky,Grant County,8,15,866,422,444
Kentucky,Grant County,8,16,577,265,312
Kentucky,Grant County,8,17,352,161,191
Kentucky,Grant County,8,18,249,70,179
Kentucky,Grant County,9,0,24910,12420,12490
Kentucky,Grant County,9,1,1876,978,898
Kentucky,Grant County,9,2,1869,923,946
Kentucky,Grant County,9,3,1887,933,954
Kentucky,Grant County,9,4,1736,887,849
Kentucky,Grant County,9,5,1483,804,679
Kentucky,Grant County,9,6,1559,817,742
Kentucky,Grant County,9,7,1500,752,748
Kentucky,Grant County,9,8,1632,809,823
Kentucky,Grant County,9,9,1518,756,762
Kentucky,Grant County,9,10,1800,910,890
Kentucky,Grant County,9,11,1720,826,894
Kentucky,Grant County,9,12,1682,833,849
Kentucky,Grant County,9,13,1338,668,670
Kentucky,Grant County,9,14,1196,574,622
Kentucky,Grant County,9,15,892,436,456
Kentucky,Grant County,9,16,588,265,323
Kentucky,Grant County,9,17,363,168,195
Kentucky,Grant County,9,18,271,81,190
Kentucky,Grant County,10,0,24973,12471,12502
Kentucky,Grant County,10,1,1797,935,862
Kentucky,Grant County,10,2,1819,915,904
Kentucky,Grant County,10,3,1905,908,997
Kentucky,Grant County,10,4,1713,895,818
Kentucky,Grant County,10,5,1531,826,705
Kentucky,Grant County,10,6,1611,822,789
Kentucky,Grant County,10,7,1503,753,750
Kentucky,Grant County,10,8,1587,796,791
Kentucky,Grant County,10,9,1491,759,732
Kentucky,Grant County,10,10,1810,914,896
Kentucky,Grant County,10,11,1682,819,863
Kentucky,Grant County,10,12,1731,854,877
Kentucky,Grant County,10,13,1407,695,712
Kentucky,Grant County,10,14,1190,580,610
Kentucky,Grant County,10,15,936,462,474
Kentucky,Grant County,10,16,615,280,335
Kentucky,Grant County,10,17,358,164,194
Kentucky,Grant County,10,18,287,94,193
Kentucky,Grant County,11,0,25065,12567,12498
Kentucky,Grant County,11,1,1858,940,918
Kentucky,Grant County,11,2,1750,914,836
Kentucky,Grant County,11,3,1947,934,1013
Kentucky,Grant County,11,4,1702,867,835
Kentucky,Grant County,11,5,1530,831,699
Kentucky,Grant County,11,6,1652,855,797
Kentucky,Grant County,11,7,1482,770,712
Kentucky,Grant County,11,8,1557,771,786
Kentucky,Grant County,11,9,1485,759,726
Kentucky,Grant County,11,10,1792,895,897
Kentucky,Grant County,11,11,1651,836,815
Kentucky,Grant County,11,12,1720,834,886
Kentucky,Grant County,11,13,1469,730,739
Kentucky,Grant County,11,14,1185,568,617
Kentucky,Grant County,11,15,948,469,479
Kentucky,Grant County,11,16,690,331,359
Kentucky,Grant County,11,17,353,160,193
Kentucky,Grant County,11,18,294,103,191
Kentucky,Grant County,12,0,25069,12547,12522
Kentucky,Grant County,12,1,1824,933,891
Kentucky,Grant County,12,2,1732,896,836
Kentucky,Grant County,12,3,1946,917,1029
Kentucky,Grant County,12,4,1675,849,826
Kentucky,Grant County,12,5,1536,812,724
Kentucky,Grant County,12,6,1678,877,801
Kentucky,Grant County,12,7,1517,797,720
Kentucky,Grant County,12,8,1505,728,777
Kentucky,Grant County,12,9,1565,814,751
Kentucky,Grant County,12,10,1689,831,858
Kentucky,Grant County,12,11,1656,848,808
Kentucky,Grant County,12,12,1697,847,850
Kentucky,Grant County,12,13,1529,739,790
Kentucky,Grant County,12,14,1167,560,607
Kentucky,Grant County,12,15,958,474,484
Kentucky,Grant County,12,16,736,345,391
Kentucky,Grant County,12,17,363,173,190
Kentucky,Grant County,12,18,296,107,189
Kentucky,Graves County,1,0,37121,18207,18914
Kentucky,Graves County,1,1,2464,1250,1214
Kentucky,Graves County,1,2,2437,1234,1203
Kentucky,Graves County,1,3,2594,1333,1261
Kentucky,Graves County,1,4,2453,1252,1201
Kentucky,Graves County,1,5,2069,1056,1013
Kentucky,Graves County,1,6,2185,1090,1095
Kentucky,Graves County,1,7,2175,1093,1082
Kentucky,Graves County,1,8,2258,1195,1063
Kentucky,Graves County,1,9,2299,1093,1206
Kentucky,Graves County,1,10,2747,1362,1385
Kentucky,Graves County,1,11,2556,1255,1301
Kentucky,Graves County,1,12,2498,1255,1243
Kentucky,Graves County,1,13,2241,1087,1154
Kentucky,Graves County,1,14,1884,875,1009
Kentucky,Graves County,1,15,1457,698,759
Kentucky,Graves County,1,16,1073,482,591
Kentucky,Graves County,1,17,847,320,527
Kentucky,Graves County,1,18,884,277,607
Kentucky,Graves County,2,0,37151,18223,18928
Kentucky,Graves County,2,1,2465,1251,1214
Kentucky,Graves County,2,2,2440,1235,1205
Kentucky,Graves County,2,3,2595,1333,1262
Kentucky,Graves County,2,4,2459,1256,1203
Kentucky,Graves County,2,5,2072,1059,1013
Kentucky,Graves County,2,6,2185,1090,1095
Kentucky,Graves County,2,7,2175,1093,1082
Kentucky,Graves County,2,8,2262,1197,1065
Kentucky,Graves County,2,9,2302,1094,1208
Kentucky,Graves County,2,10,2751,1364,1387
Kentucky,Graves County,2,11,2557,1256,1301
Kentucky,Graves County,2,12,2500,1256,1244
Kentucky,Graves County,2,13,2244,1087,1157
Kentucky,Graves County,2,14,1884,875,1009
Kentucky,Graves County,2,15,1456,698,758
Kentucky,Graves County,2,16,1072,481,591
Kentucky,Graves County,2,17,848,321,527
Kentucky,Graves County,2,18,884,277,607
Kentucky,Graves County,3,0,37262,18298,18964
Kentucky,Graves County,3,1,2485,1271,1214
Kentucky,Graves County,3,2,2434,1226,1208
Kentucky,Graves County,3,3,2612,1347,1265
Kentucky,Graves County,3,4,2458,1260,1198
Kentucky,Graves County,3,5,2088,1064,1024
Kentucky,Graves County,3,6,2184,1094,1090
Kentucky,Graves County,3,7,2198,1099,1099
Kentucky,Graves County,3,8,2254,1195,1059
Kentucky,Graves County,3,9,2318,1108,1210
Kentucky,Graves County,3,10,2747,1361,1386
Kentucky,Graves County,3,11,2568,1258,1310
Kentucky,Graves County,3,12,2510,1260,1250
Kentucky,Graves County,3,13,2265,1101,1164
Kentucky,Graves County,3,14,1881,877,1004
Kentucky,Graves County,3,15,1461,696,765
Kentucky,Graves County,3,16,1072,481,591
Kentucky,Graves County,3,17,853,326,527
Kentucky,Graves County,3,18,874,274,600
Kentucky,Graves County,4,0,37613,18445,19168
Kentucky,Graves County,4,1,2519,1273,1246
Kentucky,Graves County,4,2,2435,1208,1227
Kentucky,Graves County,4,3,2658,1380,1278
Kentucky,Graves County,4,4,2443,1265,1178
Kentucky,Graves County,4,5,2220,1113,1107
Kentucky,Graves County,4,6,2143,1084,1059
Kentucky,Graves County,4,7,2289,1114,1175
Kentucky,Graves County,4,8,2199,1150,1049
Kentucky,Graves County,4,9,2386,1181,1205
Kentucky,Graves County,4,10,2682,1331,1351
Kentucky,Graves County,4,11,2603,1252,1351
Kentucky,Graves County,4,12,2516,1260,1256
Kentucky,Graves County,4,13,2357,1154,1203
Kentucky,Graves County,4,14,1875,881,994
Kentucky,Graves County,4,15,1492,701,791
Kentucky,Graves County,4,16,1088,488,600
Kentucky,Graves County,4,17,840,332,508
Kentucky,Graves County,4,18,868,278,590
Kentucky,Graves County,5,0,37566,18443,19123
Kentucky,Graves County,5,1,2543,1298,1245
Kentucky,Graves County,5,2,2455,1238,1217
Kentucky,Graves County,5,3,2605,1337,1268
Kentucky,Graves County,5,4,2486,1287,1199
Kentucky,Graves County,5,5,2229,1127,1102
Kentucky,Graves County,5,6,2124,1062,1062
Kentucky,Graves County,5,7,2277,1112,1165
Kentucky,Graves County,5,8,2163,1090,1073
Kentucky,Graves County,5,9,2358,1179,1179
Kentucky,Graves County,5,10,2575,1299,1276
Kentucky,Graves County,5,11,2639,1260,1379
Kentucky,Graves County,5,12,2499,1245,1254
Kentucky,Graves County,5,13,2334,1154,1180
Kentucky,Graves County,5,14,1993,945,1048
Kentucky,Graves County,5,15,1543,732,811
Kentucky,Graves County,5,16,1066,478,588
Kentucky,Graves County,5,17,815,321,494
Kentucky,Graves County,5,18,862,279,583
Kentucky,Graves County,6,0,37406,18285,19121
Kentucky,Graves County,6,1,2533,1291,1242
Kentucky,Graves County,6,2,2437,1223,1214
Kentucky,Graves County,6,3,2591,1318,1273
Kentucky,Graves County,6,4,2456,1277,1179
Kentucky,Graves County,6,5,2222,1116,1106
Kentucky,Graves County,6,6,2074,1015,1059
Kentucky,Graves County,6,7,2232,1091,1141
Kentucky,Graves County,6,8,2190,1093,1097
Kentucky,Graves County,6,9,2330,1157,1173
Kentucky,Graves County,6,10,2476,1249,1227
Kentucky,Graves County,6,11,2664,1261,1403
Kentucky,Graves County,6,12,2503,1236,1267
Kentucky,Graves County,6,13,2333,1153,1180
Kentucky,Graves County,6,14,2017,963,1054
Kentucky,Graves County,6,15,1627,760,867
Kentucky,Graves County,6,16,1088,487,601
Kentucky,Graves County,6,17,797,320,477
Kentucky,Graves County,6,18,836,275,561
Kentucky,Graves County,7,0,37583,18364,19219
Kentucky,Graves County,7,1,2570,1290,1280
Kentucky,Graves County,7,2,2470,1259,1211
Kentucky,Graves County,7,3,2588,1292,1296
Kentucky,Graves County,7,4,2445,1284,1161
Kentucky,Graves County,7,5,2220,1128,1092
Kentucky,Graves County,7,6,2120,1055,1065
Kentucky,Graves County,7,7,2225,1071,1154
Kentucky,Graves County,7,8,2214,1093,1121
Kentucky,Graves County,7,9,2343,1190,1153
Kentucky,Graves County,7,10,2347,1137,1210
Kentucky,Graves County,7,11,2698,1298,1400
Kentucky,Graves County,7,12,2523,1243,1280
Kentucky,Graves County,7,13,2386,1184,1202
Kentucky,Graves County,7,14,2019,974,1045
Kentucky,Graves County,7,15,1638,735,903
Kentucky,Graves County,7,16,1170,536,634
Kentucky,Graves County,7,17,783,330,453
Kentucky,Graves County,7,18,824,265,559
Kentucky,Graves County,8,0,37248,18204,19044
Kentucky,Graves County,8,1,2501,1284,1217
Kentucky,Graves County,8,2,2477,1249,1228
Kentucky,Graves County,8,3,2468,1243,1225
Kentucky,Graves County,8,4,2405,1263,1142
Kentucky,Graves County,8,5,2110,1055,1055
Kentucky,Graves County,8,6,2144,1055,1089
Kentucky,Graves County,8,7,2160,1058,1102
Kentucky,Graves County,8,8,2241,1094,1147
Kentucky,Graves County,8,9,2267,1162,1105
Kentucky,Graves County,8,10,2298,1111,1187
Kentucky,Graves County,8,11,2729,1339,1390
Kentucky,Graves County,8,12,2498,1224,1274
Kentucky,Graves County,8,13,2424,1182,1242
Kentucky,Graves County,8,14,2081,1004,1077
Kentucky,Graves County,8,15,1633,732,901
Kentucky,Graves County,8,16,1197,549,648
Kentucky,Graves County,8,17,786,319,467
Kentucky,Graves County,8,18,829,281,548
Kentucky,Graves County,9,0,37217,18229,18988
Kentucky,Graves County,9,1,2470,1290,1180
Kentucky,Graves County,9,2,2487,1245,1242
Kentucky,Graves County,9,3,2421,1206,1215
Kentucky,Graves County,9,4,2416,1288,1128
Kentucky,Graves County,9,5,2056,1056,1000
Kentucky,Graves County,9,6,2251,1084,1167
Kentucky,Graves County,9,7,2063,1034,1029
Kentucky,Graves County,9,8,2276,1095,1181
Kentucky,Graves County,9,9,2166,1110,1056
Kentucky,Graves County,9,10,2363,1158,1205
Kentucky,Graves County,9,11,2672,1329,1343
Kentucky,Graves County,9,12,2543,1205,1338
Kentucky,Graves County,9,13,2399,1179,1220
Kentucky,Graves County,9,14,2159,1040,1119
Kentucky,Graves County,9,15,1626,753,873
Kentucky,Graves County,9,16,1225,548,677
Kentucky,Graves County,9,17,787,325,462
Kentucky,Graves County,9,18,837,284,553
Kentucky,Graves County,10,0,37190,18216,18974
Kentucky,Graves County,10,1,2501,1310,1191
Kentucky,Graves County,10,2,2470,1263,1207
Kentucky,Graves County,10,3,2408,1202,1206
Kentucky,Graves County,10,4,2352,1234,1118
Kentucky,Graves County,10,5,2095,1102,993
Kentucky,Graves County,10,6,2297,1112,1185
Kentucky,Graves County,10,7,2102,1027,1075
Kentucky,Graves County,10,8,2230,1083,1147
Kentucky,Graves County,10,9,2127,1075,1052
Kentucky,Graves County,10,10,2327,1142,1185
Kentucky,Graves County,10,11,2525,1272,1253
Kentucky,Graves County,10,12,2597,1225,1372
Kentucky,Graves County,10,13,2412,1171,1241
Kentucky,Graves County,10,14,2148,1035,1113
Kentucky,Graves County,10,15,1726,792,934
Kentucky,Graves County,10,16,1271,576,695
Kentucky,Graves County,10,17,762,309,453
Kentucky,Graves County,10,18,840,286,554
Kentucky,Graves County,11,0,37319,18239,19080
Kentucky,Graves County,11,1,2529,1314,1215
Kentucky,Graves County,11,2,2522,1281,1241
Kentucky,Graves County,11,3,2415,1230,1185
Kentucky,Graves County,11,4,2287,1161,1126
Kentucky,Graves County,11,5,2059,1080,979
Kentucky,Graves County,11,6,2393,1174,1219
Kentucky,Graves County,11,7,2098,1038,1060
Kentucky,Graves County,11,8,2211,1046,1165
Kentucky,Graves County,11,9,2146,1085,1061
Kentucky,Graves County,11,10,2258,1104,1154
Kentucky,Graves County,11,11,2453,1234,1219
Kentucky,Graves County,11,12,2614,1226,1388
Kentucky,Graves County,11,13,2453,1180,1273
Kentucky,Graves County,11,14,2153,1040,1113
Kentucky,Graves County,11,15,1775,827,948
Kentucky,Graves County,11,16,1334,599,735
Kentucky,Graves County,11,17,799,330,469
Kentucky,Graves County,11,18,820,290,530
Kentucky,Graves County,12,0,37266,18226,19040
Kentucky,Graves County,12,1,2542,1358,1184
Kentucky,Graves County,12,2,2503,1240,1263
Kentucky,Graves County,12,3,2422,1229,1193
Kentucky,Graves County,12,4,2282,1138,1144
Kentucky,Graves County,12,5,1938,1010,928
Kentucky,Graves County,12,6,2384,1179,1205
Kentucky,Graves County,12,7,2170,1093,1077
Kentucky,Graves County,12,8,2184,1025,1159
Kentucky,Graves County,12,9,2172,1073,1099
Kentucky,Graves County,12,10,2217,1129,1088
Kentucky,Graves County,12,11,2318,1125,1193
Kentucky,Graves County,12,12,2612,1277,1335
Kentucky,Graves County,12,13,2498,1186,1312
Kentucky,Graves County,12,14,2227,1085,1142
Kentucky,Graves County,12,15,1751,812,939
Kentucky,Graves County,12,16,1363,594,769
Kentucky,Graves County,12,17,862,372,490
Kentucky,Graves County,12,18,821,301,520
Kentucky,Grayson County,1,0,25746,13052,12694
Kentucky,Grayson County,1,1,1619,892,727
Kentucky,Grayson County,1,2,1705,873,832
Kentucky,Grayson County,1,3,1727,922,805
Kentucky,Grayson County,1,4,1721,909,812
Kentucky,Grayson County,1,5,1355,676,679
Kentucky,Grayson County,1,6,1512,787,725
Kentucky,Grayson County,1,7,1632,854,778
Kentucky,Grayson County,1,8,1691,861,830
Kentucky,Grayson County,1,9,1683,886,797
Kentucky,Grayson County,1,10,1853,968,885
Kentucky,Grayson County,1,11,1918,963,955
Kentucky,Grayson County,1,12,1821,881,940
Kentucky,Grayson County,1,13,1625,830,795
Kentucky,Grayson County,1,14,1297,621,676
Kentucky,Grayson County,1,15,1004,473,531
Kentucky,Grayson County,1,16,710,342,368
Kentucky,Grayson County,1,17,512,196,316
Kentucky,Grayson County,1,18,361,118,243
Kentucky,Grayson County,2,0,25749,13054,12695
Kentucky,Grayson County,2,1,1619,892,727
Kentucky,Grayson County,2,2,1705,873,832
Kentucky,Grayson County,2,3,1727,922,805
Kentucky,Grayson County,2,4,1722,910,812
Kentucky,Grayson County,2,5,1355,676,679
Kentucky,Grayson County,2,6,1512,787,725
Kentucky,Grayson County,2,7,1632,854,778
Kentucky,Grayson County,2,8,1693,862,831
Kentucky,Grayson County,2,9,1683,886,797
Kentucky,Grayson County,2,10,1853,968,885
Kentucky,Grayson County,2,11,1918,963,955
Kentucky,Grayson County,2,12,1821,881,940
Kentucky,Grayson County,2,13,1625,830,795
Kentucky,Grayson County,2,14,1297,621,676
Kentucky,Grayson County,2,15,1004,473,531
Kentucky,Grayson County,2,16,710,342,368
Kentucky,Grayson County,2,17,512,196,316
Kentucky,Grayson County,2,18,361,118,243
Kentucky,Grayson County,3,0,25786,13073,12713
Kentucky,Grayson County,3,1,1625,899,726
Kentucky,Grayson County,3,2,1703,874,829
Kentucky,Grayson County,3,3,1733,917,816
Kentucky,Grayson County,3,4,1703,912,791
Kentucky,Grayson County,3,5,1380,685,695
Kentucky,Grayson County,3,6,1510,788,722
Kentucky,Grayson County,3,7,1648,860,788
Kentucky,Grayson County,3,8,1687,860,827
Kentucky,Grayson County,3,9,1675,880,795
Kentucky,Grayson County,3,10,1857,966,891
Kentucky,Grayson County,3,11,1912,959,953
Kentucky,Grayson County,3,12,1824,886,938
Kentucky,Grayson County,3,13,1641,835,806
Kentucky,Grayson County,3,14,1292,619,673
Kentucky,Grayson County,3,15,1008,476,532
Kentucky,Grayson County,3,16,714,340,374
Kentucky,Grayson County,3,17,512,199,313
Kentucky,Grayson County,3,18,362,118,244
Kentucky,Grayson County,4,0,25752,13016,12736
Kentucky,Grayson County,4,1,1575,847,728
Kentucky,Grayson County,4,2,1679,859,820
Kentucky,Grayson County,4,3,1746,889,857
Kentucky,Grayson County,4,4,1684,933,751
Kentucky,Grayson County,4,5,1457,708,749
Kentucky,Grayson County,4,6,1439,762,677
Kentucky,Grayson County,4,7,1681,869,812
Kentucky,Grayson County,4,8,1635,821,814
Kentucky,Grayson County,4,9,1665,862,803
Kentucky,Grayson County,4,10,1841,968,873
Kentucky,Grayson County,4,11,1885,952,933
Kentucky,Grayson County,4,12,1824,911,913
Kentucky,Grayson County,4,13,1747,870,877
Kentucky,Grayson County,4,14,1263,607,656
Kentucky,Grayson County,4,15,1019,494,525
Kentucky,Grayson County,4,16,726,337,389
Kentucky,Grayson County,4,17,517,201,316
Kentucky,Grayson County,4,18,369,126,243
Kentucky,Grayson County,5,0,25792,12995,12797
Kentucky,Grayson County,5,1,1608,845,763
Kentucky,Grayson County,5,2,1714,890,824
Kentucky,Grayson County,5,3,1749,885,864
Kentucky,Grayson County,5,4,1633,890,743
Kentucky,Grayson County,5,5,1508,746,762
Kentucky,Grayson County,5,6,1394,729,665
Kentucky,Grayson County,5,7,1694,865,829
Kentucky,Grayson County,5,8,1608,813,795
Kentucky,Grayson County,5,9,1676,854,822
Kentucky,Grayson County,5,10,1784,937,847
Kentucky,Grayson County,5,11,1895,977,918
Kentucky,Grayson County,5,12,1815,910,905
Kentucky,Grayson County,5,13,1742,850,892
Kentucky,Grayson County,5,14,1317,641,676
Kentucky,Grayson County,5,15,1025,502,523
Kentucky,Grayson County,5,16,741,340,401
Kentucky,Grayson County,5,17,512,196,316
Kentucky,Grayson County,5,18,377,125,252
Kentucky,Grayson County,6,0,25948,13063,12885
Kentucky,Grayson County,6,1,1642,852,790
Kentucky,Grayson County,6,2,1724,905,819
Kentucky,Grayson County,6,3,1758,895,863
Kentucky,Grayson County,6,4,1645,888,757
Kentucky,Grayson County,6,5,1559,775,784
Kentucky,Grayson County,6,6,1409,715,694
Kentucky,Grayson County,6,7,1631,852,779
Kentucky,Grayson County,6,8,1642,841,801
Kentucky,Grayson County,6,9,1648,827,821
Kentucky,Grayson County,6,10,1721,909,812
Kentucky,Grayson County,6,11,1899,979,920
Kentucky,Grayson County,6,12,1831,909,922
Kentucky,Grayson County,6,13,1754,852,902
Kentucky,Grayson County,6,14,1339,665,674
Kentucky,Grayson County,6,15,1081,517,564
Kentucky,Grayson County,6,16,748,341,407
Kentucky,Grayson County,6,17,514,200,314
Kentucky,Grayson County,6,18,403,141,262
Kentucky,Grayson County,7,0,26066,13119,12947
Kentucky,Grayson County,7,1,1677,849,828
Kentucky,Grayson County,7,2,1721,912,809
Kentucky,Grayson County,7,3,1781,918,863
Kentucky,Grayson County,7,4,1644,877,767
Kentucky,Grayson County,7,5,1581,799,782
Kentucky,Grayson County,7,6,1437,736,701
Kentucky,Grayson County,7,7,1575,823,752
Kentucky,Grayson County,7,8,1645,839,806
Kentucky,Grayson County,7,9,1670,826,844
Kentucky,Grayson County,7,10,1660,885,775
Kentucky,Grayson County,7,11,1867,971,896
Kentucky,Grayson County,7,12,1874,920,954
Kentucky,Grayson County,7,13,1764,855,909
Kentucky,Grayson County,7,14,1420,704,716
Kentucky,Grayson County,7,15,1094,520,574
Kentucky,Grayson County,7,16,763,361,402
Kentucky,Grayson County,7,17,489,187,302
Kentucky,Grayson County,7,18,404,137,267
Kentucky,Grayson County,8,0,26138,13144,12994
Kentucky,Grayson County,8,1,1702,833,869
Kentucky,Grayson County,8,2,1709,916,793
Kentucky,Grayson County,8,3,1803,926,877
Kentucky,Grayson County,8,4,1586,834,752
Kentucky,Grayson County,8,5,1581,822,759
Kentucky,Grayson County,8,6,1497,750,747
Kentucky,Grayson County,8,7,1543,808,735
Kentucky,Grayson County,8,8,1649,846,803
Kentucky,Grayson County,8,9,1654,817,837
Kentucky,Grayson County,8,10,1650,888,762
Kentucky,Grayson County,8,11,1825,947,878
Kentucky,Grayson County,8,12,1895,937,958
Kentucky,Grayson County,8,13,1775,852,923
Kentucky,Grayson County,8,14,1503,752,751
Kentucky,Grayson County,8,15,1093,514,579
Kentucky,Grayson County,8,16,796,378,418
Kentucky,Grayson County,8,17,468,186,282
Kentucky,Grayson County,8,18,409,138,271
Kentucky,Grayson County,9,0,26093,13120,12973
Kentucky,Grayson County,9,1,1685,846,839
Kentucky,Grayson County,9,2,1646,847,799
Kentucky,Grayson County,9,3,1775,914,861
Kentucky,Grayson County,9,4,1637,842,795
Kentucky,Grayson County,9,5,1524,805,719
Kentucky,Grayson County,9,6,1610,792,818
Kentucky,Grayson County,9,7,1482,795,687
Kentucky,Grayson County,9,8,1669,864,805
Kentucky,Grayson County,9,9,1601,795,806
Kentucky,Grayson County,9,10,1627,858,769
Kentucky,Grayson County,9,11,1798,918,880
Kentucky,Grayson County,9,12,1865,937,928
Kentucky,Grayson County,9,13,1774,869,905
Kentucky,Grayson County,9,14,1605,799,806
Kentucky,Grayson County,9,15,1084,502,582
Kentucky,Grayson County,9,16,816,398,418
Kentucky,Grayson County,9,17,487,199,288
Kentucky,Grayson County,9,18,408,140,268
Kentucky,Grayson County,10,0,26286,13200,13086
Kentucky,Grayson County,10,1,1689,827,862
Kentucky,Grayson County,10,2,1655,865,790
Kentucky,Grayson County,10,3,1807,935,872
Kentucky,Grayson County,10,4,1643,844,799
Kentucky,Grayson County,10,5,1497,786,711
Kentucky,Grayson County,10,6,1662,848,814
Kentucky,Grayson County,10,7,1474,783,691
Kentucky,Grayson County,10,8,1695,876,819
Kentucky,Grayson County,10,9,1565,777,788
Kentucky,Grayson County,10,10,1653,847,806
Kentucky,Grayson County,10,11,1750,897,853
Kentucky,Grayson County,10,12,1898,965,933
Kentucky,Grayson County,10,13,1763,867,896
Kentucky,Grayson County,10,14,1595,765,830
Kentucky,Grayson County,10,15,1168,552,616
Kentucky,Grayson County,10,16,839,409,430
Kentucky,Grayson County,10,17,505,212,293
Kentucky,Grayson County,10,18,428,145,283
Kentucky,Grayson County,11,0,26293,13224,13069
Kentucky,Grayson County,11,1,1653,828,825
Kentucky,Grayson County,11,2,1659,838,821
Kentucky,Grayson County,11,3,1791,946,845
Kentucky,Grayson County,11,4,1630,850,780
Kentucky,Grayson County,11,5,1463,778,685
Kentucky,Grayson County,11,6,1729,883,846
Kentucky,Grayson County,11,7,1468,785,683
Kentucky,Grayson County,11,8,1637,840,797
Kentucky,Grayson County,11,9,1565,799,766
Kentucky,Grayson County,11,10,1649,833,816
Kentucky,Grayson County,11,11,1704,868,836
Kentucky,Grayson County,11,12,1911,984,927
Kentucky,Grayson County,11,13,1792,865,927
Kentucky,Grayson County,11,14,1610,766,844
Kentucky,Grayson County,11,15,1187,570,617
Kentucky,Grayson County,11,16,885,419,466
Kentucky,Grayson County,11,17,520,229,291
Kentucky,Grayson County,11,18,440,143,297
Kentucky,Grayson County,12,0,26427,13274,13153
Kentucky,Grayson County,12,1,1660,837,823
Kentucky,Grayson County,12,2,1681,832,849
Kentucky,Grayson County,12,3,1740,927,813
Kentucky,Grayson County,12,4,1634,864,770
Kentucky,Grayson County,12,5,1500,781,719
Kentucky,Grayson County,12,6,1751,894,857
Kentucky,Grayson County,12,7,1498,789,709
Kentucky,Grayson County,12,8,1568,823,745
Kentucky,Grayson County,12,9,1596,814,782
Kentucky,Grayson County,12,10,1643,822,821
Kentucky,Grayson County,12,11,1636,842,794
Kentucky,Grayson County,12,12,1908,991,917
Kentucky,Grayson County,12,13,1831,882,949
Kentucky,Grayson County,12,14,1636,758,878
Kentucky,Grayson County,12,15,1254,592,662
Kentucky,Grayson County,12,16,906,428,478
Kentucky,Grayson County,12,17,554,256,298
Kentucky,Grayson County,12,18,431,142,289
Kentucky,Green County,1,0,11258,5548,5710
Kentucky,Green County,1,1,681,336,345
Kentucky,Green County,1,2,698,380,318
Kentucky,Green County,1,3,712,380,332
Kentucky,Green County,1,4,711,352,359
Kentucky,Green County,1,5,529,273,256
Kentucky,Green County,1,6,567,285,282
Kentucky,Green County,1,7,683,330,353
Kentucky,Green County,1,8,698,360,338
Kentucky,Green County,1,9,719,348,371
Kentucky,Green County,1,10,889,449,440
Kentucky,Green County,1,11,874,442,432
Kentucky,Green County,1,12,776,379,397
Kentucky,Green County,1,13,775,377,398
Kentucky,Green County,1,14,593,284,309
Kentucky,Green County,1,15,487,231,256
Kentucky,Green County,1,16,372,178,194
Kentucky,Green County,1,17,236,82,154
Kentucky,Green County,1,18,258,82,176
Kentucky,Green County,2,0,11255,5547,5708
Kentucky,Green County,2,1,680,336,344
Kentucky,Green County,2,2,699,380,319
Kentucky,Green County,2,3,711,379,332
Kentucky,Green County,2,4,709,352,357
Kentucky,Green County,2,5,529,273,256
Kentucky,Green County,2,6,567,284,283
Kentucky,Green County,2,7,683,330,353
Kentucky,Green County,2,8,698,360,338
Kentucky,Green County,2,9,716,347,369
Kentucky,Green County,2,10,889,448,441
Kentucky,Green County,2,11,877,444,433
Kentucky,Green County,2,12,777,379,398
Kentucky,Green County,2,13,776,378,398
Kentucky,Green County,2,14,592,284,308
Kentucky,Green County,2,15,486,231,255
Kentucky,Green County,2,16,371,177,194
Kentucky,Green County,2,17,237,83,154
Kentucky,Green County,2,18,258,82,176
Kentucky,Green County,3,0,11230,5536,5694
Kentucky,Green County,3,1,673,331,342
Kentucky,Green County,3,2,698,374,324
Kentucky,Green County,3,3,708,375,333
Kentucky,Green County,3,4,703,355,348
Kentucky,Green County,3,5,532,275,257
Kentucky,Green County,3,6,567,287,280
Kentucky,Green County,3,7,676,324,352
Kentucky,Green County,3,8,697,359,338
Kentucky,Green County,3,9,715,349,366
Kentucky,Green County,3,10,877,443,434
Kentucky,Green County,3,11,878,445,433
Kentucky,Green County,3,12,782,383,399
Kentucky,Green County,3,13,778,379,399
Kentucky,Green County,3,14,593,286,307
Kentucky,Green County,3,15,487,228,259
Kentucky,Green County,3,16,368,175,193
Kentucky,Green County,3,17,242,87,155
Kentucky,Green County,3,18,256,81,175
Kentucky,Green County,4,0,11191,5519,5672
Kentucky,Green County,4,1,645,328,317
Kentucky,Green County,4,2,687,357,330
Kentucky,Green County,4,3,704,379,325
Kentucky,Green County,4,4,691,358,333
Kentucky,Green County,4,5,557,271,286
Kentucky,Green County,4,6,543,282,261
Kentucky,Green County,4,7,692,323,369
Kentucky,Green County,4,8,673,353,320
Kentucky,Green County,4,9,712,352,360
Kentucky,Green County,4,10,847,428,419
Kentucky,Green County,4,11,880,445,435
Kentucky,Green County,4,12,792,390,402
Kentucky,Green County,4,13,813,401,412
Kentucky,Green County,4,14,590,282,308
Kentucky,Green County,4,15,487,215,272
Kentucky,Green County,4,16,368,177,191
Kentucky,Green County,4,17,258,102,156
Kentucky,Green County,4,18,252,76,176
Kentucky,Green County,5,0,11277,5592,5685
Kentucky,Green County,5,1,636,333,303
Kentucky,Green County,5,2,719,389,330
Kentucky,Green County,5,3,709,374,335
Kentucky,Green County,5,4,684,367,317
Kentucky,Green County,5,5,570,271,299
Kentucky,Green County,5,6,536,288,248
Kentucky,Green County,5,7,687,312,375
Kentucky,Green County,5,8,690,360,330
Kentucky,Green County,5,9,685,345,340
Kentucky,Green County,5,10,847,417,430
Kentucky,Green County,5,11,874,439,435
Kentucky,Green County,5,12,820,417,403
Kentucky,Green County,5,13,808,401,407
Kentucky,Green County,5,14,613,287,326
Kentucky,Green County,5,15,509,232,277
Kentucky,Green County,5,16,350,165,185
Kentucky,Green County,5,17,282,118,164
Kentucky,Green County,5,18,258,77,181
Kentucky,Green County,6,0,11154,5505,5649
Kentucky,Green County,6,1,617,309,308
Kentucky,Green County,6,2,672,339,333
Kentucky,Green County,6,3,699,380,319
Kentucky,Green County,6,4,662,357,305
Kentucky,Green County,6,5,593,278,315
Kentucky,Green County,6,6,524,287,237
Kentucky,Green County,6,7,657,305,352
Kentucky,Green County,6,8,665,338,327
Kentucky,Green County,6,9,687,353,334
Kentucky,Green County,6,10,809,391,418
Kentucky,Green County,6,11,901,468,433
Kentucky,Green County,6,12,826,414,412
Kentucky,Green County,6,13,786,386,400
Kentucky,Green County,6,14,654,308,346
Kentucky,Green County,6,15,535,242,293
Kentucky,Green County,6,16,348,160,188
Kentucky,Green County,6,17,280,119,161
Kentucky,Green County,6,18,239,71,168
Kentucky,Green County,7,0,11017,5422,5595
Kentucky,Green County,7,1,580,284,296
Kentucky,Green County,7,2,652,321,331
Kentucky,Green County,7,3,695,384,311
Kentucky,Green County,7,4,627,333,294
Kentucky,Green County,7,5,579,290,289
Kentucky,Green County,7,6,532,276,256
Kentucky,Green County,7,7,626,295,331
Kentucky,Green County,7,8,639,308,331
Kentucky,Green County,7,9,714,371,343
Kentucky,Green County,7,10,732,343,389
Kentucky,Green County,7,11,880,453,427
Kentucky,Green County,7,12,855,440,415
Kentucky,Green County,7,13,756,358,398
Kentucky,Green County,7,14,707,349,358
Kentucky,Green County,7,15,529,242,287
Kentucky,Green County,7,16,391,179,212
Kentucky,Green County,7,17,281,120,161
Kentucky,Green County,7,18,242,76,166
Kentucky,Green County,8,0,10951,5376,5575
Kentucky,Green County,8,1,584,286,298
Kentucky,Green County,8,2,646,319,327
Kentucky,Green County,8,3,689,378,311
Kentucky,Green County,8,4,610,325,285
Kentucky,Green County,8,5,571,286,285
Kentucky,Green County,8,6,531,255,276
Kentucky,Green County,8,7,572,287,285
Kentucky,Green County,8,8,659,313,346
Kentucky,Green County,8,9,685,349,336
Kentucky,Green County,8,10,729,352,377
Kentucky,Green County,8,11,882,451,431
Kentucky,Green County,8,12,857,440,417
Kentucky,Green County,8,13,752,368,384
Kentucky,Green County,8,14,736,351,385
Kentucky,Green County,8,15,519,241,278
Kentucky,Green County,8,16,417,174,243
Kentucky,Green County,8,17,273,121,152
Kentucky,Green County,8,18,239,80,159
Kentucky,Green County,9,0,10969,5409,5560
Kentucky,Green County,9,1,563,257,306
Kentucky,Green County,9,2,668,342,326
Kentucky,Green County,9,3,670,361,309
Kentucky,Green County,9,4,622,338,284
Kentucky,Green County,9,5,561,293,268
Kentucky,Green County,9,6,577,293,284
Kentucky,Green County,9,7,533,278,255
Kentucky,Green County,9,8,660,303,357
Kentucky,Green County,9,9,658,338,320
Kentucky,Green County,9,10,741,363,378
Kentucky,Green County,9,11,858,427,431
Kentucky,Green County,9,12,869,452,417
Kentucky,Green County,9,13,768,375,393
Kentucky,Green County,9,14,762,367,395
Kentucky,Green County,9,15,523,249,274
Kentucky,Green County,9,16,401,163,238
Kentucky,Green County,9,17,273,124,149
Kentucky,Green County,9,18,262,86,176
Kentucky,Green County,10,0,11036,5418,5618
Kentucky,Green County,10,1,573,245,328
Kentucky,Green County,10,2,638,327,311
Kentucky,Green County,10,3,679,364,315
Kentucky,Green County,10,4,630,333,297
Kentucky,Green County,10,5,588,295,293
Kentucky,Green County,10,6,570,286,284
Kentucky,Green County,10,7,544,286,258
Kentucky,Green County,10,8,646,302,344
Kentucky,Green County,10,9,660,342,318
Kentucky,Green County,10,10,714,362,352
Kentucky,Green County,10,11,878,423,455
Kentucky,Green County,10,12,861,442,419
Kentucky,Green County,10,13,805,410,395
Kentucky,Green County,10,14,741,365,376
Kentucky,Green County,10,15,556,254,302
Kentucky,Green County,10,16,426,184,242
Kentucky,Green County,10,17,264,112,152
Kentucky,Green County,10,18,263,86,177
Kentucky,Green County,11,0,10998,5402,5596
Kentucky,Green County,11,1,592,256,336
Kentucky,Green County,11,2,619,320,299
Kentucky,Green County,11,3,671,341,330
Kentucky,Green County,11,4,630,335,295
Kentucky,Green County,11,5,570,311,259
Kentucky,Green County,11,6,605,282,323
Kentucky,Green County,11,7,512,273,239
Kentucky,Green County,11,8,661,315,346
Kentucky,Green County,11,9,624,311,313
Kentucky,Green County,11,10,701,360,341
Kentucky,Green County,11,11,836,394,442
Kentucky,Green County,11,12,890,470,420
Kentucky,Green County,11,13,804,409,395
Kentucky,Green County,11,14,737,365,372
Kentucky,Green County,11,15,575,266,309
Kentucky,Green County,11,16,441,189,252
Kentucky,Green County,11,17,276,121,155
Kentucky,Green County,11,18,254,84,170
Kentucky,Green County,12,0,10941,5372,5569
Kentucky,Green County,12,1,586,249,337
Kentucky,Green County,12,2,581,301,280
Kentucky,Green County,12,3,690,339,351
Kentucky,Green County,12,4,604,332,272
Kentucky,Green County,12,5,554,298,256
Kentucky,Green County,12,6,639,312,327
Kentucky,Green County,12,7,525,264,261
Kentucky,Green County,12,8,656,318,338
Kentucky,Green County,12,9,610,309,301
Kentucky,Green County,12,10,700,365,335
Kentucky,Green County,12,11,772,358,414
Kentucky,Green County,12,12,873,447,426
Kentucky,Green County,12,13,844,442,402
Kentucky,Green County,12,14,715,344,371
Kentucky,Green County,12,15,614,294,320
Kentucky,Green County,12,16,432,186,246
Kentucky,Green County,12,17,298,123,175
Kentucky,Green County,12,18,248,91,157
Kentucky,Greenup County,1,0,36910,17860,19050
Kentucky,Greenup County,1,1,2140,1088,1052
Kentucky,Greenup County,1,2,2310,1185,1125
Kentucky,Greenup County,1,3,2357,1220,1137
Kentucky,Greenup County,1,4,2401,1238,1163
Kentucky,Greenup County,1,5,1778,881,897
Kentucky,Greenup County,1,6,1907,960,947
Kentucky,Greenup County,1,7,2169,1094,1075
Kentucky,Greenup County,1,8,2365,1134,1231
Kentucky,Greenup County,1,9,2476,1173,1303
Kentucky,Greenup County,1,10,2703,1324,1379
Kentucky,Greenup County,1,11,2932,1432,1500
Kentucky,Greenup County,1,12,2605,1225,1380
Kentucky,Greenup County,1,13,2479,1180,1299
Kentucky,Greenup County,1,14,1974,927,1047
Kentucky,Greenup County,1,15,1538,716,822
Kentucky,Greenup County,1,16,1182,517,665
Kentucky,Greenup County,1,17,916,349,567
Kentucky,Greenup County,1,18,678,217,461
Kentucky,Greenup County,2,0,36906,17858,19048
Kentucky,Greenup County,2,1,2137,1087,1050
Kentucky,Greenup County,2,2,2308,1185,1123
Kentucky,Greenup County,2,3,2356,1218,1138
Kentucky,Greenup County,2,4,2403,1239,1164
Kentucky,Greenup County,2,5,1778,881,897
Kentucky,Greenup County,2,6,1907,960,947
Kentucky,Greenup County,2,7,2168,1094,1074
Kentucky,Greenup County,2,8,2362,1133,1229
Kentucky,Greenup County,2,9,2476,1173,1303
Kentucky,Greenup County,2,10,2706,1325,1381
Kentucky,Greenup County,2,11,2933,1432,1501
Kentucky,Greenup County,2,12,2605,1225,1380
Kentucky,Greenup County,2,13,2479,1180,1299
Kentucky,Greenup County,2,14,1974,927,1047
Kentucky,Greenup County,2,15,1538,716,822
Kentucky,Greenup County,2,16,1182,517,665
Kentucky,Greenup County,2,17,916,349,567
Kentucky,Greenup County,2,18,678,217,461
Kentucky,Greenup County,3,0,36885,17850,19035
Kentucky,Greenup County,3,1,2115,1072,1043
Kentucky,Greenup County,3,2,2315,1192,1123
Kentucky,Greenup County,3,3,2346,1211,1135
Kentucky,Greenup County,3,4,2364,1217,1147
Kentucky,Greenup County,3,5,1820,909,911
Kentucky,Greenup County,3,6,1899,954,945
Kentucky,Greenup County,3,7,2174,1102,1072
Kentucky,Greenup County,3,8,2342,1123,1219
Kentucky,Greenup County,3,9,2480,1173,1307
Kentucky,Greenup County,3,10,2693,1320,1373
Kentucky,Greenup County,3,11,2911,1424,1487
Kentucky,Greenup County,3,12,2616,1230,1386
Kentucky,Greenup County,3,13,2501,1189,1312
Kentucky,Greenup County,3,14,1969,926,1043
Kentucky,Greenup County,3,15,1538,716,822
Kentucky,Greenup County,3,16,1190,521,669
Kentucky,Greenup County,3,17,919,347,572
Kentucky,Greenup County,3,18,693,224,469
Kentucky,Greenup County,4,0,36841,17827,19014
Kentucky,Greenup County,4,1,2042,1049,993
Kentucky,Greenup County,4,2,2338,1194,1144
Kentucky,Greenup County,4,3,2341,1245,1096
Kentucky,Greenup County,4,4,2281,1170,1111
Kentucky,Greenup County,4,5,1888,964,924
Kentucky,Greenup County,4,6,1857,922,935
Kentucky,Greenup County,4,7,2176,1104,1072
Kentucky,Greenup County,4,8,2302,1105,1197
Kentucky,Greenup County,4,9,2535,1183,1352
Kentucky,Greenup County,4,10,2617,1278,1339
Kentucky,Greenup County,4,11,2808,1368,1440
Kentucky,Greenup County,4,12,2664,1254,1410
Kentucky,Greenup County,4,13,2626,1229,1397
Kentucky,Greenup County,4,14,1963,923,1040
Kentucky,Greenup County,4,15,1552,717,835
Kentucky,Greenup County,4,16,1226,540,686
Kentucky,Greenup County,4,17,899,339,560
Kentucky,Greenup County,4,18,726,243,483
Kentucky,Greenup County,5,0,36686,17764,18922
Kentucky,Greenup County,5,1,2035,1060,975
Kentucky,Greenup County,5,2,2336,1187,1149
Kentucky,Greenup County,5,3,2300,1205,1095
Kentucky,Greenup County,5,4,2189,1135,1054
Kentucky,Greenup County,5,5,1957,1015,942
Kentucky,Greenup County,5,6,1814,885,929
Kentucky,Greenup County,5,7,2147,1082,1065
Kentucky,Greenup County,5,8,2247,1106,1141
Kentucky,Greenup County,5,9,2504,1179,1325
Kentucky,Greenup County,5,10,2547,1235,1312
Kentucky,Greenup County,5,11,2728,1308,1420
Kentucky,Greenup County,5,12,2693,1279,1414
Kentucky,Greenup County,5,13,2594,1219,1375
Kentucky,Greenup County,5,14,2128,1013,1115
Kentucky,Greenup County,5,15,1585,715,870
Kentucky,Greenup County,5,16,1240,541,699
Kentucky,Greenup County,5,17,901,352,549
Kentucky,Greenup County,5,18,741,248,493
Kentucky,Greenup County,6,0,36483,17687,18796
Kentucky,Greenup County,6,1,2006,1053,953
Kentucky,Greenup County,6,2,2320,1161,1159
Kentucky,Greenup County,6,3,2310,1197,1113
Kentucky,Greenup County,6,4,2112,1113,999
Kentucky,Greenup County,6,5,1981,1050,931
Kentucky,Greenup County,6,6,1758,858,900
Kentucky,Greenup County,6,7,2132,1081,1051
Kentucky,Greenup County,6,8,2215,1116,1099
Kentucky,Greenup County,6,9,2469,1150,1319
Kentucky,Greenup County,6,10,2467,1189,1278
Kentucky,Greenup County,6,11,2645,1265,1380
Kentucky,Greenup County,6,12,2755,1312,1443
Kentucky,Greenup County,6,13,2512,1183,1329
Kentucky,Greenup County,6,14,2227,1047,1180
Kentucky,Greenup County,6,15,1628,740,888
Kentucky,Greenup County,6,16,1281,558,723
Kentucky,Greenup County,6,17,900,358,542
Kentucky,Greenup County,6,18,765,256,509
Kentucky,Greenup County,7,0,36303,17601,18702
Kentucky,Greenup County,7,1,1969,1037,932
Kentucky,Greenup County,7,2,2248,1131,1117
Kentucky,Greenup County,7,3,2338,1228,1110
Kentucky,Greenup County,7,4,2126,1103,1023
Kentucky,Greenup County,7,5,1994,1071,923
Kentucky,Greenup County,7,6,1794,877,917
Kentucky,Greenup County,7,7,2052,1024,1028
Kentucky,Greenup County,7,8,2214,1104,1110
Kentucky,Greenup County,7,9,2342,1107,1235
Kentucky,Greenup County,7,10,2454,1178,1276
Kentucky,Greenup County,7,11,2604,1257,1347
Kentucky,Greenup County,7,12,2771,1316,1455
Kentucky,Greenup County,7,13,2465,1142,1323
Kentucky,Greenup County,7,14,2260,1043,1217
Kentucky,Greenup County,7,15,1718,793,925
Kentucky,Greenup County,7,16,1276,561,715
Kentucky,Greenup County,7,17,878,369,509
Kentucky,Greenup County,7,18,800,260,540
Kentucky,Greenup County,8,0,36006,17466,18540
Kentucky,Greenup County,8,1,1946,1020,926
Kentucky,Greenup County,8,2,2179,1117,1062
Kentucky,Greenup County,8,3,2348,1208,1140
Kentucky,Greenup County,8,4,2091,1093,998
Kentucky,Greenup County,8,5,1948,1021,927
Kentucky,Greenup County,8,6,1793,906,887
Kentucky,Greenup County,8,7,2000,1003,997
Kentucky,Greenup County,8,8,2223,1113,1110
Kentucky,Greenup County,8,9,2299,1107,1192
Kentucky,Greenup County,8,10,2413,1128,1285
Kentucky,Greenup County,8,11,2553,1256,1297
Kentucky,Greenup County,8,12,2744,1303,1441
Kentucky,Greenup County,8,13,2440,1125,1315
Kentucky,Greenup County,8,14,2315,1050,1265
Kentucky,Greenup County,8,15,1742,792,950
Kentucky,Greenup County,8,16,1253,562,691
Kentucky,Greenup County,8,17,899,383,516
Kentucky,Greenup County,8,18,820,279,541
Kentucky,Greenup County,9,0,35824,17407,18417
Kentucky,Greenup County,9,1,1934,1005,929
Kentucky,Greenup County,9,2,2157,1123,1034
Kentucky,Greenup County,9,3,2345,1209,1136
Kentucky,Greenup County,9,4,2050,1094,956
Kentucky,Greenup County,9,5,1886,977,909
Kentucky,Greenup County,9,6,1934,995,939
Kentucky,Greenup County,9,7,1948,962,986
Kentucky,Greenup County,9,8,2207,1103,1104
Kentucky,Greenup County,9,9,2198,1065,1133
Kentucky,Greenup County,9,10,2400,1123,1277
Kentucky,Greenup County,9,11,2499,1217,1282
Kentucky,Greenup County,9,12,2630,1249,1381
Kentucky,Greenup County,9,13,2487,1165,1322
Kentucky,Greenup County,9,14,2406,1104,1302
Kentucky,Greenup County,9,15,1716,777,939
Kentucky,Greenup County,9,16,1274,558,716
Kentucky,Greenup County,9,17,921,395,526
Kentucky,Greenup County,9,18,832,286,546
Kentucky,Greenup County,10,0,35514,17295,18219
Kentucky,Greenup County,10,1,1911,985,926
Kentucky,Greenup County,10,2,2123,1139,984
Kentucky,Greenup County,10,3,2317,1179,1138
Kentucky,Greenup County,10,4,2010,1088,922
Kentucky,Greenup County,10,5,1804,934,870
Kentucky,Greenup County,10,6,2028,1061,967
Kentucky,Greenup County,10,7,1815,863,952
Kentucky,Greenup County,10,8,2169,1094,1075
Kentucky,Greenup County,10,9,2211,1088,1123
Kentucky,Greenup County,10,10,2378,1116,1262
Kentucky,Greenup County,10,11,2399,1153,1246
Kentucky,Greenup County,10,12,2526,1203,1323
Kentucky,Greenup County,10,13,2541,1197,1344
Kentucky,Greenup County,10,14,2344,1081,1263
Kentucky,Greenup County,10,15,1874,872,1002
Kentucky,Greenup County,10,16,1263,537,726
Kentucky,Greenup County,10,17,955,405,550
Kentucky,Greenup County,10,18,846,300,546
Kentucky,Greenup County,11,0,35332,17201,18131
Kentucky,Greenup County,11,1,1906,965,941
Kentucky,Greenup County,11,2,2076,1095,981
Kentucky,Greenup County,11,3,2275,1164,1111
Kentucky,Greenup County,11,4,2001,1083,918
Kentucky,Greenup County,11,5,1783,924,859
Kentucky,Greenup County,11,6,2111,1098,1013
Kentucky,Greenup County,11,7,1775,855,920
Kentucky,Greenup County,11,8,2134,1083,1051
Kentucky,Greenup County,11,9,2164,1073,1091
Kentucky,Greenup County,11,10,2382,1124,1258
Kentucky,Greenup County,11,11,2334,1122,1212
Kentucky,Greenup County,11,12,2435,1160,1275
Kentucky,Greenup County,11,13,2578,1220,1358
Kentucky,Greenup County,11,14,2293,1069,1224
Kentucky,Greenup County,11,15,1955,903,1052
Kentucky,Greenup County,11,16,1317,566,751
Kentucky,Greenup County,11,17,952,391,561
Kentucky,Greenup County,11,18,861,306,555
Kentucky,Greenup County,12,0,35098,17094,18004
Kentucky,Greenup County,12,1,1895,976,919
Kentucky,Greenup County,12,2,2026,1069,957
Kentucky,Greenup County,12,3,2232,1146,1086
Kentucky,Greenup County,12,4,2030,1088,942
Kentucky,Greenup County,12,5,1782,923,859
Kentucky,Greenup County,12,6,2114,1098,1016
Kentucky,Greenup County,12,7,1814,893,921
Kentucky,Greenup County,12,8,2020,1003,1017
Kentucky,Greenup County,12,9,2167,1061,1106
Kentucky,Greenup County,12,10,2279,1089,1190
Kentucky,Greenup County,12,11,2306,1110,1196
Kentucky,Greenup County,12,12,2390,1146,1244
Kentucky,Greenup County,12,13,2574,1207,1367
Kentucky,Greenup County,12,14,2274,1049,1225
Kentucky,Greenup County,12,15,1983,921,1062
Kentucky,Greenup County,12,16,1389,624,765
Kentucky,Greenup County,12,17,961,383,578
Kentucky,Greenup County,12,18,862,308,554
Kentucky,Hancock County,1,0,8565,4328,4237
Kentucky,Hancock County,1,1,556,307,249
Kentucky,Hancock County,1,2,658,356,302
Kentucky,Hancock County,1,3,612,303,309
Kentucky,Hancock County,1,4,588,299,289
Kentucky,Hancock County,1,5,408,216,192
Kentucky,Hancock County,1,6,416,191,225
Kentucky,Hancock County,1,7,535,264,271
Kentucky,Hancock County,1,8,572,297,275
Kentucky,Hancock County,1,9,591,296,295
Kentucky,Hancock County,1,10,653,331,322
Kentucky,Hancock County,1,11,620,315,305
Kentucky,Hancock County,1,12,598,324,274
Kentucky,Hancock County,1,13,562,281,281
Kentucky,Hancock County,1,14,428,205,223
Kentucky,Hancock County,1,15,289,151,138
Kentucky,Hancock County,1,16,227,110,117
Kentucky,Hancock County,1,17,129,47,82
Kentucky,Hancock County,1,18,123,35,88
Kentucky,Hancock County,2,0,8565,4328,4237
Kentucky,Hancock County,2,1,556,307,249
Kentucky,Hancock County,2,2,658,356,302
Kentucky,Hancock County,2,3,612,303,309
Kentucky,Hancock County,2,4,588,299,289
Kentucky,Hancock County,2,5,408,216,192
Kentucky,Hancock County,2,6,416,191,225
Kentucky,Hancock County,2,7,535,264,271
Kentucky,Hancock County,2,8,572,297,275
Kentucky,Hancock County,2,9,591,296,295
Kentucky,Hancock County,2,10,653,331,322
Kentucky,Hancock County,2,11,620,315,305
Kentucky,Hancock County,2,12,598,324,274
Kentucky,Hancock County,2,13,562,281,281
Kentucky,Hancock County,2,14,428,205,223
Kentucky,Hancock County,2,15,289,151,138
Kentucky,Hancock County,2,16,227,110,117
Kentucky,Hancock County,2,17,129,47,82
Kentucky,Hancock County,2,18,123,35,88
Kentucky,Hancock County,3,0,8551,4329,4222
Kentucky,Hancock County,3,1,550,304,246
Kentucky,Hancock County,3,2,650,353,297
Kentucky,Hancock County,3,3,622,315,307
Kentucky,Hancock County,3,4,586,297,289
Kentucky,Hancock County,3,5,415,221,194
Kentucky,Hancock County,3,6,412,190,222
Kentucky,Hancock County,3,7,535,263,272
Kentucky,Hancock County,3,8,567,295,272
Kentucky,Hancock County,3,9,587,292,295
Kentucky,Hancock County,3,10,655,336,319
Kentucky,Hancock County,3,11,625,315,310
Kentucky,Hancock County,3,12,593,320,273
Kentucky,Hancock County,3,13,558,277,281
Kentucky,Hancock County,3,14,427,206,221
Kentucky,Hancock County,3,15,293,153,140
Kentucky,Hancock County,3,16,225,108,117
Kentucky,Hancock County,3,17,131,51,80
Kentucky,Hancock County,3,18,120,33,87
Kentucky,Hancock County,4,0,8588,4356,4232
Kentucky,Hancock County,4,1,543,302,241
Kentucky,Hancock County,4,2,628,340,288
Kentucky,Hancock County,4,3,645,329,316
Kentucky,Hancock County,4,4,584,287,297
Kentucky,Hancock County,4,5,440,238,202
Kentucky,Hancock County,4,6,395,192,203
Kentucky,Hancock County,4,7,534,263,271
Kentucky,Hancock County,4,8,548,285,263
Kentucky,Hancock County,4,9,598,290,308
Kentucky,Hancock County,4,10,641,337,304
Kentucky,Hancock County,4,11,655,325,330
Kentucky,Hancock County,4,12,584,316,268
Kentucky,Hancock County,4,13,576,287,289
Kentucky,Hancock County,4,14,425,207,218
Kentucky,Hancock County,4,15,320,167,153
Kentucky,Hancock County,4,16,229,112,117
Kentucky,Hancock County,4,17,125,50,75
Kentucky,Hancock County,4,18,118,29,89
Kentucky,Hancock County,5,0,8642,4398,4244
Kentucky,Hancock County,5,1,568,308,260
Kentucky,Hancock County,5,2,619,343,276
Kentucky,Hancock County,5,3,638,328,310
Kentucky,Hancock County,5,4,567,283,284
Kentucky,Hancock County,5,5,459,251,208
Kentucky,Hancock County,5,6,407,198,209
Kentucky,Hancock County,5,7,521,257,264
Kentucky,Hancock County,5,8,538,269,269
Kentucky,Hancock County,5,9,593,310,283
Kentucky,Hancock County,5,10,637,327,310
Kentucky,Hancock County,5,11,654,321,333
Kentucky,Hancock County,5,12,613,320,293
Kentucky,Hancock County,5,13,542,280,262
Kentucky,Hancock County,5,14,473,230,243
Kentucky,Hancock County,5,15,332,171,161
Kentucky,Hancock County,5,16,227,113,114
Kentucky,Hancock County,5,17,130,59,71
Kentucky,Hancock County,5,18,124,30,94
Kentucky,Hancock County,6,0,8626,4403,4223
Kentucky,Hancock County,6,1,526,284,242
Kentucky,Hancock County,6,2,627,351,276
Kentucky,Hancock County,6,3,652,349,303
Kentucky,Hancock County,6,4,548,278,270
Kentucky,Hancock County,6,5,501,278,223
Kentucky,Hancock County,6,6,412,208,204
Kentucky,Hancock County,6,7,489,233,256
Kentucky,Hancock County,6,8,536,267,269
Kentucky,Hancock County,6,9,598,300,298
Kentucky,Hancock County,6,10,604,318,286
Kentucky,Hancock County,6,11,659,320,339
Kentucky,Hancock County,6,12,611,324,287
Kentucky,Hancock County,6,13,523,265,258
Kentucky,Hancock County,6,14,498,246,252
Kentucky,Hancock County,6,15,354,174,180
Kentucky,Hancock County,6,16,235,121,114
Kentucky,Hancock County,6,17,140,63,77
Kentucky,Hancock County,6,18,113,24,89
Kentucky,Hancock County,7,0,8681,4423,4258
Kentucky,Hancock County,7,1,539,277,262
Kentucky,Hancock County,7,2,609,341,268
Kentucky,Hancock County,7,3,693,366,327
Kentucky,Hancock County,7,4,544,283,261
Kentucky,Hancock County,7,5,522,265,257
Kentucky,Hancock County,7,6,413,225,188
Kentucky,Hancock County,7,7,462,211,251
Kentucky,Hancock County,7,8,570,288,282
Kentucky,Hancock County,7,9,567,290,277
Kentucky,Hancock County,7,10,594,310,284
Kentucky,Hancock County,7,11,659,325,334
Kentucky,Hancock County,7,12,597,310,287
Kentucky,Hancock County,7,13,531,278,253
Kentucky,Hancock County,7,14,506,251,255
Kentucky,Hancock County,7,15,373,182,191
Kentucky,Hancock County,7,16,234,120,114
Kentucky,Hancock County,7,17,155,73,82
Kentucky,Hancock County,7,18,113,28,85
Kentucky,Hancock County,8,0,8641,4433,4208
Kentucky,Hancock County,8,1,556,292,264
Kentucky,Hancock County,8,2,571,332,239
Kentucky,Hancock County,8,3,689,372,317
Kentucky,Hancock County,8,4,542,287,255
Kentucky,Hancock County,8,5,468,230,238
Kentucky,Hancock County,8,6,454,248,206
Kentucky,Hancock County,8,7,468,222,246
Kentucky,Hancock County,8,8,544,267,277
Kentucky,Hancock County,8,9,550,284,266
Kentucky,Hancock County,8,10,590,303,287
Kentucky,Hancock County,8,11,648,325,323
Kentucky,Hancock County,8,12,588,296,292
Kentucky,Hancock County,8,13,545,295,250
Kentucky,Hancock County,8,14,510,256,254
Kentucky,Hancock County,8,15,380,180,200
Kentucky,Hancock County,8,16,251,135,116
Kentucky,Hancock County,8,17,168,83,85
Kentucky,Hancock County,8,18,119,26,93
Kentucky,Hancock County,9,0,8723,4493,4230
Kentucky,Hancock County,9,1,590,312,278
Kentucky,Hancock County,9,2,576,345,231
Kentucky,Hancock County,9,3,664,359,305
Kentucky,Hancock County,9,4,589,316,273
Kentucky,Hancock County,9,5,480,229,251
Kentucky,Hancock County,9,6,475,258,217
Kentucky,Hancock County,9,7,460,235,225
Kentucky,Hancock County,9,8,537,256,281
Kentucky,Hancock County,9,9,543,272,271
Kentucky,Hancock County,9,10,595,303,292
Kentucky,Hancock County,9,11,627,329,298
Kentucky,Hancock County,9,12,599,293,306
Kentucky,Hancock County,9,13,533,293,240
Kentucky,Hancock County,9,14,512,251,261
Kentucky,Hancock County,9,15,375,183,192
Kentucky,Hancock County,9,16,271,143,128
Kentucky,Hancock County,9,17,171,84,87
Kentucky,Hancock County,9,18,126,32,94
Kentucky,Hancock County,10,0,8778,4529,4249
Kentucky,Hancock County,10,1,569,301,268
Kentucky,Hancock County,10,2,588,339,249
Kentucky,Hancock County,10,3,658,367,291
Kentucky,Hancock County,10,4,611,331,280
Kentucky,Hancock County,10,5,476,232,244
Kentucky,Hancock County,10,6,511,271,240
Kentucky,Hancock County,10,7,431,217,214
Kentucky,Hancock County,10,8,544,268,276
Kentucky,Hancock County,10,9,529,268,261
Kentucky,Hancock County,10,10,603,309,294
Kentucky,Hancock County,10,11,615,322,293
Kentucky,Hancock County,10,12,608,295,313
Kentucky,Hancock County,10,13,568,299,269
Kentucky,Hancock County,10,14,481,248,233
Kentucky,Hancock County,10,15,407,202,205
Kentucky,Hancock County,10,16,279,140,139
Kentucky,Hancock County,10,17,168,81,87
Kentucky,Hancock County,10,18,132,39,93
Kentucky,Hancock County,11,0,8738,4489,4249
Kentucky,Hancock County,11,1,581,314,267
Kentucky,Hancock County,11,2,574,297,277
Kentucky,Hancock County,11,3,650,375,275
Kentucky,Hancock County,11,4,590,318,272
Kentucky,Hancock County,11,5,463,221,242
Kentucky,Hancock County,11,6,538,282,256
Kentucky,Hancock County,11,7,442,240,202
Kentucky,Hancock County,11,8,512,245,267
Kentucky,Hancock County,11,9,520,262,258
Kentucky,Hancock County,11,10,602,303,299
Kentucky,Hancock County,11,11,579,308,271
Kentucky,Hancock County,11,12,620,299,321
Kentucky,Hancock County,11,13,571,304,267
Kentucky,Hancock County,11,14,467,240,227
Kentucky,Hancock County,11,15,420,205,215
Kentucky,Hancock County,11,16,296,145,151
Kentucky,Hancock County,11,17,178,85,93
Kentucky,Hancock County,11,18,135,46,89
Kentucky,Hancock County,12,0,8722,4485,4237
Kentucky,Hancock County,12,1,572,322,250
Kentucky,Hancock County,12,2,553,288,265
Kentucky,Hancock County,12,3,656,374,282
Kentucky,Hancock County,12,4,601,326,275
Kentucky,Hancock County,12,5,451,229,222
Kentucky,Hancock County,12,6,527,256,271
Kentucky,Hancock County,12,7,459,255,204
Kentucky,Hancock County,12,8,497,231,266
Kentucky,Hancock County,12,9,539,273,266
Kentucky,Hancock County,12,10,583,293,290
Kentucky,Hancock County,12,11,572,298,274
Kentucky,Hancock County,12,12,617,307,310
Kentucky,Hancock County,12,13,554,292,262
Kentucky,Hancock County,12,14,479,246,233
Kentucky,Hancock County,12,15,428,210,218
Kentucky,Hancock County,12,16,314,148,166
Kentucky,Hancock County,12,17,166,79,87
Kentucky,Hancock County,12,18,154,58,96
Kentucky,Hardin County,1,0,105543,52663,52880
Kentucky,Hardin County,1,1,8010,4100,3910
Kentucky,Hardin County,1,2,7336,3739,3597
Kentucky,Hardin County,1,3,7526,3896,3630
Kentucky,Hardin County,1,4,7352,3900,3452
Kentucky,Hardin County,1,5,7671,4292,3379
Kentucky,Hardin County,1,6,7946,4132,3814
Kentucky,Hardin County,1,7,6992,3499,3493
Kentucky,Hardin County,1,8,7012,3539,3473
Kentucky,Hardin County,1,9,7074,3536,3538
Kentucky,Hardin County,1,10,8091,3979,4112
Kentucky,Hardin County,1,11,7492,3618,3874
Kentucky,Hardin County,1,12,6376,3071,3305
Kentucky,Hardin County,1,13,5057,2450,2607
Kentucky,Hardin County,1,14,3764,1775,1989
Kentucky,Hardin County,1,15,2846,1234,1612
Kentucky,Hardin County,1,16,2181,917,1264
Kentucky,Hardin County,1,17,1501,578,923
Kentucky,Hardin County,1,18,1316,408,908
Kentucky,Hardin County,2,0,105537,52657,52880
Kentucky,Hardin County,2,1,8008,4099,3909
Kentucky,Hardin County,2,2,7335,3738,3597
Kentucky,Hardin County,2,3,7527,3897,3630
Kentucky,Hardin County,2,4,7352,3899,3453
Kentucky,Hardin County,2,5,7670,4292,3378
Kentucky,Hardin County,2,6,7944,4130,3814
Kentucky,Hardin County,2,7,6992,3499,3493
Kentucky,Hardin County,2,8,7011,3539,3472
Kentucky,Hardin County,2,9,7075,3536,3539
Kentucky,Hardin County,2,10,8091,3979,4112
Kentucky,Hardin County,2,11,7491,3617,3874
Kentucky,Hardin County,2,12,6376,3071,3305
Kentucky,Hardin County,2,13,5055,2448,2607
Kentucky,Hardin County,2,14,3764,1775,1989
Kentucky,Hardin County,2,15,2847,1234,1613
Kentucky,Hardin County,2,16,2182,918,1264
Kentucky,Hardin County,2,17,1501,578,923
Kentucky,Hardin County,2,18,1316,408,908
Kentucky,Hardin County,3,0,106950,53446,53504
Kentucky,Hardin County,3,1,8211,4180,4031
Kentucky,Hardin County,3,2,7496,3823,3673
Kentucky,Hardin County,3,3,7595,3933,3662
Kentucky,Hardin County,3,4,7437,3959,3478
Kentucky,Hardin County,3,5,7868,4403,3465
Kentucky,Hardin County,3,6,8134,4245,3889
Kentucky,Hardin County,3,7,7191,3617,3574
Kentucky,Hardin County,3,8,7070,3576,3494
Kentucky,Hardin County,3,9,7115,3572,3543
Kentucky,Hardin County,3,10,8119,3999,4120
Kentucky,Hardin County,3,11,7528,3636,3892
Kentucky,Hardin County,3,12,6434,3101,3333
Kentucky,Hardin County,3,13,5123,2481,2642
Kentucky,Hardin County,3,14,3765,1770,1995
Kentucky,Hardin County,3,15,2826,1232,1594
Kentucky,Hardin County,3,16,2191,920,1271
Kentucky,Hardin County,3,17,1529,591,938
Kentucky,Hardin County,3,18,1318,408,910
Kentucky,Hardin County,4,0,107497,53650,53847
Kentucky,Hardin County,4,1,8060,4114,3946
Kentucky,Hardin County,4,2,7607,3886,3721
Kentucky,Hardin County,4,3,7657,3990,3667
Kentucky,Hardin County,4,4,7489,4027,3462
Kentucky,Hardin County,4,5,7734,4293,3441
Kentucky,Hardin County,4,6,7546,3934,3612
Kentucky,Hardin County,4,7,7246,3619,3627
Kentucky,Hardin County,4,8,6994,3508,3486
Kentucky,Hardin County,4,9,7267,3651,3616
Kentucky,Hardin County,4,10,8179,4047,4132
Kentucky,Hardin County,4,11,7808,3752,4056
Kentucky,Hardin County,4,12,6654,3204,3450
Kentucky,Hardin County,4,13,5461,2620,2841
Kentucky,Hardin County,4,14,3786,1750,2036
Kentucky,Hardin County,4,15,2856,1268,1588
Kentucky,Hardin County,4,16,2227,934,1293
Kentucky,Hardin County,4,17,1600,630,970
Kentucky,Hardin County,4,18,1326,423,903
Kentucky,Hardin County,5,0,108198,54428,53770
Kentucky,Hardin County,5,1,7648,3932,3716
Kentucky,Hardin County,5,2,7661,3887,3774
Kentucky,Hardin County,5,3,7450,3853,3597
Kentucky,Hardin County,5,4,7451,4025,3426
Kentucky,Hardin County,5,5,8670,5043,3627
Kentucky,Hardin County,5,6,7586,4065,3521
Kentucky,Hardin County,5,7,7195,3605,3590
Kentucky,Hardin County,5,8,6843,3455,3388
Kentucky,Hardin County,5,9,7292,3615,3677
Kentucky,Hardin County,5,10,7822,3957,3865
Kentucky,Hardin County,5,11,7876,3771,4105
Kentucky,Hardin County,5,12,6807,3279,3528
Kentucky,Hardin County,5,13,5556,2694,2862
Kentucky,Hardin County,5,14,4076,1857,2219
Kentucky,Hardin County,5,15,3026,1340,1686
Kentucky,Hardin County,5,16,2208,926,1282
Kentucky,Hardin County,5,17,1647,674,973
Kentucky,Hardin County,5,18,1384,450,934
Kentucky,Hardin County,6,0,108969,54719,54250
Kentucky,Hardin County,6,1,7667,3931,3736
Kentucky,Hardin County,6,2,7669,3883,3786
Kentucky,Hardin County,6,3,7422,3839,3583
Kentucky,Hardin County,6,4,7524,4078,3446
Kentucky,Hardin County,6,5,8806,5064,3742
Kentucky,Hardin County,6,6,7686,4098,3588
Kentucky,Hardin County,6,7,7208,3630,3578
Kentucky,Hardin County,6,8,6768,3458,3310
Kentucky,Hardin County,6,9,7321,3605,3716
Kentucky,Hardin County,6,10,7419,3707,3712
Kentucky,Hardin County,6,11,8070,3925,4145
Kentucky,Hardin County,6,12,6916,3293,3623
Kentucky,Hardin County,6,13,5681,2757,2924
Kentucky,Hardin County,6,14,4242,1918,2324
Kentucky,Hardin County,6,15,3231,1456,1775
Kentucky,Hardin County,6,16,2232,916,1316
Kentucky,Hardin County,6,17,1674,686,988
Kentucky,Hardin County,6,18,1433,475,958
Kentucky,Hardin County,7,0,108483,54152,54331
Kentucky,Hardin County,7,1,7590,3867,3723
Kentucky,Hardin County,7,2,7671,3901,3770
Kentucky,Hardin County,7,3,7408,3808,3600
Kentucky,Hardin County,7,4,7288,3904,3384
Kentucky,Hardin County,7,5,8392,4725,3667
Kentucky,Hardin County,7,6,7624,4003,3621
Kentucky,Hardin County,7,7,7150,3608,3542
Kentucky,Hardin County,7,8,6826,3400,3426
Kentucky,Hardin County,7,9,7166,3600,3566
Kentucky,Hardin County,7,10,7179,3583,3596
Kentucky,Hardin County,7,11,8050,3907,4143
Kentucky,Hardin County,7,12,7105,3371,3734
Kentucky,Hardin County,7,13,5744,2758,2986
Kentucky,Hardin County,7,14,4481,2086,2395
Kentucky,Hardin County,7,15,3338,1498,1840
Kentucky,Hardin County,7,16,2320,940,1380
Kentucky,Hardin County,7,17,1667,693,974
Kentucky,Hardin County,7,18,1484,500,984
Kentucky,Hardin County,8,0,106272,52967,53305
Kentucky,Hardin County,8,1,7169,3626,3543
Kentucky,Hardin County,8,2,7248,3676,3572
Kentucky,Hardin County,8,3,7209,3683,3526
Kentucky,Hardin County,8,4,7289,3912,3377
Kentucky,Hardin County,8,5,7649,4366,3283
Kentucky,Hardin County,8,6,7151,3707,3444
Kentucky,Hardin County,8,7,6934,3542,3392
Kentucky,Hardin County,8,8,6812,3361,3451
Kentucky,Hardin County,8,9,6910,3491,3419
Kentucky,Hardin County,8,10,6937,3484,3453
Kentucky,Hardin County,8,11,7917,3839,4078
Kentucky,Hardin County,8,12,7263,3458,3805
Kentucky,Hardin County,8,13,6008,2849,3159
Kentucky,Hardin County,8,14,4765,2243,2522
Kentucky,Hardin County,8,15,3380,1511,1869
Kentucky,Hardin County,8,16,2420,991,1429
Kentucky,Hardin County,8,17,1645,687,958
Kentucky,Hardin County,8,18,1566,541,1025
Kentucky,Hardin County,9,0,106964,53258,53706
Kentucky,Hardin County,9,1,7212,3662,3550
Kentucky,Hardin County,9,2,7285,3731,3554
Kentucky,Hardin County,9,3,7326,3701,3625
Kentucky,Hardin County,9,4,7205,3879,3326
Kentucky,Hardin County,9,5,7499,4287,3212
Kentucky,Hardin County,9,6,7438,3835,3603
Kentucky,Hardin County,9,7,6922,3487,3435
Kentucky,Hardin County,9,8,6966,3441,3525
Kentucky,Hardin County,9,9,6638,3341,3297
Kentucky,Hardin County,9,10,6940,3482,3458
Kentucky,Hardin County,9,11,7737,3817,3920
Kentucky,Hardin County,9,12,7394,3515,3879
Kentucky,Hardin County,9,13,6177,2918,3259
Kentucky,Hardin County,9,14,5018,2363,2655
Kentucky,Hardin County,9,15,3410,1519,1891
Kentucky,Hardin County,9,16,2468,1015,1453
Kentucky,Hardin County,9,17,1708,698,1010
Kentucky,Hardin County,9,18,1621,567,1054
Kentucky,Hardin County,10,0,108161,53891,54270
Kentucky,Hardin County,10,1,7253,3725,3528
Kentucky,Hardin County,10,2,7216,3675,3541
Kentucky,Hardin County,10,3,7516,3821,3695
Kentucky,Hardin County,10,4,7166,3835,3331
Kentucky,Hardin County,10,5,7451,4266,3185
Kentucky,Hardin County,10,6,7592,3912,3680
Kentucky,Hardin County,10,7,6956,3503,3453
Kentucky,Hardin County,10,8,7120,3540,3580
Kentucky,Hardin County,10,9,6611,3301,3310
Kentucky,Hardin County,10,10,7076,3509,3567
Kentucky,Hardin County,10,11,7473,3745,3728
Kentucky,Hardin County,10,12,7499,3557,3942
Kentucky,Hardin County,10,13,6408,3040,3368
Kentucky,Hardin County,10,14,5120,2456,2664
Kentucky,Hardin County,10,15,3693,1619,2074
Kentucky,Hardin County,10,16,2645,1112,1533
Kentucky,Hardin County,10,17,1692,684,1008
Kentucky,Hardin County,10,18,1674,591,1083
Kentucky,Hardin County,11,0,110279,55013,55266
Kentucky,Hardin County,11,1,7428,3768,3660
Kentucky,Hardin County,11,2,7388,3819,3569
Kentucky,Hardin County,11,3,7772,3998,3774
Kentucky,Hardin County,11,4,7206,3850,3356
Kentucky,Hardin County,11,5,7454,4293,3161
Kentucky,Hardin County,11,6,7719,3966,3753
Kentucky,Hardin County,11,7,7179,3594,3585
Kentucky,Hardin County,11,8,7467,3712,3755
Kentucky,Hardin County,11,9,6765,3420,3345
Kentucky,Hardin County,11,10,7128,3539,3589
Kentucky,Hardin County,11,11,7052,3491,3561
Kentucky,Hardin County,11,12,7729,3760,3969
Kentucky,Hardin County,11,13,6552,3074,3478
Kentucky,Hardin County,11,14,5268,2515,2753
Kentucky,Hardin County,11,15,3898,1710,2188
Kentucky,Hardin County,11,16,2825,1221,1604
Kentucky,Hardin County,11,17,1732,691,1041
Kentucky,Hardin County,11,18,1717,592,1125
Kentucky,Hardin County,12,0,110958,55356,55602
Kentucky,Hardin County,12,1,7394,3747,3647
Kentucky,Hardin County,12,2,7600,3950,3650
Kentucky,Hardin County,12,3,7702,3964,3738
Kentucky,Hardin County,12,4,7135,3782,3353
Kentucky,Hardin County,12,5,7332,4206,3126
Kentucky,Hardin County,12,6,7814,4101,3713
Kentucky,Hardin County,12,7,7298,3616,3682
Kentucky,Hardin County,12,8,7610,3819,3791
Kentucky,Hardin County,12,9,6852,3418,3434
Kentucky,Hardin County,12,10,6983,3522,3461
Kentucky,Hardin County,12,11,6856,3375,3481
Kentucky,Hardin County,12,12,7645,3707,3938
Kentucky,Hardin County,12,13,6710,3135,3575
Kentucky,Hardin County,12,14,5380,2553,2827
Kentucky,Hardin County,12,15,4176,1876,2300
Kentucky,Hardin County,12,16,2914,1265,1649
Kentucky,Hardin County,12,17,1827,708,1119
Kentucky,Hardin County,12,18,1730,612,1118
Kentucky,Harlan County,1,0,29278,14273,15005
Kentucky,Harlan County,1,1,1890,962,928
Kentucky,Harlan County,1,2,1733,913,820
Kentucky,Harlan County,1,3,1865,925,940
Kentucky,Harlan County,1,4,1974,1011,963
Kentucky,Harlan County,1,5,1721,890,831
Kentucky,Harlan County,1,6,1703,836,867
Kentucky,Harlan County,1,7,1719,847,872
Kentucky,Harlan County,1,8,1850,911,939
Kentucky,Harlan County,1,9,1946,968,978
Kentucky,Harlan County,1,10,2080,978,1102
Kentucky,Harlan County,1,11,2281,1116,1165
Kentucky,Harlan County,1,12,2291,1126,1165
Kentucky,Harlan County,1,13,2046,992,1054
Kentucky,Harlan County,1,14,1356,661,695
Kentucky,Harlan County,1,15,1018,469,549
Kentucky,Harlan County,1,16,722,306,416
Kentucky,Harlan County,1,17,594,230,364
Kentucky,Harlan County,1,18,489,132,357
Kentucky,Harlan County,2,0,29278,14273,15005
Kentucky,Harlan County,2,1,1890,962,928
Kentucky,Harlan County,2,2,1733,913,820
Kentucky,Harlan County,2,3,1865,925,940
Kentucky,Harlan County,2,4,1974,1011,963
Kentucky,Harlan County,2,5,1721,890,831
Kentucky,Harlan County,2,6,1703,836,867
Kentucky,Harlan County,2,7,1719,847,872
Kentucky,Harlan County,2,8,1850,911,939
Kentucky,Harlan County,2,9,1946,968,978
Kentucky,Harlan County,2,10,2080,978,1102
Kentucky,Harlan County,2,11,2281,1116,1165
Kentucky,Harlan County,2,12,2291,1126,1165
Kentucky,Harlan County,2,13,2046,992,1054
Kentucky,Harlan County,2,14,1356,661,695
Kentucky,Harlan County,2,15,1018,469,549
Kentucky,Harlan County,2,16,722,306,416
Kentucky,Harlan County,2,17,594,230,364
Kentucky,Harlan County,2,18,489,132,357
Kentucky,Harlan County,3,0,29222,14256,14966
Kentucky,Harlan County,3,1,1881,956,925
Kentucky,Harlan County,3,2,1743,923,820
Kentucky,Harlan County,3,3,1845,913,932
Kentucky,Harlan County,3,4,1940,996,944
Kentucky,Harlan County,3,5,1753,906,847
Kentucky,Harlan County,3,6,1702,832,870
Kentucky,Harlan County,3,7,1714,849,865
Kentucky,Harlan County,3,8,1840,905,935
Kentucky,Harlan County,3,9,1938,972,966
Kentucky,Harlan County,3,10,2083,978,1105
Kentucky,Harlan County,3,11,2263,1106,1157
Kentucky,Harlan County,3,12,2283,1120,1163
Kentucky,Harlan County,3,13,2052,997,1055
Kentucky,Harlan County,3,14,1365,665,700
Kentucky,Harlan County,3,15,1017,469,548
Kentucky,Harlan County,3,16,719,305,414
Kentucky,Harlan County,3,17,590,229,361
Kentucky,Harlan County,3,18,494,135,359
Kentucky,Harlan County,4,0,29129,14189,14940
Kentucky,Harlan County,4,1,1900,951,949
Kentucky,Harlan County,4,2,1770,939,831
Kentucky,Harlan County,4,3,1794,873,921
Kentucky,Harlan County,4,4,1831,955,876
Kentucky,Harlan County,4,5,1834,942,892
Kentucky,Harlan County,4,6,1713,844,869
Kentucky,Harlan County,4,7,1705,841,864
Kentucky,Harlan County,4,8,1792,878,914
Kentucky,Harlan County,4,9,1890,970,920
Kentucky,Harlan County,4,10,2106,988,1118
Kentucky,Harlan County,4,11,2179,1055,1124
Kentucky,Harlan County,4,12,2263,1103,1160
Kentucky,Harlan County,4,13,2107,1026,1081
Kentucky,Harlan County,4,14,1407,682,725
Kentucky,Harlan County,4,15,1018,468,550
Kentucky,Harlan County,4,16,736,319,417
Kentucky,Harlan County,4,17,575,214,361
Kentucky,Harlan County,4,18,509,141,368
Kentucky,Harlan County,5,0,28681,13942,14739
Kentucky,Harlan County,5,1,1889,936,953
Kentucky,Harlan County,5,2,1782,932,850
Kentucky,Harlan County,5,3,1777,893,884
Kentucky,Harlan County,5,4,1664,831,833
Kentucky,Harlan County,5,5,1792,909,883
Kentucky,Harlan County,5,6,1690,850,840
Kentucky,Harlan County,5,7,1710,826,884
Kentucky,Harlan County,5,8,1737,870,867
Kentucky,Harlan County,5,9,1832,930,902
Kentucky,Harlan County,5,10,2095,998,1097
Kentucky,Harlan County,5,11,2065,974,1091
Kentucky,Harlan County,5,12,2248,1107,1141
Kentucky,Harlan County,5,13,2042,983,1059
Kentucky,Harlan County,5,14,1532,754,778
Kentucky,Harlan County,5,15,1002,452,550
Kentucky,Harlan County,5,16,760,345,415
Kentucky,Harlan County,5,17,554,202,352
Kentucky,Harlan County,5,18,510,150,360
Kentucky,Harlan County,6,0,28489,13834,14655
Kentucky,Harlan County,6,1,1924,965,959
Kentucky,Harlan County,6,2,1785,916,869
Kentucky,Harlan County,6,3,1732,879,853
Kentucky,Harlan County,6,4,1634,821,813
Kentucky,Harlan County,6,5,1802,909,893
Kentucky,Harlan County,6,6,1736,873,863
Kentucky,Harlan County,6,7,1704,838,866
Kentucky,Harlan County,6,8,1682,845,837
Kentucky,Harlan County,6,9,1798,900,898
Kentucky,Harlan County,6,10,1968,958,1010
Kentucky,Harlan County,6,11,2036,938,1098
Kentucky,Harlan County,6,12,2191,1063,1128
Kentucky,Harlan County,6,13,2086,1017,1069
Kentucky,Harlan County,6,14,1559,734,825
Kentucky,Harlan County,6,15,1036,483,553
Kentucky,Harlan County,6,16,775,346,429
Kentucky,Harlan County,6,17,537,198,339
Kentucky,Harlan County,6,18,504,151,353
Kentucky,Harlan County,7,0,28014,13604,14410
Kentucky,Harlan County,7,1,1894,948,946
Kentucky,Harlan County,7,2,1769,919,850
Kentucky,Harlan County,7,3,1672,846,826
Kentucky,Harlan County,7,4,1580,806,774
Kentucky,Harlan County,7,5,1738,861,877
Kentucky,Harlan County,7,6,1755,876,879
Kentucky,Harlan County,7,7,1622,806,816
Kentucky,Harlan County,7,8,1631,801,830
Kentucky,Harlan County,7,9,1755,870,885
Kentucky,Harlan County,7,10,1904,944,960
Kentucky,Harlan County,7,11,1990,928,1062
Kentucky,Harlan County,7,12,2159,1023,1136
Kentucky,Harlan County,7,13,2029,1014,1015
Kentucky,Harlan County,7,14,1658,777,881
Kentucky,Harlan County,7,15,1066,494,572
Kentucky,Harlan County,7,16,769,336,433
Kentucky,Harlan County,7,17,526,203,323
Kentucky,Harlan County,7,18,497,152,345
Kentucky,Harlan County,8,0,27506,13327,14179
Kentucky,Harlan County,8,1,1847,915,932
Kentucky,Harlan County,8,2,1693,858,835
Kentucky,Harlan County,8,3,1645,854,791
Kentucky,Harlan County,8,4,1517,751,766
Kentucky,Harlan County,8,5,1647,823,824
Kentucky,Harlan County,8,6,1729,875,854
Kentucky,Harlan County,8,7,1593,788,805
Kentucky,Harlan County,8,8,1608,796,812
Kentucky,Harlan County,8,9,1724,848,876
Kentucky,Harlan County,8,10,1828,911,917
Kentucky,Harlan County,8,11,1944,898,1046
Kentucky,Harlan County,8,12,2107,1007,1100
Kentucky,Harlan County,8,13,2008,972,1036
Kentucky,Harlan County,8,14,1742,832,910
Kentucky,Harlan County,8,15,1095,504,591
Kentucky,Harlan County,8,16,767,342,425
Kentucky,Harlan County,8,17,511,201,310
Kentucky,Harlan County,8,18,501,152,349
Kentucky,Harlan County,9,0,26996,13002,13994
Kentucky,Harlan County,9,1,1789,879,910
Kentucky,Harlan County,9,2,1715,857,858
Kentucky,Harlan County,9,3,1621,853,768
Kentucky,Harlan County,9,4,1458,728,730
Kentucky,Harlan County,9,5,1476,737,739
Kentucky,Harlan County,9,6,1769,866,903
Kentucky,Harlan County,9,7,1563,751,812
Kentucky,Harlan County,9,8,1567,783,784
Kentucky,Harlan County,9,9,1653,816,837
Kentucky,Harlan County,9,10,1748,880,868
Kentucky,Harlan County,9,11,1947,896,1051
Kentucky,Harlan County,9,12,2000,938,1062
Kentucky,Harlan County,9,13,1990,964,1026
Kentucky,Harlan County,9,14,1767,833,934
Kentucky,Harlan County,9,15,1133,509,624
Kentucky,Harlan County,9,16,771,346,425
Kentucky,Harlan County,9,17,534,208,326
Kentucky,Harlan County,9,18,495,158,337
Kentucky,Harlan County,10,0,26676,12826,13850
Kentucky,Harlan County,10,1,1774,866,908
Kentucky,Harlan County,10,2,1706,845,861
Kentucky,Harlan County,10,3,1628,843,785
Kentucky,Harlan County,10,4,1477,738,739
Kentucky,Harlan County,10,5,1362,679,683
Kentucky,Harlan County,10,6,1789,872,917
Kentucky,Harlan County,10,7,1503,730,773
Kentucky,Harlan County,10,8,1559,774,785
Kentucky,Harlan County,10,9,1583,800,783
Kentucky,Harlan County,10,10,1706,847,859
Kentucky,Harlan County,10,11,1912,908,1004
Kentucky,Harlan County,10,12,1884,859,1025
Kentucky,Harlan County,10,13,1999,973,1026
Kentucky,Harlan County,10,14,1716,799,917
Kentucky,Harlan County,10,15,1243,573,670
Kentucky,Harlan County,10,16,773,330,443
Kentucky,Harlan County,10,17,548,224,324
Kentucky,Harlan County,10,18,514,166,348
Kentucky,Harlan County,11,0,26309,12614,13695
Kentucky,Harlan County,11,1,1706,846,860
Kentucky,Harlan County,11,2,1732,851,881
Kentucky,Harlan County,11,3,1631,820,811
Kentucky,Harlan County,11,4,1431,727,704
Kentucky,Harlan County,11,5,1330,655,675
Kentucky,Harlan County,11,6,1713,832,881
Kentucky,Harlan County,11,7,1545,752,793
Kentucky,Harlan County,11,8,1533,764,769
Kentucky,Harlan County,11,9,1516,759,757
Kentucky,Harlan County,11,10,1670,819,851
Kentucky,Harlan County,11,11,1779,864,915
Kentucky,Harlan County,11,12,1851,823,1028
Kentucky,Harlan County,11,13,1963,933,1030
Kentucky,Harlan County,11,14,1762,847,915
Kentucky,Harlan County,11,15,1262,574,688
Kentucky,Harlan County,11,16,810,356,454
Kentucky,Harlan County,11,17,556,220,336
Kentucky,Harlan County,11,18,519,172,347
Kentucky,Harlan County,12,0,26010,12439,13571
Kentucky,Harlan County,12,1,1636,787,849
Kentucky,Harlan County,12,2,1763,873,890
Kentucky,Harlan County,12,3,1648,841,807
Kentucky,Harlan County,12,4,1395,710,685
Kentucky,Harlan County,12,5,1278,639,639
Kentucky,Harlan County,12,6,1709,825,884
Kentucky,Harlan County,12,7,1559,764,795
Kentucky,Harlan County,12,8,1506,744,762
Kentucky,Harlan County,12,9,1465,718,747
Kentucky,Harlan County,12,10,1623,797,826
Kentucky,Harlan County,12,11,1720,838,882
Kentucky,Harlan County,12,12,1809,803,1006
Kentucky,Harlan County,12,13,1901,876,1025
Kentucky,Harlan County,12,14,1736,859,877
Kentucky,Harlan County,12,15,1344,603,741
Kentucky,Harlan County,12,16,841,369,472
Kentucky,Harlan County,12,17,559,218,341
Kentucky,Harlan County,12,18,518,175,343
Kentucky,Harrison County,1,0,18846,9216,9630
Kentucky,Harrison County,1,1,1155,583,572
Kentucky,Harrison County,1,2,1259,648,611
Kentucky,Harrison County,1,3,1328,686,642
Kentucky,Harrison County,1,4,1315,688,627
Kentucky,Harrison County,1,5,896,435,461
Kentucky,Harrison County,1,6,996,485,511
Kentucky,Harrison County,1,7,1031,498,533
Kentucky,Harrison County,1,8,1234,609,625
Kentucky,Harrison County,1,9,1370,691,679
Kentucky,Harrison County,1,10,1487,712,775
Kentucky,Harrison County,1,11,1506,770,736
Kentucky,Harrison County,1,12,1303,610,693
Kentucky,Harrison County,1,13,1154,587,567
Kentucky,Harrison County,1,14,890,427,463
Kentucky,Harrison County,1,15,692,322,370
Kentucky,Harrison County,1,16,482,188,294
Kentucky,Harrison County,1,17,398,166,232
Kentucky,Harrison County,1,18,350,111,239
Kentucky,Harrison County,2,0,18850,9219,9631
Kentucky,Harrison County,2,1,1155,583,572
Kentucky,Harrison County,2,2,1260,649,611
Kentucky,Harrison County,2,3,1329,687,642
Kentucky,Harrison County,2,4,1315,688,627
Kentucky,Harrison County,2,5,896,435,461
Kentucky,Harrison County,2,6,996,485,511
Kentucky,Harrison County,2,7,1033,499,534
Kentucky,Harrison County,2,8,1234,609,625
Kentucky,Harrison County,2,9,1368,690,678
Kentucky,Harrison County,2,10,1488,712,776
Kentucky,Harrison County,2,11,1507,771,736
Kentucky,Harrison County,2,12,1303,610,693
Kentucky,Harrison County,2,13,1154,587,567
Kentucky,Harrison County,2,14,890,427,463
Kentucky,Harrison County,2,15,692,322,370
Kentucky,Harrison County,2,16,482,188,294
Kentucky,Harrison County,2,17,398,166,232
Kentucky,Harrison County,2,18,350,111,239
Kentucky,Harrison County,3,0,18810,9197,9613
Kentucky,Harrison County,3,1,1135,571,564
Kentucky,Harrison County,3,2,1251,645,606
Kentucky,Harrison County,3,3,1323,683,640
Kentucky,Harrison County,3,4,1296,676,620
Kentucky,Harrison County,3,5,908,447,461
Kentucky,Harrison County,3,6,986,471,515
Kentucky,Harrison County,3,7,1035,502,533
Kentucky,Harrison County,3,8,1211,597,614
Kentucky,Harrison County,3,9,1363,688,675
Kentucky,Harrison County,3,10,1481,711,770
Kentucky,Harrison County,3,11,1522,775,747
Kentucky,Harrison County,3,12,1319,616,703
Kentucky,Harrison County,3,13,1162,596,566
Kentucky,Harrison County,3,14,888,424,464
Kentucky,Harrison County,3,15,699,329,370
Kentucky,Harrison County,3,16,484,189,295
Kentucky,Harrison County,3,17,394,164,230
Kentucky,Harrison County,3,18,353,113,240
Kentucky,Harrison County,4,0,18689,9164,9525
Kentucky,Harrison County,4,1,1124,559,565
Kentucky,Harrison County,4,2,1196,610,586
Kentucky,Harrison County,4,3,1314,695,619
Kentucky,Harrison County,4,4,1241,651,590
Kentucky,Harrison County,4,5,973,492,481
Kentucky,Harrison County,4,6,937,441,496
Kentucky,Harrison County,4,7,1058,527,531
Kentucky,Harrison County,4,8,1132,555,577
Kentucky,Harrison County,4,9,1341,662,679
Kentucky,Harrison County,4,10,1422,696,726
Kentucky,Harrison County,4,11,1544,779,765
Kentucky,Harrison County,4,12,1354,640,714
Kentucky,Harrison County,4,13,1216,622,594
Kentucky,Harrison County,4,14,892,425,467
Kentucky,Harrison County,4,15,721,351,370
Kentucky,Harrison County,4,16,495,192,303
Kentucky,Harrison County,4,17,369,150,219
Kentucky,Harrison County,4,18,360,117,243
Kentucky,Harrison County,5,0,18622,9136,9486
Kentucky,Harrison County,5,1,1087,530,557
Kentucky,Harrison County,5,2,1217,624,593
Kentucky,Harrison County,5,3,1296,701,595
Kentucky,Harrison County,5,4,1218,628,590
Kentucky,Harrison County,5,5,1023,530,493
Kentucky,Harrison County,5,6,912,437,475
Kentucky,Harrison County,5,7,1026,523,503
Kentucky,Harrison County,5,8,1116,532,584
Kentucky,Harrison County,5,9,1324,656,668
Kentucky,Harrison County,5,10,1368,674,694
Kentucky,Harrison County,5,11,1488,747,741
Kentucky,Harrison County,5,12,1387,659,728
Kentucky,Harrison County,5,13,1221,611,610
Kentucky,Harrison County,5,14,922,445,477
Kentucky,Harrison County,5,15,785,367,418
Kentucky,Harrison County,5,16,508,208,300
Kentucky,Harrison County,5,17,353,138,215
Kentucky,Harrison County,5,18,371,126,245
Kentucky,Harrison County,6,0,18571,9129,9442
Kentucky,Harrison County,6,1,1027,501,526
Kentucky,Harrison County,6,2,1225,636,589
Kentucky,Harrison County,6,3,1304,719,585
Kentucky,Harrison County,6,4,1203,628,575
Kentucky,Harrison County,6,5,1075,555,520
Kentucky,Harrison County,6,6,876,406,470
Kentucky,Harrison County,6,7,1022,531,491
Kentucky,Harrison County,6,8,1084,505,579
Kentucky,Harrison County,6,9,1282,642,640
Kentucky,Harrison County,6,10,1344,663,681
Kentucky,Harrison County,6,11,1487,757,730
Kentucky,Harrison County,6,12,1425,687,738
Kentucky,Harrison County,6,13,1230,599,631
Kentucky,Harrison County,6,14,953,463,490
Kentucky,Harrison County,6,15,791,374,417
Kentucky,Harrison County,6,16,518,219,299
Kentucky,Harrison County,6,17,352,121,231
Kentucky,Harrison County,6,18,373,123,250
Kentucky,Harrison County,7,0,18636,9170,9466
Kentucky,Harrison County,7,1,1076,536,540
Kentucky,Harrison County,7,2,1256,653,603
Kentucky,Harrison County,7,3,1294,698,596
Kentucky,Harrison County,7,4,1190,611,579
Kentucky,Harrison County,7,5,1085,559,526
Kentucky,Harrison County,7,6,909,430,479
Kentucky,Harrison County,7,7,1001,509,492
Kentucky,Harrison County,7,8,1067,502,565
Kentucky,Harrison County,7,9,1259,638,621
Kentucky,Harrison County,7,10,1337,662,675
Kentucky,Harrison County,7,11,1468,746,722
Kentucky,Harrison County,7,12,1445,724,721
Kentucky,Harrison County,7,13,1199,565,634
Kentucky,Harrison County,7,14,1016,503,513
Kentucky,Harrison County,7,15,765,364,401
Kentucky,Harrison County,7,16,551,247,304
Kentucky,Harrison County,7,17,374,128,246
Kentucky,Harrison County,7,18,344,95,249
Kentucky,Harrison County,8,0,18641,9177,9464
Kentucky,Harrison County,8,1,1040,519,521
Kentucky,Harrison County,8,2,1194,602,592
Kentucky,Harrison County,8,3,1286,689,597
Kentucky,Harrison County,8,4,1223,630,593
Kentucky,Harrison County,8,5,1099,576,523
Kentucky,Harrison County,8,6,954,461,493
Kentucky,Harrison County,8,7,976,487,489
Kentucky,Harrison County,8,8,1063,524,539
Kentucky,Harrison County,8,9,1217,622,595
Kentucky,Harrison County,8,10,1314,638,676
Kentucky,Harrison County,8,11,1462,731,731
Kentucky,Harrison County,8,12,1476,757,719
Kentucky,Harrison County,8,13,1259,593,666
Kentucky,Harrison County,8,14,1040,518,522
Kentucky,Harrison County,8,15,744,345,399
Kentucky,Harrison County,8,16,572,266,306
Kentucky,Harrison County,8,17,366,114,252
Kentucky,Harrison County,8,18,356,105,251
Kentucky,Harrison County,9,0,18569,9098,9471
Kentucky,Harrison County,9,1,1074,531,543
Kentucky,Harrison County,9,2,1125,550,575
Kentucky,Harrison County,9,3,1262,659,603
Kentucky,Harrison County,9,4,1229,656,573
Kentucky,Harrison County,9,5,1074,544,530
Kentucky,Harrison County,9,6,1020,517,503
Kentucky,Harrison County,9,7,927,439,488
Kentucky,Harrison County,9,8,1053,523,530
Kentucky,Harrison County,9,9,1165,578,587
Kentucky,Harrison County,9,10,1307,645,662
Kentucky,Harrison County,9,11,1407,695,712
Kentucky,Harrison County,9,12,1506,761,745
Kentucky,Harrison County,9,13,1278,605,673
Kentucky,Harrison County,9,14,1104,554,550
Kentucky,Harrison County,9,15,722,341,381
Kentucky,Harrison County,9,16,596,275,321
Kentucky,Harrison County,9,17,383,127,256
Kentucky,Harrison County,9,18,337,98,239
Kentucky,Harrison County,10,0,18735,9204,9531
Kentucky,Harrison County,10,1,1141,586,555
Kentucky,Harrison County,10,2,1094,537,557
Kentucky,Harrison County,10,3,1275,656,619
Kentucky,Harrison County,10,4,1212,650,562
Kentucky,Harrison County,10,5,1045,531,514
Kentucky,Harrison County,10,6,1136,585,551
Kentucky,Harrison County,10,7,950,461,489
Kentucky,Harrison County,10,8,1042,509,533
Kentucky,Harrison County,10,9,1138,552,586
Kentucky,Harrison County,10,10,1313,645,668
Kentucky,Harrison County,10,11,1377,688,689
Kentucky,Harrison County,10,12,1450,724,726
Kentucky,Harrison County,10,13,1324,628,696
Kentucky,Harrison County,10,14,1099,541,558
Kentucky,Harrison County,10,15,761,365,396
Kentucky,Harrison County,10,16,636,287,349
Kentucky,Harrison County,10,17,385,147,238
Kentucky,Harrison County,10,18,357,112,245
Kentucky,Harrison County,11,0,18780,9225,9555
Kentucky,Harrison County,11,1,1166,589,577
Kentucky,Harrison County,11,2,1063,540,523
Kentucky,Harrison County,11,3,1244,627,617
Kentucky,Harrison County,11,4,1179,638,541
Kentucky,Harrison County,11,5,1065,538,527
Kentucky,Harrison County,11,6,1192,613,579
Kentucky,Harrison County,11,7,964,476,488
Kentucky,Harrison County,11,8,1031,502,529
Kentucky,Harrison County,11,9,1103,529,574
Kentucky,Harrison County,11,10,1264,634,630
Kentucky,Harrison County,11,11,1380,676,704
Kentucky,Harrison County,11,12,1448,715,733
Kentucky,Harrison County,11,13,1374,664,710
Kentucky,Harrison County,11,14,1098,528,570
Kentucky,Harrison County,11,15,820,395,425
Kentucky,Harrison County,11,16,623,285,338
Kentucky,Harrison County,11,17,398,163,235
Kentucky,Harrison County,11,18,368,113,255
Kentucky,Harrison County,12,0,18886,9266,9620
Kentucky,Harrison County,12,1,1175,599,576
Kentucky,Harrison County,12,2,1107,550,557
Kentucky,Harrison County,12,3,1244,636,608
Kentucky,Harrison County,12,4,1170,617,553
Kentucky,Harrison County,12,5,1028,519,509
Kentucky,Harrison County,12,6,1206,636,570
Kentucky,Harrison County,12,7,998,483,515
Kentucky,Harrison County,12,8,1073,529,544
Kentucky,Harrison County,12,9,1056,494,562
Kentucky,Harrison County,12,10,1263,644,619
Kentucky,Harrison County,12,11,1337,657,680
Kentucky,Harrison County,12,12,1430,700,730
Kentucky,Harrison County,12,13,1390,684,706
Kentucky,Harrison County,12,14,1105,511,594
Kentucky,Harrison County,12,15,899,436,463
Kentucky,Harrison County,12,16,595,262,333
Kentucky,Harrison County,12,17,427,187,240
Kentucky,Harrison County,12,18,383,122,261
Kentucky,Hart County,1,0,18199,9001,9198
Kentucky,Hart County,1,1,1183,594,589
Kentucky,Hart County,1,2,1267,654,613
Kentucky,Hart County,1,3,1279,677,602
Kentucky,Hart County,1,4,1303,663,640
Kentucky,Hart County,1,5,1005,518,487
Kentucky,Hart County,1,6,956,460,496
Kentucky,Hart County,1,7,1002,494,508
Kentucky,Hart County,1,8,1075,557,518
Kentucky,Hart County,1,9,1223,598,625
Kentucky,Hart County,1,10,1466,722,744
Kentucky,Hart County,1,11,1363,703,660
Kentucky,Hart County,1,12,1252,631,621
Kentucky,Hart County,1,13,1112,515,597
Kentucky,Hart County,1,14,917,462,455
Kentucky,Hart County,1,15,683,338,345
Kentucky,Hart County,1,16,511,211,300
Kentucky,Hart County,1,17,323,130,193
Kentucky,Hart County,1,18,279,74,205
Kentucky,Hart County,2,0,18194,8998,9196
Kentucky,Hart County,2,1,1183,594,589
Kentucky,Hart County,2,2,1265,653,612
Kentucky,Hart County,2,3,1280,678,602
Kentucky,Hart County,2,4,1304,663,641
Kentucky,Hart County,2,5,1005,518,487
Kentucky,Hart County,2,6,956,460,496
Kentucky,Hart County,2,7,1002,494,508
Kentucky,Hart County,2,8,1074,557,517
Kentucky,Hart County,2,9,1225,599,626
Kentucky,Hart County,2,10,1464,721,743
Kentucky,Hart County,2,11,1362,702,660
Kentucky,Hart County,2,12,1250,630,620
Kentucky,Hart County,2,13,1112,515,597
Kentucky,Hart County,2,14,917,462,455
Kentucky,Hart County,2,15,683,338,345
Kentucky,Hart County,2,16,510,210,300
Kentucky,Hart County,2,17,323,130,193
Kentucky,Hart County,2,18,279,74,205
Kentucky,Hart County,3,0,18188,8989,9199
Kentucky,Hart County,3,1,1185,600,585
Kentucky,Hart County,3,2,1269,653,616
Kentucky,Hart County,3,3,1271,672,599
Kentucky,Hart County,3,4,1294,653,641
Kentucky,Hart County,3,5,1018,530,488
Kentucky,Hart County,3,6,958,459,499
Kentucky,Hart County,3,7,998,494,504
Kentucky,Hart County,3,8,1067,550,517
Kentucky,Hart County,3,9,1217,592,625
Kentucky,Hart County,3,10,1464,722,742
Kentucky,Hart County,3,11,1379,709,670
Kentucky,Hart County,3,12,1244,628,616
Kentucky,Hart County,3,13,1120,522,598
Kentucky,Hart County,3,14,909,452,457
Kentucky,Hart County,3,15,692,344,348
Kentucky,Hart County,3,16,502,208,294
Kentucky,Hart County,3,17,324,129,195
Kentucky,Hart County,3,18,277,72,205
Kentucky,Hart County,4,0,18289,9030,9259
Kentucky,Hart County,4,1,1189,606,583
Kentucky,Hart County,4,2,1236,641,595
Kentucky,Hart County,4,3,1291,664,627
Kentucky,Hart County,4,4,1264,627,637
Kentucky,Hart County,4,5,1074,565,509
Kentucky,Hart County,4,6,929,444,485
Kentucky,Hart County,4,7,1027,515,512
Kentucky,Hart County,4,8,1050,533,517
Kentucky,Hart County,4,9,1175,576,599
Kentucky,Hart County,4,10,1435,712,723
Kentucky,Hart County,4,11,1465,749,716
Kentucky,Hart County,4,12,1248,630,618
Kentucky,Hart County,4,13,1162,555,607
Kentucky,Hart County,4,14,910,439,471
Kentucky,Hart County,4,15,725,355,370
Kentucky,Hart County,4,16,489,210,279
Kentucky,Hart County,4,17,338,133,205
Kentucky,Hart County,4,18,282,76,206
Kentucky,Hart County,5,0,18401,9076,9325
Kentucky,Hart County,5,1,1196,617,579
Kentucky,Hart County,5,2,1227,621,606
Kentucky,Hart County,5,3,1323,668,655
Kentucky,Hart County,5,4,1200,624,576
Kentucky,Hart County,5,5,1110,554,556
Kentucky,Hart County,5,6,951,486,465
Kentucky,Hart County,5,7,1012,488,524
Kentucky,Hart County,5,8,1039,540,499
Kentucky,Hart County,5,9,1174,577,597
Kentucky,Hart County,5,10,1398,691,707
Kentucky,Hart County,5,11,1513,765,748
Kentucky,Hart County,5,12,1263,632,631
Kentucky,Hart County,5,13,1131,550,581
Kentucky,Hart County,5,14,981,462,519
Kentucky,Hart County,5,15,740,363,377
Kentucky,Hart County,5,16,502,218,284
Kentucky,Hart County,5,17,352,140,212
Kentucky,Hart County,5,18,289,80,209
Kentucky,Hart County,6,0,18464,9164,9300
Kentucky,Hart County,6,1,1187,620,567
Kentucky,Hart County,6,2,1235,629,606
Kentucky,Hart County,6,3,1299,649,650
Kentucky,Hart County,6,4,1216,630,586
Kentucky,Hart County,6,5,1132,571,561
Kentucky,Hart County,6,6,996,515,481
Kentucky,Hart County,6,7,1056,534,522
Kentucky,Hart County,6,8,1028,524,504
Kentucky,Hart County,6,9,1152,581,571
Kentucky,Hart County,6,10,1322,646,676
Kentucky,Hart County,6,11,1530,775,755
Kentucky,Hart County,6,12,1286,650,636
Kentucky,Hart County,6,13,1102,543,559
Kentucky,Hart County,6,14,1012,471,541
Kentucky,Hart County,6,15,760,379,381
Kentucky,Hart County,6,16,515,243,272
Kentucky,Hart County,6,17,357,133,224
Kentucky,Hart County,6,18,279,71,208
Kentucky,Hart County,7,0,18512,9184,9328
Kentucky,Hart County,7,1,1205,639,566
Kentucky,Hart County,7,2,1232,626,606
Kentucky,Hart County,7,3,1311,652,659
Kentucky,Hart County,7,4,1188,608,580
Kentucky,Hart County,7,5,1161,603,558
Kentucky,Hart County,7,6,981,517,464
Kentucky,Hart County,7,7,1027,498,529
Kentucky,Hart County,7,8,1021,519,502
Kentucky,Hart County,7,9,1117,566,551
Kentucky,Hart County,7,10,1293,635,658
Kentucky,Hart County,7,11,1504,745,759
Kentucky,Hart County,7,12,1345,691,654
Kentucky,Hart County,7,13,1149,569,580
Kentucky,Hart County,7,14,994,457,537
Kentucky,Hart County,7,15,785,383,402
Kentucky,Hart County,7,16,548,263,285
Kentucky,Hart County,7,17,363,134,229
Kentucky,Hart County,7,18,288,79,209
Kentucky,Hart County,8,0,18421,9124,9297
Kentucky,Hart County,8,1,1250,642,608
Kentucky,Hart County,8,2,1191,601,590
Kentucky,Hart County,8,3,1252,624,628
Kentucky,Hart County,8,4,1183,609,574
Kentucky,Hart County,8,5,1120,584,536
Kentucky,Hart County,8,6,1064,554,510
Kentucky,Hart County,8,7,936,460,476
Kentucky,Hart County,8,8,1012,510,502
Kentucky,Hart County,8,9,1104,577,527
Kentucky,Hart County,8,10,1253,613,640
Kentucky,Hart County,8,11,1466,718,748
Kentucky,Hart County,8,12,1413,724,689
Kentucky,Hart County,8,13,1170,584,586
Kentucky,Hart County,8,14,1031,474,557
Kentucky,Hart County,8,15,758,366,392
Kentucky,Hart County,8,16,556,264,292
Kentucky,Hart County,8,17,372,138,234
Kentucky,Hart County,8,18,290,82,208
Kentucky,Hart County,9,0,18541,9153,9388
Kentucky,Hart County,9,1,1266,611,655
Kentucky,Hart County,9,2,1193,618,575
Kentucky,Hart County,9,3,1252,635,617
Kentucky,Hart County,9,4,1177,596,581
Kentucky,Hart County,9,5,1092,561,531
Kentucky,Hart County,9,6,1139,583,556
Kentucky,Hart County,9,7,935,474,461
Kentucky,Hart County,9,8,1037,530,507
Kentucky,Hart County,9,9,1094,566,528
Kentucky,Hart County,9,10,1210,592,618
Kentucky,Hart County,9,11,1427,703,724
Kentucky,Hart County,9,12,1484,744,740
Kentucky,Hart County,9,13,1212,604,608
Kentucky,Hart County,9,14,1042,494,548
Kentucky,Hart County,9,15,738,340,398
Kentucky,Hart County,9,16,562,270,292
Kentucky,Hart County,9,17,363,141,222
Kentucky,Hart County,9,18,318,91,227
Kentucky,Hart County,10,0,18745,9252,9493
Kentucky,Hart County,10,1,1342,640,702
Kentucky,Hart County,10,2,1222,634,588
Kentucky,Hart County,10,3,1275,641,634
Kentucky,Hart County,10,4,1210,616,594
Kentucky,Hart County,10,5,1052,544,508
Kentucky,Hart County,10,6,1185,610,575
Kentucky,Hart County,10,7,954,490,464
Kentucky,Hart County,10,8,1034,518,516
Kentucky,Hart County,10,9,1098,574,524
Kentucky,Hart County,10,10,1199,590,609
Kentucky,Hart County,10,11,1377,690,687
Kentucky,Hart County,10,12,1497,734,763
Kentucky,Hart County,10,13,1245,614,631
Kentucky,Hart County,10,14,1010,496,514
Kentucky,Hart County,10,15,810,364,446
Kentucky,Hart County,10,16,570,275,295
Kentucky,Hart County,10,17,358,141,217
Kentucky,Hart County,10,18,307,81,226
Kentucky,Hart County,11,0,18902,9302,9600
Kentucky,Hart County,11,1,1368,653,715
Kentucky,Hart County,11,2,1221,634,587
Kentucky,Hart County,11,3,1290,644,646
Kentucky,Hart County,11,4,1203,612,591
Kentucky,Hart County,11,5,1066,547,519
Kentucky,Hart County,11,6,1202,612,590
Kentucky,Hart County,11,7,1007,528,479
Kentucky,Hart County,11,8,1062,520,542
Kentucky,Hart County,11,9,1089,553,536
Kentucky,Hart County,11,10,1161,586,575
Kentucky,Hart County,11,11,1349,655,694
Kentucky,Hart County,11,12,1491,751,740
Kentucky,Hart County,11,13,1279,623,656
Kentucky,Hart County,11,14,1011,500,511
Kentucky,Hart County,11,15,826,359,467
Kentucky,Hart County,11,16,583,282,301
Kentucky,Hart County,11,17,371,160,211
Kentucky,Hart County,11,18,323,83,240
Kentucky,Hart County,12,0,19035,9364,9671
Kentucky,Hart County,12,1,1407,668,739
Kentucky,Hart County,12,2,1200,637,563
Kentucky,Hart County,12,3,1265,619,646
Kentucky,Hart County,12,4,1223,621,602
Kentucky,Hart County,12,5,1066,559,507
Kentucky,Hart County,12,6,1223,618,605
Kentucky,Hart County,12,7,1053,550,503
Kentucky,Hart County,12,8,1088,533,555
Kentucky,Hart County,12,9,1068,536,532
Kentucky,Hart County,12,10,1143,571,572
Kentucky,Hart County,12,11,1298,642,656
Kentucky,Hart County,12,12,1502,748,754
Kentucky,Hart County,12,13,1313,639,674
Kentucky,Hart County,12,14,1049,522,527
Kentucky,Hart County,12,15,829,364,465
Kentucky,Hart County,12,16,593,276,317
Kentucky,Hart County,12,17,391,175,216
Kentucky,Hart County,12,18,324,86,238
Kentucky,Henderson County,1,0,46250,22317,23933
Kentucky,Henderson County,1,1,3114,1558,1556
Kentucky,Henderson County,1,2,3002,1504,1498
Kentucky,Henderson County,1,3,3013,1564,1449
Kentucky,Henderson County,1,4,2809,1422,1387
Kentucky,Henderson County,1,5,2593,1270,1323
Kentucky,Henderson County,1,6,3043,1468,1575
Kentucky,Henderson County,1,7,2801,1369,1432
Kentucky,Henderson County,1,8,2875,1387,1488
Kentucky,Henderson County,1,9,3039,1542,1497
Kentucky,Henderson County,1,10,3561,1737,1824
Kentucky,Henderson County,1,11,3729,1831,1898
Kentucky,Henderson County,1,12,3293,1546,1747
Kentucky,Henderson County,1,13,2827,1340,1487
Kentucky,Henderson County,1,14,2124,1027,1097
Kentucky,Henderson County,1,15,1473,639,834
Kentucky,Henderson County,1,16,1199,525,674
Kentucky,Henderson County,1,17,978,368,610
Kentucky,Henderson County,1,18,777,220,557
Kentucky,Henderson County,2,0,46246,22316,23930
Kentucky,Henderson County,2,1,3114,1558,1556
Kentucky,Henderson County,2,2,3000,1504,1496
Kentucky,Henderson County,2,3,3013,1564,1449
Kentucky,Henderson County,2,4,2809,1422,1387
Kentucky,Henderson County,2,5,2593,1270,1323
Kentucky,Henderson County,2,6,3042,1467,1575
Kentucky,Henderson County,2,7,2801,1369,1432
Kentucky,Henderson County,2,8,2874,1387,1487
Kentucky,Henderson County,2,9,3040,1542,1498
Kentucky,Henderson County,2,10,3561,1737,1824
Kentucky,Henderson County,2,11,3729,1831,1898
Kentucky,Henderson County,2,12,3293,1546,1747
Kentucky,Henderson County,2,13,2826,1340,1486
Kentucky,Henderson County,2,14,2124,1027,1097
Kentucky,Henderson County,2,15,1473,639,834
Kentucky,Henderson County,2,16,1199,525,674
Kentucky,Henderson County,2,17,978,368,610
Kentucky,Henderson County,2,18,777,220,557
Kentucky,Henderson County,3,0,46260,22314,23946
Kentucky,Henderson County,3,1,3097,1542,1555
Kentucky,Henderson County,3,2,3019,1511,1508
Kentucky,Henderson County,3,3,2993,1550,1443
Kentucky,Henderson County,3,4,2801,1430,1371
Kentucky,Henderson County,3,5,2623,1286,1337
Kentucky,Henderson County,3,6,3028,1453,1575
Kentucky,Henderson County,3,7,2824,1383,1441
Kentucky,Henderson County,3,8,2855,1375,1480
Kentucky,Henderson County,3,9,3048,1543,1505
Kentucky,Henderson County,3,10,3519,1721,1798
Kentucky,Henderson County,3,11,3720,1830,1890
Kentucky,Henderson County,3,12,3320,1552,1768
Kentucky,Henderson County,3,13,2849,1357,1492
Kentucky,Henderson County,3,14,2124,1021,1103
Kentucky,Henderson County,3,15,1483,643,840
Kentucky,Henderson County,3,16,1197,527,670
Kentucky,Henderson County,3,17,976,365,611
Kentucky,Henderson County,3,18,784,225,559
Kentucky,Henderson County,4,0,46334,22385,23949
Kentucky,Henderson County,4,1,3050,1552,1498
Kentucky,Henderson County,4,2,3052,1527,1525
Kentucky,Henderson County,4,3,2958,1512,1446
Kentucky,Henderson County,4,4,2765,1428,1337
Kentucky,Henderson County,4,5,2753,1337,1416
Kentucky,Henderson County,4,6,2970,1421,1549
Kentucky,Henderson County,4,7,2950,1461,1489
Kentucky,Henderson County,4,8,2748,1327,1421
Kentucky,Henderson County,4,9,3071,1553,1518
Kentucky,Henderson County,4,10,3341,1654,1687
Kentucky,Henderson County,4,11,3713,1813,1900
Kentucky,Henderson County,4,12,3403,1584,1819
Kentucky,Henderson County,4,13,2948,1406,1542
Kentucky,Henderson County,4,14,2120,1013,1107
Kentucky,Henderson County,4,15,1551,678,873
Kentucky,Henderson County,4,16,1187,528,659
Kentucky,Henderson County,4,17,943,348,595
Kentucky,Henderson County,4,18,811,243,568
Kentucky,Henderson County,5,0,46419,22470,23949
Kentucky,Henderson County,5,1,2960,1506,1454
Kentucky,Henderson County,5,2,3098,1546,1552
Kentucky,Henderson County,5,3,2971,1508,1463
Kentucky,Henderson County,5,4,2728,1424,1304
Kentucky,Henderson County,5,5,2798,1392,1406
Kentucky,Henderson County,5,6,2892,1376,1516
Kentucky,Henderson County,5,7,2992,1477,1515
Kentucky,Henderson County,5,8,2733,1308,1425
Kentucky,Henderson County,5,9,3064,1552,1512
Kentucky,Henderson County,5,10,3230,1607,1623
Kentucky,Henderson County,5,11,3646,1797,1849
Kentucky,Henderson County,5,12,3455,1621,1834
Kentucky,Henderson County,5,13,2966,1408,1558
Kentucky,Henderson County,5,14,2317,1096,1221
Kentucky,Henderson County,5,15,1600,721,879
Kentucky,Henderson County,5,16,1197,529,668
Kentucky,Henderson County,5,17,910,337,573
Kentucky,Henderson County,5,18,862,265,597
Kentucky,Henderson County,6,0,46338,22473,23865
Kentucky,Henderson County,6,1,2847,1481,1366
Kentucky,Henderson County,6,2,3127,1554,1573
Kentucky,Henderson County,6,3,3021,1536,1485
Kentucky,Henderson County,6,4,2685,1389,1296
Kentucky,Henderson County,6,5,2767,1401,1366
Kentucky,Henderson County,6,6,2823,1333,1490
Kentucky,Henderson County,6,7,3044,1509,1535
Kentucky,Henderson County,6,8,2731,1308,1423
Kentucky,Henderson County,6,9,2952,1501,1451
Kentucky,Henderson County,6,10,3109,1567,1542
Kentucky,Henderson County,6,11,3559,1740,1819
Kentucky,Henderson County,6,12,3535,1651,1884
Kentucky,Henderson County,6,13,3014,1448,1566
Kentucky,Henderson County,6,14,2462,1147,1315
Kentucky,Henderson County,6,15,1678,779,899
Kentucky,Henderson County,6,16,1203,513,690
Kentucky,Henderson County,6,17,909,347,562
Kentucky,Henderson County,6,18,872,269,603
Kentucky,Henderson County,7,0,46366,22457,23909
Kentucky,Henderson County,7,1,2810,1470,1340
Kentucky,Henderson County,7,2,3161,1581,1580
Kentucky,Henderson County,7,3,3022,1548,1474
Kentucky,Henderson County,7,4,2711,1390,1321
Kentucky,Henderson County,7,5,2713,1365,1348
Kentucky,Henderson County,7,6,2817,1361,1456
Kentucky,Henderson County,7,7,3024,1475,1549
Kentucky,Henderson County,7,8,2784,1352,1432
Kentucky,Henderson County,7,9,2901,1451,1450
Kentucky,Henderson County,7,10,2975,1467,1508
Kentucky,Henderson County,7,11,3473,1719,1754
Kentucky,Henderson County,7,12,3596,1698,1898
Kentucky,Henderson County,7,13,3081,1440,1641
Kentucky,Henderson County,7,14,2494,1163,1331
Kentucky,Henderson County,7,15,1778,828,950
Kentucky,Henderson County,7,16,1200,500,700
Kentucky,Henderson County,7,17,933,376,557
Kentucky,Henderson County,7,18,893,273,620
Kentucky,Henderson County,8,0,46344,22455,23889
Kentucky,Henderson County,8,1,2810,1463,1347
Kentucky,Henderson County,8,2,3153,1603,1550
Kentucky,Henderson County,8,3,3008,1509,1499
Kentucky,Henderson County,8,4,2728,1411,1317
Kentucky,Henderson County,8,5,2634,1362,1272
Kentucky,Henderson County,8,6,2928,1413,1515
Kentucky,Henderson County,8,7,2983,1416,1567
Kentucky,Henderson County,8,8,2838,1374,1464
Kentucky,Henderson County,8,9,2801,1382,1419
Kentucky,Henderson County,8,10,2929,1454,1475
Kentucky,Henderson County,8,11,3356,1672,1684
Kentucky,Henderson County,8,12,3576,1707,1869
Kentucky,Henderson County,8,13,3162,1452,1710
Kentucky,Henderson County,8,14,2555,1208,1347
Kentucky,Henderson County,8,15,1823,843,980
Kentucky,Henderson County,8,16,1238,522,716
Kentucky,Henderson County,8,17,917,381,536
Kentucky,Henderson County,8,18,905,283,622
Kentucky,Henderson County,9,0,46212,22365,23847
Kentucky,Henderson County,9,1,2779,1414,1365
Kentucky,Henderson County,9,2,3081,1587,1494
Kentucky,Henderson County,9,3,3026,1494,1532
Kentucky,Henderson County,9,4,2743,1418,1325
Kentucky,Henderson County,9,5,2593,1369,1224
Kentucky,Henderson County,9,6,3036,1491,1545
Kentucky,Henderson County,9,7,2856,1362,1494
Kentucky,Henderson County,9,8,2879,1377,1502
Kentucky,Henderson County,9,9,2723,1332,1391
Kentucky,Henderson County,9,10,2925,1453,1472
Kentucky,Henderson County,9,11,3205,1591,1614
Kentucky,Henderson County,9,12,3508,1681,1827
Kentucky,Henderson County,9,13,3204,1470,1734
Kentucky,Henderson County,9,14,2648,1251,1397
Kentucky,Henderson County,9,15,1857,837,1020
Kentucky,Henderson County,9,16,1295,547,748
Kentucky,Henderson County,9,17,940,408,532
Kentucky,Henderson County,9,18,914,283,631
Kentucky,Henderson County,10,0,45867,22161,23706
Kentucky,Henderson County,10,1,2786,1397,1389
Kentucky,Henderson County,10,2,2980,1539,1441
Kentucky,Henderson County,10,3,3090,1548,1542
Kentucky,Henderson County,10,4,2702,1375,1327
Kentucky,Henderson County,10,5,2520,1298,1222
Kentucky,Henderson County,10,6,2972,1497,1475
Kentucky,Henderson County,10,7,2789,1316,1473
Kentucky,Henderson County,10,8,2905,1393,1512
Kentucky,Henderson County,10,9,2643,1293,1350
Kentucky,Henderson County,10,10,2919,1438,1481
Kentucky,Henderson County,10,11,3087,1521,1566
Kentucky,Henderson County,10,12,3425,1648,1777
Kentucky,Henderson County,10,13,3211,1497,1714
Kentucky,Henderson County,10,14,2635,1220,1415
Kentucky,Henderson County,10,15,2012,910,1102
Kentucky,Henderson County,10,16,1343,584,759
Kentucky,Henderson County,10,17,919,393,526
Kentucky,Henderson County,10,18,929,294,635
Kentucky,Henderson County,11,0,45512,22006,23506
Kentucky,Henderson County,11,1,2701,1353,1348
Kentucky,Henderson County,11,2,2897,1521,1376
Kentucky,Henderson County,11,3,3117,1554,1563
Kentucky,Henderson County,11,4,2697,1386,1311
Kentucky,Henderson County,11,5,2455,1255,1200
Kentucky,Henderson County,11,6,2944,1476,1468
Kentucky,Henderson County,11,7,2677,1287,1390
Kentucky,Henderson County,11,8,2898,1393,1505
Kentucky,Henderson County,11,9,2628,1275,1353
Kentucky,Henderson County,11,10,2862,1416,1446
Kentucky,Henderson County,11,11,2970,1457,1513
Kentucky,Henderson County,11,12,3325,1603,1722
Kentucky,Henderson County,11,13,3280,1512,1768
Kentucky,Henderson County,11,14,2667,1254,1413
Kentucky,Henderson County,11,15,2127,956,1171
Kentucky,Henderson County,11,16,1424,643,781
Kentucky,Henderson County,11,17,903,359,544
Kentucky,Henderson County,11,18,940,306,634
Kentucky,Henderson County,12,0,45210,21841,23369
Kentucky,Henderson County,12,1,2639,1350,1289
Kentucky,Henderson County,12,2,2821,1482,1339
Kentucky,Henderson County,12,3,3093,1531,1562
Kentucky,Henderson County,12,4,2678,1377,1301
Kentucky,Henderson County,12,5,2519,1273,1246
Kentucky,Henderson County,12,6,2829,1413,1416
Kentucky,Henderson County,12,7,2677,1300,1377
Kentucky,Henderson County,12,8,2872,1369,1503
Kentucky,Henderson County,12,9,2609,1280,1329
Kentucky,Henderson County,12,10,2819,1382,1437
Kentucky,Henderson County,12,11,2856,1381,1475
Kentucky,Henderson County,12,12,3213,1555,1658
Kentucky,Henderson County,12,13,3325,1555,1770
Kentucky,Henderson County,12,14,2718,1251,1467
Kentucky,Henderson County,12,15,2157,972,1185
Kentucky,Henderson County,12,16,1519,690,829
Kentucky,Henderson County,12,17,908,358,550
Kentucky,Henderson County,12,18,958,322,636
Kentucky,Henry County,1,0,15416,7596,7820
Kentucky,Henry County,1,1,940,488,452
Kentucky,Henry County,1,2,1133,586,547
Kentucky,Henry County,1,3,1059,582,477
Kentucky,Henry County,1,4,1048,548,500
Kentucky,Henry County,1,5,736,356,380
Kentucky,Henry County,1,6,822,395,427
Kentucky,Henry County,1,7,862,422,440
Kentucky,Henry County,1,8,968,469,499
Kentucky,Henry County,1,9,1080,529,551
Kentucky,Henry County,1,10,1193,589,604
Kentucky,Henry County,1,11,1269,620,649
Kentucky,Henry County,1,12,1097,552,545
Kentucky,Henry County,1,13,1019,493,526
Kentucky,Henry County,1,14,767,366,401
Kentucky,Henry County,1,15,546,262,284
Kentucky,Henry County,1,16,377,166,211
Kentucky,Henry County,1,17,249,104,145
Kentucky,Henry County,1,18,251,69,182
Kentucky,Henry County,2,0,15413,7594,7819
Kentucky,Henry County,2,1,940,488,452
Kentucky,Henry County,2,2,1133,586,547
Kentucky,Henry County,2,3,1059,582,477
Kentucky,Henry County,2,4,1047,547,500
Kentucky,Henry County,2,5,736,356,380
Kentucky,Henry County,2,6,824,396,428
Kentucky,Henry County,2,7,862,422,440
Kentucky,Henry County,2,8,968,469,499
Kentucky,Henry County,2,9,1078,528,550
Kentucky,Henry County,2,10,1193,589,604
Kentucky,Henry County,2,11,1269,620,649
Kentucky,Henry County,2,12,1096,552,544
Kentucky,Henry County,2,13,1018,492,526
Kentucky,Henry County,2,14,767,366,401
Kentucky,Henry County,2,15,546,262,284
Kentucky,Henry County,2,16,377,166,211
Kentucky,Henry County,2,17,249,104,145
Kentucky,Henry County,2,18,251,69,182
Kentucky,Henry County,3,0,15376,7567,7809
Kentucky,Henry County,3,1,927,483,444
Kentucky,Henry County,3,2,1113,577,536
Kentucky,Henry County,3,3,1064,580,484
Kentucky,Henry County,3,4,1041,542,499
Kentucky,Henry County,3,5,741,358,383
Kentucky,Henry County,3,6,821,395,426
Kentucky,Henry County,3,7,856,419,437
Kentucky,Henry County,3,8,961,463,498
Kentucky,Henry County,3,9,1077,527,550
Kentucky,Henry County,3,10,1184,585,599
Kentucky,Henry County,3,11,1261,612,649
Kentucky,Henry County,3,12,1110,558,552
Kentucky,Henry County,3,13,1019,495,524
Kentucky,Henry County,3,14,771,367,404
Kentucky,Henry County,3,15,552,267,285
Kentucky,Henry County,3,16,380,169,211
Kentucky,Henry County,3,17,247,101,146
Kentucky,Henry County,3,18,251,69,182
Kentucky,Henry County,4,0,15375,7589,7786
Kentucky,Henry County,4,1,918,485,433
Kentucky,Henry County,4,2,1063,560,503
Kentucky,Henry County,4,3,1122,605,517
Kentucky,Henry County,4,4,1027,541,486
Kentucky,Henry County,4,5,768,383,385
Kentucky,Henry County,4,6,807,390,417
Kentucky,Henry County,4,7,854,415,439
Kentucky,Henry County,4,8,958,462,496
Kentucky,Henry County,4,9,1068,523,545
Kentucky,Henry County,4,10,1143,565,578
Kentucky,Henry County,4,11,1231,586,645
Kentucky,Henry County,4,12,1129,570,559
Kentucky,Henry County,4,13,1047,511,536
Kentucky,Henry County,4,14,766,359,407
Kentucky,Henry County,4,15,578,283,295
Kentucky,Henry County,4,16,404,193,211
Kentucky,Henry County,4,17,238,87,151
Kentucky,Henry County,4,18,254,71,183
Kentucky,Henry County,5,0,15336,7550,7786
Kentucky,Henry County,5,1,907,454,453
Kentucky,Henry County,5,2,1040,554,486
Kentucky,Henry County,5,3,1082,581,501
Kentucky,Henry County,5,4,985,517,468
Kentucky,Henry County,5,5,781,401,380
Kentucky,Henry County,5,6,802,366,436
Kentucky,Henry County,5,7,851,417,434
Kentucky,Henry County,5,8,944,473,471
Kentucky,Henry County,5,9,1048,501,547
Kentucky,Henry County,5,10,1131,559,572
Kentucky,Henry County,5,11,1207,586,621
Kentucky,Henry County,5,12,1155,585,570
Kentucky,Henry County,5,13,1059,514,545
Kentucky,Henry County,5,14,822,387,435
Kentucky,Henry County,5,15,613,298,315
Kentucky,Henry County,5,16,430,205,225
Kentucky,Henry County,5,17,219,80,139
Kentucky,Henry County,5,18,260,72,188
Kentucky,Henry County,6,0,15432,7619,7813
Kentucky,Henry County,6,1,924,446,478
Kentucky,Henry County,6,2,989,542,447
Kentucky,Henry County,6,3,1153,611,542
Kentucky,Henry County,6,4,967,522,445
Kentucky,Henry County,6,5,824,430,394
Kentucky,Henry County,6,6,778,375,403
Kentucky,Henry County,6,7,909,441,468
Kentucky,Henry County,6,8,906,457,449
Kentucky,Henry County,6,9,1046,512,534
Kentucky,Henry County,6,10,1095,527,568
Kentucky,Henry County,6,11,1190,586,604
Kentucky,Henry County,6,12,1203,599,604
Kentucky,Henry County,6,13,1057,512,545
Kentucky,Henry County,6,14,822,399,423
Kentucky,Henry County,6,15,635,299,336
Kentucky,Henry County,6,16,451,207,244
Kentucky,Henry County,6,17,237,88,149
Kentucky,Henry County,6,18,246,66,180
Kentucky,Henry County,7,0,15547,7637,7910
Kentucky,Henry County,7,1,896,442,454
Kentucky,Henry County,7,2,979,526,453
Kentucky,Henry County,7,3,1178,596,582
Kentucky,Henry County,7,4,993,544,449
Kentucky,Henry County,7,5,864,440,424
Kentucky,Henry County,7,6,815,405,410
Kentucky,Henry County,7,7,894,429,465
Kentucky,Henry County,7,8,889,438,451
Kentucky,Henry County,7,9,1032,504,528
Kentucky,Henry County,7,10,1083,520,563
Kentucky,Henry County,7,11,1204,606,598
Kentucky,Henry County,7,12,1174,580,594
Kentucky,Henry County,7,13,1052,513,539
Kentucky,Henry County,7,14,876,412,464
Kentucky,Henry County,7,15,649,301,348
Kentucky,Henry County,7,16,451,208,243
Kentucky,Henry County,7,17,268,105,163
Kentucky,Henry County,7,18,250,68,182
Kentucky,Henry County,8,0,15563,7670,7893
Kentucky,Henry County,8,1,884,450,434
Kentucky,Henry County,8,2,983,529,454
Kentucky,Henry County,8,3,1134,592,542
Kentucky,Henry County,8,4,988,542,446
Kentucky,Henry County,8,5,851,435,416
Kentucky,Henry County,8,6,836,402,434
Kentucky,Henry County,8,7,877,424,453
Kentucky,Henry County,8,8,911,450,461
Kentucky,Henry County,8,9,980,493,487
Kentucky,Henry County,8,10,1061,500,561
Kentucky,Henry County,8,11,1233,613,620
Kentucky,Henry County,8,12,1189,574,615
Kentucky,Henry County,8,13,1062,519,543
Kentucky,Henry County,8,14,945,452,493
Kentucky,Henry County,8,15,642,295,347
Kentucky,Henry County,8,16,446,217,229
Kentucky,Henry County,8,17,283,113,170
Kentucky,Henry County,8,18,258,70,188
Kentucky,Henry County,9,0,15834,7843,7991
Kentucky,Henry County,9,1,937,494,443
Kentucky,Henry County,9,2,1040,551,489
Kentucky,Henry County,9,3,1078,576,502
Kentucky,Henry County,9,4,1060,564,496
Kentucky,Henry County,9,5,844,434,410
Kentucky,Henry County,9,6,863,424,439
Kentucky,Henry County,9,7,907,436,471
Kentucky,Henry County,9,8,924,450,474
Kentucky,Henry County,9,9,967,489,478
Kentucky,Henry County,9,10,1087,528,559
Kentucky,Henry County,9,11,1195,589,606
Kentucky,Henry County,9,12,1200,583,617
Kentucky,Henry County,9,13,1097,538,559
Kentucky,Henry County,9,14,983,471,512
Kentucky,Henry County,9,15,634,286,348
Kentucky,Henry County,9,16,466,233,233
Kentucky,Henry County,9,17,296,130,166
Kentucky,Henry County,9,18,256,67,189
Kentucky,Henry County,10,0,15972,7909,8063
Kentucky,Henry County,10,1,952,505,447
Kentucky,Henry County,10,2,1029,533,496
Kentucky,Henry County,10,3,1109,607,502
Kentucky,Henry County,10,4,1038,562,476
Kentucky,Henry County,10,5,887,456,431
Kentucky,Henry County,10,6,877,442,435
Kentucky,Henry County,10,7,915,449,466
Kentucky,Henry County,10,8,899,422,477
Kentucky,Henry County,10,9,966,491,475
Kentucky,Henry County,10,10,1075,503,572
Kentucky,Henry County,10,11,1185,582,603
Kentucky,Henry County,10,12,1197,573,624
Kentucky,Henry County,10,13,1122,562,560
Kentucky,Henry County,10,14,1005,479,526
Kentucky,Henry County,10,15,683,305,378
Kentucky,Henry County,10,16,485,243,242
Kentucky,Henry County,10,17,306,134,172
Kentucky,Henry County,10,18,242,61,181
Kentucky,Henry County,11,0,16061,7950,8111
Kentucky,Henry County,11,1,960,510,450
Kentucky,Henry County,11,2,1035,532,503
Kentucky,Henry County,11,3,1099,599,500
Kentucky,Henry County,11,4,1083,565,518
Kentucky,Henry County,11,5,863,441,422
Kentucky,Henry County,11,6,889,454,435
Kentucky,Henry County,11,7,904,448,456
Kentucky,Henry County,11,8,975,472,503
Kentucky,Henry County,11,9,940,485,455
Kentucky,Henry County,11,10,1054,502,552
Kentucky,Henry County,11,11,1149,541,608
Kentucky,Henry County,11,12,1164,578,586
Kentucky,Henry County,11,13,1153,573,580
Kentucky,Henry County,11,14,1011,477,534
Kentucky,Henry County,11,15,707,327,380
Kentucky,Henry County,11,16,506,238,268
Kentucky,Henry County,11,17,320,141,179
Kentucky,Henry County,11,18,249,67,182
Kentucky,Henry County,12,0,16126,7978,8148
Kentucky,Henry County,12,1,963,509,454
Kentucky,Henry County,12,2,1035,521,514
Kentucky,Henry County,12,3,1083,587,496
Kentucky,Henry County,12,4,1038,546,492
Kentucky,Henry County,12,5,832,438,394
Kentucky,Henry County,12,6,923,466,457
Kentucky,Henry County,12,7,936,464,472
Kentucky,Henry County,12,8,978,478,500
Kentucky,Henry County,12,9,921,465,456
Kentucky,Henry County,12,10,1023,509,514
Kentucky,Henry County,12,11,1130,534,596
Kentucky,Henry County,12,12,1201,589,612
Kentucky,Henry County,12,13,1158,578,580
Kentucky,Henry County,12,14,1022,483,539
Kentucky,Henry County,12,15,778,349,429
Kentucky,Henry County,12,16,524,246,278
Kentucky,Henry County,12,17,312,135,177
Kentucky,Henry County,12,18,269,81,188
Kentucky,Hickman County,1,0,4902,2345,2557
Kentucky,Hickman County,1,1,283,134,149
Kentucky,Hickman County,1,2,277,143,134
Kentucky,Hickman County,1,3,299,148,151
Kentucky,Hickman County,1,4,297,147,150
Kentucky,Hickman County,1,5,225,105,120
Kentucky,Hickman County,1,6,236,121,115
Kentucky,Hickman County,1,7,258,145,113
Kentucky,Hickman County,1,8,278,127,151
Kentucky,Hickman County,1,9,309,153,156
Kentucky,Hickman County,1,10,373,185,188
Kentucky,Hickman County,1,11,352,167,185
Kentucky,Hickman County,1,12,347,175,172
Kentucky,Hickman County,1,13,349,170,179
Kentucky,Hickman County,1,14,296,130,166
Kentucky,Hickman County,1,15,241,115,126
Kentucky,Hickman County,1,16,177,86,91
Kentucky,Hickman County,1,17,152,57,95
Kentucky,Hickman County,1,18,153,37,116
Kentucky,Hickman County,2,0,4903,2345,2558
Kentucky,Hickman County,2,1,283,134,149
Kentucky,Hickman County,2,2,277,143,134
Kentucky,Hickman County,2,3,299,148,151
Kentucky,Hickman County,2,4,297,147,150
Kentucky,Hickman County,2,5,225,105,120
Kentucky,Hickman County,2,6,236,121,115
Kentucky,Hickman County,2,7,258,145,113
Kentucky,Hickman County,2,8,278,127,151
Kentucky,Hickman County,2,9,309,153,156
Kentucky,Hickman County,2,10,373,185,188
Kentucky,Hickman County,2,11,352,167,185
Kentucky,Hickman County,2,12,347,175,172
Kentucky,Hickman County,2,13,349,170,179
Kentucky,Hickman County,2,14,296,130,166
Kentucky,Hickman County,2,15,241,115,126
Kentucky,Hickman County,2,16,177,86,91
Kentucky,Hickman County,2,17,152,57,95
Kentucky,Hickman County,2,18,154,37,117
Kentucky,Hickman County,3,0,4860,2328,2532
Kentucky,Hickman County,3,1,275,132,143
Kentucky,Hickman County,3,2,278,143,135
Kentucky,Hickman County,3,3,298,149,149
Kentucky,Hickman County,3,4,292,143,149
Kentucky,Hickman County,3,5,224,105,119
Kentucky,Hickman County,3,6,235,120,115
Kentucky,Hickman County,3,7,256,144,112
Kentucky,Hickman County,3,8,276,128,148
Kentucky,Hickman County,3,9,306,154,152
Kentucky,Hickman County,3,10,369,182,187
Kentucky,Hickman County,3,11,354,167,187
Kentucky,Hickman County,3,12,345,172,173
Kentucky,Hickman County,3,13,343,165,178
Kentucky,Hickman County,3,14,290,132,158
Kentucky,Hickman County,3,15,236,111,125
Kentucky,Hickman County,3,16,180,88,92
Kentucky,Hickman County,3,17,151,57,94
Kentucky,Hickman County,3,18,152,36,116
Kentucky,Hickman County,4,0,4783,2292,2491
Kentucky,Hickman County,4,1,244,113,131
Kentucky,Hickman County,4,2,269,128,141
Kentucky,Hickman County,4,3,291,150,141
Kentucky,Hickman County,4,4,279,147,132
Kentucky,Hickman County,4,5,236,109,127
Kentucky,Hickman County,4,6,230,115,115
Kentucky,Hickman County,4,7,246,134,112
Kentucky,Hickman County,4,8,255,126,129
Kentucky,Hickman County,4,9,311,161,150
Kentucky,Hickman County,4,10,368,187,181
Kentucky,Hickman County,4,11,358,170,188
Kentucky,Hickman County,4,12,340,161,179
Kentucky,Hickman County,4,13,346,162,184
Kentucky,Hickman County,4,14,286,137,149
Kentucky,Hickman County,4,15,236,108,128
Kentucky,Hickman County,4,16,192,93,99
Kentucky,Hickman County,4,17,149,55,94
Kentucky,Hickman County,4,18,147,36,111
Kentucky,Hickman County,5,0,4737,2284,2453
Kentucky,Hickman County,5,1,229,114,115
Kentucky,Hickman County,5,2,268,136,132
Kentucky,Hickman County,5,3,281,140,141
Kentucky,Hickman County,5,4,270,138,132
Kentucky,Hickman County,5,5,237,120,117
Kentucky,Hickman County,5,6,229,115,114
Kentucky,Hickman County,5,7,256,135,121
Kentucky,Hickman County,5,8,236,116,120
Kentucky,Hickman County,5,9,306,156,150
Kentucky,Hickman County,5,10,355,186,169
Kentucky,Hickman County,5,11,351,166,185
Kentucky,Hickman County,5,12,339,160,179
Kentucky,Hickman County,5,13,341,155,186
Kentucky,Hickman County,5,14,308,146,162
Kentucky,Hickman County,5,15,238,112,126
Kentucky,Hickman County,5,16,194,94,100
Kentucky,Hickman County,5,17,145,52,93
Kentucky,Hickman County,5,18,154,43,111
Kentucky,Hickman County,6,0,4708,2252,2456
Kentucky,Hickman County,6,1,216,105,111
Kentucky,Hickman County,6,2,266,135,131
Kentucky,Hickman County,6,3,267,125,142
Kentucky,Hickman County,6,4,274,137,137
Kentucky,Hickman County,6,5,226,112,114
Kentucky,Hickman County,6,6,249,130,119
Kentucky,Hickman County,6,7,245,127,118
Kentucky,Hickman County,6,8,248,123,125
Kentucky,Hickman County,6,9,278,135,143
Kentucky,Hickman County,6,10,335,175,160
Kentucky,Hickman County,6,11,360,172,188
Kentucky,Hickman County,6,12,343,159,184
Kentucky,Hickman County,6,13,318,151,167
Kentucky,Hickman County,6,14,339,159,180
Kentucky,Hickman County,6,15,234,111,123
Kentucky,Hickman County,6,16,208,96,112
Kentucky,Hickman County,6,17,139,55,84
Kentucky,Hickman County,6,18,163,45,118
Kentucky,Hickman County,7,0,4679,2253,2426
Kentucky,Hickman County,7,1,195,101,94
Kentucky,Hickman County,7,2,276,138,138
Kentucky,Hickman County,7,3,281,138,143
Kentucky,Hickman County,7,4,265,137,128
Kentucky,Hickman County,7,5,233,117,116
Kentucky,Hickman County,7,6,230,111,119
Kentucky,Hickman County,7,7,232,125,107
Kentucky,Hickman County,7,8,248,132,116
Kentucky,Hickman County,7,9,280,122,158
Kentucky,Hickman County,7,10,313,165,148
Kentucky,Hickman County,7,11,373,183,190
Kentucky,Hickman County,7,12,340,155,185
Kentucky,Hickman County,7,13,324,154,170
Kentucky,Hickman County,7,14,319,150,169
Kentucky,Hickman County,7,15,258,126,132
Kentucky,Hickman County,7,16,200,93,107
Kentucky,Hickman County,7,17,143,63,80
Kentucky,Hickman County,7,18,169,43,126
Kentucky,Hickman County,8,0,4612,2209,2403
Kentucky,Hickman County,8,1,209,112,97
Kentucky,Hickman County,8,2,260,121,139
Kentucky,Hickman County,8,3,275,137,138
Kentucky,Hickman County,8,4,257,126,131
Kentucky,Hickman County,8,5,224,119,105
Kentucky,Hickman County,8,6,242,105,137
Kentucky,Hickman County,8,7,225,118,107
Kentucky,Hickman County,8,8,240,133,107
Kentucky,Hickman County,8,9,290,136,154
Kentucky,Hickman County,8,10,300,153,147
Kentucky,Hickman County,8,11,345,173,172
Kentucky,Hickman County,8,12,329,148,181
Kentucky,Hickman County,8,13,333,161,172
Kentucky,Hickman County,8,14,326,155,171
Kentucky,Hickman County,8,15,253,118,135
Kentucky,Hickman County,8,16,195,90,105
Kentucky,Hickman County,8,17,147,69,78
Kentucky,Hickman County,8,18,162,35,127
Kentucky,Hickman County,9,0,4607,2203,2404
Kentucky,Hickman County,9,1,222,115,107
Kentucky,Hickman County,9,2,264,127,137
Kentucky,Hickman County,9,3,266,131,135
Kentucky,Hickman County,9,4,248,124,124
Kentucky,Hickman County,9,5,236,126,110
Kentucky,Hickman County,9,6,238,100,138
Kentucky,Hickman County,9,7,236,120,116
Kentucky,Hickman County,9,8,221,120,101
Kentucky,Hickman County,9,9,272,133,139
Kentucky,Hickman County,9,10,294,148,146
Kentucky,Hickman County,9,11,348,178,170
Kentucky,Hickman County,9,12,329,147,182
Kentucky,Hickman County,9,13,327,154,173
Kentucky,Hickman County,9,14,330,157,173
Kentucky,Hickman County,9,15,260,124,136
Kentucky,Hickman County,9,16,200,91,109
Kentucky,Hickman County,9,17,156,71,85
Kentucky,Hickman County,9,18,160,37,123
Kentucky,Hickman County,10,0,4518,2152,2366
Kentucky,Hickman County,10,1,225,121,104
Kentucky,Hickman County,10,2,244,119,125
Kentucky,Hickman County,10,3,258,122,136
Kentucky,Hickman County,10,4,253,120,133
Kentucky,Hickman County,10,5,222,115,107
Kentucky,Hickman County,10,6,217,98,119
Kentucky,Hickman County,10,7,230,114,116
Kentucky,Hickman County,10,8,230,118,112
Kentucky,Hickman County,10,9,247,114,133
Kentucky,Hickman County,10,10,295,151,144
Kentucky,Hickman County,10,11,338,174,164
Kentucky,Hickman County,10,12,317,149,168
Kentucky,Hickman County,10,13,328,151,177
Kentucky,Hickman County,10,14,324,149,175
Kentucky,Hickman County,10,15,274,128,146
Kentucky,Hickman County,10,16,199,98,101
Kentucky,Hickman County,10,17,153,73,80
Kentucky,Hickman County,10,18,164,38,126
Kentucky,Hickman County,11,0,4431,2095,2336
Kentucky,Hickman County,11,1,204,99,105
Kentucky,Hickman County,11,2,229,115,114
Kentucky,Hickman County,11,3,260,125,135
Kentucky,Hickman County,11,4,233,112,121
Kentucky,Hickman County,11,5,208,109,99
Kentucky,Hickman County,11,6,211,92,119
Kentucky,Hickman County,11,7,247,123,124
Kentucky,Hickman County,11,8,214,114,100
Kentucky,Hickman County,11,9,234,111,123
Kentucky,Hickman County,11,10,281,135,146
Kentucky,Hickman County,11,11,326,175,151
Kentucky,Hickman County,11,12,324,148,176
Kentucky,Hickman County,11,13,326,141,185
Kentucky,Hickman County,11,14,307,145,162
Kentucky,Hickman County,11,15,305,138,167
Kentucky,Hickman County,11,16,194,95,99
Kentucky,Hickman County,11,17,158,70,88
Kentucky,Hickman County,11,18,170,48,122
Kentucky,Hickman County,12,0,4380,2066,2314
Kentucky,Hickman County,12,1,193,91,102
Kentucky,Hickman County,12,2,202,100,102
Kentucky,Hickman County,12,3,258,119,139
Kentucky,Hickman County,12,4,244,118,126
Kentucky,Hickman County,12,5,204,113,91
Kentucky,Hickman County,12,6,215,101,114
Kentucky,Hickman County,12,7,225,108,117
Kentucky,Hickman County,12,8,219,114,105
Kentucky,Hickman County,12,9,227,118,109
Kentucky,Hickman County,12,10,277,123,154
Kentucky,Hickman County,12,11,303,162,141
Kentucky,Hickman County,12,12,346,164,182
Kentucky,Hickman County,12,13,311,135,176
Kentucky,Hickman County,12,14,319,151,168
Kentucky,Hickman County,12,15,293,128,165
Kentucky,Hickman County,12,16,227,109,118
Kentucky,Hickman County,12,17,141,59,82
Kentucky,Hickman County,12,18,176,53,123
Kentucky,Hopkins County,1,0,46920,22805,24115
Kentucky,Hopkins County,1,1,3052,1562,1490
Kentucky,Hopkins County,1,2,2963,1557,1406
Kentucky,Hopkins County,1,3,2993,1481,1512
Kentucky,Hopkins County,1,4,2963,1487,1476
Kentucky,Hopkins County,1,5,2575,1317,1258
Kentucky,Hopkins County,1,6,2808,1393,1415
Kentucky,Hopkins County,1,7,2925,1462,1463
Kentucky,Hopkins County,1,8,2959,1514,1445
Kentucky,Hopkins County,1,9,3096,1511,1585
Kentucky,Hopkins County,1,10,3393,1626,1767
Kentucky,Hopkins County,1,11,3640,1744,1896
Kentucky,Hopkins County,1,12,3425,1651,1774
Kentucky,Hopkins County,1,13,2884,1413,1471
Kentucky,Hopkins County,1,14,2263,1091,1172
Kentucky,Hopkins County,1,15,1770,760,1010
Kentucky,Hopkins County,1,16,1355,573,782
Kentucky,Hopkins County,1,17,961,394,567
Kentucky,Hopkins County,1,18,895,269,626
Kentucky,Hopkins County,2,0,46918,22804,24114
Kentucky,Hopkins County,2,1,3052,1562,1490
Kentucky,Hopkins County,2,2,2963,1557,1406
Kentucky,Hopkins County,2,3,2993,1481,1512
Kentucky,Hopkins County,2,4,2963,1487,1476
Kentucky,Hopkins County,2,5,2575,1317,1258
Kentucky,Hopkins County,2,6,2808,1393,1415
Kentucky,Hopkins County,2,7,2925,1462,1463
Kentucky,Hopkins County,2,8,2959,1514,1445
Kentucky,Hopkins County,2,9,3096,1511,1585
Kentucky,Hopkins County,2,10,3393,1626,1767
Kentucky,Hopkins County,2,11,3640,1744,1896
Kentucky,Hopkins County,2,12,3425,1651,1774
Kentucky,Hopkins County,2,13,2884,1413,1471
Kentucky,Hopkins County,2,14,2263,1091,1172
Kentucky,Hopkins County,2,15,1769,760,1009
Kentucky,Hopkins County,2,16,1354,572,782
Kentucky,Hopkins County,2,17,961,394,567
Kentucky,Hopkins County,2,18,895,269,626
Kentucky,Hopkins County,3,0,46841,22758,24083
Kentucky,Hopkins County,3,1,3001,1529,1472
Kentucky,Hopkins County,3,2,2956,1558,1398
Kentucky,Hopkins County,3,3,3007,1494,1513
Kentucky,Hopkins County,3,4,2954,1484,1470
Kentucky,Hopkins County,3,5,2583,1317,1266
Kentucky,Hopkins County,3,6,2793,1379,1414
Kentucky,Hopkins County,3,7,2928,1466,1462
Kentucky,Hopkins County,3,8,2934,1492,1442
Kentucky,Hopkins County,3,9,3104,1523,1581
Kentucky,Hopkins County,3,10,3381,1629,1752
Kentucky,Hopkins County,3,11,3632,1730,1902
Kentucky,Hopkins County,3,12,3435,1656,1779
Kentucky,Hopkins County,3,13,2894,1415,1479
Kentucky,Hopkins County,3,14,2264,1090,1174
Kentucky,Hopkins County,3,15,1767,765,1002
Kentucky,Hopkins County,3,16,1346,571,775
Kentucky,Hopkins County,3,17,964,388,576
Kentucky,Hopkins County,3,18,898,272,626
Kentucky,Hopkins County,4,0,46844,22832,24012
Kentucky,Hopkins County,4,1,2952,1507,1445
Kentucky,Hopkins County,4,2,2977,1575,1402
Kentucky,Hopkins County,4,3,3034,1538,1496
Kentucky,Hopkins County,4,4,2890,1470,1420
Kentucky,Hopkins County,4,5,2656,1347,1309
Kentucky,Hopkins County,4,6,2720,1344,1376
Kentucky,Hopkins County,4,7,2936,1480,1456
Kentucky,Hopkins County,4,8,2809,1407,1402
Kentucky,Hopkins County,4,9,3140,1575,1565
Kentucky,Hopkins County,4,10,3292,1610,1682
Kentucky,Hopkins County,4,11,3605,1675,1930
Kentucky,Hopkins County,4,12,3476,1693,1783
Kentucky,Hopkins County,4,13,3036,1479,1557
Kentucky,Hopkins County,4,14,2265,1073,1192
Kentucky,Hopkins County,4,15,1817,809,1008
Kentucky,Hopkins County,4,16,1354,582,772
Kentucky,Hopkins County,4,17,965,374,591
Kentucky,Hopkins County,4,18,920,294,626
Kentucky,Hopkins County,5,0,46607,22752,23855
Kentucky,Hopkins County,5,1,2880,1458,1422
Kentucky,Hopkins County,5,2,3033,1582,1451
Kentucky,Hopkins County,5,3,3038,1583,1455
Kentucky,Hopkins County,5,4,2837,1432,1405
Kentucky,Hopkins County,5,5,2635,1336,1299
Kentucky,Hopkins County,5,6,2714,1364,1350
Kentucky,Hopkins County,5,7,2876,1435,1441
Kentucky,Hopkins County,5,8,2850,1441,1409
Kentucky,Hopkins County,5,9,3016,1543,1473
Kentucky,Hopkins County,5,10,3190,1542,1648
Kentucky,Hopkins County,5,11,3490,1606,1884
Kentucky,Hopkins County,5,12,3468,1702,1766
Kentucky,Hopkins County,5,13,3073,1495,1578
Kentucky,Hopkins County,5,14,2406,1133,1273
Kentucky,Hopkins County,5,15,1860,861,999
Kentucky,Hopkins County,5,16,1394,608,786
Kentucky,Hopkins County,5,17,930,343,587
Kentucky,Hopkins County,5,18,917,288,629
Kentucky,Hopkins County,6,0,46424,22688,23736
Kentucky,Hopkins County,6,1,2766,1406,1360
Kentucky,Hopkins County,6,2,3114,1630,1484
Kentucky,Hopkins County,6,3,2969,1554,1415
Kentucky,Hopkins County,6,4,2758,1393,1365
Kentucky,Hopkins County,6,5,2734,1393,1341
Kentucky,Hopkins County,6,6,2676,1355,1321
Kentucky,Hopkins County,6,7,2848,1408,1440
Kentucky,Hopkins County,6,8,2884,1454,1430
Kentucky,Hopkins County,6,9,2912,1486,1426
Kentucky,Hopkins County,6,10,3152,1544,1608
Kentucky,Hopkins County,6,11,3370,1557,1813
Kentucky,Hopkins County,6,12,3511,1703,1808
Kentucky,Hopkins County,6,13,3104,1494,1610
Kentucky,Hopkins County,6,14,2449,1167,1282
Kentucky,Hopkins County,6,15,1902,883,1019
Kentucky,Hopkins County,6,16,1432,619,813
Kentucky,Hopkins County,6,17,922,350,572
Kentucky,Hopkins County,6,18,921,292,629
Kentucky,Hopkins County,7,0,46155,22485,23670
Kentucky,Hopkins County,7,1,2737,1353,1384
Kentucky,Hopkins County,7,2,3054,1601,1453
Kentucky,Hopkins County,7,3,2973,1589,1384
Kentucky,Hopkins County,7,4,2739,1338,1401
Kentucky,Hopkins County,7,5,2668,1355,1313
Kentucky,Hopkins County,7,6,2712,1388,1324
Kentucky,Hopkins County,7,7,2785,1352,1433
Kentucky,Hopkins County,7,8,2894,1458,1436
Kentucky,Hopkins County,7,9,2864,1451,1413
Kentucky,Hopkins County,7,10,3073,1490,1583
Kentucky,Hopkins County,7,11,3267,1541,1726
Kentucky,Hopkins County,7,12,3470,1670,1800
Kentucky,Hopkins County,7,13,3147,1499,1648
Kentucky,Hopkins County,7,14,2526,1206,1320
Kentucky,Hopkins County,7,15,1927,902,1025
Kentucky,Hopkins County,7,16,1442,622,820
Kentucky,Hopkins County,7,17,936,367,569
Kentucky,Hopkins County,7,18,941,303,638
Kentucky,Hopkins County,8,0,46055,22389,23666
Kentucky,Hopkins County,8,1,2759,1368,1391
Kentucky,Hopkins County,8,2,3063,1595,1468
Kentucky,Hopkins County,8,3,2958,1543,1415
Kentucky,Hopkins County,8,4,2666,1327,1339
Kentucky,Hopkins County,8,5,2720,1376,1344
Kentucky,Hopkins County,8,6,2777,1406,1371
Kentucky,Hopkins County,8,7,2754,1352,1402
Kentucky,Hopkins County,8,8,2875,1431,1444
Kentucky,Hopkins County,8,9,2786,1413,1373
Kentucky,Hopkins County,8,10,3027,1449,1578
Kentucky,Hopkins County,8,11,3168,1519,1649
Kentucky,Hopkins County,8,12,3427,1617,1810
Kentucky,Hopkins County,8,13,3246,1554,1692
Kentucky,Hopkins County,8,14,2577,1232,1345
Kentucky,Hopkins County,8,15,1932,904,1028
Kentucky,Hopkins County,8,16,1419,614,805
Kentucky,Hopkins County,8,17,1008,414,594
Kentucky,Hopkins County,8,18,893,275,618
Kentucky,Hopkins County,9,0,45598,22232,23366
Kentucky,Hopkins County,9,1,2732,1388,1344
Kentucky,Hopkins County,9,2,2987,1522,1465
Kentucky,Hopkins County,9,3,2929,1548,1381
Kentucky,Hopkins County,9,4,2683,1361,1322
Kentucky,Hopkins County,9,5,2584,1314,1270
Kentucky,Hopkins County,9,6,2800,1432,1368
Kentucky,Hopkins County,9,7,2716,1329,1387
Kentucky,Hopkins County,9,8,2822,1415,1407
Kentucky,Hopkins County,9,9,2706,1347,1359
Kentucky,Hopkins County,9,10,2977,1467,1510
Kentucky,Hopkins County,9,11,3069,1498,1571
Kentucky,Hopkins County,9,12,3398,1564,1834
Kentucky,Hopkins County,9,13,3243,1568,1675
Kentucky,Hopkins County,9,14,2675,1264,1411
Kentucky,Hopkins County,9,15,1920,883,1037
Kentucky,Hopkins County,9,16,1459,638,821
Kentucky,Hopkins County,9,17,988,415,573
Kentucky,Hopkins County,9,18,910,279,631
Kentucky,Hopkins County,10,0,45293,22098,23195
Kentucky,Hopkins County,10,1,2686,1376,1310
Kentucky,Hopkins County,10,2,2922,1489,1433
Kentucky,Hopkins County,10,3,2957,1515,1442
Kentucky,Hopkins County,10,4,2690,1413,1277
Kentucky,Hopkins County,10,5,2504,1261,1243
Kentucky,Hopkins County,10,6,2842,1457,1385
Kentucky,Hopkins County,10,7,2656,1330,1326
Kentucky,Hopkins County,10,8,2779,1354,1425
Kentucky,Hopkins County,10,9,2692,1343,1349
Kentucky,Hopkins County,10,10,2886,1456,1430
Kentucky,Hopkins County,10,11,3052,1489,1563
Kentucky,Hopkins County,10,12,3317,1515,1802
Kentucky,Hopkins County,10,13,3186,1521,1665
Kentucky,Hopkins County,10,14,2708,1272,1436
Kentucky,Hopkins County,10,15,2059,945,1114
Kentucky,Hopkins County,10,16,1459,653,806
Kentucky,Hopkins County,10,17,1016,429,587
Kentucky,Hopkins County,10,18,882,280,602
Kentucky,Hopkins County,11,0,45024,21962,23062
Kentucky,Hopkins County,11,1,2730,1398,1332
Kentucky,Hopkins County,11,2,2793,1385,1408
Kentucky,Hopkins County,11,3,3015,1561,1454
Kentucky,Hopkins County,11,4,2611,1372,1239
Kentucky,Hopkins County,11,5,2421,1213,1208
Kentucky,Hopkins County,11,6,2879,1453,1426
Kentucky,Hopkins County,11,7,2599,1293,1306
Kentucky,Hopkins County,11,8,2733,1340,1393
Kentucky,Hopkins County,11,9,2764,1372,1392
Kentucky,Hopkins County,11,10,2737,1383,1354
Kentucky,Hopkins County,11,11,3038,1495,1543
Kentucky,Hopkins County,11,12,3181,1474,1707
Kentucky,Hopkins County,11,13,3232,1534,1698
Kentucky,Hopkins County,11,14,2746,1294,1452
Kentucky,Hopkins County,11,15,2114,992,1122
Kentucky,Hopkins County,11,16,1492,655,837
Kentucky,Hopkins County,11,17,1032,443,589
Kentucky,Hopkins County,11,18,907,305,602
Kentucky,Hopkins County,12,0,44686,21787,22899
Kentucky,Hopkins County,12,1,2678,1377,1301
Kentucky,Hopkins County,12,2,2717,1324,1393
Kentucky,Hopkins County,12,3,2997,1538,1459
Kentucky,Hopkins County,12,4,2648,1399,1249
Kentucky,Hopkins County,12,5,2337,1138,1199
Kentucky,Hopkins County,12,6,2868,1465,1403
Kentucky,Hopkins County,12,7,2630,1304,1326
Kentucky,Hopkins County,12,8,2683,1311,1372
Kentucky,Hopkins County,12,9,2739,1366,1373
Kentucky,Hopkins County,12,10,2682,1349,1333
Kentucky,Hopkins County,12,11,2929,1443,1486
Kentucky,Hopkins County,12,12,3095,1459,1636
Kentucky,Hopkins County,12,13,3189,1512,1677
Kentucky,Hopkins County,12,14,2812,1315,1497
Kentucky,Hopkins County,12,15,2216,1054,1162
Kentucky,Hopkins County,12,16,1527,687,840
Kentucky,Hopkins County,12,17,1022,425,597
Kentucky,Hopkins County,12,18,917,321,596
Kentucky,Jackson County,1,0,13494,6711,6783
Kentucky,Jackson County,1,1,824,445,379
Kentucky,Jackson County,1,2,892,464,428
Kentucky,Jackson County,1,3,890,491,399
Kentucky,Jackson County,1,4,928,460,468
Kentucky,Jackson County,1,5,694,334,360
Kentucky,Jackson County,1,6,805,381,424
Kentucky,Jackson County,1,7,865,451,414
Kentucky,Jackson County,1,8,964,466,498
Kentucky,Jackson County,1,9,954,464,490
Kentucky,Jackson County,1,10,1015,506,509
Kentucky,Jackson County,1,11,1026,507,519
Kentucky,Jackson County,1,12,980,484,496
Kentucky,Jackson County,1,13,795,393,402
Kentucky,Jackson County,1,14,666,323,343
Kentucky,Jackson County,1,15,500,243,257
Kentucky,Jackson County,1,16,315,154,161
Kentucky,Jackson County,1,17,182,70,112
Kentucky,Jackson County,1,18,199,75,124
Kentucky,Jackson County,2,0,13490,6707,6783
Kentucky,Jackson County,2,1,824,445,379
Kentucky,Jackson County,2,2,890,462,428
Kentucky,Jackson County,2,3,888,489,399
Kentucky,Jackson County,2,4,929,461,468
Kentucky,Jackson County,2,5,693,333,360
Kentucky,Jackson County,2,6,805,381,424
Kentucky,Jackson County,2,7,865,451,414
Kentucky,Jackson County,2,8,964,466,498
Kentucky,Jackson County,2,9,955,464,491
Kentucky,Jackson County,2,10,1013,505,508
Kentucky,Jackson County,2,11,1027,508,519
Kentucky,Jackson County,2,12,980,484,496
Kentucky,Jackson County,2,13,795,393,402
Kentucky,Jackson County,2,14,666,323,343
Kentucky,Jackson County,2,15,500,243,257
Kentucky,Jackson County,2,16,315,154,161
Kentucky,Jackson County,2,17,182,70,112
Kentucky,Jackson County,2,18,199,75,124
Kentucky,Jackson County,3,0,13480,6702,6778
Kentucky,Jackson County,3,1,827,446,381
Kentucky,Jackson County,3,2,884,462,422
Kentucky,Jackson County,3,3,893,492,401
Kentucky,Jackson County,3,4,913,451,462
Kentucky,Jackson County,3,5,708,343,365
Kentucky,Jackson County,3,6,803,380,423
Kentucky,Jackson County,3,7,870,454,416
Kentucky,Jackson County,3,8,955,457,498
Kentucky,Jackson County,3,9,955,462,493
Kentucky,Jackson County,3,10,1012,505,507
Kentucky,Jackson County,3,11,1028,508,520
Kentucky,Jackson County,3,12,981,485,496
Kentucky,Jackson County,3,13,797,394,403
Kentucky,Jackson County,3,14,662,322,340
Kentucky,Jackson County,3,15,492,236,256
Kentucky,Jackson County,3,16,316,158,158
Kentucky,Jackson County,3,17,184,72,112
Kentucky,Jackson County,3,18,200,75,125
Kentucky,Jackson County,4,0,13384,6659,6725
Kentucky,Jackson County,4,1,811,440,371
Kentucky,Jackson County,4,2,820,432,388
Kentucky,Jackson County,4,3,904,485,419
Kentucky,Jackson County,4,4,860,436,424
Kentucky,Jackson County,4,5,769,383,386
Kentucky,Jackson County,4,6,773,369,404
Kentucky,Jackson County,4,7,873,460,413
Kentucky,Jackson County,4,8,893,408,485
Kentucky,Jackson County,4,9,964,477,487
Kentucky,Jackson County,4,10,991,495,496
Kentucky,Jackson County,4,11,1023,498,525
Kentucky,Jackson County,4,12,990,490,500
Kentucky,Jackson County,4,13,843,417,426
Kentucky,Jackson County,4,14,656,318,338
Kentucky,Jackson County,4,15,498,232,266
Kentucky,Jackson County,4,16,337,170,167
Kentucky,Jackson County,4,17,184,78,106
Kentucky,Jackson County,4,18,195,71,124
Kentucky,Jackson County,5,0,13307,6644,6663
Kentucky,Jackson County,5,1,762,426,336
Kentucky,Jackson County,5,2,851,447,404
Kentucky,Jackson County,5,3,900,474,426
Kentucky,Jackson County,5,4,828,444,384
Kentucky,Jackson County,5,5,799,385,414
Kentucky,Jackson County,5,6,728,352,376
Kentucky,Jackson County,5,7,884,464,420
Kentucky,Jackson County,5,8,857,395,462
Kentucky,Jackson County,5,9,954,479,475
Kentucky,Jackson County,5,10,972,475,497
Kentucky,Jackson County,5,11,987,477,510
Kentucky,Jackson County,5,12,1009,500,509
Kentucky,Jackson County,5,13,831,422,409
Kentucky,Jackson County,5,14,683,328,355
Kentucky,Jackson County,5,15,535,258,277
Kentucky,Jackson County,5,16,347,164,183
Kentucky,Jackson County,5,17,185,82,103
Kentucky,Jackson County,5,18,195,72,123
Kentucky,Jackson County,6,0,13391,6662,6729
Kentucky,Jackson County,6,1,794,425,369
Kentucky,Jackson County,6,2,864,463,401
Kentucky,Jackson County,6,3,880,459,421
Kentucky,Jackson County,6,4,804,439,365
Kentucky,Jackson County,6,5,818,394,424
Kentucky,Jackson County,6,6,728,360,368
Kentucky,Jackson County,6,7,859,436,423
Kentucky,Jackson County,6,8,873,428,445
Kentucky,Jackson County,6,9,959,477,482
Kentucky,Jackson County,6,10,954,459,495
Kentucky,Jackson County,6,11,988,478,510
Kentucky,Jackson County,6,12,1015,495,520
Kentucky,Jackson County,6,13,858,429,429
Kentucky,Jackson County,6,14,714,348,366
Kentucky,Jackson County,6,15,547,266,281
Kentucky,Jackson County,6,16,366,160,206
Kentucky,Jackson County,6,17,178,83,95
Kentucky,Jackson County,6,18,192,63,129
Kentucky,Jackson County,7,0,13307,6661,6646
Kentucky,Jackson County,7,1,805,433,372
Kentucky,Jackson County,7,2,841,452,389
Kentucky,Jackson County,7,3,854,454,400
Kentucky,Jackson County,7,4,798,450,348
Kentucky,Jackson County,7,5,781,396,385
Kentucky,Jackson County,7,6,746,364,382
Kentucky,Jackson County,7,7,807,402,405
Kentucky,Jackson County,7,8,882,442,440
Kentucky,Jackson County,7,9,937,458,479
Kentucky,Jackson County,7,10,917,438,479
Kentucky,Jackson County,7,11,985,490,495
Kentucky,Jackson County,7,12,1003,495,508
Kentucky,Jackson County,7,13,899,450,449
Kentucky,Jackson County,7,14,742,352,390
Kentucky,Jackson County,7,15,560,269,291
Kentucky,Jackson County,7,16,374,164,210
Kentucky,Jackson County,7,17,195,96,99
Kentucky,Jackson County,7,18,181,56,125
Kentucky,Jackson County,8,0,13325,6618,6707
Kentucky,Jackson County,8,1,825,428,397
Kentucky,Jackson County,8,2,820,442,378
Kentucky,Jackson County,8,3,838,435,403
Kentucky,Jackson County,8,4,822,457,365
Kentucky,Jackson County,8,5,753,386,367
Kentucky,Jackson County,8,6,730,355,375
Kentucky,Jackson County,8,7,787,380,407
Kentucky,Jackson County,8,8,875,448,427
Kentucky,Jackson County,8,9,941,445,496
Kentucky,Jackson County,8,10,911,450,461
Kentucky,Jackson County,8,11,965,471,494
Kentucky,Jackson County,8,12,1007,494,513
Kentucky,Jackson County,8,13,960,473,487
Kentucky,Jackson County,8,14,730,348,382
Kentucky,Jackson County,8,15,576,274,302
Kentucky,Jackson County,8,16,392,173,219
Kentucky,Jackson County,8,17,206,99,107
Kentucky,Jackson County,8,18,187,60,127
Kentucky,Jackson County,9,0,13364,6638,6726
Kentucky,Jackson County,9,1,841,442,399
Kentucky,Jackson County,9,2,798,426,372
Kentucky,Jackson County,9,3,824,431,393
Kentucky,Jackson County,9,4,844,465,379
Kentucky,Jackson County,9,5,725,383,342
Kentucky,Jackson County,9,6,772,376,396
Kentucky,Jackson County,9,7,755,373,382
Kentucky,Jackson County,9,8,895,455,440
Kentucky,Jackson County,9,9,894,413,481
Kentucky,Jackson County,9,10,934,454,480
Kentucky,Jackson County,9,11,956,472,484
Kentucky,Jackson County,9,12,995,477,518
Kentucky,Jackson County,9,13,977,481,496
Kentucky,Jackson County,9,14,761,376,385
Kentucky,Jackson County,9,15,586,272,314
Kentucky,Jackson County,9,16,393,170,223
Kentucky,Jackson County,9,17,234,109,125
Kentucky,Jackson County,9,18,180,63,117
Kentucky,Jackson County,10,0,13422,6670,6752
Kentucky,Jackson County,10,1,891,438,453
Kentucky,Jackson County,10,2,828,447,381
Kentucky,Jackson County,10,3,836,453,383
Kentucky,Jackson County,10,4,800,433,367
Kentucky,Jackson County,10,5,708,383,325
Kentucky,Jackson County,10,6,793,388,405
Kentucky,Jackson County,10,7,713,352,361
Kentucky,Jackson County,10,8,916,470,446
Kentucky,Jackson County,10,9,862,404,458
Kentucky,Jackson County,10,10,940,468,472
Kentucky,Jackson County,10,11,964,471,493
Kentucky,Jackson County,10,12,935,447,488
Kentucky,Jackson County,10,13,991,479,512
Kentucky,Jackson County,10,14,767,386,381
Kentucky,Jackson County,10,15,629,294,335
Kentucky,Jackson County,10,16,426,192,234
Kentucky,Jackson County,10,17,239,103,136
Kentucky,Jackson County,10,18,184,62,122
Kentucky,Jackson County,11,0,13403,6646,6757
Kentucky,Jackson County,11,1,846,428,418
Kentucky,Jackson County,11,2,830,443,387
Kentucky,Jackson County,11,3,857,459,398
Kentucky,Jackson County,11,4,790,418,372
Kentucky,Jackson County,11,5,684,365,319
Kentucky,Jackson County,11,6,834,411,423
Kentucky,Jackson County,11,7,720,356,364
Kentucky,Jackson County,11,8,870,432,438
Kentucky,Jackson County,11,9,868,419,449
Kentucky,Jackson County,11,10,939,477,462
Kentucky,Jackson County,11,11,928,440,488
Kentucky,Jackson County,11,12,956,467,489
Kentucky,Jackson County,11,13,966,465,501
Kentucky,Jackson County,11,14,792,390,402
Kentucky,Jackson County,11,15,653,312,341
Kentucky,Jackson County,11,16,433,202,231
Kentucky,Jackson County,11,17,261,105,156
Kentucky,Jackson County,11,18,176,57,119
Kentucky,Jackson County,12,0,13329,6638,6691
Kentucky,Jackson County,12,1,827,429,398
Kentucky,Jackson County,12,2,863,467,396
Kentucky,Jackson County,12,3,832,440,392
Kentucky,Jackson County,12,4,757,410,347
Kentucky,Jackson County,12,5,686,353,333
Kentucky,Jackson County,12,6,810,428,382
Kentucky,Jackson County,12,7,721,357,364
Kentucky,Jackson County,12,8,817,395,422
Kentucky,Jackson County,12,9,878,428,450
Kentucky,Jackson County,12,10,931,467,464
Kentucky,Jackson County,12,11,899,429,470
Kentucky,Jackson County,12,12,947,463,484
Kentucky,Jackson County,12,13,955,462,493
Kentucky,Jackson County,12,14,841,419,422
Kentucky,Jackson County,12,15,672,312,360
Kentucky,Jackson County,12,16,458,212,246
Kentucky,Jackson County,12,17,253,108,145
Kentucky,Jackson County,12,18,182,59,123
Kentucky,Jefferson County,1,0,741096,357699,383397
Kentucky,Jefferson County,1,1,48634,24924,23710
Kentucky,Jefferson County,1,2,47238,23966,23272
Kentucky,Jefferson County,1,3,47444,24375,23069
Kentucky,Jefferson County,1,4,47427,24166,23261
Kentucky,Jefferson County,1,5,48887,24223,24664
Kentucky,Jefferson County,1,6,53848,26447,27401
Kentucky,Jefferson County,1,7,50435,25156,25279
Kentucky,Jefferson County,1,8,48529,24001,24528
Kentucky,Jefferson County,1,9,47401,23593,23808
Kentucky,Jefferson County,1,10,55008,26861,28147
Kentucky,Jefferson County,1,11,55749,26780,28969
Kentucky,Jefferson County,1,12,49937,23587,26350
Kentucky,Jefferson County,1,13,41464,19635,21829
Kentucky,Jefferson County,1,14,28926,13102,15824
Kentucky,Jefferson County,1,15,22136,9415,12721
Kentucky,Jefferson County,1,16,18527,7515,11012
Kentucky,Jefferson County,1,17,15452,5768,9684
Kentucky,Jefferson County,1,18,14054,4185,9869
Kentucky,Jefferson County,2,0,741075,357687,383388
Kentucky,Jefferson County,2,1,48633,24923,23710
Kentucky,Jefferson County,2,2,47236,23964,23272
Kentucky,Jefferson County,2,3,47441,24373,23068
Kentucky,Jefferson County,2,4,47425,24164,23261
Kentucky,Jefferson County,2,5,48886,24222,24664
Kentucky,Jefferson County,2,6,53847,26446,27401
Kentucky,Jefferson County,2,7,50434,25156,25278
Kentucky,Jefferson County,2,8,48526,24000,24526
Kentucky,Jefferson County,2,9,47398,23592,23806
Kentucky,Jefferson County,2,10,55004,26859,28145
Kentucky,Jefferson County,2,11,55749,26780,28969
Kentucky,Jefferson County,2,12,49936,23587,26349
Kentucky,Jefferson County,2,13,41464,19635,21829
Kentucky,Jefferson County,2,14,28928,13103,15825
Kentucky,Jefferson County,2,15,22132,9413,12719
Kentucky,Jefferson County,2,16,18528,7516,11012
Kentucky,Jefferson County,2,17,15452,5768,9684
Kentucky,Jefferson County,2,18,14056,4186,9870
Kentucky,Jefferson County,3,0,742054,358072,383982
Kentucky,Jefferson County,3,1,48775,24971,23804
Kentucky,Jefferson County,3,2,47128,23898,23230
Kentucky,Jefferson County,3,3,47456,24340,23116
Kentucky,Jefferson County,3,4,47233,24107,23126
Kentucky,Jefferson County,3,5,49011,24227,24784
Kentucky,Jefferson County,3,6,53772,26438,27334
Kentucky,Jefferson County,3,7,50734,25233,25501
Kentucky,Jefferson County,3,8,48195,23873,24322
Kentucky,Jefferson County,3,9,47626,23677,23949
Kentucky,Jefferson County,3,10,54597,26681,27916
Kentucky,Jefferson County,3,11,55838,26816,29022
Kentucky,Jefferson County,3,12,50241,23730,26511
Kentucky,Jefferson County,3,13,42183,19971,22212
Kentucky,Jefferson County,3,14,29015,13194,15821
Kentucky,Jefferson County,3,15,22199,9445,12754
Kentucky,Jefferson County,3,16,18455,7478,10977
Kentucky,Jefferson County,3,17,15430,5767,9663
Kentucky,Jefferson County,3,18,14166,4226,9940
Kentucky,Jefferson County,4,0,746361,360031,386330
Kentucky,Jefferson County,4,1,49208,25238,23970
Kentucky,Jefferson County,4,2,46978,23796,23182
Kentucky,Jefferson County,4,3,47552,24349,23203
Kentucky,Jefferson County,4,4,46038,23616,22422
Kentucky,Jefferson County,4,5,49984,24627,25357
Kentucky,Jefferson County,4,6,53895,26544,27351
Kentucky,Jefferson County,4,7,52072,25734,26338
Kentucky,Jefferson County,4,8,46920,23269,23651
Kentucky,Jefferson County,4,9,48512,23914,24598
Kentucky,Jefferson County,4,10,52497,25653,26844
Kentucky,Jefferson County,4,11,56431,27201,29230
Kentucky,Jefferson County,4,12,51237,24190,27047
Kentucky,Jefferson County,4,13,44828,21147,23681
Kentucky,Jefferson County,4,14,29547,13506,16041
Kentucky,Jefferson County,4,15,22555,9653,12902
Kentucky,Jefferson County,4,16,18305,7428,10877
Kentucky,Jefferson County,4,17,15248,5748,9500
Kentucky,Jefferson County,4,18,14554,4418,10136
Kentucky,Jefferson County,5,0,751629,362786,388843
Kentucky,Jefferson County,5,1,49132,25154,23978
Kentucky,Jefferson County,5,2,47343,24060,23283
Kentucky,Jefferson County,5,3,47554,24361,23193
Kentucky,Jefferson County,5,4,45476,23413,22063
Kentucky,Jefferson County,5,5,50720,24921,25799
Kentucky,Jefferson County,5,6,54225,26873,27352
Kentucky,Jefferson County,5,7,52855,26115,26740
Kentucky,Jefferson County,5,8,46689,23120,23569
Kentucky,Jefferson County,5,9,49053,24071,24982
Kentucky,Jefferson County,5,10,50591,24790,25801
Kentucky,Jefferson County,5,11,56265,27170,29095
Kentucky,Jefferson County,5,12,52459,24701,27758
Kentucky,Jefferson County,5,13,45159,21264,23895
Kentucky,Jefferson County,5,14,32604,15005,17599
Kentucky,Jefferson County,5,15,23313,10051,13262
Kentucky,Jefferson County,5,16,18186,7360,10826
Kentucky,Jefferson County,5,17,15043,5741,9302
Kentucky,Jefferson County,5,18,14962,4616,10346
Kentucky,Jefferson County,6,0,759183,366705,392478
Kentucky,Jefferson County,6,1,49172,25210,23962
Kentucky,Jefferson County,6,2,48086,24499,23587
Kentucky,Jefferson County,6,3,47480,24286,23194
Kentucky,Jefferson County,6,4,45753,23559,22194
Kentucky,Jefferson County,6,5,51173,25107,26066
Kentucky,Jefferson County,6,6,55286,27464,27822
Kentucky,Jefferson County,6,7,53903,26688,27215
Kentucky,Jefferson County,6,8,47276,23391,23885
Kentucky,Jefferson County,6,9,49088,23994,25094
Kentucky,Jefferson County,6,10,49182,24166,25016
Kentucky,Jefferson County,6,11,55650,26853,28797
Kentucky,Jefferson County,6,12,53782,25509,28273
Kentucky,Jefferson County,6,13,45975,21467,24508
Kentucky,Jefferson County,6,14,34561,16025,18536
Kentucky,Jefferson County,6,15,24525,10679,13846
Kentucky,Jefferson County,6,16,18428,7457,10971
Kentucky,Jefferson County,6,17,14654,5612,9042
Kentucky,Jefferson County,6,18,15209,4739,10470
Kentucky,Jefferson County,7,0,761725,368096,393629
Kentucky,Jefferson County,7,1,49003,25279,23724
Kentucky,Jefferson County,7,2,47811,24457,23354
Kentucky,Jefferson County,7,3,47349,24121,23228
Kentucky,Jefferson County,7,4,45618,23401,22217
Kentucky,Jefferson County,7,5,50479,25185,25294
Kentucky,Jefferson County,7,6,56460,27859,28601
Kentucky,Jefferson County,7,7,53776,26540,27236
Kentucky,Jefferson County,7,8,48081,23927,24154
Kentucky,Jefferson County,7,9,48182,23512,24670
Kentucky,Jefferson County,7,10,47594,23277,24317
Kentucky,Jefferson County,7,11,55122,26521,28601
Kentucky,Jefferson County,7,12,54308,25800,28508
Kentucky,Jefferson County,7,13,46961,21927,25034
Kentucky,Jefferson County,7,14,36883,17094,19789
Kentucky,Jefferson County,7,15,25452,11160,14292
Kentucky,Jefferson County,7,16,18728,7636,11092
Kentucky,Jefferson County,7,17,14331,5484,8847
Kentucky,Jefferson County,7,18,15587,4916,10671
Kentucky,Jefferson County,8,0,764946,369785,395161
Kentucky,Jefferson County,8,1,49082,25327,23755
Kentucky,Jefferson County,8,2,47707,24494,23213
Kentucky,Jefferson County,8,3,47021,23897,23124
Kentucky,Jefferson County,8,4,45694,23382,22312
Kentucky,Jefferson County,8,5,49550,24881,24669
Kentucky,Jefferson County,8,6,57845,28450,29395
Kentucky,Jefferson County,8,7,53585,26462,27123
Kentucky,Jefferson County,8,8,49236,24464,24772
Kentucky,Jefferson County,8,9,47289,23086,24203
Kentucky,Jefferson County,8,10,47040,22994,24046
Kentucky,Jefferson County,8,11,53993,26014,27979
Kentucky,Jefferson County,8,12,54650,25973,28677
Kentucky,Jefferson County,8,13,48002,22329,25673
Kentucky,Jefferson County,8,14,39299,18267,21032
Kentucky,Jefferson County,8,15,26088,11554,14534
Kentucky,Jefferson County,8,16,18995,7768,11227
Kentucky,Jefferson County,8,17,14044,5409,8635
Kentucky,Jefferson County,8,18,15826,5034,10792
Kentucky,Jefferson County,9,0,767464,371171,396293
Kentucky,Jefferson County,9,1,48850,25144,23706
Kentucky,Jefferson County,9,2,47571,24438,23133
Kentucky,Jefferson County,9,3,47025,23927,23098
Kentucky,Jefferson County,9,4,46149,23614,22535
Kentucky,Jefferson County,9,5,48717,24696,24021
Kentucky,Jefferson County,9,6,59474,29078,30396
Kentucky,Jefferson County,9,7,53457,26583,26874
Kentucky,Jefferson County,9,8,50039,24766,25273
Kentucky,Jefferson County,9,9,45760,22399,23361
Kentucky,Jefferson County,9,10,47744,23161,24583
Kentucky,Jefferson County,9,11,51581,24901,26680
Kentucky,Jefferson County,9,12,54828,26137,28691
Kentucky,Jefferson County,9,13,48885,22695,26190
Kentucky,Jefferson County,9,14,41677,19319,22358
Kentucky,Jefferson County,9,15,26484,11836,14648
Kentucky,Jefferson County,9,16,19437,8035,11402
Kentucky,Jefferson County,9,17,13978,5365,8613
Kentucky,Jefferson County,9,18,15808,5077,10731
Kentucky,Jefferson County,10,0,769828,372253,397575
Kentucky,Jefferson County,10,1,48745,25020,23725
Kentucky,Jefferson County,10,2,47225,24200,23025
Kentucky,Jefferson County,10,3,47085,24013,23072
Kentucky,Jefferson County,10,4,46459,23691,22768
Kentucky,Jefferson County,10,5,48248,24535,23713
Kentucky,Jefferson County,10,6,60678,29721,30957
Kentucky,Jefferson County,10,7,53554,26739,26815
Kentucky,Jefferson County,10,8,50659,25022,25637
Kentucky,Jefferson County,10,9,45348,22210,23138
Kentucky,Jefferson County,10,10,47747,23003,24744
Kentucky,Jefferson County,10,11,49558,24020,25538
Kentucky,Jefferson County,10,12,54323,25863,28460
Kentucky,Jefferson County,10,13,49569,22981,26588
Kentucky,Jefferson County,10,14,41670,19229,22441
Kentucky,Jefferson County,10,15,29269,13174,16095
Kentucky,Jefferson County,10,16,19923,8289,11634
Kentucky,Jefferson County,10,17,13965,5398,8567
Kentucky,Jefferson County,10,18,15803,5145,10658
Kentucky,Jefferson County,11,0,768101,371267,396834
Kentucky,Jefferson County,11,1,48341,24874,23467
Kentucky,Jefferson County,11,2,46552,23813,22739
Kentucky,Jefferson County,11,3,47080,24089,22991
Kentucky,Jefferson County,11,4,46052,23453,22599
Kentucky,Jefferson County,11,5,47692,23954,23738
Kentucky,Jefferson County,11,6,60332,29713,30619
Kentucky,Jefferson County,11,7,53427,26754,26673
Kentucky,Jefferson County,11,8,50952,25130,25822
Kentucky,Jefferson County,11,9,45244,22111,23133
Kentucky,Jefferson County,11,10,47227,22778,24449
Kentucky,Jefferson County,11,11,47581,23055,24526
Kentucky,Jefferson County,11,12,53241,25269,27972
Kentucky,Jefferson County,11,13,50398,23548,26850
Kentucky,Jefferson County,11,14,42180,19244,22936
Kentucky,Jefferson County,11,15,30867,14002,16865
Kentucky,Jefferson County,11,16,20858,8728,12130
Kentucky,Jefferson County,11,17,14267,5572,8695
Kentucky,Jefferson County,11,18,15810,5180,10630
Kentucky,Jefferson County,12,0,766757,370607,396150
Kentucky,Jefferson County,12,1,47660,24529,23131
Kentucky,Jefferson County,12,2,46450,23790,22660
Kentucky,Jefferson County,12,3,46670,23963,22707
Kentucky,Jefferson County,12,4,45950,23287,22663
Kentucky,Jefferson County,12,5,47294,23785,23509
Kentucky,Jefferson County,12,6,59451,29611,29840
Kentucky,Jefferson County,12,7,54215,26955,27260
Kentucky,Jefferson County,12,8,50769,24957,25812
Kentucky,Jefferson County,12,9,45620,22419,23201
Kentucky,Jefferson County,12,10,46395,22299,24096
Kentucky,Jefferson County,12,11,45521,22002,23519
Kentucky,Jefferson County,12,12,52492,24863,27629
Kentucky,Jefferson County,12,13,50529,23655,26874
Kentucky,Jefferson County,12,14,42900,19546,23354
Kentucky,Jefferson County,12,15,32854,14899,17955
Kentucky,Jefferson County,12,16,21490,9031,12459
Kentucky,Jefferson County,12,17,14591,5781,8810
Kentucky,Jefferson County,12,18,15906,5235,10671
Kentucky,Jessamine County,1,0,48586,23668,24918
Kentucky,Jessamine County,1,1,3547,1809,1738
Kentucky,Jessamine County,1,2,3407,1738,1669
Kentucky,Jessamine County,1,3,3477,1806,1671
Kentucky,Jessamine County,1,4,3660,1790,1870
Kentucky,Jessamine County,1,5,3311,1566,1745
Kentucky,Jessamine County,1,6,3187,1580,1607
Kentucky,Jessamine County,1,7,3212,1582,1630
Kentucky,Jessamine County,1,8,3366,1640,1726
Kentucky,Jessamine County,1,9,3239,1548,1691
Kentucky,Jessamine County,1,10,3645,1758,1887
Kentucky,Jessamine County,1,11,3530,1680,1850
Kentucky,Jessamine County,1,12,2961,1426,1535
Kentucky,Jessamine County,1,13,2550,1204,1346
Kentucky,Jessamine County,1,14,1744,839,905
Kentucky,Jessamine County,1,15,1298,611,687
Kentucky,Jessamine County,1,16,986,454,532
Kentucky,Jessamine County,1,17,731,329,402
Kentucky,Jessamine County,1,18,735,308,427
Kentucky,Jessamine County,2,0,48580,23665,24915
Kentucky,Jessamine County,2,1,3547,1809,1738
Kentucky,Jessamine County,2,2,3407,1738,1669
Kentucky,Jessamine County,2,3,3477,1806,1671
Kentucky,Jessamine County,2,4,3660,1790,1870
Kentucky,Jessamine County,2,5,3311,1566,1745
Kentucky,Jessamine County,2,6,3187,1580,1607
Kentucky,Jessamine County,2,7,3212,1582,1630
Kentucky,Jessamine County,2,8,3366,1640,1726
Kentucky,Jessamine County,2,9,3239,1548,1691
Kentucky,Jessamine County,2,10,3645,1758,1887
Kentucky,Jessamine County,2,11,3530,1680,1850
Kentucky,Jessamine County,2,12,2956,1424,1532
Kentucky,Jessamine County,2,13,2549,1203,1346
Kentucky,Jessamine County,2,14,1744,839,905
Kentucky,Jessamine County,2,15,1298,611,687
Kentucky,Jessamine County,2,16,986,454,532
Kentucky,Jessamine County,2,17,731,329,402
Kentucky,Jessamine County,2,18,735,308,427
Kentucky,Jessamine County,3,0,48682,23705,24977
Kentucky,Jessamine County,3,1,3555,1806,1749
Kentucky,Jessamine County,3,2,3423,1740,1683
Kentucky,Jessamine County,3,3,3476,1802,1674
Kentucky,Jessamine County,3,4,3642,1792,1850
Kentucky,Jessamine County,3,5,3326,1575,1751
Kentucky,Jessamine County,3,6,3189,1572,1617
Kentucky,Jessamine County,3,7,3232,1592,1640
Kentucky,Jessamine County,3,8,3334,1621,1713
Kentucky,Jessamine County,3,9,3250,1557,1693
Kentucky,Jessamine County,3,10,3634,1750,1884
Kentucky,Jessamine County,3,11,3542,1692,1850
Kentucky,Jessamine County,3,12,3005,1445,1560
Kentucky,Jessamine County,3,13,2550,1204,1346
Kentucky,Jessamine County,3,14,1766,849,917
Kentucky,Jessamine County,3,15,1297,612,685
Kentucky,Jessamine County,3,16,980,452,528
Kentucky,Jessamine County,3,17,739,334,405
Kentucky,Jessamine County,3,18,742,310,432
Kentucky,Jessamine County,4,0,48892,23800,25092
Kentucky,Jessamine County,4,1,3535,1784,1751
Kentucky,Jessamine County,4,2,3425,1745,1680
Kentucky,Jessamine County,4,3,3467,1777,1690
Kentucky,Jessamine County,4,4,3554,1770,1784
Kentucky,Jessamine County,4,5,3370,1614,1756
Kentucky,Jessamine County,4,6,3126,1518,1608
Kentucky,Jessamine County,4,7,3250,1593,1657
Kentucky,Jessamine County,4,8,3209,1550,1659
Kentucky,Jessamine County,4,9,3365,1662,1703
Kentucky,Jessamine County,4,10,3508,1652,1856
Kentucky,Jessamine County,4,11,3579,1729,1850
Kentucky,Jessamine County,4,12,3151,1515,1636
Kentucky,Jessamine County,4,13,2614,1227,1387
Kentucky,Jessamine County,4,14,1866,900,966
Kentucky,Jessamine County,4,15,1336,634,702
Kentucky,Jessamine County,4,16,1002,464,538
Kentucky,Jessamine County,4,17,754,344,410
Kentucky,Jessamine County,4,18,781,322,459
Kentucky,Jessamine County,5,0,49467,24112,25355
Kentucky,Jessamine County,5,1,3414,1694,1720
Kentucky,Jessamine County,5,2,3530,1803,1727
Kentucky,Jessamine County,5,3,3473,1802,1671
Kentucky,Jessamine County,5,4,3542,1789,1753
Kentucky,Jessamine County,5,5,3537,1725,1812
Kentucky,Jessamine County,5,6,3144,1527,1617
Kentucky,Jessamine County,5,7,3206,1555,1651
Kentucky,Jessamine County,5,8,3201,1567,1634
Kentucky,Jessamine County,5,9,3447,1707,1740
Kentucky,Jessamine County,5,10,3419,1611,1808
Kentucky,Jessamine County,5,11,3577,1724,1853
Kentucky,Jessamine County,5,12,3257,1561,1696
Kentucky,Jessamine County,5,13,2640,1229,1411
Kentucky,Jessamine County,5,14,2099,1002,1097
Kentucky,Jessamine County,5,15,1373,646,727
Kentucky,Jessamine County,5,16,1027,481,546
Kentucky,Jessamine County,5,17,773,360,413
Kentucky,Jessamine County,5,18,808,329,479
Kentucky,Jessamine County,6,0,50120,24473,25647
Kentucky,Jessamine County,6,1,3400,1717,1683
Kentucky,Jessamine County,6,2,3548,1822,1726
Kentucky,Jessamine County,6,3,3462,1773,1689
Kentucky,Jessamine County,6,4,3602,1825,1777
Kentucky,Jessamine County,6,5,3685,1821,1864
Kentucky,Jessamine County,6,6,3209,1544,1665
Kentucky,Jessamine County,6,7,3189,1554,1635
Kentucky,Jessamine County,6,8,3170,1556,1614
Kentucky,Jessamine County,6,9,3470,1719,1751
Kentucky,Jessamine County,6,10,3354,1592,1762
Kentucky,Jessamine County,6,11,3579,1722,1857
Kentucky,Jessamine County,6,12,3364,1601,1763
Kentucky,Jessamine County,6,13,2719,1272,1447
Kentucky,Jessamine County,6,14,2251,1069,1182
Kentucky,Jessamine County,6,15,1426,668,758
Kentucky,Jessamine County,6,16,1071,506,565
Kentucky,Jessamine County,6,17,770,360,410
Kentucky,Jessamine County,6,18,851,352,499
Kentucky,Jessamine County,7,0,50871,24826,26045
Kentucky,Jessamine County,7,1,3467,1794,1673
Kentucky,Jessamine County,7,2,3544,1792,1752
Kentucky,Jessamine County,7,3,3523,1812,1711
Kentucky,Jessamine County,7,4,3628,1857,1771
Kentucky,Jessamine County,7,5,3695,1823,1872
Kentucky,Jessamine County,7,6,3211,1563,1648
Kentucky,Jessamine County,7,7,3192,1549,1643
Kentucky,Jessamine County,7,8,3220,1569,1651
Kentucky,Jessamine County,7,9,3396,1672,1724
Kentucky,Jessamine County,7,10,3371,1605,1766
Kentucky,Jessamine County,7,11,3681,1753,1928
Kentucky,Jessamine County,7,12,3430,1615,1815
Kentucky,Jessamine County,7,13,2788,1325,1463
Kentucky,Jessamine County,7,14,2407,1132,1275
Kentucky,Jessamine County,7,15,1529,721,808
Kentucky,Jessamine County,7,16,1114,504,610
Kentucky,Jessamine County,7,17,795,369,426
Kentucky,Jessamine County,7,18,880,371,509
Kentucky,Jessamine County,8,0,51809,25238,26571
Kentucky,Jessamine County,8,1,3476,1787,1689
Kentucky,Jessamine County,8,2,3666,1874,1792
Kentucky,Jessamine County,8,3,3494,1800,1694
Kentucky,Jessamine County,8,4,3698,1868,1830
Kentucky,Jessamine County,8,5,3759,1873,1886
Kentucky,Jessamine County,8,6,3243,1556,1687
Kentucky,Jessamine County,8,7,3284,1588,1696
Kentucky,Jessamine County,8,8,3251,1567,1684
Kentucky,Jessamine County,8,9,3392,1662,1730
Kentucky,Jessamine County,8,10,3400,1635,1765
Kentucky,Jessamine County,8,11,3662,1735,1927
Kentucky,Jessamine County,8,12,3551,1669,1882
Kentucky,Jessamine County,8,13,2937,1401,1536
Kentucky,Jessamine County,8,14,2515,1163,1352
Kentucky,Jessamine County,8,15,1629,782,847
Kentucky,Jessamine County,8,16,1146,517,629
Kentucky,Jessamine County,8,17,817,391,426
Kentucky,Jessamine County,8,18,889,370,519
Kentucky,Jessamine County,9,0,52219,25424,26795
Kentucky,Jessamine County,9,1,3473,1805,1668
Kentucky,Jessamine County,9,2,3583,1841,1742
Kentucky,Jessamine County,9,3,3570,1796,1774
Kentucky,Jessamine County,9,4,3687,1860,1827
Kentucky,Jessamine County,9,5,3630,1813,1817
Kentucky,Jessamine County,9,6,3315,1609,1706
Kentucky,Jessamine County,9,7,3235,1537,1698
Kentucky,Jessamine County,9,8,3405,1664,1741
Kentucky,Jessamine County,9,9,3277,1586,1691
Kentucky,Jessamine County,9,10,3456,1687,1769
Kentucky,Jessamine County,9,11,3578,1678,1900
Kentucky,Jessamine County,9,12,3612,1713,1899
Kentucky,Jessamine County,9,13,3118,1482,1636
Kentucky,Jessamine County,9,14,2586,1189,1397
Kentucky,Jessamine County,9,15,1745,824,921
Kentucky,Jessamine County,9,16,1171,543,628
Kentucky,Jessamine County,9,17,846,408,438
Kentucky,Jessamine County,9,18,932,389,543
Kentucky,Jessamine County,10,0,53259,25932,27327
Kentucky,Jessamine County,10,1,3473,1797,1676
Kentucky,Jessamine County,10,2,3678,1908,1770
Kentucky,Jessamine County,10,3,3705,1853,1852
Kentucky,Jessamine County,10,4,3697,1856,1841
Kentucky,Jessamine County,10,5,3653,1826,1827
Kentucky,Jessamine County,10,6,3466,1694,1772
Kentucky,Jessamine County,10,7,3254,1564,1690
Kentucky,Jessamine County,10,8,3408,1649,1759
Kentucky,Jessamine County,10,9,3266,1598,1668
Kentucky,Jessamine County,10,10,3599,1746,1853
Kentucky,Jessamine County,10,11,3501,1663,1838
Kentucky,Jessamine County,10,12,3687,1724,1963
Kentucky,Jessamine County,10,13,3215,1523,1692
Kentucky,Jessamine County,10,14,2598,1209,1389
Kentucky,Jessamine County,10,15,1986,931,1055
Kentucky,Jessamine County,10,16,1211,553,658
Kentucky,Jessamine County,10,17,893,433,460
Kentucky,Jessamine County,10,18,969,405,564
Kentucky,Jessamine County,11,0,53757,26148,27609
Kentucky,Jessamine County,11,1,3453,1780,1673
Kentucky,Jessamine County,11,2,3610,1857,1753
Kentucky,Jessamine County,11,3,3624,1831,1793
Kentucky,Jessamine County,11,4,3774,1875,1899
Kentucky,Jessamine County,11,5,3716,1851,1865
Kentucky,Jessamine County,11,6,3631,1799,1832
Kentucky,Jessamine County,11,7,3228,1559,1669
Kentucky,Jessamine County,11,8,3339,1608,1731
Kentucky,Jessamine County,11,9,3360,1661,1699
Kentucky,Jessamine County,11,10,3600,1755,1845
Kentucky,Jessamine County,11,11,3395,1589,1806
Kentucky,Jessamine County,11,12,3666,1726,1940
Kentucky,Jessamine County,11,13,3371,1571,1800
Kentucky,Jessamine County,11,14,2620,1229,1391
Kentucky,Jessamine County,11,15,2139,1001,1138
Kentucky,Jessamine County,11,16,1306,597,709
Kentucky,Jessamine County,11,17,912,424,488
Kentucky,Jessamine County,11,18,1013,435,578
Kentucky,Jessamine County,12,0,54115,26306,27809
Kentucky,Jessamine County,12,1,3365,1728,1637
Kentucky,Jessamine County,12,2,3609,1848,1761
Kentucky,Jessamine County,12,3,3690,1868,1822
Kentucky,Jessamine County,12,4,3693,1852,1841
Kentucky,Jessamine County,12,5,3662,1814,1848
Kentucky,Jessamine County,12,6,3583,1788,1795
Kentucky,Jessamine County,12,7,3238,1589,1649
Kentucky,Jessamine County,12,8,3357,1596,1761
Kentucky,Jessamine County,12,9,3362,1649,1713
Kentucky,Jessamine County,12,10,3553,1723,1830
Kentucky,Jessamine County,12,11,3380,1601,1779
Kentucky,Jessamine County,12,12,3750,1779,1971
Kentucky,Jessamine County,12,13,3472,1603,1869
Kentucky,Jessamine County,12,14,2691,1267,1424
Kentucky,Jessamine County,12,15,2274,1059,1215
Kentucky,Jessamine County,12,16,1415,655,760
Kentucky,Jessamine County,12,17,961,425,536
Kentucky,Jessamine County,12,18,1060,462,598
Kentucky,Johnson County,1,0,23356,11484,11872
Kentucky,Johnson County,1,1,1364,711,653
Kentucky,Johnson County,1,2,1457,795,662
Kentucky,Johnson County,1,3,1495,731,764
Kentucky,Johnson County,1,4,1524,809,715
Kentucky,Johnson County,1,5,1329,668,661
Kentucky,Johnson County,1,6,1371,675,696
Kentucky,Johnson County,1,7,1415,727,688
Kentucky,Johnson County,1,8,1586,765,821
Kentucky,Johnson County,1,9,1647,798,849
Kentucky,Johnson County,1,10,1763,844,919
Kentucky,Johnson County,1,11,1753,859,894
Kentucky,Johnson County,1,12,1733,820,913
Kentucky,Johnson County,1,13,1618,833,785
Kentucky,Johnson County,1,14,1127,521,606
Kentucky,Johnson County,1,15,851,408,443
Kentucky,Johnson County,1,16,572,262,310
Kentucky,Johnson County,1,17,421,157,264
Kentucky,Johnson County,1,18,330,101,229
Kentucky,Johnson County,2,0,23359,11485,11874
Kentucky,Johnson County,2,1,1364,711,653
Kentucky,Johnson County,2,2,1457,795,662
Kentucky,Johnson County,2,3,1495,731,764
Kentucky,Johnson County,2,4,1524,809,715
Kentucky,Johnson County,2,5,1329,668,661
Kentucky,Johnson County,2,6,1371,675,696
Kentucky,Johnson County,2,7,1415,727,688
Kentucky,Johnson County,2,8,1586,765,821
Kentucky,Johnson County,2,9,1647,798,849
Kentucky,Johnson County,2,10,1763,844,919
Kentucky,Johnson County,2,11,1755,860,895
Kentucky,Johnson County,2,12,1734,820,914
Kentucky,Johnson County,2,13,1618,833,785
Kentucky,Johnson County,2,14,1127,521,606
Kentucky,Johnson County,2,15,851,408,443
Kentucky,Johnson County,2,16,572,262,310
Kentucky,Johnson County,2,17,421,157,264
Kentucky,Johnson County,2,18,330,101,229
Kentucky,Johnson County,3,0,23385,11499,11886
Kentucky,Johnson County,3,1,1378,719,659
Kentucky,Johnson County,3,2,1450,788,662
Kentucky,Johnson County,3,3,1507,742,765
Kentucky,Johnson County,3,4,1513,799,714
Kentucky,Johnson County,3,5,1351,679,672
Kentucky,Johnson County,3,6,1366,677,689
Kentucky,Johnson County,3,7,1424,724,700
Kentucky,Johnson County,3,8,1588,768,820
Kentucky,Johnson County,3,9,1655,802,853
Kentucky,Johnson County,3,10,1762,851,911
Kentucky,Johnson County,3,11,1740,851,889
Kentucky,Johnson County,3,12,1729,817,912
Kentucky,Johnson County,3,13,1623,835,788
Kentucky,Johnson County,3,14,1134,523,611
Kentucky,Johnson County,3,15,850,406,444
Kentucky,Johnson County,3,16,570,265,305
Kentucky,Johnson County,3,17,414,149,265
Kentucky,Johnson County,3,18,331,104,227
Kentucky,Johnson County,4,0,23417,11516,11901
Kentucky,Johnson County,4,1,1363,691,672
Kentucky,Johnson County,4,2,1447,781,666
Kentucky,Johnson County,4,3,1540,776,764
Kentucky,Johnson County,4,4,1435,746,689
Kentucky,Johnson County,4,5,1408,719,689
Kentucky,Johnson County,4,6,1331,673,658
Kentucky,Johnson County,4,7,1437,713,724
Kentucky,Johnson County,4,8,1535,747,788
Kentucky,Johnson County,4,9,1668,812,856
Kentucky,Johnson County,4,10,1758,859,899
Kentucky,Johnson County,4,11,1719,823,896
Kentucky,Johnson County,4,12,1750,846,904
Kentucky,Johnson County,4,13,1648,839,809
Kentucky,Johnson County,4,14,1153,540,613
Kentucky,Johnson County,4,15,870,423,447
Kentucky,Johnson County,4,16,596,272,324
Kentucky,Johnson County,4,17,423,145,278
Kentucky,Johnson County,4,18,336,111,225
Kentucky,Johnson County,5,0,23403,11479,11924
Kentucky,Johnson County,5,1,1438,725,713
Kentucky,Johnson County,5,2,1410,752,658
Kentucky,Johnson County,5,3,1535,783,752
Kentucky,Johnson County,5,4,1372,702,670
Kentucky,Johnson County,5,5,1435,731,704
Kentucky,Johnson County,5,6,1339,684,655
Kentucky,Johnson County,5,7,1451,705,746
Kentucky,Johnson County,5,8,1452,726,726
Kentucky,Johnson County,5,9,1682,824,858
Kentucky,Johnson County,5,10,1731,832,899
Kentucky,Johnson County,5,11,1715,801,914
Kentucky,Johnson County,5,12,1718,835,883
Kentucky,Johnson County,5,13,1625,808,817
Kentucky,Johnson County,5,14,1228,598,630
Kentucky,Johnson County,5,15,892,425,467
Kentucky,Johnson County,5,16,620,278,342
Kentucky,Johnson County,5,17,421,159,262
Kentucky,Johnson County,5,18,339,111,228
Kentucky,Johnson County,6,0,23458,11513,11945
Kentucky,Johnson County,6,1,1475,747,728
Kentucky,Johnson County,6,2,1409,740,669
Kentucky,Johnson County,6,3,1528,793,735
Kentucky,Johnson County,6,4,1383,715,668
Kentucky,Johnson County,6,5,1445,728,717
Kentucky,Johnson County,6,6,1330,687,643
Kentucky,Johnson County,6,7,1421,680,741
Kentucky,Johnson County,6,8,1466,727,739
Kentucky,Johnson County,6,9,1681,829,852
Kentucky,Johnson County,6,10,1685,809,876
Kentucky,Johnson County,6,11,1698,808,890
Kentucky,Johnson County,6,12,1727,830,897
Kentucky,Johnson County,6,13,1595,770,825
Kentucky,Johnson County,6,14,1317,665,652
Kentucky,Johnson County,6,15,917,426,491
Kentucky,Johnson County,6,16,624,284,340
Kentucky,Johnson County,6,17,409,156,253
Kentucky,Johnson County,6,18,348,119,229
Kentucky,Johnson County,7,0,23252,11414,11838
Kentucky,Johnson County,7,1,1455,727,728
Kentucky,Johnson County,7,2,1413,736,677
Kentucky,Johnson County,7,3,1465,776,689
Kentucky,Johnson County,7,4,1381,713,668
Kentucky,Johnson County,7,5,1421,732,689
Kentucky,Johnson County,7,6,1323,684,639
Kentucky,Johnson County,7,7,1408,678,730
Kentucky,Johnson County,7,8,1425,704,721
Kentucky,Johnson County,7,9,1615,787,828
Kentucky,Johnson County,7,10,1594,761,833
Kentucky,Johnson County,7,11,1694,810,884
Kentucky,Johnson County,7,12,1713,823,890
Kentucky,Johnson County,7,13,1615,760,855
Kentucky,Johnson County,7,14,1371,704,667
Kentucky,Johnson County,7,15,955,449,506
Kentucky,Johnson County,7,16,649,284,365
Kentucky,Johnson County,7,17,404,171,233
Kentucky,Johnson County,7,18,351,115,236
Kentucky,Johnson County,8,0,23128,11351,11777
Kentucky,Johnson County,8,1,1441,723,718
Kentucky,Johnson County,8,2,1398,709,689
Kentucky,Johnson County,8,3,1447,778,669
Kentucky,Johnson County,8,4,1420,729,691
Kentucky,Johnson County,8,5,1258,663,595
Kentucky,Johnson County,8,6,1391,694,697
Kentucky,Johnson County,8,7,1383,678,705
Kentucky,Johnson County,8,8,1422,718,704
Kentucky,Johnson County,8,9,1557,744,813
Kentucky,Johnson County,8,10,1575,750,825
Kentucky,Johnson County,8,11,1691,814,877
Kentucky,Johnson County,8,12,1662,791,871
Kentucky,Johnson County,8,13,1629,776,853
Kentucky,Johnson County,8,14,1445,742,703
Kentucky,Johnson County,8,15,956,438,518
Kentucky,Johnson County,8,16,671,307,364
Kentucky,Johnson County,8,17,429,188,241
Kentucky,Johnson County,8,18,353,109,244
Kentucky,Johnson County,9,0,22858,11192,11666
Kentucky,Johnson County,9,1,1358,664,694
Kentucky,Johnson County,9,2,1358,685,673
Kentucky,Johnson County,9,3,1457,777,680
Kentucky,Johnson County,9,4,1413,732,681
Kentucky,Johnson County,9,5,1255,662,593
Kentucky,Johnson County,9,6,1350,680,670
Kentucky,Johnson County,9,7,1317,655,662
Kentucky,Johnson County,9,8,1441,694,747
Kentucky,Johnson County,9,9,1502,738,764
Kentucky,Johnson County,9,10,1593,761,832
Kentucky,Johnson County,9,11,1654,797,857
Kentucky,Johnson County,9,12,1623,762,861
Kentucky,Johnson County,9,13,1599,753,846
Kentucky,Johnson County,9,14,1473,748,725
Kentucky,Johnson County,9,15,967,448,519
Kentucky,Johnson County,9,16,700,328,372
Kentucky,Johnson County,9,17,430,188,242
Kentucky,Johnson County,9,18,368,120,248
Kentucky,Johnson County,10,0,22606,11119,11487
Kentucky,Johnson County,10,1,1323,671,652
Kentucky,Johnson County,10,2,1345,676,669
Kentucky,Johnson County,10,3,1429,775,654
Kentucky,Johnson County,10,4,1399,728,671
Kentucky,Johnson County,10,5,1222,640,582
Kentucky,Johnson County,10,6,1315,678,637
Kentucky,Johnson County,10,7,1334,666,668
Kentucky,Johnson County,10,8,1394,668,726
Kentucky,Johnson County,10,9,1424,703,721
Kentucky,Johnson County,10,10,1578,764,814
Kentucky,Johnson County,10,11,1634,778,856
Kentucky,Johnson County,10,12,1606,742,864
Kentucky,Johnson County,10,13,1582,752,830
Kentucky,Johnson County,10,14,1436,722,714
Kentucky,Johnson County,10,15,1062,518,544
Kentucky,Johnson County,10,16,702,318,384
Kentucky,Johnson County,10,17,436,184,252
Kentucky,Johnson County,10,18,385,136,249
Kentucky,Johnson County,11,0,22391,10986,11405
Kentucky,Johnson County,11,1,1276,638,638
Kentucky,Johnson County,11,2,1354,666,688
Kentucky,Johnson County,11,3,1435,756,679
Kentucky,Johnson County,11,4,1379,730,649
Kentucky,Johnson County,11,5,1208,636,572
Kentucky,Johnson County,11,6,1327,668,659
Kentucky,Johnson County,11,7,1254,625,629
Kentucky,Johnson County,11,8,1389,683,706
Kentucky,Johnson County,11,9,1420,697,723
Kentucky,Johnson County,11,10,1564,760,804
Kentucky,Johnson County,11,11,1577,755,822
Kentucky,Johnson County,11,12,1580,748,832
Kentucky,Johnson County,11,13,1548,726,822
Kentucky,Johnson County,11,14,1395,675,720
Kentucky,Johnson County,11,15,1138,569,569
Kentucky,Johnson County,11,16,731,328,403
Kentucky,Johnson County,11,17,450,197,253
Kentucky,Johnson County,11,18,366,129,237
Kentucky,Johnson County,12,0,22188,10901,11287
Kentucky,Johnson County,12,1,1250,650,600
Kentucky,Johnson County,12,2,1372,681,691
Kentucky,Johnson County,12,3,1407,724,683
Kentucky,Johnson County,12,4,1389,767,622
Kentucky,Johnson County,12,5,1174,608,566
Kentucky,Johnson County,12,6,1268,638,630
Kentucky,Johnson County,12,7,1244,627,617
Kentucky,Johnson County,12,8,1386,656,730
Kentucky,Johnson County,12,9,1391,694,697
Kentucky,Johnson County,12,10,1499,728,771
Kentucky,Johnson County,12,11,1494,711,783
Kentucky,Johnson County,12,12,1592,753,839
Kentucky,Johnson County,12,13,1562,734,828
Kentucky,Johnson County,12,14,1367,646,721
Kentucky,Johnson County,12,15,1185,599,586
Kentucky,Johnson County,12,16,778,350,428
Kentucky,Johnson County,12,17,465,199,266
Kentucky,Johnson County,12,18,365,136,229
Kentucky,Kenton County,1,0,159720,78915,80805
Kentucky,Kenton County,1,1,11568,5844,5724
Kentucky,Kenton County,1,2,11215,5817,5398
Kentucky,Kenton County,1,3,10704,5577,5127
Kentucky,Kenton County,1,4,10240,5287,4953
Kentucky,Kenton County,1,5,10088,5056,5032
Kentucky,Kenton County,1,6,12190,6049,6141
Kentucky,Kenton County,1,7,11686,5853,5833
Kentucky,Kenton County,1,8,10458,5381,5077
Kentucky,Kenton County,1,9,11068,5531,5537
Kentucky,Kenton County,1,10,12080,6074,6006
Kentucky,Kenton County,1,11,11979,5933,6046
Kentucky,Kenton County,1,12,10194,5078,5116
Kentucky,Kenton County,1,13,8397,4074,4323
Kentucky,Kenton County,1,14,5499,2559,2940
Kentucky,Kenton County,1,15,4194,1867,2327
Kentucky,Kenton County,1,16,3208,1357,1851
Kentucky,Kenton County,1,17,2601,945,1656
Kentucky,Kenton County,1,18,2351,633,1718
Kentucky,Kenton County,2,0,159728,78920,80808
Kentucky,Kenton County,2,1,11565,5842,5723
Kentucky,Kenton County,2,2,11215,5817,5398
Kentucky,Kenton County,2,3,10704,5577,5127
Kentucky,Kenton County,2,4,10241,5288,4953
Kentucky,Kenton County,2,5,10088,5056,5032
Kentucky,Kenton County,2,6,12189,6048,6141
Kentucky,Kenton County,2,7,11685,5853,5832
Kentucky,Kenton County,2,8,10458,5381,5077
Kentucky,Kenton County,2,9,11067,5530,5537
Kentucky,Kenton County,2,10,12083,6077,6006
Kentucky,Kenton County,2,11,11980,5934,6046
Kentucky,Kenton County,2,12,10197,5079,5118
Kentucky,Kenton County,2,13,8397,4074,4323
Kentucky,Kenton County,2,14,5500,2560,2940
Kentucky,Kenton County,2,15,4197,1868,2329
Kentucky,Kenton County,2,16,3209,1357,1852
Kentucky,Kenton County,2,17,2602,946,1656
Kentucky,Kenton County,2,18,2351,633,1718
Kentucky,Kenton County,3,0,159961,79025,80936
Kentucky,Kenton County,3,1,11625,5885,5740
Kentucky,Kenton County,3,2,11176,5780,5396
Kentucky,Kenton County,3,3,10743,5582,5161
Kentucky,Kenton County,3,4,10231,5296,4935
Kentucky,Kenton County,3,5,10061,5037,5024
Kentucky,Kenton County,3,6,12171,6053,6118
Kentucky,Kenton County,3,7,11750,5879,5871
Kentucky,Kenton County,3,8,10399,5350,5049
Kentucky,Kenton County,3,9,11054,5519,5535
Kentucky,Kenton County,3,10,12056,6039,6017
Kentucky,Kenton County,3,11,11982,5953,6029
Kentucky,Kenton County,3,12,10282,5117,5165
Kentucky,Kenton County,3,13,8512,4126,4386
Kentucky,Kenton County,3,14,5529,2589,2940
Kentucky,Kenton County,3,15,4218,1879,2339
Kentucky,Kenton County,3,16,3203,1346,1857
Kentucky,Kenton County,3,17,2598,954,1644
Kentucky,Kenton County,3,18,2371,641,1730
Kentucky,Kenton County,4,0,160526,79343,81183
Kentucky,Kenton County,4,1,11679,5949,5730
Kentucky,Kenton County,4,2,11089,5699,5390
Kentucky,Kenton County,4,3,10758,5564,5194
Kentucky,Kenton County,4,4,10116,5278,4838
Kentucky,Kenton County,4,5,10019,5017,5002
Kentucky,Kenton County,4,6,12017,5978,6039
Kentucky,Kenton County,4,7,12048,6004,6044
Kentucky,Kenton County,4,8,10124,5234,4890
Kentucky,Kenton County,4,9,11012,5527,5485
Kentucky,Kenton County,4,10,11723,5823,5900
Kentucky,Kenton County,4,11,12073,6055,6018
Kentucky,Kenton County,4,12,10547,5180,5367
Kentucky,Kenton County,4,13,9056,4383,4673
Kentucky,Kenton County,4,14,5688,2706,2982
Kentucky,Kenton County,4,15,4385,1962,2423
Kentucky,Kenton County,4,16,3169,1330,1839
Kentucky,Kenton County,4,17,2578,975,1603
Kentucky,Kenton County,4,18,2445,679,1766
Kentucky,Kenton County,5,0,161704,79946,81758
Kentucky,Kenton County,5,1,11569,5928,5641
Kentucky,Kenton County,5,2,11214,5668,5546
Kentucky,Kenton County,5,3,10862,5635,5227
Kentucky,Kenton County,5,4,9964,5214,4750
Kentucky,Kenton County,5,5,10214,5131,5083
Kentucky,Kenton County,5,6,11929,5915,6014
Kentucky,Kenton County,5,7,12235,6072,6163
Kentucky,Kenton County,5,8,10375,5352,5023
Kentucky,Kenton County,5,9,10771,5430,5341
Kentucky,Kenton County,5,10,11492,5694,5798
Kentucky,Kenton County,5,11,12083,6075,6008
Kentucky,Kenton County,5,12,10814,5321,5493
Kentucky,Kenton County,5,13,9115,4404,4711
Kentucky,Kenton County,5,14,6301,2988,3313
Kentucky,Kenton County,5,15,4538,2047,2491
Kentucky,Kenton County,5,16,3175,1377,1798
Kentucky,Kenton County,5,17,2537,959,1578
Kentucky,Kenton County,5,18,2516,736,1780
Kentucky,Kenton County,6,0,163131,80666,82465
Kentucky,Kenton County,6,1,11628,5907,5721
Kentucky,Kenton County,6,2,11228,5643,5585
Kentucky,Kenton County,6,3,11052,5743,5309
Kentucky,Kenton County,6,4,9854,5178,4676
Kentucky,Kenton County,6,5,10357,5225,5132
Kentucky,Kenton County,6,6,11910,5894,6016
Kentucky,Kenton County,6,7,12296,6109,6187
Kentucky,Kenton County,6,8,10689,5512,5177
Kentucky,Kenton County,6,9,10523,5338,5185
Kentucky,Kenton County,6,10,11221,5563,5658
Kentucky,Kenton County,6,11,12008,5975,6033
Kentucky,Kenton County,6,12,11175,5519,5656
Kentucky,Kenton County,6,13,9391,4549,4842
Kentucky,Kenton County,6,14,6767,3210,3557
Kentucky,Kenton County,6,15,4706,2140,2566
Kentucky,Kenton County,6,16,3303,1441,1862
Kentucky,Kenton County,6,17,2498,951,1547
Kentucky,Kenton County,6,18,2525,769,1756
Kentucky,Kenton County,7,0,163623,81067,82556
Kentucky,Kenton County,7,1,11399,5918,5481
Kentucky,Kenton County,7,2,11297,5639,5658
Kentucky,Kenton County,7,3,11073,5796,5277
Kentucky,Kenton County,7,4,9868,5157,4711
Kentucky,Kenton County,7,5,10244,5233,5011
Kentucky,Kenton County,7,6,12098,5990,6108
Kentucky,Kenton County,7,7,12003,5966,6037
Kentucky,Kenton County,7,8,10949,5572,5377
Kentucky,Kenton County,7,9,10241,5212,5029
Kentucky,Kenton County,7,10,10935,5472,5463
Kentucky,Kenton County,7,11,11951,5943,6008
Kentucky,Kenton County,7,12,11411,5583,5828
Kentucky,Kenton County,7,13,9520,4677,4843
Kentucky,Kenton County,7,14,7351,3497,3854
Kentucky,Kenton County,7,15,4841,2201,2640
Kentucky,Kenton County,7,16,3460,1500,1960
Kentucky,Kenton County,7,17,2425,933,1492
Kentucky,Kenton County,7,18,2557,778,1779
Kentucky,Kenton County,8,0,164478,81383,83095
Kentucky,Kenton County,8,1,11333,5837,5496
Kentucky,Kenton County,8,2,11337,5740,5597
Kentucky,Kenton County,8,3,10978,5718,5260
Kentucky,Kenton County,8,4,9965,5228,4737
Kentucky,Kenton County,8,5,10193,5197,4996
Kentucky,Kenton County,8,6,12077,5922,6155
Kentucky,Kenton County,8,7,12019,5988,6031
Kentucky,Kenton County,8,8,11261,5692,5569
Kentucky,Kenton County,8,9,10035,5116,4919
Kentucky,Kenton County,8,10,10747,5309,5438
Kentucky,Kenton County,8,11,11805,5887,5918
Kentucky,Kenton County,8,12,11487,5648,5839
Kentucky,Kenton County,8,13,9768,4812,4956
Kentucky,Kenton County,8,14,7892,3729,4163
Kentucky,Kenton County,8,15,4936,2238,2698
Kentucky,Kenton County,8,16,3563,1531,2032
Kentucky,Kenton County,8,17,2464,972,1492
Kentucky,Kenton County,8,18,2618,819,1799
Kentucky,Kenton County,9,0,164962,81601,83361
Kentucky,Kenton County,9,1,11082,5678,5404
Kentucky,Kenton County,9,2,11394,5780,5614
Kentucky,Kenton County,9,3,10889,5560,5329
Kentucky,Kenton County,9,4,9998,5218,4780
Kentucky,Kenton County,9,5,9857,5024,4833
Kentucky,Kenton County,9,6,12631,6330,6301
Kentucky,Kenton County,9,7,11832,5953,5879
Kentucky,Kenton County,9,8,11465,5759,5706
Kentucky,Kenton County,9,9,9685,4960,4725
Kentucky,Kenton County,9,10,10617,5269,5348
Kentucky,Kenton County,9,11,11574,5717,5857
Kentucky,Kenton County,9,12,11576,5711,5865
Kentucky,Kenton County,9,13,10027,4943,5084
Kentucky,Kenton County,9,14,8430,3944,4486
Kentucky,Kenton County,9,15,5066,2333,2733
Kentucky,Kenton County,9,16,3698,1605,2093
Kentucky,Kenton County,9,17,2449,968,1481
Kentucky,Kenton County,9,18,2692,849,1843
Kentucky,Kenton County,10,0,165608,81878,83730
Kentucky,Kenton County,10,1,11032,5639,5393
Kentucky,Kenton County,10,2,11224,5767,5457
Kentucky,Kenton County,10,3,11084,5555,5529
Kentucky,Kenton County,10,4,9951,5229,4722
Kentucky,Kenton County,10,5,9770,4993,4777
Kentucky,Kenton County,10,6,12682,6448,6234
Kentucky,Kenton County,10,7,11970,5980,5990
Kentucky,Kenton County,10,8,11515,5706,5809
Kentucky,Kenton County,10,9,9861,5046,4815
Kentucky,Kenton County,10,10,10285,5094,5191
Kentucky,Kenton County,10,11,11227,5509,5718
Kentucky,Kenton County,10,12,11619,5740,5879
Kentucky,Kenton County,10,13,10247,5031,5216
Kentucky,Kenton County,10,14,8490,3980,4510
Kentucky,Kenton County,10,15,5656,2622,3034
Kentucky,Kenton County,10,16,3846,1661,2185
Kentucky,Kenton County,10,17,2461,1006,1455
Kentucky,Kenton County,10,18,2688,872,1816
Kentucky,Kenton County,11,0,166292,82259,84033
Kentucky,Kenton County,11,1,11054,5648,5406
Kentucky,Kenton County,11,2,11147,5747,5400
Kentucky,Kenton County,11,3,11078,5524,5554
Kentucky,Kenton County,11,4,9952,5242,4710
Kentucky,Kenton County,11,5,9709,4975,4734
Kentucky,Kenton County,11,6,12658,6389,6269
Kentucky,Kenton County,11,7,12036,6055,5981
Kentucky,Kenton County,11,8,11499,5703,5796
Kentucky,Kenton County,11,9,10155,5156,4999
Kentucky,Kenton County,11,10,10032,5049,4983
Kentucky,Kenton County,11,11,10985,5343,5642
Kentucky,Kenton County,11,12,11391,5643,5748
Kentucky,Kenton County,11,13,10610,5174,5436
Kentucky,Kenton County,11,14,8616,4083,4533
Kentucky,Kenton County,11,15,6103,2852,3251
Kentucky,Kenton County,11,16,3964,1713,2251
Kentucky,Kenton County,11,17,2623,1092,1531
Kentucky,Kenton County,11,18,2680,871,1809
Kentucky,Kenton County,12,0,166998,82647,84351
Kentucky,Kenton County,12,1,10874,5528,5346
Kentucky,Kenton County,12,2,11013,5765,5248
Kentucky,Kenton County,12,3,11062,5487,5575
Kentucky,Kenton County,12,4,10017,5259,4758
Kentucky,Kenton County,12,5,9795,5031,4764
Kentucky,Kenton County,12,6,12629,6377,6252
Kentucky,Kenton County,12,7,12345,6242,6103
Kentucky,Kenton County,12,8,11306,5615,5691
Kentucky,Kenton County,12,9,10460,5236,5224
Kentucky,Kenton County,12,10,9778,4932,4846
Kentucky,Kenton County,12,11,10619,5250,5369
Kentucky,Kenton County,12,12,11497,5625,5872
Kentucky,Kenton County,12,13,10756,5210,5546
Kentucky,Kenton County,12,14,8764,4207,4557
Kentucky,Kenton County,12,15,6589,3097,3492
Kentucky,Kenton County,12,16,4094,1790,2304
Kentucky,Kenton County,12,17,2750,1120,1630
Kentucky,Kenton County,12,18,2650,876,1774
Kentucky,Knott County,1,0,16346,8148,8198
Kentucky,Knott County,1,1,953,486,467
Kentucky,Knott County,1,2,947,491,456
Kentucky,Knott County,1,3,984,539,445
Kentucky,Knott County,1,4,1232,623,609
Kentucky,Knott County,1,5,1015,513,502
Kentucky,Knott County,1,6,916,455,461
Kentucky,Knott County,1,7,964,477,487
Kentucky,Knott County,1,8,1045,535,510
Kentucky,Knott County,1,9,1170,572,598
Kentucky,Knott County,1,10,1291,652,639
Kentucky,Knott County,1,11,1337,682,655
Kentucky,Knott County,1,12,1212,597,615
Kentucky,Knott County,1,13,1097,571,526
Kentucky,Knott County,1,14,743,347,396
Kentucky,Knott County,1,15,566,256,310
Kentucky,Knott County,1,16,384,185,199
Kentucky,Knott County,1,17,264,103,161
Kentucky,Knott County,1,18,226,64,162
Kentucky,Knott County,2,0,16364,8161,8203
Kentucky,Knott County,2,1,954,487,467
Kentucky,Knott County,2,2,948,492,456
Kentucky,Knott County,2,3,987,542,445
Kentucky,Knott County,2,4,1237,627,610
Kentucky,Knott County,2,5,1015,513,502
Kentucky,Knott County,2,6,914,454,460
Kentucky,Knott County,2,7,966,478,488
Kentucky,Knott County,2,8,1045,536,509
Kentucky,Knott County,2,9,1172,572,600
Kentucky,Knott County,2,10,1293,654,639
Kentucky,Knott County,2,11,1340,684,656
Kentucky,Knott County,2,12,1213,596,617
Kentucky,Knott County,2,13,1097,571,526
Kentucky,Knott County,2,14,743,347,396
Kentucky,Knott County,2,15,566,256,310
Kentucky,Knott County,2,16,384,185,199
Kentucky,Knott County,2,17,264,103,161
Kentucky,Knott County,2,18,226,64,162
Kentucky,Knott County,3,0,16355,8159,8196
Kentucky,Knott County,3,1,966,497,469
Kentucky,Knott County,3,2,943,491,452
Kentucky,Knott County,3,3,985,540,445
Kentucky,Knott County,3,4,1222,621,601
Kentucky,Knott County,3,5,1038,523,515
Kentucky,Knott County,3,6,911,449,462
Kentucky,Knott County,3,7,966,478,488
Kentucky,Knott County,3,8,1044,536,508
Kentucky,Knott County,3,9,1147,563,584
Kentucky,Knott County,3,10,1289,647,642
Kentucky,Knott County,3,11,1336,682,654
Kentucky,Knott County,3,12,1211,601,610
Kentucky,Knott County,3,13,1095,566,529
Kentucky,Knott County,3,14,750,351,399
Kentucky,Knott County,3,15,569,256,313
Kentucky,Knott County,3,16,391,188,203
Kentucky,Knott County,3,17,266,106,160
Kentucky,Knott County,3,18,226,64,162
Kentucky,Knott County,4,0,16312,8105,8207
Kentucky,Knott County,4,1,984,503,481
Kentucky,Knott County,4,2,905,471,434
Kentucky,Knott County,4,3,958,527,431
Kentucky,Knott County,4,4,1196,617,579
Kentucky,Knott County,4,5,1112,545,567
Kentucky,Knott County,4,6,877,425,452
Kentucky,Knott County,4,7,926,457,469
Kentucky,Knott County,4,8,1036,529,507
Kentucky,Knott County,4,9,1100,538,562
Kentucky,Knott County,4,10,1292,639,653
Kentucky,Knott County,4,11,1329,679,650
Kentucky,Knott County,4,12,1218,617,601
Kentucky,Knott County,4,13,1121,566,555
Kentucky,Knott County,4,14,765,362,403
Kentucky,Knott County,4,15,608,266,342
Kentucky,Knott County,4,16,405,190,215
Kentucky,Knott County,4,17,265,108,157
Kentucky,Knott County,4,18,215,66,149
Kentucky,Knott County,5,0,16127,8013,8114
Kentucky,Knott County,5,1,930,468,462
Kentucky,Knott County,5,2,943,489,454
Kentucky,Knott County,5,3,964,534,430
Kentucky,Knott County,5,4,1120,573,547
Kentucky,Knott County,5,5,1133,559,574
Kentucky,Knott County,5,6,845,416,429
Kentucky,Knott County,5,7,909,451,458
Kentucky,Knott County,5,8,1008,510,498
Kentucky,Knott County,5,9,1076,533,543
Kentucky,Knott County,5,10,1268,635,633
Kentucky,Knott County,5,11,1258,630,628
Kentucky,Knott County,5,12,1224,625,599
Kentucky,Knott County,5,13,1133,569,564
Kentucky,Knott County,5,14,799,377,422
Kentucky,Knott County,5,15,610,273,337
Kentucky,Knott County,5,16,426,195,231
Kentucky,Knott County,5,17,262,107,155
Kentucky,Knott County,5,18,219,69,150
Kentucky,Knott County,6,0,16092,7995,8097
Kentucky,Knott County,6,1,904,468,436
Kentucky,Knott County,6,2,961,491,470
Kentucky,Knott County,6,3,958,526,432
Kentucky,Knott County,6,4,1076,566,510
Kentucky,Knott County,6,5,1182,590,592
Kentucky,Knott County,6,6,815,383,432
Kentucky,Knott County,6,7,937,474,463
Kentucky,Knott County,6,8,956,480,476
Kentucky,Knott County,6,9,1065,524,541
Kentucky,Knott County,6,10,1238,610,628
Kentucky,Knott County,6,11,1228,620,608
Kentucky,Knott County,6,12,1246,638,608
Kentucky,Knott County,6,13,1131,557,574
Kentucky,Knott County,6,14,856,430,426
Kentucky,Knott County,6,15,612,262,350
Kentucky,Knott County,6,16,436,197,239
Kentucky,Knott County,6,17,277,119,158
Kentucky,Knott County,6,18,214,60,154
Kentucky,Knott County,7,0,15944,7908,8036
Kentucky,Knott County,7,1,913,476,437
Kentucky,Knott County,7,2,922,454,468
Kentucky,Knott County,7,3,934,488,446
Kentucky,Knott County,7,4,1050,560,490
Kentucky,Knott County,7,5,1209,607,602
Kentucky,Knott County,7,6,820,411,409
Kentucky,Knott County,7,7,885,441,444
Kentucky,Knott County,7,8,915,459,456
Kentucky,Knott County,7,9,1039,521,518
Kentucky,Knott County,7,10,1152,562,590
Kentucky,Knott County,7,11,1234,622,612
Kentucky,Knott County,7,12,1241,627,614
Kentucky,Knott County,7,13,1136,551,585
Kentucky,Knott County,7,14,905,470,435
Kentucky,Knott County,7,15,626,278,348
Kentucky,Knott County,7,16,467,203,264
Kentucky,Knott County,7,17,265,112,153
Kentucky,Knott County,7,18,231,66,165
Kentucky,Knott County,8,0,15680,7789,7891
Kentucky,Knott County,8,1,838,438,400
Kentucky,Knott County,8,2,910,460,450
Kentucky,Knott County,8,3,879,461,418
Kentucky,Knott County,8,4,1067,569,498
Kentucky,Knott County,8,5,1209,623,586
Kentucky,Knott County,8,6,783,389,394
Kentucky,Knott County,8,7,836,416,420
Kentucky,Knott County,8,8,873,430,443
Kentucky,Knott County,8,9,1031,526,505
Kentucky,Knott County,8,10,1096,529,567
Kentucky,Knott County,8,11,1212,602,610
Kentucky,Knott County,8,12,1245,631,614
Kentucky,Knott County,8,13,1138,558,580
Kentucky,Knott County,8,14,934,478,456
Kentucky,Knott County,8,15,646,297,349
Kentucky,Knott County,8,16,459,188,271
Kentucky,Knott County,8,17,287,123,164
Kentucky,Knott County,8,18,237,71,166
Kentucky,Knott County,9,0,15492,7680,7812
Kentucky,Knott County,9,1,852,432,420
Kentucky,Knott County,9,2,891,456,435
Kentucky,Knott County,9,3,871,460,411
Kentucky,Knott County,9,4,1055,559,496
Kentucky,Knott County,9,5,1143,584,559
Kentucky,Knott County,9,6,829,412,417
Kentucky,Knott County,9,7,797,393,404
Kentucky,Knott County,9,8,851,422,429
Kentucky,Knott County,9,9,983,487,496
Kentucky,Knott County,9,10,1019,510,509
Kentucky,Knott County,9,11,1176,560,616
Kentucky,Knott County,9,12,1239,639,600
Kentucky,Knott County,9,13,1118,566,552
Kentucky,Knott County,9,14,984,500,484
Kentucky,Knott County,9,15,654,300,354
Kentucky,Knott County,9,16,485,194,291
Kentucky,Knott County,9,17,307,129,178
Kentucky,Knott County,9,18,238,77,161
Kentucky,Knott County,10,0,15244,7540,7704
Kentucky,Knott County,10,1,827,422,405
Kentucky,Knott County,10,2,875,445,430
Kentucky,Knott County,10,3,854,440,414
Kentucky,Knott County,10,4,1031,547,484
Kentucky,Knott County,10,5,1076,551,525
Kentucky,Knott County,10,6,868,434,434
Kentucky,Knott County,10,7,759,374,385
Kentucky,Knott County,10,8,830,403,427
Kentucky,Knott County,10,9,943,469,474
Kentucky,Knott County,10,10,994,495,499
Kentucky,Knott County,10,11,1161,553,608
Kentucky,Knott County,10,12,1176,597,579
Kentucky,Knott County,10,13,1130,585,545
Kentucky,Knott County,10,14,984,493,491
Kentucky,Knott County,10,15,685,320,365
Kentucky,Knott County,10,16,484,210,274
Kentucky,Knott County,10,17,311,119,192
Kentucky,Knott County,10,18,256,83,173
Kentucky,Knott County,11,0,15076,7467,7609
Kentucky,Knott County,11,1,835,426,409
Kentucky,Knott County,11,2,834,449,385
Kentucky,Knott County,11,3,838,417,421
Kentucky,Knott County,11,4,1032,541,491
Kentucky,Knott County,11,5,1035,541,494
Kentucky,Knott County,11,6,887,435,452
Kentucky,Knott County,11,7,724,354,370
Kentucky,Knott County,11,8,821,409,412
Kentucky,Knott County,11,9,897,443,454
Kentucky,Knott County,11,10,981,492,489
Kentucky,Knott County,11,11,1128,540,588
Kentucky,Knott County,11,12,1159,576,583
Kentucky,Knott County,11,13,1130,600,530
Kentucky,Knott County,11,14,971,465,506
Kentucky,Knott County,11,15,753,374,379
Kentucky,Knott County,11,16,480,198,282
Kentucky,Knott County,11,17,309,127,182
Kentucky,Knott County,11,18,262,80,182
Kentucky,Knott County,12,0,14806,7307,7499
Kentucky,Knott County,12,1,781,391,390
Kentucky,Knott County,12,2,829,443,386
Kentucky,Knott County,12,3,818,399,419
Kentucky,Knott County,12,4,1001,524,477
Kentucky,Knott County,12,5,1019,537,482
Kentucky,Knott County,12,6,864,419,445
Kentucky,Knott County,12,7,697,348,349
Kentucky,Knott County,12,8,773,383,390
Kentucky,Knott County,12,9,878,425,453
Kentucky,Knott County,12,10,962,485,477
Kentucky,Knott County,12,11,1075,514,561
Kentucky,Knott County,12,12,1133,556,577
Kentucky,Knott County,12,13,1143,595,548
Kentucky,Knott County,12,14,983,468,515
Kentucky,Knott County,12,15,779,394,385
Kentucky,Knott County,12,16,494,214,280
Kentucky,Knott County,12,17,321,136,185
Kentucky,Knott County,12,18,256,76,180
Kentucky,Knox County,1,0,31883,15516,16367
Kentucky,Knox County,1,1,2162,1094,1068
Kentucky,Knox County,1,2,2096,1049,1047
Kentucky,Knox County,1,3,2198,1179,1019
Kentucky,Knox County,1,4,2377,1238,1139
Kentucky,Knox County,1,5,2056,1060,996
Kentucky,Knox County,1,6,1828,888,940
Kentucky,Knox County,1,7,1822,894,928
Kentucky,Knox County,1,8,2091,1031,1060
Kentucky,Knox County,1,9,2130,1067,1063
Kentucky,Knox County,1,10,2304,1113,1191
Kentucky,Knox County,1,11,2205,1058,1147
Kentucky,Knox County,1,12,2000,918,1082
Kentucky,Knox County,1,13,1964,937,1027
Kentucky,Knox County,1,14,1631,755,876
Kentucky,Knox County,1,15,1185,545,640
Kentucky,Knox County,1,16,868,384,484
Kentucky,Knox County,1,17,504,182,322
Kentucky,Knox County,1,18,462,124,338
Kentucky,Knox County,2,0,31888,15516,16372
Kentucky,Knox County,2,1,2162,1094,1068
Kentucky,Knox County,2,2,2098,1049,1049
Kentucky,Knox County,2,3,2199,1179,1020
Kentucky,Knox County,2,4,2377,1238,1139
Kentucky,Knox County,2,5,2056,1060,996
Kentucky,Knox County,2,6,1829,888,941
Kentucky,Knox County,2,7,1823,895,928
Kentucky,Knox County,2,8,2091,1031,1060
Kentucky,Knox County,2,9,2131,1067,1064
Kentucky,Knox County,2,10,2303,1112,1191
Kentucky,Knox County,2,11,2204,1058,1146
Kentucky,Knox County,2,12,2000,918,1082
Kentucky,Knox County,2,13,1964,937,1027
Kentucky,Knox County,2,14,1631,755,876
Kentucky,Knox County,2,15,1185,545,640
Kentucky,Knox County,2,16,868,384,484
Kentucky,Knox County,2,17,504,182,322
Kentucky,Knox County,2,18,463,124,339
Kentucky,Knox County,3,0,31851,15497,16354
Kentucky,Knox County,3,1,2148,1079,1069
Kentucky,Knox County,3,2,2101,1051,1050
Kentucky,Knox County,3,3,2207,1182,1025
Kentucky,Knox County,3,4,2336,1217,1119
Kentucky,Knox County,3,5,2089,1075,1014
Kentucky,Knox County,3,6,1824,889,935
Kentucky,Knox County,3,7,1818,900,918
Kentucky,Knox County,3,8,2079,1021,1058
Kentucky,Knox County,3,9,2124,1065,1059
Kentucky,Knox County,3,10,2316,1122,1194
Kentucky,Knox County,3,11,2199,1053,1146
Kentucky,Knox County,3,12,2003,919,1084
Kentucky,Knox County,3,13,1960,933,1027
Kentucky,Knox County,3,14,1624,749,875
Kentucky,Knox County,3,15,1193,549,644
Kentucky,Knox County,3,16,872,386,486
Kentucky,Knox County,3,17,502,185,317
Kentucky,Knox County,3,18,456,122,334
Kentucky,Knox County,4,0,31878,15506,16372
Kentucky,Knox County,4,1,2108,1065,1043
Kentucky,Knox County,4,2,2145,1086,1059
Kentucky,Knox County,4,3,2187,1153,1034
Kentucky,Knox County,4,4,2202,1154,1048
Kentucky,Knox County,4,5,2196,1107,1089
Kentucky,Knox County,4,6,1840,883,957
Kentucky,Knox County,4,7,1845,939,906
Kentucky,Knox County,4,8,1995,971,1024
Kentucky,Knox County,4,9,2126,1076,1050
Kentucky,Knox County,4,10,2308,1128,1180
Kentucky,Knox County,4,11,2215,1058,1157
Kentucky,Knox County,4,12,2017,924,1093
Kentucky,Knox County,4,13,1992,943,1049
Kentucky,Knox County,4,14,1589,729,860
Kentucky,Knox County,4,15,1243,577,666
Kentucky,Knox County,4,16,898,399,499
Kentucky,Knox County,4,17,516,195,321
Kentucky,Knox County,4,18,456,119,337
Kentucky,Knox County,5,0,31494,15345,16149
Kentucky,Knox County,5,1,2031,1027,1004
Kentucky,Knox County,5,2,2132,1107,1025
Kentucky,Knox County,5,3,2115,1104,1011
Kentucky,Knox County,5,4,2082,1105,977
Kentucky,Knox County,5,5,2186,1096,1090
Kentucky,Knox County,5,6,1794,877,917
Kentucky,Knox County,5,7,1854,936,918
Kentucky,Knox County,5,8,1918,927,991
Kentucky,Knox County,5,9,2108,1070,1038
Kentucky,Knox County,5,10,2251,1106,1145
Kentucky,Knox County,5,11,2224,1058,1166
Kentucky,Knox County,5,12,2033,929,1104
Kentucky,Knox County,5,13,1887,881,1006
Kentucky,Knox County,5,14,1684,785,899
Kentucky,Knox County,5,15,1285,602,683
Kentucky,Knox County,5,16,899,391,508
Kentucky,Knox County,5,17,540,217,323
Kentucky,Knox County,5,18,471,127,344
Kentucky,Knox County,6,0,31638,15412,16226
Kentucky,Knox County,6,1,2033,1049,984
Kentucky,Knox County,6,2,2168,1116,1052
Kentucky,Knox County,6,3,2085,1062,1023
Kentucky,Knox County,6,4,2066,1106,960
Kentucky,Knox County,6,5,2253,1153,1100
Kentucky,Knox County,6,6,1844,899,945
Kentucky,Knox County,6,7,1826,902,924
Kentucky,Knox County,6,8,1866,919,947
Kentucky,Knox County,6,9,2106,1042,1064
Kentucky,Knox County,6,10,2203,1086,1117
Kentucky,Knox County,6,11,2237,1061,1176
Kentucky,Knox County,6,12,2060,965,1095
Kentucky,Knox County,6,13,1859,849,1010
Kentucky,Knox County,6,14,1715,807,908
Kentucky,Knox County,6,15,1346,619,727
Kentucky,Knox County,6,16,945,420,525
Kentucky,Knox County,6,17,531,222,309
Kentucky,Knox County,6,18,495,135,360
Kentucky,Knox County,7,0,31540,15361,16179
Kentucky,Knox County,7,1,2025,1048,977
Kentucky,Knox County,7,2,2115,1075,1040
Kentucky,Knox County,7,3,2047,1039,1008
Kentucky,Knox County,7,4,2109,1153,956
Kentucky,Knox County,7,5,2167,1108,1059
Kentucky,Knox County,7,6,1929,934,995
Kentucky,Knox County,7,7,1819,906,913
Kentucky,Knox County,7,8,1828,887,941
Kentucky,Knox County,7,9,2065,1022,1043
Kentucky,Knox County,7,10,2119,1050,1069
Kentucky,Knox County,7,11,2192,1040,1152
Kentucky,Knox County,7,12,2096,996,1100
Kentucky,Knox County,7,13,1857,844,1013
Kentucky,Knox County,7,14,1768,829,939
Kentucky,Knox County,7,15,1343,612,731
Kentucky,Knox County,7,16,977,438,539
Kentucky,Knox County,7,17,572,236,336
Kentucky,Knox County,7,18,512,144,368
Kentucky,Knox County,8,0,31465,15359,16106
Kentucky,Knox County,8,1,2010,1045,965
Kentucky,Knox County,8,2,2075,1059,1016
Kentucky,Knox County,8,3,2015,1006,1009
Kentucky,Knox County,8,4,2145,1153,992
Kentucky,Knox County,8,5,2090,1068,1022
Kentucky,Knox County,8,6,2071,1026,1045
Kentucky,Knox County,8,7,1750,876,874
Kentucky,Knox County,8,8,1818,897,921
Kentucky,Knox County,8,9,2066,1028,1038
Kentucky,Knox County,8,10,2030,1008,1022
Kentucky,Knox County,8,11,2208,1070,1138
Kentucky,Knox County,8,12,2075,984,1091
Kentucky,Knox County,8,13,1863,848,1015
Kentucky,Knox County,8,14,1741,806,935
Kentucky,Knox County,8,15,1384,629,755
Kentucky,Knox County,8,16,996,451,545
Kentucky,Knox County,8,17,611,263,348
Kentucky,Knox County,8,18,517,142,375
Kentucky,Knox County,9,0,31471,15354,16117
Kentucky,Knox County,9,1,2059,1059,1000
Kentucky,Knox County,9,2,2016,1036,980
Kentucky,Knox County,9,3,2071,1052,1019
Kentucky,Knox County,9,4,2115,1116,999
Kentucky,Knox County,9,5,2036,1058,978
Kentucky,Knox County,9,6,2161,1062,1099
Kentucky,Knox County,9,7,1771,869,902
Kentucky,Knox County,9,8,1812,907,905
Kentucky,Knox County,9,9,1965,960,1005
Kentucky,Knox County,9,10,2019,1005,1014
Kentucky,Knox County,9,11,2201,1078,1123
Kentucky,Knox County,9,12,2070,986,1084
Kentucky,Knox County,9,13,1891,861,1030
Kentucky,Knox County,9,14,1742,802,940
Kentucky,Knox County,9,15,1345,609,736
Kentucky,Knox County,9,16,1038,473,565
Kentucky,Knox County,9,17,634,264,370
Kentucky,Knox County,9,18,525,157,368
Kentucky,Knox County,10,0,31444,15352,16092
Kentucky,Knox County,10,1,2017,1025,992
Kentucky,Knox County,10,2,1969,999,970
Kentucky,Knox County,10,3,2100,1088,1012
Kentucky,Knox County,10,4,2099,1097,1002
Kentucky,Knox County,10,5,2005,1058,947
Kentucky,Knox County,10,6,2157,1055,1102
Kentucky,Knox County,10,7,1803,907,896
Kentucky,Knox County,10,8,1843,924,919
Kentucky,Knox County,10,9,1896,919,977
Kentucky,Knox County,10,10,2044,1036,1008
Kentucky,Knox County,10,11,2160,1051,1109
Kentucky,Knox County,10,12,2094,998,1096
Kentucky,Knox County,10,13,1898,874,1024
Kentucky,Knox County,10,14,1671,768,903
Kentucky,Knox County,10,15,1439,633,806
Kentucky,Knox County,10,16,1054,477,577
Kentucky,Knox County,10,17,649,267,382
Kentucky,Knox County,10,18,546,176,370
Kentucky,Knox County,11,0,31300,15281,16019
Kentucky,Knox County,11,1,1984,992,992
Kentucky,Knox County,11,2,1985,1036,949
Kentucky,Knox County,11,3,2088,1074,1014
Kentucky,Knox County,11,4,2041,1061,980
Kentucky,Knox County,11,5,1997,1068,929
Kentucky,Knox County,11,6,2122,1045,1077
Kentucky,Knox County,11,7,1840,908,932
Kentucky,Knox County,11,8,1829,909,920
Kentucky,Knox County,11,9,1830,903,927
Kentucky,Knox County,11,10,2060,1020,1040
Kentucky,Knox County,11,11,2081,1007,1074
Kentucky,Knox County,11,12,2090,1009,1081
Kentucky,Knox County,11,13,1910,899,1011
Kentucky,Knox County,11,14,1626,732,894
Kentucky,Knox County,11,15,1518,679,839
Kentucky,Knox County,11,16,1074,471,603
Kentucky,Knox County,11,17,670,277,393
Kentucky,Knox County,11,18,555,191,364
Kentucky,Knox County,12,0,31145,15190,15955
Kentucky,Knox County,12,1,1928,964,964
Kentucky,Knox County,12,2,1972,985,987
Kentucky,Knox County,12,3,2051,1071,980
Kentucky,Knox County,12,4,2029,1049,980
Kentucky,Knox County,12,5,1984,1087,897
Kentucky,Knox County,12,6,2089,1024,1065
Kentucky,Knox County,12,7,1873,926,947
Kentucky,Knox County,12,8,1791,887,904
Kentucky,Knox County,12,9,1830,880,950
Kentucky,Knox County,12,10,2033,1017,1016
Kentucky,Knox County,12,11,2028,997,1031
Kentucky,Knox County,12,12,2109,1015,1094
Kentucky,Knox County,12,13,1905,906,999
Kentucky,Knox County,12,14,1635,734,901
Kentucky,Knox County,12,15,1588,720,868
Kentucky,Knox County,12,16,1080,470,610
Kentucky,Knox County,12,17,654,265,389
Kentucky,Knox County,12,18,566,193,373
Kentucky,Larue County,1,0,14193,7038,7155
Kentucky,Larue County,1,1,887,445,442
Kentucky,Larue County,1,2,900,474,426
Kentucky,Larue County,1,3,972,493,479
Kentucky,Larue County,1,4,956,510,446
Kentucky,Larue County,1,5,807,420,387
Kentucky,Larue County,1,6,842,446,396
Kentucky,Larue County,1,7,853,435,418
Kentucky,Larue County,1,8,845,428,417
Kentucky,Larue County,1,9,918,484,434
Kentucky,Larue County,1,10,1131,557,574
Kentucky,Larue County,1,11,1077,523,554
Kentucky,Larue County,1,12,944,475,469
Kentucky,Larue County,1,13,847,425,422
Kentucky,Larue County,1,14,631,279,352
Kentucky,Larue County,1,15,553,252,301
Kentucky,Larue County,1,16,411,175,236
Kentucky,Larue County,1,17,322,134,188
Kentucky,Larue County,1,18,297,83,214
Kentucky,Larue County,2,0,14181,7033,7148
Kentucky,Larue County,2,1,887,445,442
Kentucky,Larue County,2,2,900,474,426
Kentucky,Larue County,2,3,971,492,479
Kentucky,Larue County,2,4,957,510,447
Kentucky,Larue County,2,5,807,420,387
Kentucky,Larue County,2,6,841,447,394
Kentucky,Larue County,2,7,853,435,418
Kentucky,Larue County,2,8,845,428,417
Kentucky,Larue County,2,9,918,484,434
Kentucky,Larue County,2,10,1130,557,573
Kentucky,Larue County,2,11,1075,522,553
Kentucky,Larue County,2,12,940,474,466
Kentucky,Larue County,2,13,845,423,422
Kentucky,Larue County,2,14,630,279,351
Kentucky,Larue County,2,15,552,251,301
Kentucky,Larue County,2,16,411,175,236
Kentucky,Larue County,2,17,322,134,188
Kentucky,Larue County,2,18,297,83,214
Kentucky,Larue County,3,0,14169,7034,7135
Kentucky,Larue County,3,1,871,442,429
Kentucky,Larue County,3,2,901,475,426
Kentucky,Larue County,3,3,965,491,474
Kentucky,Larue County,3,4,952,507,445
Kentucky,Larue County,3,5,820,425,395
Kentucky,Larue County,3,6,833,440,393
Kentucky,Larue County,3,7,862,444,418
Kentucky,Larue County,3,8,845,424,421
Kentucky,Larue County,3,9,914,483,431
Kentucky,Larue County,3,10,1122,553,569
Kentucky,Larue County,3,11,1085,529,556
Kentucky,Larue County,3,12,947,481,466
Kentucky,Larue County,3,13,839,419,420
Kentucky,Larue County,3,14,636,284,352
Kentucky,Larue County,3,15,549,246,303
Kentucky,Larue County,3,16,406,173,233
Kentucky,Larue County,3,17,322,134,188
Kentucky,Larue County,3,18,300,84,216
Kentucky,Larue County,4,0,14179,7051,7128
Kentucky,Larue County,4,1,818,416,402
Kentucky,Larue County,4,2,931,498,433
Kentucky,Larue County,4,3,954,501,453
Kentucky,Larue County,4,4,906,473,433
Kentucky,Larue County,4,5,862,445,417
Kentucky,Larue County,4,6,839,433,406
Kentucky,Larue County,4,7,906,475,431
Kentucky,Larue County,4,8,816,417,399
Kentucky,Larue County,4,9,906,474,432
Kentucky,Larue County,4,10,1088,527,561
Kentucky,Larue County,4,11,1093,545,548
Kentucky,Larue County,4,12,992,510,482
Kentucky,Larue County,4,13,842,415,427
Kentucky,Larue County,4,14,649,301,348
Kentucky,Larue County,4,15,549,240,309
Kentucky,Larue County,4,16,416,174,242
Kentucky,Larue County,4,17,324,130,194
Kentucky,Larue County,4,18,288,77,211
Kentucky,Larue County,5,0,14048,7000,7048
Kentucky,Larue County,5,1,761,401,360
Kentucky,Larue County,5,2,912,476,436
Kentucky,Larue County,5,3,922,476,446
Kentucky,Larue County,5,4,894,484,410
Kentucky,Larue County,5,5,855,452,403
Kentucky,Larue County,5,6,823,416,407
Kentucky,Larue County,5,7,879,470,409
Kentucky,Larue County,5,8,792,390,402
Kentucky,Larue County,5,9,891,470,421
Kentucky,Larue County,5,10,1064,520,544
Kentucky,Larue County,5,11,1074,533,541
Kentucky,Larue County,5,12,1016,511,505
Kentucky,Larue County,5,13,864,438,426
Kentucky,Larue County,5,14,691,328,363
Kentucky,Larue County,5,15,562,243,319
Kentucky,Larue County,5,16,437,191,246
Kentucky,Larue County,5,17,322,117,205
Kentucky,Larue County,5,18,289,84,205
Kentucky,Larue County,6,0,14019,6977,7042
Kentucky,Larue County,6,1,767,400,367
Kentucky,Larue County,6,2,905,464,441
Kentucky,Larue County,6,3,926,501,425
Kentucky,Larue County,6,4,875,462,413
Kentucky,Larue County,6,5,823,419,404
Kentucky,Larue County,6,6,800,401,399
Kentucky,Larue County,6,7,887,467,420
Kentucky,Larue County,6,8,793,393,400
Kentucky,Larue County,6,9,868,444,424
Kentucky,Larue County,6,10,1020,512,508
Kentucky,Larue County,6,11,1112,546,566
Kentucky,Larue County,6,12,1034,523,511
Kentucky,Larue County,6,13,906,452,454
Kentucky,Larue County,6,14,703,350,353
Kentucky,Larue County,6,15,559,240,319
Kentucky,Larue County,6,16,451,212,239
Kentucky,Larue County,6,17,301,98,203
Kentucky,Larue County,6,18,289,93,196
Kentucky,Larue County,7,0,14106,7011,7095
Kentucky,Larue County,7,1,795,425,370
Kentucky,Larue County,7,2,901,456,445
Kentucky,Larue County,7,3,934,505,429
Kentucky,Larue County,7,4,871,453,418
Kentucky,Larue County,7,5,819,426,393
Kentucky,Larue County,7,6,848,426,422
Kentucky,Larue County,7,7,926,488,438
Kentucky,Larue County,7,8,802,396,406
Kentucky,Larue County,7,9,837,408,429
Kentucky,Larue County,7,10,923,473,450
Kentucky,Larue County,7,11,1167,563,604
Kentucky,Larue County,7,12,1010,512,498
Kentucky,Larue County,7,13,921,460,461
Kentucky,Larue County,7,14,742,373,369
Kentucky,Larue County,7,15,546,231,315
Kentucky,Larue County,7,16,462,213,249
Kentucky,Larue County,7,17,305,112,193
Kentucky,Larue County,7,18,297,91,206
Kentucky,Larue County,8,0,14110,7005,7105
Kentucky,Larue County,8,1,795,416,379
Kentucky,Larue County,8,2,889,460,429
Kentucky,Larue County,8,3,904,470,434
Kentucky,Larue County,8,4,894,485,409
Kentucky,Larue County,8,5,802,412,390
Kentucky,Larue County,8,6,845,431,414
Kentucky,Larue County,8,7,890,450,440
Kentucky,Larue County,8,8,847,423,424
Kentucky,Larue County,8,9,827,406,421
Kentucky,Larue County,8,10,909,459,450
Kentucky,Larue County,8,11,1132,554,578
Kentucky,Larue County,8,12,1037,513,524
Kentucky,Larue County,8,13,940,472,468
Kentucky,Larue County,8,14,771,386,385
Kentucky,Larue County,8,15,559,248,311
Kentucky,Larue County,8,16,463,203,260
Kentucky,Larue County,8,17,316,129,187
Kentucky,Larue County,8,18,290,88,202
Kentucky,Larue County,9,0,14018,6952,7066
Kentucky,Larue County,9,1,818,438,380
Kentucky,Larue County,9,2,830,423,407
Kentucky,Larue County,9,3,897,481,416
Kentucky,Larue County,9,4,885,470,415
Kentucky,Larue County,9,5,780,400,380
Kentucky,Larue County,9,6,842,424,418
Kentucky,Larue County,9,7,870,447,423
Kentucky,Larue County,9,8,887,436,451
Kentucky,Larue County,9,9,802,392,410
Kentucky,Larue County,9,10,889,444,445
Kentucky,Larue County,9,11,1075,522,553
Kentucky,Larue County,9,12,1065,521,544
Kentucky,Larue County,9,13,974,497,477
Kentucky,Larue County,9,14,771,372,399
Kentucky,Larue County,9,15,561,260,301
Kentucky,Larue County,9,16,465,194,271
Kentucky,Larue County,9,17,315,141,174
Kentucky,Larue County,9,18,292,90,202
Kentucky,Larue County,10,0,14196,7062,7134
Kentucky,Larue County,10,1,814,429,385
Kentucky,Larue County,10,2,853,449,404
Kentucky,Larue County,10,3,965,505,460
Kentucky,Larue County,10,4,888,489,399
Kentucky,Larue County,10,5,776,400,376
Kentucky,Larue County,10,6,841,425,416
Kentucky,Larue County,10,7,868,430,438
Kentucky,Larue County,10,8,921,461,460
Kentucky,Larue County,10,9,817,405,412
Kentucky,Larue County,10,10,901,449,452
Kentucky,Larue County,10,11,1050,522,528
Kentucky,Larue County,10,12,1066,527,539
Kentucky,Larue County,10,13,982,480,502
Kentucky,Larue County,10,14,801,399,402
Kentucky,Larue County,10,15,580,271,309
Kentucky,Larue County,10,16,456,186,270
Kentucky,Larue County,10,17,322,145,177
Kentucky,Larue County,10,18,295,90,205
Kentucky,Larue County,11,0,14299,7097,7202
Kentucky,Larue County,11,1,826,449,377
Kentucky,Larue County,11,2,860,439,421
Kentucky,Larue County,11,3,976,501,475
Kentucky,Larue County,11,4,872,478,394
Kentucky,Larue County,11,5,820,437,383
Kentucky,Larue County,11,6,871,426,445
Kentucky,Larue County,11,7,834,420,414
Kentucky,Larue County,11,8,937,471,466
Kentucky,Larue County,11,9,827,408,419
Kentucky,Larue County,11,10,898,435,463
Kentucky,Larue County,11,11,1010,508,502
Kentucky,Larue County,11,12,1076,529,547
Kentucky,Larue County,11,13,986,481,505
Kentucky,Larue County,11,14,823,397,426
Kentucky,Larue County,11,15,597,291,306
Kentucky,Larue County,11,16,458,186,272
Kentucky,Larue County,11,17,334,151,183
Kentucky,Larue County,11,18,294,90,204
Kentucky,Larue County,12,0,14398,7111,7287
Kentucky,Larue County,12,1,819,423,396
Kentucky,Larue County,12,2,887,461,426
Kentucky,Larue County,12,3,989,504,485
Kentucky,Larue County,12,4,873,477,396
Kentucky,Larue County,12,5,794,417,377
Kentucky,Larue County,12,6,899,471,428
Kentucky,Larue County,12,7,854,421,433
Kentucky,Larue County,12,8,943,468,475
Kentucky,Larue County,12,9,869,426,443
Kentucky,Larue County,12,10,892,419,473
Kentucky,Larue County,12,11,907,452,455
Kentucky,Larue County,12,12,1125,549,576
Kentucky,Larue County,12,13,974,476,498
Kentucky,Larue County,12,14,845,404,441
Kentucky,Larue County,12,15,636,317,319
Kentucky,Larue County,12,16,454,186,268
Kentucky,Larue County,12,17,344,147,197
Kentucky,Larue County,12,18,294,93,201
Kentucky,Laurel County,1,0,58849,28849,30000
Kentucky,Laurel County,1,1,3824,1921,1903
Kentucky,Laurel County,1,2,4058,2047,2011
Kentucky,Laurel County,1,3,4041,2110,1931
Kentucky,Laurel County,1,4,3846,1954,1892
Kentucky,Laurel County,1,5,3344,1669,1675
Kentucky,Laurel County,1,6,3678,1794,1884
Kentucky,Laurel County,1,7,3979,1934,2045
Kentucky,Laurel County,1,8,4096,2070,2026
Kentucky,Laurel County,1,9,4126,2079,2047
Kentucky,Laurel County,1,10,4467,2155,2312
Kentucky,Laurel County,1,11,4397,2103,2294
Kentucky,Laurel County,1,12,3915,1931,1984
Kentucky,Laurel County,1,13,3501,1764,1737
Kentucky,Laurel County,1,14,2615,1227,1388
Kentucky,Laurel County,1,15,1979,940,1039
Kentucky,Laurel County,1,16,1374,598,776
Kentucky,Laurel County,1,17,910,345,565
Kentucky,Laurel County,1,18,699,208,491
Kentucky,Laurel County,2,0,58849,28851,29998
Kentucky,Laurel County,2,1,3825,1922,1903
Kentucky,Laurel County,2,2,4057,2047,2010
Kentucky,Laurel County,2,3,4041,2110,1931
Kentucky,Laurel County,2,4,3846,1954,1892
Kentucky,Laurel County,2,5,3344,1669,1675
Kentucky,Laurel County,2,6,3678,1794,1884
Kentucky,Laurel County,2,7,3979,1934,2045
Kentucky,Laurel County,2,8,4097,2070,2027
Kentucky,Laurel County,2,9,4125,2079,2046
Kentucky,Laurel County,2,10,4468,2156,2312
Kentucky,Laurel County,2,11,4398,2103,2295
Kentucky,Laurel County,2,12,3915,1931,1984
Kentucky,Laurel County,2,13,3501,1764,1737
Kentucky,Laurel County,2,14,2615,1227,1388
Kentucky,Laurel County,2,15,1978,940,1038
Kentucky,Laurel County,2,16,1374,598,776
Kentucky,Laurel County,2,17,910,345,565
Kentucky,Laurel County,2,18,698,208,490
Kentucky,Laurel County,3,0,58998,28936,30062
Kentucky,Laurel County,3,1,3796,1920,1876
Kentucky,Laurel County,3,2,4051,2051,2000
Kentucky,Laurel County,3,3,4070,2112,1958
Kentucky,Laurel County,3,4,3801,1942,1859
Kentucky,Laurel County,3,5,3392,1687,1705
Kentucky,Laurel County,3,6,3668,1793,1875
Kentucky,Laurel County,3,7,3996,1947,2049
Kentucky,Laurel County,3,8,4100,2058,2042
Kentucky,Laurel County,3,9,4151,2103,2048
Kentucky,Laurel County,3,10,4463,2148,2315
Kentucky,Laurel County,3,11,4392,2107,2285
Kentucky,Laurel County,3,12,3967,1946,2021
Kentucky,Laurel County,3,13,3522,1777,1745
Kentucky,Laurel County,3,14,2628,1235,1393
Kentucky,Laurel County,3,15,1992,946,1046
Kentucky,Laurel County,3,16,1392,604,788
Kentucky,Laurel County,3,17,919,352,567
Kentucky,Laurel County,3,18,698,208,490
Kentucky,Laurel County,4,0,59359,29085,30274
Kentucky,Laurel County,4,1,3743,1884,1859
Kentucky,Laurel County,4,2,3989,2050,1939
Kentucky,Laurel County,4,3,4184,2154,2030
Kentucky,Laurel County,4,4,3666,1865,1801
Kentucky,Laurel County,4,5,3568,1745,1823
Kentucky,Laurel County,4,6,3661,1827,1834
Kentucky,Laurel County,4,7,4029,1962,2067
Kentucky,Laurel County,4,8,3948,1957,1991
Kentucky,Laurel County,4,9,4273,2194,2079
Kentucky,Laurel County,4,10,4438,2100,2338
Kentucky,Laurel County,4,11,4359,2120,2239
Kentucky,Laurel County,4,12,4031,1947,2084
Kentucky,Laurel County,4,13,3660,1839,1821
Kentucky,Laurel County,4,14,2656,1252,1404
Kentucky,Laurel County,4,15,2066,983,1083
Kentucky,Laurel County,4,16,1461,638,823
Kentucky,Laurel County,4,17,926,355,571
Kentucky,Laurel County,4,18,701,213,488
Kentucky,Laurel County,5,0,59534,29142,30392
Kentucky,Laurel County,5,1,3777,1910,1867
Kentucky,Laurel County,5,2,3960,2007,1953
Kentucky,Laurel County,5,3,4161,2117,2044
Kentucky,Laurel County,5,4,3603,1847,1756
Kentucky,Laurel County,5,5,3620,1769,1851
Kentucky,Laurel County,5,6,3685,1844,1841
Kentucky,Laurel County,5,7,4002,1958,2044
Kentucky,Laurel County,5,8,3888,1907,1981
Kentucky,Laurel County,5,9,4267,2167,2100
Kentucky,Laurel County,5,10,4347,2110,2237
Kentucky,Laurel County,5,11,4336,2106,2230
Kentucky,Laurel County,5,12,4090,1955,2135
Kentucky,Laurel County,5,13,3646,1804,1842
Kentucky,Laurel County,5,14,2883,1372,1511
Kentucky,Laurel County,5,15,2132,1028,1104
Kentucky,Laurel County,5,16,1486,652,834
Kentucky,Laurel County,5,17,932,368,564
Kentucky,Laurel County,5,18,719,221,498
Kentucky,Laurel County,6,0,59701,29211,30490
Kentucky,Laurel County,6,1,3813,1944,1869
Kentucky,Laurel County,6,2,3863,1942,1921
Kentucky,Laurel County,6,3,4127,2100,2027
Kentucky,Laurel County,6,4,3614,1862,1752
Kentucky,Laurel County,6,5,3706,1811,1895
Kentucky,Laurel County,6,6,3697,1846,1851
Kentucky,Laurel County,6,7,3913,1937,1976
Kentucky,Laurel County,6,8,3893,1884,2009
Kentucky,Laurel County,6,9,4205,2133,2072
Kentucky,Laurel County,6,10,4252,2063,2189
Kentucky,Laurel County,6,11,4280,2079,2201
Kentucky,Laurel County,6,12,4196,1981,2215
Kentucky,Laurel County,6,13,3677,1817,1860
Kentucky,Laurel County,6,14,2980,1426,1554
Kentucky,Laurel County,6,15,2180,1038,1142
Kentucky,Laurel County,6,16,1578,702,876
Kentucky,Laurel County,6,17,965,408,557
Kentucky,Laurel County,6,18,762,238,524
Kentucky,Laurel County,7,0,59897,29372,30525
Kentucky,Laurel County,7,1,3710,1917,1793
Kentucky,Laurel County,7,2,3868,1940,1928
Kentucky,Laurel County,7,3,4127,2092,2035
Kentucky,Laurel County,7,4,3638,1899,1739
Kentucky,Laurel County,7,5,3673,1804,1869
Kentucky,Laurel County,7,6,3774,1877,1897
Kentucky,Laurel County,7,7,3878,1926,1952
Kentucky,Laurel County,7,8,3891,1890,2001
Kentucky,Laurel County,7,9,4062,2055,2007
Kentucky,Laurel County,7,10,4159,2044,2115
Kentucky,Laurel County,7,11,4360,2127,2233
Kentucky,Laurel County,7,12,4262,1977,2285
Kentucky,Laurel County,7,13,3671,1809,1862
Kentucky,Laurel County,7,14,3177,1573,1604
Kentucky,Laurel County,7,15,2206,1022,1184
Kentucky,Laurel County,7,16,1652,743,909
Kentucky,Laurel County,7,17,995,424,571
Kentucky,Laurel County,7,18,794,253,541
Kentucky,Laurel County,8,0,59919,29352,30567
Kentucky,Laurel County,8,1,3713,1913,1800
Kentucky,Laurel County,8,2,3785,1935,1850
Kentucky,Laurel County,8,3,4089,2051,2038
Kentucky,Laurel County,8,4,3663,1934,1729
Kentucky,Laurel County,8,5,3583,1763,1820
Kentucky,Laurel County,8,6,3810,1877,1933
Kentucky,Laurel County,8,7,3776,1858,1918
Kentucky,Laurel County,8,8,3932,1909,2023
Kentucky,Laurel County,8,9,3932,1986,1946
Kentucky,Laurel County,8,10,4179,2107,2072
Kentucky,Laurel County,8,11,4325,2053,2272
Kentucky,Laurel County,8,12,4278,2023,2255
Kentucky,Laurel County,8,13,3783,1824,1959
Kentucky,Laurel County,8,14,3242,1615,1627
Kentucky,Laurel County,8,15,2301,1037,1264
Kentucky,Laurel County,8,16,1651,751,900
Kentucky,Laurel County,8,17,1046,435,611
Kentucky,Laurel County,8,18,831,281,550
Kentucky,Laurel County,9,0,60078,29378,30700
Kentucky,Laurel County,9,1,3713,1897,1816
Kentucky,Laurel County,9,2,3782,1922,1860
Kentucky,Laurel County,9,3,3960,2001,1959
Kentucky,Laurel County,9,4,3771,1953,1818
Kentucky,Laurel County,9,5,3432,1704,1728
Kentucky,Laurel County,9,6,3935,1916,2019
Kentucky,Laurel County,9,7,3712,1855,1857
Kentucky,Laurel County,9,8,3956,1898,2058
Kentucky,Laurel County,9,9,3862,1938,1924
Kentucky,Laurel County,9,10,4175,2145,2030
Kentucky,Laurel County,9,11,4319,2026,2293
Kentucky,Laurel County,9,12,4235,2037,2198
Kentucky,Laurel County,9,13,3827,1807,2020
Kentucky,Laurel County,9,14,3377,1668,1709
Kentucky,Laurel County,9,15,2324,1053,1271
Kentucky,Laurel County,9,16,1722,786,936
Kentucky,Laurel County,9,17,1131,472,659
Kentucky,Laurel County,9,18,845,300,545
Kentucky,Laurel County,10,0,60317,29521,30796
Kentucky,Laurel County,10,1,3732,1886,1846
Kentucky,Laurel County,10,2,3849,1978,1871
Kentucky,Laurel County,10,3,3981,2024,1957
Kentucky,Laurel County,10,4,3733,1932,1801
Kentucky,Laurel County,10,5,3404,1726,1678
Kentucky,Laurel County,10,6,4014,1957,2057
Kentucky,Laurel County,10,7,3651,1793,1858
Kentucky,Laurel County,10,8,3941,1901,2040
Kentucky,Laurel County,10,9,3867,1929,1938
Kentucky,Laurel County,10,10,4152,2111,2041
Kentucky,Laurel County,10,11,4246,2047,2199
Kentucky,Laurel County,10,12,4148,1981,2167
Kentucky,Laurel County,10,13,3898,1820,2078
Kentucky,Laurel County,10,14,3368,1618,1750
Kentucky,Laurel County,10,15,2513,1175,1338
Kentucky,Laurel County,10,16,1762,820,942
Kentucky,Laurel County,10,17,1165,500,665
Kentucky,Laurel County,10,18,893,323,570
Kentucky,Laurel County,11,0,60660,29695,30965
Kentucky,Laurel County,11,1,3733,1881,1852
Kentucky,Laurel County,11,2,3845,1980,1865
Kentucky,Laurel County,11,3,3977,2018,1959
Kentucky,Laurel County,11,4,3771,1941,1830
Kentucky,Laurel County,11,5,3391,1722,1669
Kentucky,Laurel County,11,6,4102,2036,2066
Kentucky,Laurel County,11,7,3702,1820,1882
Kentucky,Laurel County,11,8,3897,1873,2024
Kentucky,Laurel County,11,9,3886,1899,1987
Kentucky,Laurel County,11,10,4105,2106,1999
Kentucky,Laurel County,11,11,4204,2041,2163
Kentucky,Laurel County,11,12,4133,1977,2156
Kentucky,Laurel County,11,13,3965,1843,2122
Kentucky,Laurel County,11,14,3387,1623,1764
Kentucky,Laurel County,11,15,2644,1252,1392
Kentucky,Laurel County,11,16,1795,819,976
Kentucky,Laurel County,11,17,1197,520,677
Kentucky,Laurel County,11,18,926,344,582
Kentucky,Laurel County,12,0,60813,29826,30987
Kentucky,Laurel County,12,1,3770,1907,1863
Kentucky,Laurel County,12,2,3831,1986,1845
Kentucky,Laurel County,12,3,4006,2013,1993
Kentucky,Laurel County,12,4,3713,1890,1823
Kentucky,Laurel County,12,5,3334,1735,1599
Kentucky,Laurel County,12,6,4084,2055,2029
Kentucky,Laurel County,12,7,3787,1854,1933
Kentucky,Laurel County,12,8,3870,1868,2002
Kentucky,Laurel County,12,9,3915,1912,2003
Kentucky,Laurel County,12,10,4037,2061,1976
Kentucky,Laurel County,12,11,4091,2031,2060
Kentucky,Laurel County,12,12,4182,1994,2188
Kentucky,Laurel County,12,13,4028,1851,2177
Kentucky,Laurel County,12,14,3374,1609,1765
Kentucky,Laurel County,12,15,2792,1371,1421
Kentucky,Laurel County,12,16,1853,818,1035
Kentucky,Laurel County,12,17,1207,522,685
Kentucky,Laurel County,12,18,939,349,590
Kentucky,Lawrence County,1,0,15860,7836,8024
Kentucky,Lawrence County,1,1,1070,544,526
Kentucky,Lawrence County,1,2,1014,542,472
Kentucky,Lawrence County,1,3,950,494,456
Kentucky,Lawrence County,1,4,1088,574,514
Kentucky,Lawrence County,1,5,862,429,433
Kentucky,Lawrence County,1,6,929,449,480
Kentucky,Lawrence County,1,7,965,459,506
Kentucky,Lawrence County,1,8,1028,514,514
Kentucky,Lawrence County,1,9,1047,513,534
Kentucky,Lawrence County,1,10,1224,615,609
Kentucky,Lawrence County,1,11,1217,588,629
Kentucky,Lawrence County,1,12,1193,583,610
Kentucky,Lawrence County,1,13,1028,503,525
Kentucky,Lawrence County,1,14,788,385,403
Kentucky,Lawrence County,1,15,574,274,300
Kentucky,Lawrence County,1,16,390,184,206
Kentucky,Lawrence County,1,17,284,112,172
Kentucky,Lawrence County,1,18,209,74,135
Kentucky,Lawrence County,2,0,15859,7836,8023
Kentucky,Lawrence County,2,1,1070,544,526
Kentucky,Lawrence County,2,2,1014,542,472
Kentucky,Lawrence County,2,3,950,494,456
Kentucky,Lawrence County,2,4,1088,574,514
Kentucky,Lawrence County,2,5,862,429,433
Kentucky,Lawrence County,2,6,929,449,480
Kentucky,Lawrence County,2,7,965,459,506
Kentucky,Lawrence County,2,8,1029,515,514
Kentucky,Lawrence County,2,9,1047,513,534
Kentucky,Lawrence County,2,10,1224,615,609
Kentucky,Lawrence County,2,11,1215,587,628
Kentucky,Lawrence County,2,12,1193,583,610
Kentucky,Lawrence County,2,13,1028,503,525
Kentucky,Lawrence County,2,14,788,385,403
Kentucky,Lawrence County,2,15,574,274,300
Kentucky,Lawrence County,2,16,390,184,206
Kentucky,Lawrence County,2,17,284,112,172
Kentucky,Lawrence County,2,18,209,74,135
Kentucky,Lawrence County,3,0,15866,7833,8033
Kentucky,Lawrence County,3,1,1073,548,525
Kentucky,Lawrence County,3,2,1022,541,481
Kentucky,Lawrence County,3,3,951,497,454
Kentucky,Lawrence County,3,4,1060,559,501
Kentucky,Lawrence County,3,5,882,440,442
Kentucky,Lawrence County,3,6,926,445,481
Kentucky,Lawrence County,3,7,974,466,508
Kentucky,Lawrence County,3,8,1020,508,512
Kentucky,Lawrence County,3,9,1055,518,537
Kentucky,Lawrence County,3,10,1216,610,606
Kentucky,Lawrence County,3,11,1205,581,624
Kentucky,Lawrence County,3,12,1207,584,623
Kentucky,Lawrence County,3,13,1026,506,520
Kentucky,Lawrence County,3,14,785,385,400
Kentucky,Lawrence County,3,15,573,270,303
Kentucky,Lawrence County,3,16,396,187,209
Kentucky,Lawrence County,3,17,290,114,176
Kentucky,Lawrence County,3,18,205,74,131
Kentucky,Lawrence County,4,0,15941,7912,8029
Kentucky,Lawrence County,4,1,1078,568,510
Kentucky,Lawrence County,4,2,1049,555,494
Kentucky,Lawrence County,4,3,956,505,451
Kentucky,Lawrence County,4,4,976,506,470
Kentucky,Lawrence County,4,5,973,488,485
Kentucky,Lawrence County,4,6,891,439,452
Kentucky,Lawrence County,4,7,993,483,510
Kentucky,Lawrence County,4,8,988,483,505
Kentucky,Lawrence County,4,9,1065,522,543
Kentucky,Lawrence County,4,10,1172,586,586
Kentucky,Lawrence County,4,11,1183,575,608
Kentucky,Lawrence County,4,12,1256,596,660
Kentucky,Lawrence County,4,13,1068,542,526
Kentucky,Lawrence County,4,14,782,391,391
Kentucky,Lawrence County,4,15,579,270,309
Kentucky,Lawrence County,4,16,412,200,212
Kentucky,Lawrence County,4,17,305,125,180
Kentucky,Lawrence County,4,18,215,78,137
Kentucky,Lawrence County,5,0,15891,7897,7994
Kentucky,Lawrence County,5,1,1069,567,502
Kentucky,Lawrence County,5,2,1050,548,502
Kentucky,Lawrence County,5,3,977,507,470
Kentucky,Lawrence County,5,4,900,480,420
Kentucky,Lawrence County,5,5,986,510,476
Kentucky,Lawrence County,5,6,909,458,451
Kentucky,Lawrence County,5,7,961,466,495
Kentucky,Lawrence County,5,8,969,476,493
Kentucky,Lawrence County,5,9,1074,516,558
Kentucky,Lawrence County,5,10,1138,583,555
Kentucky,Lawrence County,5,11,1196,574,622
Kentucky,Lawrence County,5,12,1228,589,639
Kentucky,Lawrence County,5,13,1065,529,536
Kentucky,Lawrence County,5,14,839,416,423
Kentucky,Lawrence County,5,15,594,286,308
Kentucky,Lawrence County,5,16,422,195,227
Kentucky,Lawrence County,5,17,281,116,165
Kentucky,Lawrence County,5,18,233,81,152
Kentucky,Lawrence County,6,0,15901,7880,8021
Kentucky,Lawrence County,6,1,1034,546,488
Kentucky,Lawrence County,6,2,1087,555,532
Kentucky,Lawrence County,6,3,997,519,478
Kentucky,Lawrence County,6,4,867,460,407
Kentucky,Lawrence County,6,5,1007,513,494
Kentucky,Lawrence County,6,6,864,432,432
Kentucky,Lawrence County,6,7,969,458,511
Kentucky,Lawrence County,6,8,992,490,502
Kentucky,Lawrence County,6,9,1068,519,549
Kentucky,Lawrence County,6,10,1076,551,525
Kentucky,Lawrence County,6,11,1224,594,630
Kentucky,Lawrence County,6,12,1207,581,626
Kentucky,Lawrence County,6,13,1070,522,548
Kentucky,Lawrence County,6,14,859,436,423
Kentucky,Lawrence County,6,15,646,311,335
Kentucky,Lawrence County,6,16,413,190,223
Kentucky,Lawrence County,6,17,292,125,167
Kentucky,Lawrence County,6,18,229,78,151
Kentucky,Lawrence County,7,0,15878,7880,7998
Kentucky,Lawrence County,7,1,1035,553,482
Kentucky,Lawrence County,7,2,1094,543,551
Kentucky,Lawrence County,7,3,1020,540,480
Kentucky,Lawrence County,7,4,831,454,377
Kentucky,Lawrence County,7,5,995,517,478
Kentucky,Lawrence County,7,6,859,422,437
Kentucky,Lawrence County,7,7,936,438,498
Kentucky,Lawrence County,7,8,1006,498,508
Kentucky,Lawrence County,7,9,996,502,494
Kentucky,Lawrence County,7,10,1061,537,524
Kentucky,Lawrence County,7,11,1229,599,630
Kentucky,Lawrence County,7,12,1172,552,620
Kentucky,Lawrence County,7,13,1115,548,567
Kentucky,Lawrence County,7,14,902,443,459
Kentucky,Lawrence County,7,15,656,318,338
Kentucky,Lawrence County,7,16,458,209,249
Kentucky,Lawrence County,7,17,275,117,158
Kentucky,Lawrence County,7,18,238,90,148
Kentucky,Lawrence County,8,0,15861,7892,7969
Kentucky,Lawrence County,8,1,1029,549,480
Kentucky,Lawrence County,8,2,1104,571,533
Kentucky,Lawrence County,8,3,1037,545,492
Kentucky,Lawrence County,8,4,859,474,385
Kentucky,Lawrence County,8,5,947,493,454
Kentucky,Lawrence County,8,6,886,453,433
Kentucky,Lawrence County,8,7,940,440,500
Kentucky,Lawrence County,8,8,981,485,496
Kentucky,Lawrence County,8,9,998,508,490
Kentucky,Lawrence County,8,10,1051,529,522
Kentucky,Lawrence County,8,11,1176,572,604
Kentucky,Lawrence County,8,12,1144,535,609
Kentucky,Lawrence County,8,13,1140,550,590
Kentucky,Lawrence County,8,14,934,459,475
Kentucky,Lawrence County,8,15,669,325,344
Kentucky,Lawrence County,8,16,455,198,257
Kentucky,Lawrence County,8,17,278,127,151
Kentucky,Lawrence County,8,18,233,79,154
Kentucky,Lawrence County,9,0,15839,7903,7936
Kentucky,Lawrence County,9,1,1055,574,481
Kentucky,Lawrence County,9,2,1082,566,516
Kentucky,Lawrence County,9,3,1037,541,496
Kentucky,Lawrence County,9,4,888,485,403
Kentucky,Lawrence County,9,5,847,449,398
Kentucky,Lawrence County,9,6,954,476,478
Kentucky,Lawrence County,9,7,901,432,469
Kentucky,Lawrence County,9,8,1012,505,507
Kentucky,Lawrence County,9,9,971,489,482
Kentucky,Lawrence County,9,10,1052,527,525
Kentucky,Lawrence County,9,11,1133,561,572
Kentucky,Lawrence County,9,12,1117,517,600
Kentucky,Lawrence County,9,13,1175,550,625
Kentucky,Lawrence County,9,14,964,488,476
Kentucky,Lawrence County,9,15,662,336,326
Kentucky,Lawrence County,9,16,473,195,278
Kentucky,Lawrence County,9,17,292,140,152
Kentucky,Lawrence County,9,18,224,72,152
Kentucky,Lawrence County,10,0,15756,7824,7932
Kentucky,Lawrence County,10,1,1051,566,485
Kentucky,Lawrence County,10,2,1088,580,508
Kentucky,Lawrence County,10,3,1025,524,501
Kentucky,Lawrence County,10,4,912,483,429
Kentucky,Lawrence County,10,5,801,404,397
Kentucky,Lawrence County,10,6,976,502,474
Kentucky,Lawrence County,10,7,840,424,416
Kentucky,Lawrence County,10,8,1009,478,531
Kentucky,Lawrence County,10,9,964,478,486
Kentucky,Lawrence County,10,10,1067,529,538
Kentucky,Lawrence County,10,11,1082,554,528
Kentucky,Lawrence County,10,12,1123,531,592
Kentucky,Lawrence County,10,13,1128,517,611
Kentucky,Lawrence County,10,14,956,475,481
Kentucky,Lawrence County,10,15,724,357,367
Kentucky,Lawrence County,10,16,478,220,258
Kentucky,Lawrence County,10,17,294,125,169
Kentucky,Lawrence County,10,18,238,77,161
Kentucky,Lawrence County,11,0,15583,7749,7834
Kentucky,Lawrence County,11,1,1038,571,467
Kentucky,Lawrence County,11,2,1045,546,499
Kentucky,Lawrence County,11,3,1054,538,516
Kentucky,Lawrence County,11,4,925,488,437
Kentucky,Lawrence County,11,5,736,383,353
Kentucky,Lawrence County,11,6,969,491,478
Kentucky,Lawrence County,11,7,827,428,399
Kentucky,Lawrence County,11,8,964,454,510
Kentucky,Lawrence County,11,9,965,482,483
Kentucky,Lawrence County,11,10,1043,513,530
Kentucky,Lawrence County,11,11,1048,539,509
Kentucky,Lawrence County,11,12,1150,554,596
Kentucky,Lawrence County,11,13,1125,523,602
Kentucky,Lawrence County,11,14,944,452,492
Kentucky,Lawrence County,11,15,731,356,375
Kentucky,Lawrence County,11,16,491,232,259
Kentucky,Lawrence County,11,17,290,119,171
Kentucky,Lawrence County,11,18,238,80,158
Kentucky,Lawrence County,12,0,15317,7581,7736
Kentucky,Lawrence County,12,1,993,535,458
Kentucky,Lawrence County,12,2,1035,550,485
Kentucky,Lawrence County,12,3,1023,496,527
Kentucky,Lawrence County,12,4,901,489,412
Kentucky,Lawrence County,12,5,714,362,352
Kentucky,Lawrence County,12,6,967,484,483
Kentucky,Lawrence County,12,7,813,418,395
Kentucky,Lawrence County,12,8,914,439,475
Kentucky,Lawrence County,12,9,966,476,490
Kentucky,Lawrence County,12,10,975,491,484
Kentucky,Lawrence County,12,11,1018,506,512
Kentucky,Lawrence County,12,12,1161,571,590
Kentucky,Lawrence County,12,13,1077,494,583
Kentucky,Lawrence County,12,14,981,464,517
Kentucky,Lawrence County,12,15,765,366,399
Kentucky,Lawrence County,12,16,483,232,251
Kentucky,Lawrence County,12,17,300,124,176
Kentucky,Lawrence County,12,18,231,84,147
Kentucky,Lee County,1,0,7887,4325,3562
Kentucky,Lee County,1,1,370,193,177
Kentucky,Lee County,1,2,410,198,212
Kentucky,Lee County,1,3,463,229,234
Kentucky,Lee County,1,4,469,256,213
Kentucky,Lee County,1,5,492,292,200
Kentucky,Lee County,1,6,557,361,196
Kentucky,Lee County,1,7,549,340,209
Kentucky,Lee County,1,8,516,309,207
Kentucky,Lee County,1,9,650,378,272
Kentucky,Lee County,1,10,684,385,299
Kentucky,Lee County,1,11,609,346,263
Kentucky,Lee County,1,12,567,302,265
Kentucky,Lee County,1,13,508,270,238
Kentucky,Lee County,1,14,338,168,170
Kentucky,Lee County,1,15,249,124,125
Kentucky,Lee County,1,16,218,91,127
Kentucky,Lee County,1,17,139,52,87
Kentucky,Lee County,1,18,99,31,68
Kentucky,Lee County,2,0,7887,4325,3562
Kentucky,Lee County,2,1,370,193,177
Kentucky,Lee County,2,2,410,198,212
Kentucky,Lee County,2,3,462,229,233
Kentucky,Lee County,2,4,468,255,213
Kentucky,Lee County,2,5,493,292,201
Kentucky,Lee County,2,6,558,362,196
Kentucky,Lee County,2,7,549,340,209
Kentucky,Lee County,2,8,516,309,207
Kentucky,Lee County,2,9,649,378,271
Kentucky,Lee County,2,10,683,384,299
Kentucky,Lee County,2,11,609,346,263
Kentucky,Lee County,2,12,567,302,265
Kentucky,Lee County,2,13,509,270,239
Kentucky,Lee County,2,14,339,169,170
Kentucky,Lee County,2,15,249,124,125
Kentucky,Lee County,2,16,218,91,127
Kentucky,Lee County,2,17,139,52,87
Kentucky,Lee County,2,18,99,31,68
Kentucky,Lee County,3,0,7717,4155,3562
Kentucky,Lee County,3,1,360,187,173
Kentucky,Lee County,3,2,415,203,212
Kentucky,Lee County,3,3,465,231,234
Kentucky,Lee County,3,4,463,252,211
Kentucky,Lee County,3,5,471,277,194
Kentucky,Lee County,3,6,526,328,198
Kentucky,Lee County,3,7,522,315,207
Kentucky,Lee County,3,8,489,281,208
Kentucky,Lee County,3,9,625,356,269
Kentucky,Lee County,3,10,662,365,297
Kentucky,Lee County,3,11,597,331,266
Kentucky,Lee County,3,12,565,300,265
Kentucky,Lee County,3,13,505,263,242
Kentucky,Lee County,3,14,345,169,176
Kentucky,Lee County,3,15,246,123,123
Kentucky,Lee County,3,16,220,90,130
Kentucky,Lee County,3,17,142,54,88
Kentucky,Lee County,3,18,99,30,69
Kentucky,Lee County,4,0,7707,4169,3538
Kentucky,Lee County,4,1,339,182,157
Kentucky,Lee County,4,2,422,208,214
Kentucky,Lee County,4,3,487,241,246
Kentucky,Lee County,4,4,441,240,201
Kentucky,Lee County,4,5,453,281,172
Kentucky,Lee County,4,6,552,336,216
Kentucky,Lee County,4,7,518,316,202
Kentucky,Lee County,4,8,464,267,197
Kentucky,Lee County,4,9,616,356,260
Kentucky,Lee County,4,10,649,358,291
Kentucky,Lee County,4,11,599,321,278
Kentucky,Lee County,4,12,570,311,259
Kentucky,Lee County,4,13,511,261,250
Kentucky,Lee County,4,14,368,186,182
Kentucky,Lee County,4,15,248,123,125
Kentucky,Lee County,4,16,223,94,129
Kentucky,Lee County,4,17,139,54,85
Kentucky,Lee County,4,18,108,34,74
Kentucky,Lee County,5,0,7581,4078,3503
Kentucky,Lee County,5,1,352,191,161
Kentucky,Lee County,5,2,399,205,194
Kentucky,Lee County,5,3,453,227,226
Kentucky,Lee County,5,4,439,219,220
Kentucky,Lee County,5,5,446,271,175
Kentucky,Lee County,5,6,540,334,206
Kentucky,Lee County,5,7,510,313,197
Kentucky,Lee County,5,8,448,252,196
Kentucky,Lee County,5,9,570,338,232
Kentucky,Lee County,5,10,646,348,298
Kentucky,Lee County,5,11,596,321,275
Kentucky,Lee County,5,12,563,299,264
Kentucky,Lee County,5,13,499,255,244
Kentucky,Lee County,5,14,405,203,202
Kentucky,Lee County,5,15,260,125,135
Kentucky,Lee County,5,16,207,93,114
Kentucky,Lee County,5,17,139,53,86
Kentucky,Lee County,5,18,109,31,78
Kentucky,Lee County,6,0,6876,3454,3422
Kentucky,Lee County,6,1,358,204,154
Kentucky,Lee County,6,2,396,203,193
Kentucky,Lee County,6,3,418,213,205
Kentucky,Lee County,6,4,441,226,215
Kentucky,Lee County,6,5,367,199,168
Kentucky,Lee County,6,6,401,214,187
Kentucky,Lee County,6,7,382,216,166
Kentucky,Lee County,6,8,379,174,205
Kentucky,Lee County,6,9,459,240,219
Kentucky,Lee County,6,10,566,279,287
Kentucky,Lee County,6,11,559,277,282
Kentucky,Lee County,6,12,529,271,258
Kentucky,Lee County,6,13,488,234,254
Kentucky,Lee County,6,14,413,192,221
Kentucky,Lee County,6,15,262,122,140
Kentucky,Lee County,6,16,201,96,105
Kentucky,Lee County,6,17,154,61,93
Kentucky,Lee County,6,18,103,33,70
Kentucky,Lee County,7,0,6796,3413,3383
Kentucky,Lee County,7,1,351,202,149
Kentucky,Lee County,7,2,390,198,192
Kentucky,Lee County,7,3,397,195,202
Kentucky,Lee County,7,4,434,224,210
Kentucky,Lee County,7,5,354,189,165
Kentucky,Lee County,7,6,407,218,189
Kentucky,Lee County,7,7,380,221,159
Kentucky,Lee County,7,8,378,178,200
Kentucky,Lee County,7,9,412,213,199
Kentucky,Lee County,7,10,547,267,280
Kentucky,Lee County,7,11,583,277,306
Kentucky,Lee County,7,12,522,277,245
Kentucky,Lee County,7,13,487,235,252
Kentucky,Lee County,7,14,443,210,233
Kentucky,Lee County,7,15,262,118,144
Kentucky,Lee County,7,16,201,102,99
Kentucky,Lee County,7,17,146,53,93
Kentucky,Lee County,7,18,102,36,66
Kentucky,Lee County,8,0,6746,3400,3346
Kentucky,Lee County,8,1,350,206,144
Kentucky,Lee County,8,2,374,188,186
Kentucky,Lee County,8,3,390,199,191
Kentucky,Lee County,8,4,394,207,187
Kentucky,Lee County,8,5,369,200,169
Kentucky,Lee County,8,6,403,213,190
Kentucky,Lee County,8,7,374,207,167
Kentucky,Lee County,8,8,378,195,183
Kentucky,Lee County,8,9,386,186,200
Kentucky,Lee County,8,10,537,269,268
Kentucky,Lee County,8,11,583,286,297
Kentucky,Lee County,8,12,517,266,251
Kentucky,Lee County,8,13,512,245,267
Kentucky,Lee County,8,14,439,210,229
Kentucky,Lee County,8,15,294,138,156
Kentucky,Lee County,8,16,186,93,93
Kentucky,Lee County,8,17,149,55,94
Kentucky,Lee County,8,18,111,37,74
Kentucky,Lee County,9,0,6604,3351,3253
Kentucky,Lee County,9,1,356,210,146
Kentucky,Lee County,9,2,339,184,155
Kentucky,Lee County,9,3,391,195,196
Kentucky,Lee County,9,4,372,204,168
Kentucky,Lee County,9,5,340,179,161
Kentucky,Lee County,9,6,386,216,170
Kentucky,Lee County,9,7,374,189,185
Kentucky,Lee County,9,8,392,206,186
Kentucky,Lee County,9,9,344,169,175
Kentucky,Lee County,9,10,515,256,259
Kentucky,Lee County,9,11,568,284,284
Kentucky,Lee County,9,12,510,257,253
Kentucky,Lee County,9,13,508,250,258
Kentucky,Lee County,9,14,452,214,238
Kentucky,Lee County,9,15,314,150,164
Kentucky,Lee County,9,16,179,88,91
Kentucky,Lee County,9,17,151,61,90
Kentucky,Lee County,9,18,113,39,74
Kentucky,Lee County,10,0,6602,3363,3239
Kentucky,Lee County,10,1,398,234,164
Kentucky,Lee County,10,2,333,182,151
Kentucky,Lee County,10,3,381,205,176
Kentucky,Lee County,10,4,376,196,180
Kentucky,Lee County,10,5,324,171,153
Kentucky,Lee County,10,6,399,219,180
Kentucky,Lee County,10,7,372,191,181
Kentucky,Lee County,10,8,393,209,184
Kentucky,Lee County,10,9,334,165,169
Kentucky,Lee County,10,10,481,246,235
Kentucky,Lee County,10,11,553,265,288
Kentucky,Lee County,10,12,541,280,261
Kentucky,Lee County,10,13,504,250,254
Kentucky,Lee County,10,14,437,207,230
Kentucky,Lee County,10,15,341,169,172
Kentucky,Lee County,10,16,183,81,102
Kentucky,Lee County,10,17,135,57,78
Kentucky,Lee County,10,18,117,36,81
Kentucky,Lee County,11,0,7052,3827,3225
Kentucky,Lee County,11,1,398,225,173
Kentucky,Lee County,11,2,329,189,140
Kentucky,Lee County,11,3,381,198,183
Kentucky,Lee County,11,4,361,195,166
Kentucky,Lee County,11,5,374,223,151
Kentucky,Lee County,11,6,476,301,175
Kentucky,Lee County,11,7,472,271,201
Kentucky,Lee County,11,8,446,280,166
Kentucky,Lee County,11,9,428,246,182
Kentucky,Lee County,11,10,477,270,207
Kentucky,Lee County,11,11,577,301,276
Kentucky,Lee County,11,12,570,282,288
Kentucky,Lee County,11,13,514,281,233
Kentucky,Lee County,11,14,457,215,242
Kentucky,Lee County,11,15,357,170,187
Kentucky,Lee County,11,16,194,87,107
Kentucky,Lee County,11,17,127,58,69
Kentucky,Lee County,11,18,114,35,79
Kentucky,Lee County,12,0,7403,4144,3259
Kentucky,Lee County,12,1,395,212,183
Kentucky,Lee County,12,2,340,198,142
Kentucky,Lee County,12,3,394,211,183
Kentucky,Lee County,12,4,352,182,170
Kentucky,Lee County,12,5,413,258,155
Kentucky,Lee County,12,6,543,358,185
Kentucky,Lee County,12,7,549,344,205
Kentucky,Lee County,12,8,481,317,164
Kentucky,Lee County,12,9,483,284,199
Kentucky,Lee County,12,10,488,297,191
Kentucky,Lee County,12,11,588,320,268
Kentucky,Lee County,12,12,589,288,301
Kentucky,Lee County,12,13,514,298,216
Kentucky,Lee County,12,14,476,226,250
Kentucky,Lee County,12,15,364,174,190
Kentucky,Lee County,12,16,193,85,108
Kentucky,Lee County,12,17,138,64,74
Kentucky,Lee County,12,18,103,28,75
Kentucky,Leslie County,1,0,11310,5600,5710
Kentucky,Leslie County,1,1,649,342,307
Kentucky,Leslie County,1,2,665,348,317
Kentucky,Leslie County,1,3,680,351,329
Kentucky,Leslie County,1,4,715,363,352
Kentucky,Leslie County,1,5,672,365,307
Kentucky,Leslie County,1,6,652,315,337
Kentucky,Leslie County,1,7,725,360,365
Kentucky,Leslie County,1,8,742,365,377
Kentucky,Leslie County,1,9,793,395,398
Kentucky,Leslie County,1,10,928,478,450
Kentucky,Leslie County,1,11,987,495,492
Kentucky,Leslie County,1,12,809,410,399
Kentucky,Leslie County,1,13,690,339,351
Kentucky,Leslie County,1,14,509,223,286
Kentucky,Leslie County,1,15,443,220,223
Kentucky,Leslie County,1,16,303,125,178
Kentucky,Leslie County,1,17,167,54,113
Kentucky,Leslie County,1,18,181,52,129
Kentucky,Leslie County,2,0,11310,5600,5710
Kentucky,Leslie County,2,1,649,342,307
Kentucky,Leslie County,2,2,665,348,317
Kentucky,Leslie County,2,3,680,351,329
Kentucky,Leslie County,2,4,715,363,352
Kentucky,Leslie County,2,5,672,365,307
Kentucky,Leslie County,2,6,652,315,337
Kentucky,Leslie County,2,7,725,360,365
Kentucky,Leslie County,2,8,742,365,377
Kentucky,Leslie County,2,9,793,395,398
Kentucky,Leslie County,2,10,928,478,450
Kentucky,Leslie County,2,11,987,495,492
Kentucky,Leslie County,2,12,809,410,399
Kentucky,Leslie County,2,13,690,339,351
Kentucky,Leslie County,2,14,509,223,286
Kentucky,Leslie County,2,15,443,220,223
Kentucky,Leslie County,2,16,303,125,178
Kentucky,Leslie County,2,17,167,54,113
Kentucky,Leslie County,2,18,181,52,129
Kentucky,Leslie County,3,0,11278,5584,5694
Kentucky,Leslie County,3,1,654,342,312
Kentucky,Leslie County,3,2,659,346,313
Kentucky,Leslie County,3,3,683,357,326
Kentucky,Leslie County,3,4,698,354,344
Kentucky,Leslie County,3,5,688,371,317
Kentucky,Leslie County,3,6,652,316,336
Kentucky,Leslie County,3,7,724,356,368
Kentucky,Leslie County,3,8,738,364,374
Kentucky,Leslie County,3,9,781,388,393
Kentucky,Leslie County,3,10,929,477,452
Kentucky,Leslie County,3,11,984,497,487
Kentucky,Leslie County,3,12,814,410,404
Kentucky,Leslie County,3,13,690,341,349
Kentucky,Leslie County,3,14,503,224,279
Kentucky,Leslie County,3,15,434,208,226
Kentucky,Leslie County,3,16,308,131,177
Kentucky,Leslie County,3,17,165,53,112
Kentucky,Leslie County,3,18,174,49,125
Kentucky,Leslie County,4,0,11237,5566,5671
Kentucky,Leslie County,4,1,689,369,320
Kentucky,Leslie County,4,2,651,343,308
Kentucky,Leslie County,4,3,659,356,303
Kentucky,Leslie County,4,4,649,321,328
Kentucky,Leslie County,4,5,725,383,342
Kentucky,Leslie County,4,6,665,326,339
Kentucky,Leslie County,4,7,702,340,362
Kentucky,Leslie County,4,8,721,361,360
Kentucky,Leslie County,4,9,738,363,375
Kentucky,Leslie County,4,10,909,462,447
Kentucky,Leslie County,4,11,958,494,464
Kentucky,Leslie County,4,12,834,411,423
Kentucky,Leslie County,4,13,724,356,368
Kentucky,Leslie County,4,14,515,246,269
Kentucky,Leslie County,4,15,432,189,243
Kentucky,Leslie County,4,16,330,148,182
Kentucky,Leslie County,4,17,160,50,110
Kentucky,Leslie County,4,18,176,48,128
Kentucky,Leslie County,5,0,11140,5517,5623
Kentucky,Leslie County,5,1,705,387,318
Kentucky,Leslie County,5,2,639,324,315
Kentucky,Leslie County,5,3,677,363,314
Kentucky,Leslie County,5,4,598,301,297
Kentucky,Leslie County,5,5,705,364,341
Kentucky,Leslie County,5,6,669,333,336
Kentucky,Leslie County,5,7,680,327,353
Kentucky,Leslie County,5,8,715,363,352
Kentucky,Leslie County,5,9,709,339,370
Kentucky,Leslie County,5,10,881,455,426
Kentucky,Leslie County,5,11,903,468,435
Kentucky,Leslie County,5,12,860,415,445
Kentucky,Leslie County,5,13,716,346,370
Kentucky,Leslie County,5,14,551,275,276
Kentucky,Leslie County,5,15,444,198,246
Kentucky,Leslie County,5,16,335,153,182
Kentucky,Leslie County,5,17,173,58,115
Kentucky,Leslie County,5,18,180,48,132
Kentucky,Leslie County,6,0,10985,5457,5528
Kentucky,Leslie County,6,1,680,366,314
Kentucky,Leslie County,6,2,667,340,327
Kentucky,Leslie County,6,3,669,361,308
Kentucky,Leslie County,6,4,569,282,287
Kentucky,Leslie County,6,5,694,357,337
Kentucky,Leslie County,6,6,675,343,332
Kentucky,Leslie County,6,7,657,323,334
Kentucky,Leslie County,6,8,711,354,357
Kentucky,Leslie County,6,9,705,332,373
Kentucky,Leslie County,6,10,830,431,399
Kentucky,Leslie County,6,11,893,465,428
Kentucky,Leslie County,6,12,849,416,433
Kentucky,Leslie County,6,13,711,338,373
Kentucky,Leslie County,6,14,558,296,262
Kentucky,Leslie County,6,15,424,182,242
Kentucky,Leslie County,6,16,335,140,195
Kentucky,Leslie County,6,17,189,78,111
Kentucky,Leslie County,6,18,169,53,116
Kentucky,Leslie County,7,0,10830,5391,5439
Kentucky,Leslie County,7,1,673,355,318
Kentucky,Leslie County,7,2,653,330,323
Kentucky,Leslie County,7,3,642,351,291
Kentucky,Leslie County,7,4,571,300,271
Kentucky,Leslie County,7,5,663,327,336
Kentucky,Leslie County,7,6,671,349,322
Kentucky,Leslie County,7,7,636,316,320
Kentucky,Leslie County,7,8,679,338,341
Kentucky,Leslie County,7,9,701,345,356
Kentucky,Leslie County,7,10,778,396,382
Kentucky,Leslie County,7,11,862,440,422
Kentucky,Leslie County,7,12,867,430,437
Kentucky,Leslie County,7,13,712,340,372
Kentucky,Leslie County,7,14,590,302,288
Kentucky,Leslie County,7,15,425,188,237
Kentucky,Leslie County,7,16,348,151,197
Kentucky,Leslie County,7,17,196,81,115
Kentucky,Leslie County,7,18,163,52,111
Kentucky,Leslie County,8,0,10644,5294,5350
Kentucky,Leslie County,8,1,667,355,312
Kentucky,Leslie County,8,2,653,335,318
Kentucky,Leslie County,8,3,630,336,294
Kentucky,Leslie County,8,4,575,319,256
Kentucky,Leslie County,8,5,583,281,302
Kentucky,Leslie County,8,6,676,341,335
Kentucky,Leslie County,8,7,600,310,290
Kentucky,Leslie County,8,8,661,315,346
Kentucky,Leslie County,8,9,690,335,355
Kentucky,Leslie County,8,10,711,356,355
Kentucky,Leslie County,8,11,855,437,418
Kentucky,Leslie County,8,12,868,432,436
Kentucky,Leslie County,8,13,719,355,364
Kentucky,Leslie County,8,14,614,302,312
Kentucky,Leslie County,8,15,422,188,234
Kentucky,Leslie County,8,16,343,161,182
Kentucky,Leslie County,8,17,202,82,120
Kentucky,Leslie County,8,18,175,54,121
Kentucky,Leslie County,9,0,10431,5172,5259
Kentucky,Leslie County,9,1,639,329,310
Kentucky,Leslie County,9,2,644,355,289
Kentucky,Leslie County,9,3,596,308,288
Kentucky,Leslie County,9,4,573,309,264
Kentucky,Leslie County,9,5,518,247,271
Kentucky,Leslie County,9,6,705,350,355
Kentucky,Leslie County,9,7,597,319,278
Kentucky,Leslie County,9,8,622,289,333
Kentucky,Leslie County,9,9,678,332,346
Kentucky,Leslie County,9,10,681,336,345
Kentucky,Leslie County,9,11,813,417,396
Kentucky,Leslie County,9,12,858,429,429
Kentucky,Leslie County,9,13,717,349,368
Kentucky,Leslie County,9,14,628,298,330
Kentucky,Leslie County,9,15,433,209,224
Kentucky,Leslie County,9,16,334,146,188
Kentucky,Leslie County,9,17,231,104,127
Kentucky,Leslie County,9,18,164,46,118
Kentucky,Leslie County,10,0,10310,5161,5149
Kentucky,Leslie County,10,1,594,318,276
Kentucky,Leslie County,10,2,654,362,292
Kentucky,Leslie County,10,3,604,312,292
Kentucky,Leslie County,10,4,572,312,260
Kentucky,Leslie County,10,5,496,251,245
Kentucky,Leslie County,10,6,723,355,368
Kentucky,Leslie County,10,7,601,328,273
Kentucky,Leslie County,10,8,597,284,313
Kentucky,Leslie County,10,9,653,321,332
Kentucky,Leslie County,10,10,667,318,349
Kentucky,Leslie County,10,11,791,413,378
Kentucky,Leslie County,10,12,802,399,403
Kentucky,Leslie County,10,13,735,361,374
Kentucky,Leslie County,10,14,611,288,323
Kentucky,Leslie County,10,15,454,230,224
Kentucky,Leslie County,10,16,350,153,197
Kentucky,Leslie County,10,17,226,101,125
Kentucky,Leslie County,10,18,180,55,125
Kentucky,Leslie County,11,0,10151,5060,5091
Kentucky,Leslie County,11,1,590,313,277
Kentucky,Leslie County,11,2,635,341,294
Kentucky,Leslie County,11,3,591,302,289
Kentucky,Leslie County,11,4,549,300,249
Kentucky,Leslie County,11,5,486,248,238
Kentucky,Leslie County,11,6,692,344,348
Kentucky,Leslie County,11,7,612,333,279
Kentucky,Leslie County,11,8,566,274,292
Kentucky,Leslie County,11,9,643,323,320
Kentucky,Leslie County,11,10,659,304,355
Kentucky,Leslie County,11,11,761,383,378
Kentucky,Leslie County,11,12,782,396,386
Kentucky,Leslie County,11,13,742,364,378
Kentucky,Leslie County,11,14,625,294,331
Kentucky,Leslie County,11,15,464,246,218
Kentucky,Leslie County,11,16,333,136,197
Kentucky,Leslie County,11,17,235,89,146
Kentucky,Leslie County,11,18,186,70,116
Kentucky,Leslie County,12,0,9877,4934,4943
Kentucky,Leslie County,12,1,546,296,250
Kentucky,Leslie County,12,2,617,332,285
Kentucky,Leslie County,12,3,608,315,293
Kentucky,Leslie County,12,4,525,278,247
Kentucky,Leslie County,12,5,476,244,232
Kentucky,Leslie County,12,6,629,314,315
Kentucky,Leslie County,12,7,598,316,282
Kentucky,Leslie County,12,8,551,279,272
Kentucky,Leslie County,12,9,597,299,298
Kentucky,Leslie County,12,10,649,311,338
Kentucky,Leslie County,12,11,729,370,359
Kentucky,Leslie County,12,12,755,372,383
Kentucky,Leslie County,12,13,751,373,378
Kentucky,Leslie County,12,14,619,297,322
Kentucky,Leslie County,12,15,482,242,240
Kentucky,Leslie County,12,16,331,136,195
Kentucky,Leslie County,12,17,228,95,133
Kentucky,Leslie County,12,18,186,65,121
Kentucky,Letcher County,1,0,24519,12081,12438
Kentucky,Letcher County,1,1,1523,794,729
Kentucky,Letcher County,1,2,1441,744,697
Kentucky,Letcher County,1,3,1507,770,737
Kentucky,Letcher County,1,4,1538,799,739
Kentucky,Letcher County,1,5,1350,736,614
Kentucky,Letcher County,1,6,1476,722,754
Kentucky,Letcher County,1,7,1585,786,799
Kentucky,Letcher County,1,8,1561,777,784
Kentucky,Letcher County,1,9,1566,760,806
Kentucky,Letcher County,1,10,1929,949,980
Kentucky,Letcher County,1,11,1951,961,990
Kentucky,Letcher County,1,12,1923,940,983
Kentucky,Letcher County,1,13,1693,846,847
Kentucky,Letcher County,1,14,1161,555,606
Kentucky,Letcher County,1,15,938,418,520
Kentucky,Letcher County,1,16,605,243,362
Kentucky,Letcher County,1,17,444,164,280
Kentucky,Letcher County,1,18,328,117,211
Kentucky,Letcher County,2,0,24511,12076,12435
Kentucky,Letcher County,2,1,1523,794,729
Kentucky,Letcher County,2,2,1441,744,697
Kentucky,Letcher County,2,3,1507,770,737
Kentucky,Letcher County,2,4,1537,798,739
Kentucky,Letcher County,2,5,1350,736,614
Kentucky,Letcher County,2,6,1476,722,754
Kentucky,Letcher County,2,7,1584,785,799
Kentucky,Letcher County,2,8,1561,777,784
Kentucky,Letcher County,2,9,1566,760,806
Kentucky,Letcher County,2,10,1929,949,980
Kentucky,Letcher County,2,11,1948,959,989
Kentucky,Letcher County,2,12,1922,940,982
Kentucky,Letcher County,2,13,1691,845,846
Kentucky,Letcher County,2,14,1161,555,606
Kentucky,Letcher County,2,15,938,418,520
Kentucky,Letcher County,2,16,605,243,362
Kentucky,Letcher County,2,17,444,164,280
Kentucky,Letcher County,2,18,328,117,211
Kentucky,Letcher County,3,0,24534,12069,12465
Kentucky,Letcher County,3,1,1522,786,736
Kentucky,Letcher County,3,2,1463,760,703
Kentucky,Letcher County,3,3,1516,772,744
Kentucky,Letcher County,3,4,1508,781,727
Kentucky,Letcher County,3,5,1361,738,623
Kentucky,Letcher County,3,6,1490,733,757
Kentucky,Letcher County,3,7,1579,781,798
Kentucky,Letcher County,3,8,1560,776,784
Kentucky,Letcher County,3,9,1577,766,811
Kentucky,Letcher County,3,10,1918,942,976
Kentucky,Letcher County,3,11,1953,954,999
Kentucky,Letcher County,3,12,1908,934,974
Kentucky,Letcher County,3,13,1704,847,857
Kentucky,Letcher County,3,14,1155,556,599
Kentucky,Letcher County,3,15,936,413,523
Kentucky,Letcher County,3,16,609,250,359
Kentucky,Letcher County,3,17,444,163,281
Kentucky,Letcher County,3,18,331,117,214
Kentucky,Letcher County,4,0,24376,12033,12343
Kentucky,Letcher County,4,1,1501,785,716
Kentucky,Letcher County,4,2,1526,813,713
Kentucky,Letcher County,4,3,1506,774,732
Kentucky,Letcher County,4,4,1426,733,693
Kentucky,Letcher County,4,5,1355,729,626
Kentucky,Letcher County,4,6,1467,726,741
Kentucky,Letcher County,4,7,1561,772,789
Kentucky,Letcher County,4,8,1520,756,764
Kentucky,Letcher County,4,9,1593,790,803
Kentucky,Letcher County,4,10,1835,898,937
Kentucky,Letcher County,4,11,1948,947,1001
Kentucky,Letcher County,4,12,1841,894,947
Kentucky,Letcher County,4,13,1790,879,911
Kentucky,Letcher County,4,14,1172,583,589
Kentucky,Letcher County,4,15,937,412,525
Kentucky,Letcher County,4,16,628,269,359
Kentucky,Letcher County,4,17,440,158,282
Kentucky,Letcher County,4,18,330,115,215
Kentucky,Letcher County,5,0,24011,11840,12171
Kentucky,Letcher County,5,1,1473,775,698
Kentucky,Letcher County,5,2,1533,802,731
Kentucky,Letcher County,5,3,1435,746,689
Kentucky,Letcher County,5,4,1343,693,650
Kentucky,Letcher County,5,5,1332,703,629
Kentucky,Letcher County,5,6,1373,695,678
Kentucky,Letcher County,5,7,1568,761,807
Kentucky,Letcher County,5,8,1515,769,746
Kentucky,Letcher County,5,9,1563,776,787
Kentucky,Letcher County,5,10,1719,831,888
Kentucky,Letcher County,5,11,1888,922,966
Kentucky,Letcher County,5,12,1852,887,965
Kentucky,Letcher County,5,13,1781,862,919
Kentucky,Letcher County,5,14,1278,645,633
Kentucky,Letcher County,5,15,936,417,519
Kentucky,Letcher County,5,16,650,276,374
Kentucky,Letcher County,5,17,429,153,276
Kentucky,Letcher County,5,18,343,127,216
Kentucky,Letcher County,6,0,23540,11595,11945
Kentucky,Letcher County,6,1,1393,707,686
Kentucky,Letcher County,6,2,1504,785,719
Kentucky,Letcher County,6,3,1361,714,647
Kentucky,Letcher County,6,4,1299,675,624
Kentucky,Letcher County,6,5,1309,689,620
Kentucky,Letcher County,6,6,1334,677,657
Kentucky,Letcher County,6,7,1516,740,776
Kentucky,Letcher County,6,8,1490,752,738
Kentucky,Letcher County,6,9,1533,763,770
Kentucky,Letcher County,6,10,1599,768,831
Kentucky,Letcher County,6,11,1862,902,960
Kentucky,Letcher County,6,12,1850,900,950
Kentucky,Letcher County,6,13,1764,853,911
Kentucky,Letcher County,6,14,1330,660,670
Kentucky,Letcher County,6,15,959,444,515
Kentucky,Letcher County,6,16,676,286,390
Kentucky,Letcher County,6,17,416,145,271
Kentucky,Letcher County,6,18,345,135,210
Kentucky,Letcher County,7,0,23357,11497,11860
Kentucky,Letcher County,7,1,1420,734,686
Kentucky,Letcher County,7,2,1457,756,701
Kentucky,Letcher County,7,3,1377,727,650
Kentucky,Letcher County,7,4,1268,659,609
Kentucky,Letcher County,7,5,1265,660,605
Kentucky,Letcher County,7,6,1370,712,658
Kentucky,Letcher County,7,7,1455,705,750
Kentucky,Letcher County,7,8,1490,750,740
Kentucky,Letcher County,7,9,1479,723,756
Kentucky,Letcher County,7,10,1554,750,804
Kentucky,Letcher County,7,11,1783,862,921
Kentucky,Letcher County,7,12,1858,893,965
Kentucky,Letcher County,7,13,1731,841,890
Kentucky,Letcher County,7,14,1399,693,706
Kentucky,Letcher County,7,15,963,441,522
Kentucky,Letcher County,7,16,710,305,405
Kentucky,Letcher County,7,17,423,149,274
Kentucky,Letcher County,7,18,355,137,218
Kentucky,Letcher County,8,0,23049,11306,11743
Kentucky,Letcher County,8,1,1365,693,672
Kentucky,Letcher County,8,2,1390,714,676
Kentucky,Letcher County,8,3,1354,713,641
Kentucky,Letcher County,8,4,1289,675,614
Kentucky,Letcher County,8,5,1237,642,595
Kentucky,Letcher County,8,6,1305,692,613
Kentucky,Letcher County,8,7,1381,657,724
Kentucky,Letcher County,8,8,1492,732,760
Kentucky,Letcher County,8,9,1435,690,745
Kentucky,Letcher County,8,10,1513,735,778
Kentucky,Letcher County,8,11,1773,860,913
Kentucky,Letcher County,8,12,1788,858,930
Kentucky,Letcher County,8,13,1739,842,897
Kentucky,Letcher County,8,14,1499,734,765
Kentucky,Letcher County,8,15,967,462,505
Kentucky,Letcher County,8,16,718,304,414
Kentucky,Letcher County,8,17,437,164,273
Kentucky,Letcher County,8,18,367,139,228
Kentucky,Letcher County,9,0,22759,11148,11611
Kentucky,Letcher County,9,1,1342,651,691
Kentucky,Letcher County,9,2,1394,714,680
Kentucky,Letcher County,9,3,1372,739,633
Kentucky,Letcher County,9,4,1290,675,615
Kentucky,Letcher County,9,5,1121,574,547
Kentucky,Letcher County,9,6,1319,688,631
Kentucky,Letcher County,9,7,1357,664,693
Kentucky,Letcher County,9,8,1448,703,745
Kentucky,Letcher County,9,9,1388,674,714
Kentucky,Letcher County,9,10,1504,744,760
Kentucky,Letcher County,9,11,1691,818,873
Kentucky,Letcher County,9,12,1774,841,933
Kentucky,Letcher County,9,13,1672,811,861
Kentucky,Letcher County,9,14,1551,760,791
Kentucky,Letcher County,9,15,1001,483,518
Kentucky,Letcher County,9,16,725,298,427
Kentucky,Letcher County,9,17,456,181,275
Kentucky,Letcher County,9,18,354,130,224
Kentucky,Letcher County,10,0,22303,10907,11396
Kentucky,Letcher County,10,1,1322,638,684
Kentucky,Letcher County,10,2,1341,683,658
Kentucky,Letcher County,10,3,1427,762,665
Kentucky,Letcher County,10,4,1201,634,567
Kentucky,Letcher County,10,5,1093,571,522
Kentucky,Letcher County,10,6,1297,659,638
Kentucky,Letcher County,10,7,1253,623,630
Kentucky,Letcher County,10,8,1437,685,752
Kentucky,Letcher County,10,9,1353,673,680
Kentucky,Letcher County,10,10,1476,731,745
Kentucky,Letcher County,10,11,1575,759,816
Kentucky,Letcher County,10,12,1708,805,903
Kentucky,Letcher County,10,13,1669,792,877
Kentucky,Letcher County,10,14,1554,751,803
Kentucky,Letcher County,10,15,1073,532,541
Kentucky,Letcher County,10,16,718,306,412
Kentucky,Letcher County,10,17,455,170,285
Kentucky,Letcher County,10,18,351,133,218
Kentucky,Letcher County,11,0,21813,10654,11159
Kentucky,Letcher County,11,1,1300,655,645
Kentucky,Letcher County,11,2,1305,649,656
Kentucky,Letcher County,11,3,1378,725,653
Kentucky,Letcher County,11,4,1151,608,543
Kentucky,Letcher County,11,5,1050,542,508
Kentucky,Letcher County,11,6,1242,641,601
Kentucky,Letcher County,11,7,1206,603,603
Kentucky,Letcher County,11,8,1395,673,722
Kentucky,Letcher County,11,9,1320,654,666
Kentucky,Letcher County,11,10,1416,694,722
Kentucky,Letcher County,11,11,1488,700,788
Kentucky,Letcher County,11,12,1685,798,887
Kentucky,Letcher County,11,13,1653,793,860
Kentucky,Letcher County,11,14,1567,741,826
Kentucky,Letcher County,11,15,1109,542,567
Kentucky,Letcher County,11,16,738,330,408
Kentucky,Letcher County,11,17,476,186,290
Kentucky,Letcher County,11,18,334,120,214
Kentucky,Letcher County,12,0,21553,10533,11020
Kentucky,Letcher County,12,1,1244,625,619
Kentucky,Letcher County,12,2,1324,672,652
Kentucky,Letcher County,12,3,1353,698,655
Kentucky,Letcher County,12,4,1145,603,542
Kentucky,Letcher County,12,5,1011,521,490
Kentucky,Letcher County,12,6,1214,627,587
Kentucky,Letcher County,12,7,1246,631,615
Kentucky,Letcher County,12,8,1320,641,679
Kentucky,Letcher County,12,9,1320,647,673
Kentucky,Letcher County,12,10,1364,669,695
Kentucky,Letcher County,12,11,1438,682,756
Kentucky,Letcher County,12,12,1627,780,847
Kentucky,Letcher County,12,13,1659,782,877
Kentucky,Letcher County,12,14,1527,719,808
Kentucky,Letcher County,12,15,1189,588,601
Kentucky,Letcher County,12,16,740,335,405
Kentucky,Letcher County,12,17,503,197,306
Kentucky,Letcher County,12,18,329,116,213
Kentucky,Lewis County,1,0,13870,6920,6950
Kentucky,Lewis County,1,1,857,443,414
Kentucky,Lewis County,1,2,906,467,439
Kentucky,Lewis County,1,3,936,460,476
Kentucky,Lewis County,1,4,955,536,419
Kentucky,Lewis County,1,5,727,364,363
Kentucky,Lewis County,1,6,727,326,401
Kentucky,Lewis County,1,7,848,417,431
Kentucky,Lewis County,1,8,909,477,432
Kentucky,Lewis County,1,9,970,493,477
Kentucky,Lewis County,1,10,1101,535,566
Kentucky,Lewis County,1,11,1043,537,506
Kentucky,Lewis County,1,12,967,462,505
Kentucky,Lewis County,1,13,881,443,438
Kentucky,Lewis County,1,14,700,363,337
Kentucky,Lewis County,1,15,529,259,270
Kentucky,Lewis County,1,16,381,169,212
Kentucky,Lewis County,1,17,238,98,140
Kentucky,Lewis County,1,18,195,71,124
Kentucky,Lewis County,2,0,13883,6925,6958
Kentucky,Lewis County,2,1,859,444,415
Kentucky,Lewis County,2,2,908,467,441
Kentucky,Lewis County,2,3,938,462,476
Kentucky,Lewis County,2,4,955,536,419
Kentucky,Lewis County,2,5,727,364,363
Kentucky,Lewis County,2,6,727,326,401
Kentucky,Lewis County,2,7,851,417,434
Kentucky,Lewis County,2,8,911,478,433
Kentucky,Lewis County,2,9,970,493,477
Kentucky,Lewis County,2,10,1101,535,566
Kentucky,Lewis County,2,11,1044,538,506
Kentucky,Lewis County,2,12,967,462,505
Kentucky,Lewis County,2,13,881,443,438
Kentucky,Lewis County,2,14,700,363,337
Kentucky,Lewis County,2,15,530,259,271
Kentucky,Lewis County,2,16,381,169,212
Kentucky,Lewis County,2,17,238,98,140
Kentucky,Lewis County,2,18,195,71,124
Kentucky,Lewis County,3,0,13837,6900,6937
Kentucky,Lewis County,3,1,838,435,403
Kentucky,Lewis County,3,2,895,459,436
Kentucky,Lewis County,3,3,946,472,474
Kentucky,Lewis County,3,4,942,525,417
Kentucky,Lewis County,3,5,730,367,363
Kentucky,Lewis County,3,6,724,326,398
Kentucky,Lewis County,3,7,856,417,439
Kentucky,Lewis County,3,8,904,470,434
Kentucky,Lewis County,3,9,967,491,476
Kentucky,Lewis County,3,10,1096,533,563
Kentucky,Lewis County,3,11,1048,537,511
Kentucky,Lewis County,3,12,973,471,502
Kentucky,Lewis County,3,13,874,436,438
Kentucky,Lewis County,3,14,695,360,335
Kentucky,Lewis County,3,15,528,258,270
Kentucky,Lewis County,3,16,385,172,213
Kentucky,Lewis County,3,17,239,99,140
Kentucky,Lewis County,3,18,197,72,125
Kentucky,Lewis County,4,0,13837,6896,6941
Kentucky,Lewis County,4,1,850,440,410
Kentucky,Lewis County,4,2,846,423,423
Kentucky,Lewis County,4,3,947,492,455
Kentucky,Lewis County,4,4,906,494,412
Kentucky,Lewis County,4,5,786,400,386
Kentucky,Lewis County,4,6,692,323,369
Kentucky,Lewis County,4,7,850,405,445
Kentucky,Lewis County,4,8,887,460,427
Kentucky,Lewis County,4,9,946,475,471
Kentucky,Lewis County,4,10,1073,529,544
Kentucky,Lewis County,4,11,1083,535,548
Kentucky,Lewis County,4,12,1018,512,506
Kentucky,Lewis County,4,13,868,425,443
Kentucky,Lewis County,4,14,698,365,333
Kentucky,Lewis County,4,15,538,260,278
Kentucky,Lewis County,4,16,403,184,219
Kentucky,Lewis County,4,17,244,101,143
Kentucky,Lewis County,4,18,202,73,129
Kentucky,Lewis County,5,0,13839,6878,6961
Kentucky,Lewis County,5,1,819,429,390
Kentucky,Lewis County,5,2,876,431,445
Kentucky,Lewis County,5,3,943,471,472
Kentucky,Lewis County,5,4,846,459,387
Kentucky,Lewis County,5,5,816,427,389
Kentucky,Lewis County,5,6,740,351,389
Kentucky,Lewis County,5,7,816,376,440
Kentucky,Lewis County,5,8,888,453,435
Kentucky,Lewis County,5,9,938,477,461
Kentucky,Lewis County,5,10,997,501,496
Kentucky,Lewis County,5,11,1092,530,562
Kentucky,Lewis County,5,12,1037,531,506
Kentucky,Lewis County,5,13,867,412,455
Kentucky,Lewis County,5,14,731,388,343
Kentucky,Lewis County,5,15,566,274,292
Kentucky,Lewis County,5,16,413,193,220
Kentucky,Lewis County,5,17,247,99,148
Kentucky,Lewis County,5,18,207,76,131
Kentucky,Lewis County,6,0,13751,6833,6918
Kentucky,Lewis County,6,1,823,428,395
Kentucky,Lewis County,6,2,880,447,433
Kentucky,Lewis County,6,3,880,440,440
Kentucky,Lewis County,6,4,845,437,408
Kentucky,Lewis County,6,5,812,434,378
Kentucky,Lewis County,6,6,727,353,374
Kentucky,Lewis County,6,7,789,352,437
Kentucky,Lewis County,6,8,850,433,417
Kentucky,Lewis County,6,9,930,485,445
Kentucky,Lewis County,6,10,961,481,480
Kentucky,Lewis County,6,11,1101,529,572
Kentucky,Lewis County,6,12,1045,529,516
Kentucky,Lewis County,6,13,888,427,461
Kentucky,Lewis County,6,14,740,377,363
Kentucky,Lewis County,6,15,606,306,300
Kentucky,Lewis County,6,16,425,196,229
Kentucky,Lewis County,6,17,245,98,147
Kentucky,Lewis County,6,18,204,81,123
Kentucky,Lewis County,7,0,13830,6893,6937
Kentucky,Lewis County,7,1,805,411,394
Kentucky,Lewis County,7,2,894,452,442
Kentucky,Lewis County,7,3,881,446,435
Kentucky,Lewis County,7,4,836,424,412
Kentucky,Lewis County,7,5,810,434,376
Kentucky,Lewis County,7,6,789,396,393
Kentucky,Lewis County,7,7,764,349,415
Kentucky,Lewis County,7,8,848,430,418
Kentucky,Lewis County,7,9,914,475,439
Kentucky,Lewis County,7,10,966,493,473
Kentucky,Lewis County,7,11,1082,508,574
Kentucky,Lewis County,7,12,1072,546,526
Kentucky,Lewis County,7,13,880,428,452
Kentucky,Lewis County,7,14,759,381,378
Kentucky,Lewis County,7,15,619,318,301
Kentucky,Lewis County,7,16,422,195,227
Kentucky,Lewis County,7,17,268,114,154
Kentucky,Lewis County,7,18,221,93,128
Kentucky,Lewis County,8,0,13663,6812,6851
Kentucky,Lewis County,8,1,809,402,407
Kentucky,Lewis County,8,2,857,445,412
Kentucky,Lewis County,8,3,874,432,442
Kentucky,Lewis County,8,4,820,431,389
Kentucky,Lewis County,8,5,795,426,369
Kentucky,Lewis County,8,6,783,395,388
Kentucky,Lewis County,8,7,727,328,399
Kentucky,Lewis County,8,8,841,423,418
Kentucky,Lewis County,8,9,876,464,412
Kentucky,Lewis County,8,10,933,474,459
Kentucky,Lewis County,8,11,1078,505,573
Kentucky,Lewis County,8,12,1030,528,502
Kentucky,Lewis County,8,13,910,431,479
Kentucky,Lewis County,8,14,789,396,393
Kentucky,Lewis County,8,15,600,312,288
Kentucky,Lewis County,8,16,424,202,222
Kentucky,Lewis County,8,17,289,132,157
Kentucky,Lewis County,8,18,228,86,142
Kentucky,Lewis County,9,0,13516,6724,6792
Kentucky,Lewis County,9,1,787,388,399
Kentucky,Lewis County,9,2,825,434,391
Kentucky,Lewis County,9,3,839,404,435
Kentucky,Lewis County,9,4,805,424,381
Kentucky,Lewis County,9,5,761,400,361
Kentucky,Lewis County,9,6,825,427,398
Kentucky,Lewis County,9,7,703,329,374
Kentucky,Lewis County,9,8,812,391,421
Kentucky,Lewis County,9,9,880,465,415
Kentucky,Lewis County,9,10,902,456,446
Kentucky,Lewis County,9,11,1019,483,536
Kentucky,Lewis County,9,12,1048,519,529
Kentucky,Lewis County,9,13,952,465,487
Kentucky,Lewis County,9,14,796,395,401
Kentucky,Lewis County,9,15,597,315,282
Kentucky,Lewis County,9,16,436,207,229
Kentucky,Lewis County,9,17,308,144,164
Kentucky,Lewis County,9,18,221,78,143
Kentucky,Lewis County,10,0,13363,6652,6711
Kentucky,Lewis County,10,1,779,387,392
Kentucky,Lewis County,10,2,786,409,377
Kentucky,Lewis County,10,3,888,443,445
Kentucky,Lewis County,10,4,794,410,384
Kentucky,Lewis County,10,5,712,380,332
Kentucky,Lewis County,10,6,814,429,385
Kentucky,Lewis County,10,7,717,331,386
Kentucky,Lewis County,10,8,770,369,401
Kentucky,Lewis County,10,9,877,453,424
Kentucky,Lewis County,10,10,868,441,427
Kentucky,Lewis County,10,11,960,474,486
Kentucky,Lewis County,10,12,1026,490,536
Kentucky,Lewis County,10,13,986,497,489
Kentucky,Lewis County,10,14,789,383,406
Kentucky,Lewis County,10,15,610,329,281
Kentucky,Lewis County,10,16,454,207,247
Kentucky,Lewis County,10,17,300,135,165
Kentucky,Lewis County,10,18,233,85,148
Kentucky,Lewis County,11,0,13268,6627,6641
Kentucky,Lewis County,11,1,746,380,366
Kentucky,Lewis County,11,2,811,421,390
Kentucky,Lewis County,11,3,854,435,419
Kentucky,Lewis County,11,4,764,393,371
Kentucky,Lewis County,11,5,710,368,342
Kentucky,Lewis County,11,6,851,454,397
Kentucky,Lewis County,11,7,692,337,355
Kentucky,Lewis County,11,8,765,352,413
Kentucky,Lewis County,11,9,837,430,407
Kentucky,Lewis County,11,10,869,453,416
Kentucky,Lewis County,11,11,902,456,446
Kentucky,Lewis County,11,12,1049,490,559
Kentucky,Lewis County,11,13,996,497,499
Kentucky,Lewis County,11,14,809,384,425
Kentucky,Lewis County,11,15,613,322,291
Kentucky,Lewis County,11,16,469,225,244
Kentucky,Lewis County,11,17,302,141,161
Kentucky,Lewis County,11,18,229,89,140
Kentucky,Lewis County,12,0,13275,6621,6654
Kentucky,Lewis County,12,1,783,398,385
Kentucky,Lewis County,12,2,787,407,380
Kentucky,Lewis County,12,3,844,436,408
Kentucky,Lewis County,12,4,773,389,384
Kentucky,Lewis County,12,5,728,375,353
Kentucky,Lewis County,12,6,830,439,391
Kentucky,Lewis County,12,7,715,371,344
Kentucky,Lewis County,12,8,742,332,410
Kentucky,Lewis County,12,9,814,407,407
Kentucky,Lewis County,12,10,875,460,415
Kentucky,Lewis County,12,11,876,451,425
Kentucky,Lewis County,12,12,1041,483,558
Kentucky,Lewis County,12,13,1010,498,512
Kentucky,Lewis County,12,14,810,376,434
Kentucky,Lewis County,12,15,650,333,317
Kentucky,Lewis County,12,16,462,228,234
Kentucky,Lewis County,12,17,293,142,151
Kentucky,Lewis County,12,18,242,96,146
Kentucky,Lincoln County,1,0,24742,12218,12524
Kentucky,Lincoln County,1,1,1629,890,739
Kentucky,Lincoln County,1,2,1689,887,802
Kentucky,Lincoln County,1,3,1713,862,851
Kentucky,Lincoln County,1,4,1661,858,803
Kentucky,Lincoln County,1,5,1337,696,641
Kentucky,Lincoln County,1,6,1351,667,684
Kentucky,Lincoln County,1,7,1524,748,776
Kentucky,Lincoln County,1,8,1683,832,851
Kentucky,Lincoln County,1,9,1763,857,906
Kentucky,Lincoln County,1,10,1872,948,924
Kentucky,Lincoln County,1,11,1770,893,877
Kentucky,Lincoln County,1,12,1610,786,824
Kentucky,Lincoln County,1,13,1460,686,774
Kentucky,Lincoln County,1,14,1173,566,607
Kentucky,Lincoln County,1,15,985,442,543
Kentucky,Lincoln County,1,16,645,280,365
Kentucky,Lincoln County,1,17,456,179,277
Kentucky,Lincoln County,1,18,421,141,280
Kentucky,Lincoln County,2,0,24736,12211,12525
Kentucky,Lincoln County,2,1,1632,891,741
Kentucky,Lincoln County,2,2,1690,887,803
Kentucky,Lincoln County,2,3,1718,865,853
Kentucky,Lincoln County,2,4,1660,856,804
Kentucky,Lincoln County,2,5,1338,695,643
Kentucky,Lincoln County,2,6,1349,666,683
Kentucky,Lincoln County,2,7,1525,747,778
Kentucky,Lincoln County,2,8,1683,833,850
Kentucky,Lincoln County,2,9,1764,858,906
Kentucky,Lincoln County,2,10,1870,948,922
Kentucky,Lincoln County,2,11,1764,890,874
Kentucky,Lincoln County,2,12,1605,783,822
Kentucky,Lincoln County,2,13,1458,684,774
Kentucky,Lincoln County,2,14,1175,567,608
Kentucky,Lincoln County,2,15,985,442,543
Kentucky,Lincoln County,2,16,643,279,364
Kentucky,Lincoln County,2,17,456,179,277
Kentucky,Lincoln County,2,18,421,141,280
Kentucky,Lincoln County,3,0,24724,12212,12512
Kentucky,Lincoln County,3,1,1630,891,739
Kentucky,Lincoln County,3,2,1674,881,793
Kentucky,Lincoln County,3,3,1714,863,851
Kentucky,Lincoln County,3,4,1639,843,796
Kentucky,Lincoln County,3,5,1359,709,650
Kentucky,Lincoln County,3,6,1357,671,686
Kentucky,Lincoln County,3,7,1519,746,773
Kentucky,Lincoln County,3,8,1651,820,831
Kentucky,Lincoln County,3,9,1764,855,909
Kentucky,Lincoln County,3,10,1879,953,926
Kentucky,Lincoln County,3,11,1766,894,872
Kentucky,Lincoln County,3,12,1609,781,828
Kentucky,Lincoln County,3,13,1474,693,781
Kentucky,Lincoln County,3,14,1178,563,615
Kentucky,Lincoln County,3,15,989,448,541
Kentucky,Lincoln County,3,16,643,279,364
Kentucky,Lincoln County,3,17,462,182,280
Kentucky,Lincoln County,3,18,417,140,277
Kentucky,Lincoln County,4,0,24721,12172,12549
Kentucky,Lincoln County,4,1,1587,840,747
Kentucky,Lincoln County,4,2,1655,854,801
Kentucky,Lincoln County,4,3,1730,877,853
Kentucky,Lincoln County,4,4,1609,833,776
Kentucky,Lincoln County,4,5,1396,730,666
Kentucky,Lincoln County,4,6,1363,675,688
Kentucky,Lincoln County,4,7,1489,725,764
Kentucky,Lincoln County,4,8,1537,758,779
Kentucky,Lincoln County,4,9,1760,847,913
Kentucky,Lincoln County,4,10,1871,944,927
Kentucky,Lincoln County,4,11,1760,909,851
Kentucky,Lincoln County,4,12,1610,776,834
Kentucky,Lincoln County,4,13,1574,738,836
Kentucky,Lincoln County,4,14,1209,563,646
Kentucky,Lincoln County,4,15,1007,472,535
Kentucky,Lincoln County,4,16,655,283,372
Kentucky,Lincoln County,4,17,494,210,284
Kentucky,Lincoln County,4,18,415,138,277
Kentucky,Lincoln County,5,0,24404,12038,12366
Kentucky,Lincoln County,5,1,1532,788,744
Kentucky,Lincoln County,5,2,1583,829,754
Kentucky,Lincoln County,5,3,1709,884,825
Kentucky,Lincoln County,5,4,1546,796,750
Kentucky,Lincoln County,5,5,1385,730,655
Kentucky,Lincoln County,5,6,1368,690,678
Kentucky,Lincoln County,5,7,1424,700,724
Kentucky,Lincoln County,5,8,1511,734,777
Kentucky,Lincoln County,5,9,1712,834,878
Kentucky,Lincoln County,5,10,1804,898,906
Kentucky,Lincoln County,5,11,1762,910,852
Kentucky,Lincoln County,5,12,1593,772,821
Kentucky,Lincoln County,5,13,1575,763,812
Kentucky,Lincoln County,5,14,1273,587,686
Kentucky,Lincoln County,5,15,1002,469,533
Kentucky,Lincoln County,5,16,701,304,397
Kentucky,Lincoln County,5,17,493,208,285
Kentucky,Lincoln County,5,18,431,142,289
Kentucky,Lincoln County,6,0,24438,12045,12393
Kentucky,Lincoln County,6,1,1559,820,739
Kentucky,Lincoln County,6,2,1596,836,760
Kentucky,Lincoln County,6,3,1658,850,808
Kentucky,Lincoln County,6,4,1558,796,762
Kentucky,Lincoln County,6,5,1377,728,649
Kentucky,Lincoln County,6,6,1363,683,680
Kentucky,Lincoln County,6,7,1422,684,738
Kentucky,Lincoln County,6,8,1483,732,751
Kentucky,Lincoln County,6,9,1679,823,856
Kentucky,Lincoln County,6,10,1786,886,900
Kentucky,Lincoln County,6,11,1755,880,875
Kentucky,Lincoln County,6,12,1653,818,835
Kentucky,Lincoln County,6,13,1596,777,819
Kentucky,Lincoln County,6,14,1265,572,693
Kentucky,Lincoln County,6,15,1031,479,552
Kentucky,Lincoln County,6,16,747,339,408
Kentucky,Lincoln County,6,17,479,196,283
Kentucky,Lincoln County,6,18,431,146,285
Kentucky,Lincoln County,7,0,24429,12043,12386
Kentucky,Lincoln County,7,1,1545,812,733
Kentucky,Lincoln County,7,2,1612,849,763
Kentucky,Lincoln County,7,3,1636,839,797
Kentucky,Lincoln County,7,4,1546,795,751
Kentucky,Lincoln County,7,5,1386,721,665
Kentucky,Lincoln County,7,6,1368,679,689
Kentucky,Lincoln County,7,7,1403,678,725
Kentucky,Lincoln County,7,8,1461,715,746
Kentucky,Lincoln County,7,9,1618,783,835
Kentucky,Lincoln County,7,10,1735,852,883
Kentucky,Lincoln County,7,11,1807,927,880
Kentucky,Lincoln County,7,12,1657,820,837
Kentucky,Lincoln County,7,13,1580,757,823
Kentucky,Lincoln County,7,14,1311,611,700
Kentucky,Lincoln County,7,15,1058,495,563
Kentucky,Lincoln County,7,16,786,345,441
Kentucky,Lincoln County,7,17,495,212,283
Kentucky,Lincoln County,7,18,425,153,272
Kentucky,Lincoln County,8,0,24342,11942,12400
Kentucky,Lincoln County,8,1,1576,816,760
Kentucky,Lincoln County,8,2,1585,836,749
Kentucky,Lincoln County,8,3,1608,831,777
Kentucky,Lincoln County,8,4,1470,735,735
Kentucky,Lincoln County,8,5,1348,693,655
Kentucky,Lincoln County,8,6,1433,715,718
Kentucky,Lincoln County,8,7,1367,683,684
Kentucky,Lincoln County,8,8,1436,684,752
Kentucky,Lincoln County,8,9,1570,777,793
Kentucky,Lincoln County,8,10,1676,794,882
Kentucky,Lincoln County,8,11,1831,942,889
Kentucky,Lincoln County,8,12,1669,814,855
Kentucky,Lincoln County,8,13,1584,774,810
Kentucky,Lincoln County,8,14,1357,608,749
Kentucky,Lincoln County,8,15,1059,508,551
Kentucky,Lincoln County,8,16,828,358,470
Kentucky,Lincoln County,8,17,482,210,272
Kentucky,Lincoln County,8,18,463,164,299
Kentucky,Lincoln County,9,0,24382,12007,12375
Kentucky,Lincoln County,9,1,1577,834,743
Kentucky,Lincoln County,9,2,1531,811,720
Kentucky,Lincoln County,9,3,1627,837,790
Kentucky,Lincoln County,9,4,1487,756,731
Kentucky,Lincoln County,9,5,1340,686,654
Kentucky,Lincoln County,9,6,1442,726,716
Kentucky,Lincoln County,9,7,1359,685,674
Kentucky,Lincoln County,9,8,1470,700,770
Kentucky,Lincoln County,9,9,1479,729,750
Kentucky,Lincoln County,9,10,1694,805,889
Kentucky,Lincoln County,9,11,1828,922,906
Kentucky,Lincoln County,9,12,1662,837,825
Kentucky,Lincoln County,9,13,1601,763,838
Kentucky,Lincoln County,9,14,1428,661,767
Kentucky,Lincoln County,9,15,1087,505,582
Kentucky,Lincoln County,9,16,790,363,427
Kentucky,Lincoln County,9,17,493,201,292
Kentucky,Lincoln County,9,18,487,186,301
Kentucky,Lincoln County,10,0,24495,12028,12467
Kentucky,Lincoln County,10,1,1609,854,755
Kentucky,Lincoln County,10,2,1547,796,751
Kentucky,Lincoln County,10,3,1631,855,776
Kentucky,Lincoln County,10,4,1475,756,719
Kentucky,Lincoln County,10,5,1329,672,657
Kentucky,Lincoln County,10,6,1558,780,778
Kentucky,Lincoln County,10,7,1342,658,684
Kentucky,Lincoln County,10,8,1400,684,716
Kentucky,Lincoln County,10,9,1440,704,736
Kentucky,Lincoln County,10,10,1698,806,892
Kentucky,Lincoln County,10,11,1776,884,892
Kentucky,Lincoln County,10,12,1700,859,841
Kentucky,Lincoln County,10,13,1600,757,843
Kentucky,Lincoln County,10,14,1467,702,765
Kentucky,Lincoln County,10,15,1135,509,626
Kentucky,Lincoln County,10,16,795,368,427
Kentucky,Lincoln County,10,17,506,205,301
Kentucky,Lincoln County,10,18,487,179,308
Kentucky,Lincoln County,11,0,24612,12073,12539
Kentucky,Lincoln County,11,1,1643,862,781
Kentucky,Lincoln County,11,2,1574,785,789
Kentucky,Lincoln County,11,3,1632,851,781
Kentucky,Lincoln County,11,4,1484,766,718
Kentucky,Lincoln County,11,5,1313,669,644
Kentucky,Lincoln County,11,6,1569,778,791
Kentucky,Lincoln County,11,7,1341,674,667
Kentucky,Lincoln County,11,8,1368,658,710
Kentucky,Lincoln County,11,9,1415,703,712
Kentucky,Lincoln County,11,10,1660,807,853
Kentucky,Lincoln County,11,11,1771,884,887
Kentucky,Lincoln County,11,12,1718,848,870
Kentucky,Lincoln County,11,13,1631,801,830
Kentucky,Lincoln County,11,14,1492,707,785
Kentucky,Lincoln County,11,15,1123,496,627
Kentucky,Lincoln County,11,16,851,384,467
Kentucky,Lincoln County,11,17,554,233,321
Kentucky,Lincoln County,11,18,473,167,306
Kentucky,Lincoln County,12,0,24549,12038,12511
Kentucky,Lincoln County,12,1,1622,853,769
Kentucky,Lincoln County,12,2,1594,802,792
Kentucky,Lincoln County,12,3,1650,876,774
Kentucky,Lincoln County,12,4,1446,728,718
Kentucky,Lincoln County,12,5,1312,667,645
Kentucky,Lincoln County,12,6,1528,761,767
Kentucky,Lincoln County,12,7,1348,699,649
Kentucky,Lincoln County,12,8,1321,623,698
Kentucky,Lincoln County,12,9,1407,704,703
Kentucky,Lincoln County,12,10,1615,771,844
Kentucky,Lincoln County,12,11,1735,852,883
Kentucky,Lincoln County,12,12,1755,878,877
Kentucky,Lincoln County,12,13,1600,779,821
Kentucky,Lincoln County,12,14,1490,706,784
Kentucky,Lincoln County,12,15,1192,527,665
Kentucky,Lincoln County,12,16,881,395,486
Kentucky,Lincoln County,12,17,573,236,337
Kentucky,Lincoln County,12,18,480,181,299
Kentucky,Livingston County,1,0,9519,4666,4853
Kentucky,Livingston County,1,1,538,285,253
Kentucky,Livingston County,1,2,524,264,260
Kentucky,Livingston County,1,3,548,251,297
Kentucky,Livingston County,1,4,562,286,276
Kentucky,Livingston County,1,5,484,244,240
Kentucky,Livingston County,1,6,428,195,233
Kentucky,Livingston County,1,7,525,268,257
Kentucky,Livingston County,1,8,540,263,277
Kentucky,Livingston County,1,9,624,322,302
Kentucky,Livingston County,1,10,736,339,397
Kentucky,Livingston County,1,11,794,400,394
Kentucky,Livingston County,1,12,756,395,361
Kentucky,Livingston County,1,13,735,366,369
Kentucky,Livingston County,1,14,619,311,308
Kentucky,Livingston County,1,15,407,199,208
Kentucky,Livingston County,1,16,312,133,179
Kentucky,Livingston County,1,17,210,89,121
Kentucky,Livingston County,1,18,177,56,121
Kentucky,Livingston County,2,0,9519,4666,4853
Kentucky,Livingston County,2,1,538,285,253
Kentucky,Livingston County,2,2,524,264,260
Kentucky,Livingston County,2,3,548,251,297
Kentucky,Livingston County,2,4,562,286,276
Kentucky,Livingston County,2,5,484,244,240
Kentucky,Livingston County,2,6,428,195,233
Kentucky,Livingston County,2,7,525,268,257
Kentucky,Livingston County,2,8,540,263,277
Kentucky,Livingston County,2,9,624,322,302
Kentucky,Livingston County,2,10,736,339,397
Kentucky,Livingston County,2,11,794,400,394
Kentucky,Livingston County,2,12,756,395,361
Kentucky,Livingston County,2,13,735,366,369
Kentucky,Livingston County,2,14,619,311,308
Kentucky,Livingston County,2,15,407,199,208
Kentucky,Livingston County,2,16,312,133,179
Kentucky,Livingston County,2,17,210,89,121
Kentucky,Livingston County,2,18,177,56,121
Kentucky,Livingston County,3,0,9520,4659,4861
Kentucky,Livingston County,3,1,539,279,260
Kentucky,Livingston County,3,2,523,265,258
Kentucky,Livingston County,3,3,552,254,298
Kentucky,Livingston County,3,4,553,280,273
Kentucky,Livingston County,3,5,492,248,244
Kentucky,Livingston County,3,6,428,197,231
Kentucky,Livingston County,3,7,532,266,266
Kentucky,Livingston County,3,8,537,267,270
Kentucky,Livingston County,3,9,622,320,302
Kentucky,Livingston County,3,10,733,340,393
Kentucky,Livingston County,3,11,800,397,403
Kentucky,Livingston County,3,12,758,394,364
Kentucky,Livingston County,3,13,737,370,367
Kentucky,Livingston County,3,14,611,305,306
Kentucky,Livingston County,3,15,407,200,207
Kentucky,Livingston County,3,16,315,135,180
Kentucky,Livingston County,3,17,204,86,118
Kentucky,Livingston County,3,18,177,56,121
Kentucky,Livingston County,4,0,9502,4642,4860
Kentucky,Livingston County,4,1,541,280,261
Kentucky,Livingston County,4,2,536,267,269
Kentucky,Livingston County,4,3,552,259,293
Kentucky,Livingston County,4,4,513,240,273
Kentucky,Livingston County,4,5,501,248,253
Kentucky,Livingston County,4,6,435,223,212
Kentucky,Livingston County,4,7,537,260,277
Kentucky,Livingston County,4,8,522,264,258
Kentucky,Livingston County,4,9,603,299,304
Kentucky,Livingston County,4,10,723,351,372
Kentucky,Livingston County,4,11,785,374,411
Kentucky,Livingston County,4,12,771,392,379
Kentucky,Livingston County,4,13,743,379,364
Kentucky,Livingston County,4,14,607,301,306
Kentucky,Livingston County,4,15,430,221,209
Kentucky,Livingston County,4,16,329,146,183
Kentucky,Livingston County,4,17,203,86,117
Kentucky,Livingston County,4,18,171,52,119
Kentucky,Livingston County,5,0,9435,4612,4823
Kentucky,Livingston County,5,1,515,263,252
Kentucky,Livingston County,5,2,549,271,278
Kentucky,Livingston County,5,3,549,265,284
Kentucky,Livingston County,5,4,504,235,269
Kentucky,Livingston County,5,5,508,251,257
Kentucky,Livingston County,5,6,449,230,219
Kentucky,Livingston County,5,7,505,247,258
Kentucky,Livingston County,5,8,500,250,250
Kentucky,Livingston County,5,9,588,285,303
Kentucky,Livingston County,5,10,725,368,357
Kentucky,Livingston County,5,11,763,361,402
Kentucky,Livingston County,5,12,779,387,392
Kentucky,Livingston County,5,13,706,365,341
Kentucky,Livingston County,5,14,635,309,326
Kentucky,Livingston County,5,15,460,231,229
Kentucky,Livingston County,5,16,320,154,166
Kentucky,Livingston County,5,17,209,81,128
Kentucky,Livingston County,5,18,171,59,112
Kentucky,Livingston County,6,0,9332,4568,4764
Kentucky,Livingston County,6,1,524,279,245
Kentucky,Livingston County,6,2,539,260,279
Kentucky,Livingston County,6,3,502,243,259
Kentucky,Livingston County,6,4,482,224,258
Kentucky,Livingston County,6,5,520,252,268
Kentucky,Livingston County,6,6,465,230,235
Kentucky,Livingston County,6,7,484,244,240
Kentucky,Livingston County,6,8,497,248,249
Kentucky,Livingston County,6,9,569,281,288
Kentucky,Livingston County,6,10,667,323,344
Kentucky,Livingston County,6,11,759,366,393
Kentucky,Livingston County,6,12,798,401,397
Kentucky,Livingston County,6,13,704,367,337
Kentucky,Livingston County,6,14,621,298,323
Kentucky,Livingston County,6,15,493,248,245
Kentucky,Livingston County,6,16,327,168,159
Kentucky,Livingston County,6,17,208,75,133
Kentucky,Livingston County,6,18,173,61,112
Kentucky,Livingston County,7,0,9329,4587,4742
Kentucky,Livingston County,7,1,539,289,250
Kentucky,Livingston County,7,2,533,274,259
Kentucky,Livingston County,7,3,528,247,281
Kentucky,Livingston County,7,4,479,227,252
Kentucky,Livingston County,7,5,516,256,260
Kentucky,Livingston County,7,6,464,229,235
Kentucky,Livingston County,7,7,456,215,241
Kentucky,Livingston County,7,8,527,279,248
Kentucky,Livingston County,7,9,536,269,267
Kentucky,Livingston County,7,10,655,326,329
Kentucky,Livingston County,7,11,761,360,401
Kentucky,Livingston County,7,12,792,386,406
Kentucky,Livingston County,7,13,703,380,323
Kentucky,Livingston County,7,14,634,303,331
Kentucky,Livingston County,7,15,498,242,256
Kentucky,Livingston County,7,16,326,172,154
Kentucky,Livingston County,7,17,212,78,134
Kentucky,Livingston County,7,18,170,55,115
Kentucky,Livingston County,8,0,9289,4575,4714
Kentucky,Livingston County,8,1,517,285,232
Kentucky,Livingston County,8,2,555,290,265
Kentucky,Livingston County,8,3,511,243,268
Kentucky,Livingston County,8,4,493,239,254
Kentucky,Livingston County,8,5,478,228,250
Kentucky,Livingston County,8,6,507,249,258
Kentucky,Livingston County,8,7,435,212,223
Kentucky,Livingston County,8,8,507,261,246
Kentucky,Livingston County,8,9,536,271,265
Kentucky,Livingston County,8,10,627,314,313
Kentucky,Livingston County,8,11,754,355,399
Kentucky,Livingston County,8,12,744,368,376
Kentucky,Livingston County,8,13,727,383,344
Kentucky,Livingston County,8,14,651,325,326
Kentucky,Livingston County,8,15,511,245,266
Kentucky,Livingston County,8,16,335,167,168
Kentucky,Livingston County,8,17,216,81,135
Kentucky,Livingston County,8,18,185,59,126
Kentucky,Livingston County,9,0,9198,4519,4679
Kentucky,Livingston County,9,1,505,270,235
Kentucky,Livingston County,9,2,523,294,229
Kentucky,Livingston County,9,3,522,252,270
Kentucky,Livingston County,9,4,476,236,240
Kentucky,Livingston County,9,5,460,220,240
Kentucky,Livingston County,9,6,521,261,260
Kentucky,Livingston County,9,7,417,205,212
Kentucky,Livingston County,9,8,492,249,243
Kentucky,Livingston County,9,9,517,252,265
Kentucky,Livingston County,9,10,614,307,307
Kentucky,Livingston County,9,11,719,332,387
Kentucky,Livingston County,9,12,749,362,387
Kentucky,Livingston County,9,13,746,384,362
Kentucky,Livingston County,9,14,669,337,332
Kentucky,Livingston County,9,15,500,234,266
Kentucky,Livingston County,9,16,359,184,175
Kentucky,Livingston County,9,17,227,92,135
Kentucky,Livingston County,9,18,182,48,134
Kentucky,Livingston County,10,0,9249,4509,4740
Kentucky,Livingston County,10,1,520,275,245
Kentucky,Livingston County,10,2,523,268,255
Kentucky,Livingston County,10,3,537,268,269
Kentucky,Livingston County,10,4,484,243,241
Kentucky,Livingston County,10,5,445,206,239
Kentucky,Livingston County,10,6,529,268,261
Kentucky,Livingston County,10,7,430,220,210
Kentucky,Livingston County,10,8,488,243,245
Kentucky,Livingston County,10,9,483,237,246
Kentucky,Livingston County,10,10,631,297,334
Kentucky,Livingston County,10,11,707,346,361
Kentucky,Livingston County,10,12,734,350,384
Kentucky,Livingston County,10,13,758,377,381
Kentucky,Livingston County,10,14,637,322,315
Kentucky,Livingston County,10,15,546,250,296
Kentucky,Livingston County,10,16,379,185,194
Kentucky,Livingston County,10,17,221,97,124
Kentucky,Livingston County,10,18,197,57,140
Kentucky,Livingston County,11,0,9244,4539,4705
Kentucky,Livingston County,11,1,517,279,238
Kentucky,Livingston County,11,2,507,274,233
Kentucky,Livingston County,11,3,556,282,274
Kentucky,Livingston County,11,4,477,225,252
Kentucky,Livingston County,11,5,451,219,232
Kentucky,Livingston County,11,6,531,268,263
Kentucky,Livingston County,11,7,452,239,213
Kentucky,Livingston County,11,8,468,231,237
Kentucky,Livingston County,11,9,499,241,258
Kentucky,Livingston County,11,10,592,292,300
Kentucky,Livingston County,11,11,677,332,345
Kentucky,Livingston County,11,12,739,354,385
Kentucky,Livingston County,11,13,773,381,392
Kentucky,Livingston County,11,14,628,312,316
Kentucky,Livingston County,11,15,543,255,288
Kentucky,Livingston County,11,16,391,181,210
Kentucky,Livingston County,11,17,230,108,122
Kentucky,Livingston County,11,18,213,66,147
Kentucky,Livingston County,12,0,9194,4516,4678
Kentucky,Livingston County,12,1,499,262,237
Kentucky,Livingston County,12,2,512,284,228
Kentucky,Livingston County,12,3,556,278,278
Kentucky,Livingston County,12,4,461,223,238
Kentucky,Livingston County,12,5,443,233,210
Kentucky,Livingston County,12,6,514,248,266
Kentucky,Livingston County,12,7,454,226,228
Kentucky,Livingston County,12,8,440,215,225
Kentucky,Livingston County,12,9,526,270,256
Kentucky,Livingston County,12,10,546,269,277
Kentucky,Livingston County,12,11,684,335,349
Kentucky,Livingston County,12,12,755,361,394
Kentucky,Livingston County,12,13,736,353,383
Kentucky,Livingston County,12,14,638,321,317
Kentucky,Livingston County,12,15,578,274,304
Kentucky,Livingston County,12,16,400,179,221
Kentucky,Livingston County,12,17,236,117,119
Kentucky,Livingston County,12,18,216,68,148
Kentucky,Logan County,1,0,26835,13130,13705
Kentucky,Logan County,1,1,1711,883,828
Kentucky,Logan County,1,2,1802,892,910
Kentucky,Logan County,1,3,1905,939,966
Kentucky,Logan County,1,4,1792,924,868
Kentucky,Logan County,1,5,1366,674,692
Kentucky,Logan County,1,6,1662,814,848
Kentucky,Logan County,1,7,1527,776,751
Kentucky,Logan County,1,8,1591,818,773
Kentucky,Logan County,1,9,1744,854,890
Kentucky,Logan County,1,10,2065,1022,1043
Kentucky,Logan County,1,11,2001,1012,989
Kentucky,Logan County,1,12,1820,870,950
Kentucky,Logan County,1,13,1647,794,853
Kentucky,Logan County,1,14,1405,673,732
Kentucky,Logan County,1,15,1043,483,560
Kentucky,Logan County,1,16,766,336,430
Kentucky,Logan County,1,17,525,229,296
Kentucky,Logan County,1,18,463,137,326
Kentucky,Logan County,2,0,26832,13128,13704
Kentucky,Logan County,2,1,1711,883,828
Kentucky,Logan County,2,2,1802,892,910
Kentucky,Logan County,2,3,1905,939,966
Kentucky,Logan County,2,4,1792,924,868
Kentucky,Logan County,2,5,1365,673,692
Kentucky,Logan County,2,6,1662,814,848
Kentucky,Logan County,2,7,1527,776,751
Kentucky,Logan County,2,8,1591,818,773
Kentucky,Logan County,2,9,1744,854,890
Kentucky,Logan County,2,10,2065,1022,1043
Kentucky,Logan County,2,11,2000,1012,988
Kentucky,Logan County,2,12,1819,869,950
Kentucky,Logan County,2,13,1647,794,853
Kentucky,Logan County,2,14,1405,673,732
Kentucky,Logan County,2,15,1043,483,560
Kentucky,Logan County,2,16,766,336,430
Kentucky,Logan County,2,17,525,229,296
Kentucky,Logan County,2,18,463,137,326
Kentucky,Logan County,3,0,26851,13140,13711
Kentucky,Logan County,3,1,1695,876,819
Kentucky,Logan County,3,2,1791,881,910
Kentucky,Logan County,3,3,1918,943,975
Kentucky,Logan County,3,4,1789,931,858
Kentucky,Logan County,3,5,1378,677,701
Kentucky,Logan County,3,6,1642,802,840
Kentucky,Logan County,3,7,1535,776,759
Kentucky,Logan County,3,8,1585,812,773
Kentucky,Logan County,3,9,1735,856,879
Kentucky,Logan County,3,10,2066,1021,1045
Kentucky,Logan County,3,11,2005,1021,984
Kentucky,Logan County,3,12,1831,870,961
Kentucky,Logan County,3,13,1656,799,857
Kentucky,Logan County,3,14,1409,676,733
Kentucky,Logan County,3,15,1060,489,571
Kentucky,Logan County,3,16,758,339,419
Kentucky,Logan County,3,17,535,232,303
Kentucky,Logan County,3,18,463,139,324
Kentucky,Logan County,4,0,26847,13106,13741
Kentucky,Logan County,4,1,1657,858,799
Kentucky,Logan County,4,2,1765,865,900
Kentucky,Logan County,4,3,1933,939,994
Kentucky,Logan County,4,4,1714,894,820
Kentucky,Logan County,4,5,1479,732,747
Kentucky,Logan County,4,6,1590,769,821
Kentucky,Logan County,4,7,1567,787,780
Kentucky,Logan County,4,8,1544,780,764
Kentucky,Logan County,4,9,1708,852,856
Kentucky,Logan County,4,10,1983,966,1017
Kentucky,Logan County,4,11,2040,1046,994
Kentucky,Logan County,4,12,1864,870,994
Kentucky,Logan County,4,13,1709,823,886
Kentucky,Logan County,4,14,1398,677,721
Kentucky,Logan County,4,15,1116,516,600
Kentucky,Logan County,4,16,750,348,402
Kentucky,Logan County,4,17,556,235,321
Kentucky,Logan County,4,18,474,149,325
Kentucky,Logan County,5,0,26722,13101,13621
Kentucky,Logan County,5,1,1651,863,788
Kentucky,Logan County,5,2,1747,878,869
Kentucky,Logan County,5,3,1901,933,968
Kentucky,Logan County,5,4,1702,861,841
Kentucky,Logan County,5,5,1494,758,736
Kentucky,Logan County,5,6,1523,748,775
Kentucky,Logan County,5,7,1603,812,791
Kentucky,Logan County,5,8,1525,769,756
Kentucky,Logan County,5,9,1683,842,841
Kentucky,Logan County,5,10,1859,904,955
Kentucky,Logan County,5,11,2081,1077,1004
Kentucky,Logan County,5,12,1829,854,975
Kentucky,Logan County,5,13,1696,822,874
Kentucky,Logan County,5,14,1448,689,759
Kentucky,Logan County,5,15,1155,531,624
Kentucky,Logan County,5,16,792,368,424
Kentucky,Logan County,5,17,549,235,314
Kentucky,Logan County,5,18,484,157,327
Kentucky,Logan County,6,0,26976,13191,13785
Kentucky,Logan County,6,1,1734,877,857
Kentucky,Logan County,6,2,1771,909,862
Kentucky,Logan County,6,3,1896,934,962
Kentucky,Logan County,6,4,1701,853,848
Kentucky,Logan County,6,5,1583,787,796
Kentucky,Logan County,6,6,1511,761,750
Kentucky,Logan County,6,7,1632,810,822
Kentucky,Logan County,6,8,1522,761,761
Kentucky,Logan County,6,9,1652,837,815
Kentucky,Logan County,6,10,1790,875,915
Kentucky,Logan County,6,11,2111,1058,1053
Kentucky,Logan County,6,12,1857,881,976
Kentucky,Logan County,6,13,1684,826,858
Kentucky,Logan County,6,14,1511,705,806
Kentucky,Logan County,6,15,1185,556,629
Kentucky,Logan County,6,16,779,353,426
Kentucky,Logan County,6,17,570,237,333
Kentucky,Logan County,6,18,487,171,316
Kentucky,Logan County,7,0,26812,13088,13724
Kentucky,Logan County,7,1,1741,852,889
Kentucky,Logan County,7,2,1741,899,842
Kentucky,Logan County,7,3,1832,916,916
Kentucky,Logan County,7,4,1698,849,849
Kentucky,Logan County,7,5,1516,770,746
Kentucky,Logan County,7,6,1479,746,733
Kentucky,Logan County,7,7,1648,801,847
Kentucky,Logan County,7,8,1488,731,757
Kentucky,Logan County,7,9,1638,834,804
Kentucky,Logan County,7,10,1763,857,906
Kentucky,Logan County,7,11,2036,1018,1018
Kentucky,Logan County,7,12,1932,947,985
Kentucky,Logan County,7,13,1670,800,870
Kentucky,Logan County,7,14,1523,717,806
Kentucky,Logan County,7,15,1228,582,646
Kentucky,Logan County,7,16,793,354,439
Kentucky,Logan County,7,17,580,246,334
Kentucky,Logan County,7,18,506,169,337
Kentucky,Logan County,8,0,26746,13108,13638
Kentucky,Logan County,8,1,1731,876,855
Kentucky,Logan County,8,2,1689,878,811
Kentucky,Logan County,8,3,1808,919,889
Kentucky,Logan County,8,4,1731,864,867
Kentucky,Logan County,8,5,1513,785,728
Kentucky,Logan County,8,6,1488,752,736
Kentucky,Logan County,8,7,1637,803,834
Kentucky,Logan County,8,8,1516,741,775
Kentucky,Logan County,8,9,1563,784,779
Kentucky,Logan County,8,10,1727,852,875
Kentucky,Logan County,8,11,1984,984,1000
Kentucky,Logan County,8,12,1969,995,974
Kentucky,Logan County,8,13,1699,790,909
Kentucky,Logan County,8,14,1517,709,808
Kentucky,Logan County,8,15,1239,570,669
Kentucky,Logan County,8,16,873,404,469
Kentucky,Logan County,8,17,544,228,316
Kentucky,Logan County,8,18,518,174,344
Kentucky,Logan County,9,0,26678,13109,13569
Kentucky,Logan County,9,1,1752,917,835
Kentucky,Logan County,9,2,1684,869,815
Kentucky,Logan County,9,3,1744,863,881
Kentucky,Logan County,9,4,1722,880,842
Kentucky,Logan County,9,5,1444,749,695
Kentucky,Logan County,9,6,1593,807,786
Kentucky,Logan County,9,7,1585,775,810
Kentucky,Logan County,9,8,1545,752,793
Kentucky,Logan County,9,9,1492,745,747
Kentucky,Logan County,9,10,1697,860,837
Kentucky,Logan County,9,11,1925,937,988
Kentucky,Logan County,9,12,1992,1034,958
Kentucky,Logan County,9,13,1720,788,932
Kentucky,Logan County,9,14,1566,736,830
Kentucky,Logan County,9,15,1215,565,650
Kentucky,Logan County,9,16,906,408,498
Kentucky,Logan County,9,17,543,240,303
Kentucky,Logan County,9,18,553,184,369
Kentucky,Logan County,10,0,27003,13331,13672
Kentucky,Logan County,10,1,1779,970,809
Kentucky,Logan County,10,2,1717,873,844
Kentucky,Logan County,10,3,1793,911,882
Kentucky,Logan County,10,4,1682,842,840
Kentucky,Logan County,10,5,1479,762,717
Kentucky,Logan County,10,6,1674,865,809
Kentucky,Logan County,10,7,1557,762,795
Kentucky,Logan County,10,8,1639,798,841
Kentucky,Logan County,10,9,1488,747,741
Kentucky,Logan County,10,10,1716,889,827
Kentucky,Logan County,10,11,1855,884,971
Kentucky,Logan County,10,12,2021,1045,976
Kentucky,Logan County,10,13,1727,806,921
Kentucky,Logan County,10,14,1530,719,811
Kentucky,Logan County,10,15,1289,592,697
Kentucky,Logan County,10,16,958,426,532
Kentucky,Logan County,10,17,555,253,302
Kentucky,Logan County,10,18,544,187,357
Kentucky,Logan County,11,0,26983,13344,13639
Kentucky,Logan County,11,1,1758,955,803
Kentucky,Logan County,11,2,1771,898,873
Kentucky,Logan County,11,3,1741,887,854
Kentucky,Logan County,11,4,1628,846,782
Kentucky,Logan County,11,5,1475,760,715
Kentucky,Logan County,11,6,1690,846,844
Kentucky,Logan County,11,7,1571,787,784
Kentucky,Logan County,11,8,1658,826,832
Kentucky,Logan County,11,9,1480,725,755
Kentucky,Logan County,11,10,1670,862,808
Kentucky,Logan County,11,11,1796,879,917
Kentucky,Logan County,11,12,2018,1009,1009
Kentucky,Logan County,11,13,1760,824,936
Kentucky,Logan County,11,14,1525,734,791
Kentucky,Logan County,11,15,1345,603,742
Kentucky,Logan County,11,16,1002,460,542
Kentucky,Logan County,11,17,544,247,297
Kentucky,Logan County,11,18,551,196,355
Kentucky,Logan County,12,0,27102,13404,13698
Kentucky,Logan County,12,1,1772,948,824
Kentucky,Logan County,12,2,1795,920,875
Kentucky,Logan County,12,3,1718,876,842
Kentucky,Logan County,12,4,1642,865,777
Kentucky,Logan County,12,5,1507,764,743
Kentucky,Logan County,12,6,1710,869,841
Kentucky,Logan County,12,7,1526,771,755
Kentucky,Logan County,12,8,1680,820,860
Kentucky,Logan County,12,9,1496,731,765
Kentucky,Logan County,12,10,1629,837,792
Kentucky,Logan County,12,11,1772,870,902
Kentucky,Logan County,12,12,1948,957,991
Kentucky,Logan County,12,13,1856,894,962
Kentucky,Logan County,12,14,1535,730,805
Kentucky,Logan County,12,15,1350,602,748
Kentucky,Logan County,12,16,1044,483,561
Kentucky,Logan County,12,17,562,266,296
Kentucky,Logan County,12,18,560,201,359
Kentucky,Lyon County,1,0,8314,4579,3735
Kentucky,Lyon County,1,1,339,178,161
Kentucky,Lyon County,1,2,331,175,156
Kentucky,Lyon County,1,3,372,190,182
Kentucky,Lyon County,1,4,384,183,201
Kentucky,Lyon County,1,5,360,237,123
Kentucky,Lyon County,1,6,436,299,137
Kentucky,Lyon County,1,7,502,347,155
Kentucky,Lyon County,1,8,506,342,164
Kentucky,Lyon County,1,9,558,346,212
Kentucky,Lyon County,1,10,678,375,303
Kentucky,Lyon County,1,11,686,367,319
Kentucky,Lyon County,1,12,713,386,327
Kentucky,Lyon County,1,13,707,347,360
Kentucky,Lyon County,1,14,582,286,296
Kentucky,Lyon County,1,15,466,231,235
Kentucky,Lyon County,1,16,304,150,154
Kentucky,Lyon County,1,17,194,79,115
Kentucky,Lyon County,1,18,196,61,135
Kentucky,Lyon County,2,0,8319,4580,3739
Kentucky,Lyon County,2,1,341,179,162
Kentucky,Lyon County,2,2,332,175,157
Kentucky,Lyon County,2,3,374,190,184
Kentucky,Lyon County,2,4,383,183,200
Kentucky,Lyon County,2,5,360,237,123
Kentucky,Lyon County,2,6,436,299,137
Kentucky,Lyon County,2,7,503,348,155
Kentucky,Lyon County,2,8,507,342,165
Kentucky,Lyon County,2,9,558,346,212
Kentucky,Lyon County,2,10,679,376,303
Kentucky,Lyon County,2,11,687,367,320
Kentucky,Lyon County,2,12,713,386,327
Kentucky,Lyon County,2,13,706,347,359
Kentucky,Lyon County,2,14,580,285,295
Kentucky,Lyon County,2,15,466,231,235
Kentucky,Lyon County,2,16,304,149,155
Kentucky,Lyon County,2,17,194,79,115
Kentucky,Lyon County,2,18,196,61,135
Kentucky,Lyon County,3,0,8329,4585,3744
Kentucky,Lyon County,3,1,338,177,161
Kentucky,Lyon County,3,2,336,174,162
Kentucky,Lyon County,3,3,375,192,183
Kentucky,Lyon County,3,4,373,178,195
Kentucky,Lyon County,3,5,364,236,128
Kentucky,Lyon County,3,6,434,300,134
Kentucky,Lyon County,3,7,513,353,160
Kentucky,Lyon County,3,8,499,341,158
Kentucky,Lyon County,3,9,556,346,210
Kentucky,Lyon County,3,10,674,372,302
Kentucky,Lyon County,3,11,677,367,310
Kentucky,Lyon County,3,12,714,384,330
Kentucky,Lyon County,3,13,719,354,365
Kentucky,Lyon County,3,14,580,280,300
Kentucky,Lyon County,3,15,474,237,237
Kentucky,Lyon County,3,16,308,151,157
Kentucky,Lyon County,3,17,198,82,116
Kentucky,Lyon County,3,18,197,61,136
Kentucky,Lyon County,4,0,8435,4684,3751
Kentucky,Lyon County,4,1,328,166,162
Kentucky,Lyon County,4,2,348,172,176
Kentucky,Lyon County,4,3,387,209,178
Kentucky,Lyon County,4,4,365,170,195
Kentucky,Lyon County,4,5,403,264,139
Kentucky,Lyon County,4,6,442,312,130
Kentucky,Lyon County,4,7,530,369,161
Kentucky,Lyon County,4,8,513,350,163
Kentucky,Lyon County,4,9,578,370,208
Kentucky,Lyon County,4,10,647,369,278
Kentucky,Lyon County,4,11,679,376,303
Kentucky,Lyon County,4,12,704,374,330
Kentucky,Lyon County,4,13,750,369,381
Kentucky,Lyon County,4,14,571,267,304
Kentucky,Lyon County,4,15,484,246,238
Kentucky,Lyon County,4,16,307,154,153
Kentucky,Lyon County,4,17,204,86,118
Kentucky,Lyon County,4,18,195,61,134
Kentucky,Lyon County,5,0,8446,4684,3762
Kentucky,Lyon County,5,1,329,170,159
Kentucky,Lyon County,5,2,337,180,157
Kentucky,Lyon County,5,3,392,208,184
Kentucky,Lyon County,5,4,369,181,188
Kentucky,Lyon County,5,5,409,254,155
Kentucky,Lyon County,5,6,453,333,120
Kentucky,Lyon County,5,7,531,357,174
Kentucky,Lyon County,5,8,476,330,146
Kentucky,Lyon County,5,9,583,373,210
Kentucky,Lyon County,5,10,622,363,259
Kentucky,Lyon County,5,11,684,366,318
Kentucky,Lyon County,5,12,682,356,326
Kentucky,Lyon County,5,13,724,358,366
Kentucky,Lyon County,5,14,595,280,315
Kentucky,Lyon County,5,15,523,262,261
Kentucky,Lyon County,5,16,326,164,162
Kentucky,Lyon County,5,17,217,92,125
Kentucky,Lyon County,5,18,194,57,137
Kentucky,Lyon County,6,0,8452,4697,3755
Kentucky,Lyon County,6,1,315,158,157
Kentucky,Lyon County,6,2,346,198,148
Kentucky,Lyon County,6,3,387,197,190
Kentucky,Lyon County,6,4,370,184,186
Kentucky,Lyon County,6,5,447,278,169
Kentucky,Lyon County,6,6,414,306,108
Kentucky,Lyon County,6,7,506,343,163
Kentucky,Lyon County,6,8,481,338,143
Kentucky,Lyon County,6,9,570,366,204
Kentucky,Lyon County,6,10,595,363,232
Kentucky,Lyon County,6,11,675,357,318
Kentucky,Lyon County,6,12,693,351,342
Kentucky,Lyon County,6,13,702,360,342
Kentucky,Lyon County,6,14,648,300,348
Kentucky,Lyon County,6,15,513,253,260
Kentucky,Lyon County,6,16,372,188,184
Kentucky,Lyon County,6,17,213,93,120
Kentucky,Lyon County,6,18,205,64,141
Kentucky,Lyon County,7,0,8411,4663,3748
Kentucky,Lyon County,7,1,309,159,150
Kentucky,Lyon County,7,2,343,193,150
Kentucky,Lyon County,7,3,362,183,179
Kentucky,Lyon County,7,4,371,189,182
Kentucky,Lyon County,7,5,438,273,165
Kentucky,Lyon County,7,6,455,328,127
Kentucky,Lyon County,7,7,509,349,160
Kentucky,Lyon County,7,8,489,334,155
Kentucky,Lyon County,7,9,541,355,186
Kentucky,Lyon County,7,10,563,337,226
Kentucky,Lyon County,7,11,668,358,310
Kentucky,Lyon County,7,12,682,339,343
Kentucky,Lyon County,7,13,674,339,335
Kentucky,Lyon County,7,14,674,319,355
Kentucky,Lyon County,7,15,513,246,267
Kentucky,Lyon County,7,16,393,195,198
Kentucky,Lyon County,7,17,218,97,121
Kentucky,Lyon County,7,18,209,70,139
Kentucky,Lyon County,8,0,8474,4788,3686
Kentucky,Lyon County,8,1,278,137,141
Kentucky,Lyon County,8,2,332,185,147
Kentucky,Lyon County,8,3,369,195,174
Kentucky,Lyon County,8,4,376,188,188
Kentucky,Lyon County,8,5,444,285,159
Kentucky,Lyon County,8,6,511,377,134
Kentucky,Lyon County,8,7,491,358,133
Kentucky,Lyon County,8,8,508,350,158
Kentucky,Lyon County,8,9,556,371,185
Kentucky,Lyon County,8,10,580,369,211
Kentucky,Lyon County,8,11,656,348,308
Kentucky,Lyon County,8,12,665,332,333
Kentucky,Lyon County,8,13,690,362,328
Kentucky,Lyon County,8,14,689,326,363
Kentucky,Lyon County,8,15,489,239,250
Kentucky,Lyon County,8,16,423,201,222
Kentucky,Lyon County,8,17,199,92,107
Kentucky,Lyon County,8,18,218,73,145
Kentucky,Lyon County,9,0,8238,4589,3649
Kentucky,Lyon County,9,1,257,131,126
Kentucky,Lyon County,9,2,334,190,144
Kentucky,Lyon County,9,3,347,177,170
Kentucky,Lyon County,9,4,379,199,180
Kentucky,Lyon County,9,5,412,257,155
Kentucky,Lyon County,9,6,502,356,146
Kentucky,Lyon County,9,7,440,321,119
Kentucky,Lyon County,9,8,499,325,174
Kentucky,Lyon County,9,9,515,335,180
Kentucky,Lyon County,9,10,565,355,210
Kentucky,Lyon County,9,11,597,318,279
Kentucky,Lyon County,9,12,653,335,318
Kentucky,Lyon County,9,13,667,337,330
Kentucky,Lyon County,9,14,736,350,386
Kentucky,Lyon County,9,15,478,214,264
Kentucky,Lyon County,9,16,427,214,213
Kentucky,Lyon County,9,17,218,105,113
Kentucky,Lyon County,9,18,212,70,142
Kentucky,Lyon County,10,0,8261,4609,3652
Kentucky,Lyon County,10,1,267,135,132
Kentucky,Lyon County,10,2,312,170,142
Kentucky,Lyon County,10,3,376,201,175
Kentucky,Lyon County,10,4,341,183,158
Kentucky,Lyon County,10,5,429,262,167
Kentucky,Lyon County,10,6,515,357,158
Kentucky,Lyon County,10,7,444,332,112
Kentucky,Lyon County,10,8,510,324,186
Kentucky,Lyon County,10,9,500,338,162
Kentucky,Lyon County,10,10,552,345,207
Kentucky,Lyon County,10,11,584,321,263
Kentucky,Lyon County,10,12,638,319,319
Kentucky,Lyon County,10,13,706,352,354
Kentucky,Lyon County,10,14,698,334,364
Kentucky,Lyon County,10,15,518,243,275
Kentucky,Lyon County,10,16,430,215,215
Kentucky,Lyon County,10,17,223,106,117
Kentucky,Lyon County,10,18,218,72,146
Kentucky,Lyon County,11,0,8171,4547,3624
Kentucky,Lyon County,11,1,286,150,136
Kentucky,Lyon County,11,2,296,156,140
Kentucky,Lyon County,11,3,371,205,166
Kentucky,Lyon County,11,4,330,166,164
Kentucky,Lyon County,11,5,416,256,160
Kentucky,Lyon County,11,6,518,366,152
Kentucky,Lyon County,11,7,425,309,116
Kentucky,Lyon County,11,8,469,300,169
Kentucky,Lyon County,11,9,514,335,179
Kentucky,Lyon County,11,10,536,325,211
Kentucky,Lyon County,11,11,564,317,247
Kentucky,Lyon County,11,12,638,319,319
Kentucky,Lyon County,11,13,687,340,347
Kentucky,Lyon County,11,14,678,335,343
Kentucky,Lyon County,11,15,553,265,288
Kentucky,Lyon County,11,16,417,200,217
Kentucky,Lyon County,11,17,253,127,126
Kentucky,Lyon County,11,18,220,76,144
Kentucky,Lyon County,12,0,8210,4600,3610
Kentucky,Lyon County,12,1,258,136,122
Kentucky,Lyon County,12,2,318,167,151
Kentucky,Lyon County,12,3,398,221,177
Kentucky,Lyon County,12,4,327,170,157
Kentucky,Lyon County,12,5,396,255,141
Kentucky,Lyon County,12,6,513,359,154
Kentucky,Lyon County,12,7,476,343,133
Kentucky,Lyon County,12,8,452,294,158
Kentucky,Lyon County,12,9,521,337,184
Kentucky,Lyon County,12,10,535,323,212
Kentucky,Lyon County,12,11,543,308,235
Kentucky,Lyon County,12,12,639,320,319
Kentucky,Lyon County,12,13,696,341,355
Kentucky,Lyon County,12,14,677,344,333
Kentucky,Lyon County,12,15,574,282,292
Kentucky,Lyon County,12,16,409,198,211
Kentucky,Lyon County,12,17,256,120,136
Kentucky,Lyon County,12,18,222,82,140
Kentucky,McCracken County,1,0,65565,31440,34125
Kentucky,McCracken County,1,1,3921,1971,1950
Kentucky,McCracken County,1,2,4160,2149,2011
Kentucky,McCracken County,1,3,4081,2085,1996
Kentucky,McCracken County,1,4,3946,1994,1952
Kentucky,McCracken County,1,5,3353,1644,1709
Kentucky,McCracken County,1,6,3876,1907,1969
Kentucky,McCracken County,1,7,3931,1938,1993
Kentucky,McCracken County,1,8,4013,1984,2029
Kentucky,McCracken County,1,9,4165,2066,2099
Kentucky,McCracken County,1,10,4923,2391,2532
Kentucky,McCracken County,1,11,5079,2477,2602
Kentucky,McCracken County,1,12,4923,2394,2529
Kentucky,McCracken County,1,13,4193,1994,2199
Kentucky,McCracken County,1,14,3363,1503,1860
Kentucky,McCracken County,1,15,2365,1066,1299
Kentucky,McCracken County,1,16,2020,789,1231
Kentucky,McCracken County,1,17,1691,618,1073
Kentucky,McCracken County,1,18,1562,470,1092
Kentucky,McCracken County,2,0,65539,31426,34113
Kentucky,McCracken County,2,1,3920,1970,1950
Kentucky,McCracken County,2,2,4157,2148,2009
Kentucky,McCracken County,2,3,4081,2085,1996
Kentucky,McCracken County,2,4,3942,1991,1951
Kentucky,McCracken County,2,5,3351,1642,1709
Kentucky,McCracken County,2,6,3876,1907,1969
Kentucky,McCracken County,2,7,3931,1938,1993
Kentucky,McCracken County,2,8,4010,1982,2028
Kentucky,McCracken County,2,9,4162,2065,2097
Kentucky,McCracken County,2,10,4920,2390,2530
Kentucky,McCracken County,2,11,5078,2476,2602
Kentucky,McCracken County,2,12,4921,2393,2528
Kentucky,McCracken County,2,13,4190,1994,2196
Kentucky,McCracken County,2,14,3363,1503,1860
Kentucky,McCracken County,2,15,2365,1066,1299
Kentucky,McCracken County,2,16,2020,789,1231
Kentucky,McCracken County,2,17,1690,617,1073
Kentucky,McCracken County,2,18,1562,470,1092
Kentucky,McCracken County,3,0,65515,31431,34084
Kentucky,McCracken County,3,1,3872,1952,1920
Kentucky,McCracken County,3,2,4139,2136,2003
Kentucky,McCracken County,3,3,4084,2085,1999
Kentucky,McCracken County,3,4,3924,2000,1924
Kentucky,McCracken County,3,5,3373,1652,1721
Kentucky,McCracken County,3,6,3884,1918,1966
Kentucky,McCracken County,3,7,3933,1938,1995
Kentucky,McCracken County,3,8,3994,1965,2029
Kentucky,McCracken County,3,9,4153,2067,2086
Kentucky,McCracken County,3,10,4878,2375,2503
Kentucky,McCracken County,3,11,5077,2467,2610
Kentucky,McCracken County,3,12,4926,2395,2531
Kentucky,McCracken County,3,13,4239,2014,2225
Kentucky,McCracken County,3,14,3352,1506,1846
Kentucky,McCracken County,3,15,2396,1081,1315
Kentucky,McCracken County,3,16,2017,785,1232
Kentucky,McCracken County,3,17,1691,613,1078
Kentucky,McCracken County,3,18,1583,482,1101
Kentucky,McCracken County,4,0,65794,31548,34246
Kentucky,McCracken County,4,1,3869,1979,1890
Kentucky,McCracken County,4,2,4116,2099,2017
Kentucky,McCracken County,4,3,4178,2119,2059
Kentucky,McCracken County,4,4,3874,2002,1872
Kentucky,McCracken County,4,5,3425,1667,1758
Kentucky,McCracken County,4,6,3912,1934,1978
Kentucky,McCracken County,4,7,4020,1960,2060
Kentucky,McCracken County,4,8,3983,1943,2040
Kentucky,McCracken County,4,9,4183,2110,2073
Kentucky,McCracken County,4,10,4648,2242,2406
Kentucky,McCracken County,4,11,5080,2436,2644
Kentucky,McCracken County,4,12,4950,2416,2534
Kentucky,McCracken County,4,13,4431,2110,2321
Kentucky,McCracken County,4,14,3326,1520,1806
Kentucky,McCracken County,4,15,2502,1119,1383
Kentucky,McCracken County,4,16,1982,777,1205
Kentucky,McCracken County,4,17,1670,604,1066
Kentucky,McCracken County,4,18,1645,511,1134
Kentucky,McCracken County,5,0,65584,31418,34166
Kentucky,McCracken County,5,1,3854,1977,1877
Kentucky,McCracken County,5,2,4044,2040,2004
Kentucky,McCracken County,5,3,4148,2104,2044
Kentucky,McCracken County,5,4,3733,1936,1797
Kentucky,McCracken County,5,5,3565,1700,1865
Kentucky,McCracken County,5,6,3840,1902,1938
Kentucky,McCracken County,5,7,4030,1958,2072
Kentucky,McCracken County,5,8,3860,1899,1961
Kentucky,McCracken County,5,9,4197,2115,2082
Kentucky,McCracken County,5,10,4478,2153,2325
Kentucky,McCracken County,5,11,4981,2394,2587
Kentucky,McCracken County,5,12,5025,2437,2588
Kentucky,McCracken County,5,13,4403,2119,2284
Kentucky,McCracken County,5,14,3540,1628,1912
Kentucky,McCracken County,5,15,2646,1175,1471
Kentucky,McCracken County,5,16,1956,771,1185
Kentucky,McCracken County,5,17,1591,564,1027
Kentucky,McCracken County,5,18,1693,546,1147
Kentucky,McCracken County,6,0,65337,31302,34035
Kentucky,McCracken County,6,1,3847,1967,1880
Kentucky,McCracken County,6,2,3937,1982,1955
Kentucky,McCracken County,6,3,4104,2082,2022
Kentucky,McCracken County,6,4,3749,1922,1827
Kentucky,McCracken County,6,5,3714,1824,1890
Kentucky,McCracken County,6,6,3707,1815,1892
Kentucky,McCracken County,6,7,4008,1957,2051
Kentucky,McCracken County,6,8,3846,1892,1954
Kentucky,McCracken County,6,9,4127,2042,2085
Kentucky,McCracken County,6,10,4294,2081,2213
Kentucky,McCracken County,6,11,4888,2353,2535
Kentucky,McCracken County,6,12,4984,2437,2547
Kentucky,McCracken County,6,13,4452,2131,2321
Kentucky,McCracken County,6,14,3650,1692,1958
Kentucky,McCracken County,6,15,2814,1232,1582
Kentucky,McCracken County,6,16,1932,789,1143
Kentucky,McCracken County,6,17,1576,560,1016
Kentucky,McCracken County,6,18,1708,544,1164
Kentucky,McCracken County,7,0,65318,31277,34041
Kentucky,McCracken County,7,1,3961,2020,1941
Kentucky,McCracken County,7,2,3909,1961,1948
Kentucky,McCracken County,7,3,4065,2079,1986
Kentucky,McCracken County,7,4,3693,1878,1815
Kentucky,McCracken County,7,5,3782,1862,1920
Kentucky,McCracken County,7,6,3727,1827,1900
Kentucky,McCracken County,7,7,4009,1974,2035
Kentucky,McCracken County,7,8,3886,1896,1990
Kentucky,McCracken County,7,9,4021,1985,2036
Kentucky,McCracken County,7,10,4092,1997,2095
Kentucky,McCracken County,7,11,4788,2290,2498
Kentucky,McCracken County,7,12,4901,2390,2511
Kentucky,McCracken County,7,13,4528,2175,2353
Kentucky,McCracken County,7,14,3767,1746,2021
Kentucky,McCracken County,7,15,2924,1273,1651
Kentucky,McCracken County,7,16,1961,829,1132
Kentucky,McCracken County,7,17,1553,561,992
Kentucky,McCracken County,7,18,1751,534,1217
Kentucky,McCracken County,8,0,64948,31084,33864
Kentucky,McCracken County,8,1,3907,2002,1905
Kentucky,McCracken County,8,2,3840,1969,1871
Kentucky,McCracken County,8,3,4014,2022,1992
Kentucky,McCracken County,8,4,3618,1853,1765
Kentucky,McCracken County,8,5,3663,1780,1883
Kentucky,McCracken County,8,6,3845,1875,1970
Kentucky,McCracken County,8,7,3930,1914,2016
Kentucky,McCracken County,8,8,3880,1893,1987
Kentucky,McCracken County,8,9,3954,1933,2021
Kentucky,McCracken County,8,10,3992,1995,1997
Kentucky,McCracken County,8,11,4649,2206,2443
Kentucky,McCracken County,8,12,4844,2337,2507
Kentucky,McCracken County,8,13,4614,2207,2407
Kentucky,McCracken County,8,14,3908,1827,2081
Kentucky,McCracken County,8,15,3004,1303,1701
Kentucky,McCracken County,8,16,1973,870,1103
Kentucky,McCracken County,8,17,1561,564,997
Kentucky,McCracken County,8,18,1752,534,1218
Kentucky,McCracken County,9,0,65304,31250,34054
Kentucky,McCracken County,9,1,3980,2047,1933
Kentucky,McCracken County,9,2,4025,2073,1952
Kentucky,McCracken County,9,3,4003,2002,2001
Kentucky,McCracken County,9,4,3636,1837,1799
Kentucky,McCracken County,9,5,3568,1778,1790
Kentucky,McCracken County,9,6,3980,1903,2077
Kentucky,McCracken County,9,7,3933,1939,1994
Kentucky,McCracken County,9,8,3965,1933,2032
Kentucky,McCracken County,9,9,3906,1895,2011
Kentucky,McCracken County,9,10,4025,2022,2003
Kentucky,McCracken County,9,11,4427,2118,2309
Kentucky,McCracken County,9,12,4789,2285,2504
Kentucky,McCracken County,9,13,4606,2191,2415
Kentucky,McCracken County,9,14,4100,1911,2189
Kentucky,McCracken County,9,15,2983,1305,1678
Kentucky,McCracken County,9,16,2090,915,1175
Kentucky,McCracken County,9,17,1549,567,982
Kentucky,McCracken County,9,18,1739,529,1210
Kentucky,McCracken County,10,0,65364,31319,34045
Kentucky,McCracken County,10,1,3948,2051,1897
Kentucky,McCracken County,10,2,4041,2072,1969
Kentucky,McCracken County,10,3,4094,2056,2038
Kentucky,McCracken County,10,4,3696,1899,1797
Kentucky,McCracken County,10,5,3442,1721,1721
Kentucky,McCracken County,10,6,4098,1933,2165
Kentucky,McCracken County,10,7,3900,1930,1970
Kentucky,McCracken County,10,8,4002,1939,2063
Kentucky,McCracken County,10,9,3825,1888,1937
Kentucky,McCracken County,10,10,4071,2038,2033
Kentucky,McCracken County,10,11,4246,2040,2206
Kentucky,McCracken County,10,12,4682,2205,2477
Kentucky,McCracken County,10,13,4616,2206,2410
Kentucky,McCracken County,10,14,4051,1889,2162
Kentucky,McCracken County,10,15,3129,1389,1740
Kentucky,McCracken County,10,16,2225,961,1264
Kentucky,McCracken County,10,17,1539,565,974
Kentucky,McCracken County,10,18,1759,537,1222
Kentucky,McCracken County,11,0,65307,31340,33967
Kentucky,McCracken County,11,1,3913,2031,1882
Kentucky,McCracken County,11,2,4060,2083,1977
Kentucky,McCracken County,11,3,4086,2052,2034
Kentucky,McCracken County,11,4,3726,1922,1804
Kentucky,McCracken County,11,5,3369,1680,1689
Kentucky,McCracken County,11,6,4110,1974,2136
Kentucky,McCracken County,11,7,3898,1919,1979
Kentucky,McCracken County,11,8,3951,1953,1998
Kentucky,McCracken County,11,9,3847,1876,1971
Kentucky,McCracken County,11,10,4087,2037,2050
Kentucky,McCracken County,11,11,4033,1938,2095
Kentucky,McCracken County,11,12,4583,2163,2420
Kentucky,McCracken County,11,13,4627,2232,2395
Kentucky,McCracken County,11,14,4141,1913,2228
Kentucky,McCracken County,11,15,3188,1430,1758
Kentucky,McCracken County,11,16,2374,998,1376
Kentucky,McCracken County,11,17,1543,597,946
Kentucky,McCracken County,11,18,1771,542,1229
Kentucky,McCracken County,12,0,65418,31389,34029
Kentucky,McCracken County,12,1,3901,2047,1854
Kentucky,McCracken County,12,2,4076,2114,1962
Kentucky,McCracken County,12,3,4078,2043,2035
Kentucky,McCracken County,12,4,3742,1902,1840
Kentucky,McCracken County,12,5,3433,1730,1703
Kentucky,McCracken County,12,6,4091,1987,2104
Kentucky,McCracken County,12,7,3894,1896,1998
Kentucky,McCracken County,12,8,3965,1932,2033
Kentucky,McCracken County,12,9,3871,1886,1985
Kentucky,McCracken County,12,10,4060,2023,2037
Kentucky,McCracken County,12,11,3885,1860,2025
Kentucky,McCracken County,12,12,4559,2138,2421
Kentucky,McCracken County,12,13,4555,2175,2380
Kentucky,McCracken County,12,14,4216,1958,2258
Kentucky,McCracken County,12,15,3293,1483,1810
Kentucky,McCracken County,12,16,2467,1030,1437
Kentucky,McCracken County,12,17,1558,641,917
Kentucky,McCracken County,12,18,1774,544,1230
Kentucky,McCreary County,1,0,18306,9948,8358
Kentucky,McCreary County,1,1,1081,548,533
Kentucky,McCreary County,1,2,1144,602,542
Kentucky,McCreary County,1,3,1114,565,549
Kentucky,McCreary County,1,4,1339,715,624
Kentucky,McCreary County,1,5,1114,613,501
Kentucky,McCreary County,1,6,1154,686,468
Kentucky,McCreary County,1,7,1412,914,498
Kentucky,McCreary County,1,8,1374,813,561
Kentucky,McCreary County,1,9,1489,895,594
Kentucky,McCreary County,1,10,1366,763,603
Kentucky,McCreary County,1,11,1243,678,565
Kentucky,McCreary County,1,12,1177,593,584
Kentucky,McCreary County,1,13,1050,519,531
Kentucky,McCreary County,1,14,836,397,439
Kentucky,McCreary County,1,15,594,314,280
Kentucky,McCreary County,1,16,398,185,213
Kentucky,McCreary County,1,17,215,85,130
Kentucky,McCreary County,1,18,206,63,143
Kentucky,McCreary County,2,0,18306,9948,8358
Kentucky,McCreary County,2,1,1081,548,533
Kentucky,McCreary County,2,2,1144,602,542
Kentucky,McCreary County,2,3,1114,565,549
Kentucky,McCreary County,2,4,1339,715,624
Kentucky,McCreary County,2,5,1114,613,501
Kentucky,McCreary County,2,6,1154,686,468
Kentucky,McCreary County,2,7,1412,914,498
Kentucky,McCreary County,2,8,1374,813,561
Kentucky,McCreary County,2,9,1489,895,594
Kentucky,McCreary County,2,10,1366,763,603
Kentucky,McCreary County,2,11,1243,678,565
Kentucky,McCreary County,2,12,1177,593,584
Kentucky,McCreary County,2,13,1050,519,531
Kentucky,McCreary County,2,14,836,397,439
Kentucky,McCreary County,2,15,594,314,280
Kentucky,McCreary County,2,16,398,185,213
Kentucky,McCreary County,2,17,215,85,130
Kentucky,McCreary County,2,18,206,63,143
Kentucky,McCreary County,3,0,18328,9948,8380
Kentucky,McCreary County,3,1,1094,561,533
Kentucky,McCreary County,3,2,1140,604,536
Kentucky,McCreary County,3,3,1116,560,556
Kentucky,McCreary County,3,4,1331,717,614
Kentucky,McCreary County,3,5,1139,627,512
Kentucky,McCreary County,3,6,1138,673,465
Kentucky,McCreary County,3,7,1411,911,500
Kentucky,McCreary County,3,8,1364,802,562
Kentucky,McCreary County,3,9,1470,886,584
Kentucky,McCreary County,3,10,1387,770,617
Kentucky,McCreary County,3,11,1254,684,570
Kentucky,McCreary County,3,12,1179,594,585
Kentucky,McCreary County,3,13,1040,513,527
Kentucky,McCreary County,3,14,844,402,442
Kentucky,McCreary County,3,15,596,311,285
Kentucky,McCreary County,3,16,405,185,220
Kentucky,McCreary County,3,17,216,86,130
Kentucky,McCreary County,3,18,204,62,142
Kentucky,McCreary County,4,0,18283,9922,8361
Kentucky,McCreary County,4,1,1105,550,555
Kentucky,McCreary County,4,2,1127,616,511
Kentucky,McCreary County,4,3,1104,547,557
Kentucky,McCreary County,4,4,1251,666,585
Kentucky,McCreary County,4,5,1188,663,525
Kentucky,McCreary County,4,6,1119,651,468
Kentucky,McCreary County,4,7,1426,928,498
Kentucky,McCreary County,4,8,1324,777,547
Kentucky,McCreary County,4,9,1416,864,552
Kentucky,McCreary County,4,10,1411,775,636
Kentucky,McCreary County,4,11,1280,706,574
Kentucky,McCreary County,4,12,1160,591,569
Kentucky,McCreary County,4,13,1066,515,551
Kentucky,McCreary County,4,14,859,419,440
Kentucky,McCreary County,4,15,596,303,293
Kentucky,McCreary County,4,16,422,192,230
Kentucky,McCreary County,4,17,231,96,135
Kentucky,McCreary County,4,18,198,63,135
Kentucky,McCreary County,5,0,18051,9811,8240
Kentucky,McCreary County,5,1,1082,558,524
Kentucky,McCreary County,5,2,1139,605,534
Kentucky,McCreary County,5,3,1093,555,538
Kentucky,McCreary County,5,4,1174,638,536
Kentucky,McCreary County,5,5,1187,660,527
Kentucky,McCreary County,5,6,1109,642,467
Kentucky,McCreary County,5,7,1347,888,459
Kentucky,McCreary County,5,8,1324,774,550
Kentucky,McCreary County,5,9,1385,836,549
Kentucky,McCreary County,5,10,1378,756,622
Kentucky,McCreary County,5,11,1259,688,571
Kentucky,McCreary County,5,12,1137,599,538
Kentucky,McCreary County,5,13,1045,495,550
Kentucky,McCreary County,5,14,901,445,456
Kentucky,McCreary County,5,15,624,311,313
Kentucky,McCreary County,5,16,429,194,235
Kentucky,McCreary County,5,17,234,102,132
Kentucky,McCreary County,5,18,204,65,139
Kentucky,McCreary County,6,0,17925,9769,8156
Kentucky,McCreary County,6,1,1107,573,534
Kentucky,McCreary County,6,2,1124,585,539
Kentucky,McCreary County,6,3,1062,567,495
Kentucky,McCreary County,6,4,1132,605,527
Kentucky,McCreary County,6,5,1178,669,509
Kentucky,McCreary County,6,6,1124,656,468
Kentucky,McCreary County,6,7,1326,860,466
Kentucky,McCreary County,6,8,1270,751,519
Kentucky,McCreary County,6,9,1360,833,527
Kentucky,McCreary County,6,10,1358,744,614
Kentucky,McCreary County,6,11,1244,675,569
Kentucky,McCreary County,6,12,1141,610,531
Kentucky,McCreary County,6,13,1043,496,547
Kentucky,McCreary County,6,14,932,450,482
Kentucky,McCreary County,6,15,643,312,331
Kentucky,McCreary County,6,16,434,203,231
Kentucky,McCreary County,6,17,251,116,135
Kentucky,McCreary County,6,18,196,64,132
Kentucky,McCreary County,7,0,17922,9773,8149
Kentucky,McCreary County,7,1,1124,566,558
Kentucky,McCreary County,7,2,1089,561,528
Kentucky,McCreary County,7,3,1089,590,499
Kentucky,McCreary County,7,4,1067,572,495
Kentucky,McCreary County,7,5,1184,661,523
Kentucky,McCreary County,7,6,1155,689,466
Kentucky,McCreary County,7,7,1309,856,453
Kentucky,McCreary County,7,8,1272,771,501
Kentucky,McCreary County,7,9,1344,816,528
Kentucky,McCreary County,7,10,1334,750,584
Kentucky,McCreary County,7,11,1237,644,593
Kentucky,McCreary County,7,12,1153,629,524
Kentucky,McCreary County,7,13,1036,500,536
Kentucky,McCreary County,7,14,952,460,492
Kentucky,McCreary County,7,15,669,299,370
Kentucky,McCreary County,7,16,447,229,218
Kentucky,McCreary County,7,17,263,117,146
Kentucky,McCreary County,7,18,198,63,135
Kentucky,McCreary County,8,0,17883,9809,8074
Kentucky,McCreary County,8,1,1091,548,543
Kentucky,McCreary County,8,2,1028,539,489
Kentucky,McCreary County,8,3,1096,586,510
Kentucky,McCreary County,8,4,1085,604,481
Kentucky,McCreary County,8,5,1131,621,510
Kentucky,McCreary County,8,6,1219,750,469
Kentucky,McCreary County,8,7,1292,844,448
Kentucky,McCreary County,8,8,1302,816,486
Kentucky,McCreary County,8,9,1336,786,550
Kentucky,McCreary County,8,10,1294,746,548
Kentucky,McCreary County,8,11,1264,674,590
Kentucky,McCreary County,8,12,1149,608,541
Kentucky,McCreary County,8,13,1048,501,547
Kentucky,McCreary County,8,14,919,442,477
Kentucky,McCreary County,8,15,706,328,378
Kentucky,McCreary County,8,16,452,222,230
Kentucky,McCreary County,8,17,280,129,151
Kentucky,McCreary County,8,18,191,65,126
Kentucky,McCreary County,9,0,17548,9570,7978
Kentucky,McCreary County,9,1,1080,546,534
Kentucky,McCreary County,9,2,1025,530,495
Kentucky,McCreary County,9,3,1081,592,489
Kentucky,McCreary County,9,4,1066,581,485
Kentucky,McCreary County,9,5,1035,574,461
Kentucky,McCreary County,9,6,1242,749,493
Kentucky,McCreary County,9,7,1210,767,443
Kentucky,McCreary County,9,8,1287,802,485
Kentucky,McCreary County,9,9,1255,744,511
Kentucky,McCreary County,9,10,1220,697,523
Kentucky,McCreary County,9,11,1267,657,610
Kentucky,McCreary County,9,12,1133,614,519
Kentucky,McCreary County,9,13,1025,487,538
Kentucky,McCreary County,9,14,951,456,495
Kentucky,McCreary County,9,15,714,348,366
Kentucky,McCreary County,9,16,456,221,235
Kentucky,McCreary County,9,17,301,135,166
Kentucky,McCreary County,9,18,200,70,130
Kentucky,McCreary County,10,0,17372,9463,7909
Kentucky,McCreary County,10,1,1037,524,513
Kentucky,McCreary County,10,2,1047,550,497
Kentucky,McCreary County,10,3,1064,568,496
Kentucky,McCreary County,10,4,1032,573,459
Kentucky,McCreary County,10,5,983,540,443
Kentucky,McCreary County,10,6,1278,761,517
Kentucky,McCreary County,10,7,1195,765,430
Kentucky,McCreary County,10,8,1241,779,462
Kentucky,McCreary County,10,9,1251,736,515
Kentucky,McCreary County,10,10,1195,670,525
Kentucky,McCreary County,10,11,1245,654,591
Kentucky,McCreary County,10,12,1119,596,523
Kentucky,McCreary County,10,13,996,492,504
Kentucky,McCreary County,10,14,934,436,498
Kentucky,McCreary County,10,15,765,376,389
Kentucky,McCreary County,10,16,481,224,257
Kentucky,McCreary County,10,17,306,138,168
Kentucky,McCreary County,10,18,203,81,122
Kentucky,McCreary County,11,0,17290,9378,7912
Kentucky,McCreary County,11,1,1031,517,514
Kentucky,McCreary County,11,2,1036,530,506
Kentucky,McCreary County,11,3,1094,577,517
Kentucky,McCreary County,11,4,1031,585,446
Kentucky,McCreary County,11,5,964,526,438
Kentucky,McCreary County,11,6,1276,763,513
Kentucky,McCreary County,11,7,1210,772,438
Kentucky,McCreary County,11,8,1201,750,451
Kentucky,McCreary County,11,9,1231,718,513
Kentucky,McCreary County,11,10,1180,671,509
Kentucky,McCreary County,11,11,1203,637,566
Kentucky,McCreary County,11,12,1122,576,546
Kentucky,McCreary County,11,13,979,497,482
Kentucky,McCreary County,11,14,919,429,490
Kentucky,McCreary County,11,15,797,372,425
Kentucky,McCreary County,11,16,516,245,271
Kentucky,McCreary County,11,17,299,129,170
Kentucky,McCreary County,11,18,201,84,117
Kentucky,McCreary County,12,0,17231,9400,7831
Kentucky,McCreary County,12,1,990,503,487
Kentucky,McCreary County,12,2,1059,542,517
Kentucky,McCreary County,12,3,1013,531,482
Kentucky,McCreary County,12,4,1067,623,444
Kentucky,McCreary County,12,5,925,506,419
Kentucky,McCreary County,12,6,1286,759,527
Kentucky,McCreary County,12,7,1218,794,424
Kentucky,McCreary County,12,8,1183,742,441
Kentucky,McCreary County,12,9,1251,751,500
Kentucky,McCreary County,12,10,1147,640,507
Kentucky,McCreary County,12,11,1191,651,540
Kentucky,McCreary County,12,12,1110,550,560
Kentucky,McCreary County,12,13,989,514,475
Kentucky,McCreary County,12,14,907,429,478
Kentucky,McCreary County,12,15,830,381,449
Kentucky,McCreary County,12,16,542,244,298
Kentucky,McCreary County,12,17,314,157,157
Kentucky,McCreary County,12,18,209,83,126
Kentucky,McLean County,1,0,9531,4676,4855
Kentucky,McLean County,1,1,553,270,283
Kentucky,McLean County,1,2,635,329,306
Kentucky,McLean County,1,3,638,335,303
Kentucky,McLean County,1,4,629,310,319
Kentucky,McLean County,1,5,483,239,244
Kentucky,McLean County,1,6,524,280,244
Kentucky,McLean County,1,7,527,245,282
Kentucky,McLean County,1,8,606,291,315
Kentucky,McLean County,1,9,647,333,314
Kentucky,McLean County,1,10,677,338,339
Kentucky,McLean County,1,11,738,369,369
Kentucky,McLean County,1,12,638,313,325
Kentucky,McLean County,1,13,625,304,321
Kentucky,McLean County,1,14,534,263,271
Kentucky,McLean County,1,15,383,179,204
Kentucky,McLean County,1,16,279,116,163
Kentucky,McLean County,1,17,196,84,112
Kentucky,McLean County,1,18,219,78,141
Kentucky,McLean County,2,0,9540,4681,4859
Kentucky,McLean County,2,1,552,269,283
Kentucky,McLean County,2,2,639,331,308
Kentucky,McLean County,2,3,637,335,302
Kentucky,McLean County,2,4,630,310,320
Kentucky,McLean County,2,5,483,239,244
Kentucky,McLean County,2,6,524,280,244
Kentucky,McLean County,2,7,529,246,283
Kentucky,McLean County,2,8,605,291,314
Kentucky,McLean County,2,9,647,333,314
Kentucky,McLean County,2,10,680,340,340
Kentucky,McLean County,2,11,739,369,370
Kentucky,McLean County,2,12,638,313,325
Kentucky,McLean County,2,13,626,305,321
Kentucky,McLean County,2,14,534,263,271
Kentucky,McLean County,2,15,383,179,204
Kentucky,McLean County,2,16,279,116,163
Kentucky,McLean County,2,17,196,84,112
Kentucky,McLean County,2,18,219,78,141
Kentucky,McLean County,3,0,9515,4667,4848
Kentucky,McLean County,3,1,541,267,274
Kentucky,McLean County,3,2,632,326,306
Kentucky,McLean County,3,3,642,339,303
Kentucky,McLean County,3,4,619,300,319
Kentucky,McLean County,3,5,486,237,249
Kentucky,McLean County,3,6,520,279,241
Kentucky,McLean County,3,7,538,251,287
Kentucky,McLean County,3,8,597,286,311
Kentucky,McLean County,3,9,642,329,313
Kentucky,McLean County,3,10,688,345,343
Kentucky,McLean County,3,11,740,369,371
Kentucky,McLean County,3,12,638,316,322
Kentucky,McLean County,3,13,623,302,321
Kentucky,McLean County,3,14,533,263,270
Kentucky,McLean County,3,15,384,179,205
Kentucky,McLean County,3,16,283,117,166
Kentucky,McLean County,3,17,193,84,109
Kentucky,McLean County,3,18,216,78,138
Kentucky,McLean County,4,0,9508,4677,4831
Kentucky,McLean County,4,1,561,301,260
Kentucky,McLean County,4,2,605,303,302
Kentucky,McLean County,4,3,670,352,318
Kentucky,McLean County,4,4,613,289,324
Kentucky,McLean County,4,5,489,240,249
Kentucky,McLean County,4,6,500,265,235
Kentucky,McLean County,4,7,540,264,276
Kentucky,McLean County,4,8,573,274,299
Kentucky,McLean County,4,9,632,318,314
Kentucky,McLean County,4,10,707,356,351
Kentucky,McLean County,4,11,726,361,365
Kentucky,McLean County,4,12,641,328,313
Kentucky,McLean County,4,13,625,302,323
Kentucky,McLean County,4,14,540,260,280
Kentucky,McLean County,4,15,391,185,206
Kentucky,McLean County,4,16,289,115,174
Kentucky,McLean County,4,17,199,91,108
Kentucky,McLean County,4,18,207,73,134
Kentucky,McLean County,5,0,9490,4677,4813
Kentucky,McLean County,5,1,563,305,258
Kentucky,McLean County,5,2,621,305,316
Kentucky,McLean County,5,3,672,352,320
Kentucky,McLean County,5,4,589,284,305
Kentucky,McLean County,5,5,497,246,251
Kentucky,McLean County,5,6,483,253,230
Kentucky,McLean County,5,7,542,271,271
Kentucky,McLean County,5,8,566,270,296
Kentucky,McLean County,5,9,615,313,302
Kentucky,McLean County,5,10,695,347,348
Kentucky,McLean County,5,11,707,339,368
Kentucky,McLean County,5,12,657,341,316
Kentucky,McLean County,5,13,593,278,315
Kentucky,McLean County,5,14,579,289,290
Kentucky,McLean County,5,15,417,207,210
Kentucky,McLean County,5,16,280,110,170
Kentucky,McLean County,5,17,199,91,108
Kentucky,McLean County,5,18,215,76,139
Kentucky,McLean County,6,0,9453,4688,4765
Kentucky,McLean County,6,1,576,306,270
Kentucky,McLean County,6,2,615,312,303
Kentucky,McLean County,6,3,673,359,314
Kentucky,McLean County,6,4,569,285,284
Kentucky,McLean County,6,5,504,258,246
Kentucky,McLean County,6,6,466,245,221
Kentucky,McLean County,6,7,547,274,273
Kentucky,McLean County,6,8,573,274,299
Kentucky,McLean County,6,9,601,293,308
Kentucky,McLean County,6,10,687,357,330
Kentucky,McLean County,6,11,700,339,361
Kentucky,McLean County,6,12,670,339,331
Kentucky,McLean County,6,13,580,277,303
Kentucky,McLean County,6,14,563,276,287
Kentucky,McLean County,6,15,436,214,222
Kentucky,McLean County,6,16,295,124,171
Kentucky,McLean County,6,17,192,82,110
Kentucky,McLean County,6,18,206,74,132
Kentucky,McLean County,7,0,9407,4681,4726
Kentucky,McLean County,7,1,581,317,264
Kentucky,McLean County,7,2,608,311,297
Kentucky,McLean County,7,3,668,357,311
Kentucky,McLean County,7,4,550,285,265
Kentucky,McLean County,7,5,529,273,256
Kentucky,McLean County,7,6,453,223,230
Kentucky,McLean County,7,7,528,268,260
Kentucky,McLean County,7,8,542,261,281
Kentucky,McLean County,7,9,592,289,303
Kentucky,McLean County,7,10,660,337,323
Kentucky,McLean County,7,11,695,348,347
Kentucky,McLean County,7,12,693,341,352
Kentucky,McLean County,7,13,606,299,307
Kentucky,McLean County,7,14,549,268,281
Kentucky,McLean County,7,15,458,222,236
Kentucky,McLean County,7,16,302,132,170
Kentucky,McLean County,7,17,191,78,113
Kentucky,McLean County,7,18,202,72,130
Kentucky,McLean County,8,0,9395,4663,4732
Kentucky,McLean County,8,1,566,306,260
Kentucky,McLean County,8,2,606,306,300
Kentucky,McLean County,8,3,673,341,332
Kentucky,McLean County,8,4,571,305,266
Kentucky,McLean County,8,5,510,252,258
Kentucky,McLean County,8,6,459,234,225
Kentucky,McLean County,8,7,509,263,246
Kentucky,McLean County,8,8,541,264,277
Kentucky,McLean County,8,9,593,284,309
Kentucky,McLean County,8,10,654,338,316
Kentucky,McLean County,8,11,679,335,344
Kentucky,McLean County,8,12,704,347,357
Kentucky,McLean County,8,13,614,300,314
Kentucky,McLean County,8,14,550,271,279
Kentucky,McLean County,8,15,462,219,243
Kentucky,McLean County,8,16,312,143,169
Kentucky,McLean County,8,17,204,85,119
Kentucky,McLean County,8,18,188,70,118
Kentucky,McLean County,9,0,9337,4622,4715
Kentucky,McLean County,9,1,528,276,252
Kentucky,McLean County,9,2,613,313,300
Kentucky,McLean County,9,3,668,341,327
Kentucky,McLean County,9,4,596,320,276
Kentucky,McLean County,9,5,474,234,240
Kentucky,McLean County,9,6,511,255,256
Kentucky,McLean County,9,7,475,242,233
Kentucky,McLean County,9,8,521,261,260
Kentucky,McLean County,9,9,577,277,300
Kentucky,McLean County,9,10,620,317,303
Kentucky,McLean County,9,11,710,353,357
Kentucky,McLean County,9,12,684,333,351
Kentucky,McLean County,9,13,622,311,311
Kentucky,McLean County,9,14,563,268,295
Kentucky,McLean County,9,15,464,222,242
Kentucky,McLean County,9,16,318,150,168
Kentucky,McLean County,9,17,203,75,128
Kentucky,McLean County,9,18,190,74,116
Kentucky,McLean County,10,0,9216,4560,4656
Kentucky,McLean County,10,1,504,264,240
Kentucky,McLean County,10,2,603,306,297
Kentucky,McLean County,10,3,658,340,318
Kentucky,McLean County,10,4,586,323,263
Kentucky,McLean County,10,5,445,213,232
Kentucky,McLean County,10,6,520,268,252
Kentucky,McLean County,10,7,465,234,231
Kentucky,McLean County,10,8,505,253,252
Kentucky,McLean County,10,9,571,274,297
Kentucky,McLean County,10,10,593,296,297
Kentucky,McLean County,10,11,687,345,342
Kentucky,McLean County,10,12,665,310,355
Kentucky,McLean County,10,13,638,320,318
Kentucky,McLean County,10,14,546,257,289
Kentucky,McLean County,10,15,512,253,259
Kentucky,McLean County,10,16,323,150,173
Kentucky,McLean County,10,17,199,80,119
Kentucky,McLean County,10,18,196,74,122
Kentucky,McLean County,11,0,9258,4555,4703
Kentucky,McLean County,11,1,552,287,265
Kentucky,McLean County,11,2,609,313,296
Kentucky,McLean County,11,3,638,317,321
Kentucky,McLean County,11,4,616,336,280
Kentucky,McLean County,11,5,431,207,224
Kentucky,McLean County,11,6,516,263,253
Kentucky,McLean County,11,7,474,235,239
Kentucky,McLean County,11,8,530,257,273
Kentucky,McLean County,11,9,549,267,282
Kentucky,McLean County,11,10,567,271,296
Kentucky,McLean County,11,11,661,343,318
Kentucky,McLean County,11,12,676,323,353
Kentucky,McLean County,11,13,631,309,322
Kentucky,McLean County,11,14,552,264,288
Kentucky,McLean County,11,15,504,243,261
Kentucky,McLean County,11,16,336,153,183
Kentucky,McLean County,11,17,213,96,117
Kentucky,McLean County,11,18,203,71,132
Kentucky,McLean County,12,0,9207,4526,4681
Kentucky,McLean County,12,1,514,263,251
Kentucky,McLean County,12,2,624,326,298
Kentucky,McLean County,12,3,622,308,314
Kentucky,McLean County,12,4,619,340,279
Kentucky,McLean County,12,5,427,212,215
Kentucky,McLean County,12,6,516,259,257
Kentucky,McLean County,12,7,469,234,235
Kentucky,McLean County,12,8,526,256,270
Kentucky,McLean County,12,9,533,258,275
Kentucky,McLean County,12,10,570,271,299
Kentucky,McLean County,12,11,613,312,301
Kentucky,McLean County,12,12,675,335,340
Kentucky,McLean County,12,13,661,318,343
Kentucky,McLean County,12,14,564,273,291
Kentucky,McLean County,12,15,481,221,260
Kentucky,McLean County,12,16,371,167,204
Kentucky,McLean County,12,17,212,99,113
Kentucky,McLean County,12,18,210,74,136
Kentucky,Madison County,1,0,82916,40264,42652
Kentucky,Madison County,1,1,5069,2550,2519
Kentucky,Madison County,1,2,4990,2573,2417
Kentucky,Madison County,1,3,4945,2509,2436
Kentucky,Madison County,1,4,7181,3383,3798
Kentucky,Madison County,1,5,9492,4663,4829
Kentucky,Madison County,1,6,5691,2879,2812
Kentucky,Madison County,1,7,5482,2786,2696
Kentucky,Madison County,1,8,5493,2696,2797
Kentucky,Madison County,1,9,5258,2629,2629
Kentucky,Madison County,1,10,5633,2738,2895
Kentucky,Madison County,1,11,5255,2506,2749
Kentucky,Madison County,1,12,4886,2357,2529
Kentucky,Madison County,1,13,4229,2032,2197
Kentucky,Madison County,1,14,3119,1471,1648
Kentucky,Madison County,1,15,2217,994,1223
Kentucky,Madison County,1,16,1709,720,989
Kentucky,Madison County,1,17,1188,461,727
Kentucky,Madison County,1,18,1079,317,762
Kentucky,Madison County,2,0,82913,40262,42651
Kentucky,Madison County,2,1,5069,2550,2519
Kentucky,Madison County,2,2,4990,2573,2417
Kentucky,Madison County,2,3,4945,2509,2436
Kentucky,Madison County,2,4,7180,3382,3798
Kentucky,Madison County,2,5,9492,4663,4829
Kentucky,Madison County,2,6,5691,2879,2812
Kentucky,Madison County,2,7,5482,2786,2696
Kentucky,Madison County,2,8,5493,2696,2797
Kentucky,Madison County,2,9,5257,2629,2628
Kentucky,Madison County,2,10,5633,2738,2895
Kentucky,Madison County,2,11,5254,2505,2749
Kentucky,Madison County,2,12,4886,2357,2529
Kentucky,Madison County,2,13,4229,2032,2197
Kentucky,Madison County,2,14,3119,1471,1648
Kentucky,Madison County,2,15,2217,994,1223
Kentucky,Madison County,2,16,1709,720,989
Kentucky,Madison County,2,17,1188,461,727
Kentucky,Madison County,2,18,1079,317,762
Kentucky,Madison County,3,0,83468,40490,42978
Kentucky,Madison County,3,1,5078,2547,2531
Kentucky,Madison County,3,2,4983,2568,2415
Kentucky,Madison County,3,3,4953,2512,2441
Kentucky,Madison County,3,4,7374,3457,3917
Kentucky,Madison County,3,5,9766,4793,4973
Kentucky,Madison County,3,6,5669,2861,2808
Kentucky,Madison County,3,7,5474,2769,2705
Kentucky,Madison County,3,8,5460,2696,2764
Kentucky,Madison County,3,9,5272,2631,2641
Kentucky,Madison County,3,10,5610,2720,2890
Kentucky,Madison County,3,11,5276,2523,2753
Kentucky,Madison County,3,12,4903,2363,2540
Kentucky,Madison County,3,13,4273,2061,2212
Kentucky,Madison County,3,14,3152,1482,1670
Kentucky,Madison County,3,15,2220,998,1222
Kentucky,Madison County,3,16,1719,723,996
Kentucky,Madison County,3,17,1198,470,728
Kentucky,Madison County,3,18,1088,316,772
Kentucky,Madison County,4,0,84775,41033,43742
Kentucky,Madison County,4,1,5003,2504,2499
Kentucky,Madison County,4,2,5100,2611,2489
Kentucky,Madison County,4,3,5043,2564,2479
Kentucky,Madison County,4,4,7610,3558,4052
Kentucky,Madison County,4,5,10308,5037,5271
Kentucky,Madison County,4,6,5495,2761,2734
Kentucky,Madison County,4,7,5389,2675,2714
Kentucky,Madison County,4,8,5343,2680,2663
Kentucky,Madison County,4,9,5403,2672,2731
Kentucky,Madison County,4,10,5555,2701,2854
Kentucky,Madison County,4,11,5372,2567,2805
Kentucky,Madison County,4,12,4986,2387,2599
Kentucky,Madison County,4,13,4523,2205,2318
Kentucky,Madison County,4,14,3306,1539,1767
Kentucky,Madison County,4,15,2245,1007,1238
Kentucky,Madison County,4,16,1746,744,1002
Kentucky,Madison County,4,17,1229,492,737
Kentucky,Madison County,4,18,1119,329,790
Kentucky,Madison County,5,0,85394,41379,44015
Kentucky,Madison County,5,1,4952,2509,2443
Kentucky,Madison County,5,2,5118,2606,2512
Kentucky,Madison County,5,3,5077,2575,2502
Kentucky,Madison County,5,4,7556,3536,4020
Kentucky,Madison County,5,5,10702,5273,5429
Kentucky,Madison County,5,6,5216,2607,2609
Kentucky,Madison County,5,7,5358,2629,2729
Kentucky,Madison County,5,8,5347,2698,2649
Kentucky,Madison County,5,9,5516,2738,2778
Kentucky,Madison County,5,10,5450,2664,2786
Kentucky,Madison County,5,11,5430,2607,2823
Kentucky,Madison County,5,12,5018,2363,2655
Kentucky,Madison County,5,13,4548,2203,2345
Kentucky,Madison County,5,14,3571,1673,1898
Kentucky,Madison County,5,15,2362,1085,1277
Kentucky,Madison County,5,16,1742,745,997
Kentucky,Madison County,5,17,1275,501,774
Kentucky,Madison County,5,18,1156,367,789
Kentucky,Madison County,6,0,85934,41739,44195
Kentucky,Madison County,6,1,5036,2588,2448
Kentucky,Madison County,6,2,5140,2633,2507
Kentucky,Madison County,6,3,5099,2560,2539
Kentucky,Madison County,6,4,7474,3529,3945
Kentucky,Madison County,6,5,10815,5323,5492
Kentucky,Madison County,6,6,5021,2552,2469
Kentucky,Madison County,6,7,5334,2606,2728
Kentucky,Madison County,6,8,5381,2733,2648
Kentucky,Madison County,6,9,5523,2748,2775
Kentucky,Madison County,6,10,5409,2651,2758
Kentucky,Madison County,6,11,5519,2667,2852
Kentucky,Madison County,6,12,5063,2378,2685
Kentucky,Madison County,6,13,4535,2165,2370
Kentucky,Madison County,6,14,3740,1782,1958
Kentucky,Madison County,6,15,2566,1170,1396
Kentucky,Madison County,6,16,1774,766,1008
Kentucky,Madison County,6,17,1294,497,797
Kentucky,Madison County,6,18,1211,391,820
Kentucky,Madison County,7,0,87080,42209,44871
Kentucky,Madison County,7,1,5009,2528,2481
Kentucky,Madison County,7,2,5243,2681,2562
Kentucky,Madison County,7,3,5118,2595,2523
Kentucky,Madison County,7,4,7618,3547,4071
Kentucky,Madison County,7,5,11085,5434,5651
Kentucky,Madison County,7,6,5120,2627,2493
Kentucky,Madison County,7,7,5325,2590,2735
Kentucky,Madison County,7,8,5357,2712,2645
Kentucky,Madison County,7,9,5514,2748,2766
Kentucky,Madison County,7,10,5322,2596,2726
Kentucky,Madison County,7,11,5635,2745,2890
Kentucky,Madison County,7,12,5073,2399,2674
Kentucky,Madison County,7,13,4654,2220,2434
Kentucky,Madison County,7,14,3921,1837,2084
Kentucky,Madison County,7,15,2678,1241,1437
Kentucky,Madison County,7,16,1844,782,1062
Kentucky,Madison County,7,17,1316,521,795
Kentucky,Madison County,7,18,1248,406,842
Kentucky,Madison County,8,0,88212,42808,45404
Kentucky,Madison County,8,1,5084,2609,2475
Kentucky,Madison County,8,2,5252,2642,2610
Kentucky,Madison County,8,3,5194,2679,2515
Kentucky,Madison County,8,4,7768,3588,4180
Kentucky,Madison County,8,5,11150,5457,5693
Kentucky,Madison County,8,6,5403,2784,2619
Kentucky,Madison County,8,7,5129,2512,2617
Kentucky,Madison County,8,8,5457,2751,2706
Kentucky,Madison County,8,9,5455,2705,2750
Kentucky,Madison County,8,10,5375,2636,2739
Kentucky,Madison County,8,11,5660,2759,2901
Kentucky,Madison County,8,12,5175,2454,2721
Kentucky,Madison County,8,13,4708,2243,2465
Kentucky,Madison County,8,14,4044,1922,2122
Kentucky,Madison County,8,15,2848,1311,1537
Kentucky,Madison County,8,16,1914,818,1096
Kentucky,Madison County,8,17,1301,529,772
Kentucky,Madison County,8,18,1295,409,886
Kentucky,Madison County,9,0,89532,43469,46063
Kentucky,Madison County,9,1,5239,2698,2541
Kentucky,Madison County,9,2,5213,2623,2590
Kentucky,Madison County,9,3,5302,2742,2560
Kentucky,Madison County,9,4,7886,3659,4227
Kentucky,Madison County,9,5,11154,5459,5695
Kentucky,Madison County,9,6,5810,2986,2824
Kentucky,Madison County,9,7,5079,2472,2607
Kentucky,Madison County,9,8,5521,2753,2768
Kentucky,Madison County,9,9,5389,2695,2694
Kentucky,Madison County,9,10,5479,2700,2779
Kentucky,Madison County,9,11,5598,2693,2905
Kentucky,Madison County,9,12,5319,2571,2748
Kentucky,Madison County,9,13,4786,2249,2537
Kentucky,Madison County,9,14,4228,2009,2219
Kentucky,Madison County,9,15,2943,1351,1592
Kentucky,Madison County,9,16,1929,824,1105
Kentucky,Madison County,9,17,1330,559,771
Kentucky,Madison County,9,18,1327,426,901
Kentucky,Madison County,10,0,91170,44322,46848
Kentucky,Madison County,10,1,5190,2675,2515
Kentucky,Madison County,10,2,5243,2652,2591
Kentucky,Madison County,10,3,5404,2734,2670
Kentucky,Madison County,10,4,8068,3762,4306
Kentucky,Madison County,10,5,11382,5581,5801
Kentucky,Madison County,10,6,6139,3184,2955
Kentucky,Madison County,10,7,5026,2412,2614
Kentucky,Madison County,10,8,5499,2728,2771
Kentucky,Madison County,10,9,5463,2745,2718
Kentucky,Madison County,10,10,5656,2806,2850
Kentucky,Madison County,10,11,5476,2677,2799
Kentucky,Madison County,10,12,5480,2643,2837
Kentucky,Madison County,10,13,4861,2270,2591
Kentucky,Madison County,10,14,4291,2028,2263
Kentucky,Madison County,10,15,3240,1501,1739
Kentucky,Madison County,10,16,2024,897,1127
Kentucky,Madison County,10,17,1330,556,774
Kentucky,Madison County,10,18,1398,471,927
Kentucky,Madison County,11,0,92107,44727,47380
Kentucky,Madison County,11,1,5167,2650,2517
Kentucky,Madison County,11,2,5316,2680,2636
Kentucky,Madison County,11,3,5391,2743,2648
Kentucky,Madison County,11,4,8074,3759,4315
Kentucky,Madison County,11,5,11321,5546,5775
Kentucky,Madison County,11,6,6468,3353,3115
Kentucky,Madison County,11,7,4954,2443,2511
Kentucky,Madison County,11,8,5570,2709,2861
Kentucky,Madison County,11,9,5482,2738,2744
Kentucky,Madison County,11,10,5710,2818,2892
Kentucky,Madison County,11,11,5471,2673,2798
Kentucky,Madison County,11,12,5494,2642,2852
Kentucky,Madison County,11,13,4994,2325,2669
Kentucky,Madison County,11,14,4320,2031,2289
Kentucky,Madison County,11,15,3397,1586,1811
Kentucky,Madison County,11,16,2193,968,1225
Kentucky,Madison County,11,17,1381,580,801
Kentucky,Madison County,11,18,1404,483,921
Kentucky,Madison County,12,0,92987,45127,47860
Kentucky,Madison County,12,1,5227,2693,2534
Kentucky,Madison County,12,2,5281,2630,2651
Kentucky,Madison County,12,3,5503,2784,2719
Kentucky,Madison County,12,4,7994,3745,4249
Kentucky,Madison County,12,5,11274,5521,5753
Kentucky,Madison County,12,6,6620,3395,3225
Kentucky,Madison County,12,7,5070,2560,2510
Kentucky,Madison County,12,8,5530,2676,2854
Kentucky,Madison County,12,9,5570,2796,2774
Kentucky,Madison County,12,10,5654,2758,2896
Kentucky,Madison County,12,11,5401,2626,2775
Kentucky,Madison County,12,12,5623,2706,2917
Kentucky,Madison County,12,13,5046,2358,2688
Kentucky,Madison County,12,14,4461,2112,2349
Kentucky,Madison County,12,15,3557,1628,1929
Kentucky,Madison County,12,16,2309,1041,1268
Kentucky,Madison County,12,17,1449,599,850
Kentucky,Madison County,12,18,1418,499,919
Kentucky,Magoffin County,1,0,13333,6676,6657
Kentucky,Magoffin County,1,1,803,423,380
Kentucky,Magoffin County,1,2,924,490,434
Kentucky,Magoffin County,1,3,928,477,451
Kentucky,Magoffin County,1,4,925,493,432
Kentucky,Magoffin County,1,5,734,374,360
Kentucky,Magoffin County,1,6,752,368,384
Kentucky,Magoffin County,1,7,876,434,442
Kentucky,Magoffin County,1,8,908,458,450
Kentucky,Magoffin County,1,9,986,492,494
Kentucky,Magoffin County,1,10,1058,545,513
Kentucky,Magoffin County,1,11,1000,485,515
Kentucky,Magoffin County,1,12,941,473,468
Kentucky,Magoffin County,1,13,777,367,410
Kentucky,Magoffin County,1,14,599,296,303
Kentucky,Magoffin County,1,15,473,213,260
Kentucky,Magoffin County,1,16,298,152,146
Kentucky,Magoffin County,1,17,195,77,118
Kentucky,Magoffin County,1,18,156,59,97
Kentucky,Magoffin County,2,0,13333,6676,6657
Kentucky,Magoffin County,2,1,803,423,380
Kentucky,Magoffin County,2,2,924,490,434
Kentucky,Magoffin County,2,3,928,477,451
Kentucky,Magoffin County,2,4,925,493,432
Kentucky,Magoffin County,2,5,734,374,360
Kentucky,Magoffin County,2,6,752,368,384
Kentucky,Magoffin County,2,7,876,434,442
Kentucky,Magoffin County,2,8,908,458,450
Kentucky,Magoffin County,2,9,986,492,494
Kentucky,Magoffin County,2,10,1058,545,513
Kentucky,Magoffin County,2,11,1000,485,515
Kentucky,Magoffin County,2,12,941,473,468
Kentucky,Magoffin County,2,13,777,367,410
Kentucky,Magoffin County,2,14,599,296,303
Kentucky,Magoffin County,2,15,473,213,260
Kentucky,Magoffin County,2,16,298,152,146
Kentucky,Magoffin County,2,17,195,77,118
Kentucky,Magoffin County,2,18,156,59,97
Kentucky,Magoffin County,3,0,13306,6666,6640
Kentucky,Magoffin County,3,1,785,413,372
Kentucky,Magoffin County,3,2,912,480,432
Kentucky,Magoffin County,3,3,931,481,450
Kentucky,Magoffin County,3,4,906,484,422
Kentucky,Magoffin County,3,5,747,380,367
Kentucky,Magoffin County,3,6,749,369,380
Kentucky,Magoffin County,3,7,873,436,437
Kentucky,Magoffin County,3,8,899,451,448
Kentucky,Magoffin County,3,9,984,490,494
Kentucky,Magoffin County,3,10,1059,547,512
Kentucky,Magoffin County,3,11,1009,494,515
Kentucky,Magoffin County,3,12,941,466,475
Kentucky,Magoffin County,3,13,782,377,405
Kentucky,Magoffin County,3,14,600,292,308
Kentucky,Magoffin County,3,15,476,216,260
Kentucky,Magoffin County,3,16,298,151,147
Kentucky,Magoffin County,3,17,199,80,119
Kentucky,Magoffin County,3,18,156,59,97
Kentucky,Magoffin County,4,0,13220,6607,6613
Kentucky,Magoffin County,4,1,760,403,357
Kentucky,Magoffin County,4,2,880,453,427
Kentucky,Magoffin County,4,3,928,480,448
Kentucky,Magoffin County,4,4,839,446,393
Kentucky,Magoffin County,4,5,787,398,389
Kentucky,Magoffin County,4,6,733,371,362
Kentucky,Magoffin County,4,7,852,432,420
Kentucky,Magoffin County,4,8,861,427,434
Kentucky,Magoffin County,4,9,981,480,501
Kentucky,Magoffin County,4,10,1031,534,497
Kentucky,Magoffin County,4,11,1043,520,523
Kentucky,Magoffin County,4,12,935,443,492
Kentucky,Magoffin County,4,13,822,411,411
Kentucky,Magoffin County,4,14,596,284,312
Kentucky,Magoffin County,4,15,501,226,275
Kentucky,Magoffin County,4,16,305,154,151
Kentucky,Magoffin County,4,17,202,80,122
Kentucky,Magoffin County,4,18,164,65,99
Kentucky,Magoffin County,5,0,13061,6551,6510
Kentucky,Magoffin County,5,1,751,399,352
Kentucky,Magoffin County,5,2,870,454,416
Kentucky,Magoffin County,5,3,911,466,445
Kentucky,Magoffin County,5,4,801,427,374
Kentucky,Magoffin County,5,5,783,399,384
Kentucky,Magoffin County,5,6,727,358,369
Kentucky,Magoffin County,5,7,786,414,372
Kentucky,Magoffin County,5,8,854,416,438
Kentucky,Magoffin County,5,9,950,470,480
Kentucky,Magoffin County,5,10,997,520,477
Kentucky,Magoffin County,5,11,1051,539,512
Kentucky,Magoffin County,5,12,940,443,497
Kentucky,Magoffin County,5,13,808,405,403
Kentucky,Magoffin County,5,14,624,302,322
Kentucky,Magoffin County,5,15,509,227,282
Kentucky,Magoffin County,5,16,331,161,170
Kentucky,Magoffin County,5,17,195,82,113
Kentucky,Magoffin County,5,18,173,69,104
Kentucky,Magoffin County,6,0,12941,6500,6441
Kentucky,Magoffin County,6,1,756,409,347
Kentucky,Magoffin County,6,2,817,430,387
Kentucky,Magoffin County,6,3,886,467,419
Kentucky,Magoffin County,6,4,790,416,374
Kentucky,Magoffin County,6,5,815,421,394
Kentucky,Magoffin County,6,6,721,349,372
Kentucky,Magoffin County,6,7,740,380,360
Kentucky,Magoffin County,6,8,842,416,426
Kentucky,Magoffin County,6,9,919,466,453
Kentucky,Magoffin County,6,10,993,510,483
Kentucky,Magoffin County,6,11,1023,517,506
Kentucky,Magoffin County,6,12,960,466,494
Kentucky,Magoffin County,6,13,811,401,410
Kentucky,Magoffin County,6,14,641,304,337
Kentucky,Magoffin County,6,15,508,233,275
Kentucky,Magoffin County,6,16,347,162,185
Kentucky,Magoffin County,6,17,198,82,116
Kentucky,Magoffin County,6,18,174,71,103
Kentucky,Magoffin County,7,0,12980,6516,6464
Kentucky,Magoffin County,7,1,806,438,368
Kentucky,Magoffin County,7,2,801,407,394
Kentucky,Magoffin County,7,3,882,464,418
Kentucky,Magoffin County,7,4,785,412,373
Kentucky,Magoffin County,7,5,813,431,382
Kentucky,Magoffin County,7,6,722,362,360
Kentucky,Magoffin County,7,7,705,357,348
Kentucky,Magoffin County,7,8,845,412,433
Kentucky,Magoffin County,7,9,897,460,437
Kentucky,Magoffin County,7,10,974,491,483
Kentucky,Magoffin County,7,11,991,496,495
Kentucky,Magoffin County,7,12,985,490,495
Kentucky,Magoffin County,7,13,852,419,433
Kentucky,Magoffin County,7,14,664,311,353
Kentucky,Magoffin County,7,15,508,242,266
Kentucky,Magoffin County,7,16,364,164,200
Kentucky,Magoffin County,7,17,212,90,122
Kentucky,Magoffin County,7,18,174,70,104
Kentucky,Magoffin County,8,0,12784,6421,6363
Kentucky,Magoffin County,8,1,785,427,358
Kentucky,Magoffin County,8,2,765,398,367
Kentucky,Magoffin County,8,3,851,437,414
Kentucky,Magoffin County,8,4,776,401,375
Kentucky,Magoffin County,8,5,777,420,357
Kentucky,Magoffin County,8,6,727,365,362
Kentucky,Magoffin County,8,7,703,355,348
Kentucky,Magoffin County,8,8,807,389,418
Kentucky,Magoffin County,8,9,866,440,426
Kentucky,Magoffin County,8,10,932,474,458
Kentucky,Magoffin County,8,11,992,505,487
Kentucky,Magoffin County,8,12,963,468,495
Kentucky,Magoffin County,8,13,876,431,445
Kentucky,Magoffin County,8,14,692,336,356
Kentucky,Magoffin County,8,15,515,242,273
Kentucky,Magoffin County,8,16,369,169,200
Kentucky,Magoffin County,8,17,208,91,117
Kentucky,Magoffin County,8,18,180,73,107
Kentucky,Magoffin County,9,0,12668,6340,6328
Kentucky,Magoffin County,9,1,783,424,359
Kentucky,Magoffin County,9,2,753,392,361
Kentucky,Magoffin County,9,3,830,410,420
Kentucky,Magoffin County,9,4,767,393,374
Kentucky,Magoffin County,9,5,692,370,322
Kentucky,Magoffin County,9,6,784,390,394
Kentucky,Magoffin County,9,7,676,344,332
Kentucky,Magoffin County,9,8,782,391,391
Kentucky,Magoffin County,9,9,840,419,421
Kentucky,Magoffin County,9,10,906,454,452
Kentucky,Magoffin County,9,11,952,490,462
Kentucky,Magoffin County,9,12,987,492,495
Kentucky,Magoffin County,9,13,890,417,473
Kentucky,Magoffin County,9,14,718,364,354
Kentucky,Magoffin County,9,15,514,235,279
Kentucky,Magoffin County,9,16,398,180,218
Kentucky,Magoffin County,9,17,211,95,116
Kentucky,Magoffin County,9,18,185,80,105
Kentucky,Magoffin County,10,0,12519,6255,6264
Kentucky,Magoffin County,10,1,779,424,355
Kentucky,Magoffin County,10,2,738,380,358
Kentucky,Magoffin County,10,3,804,402,402
Kentucky,Magoffin County,10,4,756,393,363
Kentucky,Magoffin County,10,5,645,340,305
Kentucky,Magoffin County,10,6,816,400,416
Kentucky,Magoffin County,10,7,660,320,340
Kentucky,Magoffin County,10,8,744,382,362
Kentucky,Magoffin County,10,9,812,398,414
Kentucky,Magoffin County,10,10,887,451,436
Kentucky,Magoffin County,10,11,918,475,443
Kentucky,Magoffin County,10,12,984,501,483
Kentucky,Magoffin County,10,13,900,419,481
Kentucky,Magoffin County,10,14,724,361,363
Kentucky,Magoffin County,10,15,532,247,285
Kentucky,Magoffin County,10,16,396,174,222
Kentucky,Magoffin County,10,17,234,101,133
Kentucky,Magoffin County,10,18,190,87,103
Kentucky,Magoffin County,11,0,12323,6160,6163
Kentucky,Magoffin County,11,1,726,386,340
Kentucky,Magoffin County,11,2,746,396,350
Kentucky,Magoffin County,11,3,794,399,395
Kentucky,Magoffin County,11,4,751,394,357
Kentucky,Magoffin County,11,5,607,309,298
Kentucky,Magoffin County,11,6,821,421,400
Kentucky,Magoffin County,11,7,655,321,334
Kentucky,Magoffin County,11,8,685,342,343
Kentucky,Magoffin County,11,9,799,388,411
Kentucky,Magoffin County,11,10,867,457,410
Kentucky,Magoffin County,11,11,893,449,444
Kentucky,Magoffin County,11,12,956,476,480
Kentucky,Magoffin County,11,13,907,441,466
Kentucky,Magoffin County,11,14,733,360,373
Kentucky,Magoffin County,11,15,559,251,308
Kentucky,Magoffin County,11,16,386,172,214
Kentucky,Magoffin County,11,17,252,106,146
Kentucky,Magoffin County,11,18,186,92,94
Kentucky,Magoffin County,12,0,12161,6090,6071
Kentucky,Magoffin County,12,1,690,364,326
Kentucky,Magoffin County,12,2,784,426,358
Kentucky,Magoffin County,12,3,781,384,397
Kentucky,Magoffin County,12,4,720,380,340
Kentucky,Magoffin County,12,5,608,307,301
Kentucky,Magoffin County,12,6,783,412,371
Kentucky,Magoffin County,12,7,665,335,330
Kentucky,Magoffin County,12,8,630,309,321
Kentucky,Magoffin County,12,9,789,385,404
Kentucky,Magoffin County,12,10,841,441,400
Kentucky,Magoffin County,12,11,870,439,431
Kentucky,Magoffin County,12,12,913,446,467
Kentucky,Magoffin County,12,13,925,459,466
Kentucky,Magoffin County,12,14,754,371,383
Kentucky,Magoffin County,12,15,580,257,323
Kentucky,Magoffin County,12,16,395,184,211
Kentucky,Magoffin County,12,17,253,103,150
Kentucky,Magoffin County,12,18,180,88,92
Kentucky,Marion County,1,0,19820,10242,9578
Kentucky,Marion County,1,1,1322,666,656
Kentucky,Marion County,1,2,1312,646,666
Kentucky,Marion County,1,3,1374,716,658
Kentucky,Marion County,1,4,1316,683,633
Kentucky,Marion County,1,5,1076,583,493
Kentucky,Marion County,1,6,1346,781,565
Kentucky,Marion County,1,7,1438,854,584
Kentucky,Marion County,1,8,1290,714,576
Kentucky,Marion County,1,9,1405,741,664
Kentucky,Marion County,1,10,1580,853,727
Kentucky,Marion County,1,11,1445,728,717
Kentucky,Marion County,1,12,1207,626,581
Kentucky,Marion County,1,13,1129,559,570
Kentucky,Marion County,1,14,815,410,405
Kentucky,Marion County,1,15,572,261,311
Kentucky,Marion County,1,16,436,176,260
Kentucky,Marion County,1,17,390,137,253
Kentucky,Marion County,1,18,367,108,259
Kentucky,Marion County,2,0,19835,10250,9585
Kentucky,Marion County,2,1,1325,668,657
Kentucky,Marion County,2,2,1313,647,666
Kentucky,Marion County,2,3,1374,716,658
Kentucky,Marion County,2,4,1316,683,633
Kentucky,Marion County,2,5,1075,583,492
Kentucky,Marion County,2,6,1346,781,565
Kentucky,Marion County,2,7,1440,854,586
Kentucky,Marion County,2,8,1291,715,576
Kentucky,Marion County,2,9,1406,742,664
Kentucky,Marion County,2,10,1582,854,728
Kentucky,Marion County,2,11,1445,728,717
Kentucky,Marion County,2,12,1208,626,582
Kentucky,Marion County,2,13,1132,560,572
Kentucky,Marion County,2,14,816,410,406
Kentucky,Marion County,2,15,573,262,311
Kentucky,Marion County,2,16,436,176,260
Kentucky,Marion County,2,17,389,137,252
Kentucky,Marion County,2,18,368,108,260
Kentucky,Marion County,3,0,19840,10275,9565
Kentucky,Marion County,3,1,1324,671,653
Kentucky,Marion County,3,2,1313,646,667
Kentucky,Marion County,3,3,1370,717,653
Kentucky,Marion County,3,4,1320,687,633
Kentucky,Marion County,3,5,1071,584,487
Kentucky,Marion County,3,6,1341,782,559
Kentucky,Marion County,3,7,1450,856,594
Kentucky,Marion County,3,8,1301,726,575
Kentucky,Marion County,3,9,1397,738,659
Kentucky,Marion County,3,10,1581,855,726
Kentucky,Marion County,3,11,1446,730,716
Kentucky,Marion County,3,12,1210,625,585
Kentucky,Marion County,3,13,1135,558,577
Kentucky,Marion County,3,14,818,414,404
Kentucky,Marion County,3,15,571,262,309
Kentucky,Marion County,3,16,436,178,258
Kentucky,Marion County,3,17,386,137,249
Kentucky,Marion County,3,18,370,109,261
Kentucky,Marion County,4,0,20001,10334,9667
Kentucky,Marion County,4,1,1343,682,661
Kentucky,Marion County,4,2,1298,613,685
Kentucky,Marion County,4,3,1361,718,643
Kentucky,Marion County,4,4,1344,700,644
Kentucky,Marion County,4,5,1108,619,489
Kentucky,Marion County,4,6,1316,762,554
Kentucky,Marion County,4,7,1496,855,641
Kentucky,Marion County,4,8,1280,732,548
Kentucky,Marion County,4,9,1354,694,660
Kentucky,Marion County,4,10,1591,876,715
Kentucky,Marion County,4,11,1457,748,709
Kentucky,Marion County,4,12,1235,623,612
Kentucky,Marion County,4,13,1181,586,595
Kentucky,Marion County,4,14,845,424,421
Kentucky,Marion County,4,15,584,272,312
Kentucky,Marion County,4,16,450,186,264
Kentucky,Marion County,4,17,373,131,242
Kentucky,Marion County,4,18,385,113,272
Kentucky,Marion County,5,0,19918,10288,9630
Kentucky,Marion County,5,1,1285,653,632
Kentucky,Marion County,5,2,1330,652,678
Kentucky,Marion County,5,3,1368,727,641
Kentucky,Marion County,5,4,1302,664,638
Kentucky,Marion County,5,5,1114,623,491
Kentucky,Marion County,5,6,1251,733,518
Kentucky,Marion County,5,7,1489,847,642
Kentucky,Marion County,5,8,1281,740,541
Kentucky,Marion County,5,9,1331,669,662
Kentucky,Marion County,5,10,1545,846,699
Kentucky,Marion County,5,11,1446,758,688
Kentucky,Marion County,5,12,1287,644,643
Kentucky,Marion County,5,13,1152,570,582
Kentucky,Marion County,5,14,918,447,471
Kentucky,Marion County,5,15,601,286,315
Kentucky,Marion County,5,16,440,181,259
Kentucky,Marion County,5,17,376,135,241
Kentucky,Marion County,5,18,402,113,289
Kentucky,Marion County,6,0,19928,10248,9680
Kentucky,Marion County,6,1,1224,588,636
Kentucky,Marion County,6,2,1334,666,668
Kentucky,Marion County,6,3,1349,690,659
Kentucky,Marion County,6,4,1309,687,622
Kentucky,Marion County,6,5,1194,666,528
Kentucky,Marion County,6,6,1226,722,504
Kentucky,Marion County,6,7,1464,830,634
Kentucky,Marion County,6,8,1282,738,544
Kentucky,Marion County,6,9,1301,661,640
Kentucky,Marion County,6,10,1488,801,687
Kentucky,Marion County,6,11,1469,776,693
Kentucky,Marion County,6,12,1320,662,658
Kentucky,Marion County,6,13,1141,566,575
Kentucky,Marion County,6,14,956,460,496
Kentucky,Marion County,6,15,648,313,335
Kentucky,Marion County,6,16,443,179,264
Kentucky,Marion County,6,17,364,126,238
Kentucky,Marion County,6,18,416,117,299
Kentucky,Marion County,7,0,19079,9425,9654
Kentucky,Marion County,7,1,1223,575,648
Kentucky,Marion County,7,2,1318,666,652
Kentucky,Marion County,7,3,1340,676,664
Kentucky,Marion County,7,4,1254,656,598
Kentucky,Marion County,7,5,1161,594,567
Kentucky,Marion County,7,6,1039,544,495
Kentucky,Marion County,7,7,1202,618,584
Kentucky,Marion County,7,8,1168,627,541
Kentucky,Marion County,7,9,1207,591,616
Kentucky,Marion County,7,10,1347,671,676
Kentucky,Marion County,7,11,1461,740,721
Kentucky,Marion County,7,12,1343,673,670
Kentucky,Marion County,7,13,1124,555,569
Kentucky,Marion County,7,14,994,486,508
Kentucky,Marion County,7,15,672,320,352
Kentucky,Marion County,7,16,450,193,257
Kentucky,Marion County,7,17,366,128,238
Kentucky,Marion County,7,18,410,112,298
Kentucky,Marion County,8,0,19212,9509,9703
Kentucky,Marion County,8,1,1246,612,634
Kentucky,Marion County,8,2,1344,684,660
Kentucky,Marion County,8,3,1305,635,670
Kentucky,Marion County,8,4,1262,675,587
Kentucky,Marion County,8,5,1180,606,574
Kentucky,Marion County,8,6,1035,528,507
Kentucky,Marion County,8,7,1162,605,557
Kentucky,Marion County,8,8,1233,649,584
Kentucky,Marion County,8,9,1169,601,568
Kentucky,Marion County,8,10,1296,630,666
Kentucky,Marion County,8,11,1470,737,733
Kentucky,Marion County,8,12,1377,690,687
Kentucky,Marion County,8,13,1167,590,577
Kentucky,Marion County,8,14,1020,486,534
Kentucky,Marion County,8,15,716,350,366
Kentucky,Marion County,8,16,450,194,256
Kentucky,Marion County,8,17,373,132,241
Kentucky,Marion County,8,18,407,105,302
Kentucky,Marion County,9,0,19135,9470,9665
Kentucky,Marion County,9,1,1235,624,611
Kentucky,Marion County,9,2,1329,668,661
Kentucky,Marion County,9,3,1302,629,673
Kentucky,Marion County,9,4,1249,667,582
Kentucky,Marion County,9,5,1164,603,561
Kentucky,Marion County,9,6,1096,571,525
Kentucky,Marion County,9,7,1069,560,509
Kentucky,Marion County,9,8,1267,641,626
Kentucky,Marion County,9,9,1125,594,531
Kentucky,Marion County,9,10,1253,589,664
Kentucky,Marion County,9,11,1449,743,706
Kentucky,Marion County,9,12,1395,700,695
Kentucky,Marion County,9,13,1181,577,604
Kentucky,Marion County,9,14,1061,513,548
Kentucky,Marion County,9,15,734,357,377
Kentucky,Marion County,9,16,454,198,256
Kentucky,Marion County,9,17,363,125,238
Kentucky,Marion County,9,18,409,111,298
Kentucky,Marion County,10,0,19276,9567,9709
Kentucky,Marion County,10,1,1250,650,600
Kentucky,Marion County,10,2,1340,668,672
Kentucky,Marion County,10,3,1312,629,683
Kentucky,Marion County,10,4,1236,651,585
Kentucky,Marion County,10,5,1159,607,552
Kentucky,Marion County,10,6,1177,625,552
Kentucky,Marion County,10,7,1057,556,501
Kentucky,Marion County,10,8,1274,648,626
Kentucky,Marion County,10,9,1125,590,535
Kentucky,Marion County,10,10,1212,573,639
Kentucky,Marion County,10,11,1426,728,698
Kentucky,Marion County,10,12,1406,712,694
Kentucky,Marion County,10,13,1225,597,628
Kentucky,Marion County,10,14,1022,501,521
Kentucky,Marion County,10,15,825,384,441
Kentucky,Marion County,10,16,465,210,255
Kentucky,Marion County,10,17,345,119,226
Kentucky,Marion County,10,18,420,119,301
Kentucky,Marion County,11,0,19326,9584,9742
Kentucky,Marion County,11,1,1218,658,560
Kentucky,Marion County,11,2,1340,643,697
Kentucky,Marion County,11,3,1348,662,686
Kentucky,Marion County,11,4,1200,607,593
Kentucky,Marion County,11,5,1175,612,563
Kentucky,Marion County,11,6,1180,642,538
Kentucky,Marion County,11,7,1071,552,519
Kentucky,Marion County,11,8,1261,639,622
Kentucky,Marion County,11,9,1136,605,531
Kentucky,Marion County,11,10,1185,554,631
Kentucky,Marion County,11,11,1389,705,684
Kentucky,Marion County,11,12,1403,711,692
Kentucky,Marion County,11,13,1261,618,643
Kentucky,Marion County,11,14,1026,499,527
Kentucky,Marion County,11,15,846,398,448
Kentucky,Marion County,11,16,520,239,281
Kentucky,Marion County,11,17,337,116,221
Kentucky,Marion County,11,18,430,124,306
Kentucky,Marion County,12,0,19273,9567,9706
Kentucky,Marion County,12,1,1232,668,564
Kentucky,Marion County,12,2,1278,625,653
Kentucky,Marion County,12,3,1352,689,663
Kentucky,Marion County,12,4,1180,577,603
Kentucky,Marion County,12,5,1124,582,542
Kentucky,Marion County,12,6,1257,678,579
Kentucky,Marion County,12,7,1061,543,518
Kentucky,Marion County,12,8,1192,610,582
Kentucky,Marion County,12,9,1160,620,540
Kentucky,Marion County,12,10,1173,563,610
Kentucky,Marion County,12,11,1310,647,663
Kentucky,Marion County,12,12,1407,701,706
Kentucky,Marion County,12,13,1282,629,653
Kentucky,Marion County,12,14,1042,510,532
Kentucky,Marion County,12,15,875,413,462
Kentucky,Marion County,12,16,552,244,308
Kentucky,Marion County,12,17,361,138,223
Kentucky,Marion County,12,18,435,130,305
Kentucky,Marshall County,1,0,31448,15466,15982
Kentucky,Marshall County,1,1,1668,845,823
Kentucky,Marshall County,1,2,1836,956,880
Kentucky,Marshall County,1,3,1820,921,899
Kentucky,Marshall County,1,4,1938,1006,932
Kentucky,Marshall County,1,5,1487,764,723
Kentucky,Marshall County,1,6,1565,765,800
Kentucky,Marshall County,1,7,1714,891,823
Kentucky,Marshall County,1,8,1933,935,998
Kentucky,Marshall County,1,9,2074,1038,1036
Kentucky,Marshall County,1,10,2359,1162,1197
Kentucky,Marshall County,1,11,2433,1190,1243
Kentucky,Marshall County,1,12,2386,1182,1204
Kentucky,Marshall County,1,13,2169,1060,1109
Kentucky,Marshall County,1,14,1921,925,996
Kentucky,Marshall County,1,15,1556,725,831
Kentucky,Marshall County,1,16,1131,559,572
Kentucky,Marshall County,1,17,760,310,450
Kentucky,Marshall County,1,18,698,232,466
Kentucky,Marshall County,2,0,31448,15466,15982
Kentucky,Marshall County,2,1,1668,845,823
Kentucky,Marshall County,2,2,1836,956,880
Kentucky,Marshall County,2,3,1820,921,899
Kentucky,Marshall County,2,4,1938,1006,932
Kentucky,Marshall County,2,5,1488,765,723
Kentucky,Marshall County,2,6,1565,765,800
Kentucky,Marshall County,2,7,1714,891,823
Kentucky,Marshall County,2,8,1933,935,998
Kentucky,Marshall County,2,9,2074,1038,1036
Kentucky,Marshall County,2,10,2359,1162,1197
Kentucky,Marshall County,2,11,2432,1189,1243
Kentucky,Marshall County,2,12,2386,1182,1204
Kentucky,Marshall County,2,13,2169,1060,1109
Kentucky,Marshall County,2,14,1921,925,996
Kentucky,Marshall County,2,15,1556,725,831
Kentucky,Marshall County,2,16,1131,559,572
Kentucky,Marshall County,2,17,760,310,450
Kentucky,Marshall County,2,18,698,232,466
Kentucky,Marshall County,3,0,31451,15472,15979
Kentucky,Marshall County,3,1,1672,842,830
Kentucky,Marshall County,3,2,1824,951,873
Kentucky,Marshall County,3,3,1825,927,898
Kentucky,Marshall County,3,4,1919,1000,919
Kentucky,Marshall County,3,5,1518,779,739
Kentucky,Marshall County,3,6,1572,765,807
Kentucky,Marshall County,3,7,1711,895,816
Kentucky,Marshall County,3,8,1928,938,990
Kentucky,Marshall County,3,9,2070,1033,1037
Kentucky,Marshall County,3,10,2341,1156,1185
Kentucky,Marshall County,3,11,2429,1188,1241
Kentucky,Marshall County,3,12,2398,1180,1218
Kentucky,Marshall County,3,13,2180,1073,1107
Kentucky,Marshall County,3,14,1917,921,996
Kentucky,Marshall County,3,15,1549,725,824
Kentucky,Marshall County,3,16,1132,554,578
Kentucky,Marshall County,3,17,765,314,451
Kentucky,Marshall County,3,18,701,231,470
Kentucky,Marshall County,4,0,31261,15335,15926
Kentucky,Marshall County,4,1,1635,829,806
Kentucky,Marshall County,4,2,1785,925,860
Kentucky,Marshall County,4,3,1840,932,908
Kentucky,Marshall County,4,4,1818,951,867
Kentucky,Marshall County,4,5,1577,801,776
Kentucky,Marshall County,4,6,1515,709,806
Kentucky,Marshall County,4,7,1784,924,860
Kentucky,Marshall County,4,8,1785,884,901
Kentucky,Marshall County,4,9,2036,1008,1028
Kentucky,Marshall County,4,10,2269,1130,1139
Kentucky,Marshall County,4,11,2435,1183,1252
Kentucky,Marshall County,4,12,2428,1172,1256
Kentucky,Marshall County,4,13,2245,1132,1113
Kentucky,Marshall County,4,14,1916,910,1006
Kentucky,Marshall County,4,15,1542,729,813
Kentucky,Marshall County,4,16,1143,538,605
Kentucky,Marshall County,4,17,797,341,456
Kentucky,Marshall County,4,18,711,237,474
Kentucky,Marshall County,5,0,31261,15372,15889
Kentucky,Marshall County,5,1,1614,812,802
Kentucky,Marshall County,5,2,1750,906,844
Kentucky,Marshall County,5,3,1886,963,923
Kentucky,Marshall County,5,4,1732,902,830
Kentucky,Marshall County,5,5,1670,860,810
Kentucky,Marshall County,5,6,1487,704,783
Kentucky,Marshall County,5,7,1793,917,876
Kentucky,Marshall County,5,8,1740,871,869
Kentucky,Marshall County,5,9,2007,980,1027
Kentucky,Marshall County,5,10,2257,1136,1121
Kentucky,Marshall County,5,11,2386,1163,1223
Kentucky,Marshall County,5,12,2450,1180,1270
Kentucky,Marshall County,5,13,2230,1134,1096
Kentucky,Marshall County,5,14,2009,948,1061
Kentucky,Marshall County,5,15,1596,775,821
Kentucky,Marshall County,5,16,1136,504,632
Kentucky,Marshall County,5,17,804,378,426
Kentucky,Marshall County,5,18,714,239,475
Kentucky,Marshall County,6,0,31215,15387,15828
Kentucky,Marshall County,6,1,1603,836,767
Kentucky,Marshall County,6,2,1730,905,825
Kentucky,Marshall County,6,3,1941,985,956
Kentucky,Marshall County,6,4,1710,883,827
Kentucky,Marshall County,6,5,1696,843,853
Kentucky,Marshall County,6,6,1518,763,755
Kentucky,Marshall County,6,7,1776,878,898
Kentucky,Marshall County,6,8,1720,889,831
Kentucky,Marshall County,6,9,1991,963,1028
Kentucky,Marshall County,6,10,2189,1112,1077
Kentucky,Marshall County,6,11,2376,1168,1208
Kentucky,Marshall County,6,12,2390,1151,1239
Kentucky,Marshall County,6,13,2196,1101,1095
Kentucky,Marshall County,6,14,2055,983,1072
Kentucky,Marshall County,6,15,1625,784,841
Kentucky,Marshall County,6,16,1189,530,659
Kentucky,Marshall County,6,17,812,386,426
Kentucky,Marshall County,6,18,698,227,471
Kentucky,Marshall County,7,0,30993,15221,15772
Kentucky,Marshall County,7,1,1573,821,752
Kentucky,Marshall County,7,2,1744,899,845
Kentucky,Marshall County,7,3,1864,952,912
Kentucky,Marshall County,7,4,1698,858,840
Kentucky,Marshall County,7,5,1668,838,830
Kentucky,Marshall County,7,6,1546,772,774
Kentucky,Marshall County,7,7,1722,821,901
Kentucky,Marshall County,7,8,1747,915,832
Kentucky,Marshall County,7,9,1939,941,998
Kentucky,Marshall County,7,10,2093,1041,1052
Kentucky,Marshall County,7,11,2386,1163,1223
Kentucky,Marshall County,7,12,2338,1132,1206
Kentucky,Marshall County,7,13,2216,1113,1103
Kentucky,Marshall County,7,14,2061,1006,1055
Kentucky,Marshall County,7,15,1664,783,881
Kentucky,Marshall County,7,16,1219,549,670
Kentucky,Marshall County,7,17,808,378,430
Kentucky,Marshall County,7,18,707,239,468
Kentucky,Marshall County,8,0,31059,15284,15775
Kentucky,Marshall County,8,1,1606,880,726
Kentucky,Marshall County,8,2,1758,886,872
Kentucky,Marshall County,8,3,1906,982,924
Kentucky,Marshall County,8,4,1669,841,828
Kentucky,Marshall County,8,5,1634,829,805
Kentucky,Marshall County,8,6,1652,848,804
Kentucky,Marshall County,8,7,1655,776,879
Kentucky,Marshall County,8,8,1789,916,873
Kentucky,Marshall County,8,9,1876,941,935
Kentucky,Marshall County,8,10,2028,1004,1024
Kentucky,Marshall County,8,11,2302,1113,1189
Kentucky,Marshall County,8,12,2318,1119,1199
Kentucky,Marshall County,8,13,2326,1154,1172
Kentucky,Marshall County,8,14,2059,1015,1044
Kentucky,Marshall County,8,15,1704,793,911
Kentucky,Marshall County,8,16,1235,563,672
Kentucky,Marshall County,8,17,799,361,438
Kentucky,Marshall County,8,18,743,263,480
Kentucky,Marshall County,9,0,31280,15359,15921
Kentucky,Marshall County,9,1,1687,908,779
Kentucky,Marshall County,9,2,1727,885,842
Kentucky,Marshall County,9,3,1923,979,944
Kentucky,Marshall County,9,4,1726,879,847
Kentucky,Marshall County,9,5,1549,791,758
Kentucky,Marshall County,9,6,1775,893,882
Kentucky,Marshall County,9,7,1665,766,899
Kentucky,Marshall County,9,8,1843,930,913
Kentucky,Marshall County,9,9,1819,918,901
Kentucky,Marshall County,9,10,2025,1017,1008
Kentucky,Marshall County,9,11,2232,1092,1140
Kentucky,Marshall County,9,12,2310,1112,1198
Kentucky,Marshall County,9,13,2357,1132,1225
Kentucky,Marshall County,9,14,2115,1068,1047
Kentucky,Marshall County,9,15,1703,788,915
Kentucky,Marshall County,9,16,1270,586,684
Kentucky,Marshall County,9,17,799,346,453
Kentucky,Marshall County,9,18,755,269,486
Kentucky,Marshall County,10,0,31318,15336,15982
Kentucky,Marshall County,10,1,1721,904,817
Kentucky,Marshall County,10,2,1743,901,842
Kentucky,Marshall County,10,3,1869,954,915
Kentucky,Marshall County,10,4,1749,888,861
Kentucky,Marshall County,10,5,1562,792,770
Kentucky,Marshall County,10,6,1834,932,902
Kentucky,Marshall County,10,7,1635,749,886
Kentucky,Marshall County,10,8,1880,940,940
Kentucky,Marshall County,10,9,1785,882,903
Kentucky,Marshall County,10,10,1999,999,1000
Kentucky,Marshall County,10,11,2199,1106,1093
Kentucky,Marshall County,10,12,2290,1093,1197
Kentucky,Marshall County,10,13,2349,1131,1218
Kentucky,Marshall County,10,14,2083,1055,1028
Kentucky,Marshall County,10,15,1771,814,957
Kentucky,Marshall County,10,16,1297,604,693
Kentucky,Marshall County,10,17,796,307,489
Kentucky,Marshall County,10,18,756,285,471
Kentucky,Marshall County,11,0,31202,15268,15934
Kentucky,Marshall County,11,1,1687,888,799
Kentucky,Marshall County,11,2,1717,893,824
Kentucky,Marshall County,11,3,1852,960,892
Kentucky,Marshall County,11,4,1758,896,862
Kentucky,Marshall County,11,5,1512,767,745
Kentucky,Marshall County,11,6,1849,915,934
Kentucky,Marshall County,11,7,1600,769,831
Kentucky,Marshall County,11,8,1863,899,964
Kentucky,Marshall County,11,9,1757,888,869
Kentucky,Marshall County,11,10,2007,997,1010
Kentucky,Marshall County,11,11,2118,1069,1049
Kentucky,Marshall County,11,12,2335,1130,1205
Kentucky,Marshall County,11,13,2326,1094,1232
Kentucky,Marshall County,11,14,2083,1044,1039
Kentucky,Marshall County,11,15,1804,840,964
Kentucky,Marshall County,11,16,1314,609,705
Kentucky,Marshall County,11,17,875,346,529
Kentucky,Marshall County,11,18,745,264,481
Kentucky,Marshall County,12,0,31100,15268,15832
Kentucky,Marshall County,12,1,1635,858,777
Kentucky,Marshall County,12,2,1737,900,837
Kentucky,Marshall County,12,3,1853,972,881
Kentucky,Marshall County,12,4,1737,903,834
Kentucky,Marshall County,12,5,1511,785,726
Kentucky,Marshall County,12,6,1790,898,892
Kentucky,Marshall County,12,7,1617,804,813
Kentucky,Marshall County,12,8,1840,863,977
Kentucky,Marshall County,12,9,1808,915,893
Kentucky,Marshall County,12,10,1946,966,980
Kentucky,Marshall County,12,11,2063,1049,1014
Kentucky,Marshall County,12,12,2341,1119,1222
Kentucky,Marshall County,12,13,2336,1117,1219
Kentucky,Marshall County,12,14,2099,1038,1061
Kentucky,Marshall County,12,15,1784,838,946
Kentucky,Marshall County,12,16,1342,615,727
Kentucky,Marshall County,12,17,907,366,541
Kentucky,Marshall County,12,18,754,262,492
Kentucky,Martin County,1,0,12929,7150,5779
Kentucky,Martin County,1,1,733,392,341
Kentucky,Martin County,1,2,746,383,363
Kentucky,Martin County,1,3,791,402,389
Kentucky,Martin County,1,4,808,454,354
Kentucky,Martin County,1,5,781,441,340
Kentucky,Martin County,1,6,1004,699,305
Kentucky,Martin County,1,7,1155,781,374
Kentucky,Martin County,1,8,1037,646,391
Kentucky,Martin County,1,9,930,508,422
Kentucky,Martin County,1,10,979,521,458
Kentucky,Martin County,1,11,928,475,453
Kentucky,Martin County,1,12,865,444,421
Kentucky,Martin County,1,13,720,370,350
Kentucky,Martin County,1,14,458,214,244
Kentucky,Martin County,1,15,373,186,187
Kentucky,Martin County,1,16,266,114,152
Kentucky,Martin County,1,17,194,73,121
Kentucky,Martin County,1,18,161,47,114
Kentucky,Martin County,2,0,12929,7150,5779
Kentucky,Martin County,2,1,733,392,341
Kentucky,Martin County,2,2,746,383,363
Kentucky,Martin County,2,3,791,402,389
Kentucky,Martin County,2,4,808,454,354
Kentucky,Martin County,2,5,781,441,340
Kentucky,Martin County,2,6,1004,699,305
Kentucky,Martin County,2,7,1155,781,374
Kentucky,Martin County,2,8,1037,646,391
Kentucky,Martin County,2,9,930,508,422
Kentucky,Martin County,2,10,979,521,458
Kentucky,Martin County,2,11,928,475,453
Kentucky,Martin County,2,12,865,444,421
Kentucky,Martin County,2,13,720,370,350
Kentucky,Martin County,2,14,458,214,244
Kentucky,Martin County,2,15,373,186,187
Kentucky,Martin County,2,16,266,114,152
Kentucky,Martin County,2,17,194,73,121
Kentucky,Martin County,2,18,161,47,114
Kentucky,Martin County,3,0,12895,7124,5771
Kentucky,Martin County,3,1,732,393,339
Kentucky,Martin County,3,2,751,387,364
Kentucky,Martin County,3,3,788,394,394
Kentucky,Martin County,3,4,791,447,344
Kentucky,Martin County,3,5,788,445,343
Kentucky,Martin County,3,6,997,690,307
Kentucky,Martin County,3,7,1142,775,367
Kentucky,Martin County,3,8,1027,638,389
Kentucky,Martin County,3,9,936,509,427
Kentucky,Martin County,3,10,968,516,452
Kentucky,Martin County,3,11,929,473,456
Kentucky,Martin County,3,12,858,443,415
Kentucky,Martin County,3,13,726,374,352
Kentucky,Martin County,3,14,466,219,247
Kentucky,Martin County,3,15,370,183,187
Kentucky,Martin County,3,16,270,117,153
Kentucky,Martin County,3,17,193,74,119
Kentucky,Martin County,3,18,163,47,116
Kentucky,Martin County,4,0,12829,7078,5751
Kentucky,Martin County,4,1,722,382,340
Kentucky,Martin County,4,2,756,397,359
Kentucky,Martin County,4,3,774,366,408
Kentucky,Martin County,4,4,752,431,321
Kentucky,Martin County,4,5,808,464,344
Kentucky,Martin County,4,6,1010,684,326
Kentucky,Martin County,4,7,1102,760,342
Kentucky,Martin County,4,8,1021,652,369
Kentucky,Martin County,4,9,936,504,432
Kentucky,Martin County,4,10,951,509,442
Kentucky,Martin County,4,11,914,451,463
Kentucky,Martin County,4,12,827,434,393
Kentucky,Martin County,4,13,761,385,376
Kentucky,Martin County,4,14,489,233,256
Kentucky,Martin County,4,15,362,175,187
Kentucky,Martin County,4,16,282,125,157
Kentucky,Martin County,4,17,183,75,108
Kentucky,Martin County,4,18,179,51,128
Kentucky,Martin County,5,0,12725,7056,5669
Kentucky,Martin County,5,1,741,404,337
Kentucky,Martin County,5,2,741,399,342
Kentucky,Martin County,5,3,771,375,396
Kentucky,Martin County,5,4,723,414,309
Kentucky,Martin County,5,5,812,472,340
Kentucky,Martin County,5,6,1012,683,329
Kentucky,Martin County,5,7,1060,731,329
Kentucky,Martin County,5,8,1011,652,359
Kentucky,Martin County,5,9,886,481,405
Kentucky,Martin County,5,10,945,512,433
Kentucky,Martin County,5,11,907,437,470
Kentucky,Martin County,5,12,813,418,395
Kentucky,Martin County,5,13,766,387,379
Kentucky,Martin County,5,14,530,268,262
Kentucky,Martin County,5,15,369,181,188
Kentucky,Martin County,5,16,279,114,165
Kentucky,Martin County,5,17,178,78,100
Kentucky,Martin County,5,18,181,50,131
Kentucky,Martin County,6,0,12651,7045,5606
Kentucky,Martin County,6,1,711,380,331
Kentucky,Martin County,6,2,758,410,348
Kentucky,Martin County,6,3,751,375,376
Kentucky,Martin County,6,4,688,385,303
Kentucky,Martin County,6,5,841,505,336
Kentucky,Martin County,6,6,987,681,306
Kentucky,Martin County,6,7,1094,762,332
Kentucky,Martin County,6,8,974,627,347
Kentucky,Martin County,6,9,874,483,391
Kentucky,Martin County,6,10,897,475,422
Kentucky,Martin County,6,11,887,433,454
Kentucky,Martin County,6,12,824,412,412
Kentucky,Martin County,6,13,778,389,389
Kentucky,Martin County,6,14,568,302,266
Kentucky,Martin County,6,15,382,177,205
Kentucky,Martin County,6,16,297,127,170
Kentucky,Martin County,6,17,154,67,87
Kentucky,Martin County,6,18,186,55,131
Kentucky,Martin County,7,0,12494,6936,5558
Kentucky,Martin County,7,1,658,349,309
Kentucky,Martin County,7,2,721,384,337
Kentucky,Martin County,7,3,776,405,371
Kentucky,Martin County,7,4,681,357,324
Kentucky,Martin County,7,5,801,493,308
Kentucky,Martin County,7,6,974,680,294
Kentucky,Martin County,7,7,1073,754,319
Kentucky,Martin County,7,8,966,611,355
Kentucky,Martin County,7,9,892,498,394
Kentucky,Martin County,7,10,829,431,398
Kentucky,Martin County,7,11,883,433,450
Kentucky,Martin County,7,12,818,401,417
Kentucky,Martin County,7,13,779,392,387
Kentucky,Martin County,7,14,600,306,294
Kentucky,Martin County,7,15,392,182,210
Kentucky,Martin County,7,16,300,137,163
Kentucky,Martin County,7,17,160,66,94
Kentucky,Martin County,7,18,191,57,134
Kentucky,Martin County,8,0,12285,6829,5456
Kentucky,Martin County,8,1,610,314,296
Kentucky,Martin County,8,2,702,379,323
Kentucky,Martin County,8,3,751,400,351
Kentucky,Martin County,8,4,680,339,341
Kentucky,Martin County,8,5,722,464,258
Kentucky,Martin County,8,6,988,681,307
Kentucky,Martin County,8,7,1030,727,303
Kentucky,Martin County,8,8,978,619,359
Kentucky,Martin County,8,9,844,486,358
Kentucky,Martin County,8,10,815,420,395
Kentucky,Martin County,8,11,872,451,421
Kentucky,Martin County,8,12,806,389,417
Kentucky,Martin County,8,13,762,383,379
Kentucky,Martin County,8,14,655,329,326
Kentucky,Martin County,8,15,395,172,223
Kentucky,Martin County,8,16,293,141,152
Kentucky,Martin County,8,17,186,72,114
Kentucky,Martin County,8,18,196,63,133
Kentucky,Martin County,9,0,11945,6602,5343
Kentucky,Martin County,9,1,584,301,283
Kentucky,Martin County,9,2,673,348,325
Kentucky,Martin County,9,3,707,386,321
Kentucky,Martin County,9,4,639,307,332
Kentucky,Martin County,9,5,675,434,241
Kentucky,Martin County,9,6,985,671,314
Kentucky,Martin County,9,7,1006,696,310
Kentucky,Martin County,9,8,895,576,319
Kentucky,Martin County,9,9,809,463,346
Kentucky,Martin County,9,10,826,421,405
Kentucky,Martin County,9,11,814,426,388
Kentucky,Martin County,9,12,809,386,423
Kentucky,Martin County,9,13,729,373,356
Kentucky,Martin County,9,14,699,350,349
Kentucky,Martin County,9,15,406,183,223
Kentucky,Martin County,9,16,286,131,155
Kentucky,Martin County,9,17,207,82,125
Kentucky,Martin County,9,18,196,68,128
Kentucky,Martin County,10,0,11492,6307,5185
Kentucky,Martin County,10,1,554,275,279
Kentucky,Martin County,10,2,646,329,317
Kentucky,Martin County,10,3,685,370,315
Kentucky,Martin County,10,4,625,312,313
Kentucky,Martin County,10,5,603,387,216
Kentucky,Martin County,10,6,929,634,295
Kentucky,Martin County,10,7,946,655,291
Kentucky,Martin County,10,8,840,536,304
Kentucky,Martin County,10,9,770,440,330
Kentucky,Martin County,10,10,767,399,368
Kentucky,Martin County,10,11,788,415,373
Kentucky,Martin County,10,12,788,358,430
Kentucky,Martin County,10,13,713,353,360
Kentucky,Martin County,10,14,700,346,354
Kentucky,Martin County,10,15,435,210,225
Kentucky,Martin County,10,16,298,140,158
Kentucky,Martin County,10,17,201,69,132
Kentucky,Martin County,10,18,204,79,125
Kentucky,Martin County,11,0,11325,6239,5086
Kentucky,Martin County,11,1,535,284,251
Kentucky,Martin County,11,2,608,312,296
Kentucky,Martin County,11,3,674,362,312
Kentucky,Martin County,11,4,605,302,303
Kentucky,Martin County,11,5,605,384,221
Kentucky,Martin County,11,6,922,634,288
Kentucky,Martin County,11,7,933,644,289
Kentucky,Martin County,11,8,841,543,298
Kentucky,Martin County,11,9,724,404,320
Kentucky,Martin County,11,10,751,408,343
Kentucky,Martin County,11,11,768,394,374
Kentucky,Martin County,11,12,748,342,406
Kentucky,Martin County,11,13,734,362,372
Kentucky,Martin County,11,14,692,331,361
Kentucky,Martin County,11,15,466,242,224
Kentucky,Martin County,11,16,308,137,171
Kentucky,Martin County,11,17,219,83,136
Kentucky,Martin County,11,18,192,71,121
Kentucky,Martin County,12,0,11195,6190,5005
Kentucky,Martin County,12,1,510,263,247
Kentucky,Martin County,12,2,597,306,291
Kentucky,Martin County,12,3,672,361,311
Kentucky,Martin County,12,4,608,321,287
Kentucky,Martin County,12,5,601,372,229
Kentucky,Martin County,12,6,903,625,278
Kentucky,Martin County,12,7,914,652,262
Kentucky,Martin County,12,8,837,541,296
Kentucky,Martin County,12,9,710,401,309
Kentucky,Martin County,12,10,760,419,341
Kentucky,Martin County,12,11,710,355,355
Kentucky,Martin County,12,12,747,356,391
Kentucky,Martin County,12,13,714,339,375
Kentucky,Martin County,12,14,683,332,351
Kentucky,Martin County,12,15,516,261,255
Kentucky,Martin County,12,16,311,137,174
Kentucky,Martin County,12,17,210,82,128
Kentucky,Martin County,12,18,192,67,125
Kentucky,Mason County,1,0,17490,8434,9056
Kentucky,Mason County,1,1,1197,612,585
Kentucky,Mason County,1,2,1129,559,570
Kentucky,Mason County,1,3,1237,652,585
Kentucky,Mason County,1,4,1109,560,549
Kentucky,Mason County,1,5,975,477,498
Kentucky,Mason County,1,6,917,464,453
Kentucky,Mason County,1,7,976,467,509
Kentucky,Mason County,1,8,1134,566,568
Kentucky,Mason County,1,9,1239,615,624
Kentucky,Mason County,1,10,1280,611,669
Kentucky,Mason County,1,11,1317,642,675
Kentucky,Mason County,1,12,1257,624,633
Kentucky,Mason County,1,13,1078,502,576
Kentucky,Mason County,1,14,828,377,451
Kentucky,Mason County,1,15,611,268,343
Kentucky,Mason County,1,16,491,204,287
Kentucky,Mason County,1,17,392,146,246
Kentucky,Mason County,1,18,323,88,235
Kentucky,Mason County,2,0,17490,8434,9056
Kentucky,Mason County,2,1,1197,612,585
Kentucky,Mason County,2,2,1129,559,570
Kentucky,Mason County,2,3,1237,652,585
Kentucky,Mason County,2,4,1109,560,549
Kentucky,Mason County,2,5,975,477,498
Kentucky,Mason County,2,6,917,464,453
Kentucky,Mason County,2,7,976,467,509
Kentucky,Mason County,2,8,1134,566,568
Kentucky,Mason County,2,9,1239,615,624
Kentucky,Mason County,2,10,1280,611,669
Kentucky,Mason County,2,11,1317,642,675
Kentucky,Mason County,2,12,1257,624,633
Kentucky,Mason County,2,13,1078,502,576
Kentucky,Mason County,2,14,828,377,451
Kentucky,Mason County,2,15,611,268,343
Kentucky,Mason County,2,16,491,204,287
Kentucky,Mason County,2,17,392,146,246
Kentucky,Mason County,2,18,323,88,235
Kentucky,Mason County,3,0,17505,8434,9071
Kentucky,Mason County,3,1,1194,604,590
Kentucky,Mason County,3,2,1128,563,565
Kentucky,Mason County,3,3,1226,640,586
Kentucky,Mason County,3,4,1112,569,543
Kentucky,Mason County,3,5,980,475,505
Kentucky,Mason County,3,6,928,467,461
Kentucky,Mason County,3,7,984,475,509
Kentucky,Mason County,3,8,1119,557,562
Kentucky,Mason County,3,9,1226,605,621
Kentucky,Mason County,3,10,1276,614,662
Kentucky,Mason County,3,11,1314,637,677
Kentucky,Mason County,3,12,1268,626,642
Kentucky,Mason County,3,13,1088,514,574
Kentucky,Mason County,3,14,826,372,454
Kentucky,Mason County,3,15,624,275,349
Kentucky,Mason County,3,16,489,205,284
Kentucky,Mason County,3,17,391,144,247
Kentucky,Mason County,3,18,332,92,240
Kentucky,Mason County,4,0,17546,8480,9066
Kentucky,Mason County,4,1,1179,602,577
Kentucky,Mason County,4,2,1137,570,567
Kentucky,Mason County,4,3,1237,635,602
Kentucky,Mason County,4,4,1120,599,521
Kentucky,Mason County,4,5,1013,484,529
Kentucky,Mason County,4,6,941,480,461
Kentucky,Mason County,4,7,998,491,507
Kentucky,Mason County,4,8,1075,527,548
Kentucky,Mason County,4,9,1209,580,629
Kentucky,Mason County,4,10,1252,628,624
Kentucky,Mason County,4,11,1298,619,679
Kentucky,Mason County,4,12,1286,626,660
Kentucky,Mason County,4,13,1153,551,602
Kentucky,Mason County,4,14,805,364,441
Kentucky,Mason County,4,15,659,285,374
Kentucky,Mason County,4,16,472,201,271
Kentucky,Mason County,4,17,374,141,233
Kentucky,Mason County,4,18,338,97,241
Kentucky,Mason County,5,0,17460,8435,9025
Kentucky,Mason County,5,1,1100,551,549
Kentucky,Mason County,5,2,1180,602,578
Kentucky,Mason County,5,3,1194,604,590
Kentucky,Mason County,5,4,1089,589,500
Kentucky,Mason County,5,5,1004,481,523
Kentucky,Mason County,5,6,966,477,489
Kentucky,Mason County,5,7,967,477,490
Kentucky,Mason County,5,8,1041,500,541
Kentucky,Mason County,5,9,1192,576,616
Kentucky,Mason County,5,10,1284,658,626
Kentucky,Mason County,5,11,1253,598,655
Kentucky,Mason County,5,12,1260,613,647
Kentucky,Mason County,5,13,1161,560,601
Kentucky,Mason County,5,14,864,393,471
Kentucky,Mason County,5,15,704,297,407
Kentucky,Mason County,5,16,460,201,259
Kentucky,Mason County,5,17,380,145,235
Kentucky,Mason County,5,18,361,113,248
Kentucky,Mason County,6,0,17323,8345,8978
Kentucky,Mason County,6,1,1113,549,564
Kentucky,Mason County,6,2,1171,603,568
Kentucky,Mason County,6,3,1168,577,591
Kentucky,Mason County,6,4,1060,575,485
Kentucky,Mason County,6,5,1014,505,509
Kentucky,Mason County,6,6,947,459,488
Kentucky,Mason County,6,7,976,471,505
Kentucky,Mason County,6,8,998,479,519
Kentucky,Mason County,6,9,1155,566,589
Kentucky,Mason County,6,10,1232,620,612
Kentucky,Mason County,6,11,1246,609,637
Kentucky,Mason County,6,12,1261,587,674
Kentucky,Mason County,6,13,1178,575,603
Kentucky,Mason County,6,14,902,403,499
Kentucky,Mason County,6,15,729,312,417
Kentucky,Mason County,6,16,463,202,261
Kentucky,Mason County,6,17,361,140,221
Kentucky,Mason County,6,18,349,113,236
Kentucky,Mason County,7,0,17133,8282,8851
Kentucky,Mason County,7,1,1087,546,541
Kentucky,Mason County,7,2,1137,588,549
Kentucky,Mason County,7,3,1112,538,574
Kentucky,Mason County,7,4,1081,594,487
Kentucky,Mason County,7,5,1016,517,499
Kentucky,Mason County,7,6,953,470,483
Kentucky,Mason County,7,7,918,442,476
Kentucky,Mason County,7,8,963,463,500
Kentucky,Mason County,7,9,1101,544,557
Kentucky,Mason County,7,10,1203,594,609
Kentucky,Mason County,7,11,1226,614,612
Kentucky,Mason County,7,12,1263,575,688
Kentucky,Mason County,7,13,1164,569,595
Kentucky,Mason County,7,14,974,448,526
Kentucky,Mason County,7,15,731,312,419
Kentucky,Mason County,7,16,499,217,282
Kentucky,Mason County,7,17,357,136,221
Kentucky,Mason County,7,18,348,115,233
Kentucky,Mason County,8,0,17050,8227,8823
Kentucky,Mason County,8,1,1066,516,550
Kentucky,Mason County,8,2,1134,587,547
Kentucky,Mason County,8,3,1077,548,529
Kentucky,Mason County,8,4,1081,564,517
Kentucky,Mason County,8,5,998,513,485
Kentucky,Mason County,8,6,1010,488,522
Kentucky,Mason County,8,7,894,447,447
Kentucky,Mason County,8,8,947,447,500
Kentucky,Mason County,8,9,1110,547,563
Kentucky,Mason County,8,10,1140,553,587
Kentucky,Mason County,8,11,1236,615,621
Kentucky,Mason County,8,12,1228,580,648
Kentucky,Mason County,8,13,1205,573,632
Kentucky,Mason County,8,14,1004,471,533
Kentucky,Mason County,8,15,721,317,404
Kentucky,Mason County,8,16,522,213,309
Kentucky,Mason County,8,17,331,132,199
Kentucky,Mason County,8,18,346,116,230
Kentucky,Mason County,9,0,17167,8267,8900
Kentucky,Mason County,9,1,1038,508,530
Kentucky,Mason County,9,2,1141,569,572
Kentucky,Mason County,9,3,1114,572,542
Kentucky,Mason County,9,4,1101,566,535
Kentucky,Mason County,9,5,1016,545,471
Kentucky,Mason County,9,6,1045,499,546
Kentucky,Mason County,9,7,946,467,479
Kentucky,Mason County,9,8,957,457,500
Kentucky,Mason County,9,9,1035,509,526
Kentucky,Mason County,9,10,1160,558,602
Kentucky,Mason County,9,11,1197,602,595
Kentucky,Mason County,9,12,1234,584,650
Kentucky,Mason County,9,13,1199,566,633
Kentucky,Mason County,9,14,1058,495,563
Kentucky,Mason County,9,15,705,300,405
Kentucky,Mason County,9,16,553,225,328
Kentucky,Mason County,9,17,336,136,200
Kentucky,Mason County,9,18,332,109,223
Kentucky,Mason County,10,0,17192,8338,8854
Kentucky,Mason County,10,1,1101,579,522
Kentucky,Mason County,10,2,1116,537,579
Kentucky,Mason County,10,3,1150,606,544
Kentucky,Mason County,10,4,1078,549,529
Kentucky,Mason County,10,5,992,532,460
Kentucky,Mason County,10,6,1074,523,551
Kentucky,Mason County,10,7,952,480,472
Kentucky,Mason County,10,8,968,460,508
Kentucky,Mason County,10,9,991,473,518
Kentucky,Mason County,10,10,1151,560,591
Kentucky,Mason County,10,11,1223,625,598
Kentucky,Mason County,10,12,1204,573,631
Kentucky,Mason County,10,13,1141,542,599
Kentucky,Mason County,10,14,1080,501,579
Kentucky,Mason County,10,15,747,321,426
Kentucky,Mason County,10,16,583,233,350
Kentucky,Mason County,10,17,318,131,187
Kentucky,Mason County,10,18,323,113,210
Kentucky,Mason County,11,0,17080,8281,8799
Kentucky,Mason County,11,1,1046,542,504
Kentucky,Mason County,11,2,1110,549,561
Kentucky,Mason County,11,3,1181,623,558
Kentucky,Mason County,11,4,1048,537,511
Kentucky,Mason County,11,5,981,525,456
Kentucky,Mason County,11,6,1085,528,557
Kentucky,Mason County,11,7,930,463,467
Kentucky,Mason County,11,8,947,447,500
Kentucky,Mason County,11,9,958,457,501
Kentucky,Mason County,11,10,1125,554,571
Kentucky,Mason County,11,11,1205,608,597
Kentucky,Mason County,11,12,1190,577,613
Kentucky,Mason County,11,13,1152,525,627
Kentucky,Mason County,11,14,1098,529,569
Kentucky,Mason County,11,15,781,323,458
Kentucky,Mason County,11,16,598,249,349
Kentucky,Mason County,11,17,330,139,191
Kentucky,Mason County,11,18,315,106,209
Kentucky,Mason County,12,0,17070,8320,8750
Kentucky,Mason County,12,1,1018,524,494
Kentucky,Mason County,12,2,1121,563,558
Kentucky,Mason County,12,3,1168,638,530
Kentucky,Mason County,12,4,1015,515,500
Kentucky,Mason County,12,5,957,518,439
Kentucky,Mason County,12,6,1123,556,567
Kentucky,Mason County,12,7,995,512,483
Kentucky,Mason County,12,8,887,411,476
Kentucky,Mason County,12,9,943,437,506
Kentucky,Mason County,12,10,1094,551,543
Kentucky,Mason County,12,11,1211,600,611
Kentucky,Mason County,12,12,1180,579,601
Kentucky,Mason County,12,13,1168,529,639
Kentucky,Mason County,12,14,1094,531,563
Kentucky,Mason County,12,15,842,369,473
Kentucky,Mason County,12,16,583,237,346
Kentucky,Mason County,12,17,364,146,218
Kentucky,Mason County,12,18,307,104,203
Kentucky,Meade County,1,0,28602,14341,14261
Kentucky,Meade County,1,1,2194,1147,1047
Kentucky,Meade County,1,2,2150,1103,1047
Kentucky,Meade County,1,3,2210,1112,1098
Kentucky,Meade County,1,4,1981,1007,974
Kentucky,Meade County,1,5,1899,934,965
Kentucky,Meade County,1,6,1947,983,964
Kentucky,Meade County,1,7,1934,971,963
Kentucky,Meade County,1,8,1927,960,967
Kentucky,Meade County,1,9,1899,953,946
Kentucky,Meade County,1,10,2247,1135,1112
Kentucky,Meade County,1,11,2096,1039,1057
Kentucky,Meade County,1,12,1696,859,837
Kentucky,Meade County,1,13,1447,761,686
Kentucky,Meade County,1,14,1016,484,532
Kentucky,Meade County,1,15,802,412,390
Kentucky,Meade County,1,16,550,257,293
Kentucky,Meade County,1,17,333,147,186
Kentucky,Meade County,1,18,274,77,197
Kentucky,Meade County,2,0,28613,14347,14266
Kentucky,Meade County,2,1,2196,1148,1048
Kentucky,Meade County,2,2,2153,1104,1049
Kentucky,Meade County,2,3,2209,1111,1098
Kentucky,Meade County,2,4,1981,1008,973
Kentucky,Meade County,2,5,1900,934,966
Kentucky,Meade County,2,6,1946,982,964
Kentucky,Meade County,2,7,1935,971,964
Kentucky,Meade County,2,8,1930,961,969
Kentucky,Meade County,2,9,1899,953,946
Kentucky,Meade County,2,10,2245,1135,1110
Kentucky,Meade County,2,11,2096,1039,1057
Kentucky,Meade County,2,12,1698,861,837
Kentucky,Meade County,2,13,1447,761,686
Kentucky,Meade County,2,14,1018,485,533
Kentucky,Meade County,2,15,802,412,390
Kentucky,Meade County,2,16,551,258,293
Kentucky,Meade County,2,17,333,147,186
Kentucky,Meade County,2,18,274,77,197
Kentucky,Meade County,3,0,28714,14414,14300
Kentucky,Meade County,3,1,2162,1127,1035
Kentucky,Meade County,3,2,2152,1104,1048
Kentucky,Meade County,3,3,2226,1122,1104
Kentucky,Meade County,3,4,1986,1016,970
Kentucky,Meade County,3,5,1919,948,971
Kentucky,Meade County,3,6,1986,1000,986
Kentucky,Meade County,3,7,1947,980,967
Kentucky,Meade County,3,8,1923,961,962
Kentucky,Meade County,3,9,1913,956,957
Kentucky,Meade County,3,10,2221,1128,1093
Kentucky,Meade County,3,11,2106,1043,1063
Kentucky,Meade County,3,12,1723,874,849
Kentucky,Meade County,3,13,1457,768,689
Kentucky,Meade County,3,14,1025,490,535
Kentucky,Meade County,3,15,806,412,394
Kentucky,Meade County,3,16,549,259,290
Kentucky,Meade County,3,17,334,147,187
Kentucky,Meade County,3,18,279,79,200
Kentucky,Meade County,4,0,29643,14845,14798
Kentucky,Meade County,4,1,2130,1070,1060
Kentucky,Meade County,4,2,2258,1140,1118
Kentucky,Meade County,4,3,2301,1168,1133
Kentucky,Meade County,4,4,1976,1011,965
Kentucky,Meade County,4,5,1974,966,1008
Kentucky,Meade County,4,6,2249,1143,1106
Kentucky,Meade County,4,7,2046,1038,1008
Kentucky,Meade County,4,8,1911,953,958
Kentucky,Meade County,4,9,2036,1009,1027
Kentucky,Meade County,4,10,2169,1109,1060
Kentucky,Meade County,4,11,2171,1073,1098
Kentucky,Meade County,4,12,1820,932,888
Kentucky,Meade County,4,13,1510,790,720
Kentucky,Meade County,4,14,1077,519,558
Kentucky,Meade County,4,15,823,406,417
Kentucky,Meade County,4,16,553,270,283
Kentucky,Meade County,4,17,349,158,191
Kentucky,Meade County,4,18,290,90,200
Kentucky,Meade County,5,0,29255,14656,14599
Kentucky,Meade County,5,1,1892,940,952
Kentucky,Meade County,5,2,2204,1105,1099
Kentucky,Meade County,5,3,2223,1147,1076
Kentucky,Meade County,5,4,1914,960,954
Kentucky,Meade County,5,5,1967,1018,949
Kentucky,Meade County,5,6,2179,1099,1080
Kentucky,Meade County,5,7,2009,1009,1000
Kentucky,Meade County,5,8,1869,940,929
Kentucky,Meade County,5,9,1991,988,1003
Kentucky,Meade County,5,10,2135,1084,1051
Kentucky,Meade County,5,11,2203,1091,1112
Kentucky,Meade County,5,12,1909,984,925
Kentucky,Meade County,5,13,1486,751,735
Kentucky,Meade County,5,14,1184,579,605
Kentucky,Meade County,5,15,834,409,425
Kentucky,Meade County,5,16,585,285,300
Kentucky,Meade County,5,17,369,166,203
Kentucky,Meade County,5,18,302,101,201
Kentucky,Meade County,6,0,29240,14775,14465
Kentucky,Meade County,6,1,1772,895,877
Kentucky,Meade County,6,2,2137,1074,1063
Kentucky,Meade County,6,3,2155,1135,1020
Kentucky,Meade County,6,4,1978,1010,968
Kentucky,Meade County,6,5,2050,1095,955
Kentucky,Meade County,6,6,2186,1107,1079
Kentucky,Meade County,6,7,1917,978,939
Kentucky,Meade County,6,8,1927,954,973
Kentucky,Meade County,6,9,1995,1004,991
Kentucky,Meade County,6,10,2039,1022,1017
Kentucky,Meade County,6,11,2185,1088,1097
Kentucky,Meade County,6,12,2001,1037,964
Kentucky,Meade County,6,13,1486,754,732
Kentucky,Meade County,6,14,1225,615,610
Kentucky,Meade County,6,15,895,435,460
Kentucky,Meade County,6,16,588,288,300
Kentucky,Meade County,6,17,388,174,214
Kentucky,Meade County,6,18,316,110,206
Kentucky,Meade County,7,0,29086,14661,14425
Kentucky,Meade County,7,1,1631,851,780
Kentucky,Meade County,7,2,2128,1079,1049
Kentucky,Meade County,7,3,2112,1077,1035
Kentucky,Meade County,7,4,1938,988,950
Kentucky,Meade County,7,5,1973,1049,924
Kentucky,Meade County,7,6,2106,1056,1050
Kentucky,Meade County,7,7,1966,995,971
Kentucky,Meade County,7,8,1905,944,961
Kentucky,Meade County,7,9,2028,1008,1020
Kentucky,Meade County,7,10,1948,1004,944
Kentucky,Meade County,7,11,2215,1101,1114
Kentucky,Meade County,7,12,1998,1015,983
Kentucky,Meade County,7,13,1581,808,773
Kentucky,Meade County,7,14,1301,667,634
Kentucky,Meade County,7,15,884,408,476
Kentucky,Meade County,7,16,650,319,331
Kentucky,Meade County,7,17,385,170,215
Kentucky,Meade County,7,18,337,122,215
Kentucky,Meade County,8,0,27725,13934,13791
Kentucky,Meade County,8,1,1422,734,688
Kentucky,Meade County,8,2,1855,948,907
Kentucky,Meade County,8,3,2011,1035,976
Kentucky,Meade County,8,4,1933,1006,927
Kentucky,Meade County,8,5,1632,816,816
Kentucky,Meade County,8,6,1721,851,870
Kentucky,Meade County,8,7,1825,921,904
Kentucky,Meade County,8,8,1871,934,937
Kentucky,Meade County,8,9,1906,957,949
Kentucky,Meade County,8,10,1954,984,970
Kentucky,Meade County,8,11,2199,1104,1095
Kentucky,Meade County,8,12,2040,1011,1029
Kentucky,Meade County,8,13,1664,857,807
Kentucky,Meade County,8,14,1385,729,656
Kentucky,Meade County,8,15,909,414,495
Kentucky,Meade County,8,16,679,334,345
Kentucky,Meade County,8,17,389,180,209
Kentucky,Meade County,8,18,330,119,211
Kentucky,Meade County,9,0,27959,14047,13912
Kentucky,Meade County,9,1,1436,715,721
Kentucky,Meade County,9,2,1818,910,908
Kentucky,Meade County,9,3,1954,1031,923
Kentucky,Meade County,9,4,1900,983,917
Kentucky,Meade County,9,5,1669,867,802
Kentucky,Meade County,9,6,1760,900,860
Kentucky,Meade County,9,7,1866,904,962
Kentucky,Meade County,9,8,1909,956,953
Kentucky,Meade County,9,9,1855,915,940
Kentucky,Meade County,9,10,1995,989,1006
Kentucky,Meade County,9,11,2144,1117,1027
Kentucky,Meade County,9,12,2097,1030,1067
Kentucky,Meade County,9,13,1769,916,853
Kentucky,Meade County,9,14,1393,713,680
Kentucky,Meade County,9,15,964,444,520
Kentucky,Meade County,9,16,683,328,355
Kentucky,Meade County,9,17,409,191,218
Kentucky,Meade County,9,18,338,138,200
Kentucky,Meade County,10,0,28033,14115,13918
Kentucky,Meade County,10,1,1451,739,712
Kentucky,Meade County,10,2,1765,908,857
Kentucky,Meade County,10,3,1947,1007,940
Kentucky,Meade County,10,4,1854,997,857
Kentucky,Meade County,10,5,1616,867,749
Kentucky,Meade County,10,6,1794,884,910
Kentucky,Meade County,10,7,1892,931,961
Kentucky,Meade County,10,8,1925,936,989
Kentucky,Meade County,10,9,1887,922,965
Kentucky,Meade County,10,10,1989,996,993
Kentucky,Meade County,10,11,2079,1054,1025
Kentucky,Meade County,10,12,2095,1034,1061
Kentucky,Meade County,10,13,1859,971,888
Kentucky,Meade County,10,14,1334,663,671
Kentucky,Meade County,10,15,1084,535,549
Kentucky,Meade County,10,16,692,327,365
Kentucky,Meade County,10,17,408,193,215
Kentucky,Meade County,10,18,362,151,211
Kentucky,Meade County,11,0,28623,14420,14203
Kentucky,Meade County,11,1,1542,771,771
Kentucky,Meade County,11,2,1800,943,857
Kentucky,Meade County,11,3,1939,967,972
Kentucky,Meade County,11,4,1816,967,849
Kentucky,Meade County,11,5,1704,912,792
Kentucky,Meade County,11,6,1841,923,918
Kentucky,Meade County,11,7,1984,969,1015
Kentucky,Meade County,11,8,2009,1014,995
Kentucky,Meade County,11,9,1905,928,977
Kentucky,Meade County,11,10,2013,1021,992
Kentucky,Meade County,11,11,2057,1040,1017
Kentucky,Meade County,11,12,2102,1039,1063
Kentucky,Meade County,11,13,1929,980,949
Kentucky,Meade County,11,14,1362,695,667
Kentucky,Meade County,11,15,1092,552,540
Kentucky,Meade County,11,16,740,352,388
Kentucky,Meade County,11,17,418,197,221
Kentucky,Meade County,11,18,370,150,220
Kentucky,Meade County,12,0,28572,14483,14089
Kentucky,Meade County,12,1,1530,771,759
Kentucky,Meade County,12,2,1753,920,833
Kentucky,Meade County,12,3,1920,990,930
Kentucky,Meade County,12,4,1756,926,830
Kentucky,Meade County,12,5,1731,912,819
Kentucky,Meade County,12,6,1776,926,850
Kentucky,Meade County,12,7,2011,983,1028
Kentucky,Meade County,12,8,2027,1026,1001
Kentucky,Meade County,12,9,1883,954,929
Kentucky,Meade County,12,10,2018,1005,1013
Kentucky,Meade County,12,11,1903,973,930
Kentucky,Meade County,12,12,2191,1090,1101
Kentucky,Meade County,12,13,1886,951,935
Kentucky,Meade County,12,14,1456,756,700
Kentucky,Meade County,12,15,1172,607,565
Kentucky,Meade County,12,16,731,327,404
Kentucky,Meade County,12,17,471,225,246
Kentucky,Meade County,12,18,357,141,216
Kentucky,Menifee County,1,0,6306,3147,3159
Kentucky,Menifee County,1,1,345,172,173
Kentucky,Menifee County,1,2,398,214,184
Kentucky,Menifee County,1,3,424,207,217
Kentucky,Menifee County,1,4,495,269,226
Kentucky,Menifee County,1,5,387,223,164
Kentucky,Menifee County,1,6,311,144,167
Kentucky,Menifee County,1,7,338,160,178
Kentucky,Menifee County,1,8,409,210,199
Kentucky,Menifee County,1,9,371,188,183
Kentucky,Menifee County,1,10,456,233,223
Kentucky,Menifee County,1,11,470,232,238
Kentucky,Menifee County,1,12,431,213,218
Kentucky,Menifee County,1,13,466,224,242
Kentucky,Menifee County,1,14,363,193,170
Kentucky,Menifee County,1,15,269,128,141
Kentucky,Menifee County,1,16,170,68,102
Kentucky,Menifee County,1,17,110,40,70
Kentucky,Menifee County,1,18,93,29,64
Kentucky,Menifee County,2,0,6309,3149,3160
Kentucky,Menifee County,2,1,345,172,173
Kentucky,Menifee County,2,2,398,214,184
Kentucky,Menifee County,2,3,424,207,217
Kentucky,Menifee County,2,4,495,269,226
Kentucky,Menifee County,2,5,387,223,164
Kentucky,Menifee County,2,6,310,144,166
Kentucky,Menifee County,2,7,338,160,178
Kentucky,Menifee County,2,8,409,210,199
Kentucky,Menifee County,2,9,370,187,183
Kentucky,Menifee County,2,10,457,233,224
Kentucky,Menifee County,2,11,472,233,239
Kentucky,Menifee County,2,12,431,213,218
Kentucky,Menifee County,2,13,466,224,242
Kentucky,Menifee County,2,14,364,194,170
Kentucky,Menifee County,2,15,270,129,141
Kentucky,Menifee County,2,16,170,68,102
Kentucky,Menifee County,2,17,110,40,70
Kentucky,Menifee County,2,18,93,29,64
Kentucky,Menifee County,3,0,6371,3196,3175
Kentucky,Menifee County,3,1,351,173,178
Kentucky,Menifee County,3,2,396,214,182
Kentucky,Menifee County,3,3,421,208,213
Kentucky,Menifee County,3,4,516,288,228
Kentucky,Menifee County,3,5,405,237,168
Kentucky,Menifee County,3,6,311,145,166
Kentucky,Menifee County,3,7,341,163,178
Kentucky,Menifee County,3,8,408,209,199
Kentucky,Menifee County,3,9,374,188,186
Kentucky,Menifee County,3,10,455,234,221
Kentucky,Menifee County,3,11,471,234,237
Kentucky,Menifee County,3,12,436,215,221
Kentucky,Menifee County,3,13,468,223,245
Kentucky,Menifee County,3,14,365,194,171
Kentucky,Menifee County,3,15,271,130,141
Kentucky,Menifee County,3,16,176,73,103
Kentucky,Menifee County,3,17,109,38,71
Kentucky,Menifee County,3,18,97,30,67
Kentucky,Menifee County,4,0,6419,3230,3189
Kentucky,Menifee County,4,1,365,181,184
Kentucky,Menifee County,4,2,373,199,174
Kentucky,Menifee County,4,3,425,217,208
Kentucky,Menifee County,4,4,511,287,224
Kentucky,Menifee County,4,5,414,244,170
Kentucky,Menifee County,4,6,298,138,160
Kentucky,Menifee County,4,7,348,174,174
Kentucky,Menifee County,4,8,391,194,197
Kentucky,Menifee County,4,9,396,194,202
Kentucky,Menifee County,4,10,449,232,217
Kentucky,Menifee County,4,11,485,242,243
Kentucky,Menifee County,4,12,445,223,222
Kentucky,Menifee County,4,13,470,225,245
Kentucky,Menifee County,4,14,359,184,175
Kentucky,Menifee County,4,15,288,142,146
Kentucky,Menifee County,4,16,199,90,109
Kentucky,Menifee County,4,17,105,33,72
Kentucky,Menifee County,4,18,98,31,67
Kentucky,Menifee County,5,0,6338,3189,3149
Kentucky,Menifee County,5,1,323,165,158
Kentucky,Menifee County,5,2,371,176,195
Kentucky,Menifee County,5,3,390,210,180
Kentucky,Menifee County,5,4,468,260,208
Kentucky,Menifee County,5,5,426,251,175
Kentucky,Menifee County,5,6,309,153,156
Kentucky,Menifee County,5,7,347,173,174
Kentucky,Menifee County,5,8,370,189,181
Kentucky,Menifee County,5,9,390,188,202
Kentucky,Menifee County,5,10,434,224,210
Kentucky,Menifee County,5,11,490,243,247
Kentucky,Menifee County,5,12,455,232,223
Kentucky,Menifee County,5,13,457,221,236
Kentucky,Menifee County,5,14,370,183,187
Kentucky,Menifee County,5,15,317,161,156
Kentucky,Menifee County,5,16,212,93,119
Kentucky,Menifee County,5,17,103,36,67
Kentucky,Menifee County,5,18,106,31,75
Kentucky,Menifee County,6,0,6341,3198,3143
Kentucky,Menifee County,6,1,336,173,163
Kentucky,Menifee County,6,2,343,163,180
Kentucky,Menifee County,6,3,387,212,175
Kentucky,Menifee County,6,4,463,265,198
Kentucky,Menifee County,6,5,417,231,186
Kentucky,Menifee County,6,6,321,174,147
Kentucky,Menifee County,6,7,321,161,160
Kentucky,Menifee County,6,8,358,176,182
Kentucky,Menifee County,6,9,401,201,200
Kentucky,Menifee County,6,10,428,217,211
Kentucky,Menifee County,6,11,490,245,245
Kentucky,Menifee County,6,12,468,239,229
Kentucky,Menifee County,6,13,468,219,249
Kentucky,Menifee County,6,14,371,186,185
Kentucky,Menifee County,6,15,324,165,159
Kentucky,Menifee County,6,16,220,99,121
Kentucky,Menifee County,6,17,115,40,75
Kentucky,Menifee County,6,18,110,32,78
Kentucky,Menifee County,7,0,6304,3191,3113
Kentucky,Menifee County,7,1,316,158,158
Kentucky,Menifee County,7,2,321,161,160
Kentucky,Menifee County,7,3,364,194,170
Kentucky,Menifee County,7,4,436,261,175
Kentucky,Menifee County,7,5,399,215,184
Kentucky,Menifee County,7,6,356,196,160
Kentucky,Menifee County,7,7,324,154,170
Kentucky,Menifee County,7,8,349,170,179
Kentucky,Menifee County,7,9,388,201,187
Kentucky,Menifee County,7,10,418,221,197
Kentucky,Menifee County,7,11,503,253,250
Kentucky,Menifee County,7,12,491,245,246
Kentucky,Menifee County,7,13,473,225,248
Kentucky,Menifee County,7,14,391,193,198
Kentucky,Menifee County,7,15,316,160,156
Kentucky,Menifee County,7,16,221,107,114
Kentucky,Menifee County,7,17,132,48,84
Kentucky,Menifee County,7,18,106,29,77
Kentucky,Menifee County,8,0,6373,3232,3141
Kentucky,Menifee County,8,1,332,185,147
Kentucky,Menifee County,8,2,321,168,153
Kentucky,Menifee County,8,3,331,181,150
Kentucky,Menifee County,8,4,450,258,192
Kentucky,Menifee County,8,5,379,210,169
Kentucky,Menifee County,8,6,360,201,159
Kentucky,Menifee County,8,7,334,161,173
Kentucky,Menifee County,8,8,337,163,174
Kentucky,Menifee County,8,9,418,211,207
Kentucky,Menifee County,8,10,397,201,196
Kentucky,Menifee County,8,11,511,262,249
Kentucky,Menifee County,8,12,515,257,258
Kentucky,Menifee County,8,13,476,235,241
Kentucky,Menifee County,8,14,426,196,230
Kentucky,Menifee County,8,15,307,146,161
Kentucky,Menifee County,8,16,230,117,113
Kentucky,Menifee County,8,17,142,54,88
Kentucky,Menifee County,8,18,107,26,81
Kentucky,Menifee County,9,0,6449,3264,3185
Kentucky,Menifee County,9,1,359,184,175
Kentucky,Menifee County,9,2,335,179,156
Kentucky,Menifee County,9,3,318,172,146
Kentucky,Menifee County,9,4,458,271,187
Kentucky,Menifee County,9,5,385,219,166
Kentucky,Menifee County,9,6,363,208,155
Kentucky,Menifee County,9,7,331,151,180
Kentucky,Menifee County,9,8,346,175,171
Kentucky,Menifee County,9,9,419,208,211
Kentucky,Menifee County,9,10,391,188,203
Kentucky,Menifee County,9,11,495,251,244
Kentucky,Menifee County,9,12,521,257,264
Kentucky,Menifee County,9,13,477,245,232
Kentucky,Menifee County,9,14,452,209,243
Kentucky,Menifee County,9,15,295,133,162
Kentucky,Menifee County,9,16,232,118,114
Kentucky,Menifee County,9,17,163,71,92
Kentucky,Menifee County,9,18,109,25,84
Kentucky,Menifee County,10,0,6465,3289,3176
Kentucky,Menifee County,10,1,345,172,173
Kentucky,Menifee County,10,2,330,175,155
Kentucky,Menifee County,10,3,332,174,158
Kentucky,Menifee County,10,4,425,261,164
Kentucky,Menifee County,10,5,354,202,152
Kentucky,Menifee County,10,6,382,220,162
Kentucky,Menifee County,10,7,336,163,173
Kentucky,Menifee County,10,8,346,171,175
Kentucky,Menifee County,10,9,403,203,200
Kentucky,Menifee County,10,10,406,204,202
Kentucky,Menifee County,10,11,499,254,245
Kentucky,Menifee County,10,12,539,268,271
Kentucky,Menifee County,10,13,480,249,231
Kentucky,Menifee County,10,14,442,211,231
Kentucky,Menifee County,10,15,326,148,178
Kentucky,Menifee County,10,16,249,118,131
Kentucky,Menifee County,10,17,157,66,91
Kentucky,Menifee County,10,18,114,30,84
Kentucky,Menifee County,11,0,6437,3287,3150
Kentucky,Menifee County,11,1,324,170,154
Kentucky,Menifee County,11,2,303,152,151
Kentucky,Menifee County,11,3,311,161,150
Kentucky,Menifee County,11,4,433,269,164
Kentucky,Menifee County,11,5,373,212,161
Kentucky,Menifee County,11,6,367,204,163
Kentucky,Menifee County,11,7,316,169,147
Kentucky,Menifee County,11,8,336,167,169
Kentucky,Menifee County,11,9,407,201,206
Kentucky,Menifee County,11,10,427,215,212
Kentucky,Menifee County,11,11,469,240,229
Kentucky,Menifee County,11,12,539,266,273
Kentucky,Menifee County,11,13,494,255,239
Kentucky,Menifee County,11,14,469,229,240
Kentucky,Menifee County,11,15,329,156,173
Kentucky,Menifee County,11,16,255,116,139
Kentucky,Menifee County,11,17,161,68,93
Kentucky,Menifee County,11,18,124,37,87
Kentucky,Menifee County,12,0,6489,3286,3203
Kentucky,Menifee County,12,1,310,164,146
Kentucky,Menifee County,12,2,310,144,166
Kentucky,Menifee County,12,3,321,156,165
Kentucky,Menifee County,12,4,418,255,163
Kentucky,Menifee County,12,5,373,215,158
Kentucky,Menifee County,12,6,370,201,169
Kentucky,Menifee County,12,7,334,187,147
Kentucky,Menifee County,12,8,336,154,182
Kentucky,Menifee County,12,9,388,191,197
Kentucky,Menifee County,12,10,443,223,220
Kentucky,Menifee County,12,11,455,247,208
Kentucky,Menifee County,12,12,551,265,286
Kentucky,Menifee County,12,13,489,246,243
Kentucky,Menifee County,12,14,485,247,238
Kentucky,Menifee County,12,15,351,161,190
Kentucky,Menifee County,12,16,263,118,145
Kentucky,Menifee County,12,17,163,71,92
Kentucky,Menifee County,12,18,129,41,88
Kentucky,Mercer County,1,0,21331,10407,10924
Kentucky,Mercer County,1,1,1275,648,627
Kentucky,Mercer County,1,2,1337,706,631
Kentucky,Mercer County,1,3,1462,743,719
Kentucky,Mercer County,1,4,1441,772,669
Kentucky,Mercer County,1,5,1022,525,497
Kentucky,Mercer County,1,6,1138,567,571
Kentucky,Mercer County,1,7,1165,572,593
Kentucky,Mercer County,1,8,1349,664,685
Kentucky,Mercer County,1,9,1434,677,757
Kentucky,Mercer County,1,10,1666,814,852
Kentucky,Mercer County,1,11,1700,850,850
Kentucky,Mercer County,1,12,1525,746,779
Kentucky,Mercer County,1,13,1422,690,732
Kentucky,Mercer County,1,14,1119,518,601
Kentucky,Mercer County,1,15,837,379,458
Kentucky,Mercer County,1,16,571,241,330
Kentucky,Mercer County,1,17,455,174,281
Kentucky,Mercer County,1,18,413,121,292
Kentucky,Mercer County,2,0,21311,10395,10916
Kentucky,Mercer County,2,1,1275,648,627
Kentucky,Mercer County,2,2,1333,704,629
Kentucky,Mercer County,2,3,1459,740,719
Kentucky,Mercer County,2,4,1439,771,668
Kentucky,Mercer County,2,5,1021,524,497
Kentucky,Mercer County,2,6,1138,567,571
Kentucky,Mercer County,2,7,1165,572,593
Kentucky,Mercer County,2,8,1349,664,685
Kentucky,Mercer County,2,9,1430,675,755
Kentucky,Mercer County,2,10,1664,814,850
Kentucky,Mercer County,2,11,1699,849,850
Kentucky,Mercer County,2,12,1525,746,779
Kentucky,Mercer County,2,13,1419,688,731
Kentucky,Mercer County,2,14,1119,518,601
Kentucky,Mercer County,2,15,837,379,458
Kentucky,Mercer County,2,16,571,241,330
Kentucky,Mercer County,2,17,455,174,281
Kentucky,Mercer County,2,18,413,121,292
Kentucky,Mercer County,3,0,21308,10392,10916
Kentucky,Mercer County,3,1,1285,650,635
Kentucky,Mercer County,3,2,1329,707,622
Kentucky,Mercer County,3,3,1452,735,717
Kentucky,Mercer County,3,4,1439,767,672
Kentucky,Mercer County,3,5,1039,534,505
Kentucky,Mercer County,3,6,1138,564,574
Kentucky,Mercer County,3,7,1176,579,597
Kentucky,Mercer County,3,8,1323,648,675
Kentucky,Mercer County,3,9,1429,677,752
Kentucky,Mercer County,3,10,1668,809,859
Kentucky,Mercer County,3,11,1690,848,842
Kentucky,Mercer County,3,12,1534,752,782
Kentucky,Mercer County,3,13,1417,680,737
Kentucky,Mercer County,3,14,1119,524,595
Kentucky,Mercer County,3,15,840,381,459
Kentucky,Mercer County,3,16,570,245,325
Kentucky,Mercer County,3,17,448,170,278
Kentucky,Mercer County,3,18,412,122,290
Kentucky,Mercer County,4,0,21275,10387,10888
Kentucky,Mercer County,4,1,1314,661,653
Kentucky,Mercer County,4,2,1278,689,589
Kentucky,Mercer County,4,3,1366,685,681
Kentucky,Mercer County,4,4,1417,747,670
Kentucky,Mercer County,4,5,1092,575,517
Kentucky,Mercer County,4,6,1090,537,553
Kentucky,Mercer County,4,7,1196,605,591
Kentucky,Mercer County,4,8,1209,585,624
Kentucky,Mercer County,4,9,1434,693,741
Kentucky,Mercer County,4,10,1697,801,896
Kentucky,Mercer County,4,11,1679,847,832
Kentucky,Mercer County,4,12,1589,780,809
Kentucky,Mercer County,4,13,1467,703,764
Kentucky,Mercer County,4,14,1138,545,593
Kentucky,Mercer County,4,15,860,385,475
Kentucky,Mercer County,4,16,591,267,324
Kentucky,Mercer County,4,17,437,158,279
Kentucky,Mercer County,4,18,421,124,297
Kentucky,Mercer County,5,0,21323,10414,10909
Kentucky,Mercer County,5,1,1349,689,660
Kentucky,Mercer County,5,2,1292,676,616
Kentucky,Mercer County,5,3,1363,713,650
Kentucky,Mercer County,5,4,1394,739,655
Kentucky,Mercer County,5,5,1129,581,548
Kentucky,Mercer County,5,6,1054,525,529
Kentucky,Mercer County,5,7,1188,583,605
Kentucky,Mercer County,5,8,1196,586,610
Kentucky,Mercer County,5,9,1408,687,721
Kentucky,Mercer County,5,10,1632,770,862
Kentucky,Mercer County,5,11,1714,861,853
Kentucky,Mercer County,5,12,1598,790,808
Kentucky,Mercer County,5,13,1421,680,741
Kentucky,Mercer County,5,14,1234,583,651
Kentucky,Mercer County,5,15,878,400,478
Kentucky,Mercer County,5,16,623,273,350
Kentucky,Mercer County,5,17,415,156,259
Kentucky,Mercer County,5,18,435,122,313
Kentucky,Mercer County,6,0,21291,10417,10874
Kentucky,Mercer County,6,1,1304,677,627
Kentucky,Mercer County,6,2,1298,685,613
Kentucky,Mercer County,6,3,1330,700,630
Kentucky,Mercer County,6,4,1357,704,653
Kentucky,Mercer County,6,5,1170,604,566
Kentucky,Mercer County,6,6,1084,547,537
Kentucky,Mercer County,6,7,1175,590,585
Kentucky,Mercer County,6,8,1169,576,593
Kentucky,Mercer County,6,9,1365,653,712
Kentucky,Mercer County,6,10,1573,744,829
Kentucky,Mercer County,6,11,1725,862,863
Kentucky,Mercer County,6,12,1651,829,822
Kentucky,Mercer County,6,13,1415,670,745
Kentucky,Mercer County,6,14,1252,593,659
Kentucky,Mercer County,6,15,930,425,505
Kentucky,Mercer County,6,16,636,266,370
Kentucky,Mercer County,6,17,425,165,260
Kentucky,Mercer County,6,18,432,127,305
Kentucky,Mercer County,7,0,21360,10484,10876
Kentucky,Mercer County,7,1,1235,653,582
Kentucky,Mercer County,7,2,1297,674,623
Kentucky,Mercer County,7,3,1340,708,632
Kentucky,Mercer County,7,4,1330,700,630
Kentucky,Mercer County,7,5,1208,633,575
Kentucky,Mercer County,7,6,1145,573,572
Kentucky,Mercer County,7,7,1141,563,578
Kentucky,Mercer County,7,8,1162,587,575
Kentucky,Mercer County,7,9,1365,653,712
Kentucky,Mercer County,7,10,1512,715,797
Kentucky,Mercer County,7,11,1760,872,888
Kentucky,Mercer County,7,12,1653,823,830
Kentucky,Mercer County,7,13,1449,711,738
Kentucky,Mercer County,7,14,1281,600,681
Kentucky,Mercer County,7,15,949,441,508
Kentucky,Mercer County,7,16,669,278,391
Kentucky,Mercer County,7,17,428,170,258
Kentucky,Mercer County,7,18,436,130,306
Kentucky,Mercer County,8,0,21377,10477,10900
Kentucky,Mercer County,8,1,1260,668,592
Kentucky,Mercer County,8,2,1297,659,638
Kentucky,Mercer County,8,3,1350,726,624
Kentucky,Mercer County,8,4,1298,661,637
Kentucky,Mercer County,8,5,1249,652,597
Kentucky,Mercer County,8,6,1144,565,579
Kentucky,Mercer County,8,7,1129,563,566
Kentucky,Mercer County,8,8,1174,593,581
Kentucky,Mercer County,8,9,1298,629,669
Kentucky,Mercer County,8,10,1426,685,741
Kentucky,Mercer County,8,11,1779,864,915
Kentucky,Mercer County,8,12,1659,825,834
Kentucky,Mercer County,8,13,1493,727,766
Kentucky,Mercer County,8,14,1333,642,691
Kentucky,Mercer County,8,15,963,437,526
Kentucky,Mercer County,8,16,680,295,385
Kentucky,Mercer County,8,17,421,166,255
Kentucky,Mercer County,8,18,424,120,304
Kentucky,Mercer County,9,0,21405,10459,10946
Kentucky,Mercer County,9,1,1278,679,599
Kentucky,Mercer County,9,2,1293,649,644
Kentucky,Mercer County,9,3,1371,728,643
Kentucky,Mercer County,9,4,1245,625,620
Kentucky,Mercer County,9,5,1263,648,615
Kentucky,Mercer County,9,6,1198,609,589
Kentucky,Mercer County,9,7,1097,537,560
Kentucky,Mercer County,9,8,1181,587,594
Kentucky,Mercer County,9,9,1213,585,628
Kentucky,Mercer County,9,10,1414,689,725
Kentucky,Mercer County,9,11,1785,853,932
Kentucky,Mercer County,9,12,1643,834,809
Kentucky,Mercer County,9,13,1509,728,781
Kentucky,Mercer County,9,14,1380,653,727
Kentucky,Mercer County,9,15,982,455,527
Kentucky,Mercer County,9,16,703,304,399
Kentucky,Mercer County,9,17,441,186,255
Kentucky,Mercer County,9,18,409,110,299
Kentucky,Mercer County,10,0,21542,10577,10965
Kentucky,Mercer County,10,1,1220,638,582
Kentucky,Mercer County,10,2,1340,695,645
Kentucky,Mercer County,10,3,1354,707,647
Kentucky,Mercer County,10,4,1259,645,614
Kentucky,Mercer County,10,5,1209,630,579
Kentucky,Mercer County,10,6,1260,650,610
Kentucky,Mercer County,10,7,1106,562,544
Kentucky,Mercer County,10,8,1211,596,615
Kentucky,Mercer County,10,9,1173,579,594
Kentucky,Mercer County,10,10,1447,700,747
Kentucky,Mercer County,10,11,1681,800,881
Kentucky,Mercer County,10,12,1737,874,863
Kentucky,Mercer County,10,13,1537,755,782
Kentucky,Mercer County,10,14,1315,614,701
Kentucky,Mercer County,10,15,1071,487,584
Kentucky,Mercer County,10,16,736,332,404
Kentucky,Mercer County,10,17,462,191,271
Kentucky,Mercer County,10,18,424,122,302
Kentucky,Mercer County,11,0,21702,10643,11059
Kentucky,Mercer County,11,1,1270,653,617
Kentucky,Mercer County,11,2,1311,694,617
Kentucky,Mercer County,11,3,1371,704,667
Kentucky,Mercer County,11,4,1249,660,589
Kentucky,Mercer County,11,5,1209,622,587
Kentucky,Mercer County,11,6,1298,668,630
Kentucky,Mercer County,11,7,1179,602,577
Kentucky,Mercer County,11,8,1216,606,610
Kentucky,Mercer County,11,9,1175,574,601
Kentucky,Mercer County,11,10,1412,689,723
Kentucky,Mercer County,11,11,1619,767,852
Kentucky,Mercer County,11,12,1738,856,882
Kentucky,Mercer County,11,13,1592,800,792
Kentucky,Mercer County,11,14,1291,591,700
Kentucky,Mercer County,11,15,1097,495,602
Kentucky,Mercer County,11,16,755,342,413
Kentucky,Mercer County,11,17,481,189,292
Kentucky,Mercer County,11,18,439,131,308
Kentucky,Mercer County,12,0,21933,10742,11191
Kentucky,Mercer County,12,1,1319,688,631
Kentucky,Mercer County,12,2,1305,692,613
Kentucky,Mercer County,12,3,1385,716,669
Kentucky,Mercer County,12,4,1277,665,612
Kentucky,Mercer County,12,5,1184,614,570
Kentucky,Mercer County,12,6,1360,698,662
Kentucky,Mercer County,12,7,1224,619,605
Kentucky,Mercer County,12,8,1221,598,623
Kentucky,Mercer County,12,9,1195,585,610
Kentucky,Mercer County,12,10,1372,663,709
Kentucky,Mercer County,12,11,1574,753,821
Kentucky,Mercer County,12,12,1727,837,890
Kentucky,Mercer County,12,13,1648,826,822
Kentucky,Mercer County,12,14,1303,614,689
Kentucky,Mercer County,12,15,1095,478,617
Kentucky,Mercer County,12,16,785,353,432
Kentucky,Mercer County,12,17,522,212,310
Kentucky,Mercer County,12,18,437,131,306
Kentucky,Metcalfe County,1,0,10099,5008,5091
Kentucky,Metcalfe County,1,1,643,346,297
Kentucky,Metcalfe County,1,2,699,349,350
Kentucky,Metcalfe County,1,3,648,329,319
Kentucky,Metcalfe County,1,4,680,370,310
Kentucky,Metcalfe County,1,5,585,293,292
Kentucky,Metcalfe County,1,6,522,261,261
Kentucky,Metcalfe County,1,7,568,287,281
Kentucky,Metcalfe County,1,8,596,302,294
Kentucky,Metcalfe County,1,9,702,342,360
Kentucky,Metcalfe County,1,10,769,388,381
Kentucky,Metcalfe County,1,11,761,376,385
Kentucky,Metcalfe County,1,12,700,345,355
Kentucky,Metcalfe County,1,13,582,271,311
Kentucky,Metcalfe County,1,14,505,255,250
Kentucky,Metcalfe County,1,15,424,193,231
Kentucky,Metcalfe County,1,16,331,166,165
Kentucky,Metcalfe County,1,17,215,90,125
Kentucky,Metcalfe County,1,18,169,45,124
Kentucky,Metcalfe County,2,0,10116,5017,5099
Kentucky,Metcalfe County,2,1,645,347,298
Kentucky,Metcalfe County,2,2,699,349,350
Kentucky,Metcalfe County,2,3,649,329,320
Kentucky,Metcalfe County,2,4,680,370,310
Kentucky,Metcalfe County,2,5,587,295,292
Kentucky,Metcalfe County,2,6,522,261,261
Kentucky,Metcalfe County,2,7,569,287,282
Kentucky,Metcalfe County,2,8,596,302,294
Kentucky,Metcalfe County,2,9,703,343,360
Kentucky,Metcalfe County,2,10,770,388,382
Kentucky,Metcalfe County,2,11,762,377,385
Kentucky,Metcalfe County,2,12,701,345,356
Kentucky,Metcalfe County,2,13,584,272,312
Kentucky,Metcalfe County,2,14,508,257,251
Kentucky,Metcalfe County,2,15,425,194,231
Kentucky,Metcalfe County,2,16,331,166,165
Kentucky,Metcalfe County,2,17,215,90,125
Kentucky,Metcalfe County,2,18,170,45,125
Kentucky,Metcalfe County,3,0,10147,5039,5108
Kentucky,Metcalfe County,3,1,648,351,297
Kentucky,Metcalfe County,3,2,698,350,348
Kentucky,Metcalfe County,3,3,654,331,323
Kentucky,Metcalfe County,3,4,671,364,307
Kentucky,Metcalfe County,3,5,597,300,297
Kentucky,Metcalfe County,3,6,530,264,266
Kentucky,Metcalfe County,3,7,563,284,279
Kentucky,Metcalfe County,3,8,597,303,294
Kentucky,Metcalfe County,3,9,704,344,360
Kentucky,Metcalfe County,3,10,764,386,378
Kentucky,Metcalfe County,3,11,765,377,388
Kentucky,Metcalfe County,3,12,714,353,361
Kentucky,Metcalfe County,3,13,585,273,312
Kentucky,Metcalfe County,3,14,510,259,251
Kentucky,Metcalfe County,3,15,430,198,232
Kentucky,Metcalfe County,3,16,331,166,165
Kentucky,Metcalfe County,3,17,215,90,125
Kentucky,Metcalfe County,3,18,171,46,125
Kentucky,Metcalfe County,4,0,10070,4979,5091
Kentucky,Metcalfe County,4,1,647,342,305
Kentucky,Metcalfe County,4,2,697,356,341
Kentucky,Metcalfe County,4,3,673,344,329
Kentucky,Metcalfe County,4,4,623,334,289
Kentucky,Metcalfe County,4,5,604,309,295
Kentucky,Metcalfe County,4,6,530,253,277
Kentucky,Metcalfe County,4,7,542,270,272
Kentucky,Metcalfe County,4,8,579,286,293
Kentucky,Metcalfe County,4,9,678,335,343
Kentucky,Metcalfe County,4,10,740,380,360
Kentucky,Metcalfe County,4,11,755,367,388
Kentucky,Metcalfe County,4,12,734,361,373
Kentucky,Metcalfe County,4,13,607,283,324
Kentucky,Metcalfe County,4,14,506,255,251
Kentucky,Metcalfe County,4,15,435,198,237
Kentucky,Metcalfe County,4,16,334,159,175
Kentucky,Metcalfe County,4,17,210,90,120
Kentucky,Metcalfe County,4,18,176,57,119
Kentucky,Metcalfe County,5,0,9983,4960,5023
Kentucky,Metcalfe County,5,1,673,364,309
Kentucky,Metcalfe County,5,2,650,336,314
Kentucky,Metcalfe County,5,3,647,341,306
Kentucky,Metcalfe County,5,4,605,315,290
Kentucky,Metcalfe County,5,5,600,312,288
Kentucky,Metcalfe County,5,6,528,253,275
Kentucky,Metcalfe County,5,7,582,288,294
Kentucky,Metcalfe County,5,8,524,260,264
Kentucky,Metcalfe County,5,9,628,314,314
Kentucky,Metcalfe County,5,10,735,365,370
Kentucky,Metcalfe County,5,11,755,371,384
Kentucky,Metcalfe County,5,12,735,364,371
Kentucky,Metcalfe County,5,13,626,295,331
Kentucky,Metcalfe County,5,14,519,258,261
Kentucky,Metcalfe County,5,15,434,198,236
Kentucky,Metcalfe County,5,16,349,169,180
Kentucky,Metcalfe County,5,17,217,94,123
Kentucky,Metcalfe County,5,18,176,63,113
Kentucky,Metcalfe County,6,0,9960,4954,5006
Kentucky,Metcalfe County,6,1,681,362,319
Kentucky,Metcalfe County,6,2,642,327,315
Kentucky,Metcalfe County,6,3,656,338,318
Kentucky,Metcalfe County,6,4,574,304,270
Kentucky,Metcalfe County,6,5,609,318,291
Kentucky,Metcalfe County,6,6,529,255,274
Kentucky,Metcalfe County,6,7,570,285,285
Kentucky,Metcalfe County,6,8,519,258,261
Kentucky,Metcalfe County,6,9,618,311,307
Kentucky,Metcalfe County,6,10,715,353,362
Kentucky,Metcalfe County,6,11,751,379,372
Kentucky,Metcalfe County,6,12,746,373,373
Kentucky,Metcalfe County,6,13,632,296,336
Kentucky,Metcalfe County,6,14,516,259,257
Kentucky,Metcalfe County,6,15,442,210,232
Kentucky,Metcalfe County,6,16,358,166,192
Kentucky,Metcalfe County,6,17,226,96,130
Kentucky,Metcalfe County,6,18,176,64,112
Kentucky,Metcalfe County,7,0,9997,4979,5018
Kentucky,Metcalfe County,7,1,692,375,317
Kentucky,Metcalfe County,7,2,611,312,299
Kentucky,Metcalfe County,7,3,669,340,329
Kentucky,Metcalfe County,7,4,578,309,269
Kentucky,Metcalfe County,7,5,602,316,286
Kentucky,Metcalfe County,7,6,545,269,276
Kentucky,Metcalfe County,7,7,567,288,279
Kentucky,Metcalfe County,7,8,535,263,272
Kentucky,Metcalfe County,7,9,601,302,299
Kentucky,Metcalfe County,7,10,696,337,359
Kentucky,Metcalfe County,7,11,750,376,374
Kentucky,Metcalfe County,7,12,744,378,366
Kentucky,Metcalfe County,7,13,664,316,348
Kentucky,Metcalfe County,7,14,520,254,266
Kentucky,Metcalfe County,7,15,438,216,222
Kentucky,Metcalfe County,7,16,362,159,203
Kentucky,Metcalfe County,7,17,232,100,132
Kentucky,Metcalfe County,7,18,191,69,122
Kentucky,Metcalfe County,8,0,9925,4931,4994
Kentucky,Metcalfe County,8,1,661,350,311
Kentucky,Metcalfe County,8,2,636,336,300
Kentucky,Metcalfe County,8,3,671,341,330
Kentucky,Metcalfe County,8,4,574,294,280
Kentucky,Metcalfe County,8,5,550,289,261
Kentucky,Metcalfe County,8,6,559,281,278
Kentucky,Metcalfe County,8,7,526,253,273
Kentucky,Metcalfe County,8,8,564,281,283
Kentucky,Metcalfe County,8,9,572,293,279
Kentucky,Metcalfe County,8,10,681,339,342
Kentucky,Metcalfe County,8,11,736,369,367
Kentucky,Metcalfe County,8,12,734,367,367
Kentucky,Metcalfe County,8,13,670,327,343
Kentucky,Metcalfe County,8,14,551,251,300
Kentucky,Metcalfe County,8,15,459,229,230
Kentucky,Metcalfe County,8,16,364,170,194
Kentucky,Metcalfe County,8,17,223,97,126
Kentucky,Metcalfe County,8,18,194,64,130
Kentucky,Metcalfe County,9,0,10020,4967,5053
Kentucky,Metcalfe County,9,1,659,341,318
Kentucky,Metcalfe County,9,2,668,351,317
Kentucky,Metcalfe County,9,3,685,351,334
Kentucky,Metcalfe County,9,4,581,315,266
Kentucky,Metcalfe County,9,5,524,262,262
Kentucky,Metcalfe County,9,6,596,301,295
Kentucky,Metcalfe County,9,7,541,255,286
Kentucky,Metcalfe County,9,8,569,280,289
Kentucky,Metcalfe County,9,9,560,287,273
Kentucky,Metcalfe County,9,10,671,339,332
Kentucky,Metcalfe County,9,11,721,368,353
Kentucky,Metcalfe County,9,12,748,364,384
Kentucky,Metcalfe County,9,13,686,344,342
Kentucky,Metcalfe County,9,14,566,254,312
Kentucky,Metcalfe County,9,15,449,222,227
Kentucky,Metcalfe County,9,16,363,167,196
Kentucky,Metcalfe County,9,17,247,104,143
Kentucky,Metcalfe County,9,18,186,62,124
Kentucky,Metcalfe County,10,0,10093,5013,5080
Kentucky,Metcalfe County,10,1,644,337,307
Kentucky,Metcalfe County,10,2,718,385,333
Kentucky,Metcalfe County,10,3,644,324,320
Kentucky,Metcalfe County,10,4,595,321,274
Kentucky,Metcalfe County,10,5,540,267,273
Kentucky,Metcalfe County,10,6,618,320,298
Kentucky,Metcalfe County,10,7,507,238,269
Kentucky,Metcalfe County,10,8,606,299,307
Kentucky,Metcalfe County,10,9,546,273,273
Kentucky,Metcalfe County,10,10,646,342,304
Kentucky,Metcalfe County,10,11,741,363,378
Kentucky,Metcalfe County,10,12,735,363,372
Kentucky,Metcalfe County,10,13,687,345,342
Kentucky,Metcalfe County,10,14,577,264,313
Kentucky,Metcalfe County,10,15,476,228,248
Kentucky,Metcalfe County,10,16,355,163,192
Kentucky,Metcalfe County,10,17,265,117,148
Kentucky,Metcalfe County,10,18,193,64,129
Kentucky,Metcalfe County,11,0,10070,4994,5076
Kentucky,Metcalfe County,11,1,635,327,308
Kentucky,Metcalfe County,11,2,687,365,322
Kentucky,Metcalfe County,11,3,654,332,322
Kentucky,Metcalfe County,11,4,592,312,280
Kentucky,Metcalfe County,11,5,534,280,254
Kentucky,Metcalfe County,11,6,616,317,299
Kentucky,Metcalfe County,11,7,511,255,256
Kentucky,Metcalfe County,11,8,587,280,307
Kentucky,Metcalfe County,11,9,539,271,268
Kentucky,Metcalfe County,11,10,638,329,309
Kentucky,Metcalfe County,11,11,730,359,371
Kentucky,Metcalfe County,11,12,732,368,364
Kentucky,Metcalfe County,11,13,724,351,373
Kentucky,Metcalfe County,11,14,581,270,311
Kentucky,Metcalfe County,11,15,468,220,248
Kentucky,Metcalfe County,11,16,372,178,194
Kentucky,Metcalfe County,11,17,267,110,157
Kentucky,Metcalfe County,11,18,203,70,133
Kentucky,Metcalfe County,12,0,10071,4977,5094
Kentucky,Metcalfe County,12,1,618,306,312
Kentucky,Metcalfe County,12,2,686,372,314
Kentucky,Metcalfe County,12,3,634,326,308
Kentucky,Metcalfe County,12,4,597,308,289
Kentucky,Metcalfe County,12,5,523,260,263
Kentucky,Metcalfe County,12,6,616,322,294
Kentucky,Metcalfe County,12,7,534,272,262
Kentucky,Metcalfe County,12,8,582,283,299
Kentucky,Metcalfe County,12,9,554,277,277
Kentucky,Metcalfe County,12,10,615,314,301
Kentucky,Metcalfe County,12,11,696,340,356
Kentucky,Metcalfe County,12,12,749,368,381
Kentucky,Metcalfe County,12,13,713,357,356
Kentucky,Metcalfe County,12,14,607,290,317
Kentucky,Metcalfe County,12,15,480,208,272
Kentucky,Metcalfe County,12,16,371,190,181
Kentucky,Metcalfe County,12,17,283,116,167
Kentucky,Metcalfe County,12,18,213,68,145
Kentucky,Monroe County,1,0,10963,5425,5538
Kentucky,Monroe County,1,1,643,322,321
Kentucky,Monroe County,1,2,667,363,304
Kentucky,Monroe County,1,3,758,379,379
Kentucky,Monroe County,1,4,753,407,346
Kentucky,Monroe County,1,5,528,282,246
Kentucky,Monroe County,1,6,577,290,287
Kentucky,Monroe County,1,7,617,306,311
Kentucky,Monroe County,1,8,640,319,321
Kentucky,Monroe County,1,9,736,365,371
Kentucky,Monroe County,1,10,850,454,396
Kentucky,Monroe County,1,11,826,399,427
Kentucky,Monroe County,1,12,774,390,384
Kentucky,Monroe County,1,13,714,331,383
Kentucky,Monroe County,1,14,619,308,311
Kentucky,Monroe County,1,15,494,228,266
Kentucky,Monroe County,1,16,339,148,191
Kentucky,Monroe County,1,17,230,87,143
Kentucky,Monroe County,1,18,198,47,151
Kentucky,Monroe County,2,0,10963,5425,5538
Kentucky,Monroe County,2,1,643,322,321
Kentucky,Monroe County,2,2,667,363,304
Kentucky,Monroe County,2,3,758,379,379
Kentucky,Monroe County,2,4,753,407,346
Kentucky,Monroe County,2,5,528,282,246
Kentucky,Monroe County,2,6,577,290,287
Kentucky,Monroe County,2,7,617,306,311
Kentucky,Monroe County,2,8,640,319,321
Kentucky,Monroe County,2,9,736,365,371
Kentucky,Monroe County,2,10,850,454,396
Kentucky,Monroe County,2,11,826,399,427
Kentucky,Monroe County,2,12,774,390,384
Kentucky,Monroe County,2,13,714,331,383
Kentucky,Monroe County,2,14,619,308,311
Kentucky,Monroe County,2,15,494,228,266
Kentucky,Monroe County,2,16,339,148,191
Kentucky,Monroe County,2,17,230,87,143
Kentucky,Monroe County,2,18,198,47,151
Kentucky,Monroe County,3,0,10970,5432,5538
Kentucky,Monroe County,3,1,630,320,310
Kentucky,Monroe County,3,2,667,361,306
Kentucky,Monroe County,3,3,758,380,378
Kentucky,Monroe County,3,4,736,396,340
Kentucky,Monroe County,3,5,549,292,257
Kentucky,Monroe County,3,6,578,289,289
Kentucky,Monroe County,3,7,617,306,311
Kentucky,Monroe County,3,8,643,321,322
Kentucky,Monroe County,3,9,730,359,371
Kentucky,Monroe County,3,10,846,451,395
Kentucky,Monroe County,3,11,831,403,428
Kentucky,Monroe County,3,12,777,392,385
Kentucky,Monroe County,3,13,720,334,386
Kentucky,Monroe County,3,14,629,313,316
Kentucky,Monroe County,3,15,498,234,264
Kentucky,Monroe County,3,16,334,146,188
Kentucky,Monroe County,3,17,234,90,144
Kentucky,Monroe County,3,18,193,45,148
Kentucky,Monroe County,4,0,10918,5431,5487
Kentucky,Monroe County,4,1,616,329,287
Kentucky,Monroe County,4,2,664,354,310
Kentucky,Monroe County,4,3,746,382,364
Kentucky,Monroe County,4,4,721,390,331
Kentucky,Monroe County,4,5,606,335,271
Kentucky,Monroe County,4,6,552,276,276
Kentucky,Monroe County,4,7,610,294,316
Kentucky,Monroe County,4,8,638,317,321
Kentucky,Monroe County,4,9,709,341,368
Kentucky,Monroe County,4,10,806,428,378
Kentucky,Monroe County,4,11,853,418,435
Kentucky,Monroe County,4,12,769,383,386
Kentucky,Monroe County,4,13,741,351,390
Kentucky,Monroe County,4,14,623,302,321
Kentucky,Monroe County,4,15,497,246,251
Kentucky,Monroe County,4,16,327,139,188
Kentucky,Monroe County,4,17,247,97,150
Kentucky,Monroe County,4,18,193,49,144
Kentucky,Monroe County,5,0,10848,5418,5430
Kentucky,Monroe County,5,1,618,339,279
Kentucky,Monroe County,5,2,665,360,305
Kentucky,Monroe County,5,3,735,365,370
Kentucky,Monroe County,5,4,714,385,329
Kentucky,Monroe County,5,5,602,335,267
Kentucky,Monroe County,5,6,553,285,268
Kentucky,Monroe County,5,7,613,293,320
Kentucky,Monroe County,5,8,624,318,306
Kentucky,Monroe County,5,9,675,318,357
Kentucky,Monroe County,5,10,783,416,367
Kentucky,Monroe County,5,11,852,423,429
Kentucky,Monroe County,5,12,784,393,391
Kentucky,Monroe County,5,13,720,337,383
Kentucky,Monroe County,5,14,634,306,328
Kentucky,Monroe County,5,15,501,242,259
Kentucky,Monroe County,5,16,332,152,180
Kentucky,Monroe County,5,17,247,98,149
Kentucky,Monroe County,5,18,196,53,143
Kentucky,Monroe County,6,0,10715,5343,5372
Kentucky,Monroe County,6,1,609,330,279
Kentucky,Monroe County,6,2,661,351,310
Kentucky,Monroe County,6,3,700,364,336
Kentucky,Monroe County,6,4,680,365,315
Kentucky,Monroe County,6,5,608,319,289
Kentucky,Monroe County,6,6,552,288,264
Kentucky,Monroe County,6,7,601,290,311
Kentucky,Monroe County,6,8,593,305,288
Kentucky,Monroe County,6,9,666,319,347
Kentucky,Monroe County,6,10,761,399,362
Kentucky,Monroe County,6,11,837,418,419
Kentucky,Monroe County,6,12,802,402,400
Kentucky,Monroe County,6,13,702,336,366
Kentucky,Monroe County,6,14,636,300,336
Kentucky,Monroe County,6,15,522,248,274
Kentucky,Monroe County,6,16,355,164,191
Kentucky,Monroe County,6,17,240,97,143
Kentucky,Monroe County,6,18,190,48,142
Kentucky,Monroe County,7,0,10674,5314,5360
Kentucky,Monroe County,7,1,611,336,275
Kentucky,Monroe County,7,2,662,345,317
Kentucky,Monroe County,7,3,672,357,315
Kentucky,Monroe County,7,4,679,347,332
Kentucky,Monroe County,7,5,632,324,308
Kentucky,Monroe County,7,6,550,287,263
Kentucky,Monroe County,7,7,603,306,297
Kentucky,Monroe County,7,8,602,303,299
Kentucky,Monroe County,7,9,637,311,326
Kentucky,Monroe County,7,10,736,376,360
Kentucky,Monroe County,7,11,827,421,406
Kentucky,Monroe County,7,12,793,387,406
Kentucky,Monroe County,7,13,702,346,356
Kentucky,Monroe County,7,14,635,296,339
Kentucky,Monroe County,7,15,534,250,284
Kentucky,Monroe County,7,16,380,179,201
Kentucky,Monroe County,7,17,228,93,135
Kentucky,Monroe County,7,18,191,50,141
Kentucky,Monroe County,8,0,10618,5283,5335
Kentucky,Monroe County,8,1,650,343,307
Kentucky,Monroe County,8,2,640,335,305
Kentucky,Monroe County,8,3,667,359,308
Kentucky,Monroe County,8,4,660,332,328
Kentucky,Monroe County,8,5,615,319,296
Kentucky,Monroe County,8,6,579,303,276
Kentucky,Monroe County,8,7,560,279,281
Kentucky,Monroe County,8,8,613,302,311
Kentucky,Monroe County,8,9,632,313,319
Kentucky,Monroe County,8,10,709,352,357
Kentucky,Monroe County,8,11,805,424,381
Kentucky,Monroe County,8,12,792,379,413
Kentucky,Monroe County,8,13,723,362,361
Kentucky,Monroe County,8,14,630,288,342
Kentucky,Monroe County,8,15,527,250,277
Kentucky,Monroe County,8,16,388,186,202
Kentucky,Monroe County,8,17,240,102,138
Kentucky,Monroe County,8,18,188,55,133
Kentucky,Monroe County,9,0,10539,5234,5305
Kentucky,Monroe County,9,1,655,345,310
Kentucky,Monroe County,9,2,637,340,297
Kentucky,Monroe County,9,3,664,342,322
Kentucky,Monroe County,9,4,649,338,311
Kentucky,Monroe County,9,5,576,301,275
Kentucky,Monroe County,9,6,591,314,277
Kentucky,Monroe County,9,7,568,283,285
Kentucky,Monroe County,9,8,620,304,316
Kentucky,Monroe County,9,9,617,313,304
Kentucky,Monroe County,9,10,686,321,365
Kentucky,Monroe County,9,11,782,417,365
Kentucky,Monroe County,9,12,786,383,403
Kentucky,Monroe County,9,13,728,360,368
Kentucky,Monroe County,9,14,637,296,341
Kentucky,Monroe County,9,15,524,235,289
Kentucky,Monroe County,9,16,384,188,196
Kentucky,Monroe County,9,17,238,94,144
Kentucky,Monroe County,9,18,197,60,137
Kentucky,Monroe County,10,0,10597,5286,5311
Kentucky,Monroe County,10,1,674,350,324
Kentucky,Monroe County,10,2,634,350,284
Kentucky,Monroe County,10,3,670,357,313
Kentucky,Monroe County,10,4,628,336,292
Kentucky,Monroe County,10,5,593,309,284
Kentucky,Monroe County,10,6,585,316,269
Kentucky,Monroe County,10,7,566,290,276
Kentucky,Monroe County,10,8,633,288,345
Kentucky,Monroe County,10,9,634,331,303
Kentucky,Monroe County,10,10,682,325,357
Kentucky,Monroe County,10,11,761,398,363
Kentucky,Monroe County,10,12,807,403,404
Kentucky,Monroe County,10,13,737,364,373
Kentucky,Monroe County,10,14,633,287,346
Kentucky,Monroe County,10,15,543,256,287
Kentucky,Monroe County,10,16,375,166,209
Kentucky,Monroe County,10,17,250,108,142
Kentucky,Monroe County,10,18,192,52,140
Kentucky,Monroe County,11,0,10732,5345,5387
Kentucky,Monroe County,11,1,704,381,323
Kentucky,Monroe County,11,2,638,333,305
Kentucky,Monroe County,11,3,692,372,320
Kentucky,Monroe County,11,4,643,346,297
Kentucky,Monroe County,11,5,597,305,292
Kentucky,Monroe County,11,6,620,314,306
Kentucky,Monroe County,11,7,564,296,268
Kentucky,Monroe County,11,8,632,293,339
Kentucky,Monroe County,11,9,627,336,291
Kentucky,Monroe County,11,10,672,329,343
Kentucky,Monroe County,11,11,754,390,364
Kentucky,Monroe County,11,12,806,398,408
Kentucky,Monroe County,11,13,770,384,386
Kentucky,Monroe County,11,14,628,286,342
Kentucky,Monroe County,11,15,548,253,295
Kentucky,Monroe County,11,16,390,174,216
Kentucky,Monroe County,11,17,266,102,164
Kentucky,Monroe County,11,18,181,53,128
Kentucky,Monroe County,12,0,10650,5299,5351
Kentucky,Monroe County,12,1,709,374,335
Kentucky,Monroe County,12,2,646,352,294
Kentucky,Monroe County,12,3,663,358,305
Kentucky,Monroe County,12,4,622,333,289
Kentucky,Monroe County,12,5,594,315,279
Kentucky,Monroe County,12,6,635,316,319
Kentucky,Monroe County,12,7,555,286,269
Kentucky,Monroe County,12,8,597,288,309
Kentucky,Monroe County,12,9,614,315,299
Kentucky,Monroe County,12,10,672,333,339
Kentucky,Monroe County,12,11,735,368,367
Kentucky,Monroe County,12,12,811,409,402
Kentucky,Monroe County,12,13,749,369,380
Kentucky,Monroe County,12,14,641,298,343
Kentucky,Monroe County,12,15,552,251,301
Kentucky,Monroe County,12,16,404,180,224
Kentucky,Monroe County,12,17,286,111,175
Kentucky,Monroe County,12,18,165,43,122
Kentucky,Montgomery County,1,0,26499,12941,13558
Kentucky,Montgomery County,1,1,1804,912,892
Kentucky,Montgomery County,1,2,1763,904,859
Kentucky,Montgomery County,1,3,1865,960,905
Kentucky,Montgomery County,1,4,1704,885,819
Kentucky,Montgomery County,1,5,1463,710,753
Kentucky,Montgomery County,1,6,1666,832,834
Kentucky,Montgomery County,1,7,1857,934,923
Kentucky,Montgomery County,1,8,1935,976,959
Kentucky,Montgomery County,1,9,1899,930,969
Kentucky,Montgomery County,1,10,1965,981,984
Kentucky,Montgomery County,1,11,1869,906,963
Kentucky,Montgomery County,1,12,1701,784,917
Kentucky,Montgomery County,1,13,1615,764,851
Kentucky,Montgomery County,1,14,1112,535,577
Kentucky,Montgomery County,1,15,805,372,433
Kentucky,Montgomery County,1,16,590,257,333
Kentucky,Montgomery County,1,17,474,174,300
Kentucky,Montgomery County,1,18,412,125,287
Kentucky,Montgomery County,2,0,26507,12947,13560
Kentucky,Montgomery County,2,1,1804,912,892
Kentucky,Montgomery County,2,2,1764,905,859
Kentucky,Montgomery County,2,3,1868,963,905
Kentucky,Montgomery County,2,4,1706,886,820
Kentucky,Montgomery County,2,5,1463,710,753
Kentucky,Montgomery County,2,6,1667,832,835
Kentucky,Montgomery County,2,7,1857,934,923
Kentucky,Montgomery County,2,8,1935,976,959
Kentucky,Montgomery County,2,9,1901,931,970
Kentucky,Montgomery County,2,10,1966,982,984
Kentucky,Montgomery County,2,11,1868,905,963
Kentucky,Montgomery County,2,12,1701,784,917
Kentucky,Montgomery County,2,13,1615,764,851
Kentucky,Montgomery County,2,14,1112,535,577
Kentucky,Montgomery County,2,15,804,372,432
Kentucky,Montgomery County,2,16,590,257,333
Kentucky,Montgomery County,2,17,474,174,300
Kentucky,Montgomery County,2,18,412,125,287
Kentucky,Montgomery County,3,0,26549,12953,13596
Kentucky,Montgomery County,3,1,1833,920,913
Kentucky,Montgomery County,3,2,1753,897,856
Kentucky,Montgomery County,3,3,1872,969,903
Kentucky,Montgomery County,3,4,1689,878,811
Kentucky,Montgomery County,3,5,1489,726,763
Kentucky,Montgomery County,3,6,1653,820,833
Kentucky,Montgomery County,3,7,1852,927,925
Kentucky,Montgomery County,3,8,1926,972,954
Kentucky,Montgomery County,3,9,1902,937,965
Kentucky,Montgomery County,3,10,1973,979,994
Kentucky,Montgomery County,3,11,1872,910,962
Kentucky,Montgomery County,3,12,1710,789,921
Kentucky,Montgomery County,3,13,1618,761,857
Kentucky,Montgomery County,3,14,1125,540,585
Kentucky,Montgomery County,3,15,814,381,433
Kentucky,Montgomery County,3,16,580,248,332
Kentucky,Montgomery County,3,17,474,176,298
Kentucky,Montgomery County,3,18,414,123,291
Kentucky,Montgomery County,4,0,26751,13078,13673
Kentucky,Montgomery County,4,1,1847,941,906
Kentucky,Montgomery County,4,2,1733,884,849
Kentucky,Montgomery County,4,3,1865,973,892
Kentucky,Montgomery County,4,4,1617,835,782
Kentucky,Montgomery County,4,5,1588,780,808
Kentucky,Montgomery County,4,6,1649,819,830
Kentucky,Montgomery County,4,7,1798,886,912
Kentucky,Montgomery County,4,8,1896,948,948
Kentucky,Montgomery County,4,9,1960,985,975
Kentucky,Montgomery County,4,10,1980,969,1011
Kentucky,Montgomery County,4,11,1857,901,956
Kentucky,Montgomery County,4,12,1762,829,933
Kentucky,Montgomery County,4,13,1690,786,904
Kentucky,Montgomery County,4,14,1167,561,606
Kentucky,Montgomery County,4,15,847,405,442
Kentucky,Montgomery County,4,16,583,251,332
Kentucky,Montgomery County,4,17,484,193,291
Kentucky,Montgomery County,4,18,428,132,296
Kentucky,Montgomery County,5,0,26860,13122,13738
Kentucky,Montgomery County,5,1,1851,942,909
Kentucky,Montgomery County,5,2,1766,936,830
Kentucky,Montgomery County,5,3,1857,947,910
Kentucky,Montgomery County,5,4,1627,856,771
Kentucky,Montgomery County,5,5,1622,778,844
Kentucky,Montgomery County,5,6,1580,769,811
Kentucky,Montgomery County,5,7,1764,898,866
Kentucky,Montgomery County,5,8,1887,915,972
Kentucky,Montgomery County,5,9,2008,1019,989
Kentucky,Montgomery County,5,10,1947,954,993
Kentucky,Montgomery County,5,11,1842,890,952
Kentucky,Montgomery County,5,12,1791,844,947
Kentucky,Montgomery County,5,13,1667,760,907
Kentucky,Montgomery County,5,14,1261,603,658
Kentucky,Montgomery County,5,15,897,423,474
Kentucky,Montgomery County,5,16,602,269,333
Kentucky,Montgomery County,5,17,466,189,277
Kentucky,Montgomery County,5,18,425,130,295
Kentucky,Montgomery County,6,0,27229,13320,13909
Kentucky,Montgomery County,6,1,1875,987,888
Kentucky,Montgomery County,6,2,1814,940,874
Kentucky,Montgomery County,6,3,1845,951,894
Kentucky,Montgomery County,6,4,1635,851,784
Kentucky,Montgomery County,6,5,1710,821,889
Kentucky,Montgomery County,6,6,1619,809,810
Kentucky,Montgomery County,6,7,1740,872,868
Kentucky,Montgomery County,6,8,1891,926,965
Kentucky,Montgomery County,6,9,2011,1004,1007
Kentucky,Montgomery County,6,10,1932,962,970
Kentucky,Montgomery County,6,11,1858,893,965
Kentucky,Montgomery County,6,12,1833,873,960
Kentucky,Montgomery County,6,13,1633,749,884
Kentucky,Montgomery County,6,14,1343,629,714
Kentucky,Montgomery County,6,15,954,451,503
Kentucky,Montgomery County,6,16,634,271,363
Kentucky,Montgomery County,6,17,449,184,265
Kentucky,Montgomery County,6,18,453,147,306
Kentucky,Montgomery County,7,0,27365,13388,13977
Kentucky,Montgomery County,7,1,1859,988,871
Kentucky,Montgomery County,7,2,1821,941,880
Kentucky,Montgomery County,7,3,1807,935,872
Kentucky,Montgomery County,7,4,1666,864,802
Kentucky,Montgomery County,7,5,1723,857,866
Kentucky,Montgomery County,7,6,1572,789,783
Kentucky,Montgomery County,7,7,1736,864,872
Kentucky,Montgomery County,7,8,1871,892,979
Kentucky,Montgomery County,7,9,2005,1004,1001
Kentucky,Montgomery County,7,10,1946,948,998
Kentucky,Montgomery County,7,11,1887,937,950
Kentucky,Montgomery County,7,12,1803,832,971
Kentucky,Montgomery County,7,13,1622,767,855
Kentucky,Montgomery County,7,14,1444,669,775
Kentucky,Montgomery County,7,15,995,463,532
Kentucky,Montgomery County,7,16,681,299,382
Kentucky,Montgomery County,7,17,439,171,268
Kentucky,Montgomery County,7,18,488,168,320
Kentucky,Montgomery County,8,0,27576,13456,14120
Kentucky,Montgomery County,8,1,1861,997,864
Kentucky,Montgomery County,8,2,1799,892,907
Kentucky,Montgomery County,8,3,1840,933,907
Kentucky,Montgomery County,8,4,1740,899,841
Kentucky,Montgomery County,8,5,1598,819,779
Kentucky,Montgomery County,8,6,1693,829,864
Kentucky,Montgomery County,8,7,1683,835,848
Kentucky,Montgomery County,8,8,1842,890,952
Kentucky,Montgomery County,8,9,2001,987,1014
Kentucky,Montgomery County,8,10,1945,957,988
Kentucky,Montgomery County,8,11,1987,974,1013
Kentucky,Montgomery County,8,12,1792,845,947
Kentucky,Montgomery County,8,13,1630,770,860
Kentucky,Montgomery County,8,14,1526,694,832
Kentucky,Montgomery County,8,15,1024,479,545
Kentucky,Montgomery County,8,16,690,317,373
Kentucky,Montgomery County,8,17,439,184,255
Kentucky,Montgomery County,8,18,486,155,331
Kentucky,Montgomery County,9,0,27666,13546,14120
Kentucky,Montgomery County,9,1,1806,971,835
Kentucky,Montgomery County,9,2,1843,939,904
Kentucky,Montgomery County,9,3,1774,931,843
Kentucky,Montgomery County,9,4,1740,900,840
Kentucky,Montgomery County,9,5,1573,817,756
Kentucky,Montgomery County,9,6,1838,892,946
Kentucky,Montgomery County,9,7,1610,807,803
Kentucky,Montgomery County,9,8,1802,859,943
Kentucky,Montgomery County,9,9,1950,958,992
Kentucky,Montgomery County,9,10,1959,991,968
Kentucky,Montgomery County,9,11,2001,967,1034
Kentucky,Montgomery County,9,12,1819,849,970
Kentucky,Montgomery County,9,13,1689,797,892
Kentucky,Montgomery County,9,14,1534,694,840
Kentucky,Montgomery County,9,15,1058,491,567
Kentucky,Montgomery County,9,16,738,338,400
Kentucky,Montgomery County,9,17,442,176,266
Kentucky,Montgomery County,9,18,490,169,321
Kentucky,Montgomery County,10,0,27913,13689,14224
Kentucky,Montgomery County,10,1,1856,997,859
Kentucky,Montgomery County,10,2,1810,897,913
Kentucky,Montgomery County,10,3,1810,970,840
Kentucky,Montgomery County,10,4,1740,899,841
Kentucky,Montgomery County,10,5,1599,842,757
Kentucky,Montgomery County,10,6,1936,961,975
Kentucky,Montgomery County,10,7,1638,837,801
Kentucky,Montgomery County,10,8,1744,843,901
Kentucky,Montgomery County,10,9,1972,944,1028
Kentucky,Montgomery County,10,10,1974,994,980
Kentucky,Montgomery County,10,11,1957,959,998
Kentucky,Montgomery County,10,12,1798,853,945
Kentucky,Montgomery County,10,13,1712,792,920
Kentucky,Montgomery County,10,14,1537,688,849
Kentucky,Montgomery County,10,15,1136,525,611
Kentucky,Montgomery County,10,16,758,339,419
Kentucky,Montgomery County,10,17,456,185,271
Kentucky,Montgomery County,10,18,480,164,316
Kentucky,Montgomery County,11,0,28109,13743,14366
Kentucky,Montgomery County,11,1,1840,955,885
Kentucky,Montgomery County,11,2,1818,966,852
Kentucky,Montgomery County,11,3,1857,977,880
Kentucky,Montgomery County,11,4,1739,910,829
Kentucky,Montgomery County,11,5,1568,829,739
Kentucky,Montgomery County,11,6,2004,993,1011
Kentucky,Montgomery County,11,7,1638,833,805
Kentucky,Montgomery County,11,8,1738,818,920
Kentucky,Montgomery County,11,9,1928,915,1013
Kentucky,Montgomery County,11,10,2015,984,1031
Kentucky,Montgomery County,11,11,1908,933,975
Kentucky,Montgomery County,11,12,1826,880,946
Kentucky,Montgomery County,11,13,1761,802,959
Kentucky,Montgomery County,11,14,1522,702,820
Kentucky,Montgomery County,11,15,1193,536,657
Kentucky,Montgomery County,11,16,800,350,450
Kentucky,Montgomery County,11,17,479,201,278
Kentucky,Montgomery County,11,18,475,159,316
Kentucky,Montgomery County,12,0,28157,13747,14410
Kentucky,Montgomery County,12,1,1816,938,878
Kentucky,Montgomery County,12,2,1755,932,823
Kentucky,Montgomery County,12,3,1875,969,906
Kentucky,Montgomery County,12,4,1711,913,798
Kentucky,Montgomery County,12,5,1566,806,760
Kentucky,Montgomery County,12,6,2025,1045,980
Kentucky,Montgomery County,12,7,1661,806,855
Kentucky,Montgomery County,12,8,1738,841,897
Kentucky,Montgomery County,12,9,1871,876,995
Kentucky,Montgomery County,12,10,1992,970,1022
Kentucky,Montgomery County,12,11,1927,938,989
Kentucky,Montgomery County,12,12,1884,926,958
Kentucky,Montgomery County,12,13,1740,780,960
Kentucky,Montgomery County,12,14,1522,713,809
Kentucky,Montgomery County,12,15,1283,567,716
Kentucky,Montgomery County,12,16,819,350,469
Kentucky,Montgomery County,12,17,506,216,290
Kentucky,Montgomery County,12,18,466,161,305
Kentucky,Morgan County,1,0,13923,7889,6034
Kentucky,Morgan County,1,1,727,391,336
Kentucky,Morgan County,1,2,791,431,360
Kentucky,Morgan County,1,3,778,410,368
Kentucky,Morgan County,1,4,844,444,400
Kentucky,Morgan County,1,5,863,565,298
Kentucky,Morgan County,1,6,1078,706,372
Kentucky,Morgan County,1,7,1124,735,389
Kentucky,Morgan County,1,8,1052,648,404
Kentucky,Morgan County,1,9,1001,587,414
Kentucky,Morgan County,1,10,1034,603,431
Kentucky,Morgan County,1,11,1057,597,460
Kentucky,Morgan County,1,12,986,514,472
Kentucky,Morgan County,1,13,778,404,374
Kentucky,Morgan County,1,14,579,283,296
Kentucky,Morgan County,1,15,476,231,245
Kentucky,Morgan County,1,16,343,158,185
Kentucky,Morgan County,1,17,229,118,111
Kentucky,Morgan County,1,18,183,64,119
Kentucky,Morgan County,2,0,13921,7889,6032
Kentucky,Morgan County,2,1,727,391,336
Kentucky,Morgan County,2,2,791,431,360
Kentucky,Morgan County,2,3,778,410,368
Kentucky,Morgan County,2,4,844,444,400
Kentucky,Morgan County,2,5,863,565,298
Kentucky,Morgan County,2,6,1078,706,372
Kentucky,Morgan County,2,7,1124,735,389
Kentucky,Morgan County,2,8,1052,648,404
Kentucky,Morgan County,2,9,1002,588,414
Kentucky,Morgan County,2,10,1033,603,430
Kentucky,Morgan County,2,11,1055,596,459
Kentucky,Morgan County,2,12,987,515,472
Kentucky,Morgan County,2,13,778,404,374
Kentucky,Morgan County,2,14,579,283,296
Kentucky,Morgan County,2,15,475,230,245
Kentucky,Morgan County,2,16,343,158,185
Kentucky,Morgan County,2,17,229,118,111
Kentucky,Morgan County,2,18,183,64,119
Kentucky,Morgan County,3,0,13726,7704,6022
Kentucky,Morgan County,3,1,718,390,328
Kentucky,Morgan County,3,2,780,418,362
Kentucky,Morgan County,3,3,788,418,370
Kentucky,Morgan County,3,4,830,440,390
Kentucky,Morgan County,3,5,844,542,302
Kentucky,Morgan County,3,6,1038,669,369
Kentucky,Morgan County,3,7,1087,697,390
Kentucky,Morgan County,3,8,1028,623,405
Kentucky,Morgan County,3,9,986,569,417
Kentucky,Morgan County,3,10,1014,585,429
Kentucky,Morgan County,3,11,1044,587,457
Kentucky,Morgan County,3,12,989,516,473
Kentucky,Morgan County,3,13,783,403,380
Kentucky,Morgan County,3,14,569,279,290
Kentucky,Morgan County,3,15,473,228,245
Kentucky,Morgan County,3,16,341,158,183
Kentucky,Morgan County,3,17,234,118,116
Kentucky,Morgan County,3,18,180,64,116
Kentucky,Morgan County,4,0,13719,7707,6012
Kentucky,Morgan County,4,1,716,385,331
Kentucky,Morgan County,4,2,759,395,364
Kentucky,Morgan County,4,3,791,431,360
Kentucky,Morgan County,4,4,778,426,352
Kentucky,Morgan County,4,5,903,555,348
Kentucky,Morgan County,4,6,1000,657,343
Kentucky,Morgan County,4,7,1088,699,389
Kentucky,Morgan County,4,8,1014,617,397
Kentucky,Morgan County,4,9,992,575,417
Kentucky,Morgan County,4,10,994,572,422
Kentucky,Morgan County,4,11,1021,575,446
Kentucky,Morgan County,4,12,1010,537,473
Kentucky,Morgan County,4,13,851,435,416
Kentucky,Morgan County,4,14,556,280,276
Kentucky,Morgan County,4,15,464,215,249
Kentucky,Morgan County,4,16,345,163,182
Kentucky,Morgan County,4,17,256,122,134
Kentucky,Morgan County,4,18,181,68,113
Kentucky,Morgan County,5,0,13531,7602,5929
Kentucky,Morgan County,5,1,691,362,329
Kentucky,Morgan County,5,2,749,404,345
Kentucky,Morgan County,5,3,780,434,346
Kentucky,Morgan County,5,4,709,388,321
Kentucky,Morgan County,5,5,885,543,342
Kentucky,Morgan County,5,6,967,641,326
Kentucky,Morgan County,5,7,1072,682,390
Kentucky,Morgan County,5,8,972,591,381
Kentucky,Morgan County,5,9,1018,596,422
Kentucky,Morgan County,5,10,988,560,428
Kentucky,Morgan County,5,11,974,539,435
Kentucky,Morgan County,5,12,1005,541,464
Kentucky,Morgan County,5,13,875,449,426
Kentucky,Morgan County,5,14,618,308,310
Kentucky,Morgan County,5,15,453,219,234
Kentucky,Morgan County,5,16,343,157,186
Kentucky,Morgan County,5,17,251,113,138
Kentucky,Morgan County,5,18,181,75,106
Kentucky,Morgan County,6,0,13362,7555,5807
Kentucky,Morgan County,6,1,643,334,309
Kentucky,Morgan County,6,2,714,388,326
Kentucky,Morgan County,6,3,768,417,351
Kentucky,Morgan County,6,4,686,383,303
Kentucky,Morgan County,6,5,906,566,340
Kentucky,Morgan County,6,6,955,651,304
Kentucky,Morgan County,6,7,1043,665,378
Kentucky,Morgan County,6,8,967,589,378
Kentucky,Morgan County,6,9,1008,595,413
Kentucky,Morgan County,6,10,958,556,402
Kentucky,Morgan County,6,11,940,520,420
Kentucky,Morgan County,6,12,993,536,457
Kentucky,Morgan County,6,13,898,464,434
Kentucky,Morgan County,6,14,626,314,312
Kentucky,Morgan County,6,15,455,215,240
Kentucky,Morgan County,6,16,362,171,191
Kentucky,Morgan County,6,17,241,106,135
Kentucky,Morgan County,6,18,199,85,114
Kentucky,Morgan County,7,0,13343,7540,5803
Kentucky,Morgan County,7,1,643,345,298
Kentucky,Morgan County,7,2,703,378,325
Kentucky,Morgan County,7,3,716,384,332
Kentucky,Morgan County,7,4,682,387,295
Kentucky,Morgan County,7,5,908,567,341
Kentucky,Morgan County,7,6,985,665,320
Kentucky,Morgan County,7,7,1010,643,367
Kentucky,Morgan County,7,8,962,590,372
Kentucky,Morgan County,7,9,985,587,398
Kentucky,Morgan County,7,10,959,560,399
Kentucky,Morgan County,7,11,918,499,419
Kentucky,Morgan County,7,12,1022,553,469
Kentucky,Morgan County,7,13,912,469,443
Kentucky,Morgan County,7,14,660,332,328
Kentucky,Morgan County,7,15,469,214,255
Kentucky,Morgan County,7,16,366,180,186
Kentucky,Morgan County,7,17,232,97,135
Kentucky,Morgan County,7,18,211,90,121
Kentucky,Morgan County,8,0,13267,7498,5769
Kentucky,Morgan County,8,1,666,352,314
Kentucky,Morgan County,8,2,663,350,313
Kentucky,Morgan County,8,3,715,386,329
Kentucky,Morgan County,8,4,688,388,300
Kentucky,Morgan County,8,5,854,560,294
Kentucky,Morgan County,8,6,995,669,326
Kentucky,Morgan County,8,7,985,626,359
Kentucky,Morgan County,8,8,943,576,367
Kentucky,Morgan County,8,9,987,592,395
Kentucky,Morgan County,8,10,959,556,403
Kentucky,Morgan County,8,11,918,495,423
Kentucky,Morgan County,8,12,1008,552,456
Kentucky,Morgan County,8,13,928,472,456
Kentucky,Morgan County,8,14,701,356,345
Kentucky,Morgan County,8,15,464,213,251
Kentucky,Morgan County,8,16,347,170,177
Kentucky,Morgan County,8,17,230,91,139
Kentucky,Morgan County,8,18,216,94,122
Kentucky,Morgan County,9,0,13260,7485,5775
Kentucky,Morgan County,9,1,663,360,303
Kentucky,Morgan County,9,2,661,347,314
Kentucky,Morgan County,9,3,704,355,349
Kentucky,Morgan County,9,4,697,408,289
Kentucky,Morgan County,9,5,811,537,274
Kentucky,Morgan County,9,6,1037,692,345
Kentucky,Morgan County,9,7,957,613,344
Kentucky,Morgan County,9,8,939,576,363
Kentucky,Morgan County,9,9,958,577,381
Kentucky,Morgan County,9,10,979,565,414
Kentucky,Morgan County,9,11,884,473,411
Kentucky,Morgan County,9,12,990,538,452
Kentucky,Morgan County,9,13,952,493,459
Kentucky,Morgan County,9,14,747,373,374
Kentucky,Morgan County,9,15,476,230,246
Kentucky,Morgan County,9,16,339,155,184
Kentucky,Morgan County,9,17,239,105,134
Kentucky,Morgan County,9,18,227,88,139
Kentucky,Morgan County,10,0,13230,7476,5754
Kentucky,Morgan County,10,1,661,367,294
Kentucky,Morgan County,10,2,650,334,316
Kentucky,Morgan County,10,3,690,357,333
Kentucky,Morgan County,10,4,694,408,286
Kentucky,Morgan County,10,5,813,527,286
Kentucky,Morgan County,10,6,1040,697,343
Kentucky,Morgan County,10,7,920,606,314
Kentucky,Morgan County,10,8,931,559,372
Kentucky,Morgan County,10,9,913,554,359
Kentucky,Morgan County,10,10,1007,589,418
Kentucky,Morgan County,10,11,870,454,416
Kentucky,Morgan County,10,12,943,504,439
Kentucky,Morgan County,10,13,966,517,449
Kentucky,Morgan County,10,14,771,385,386
Kentucky,Morgan County,10,15,538,259,279
Kentucky,Morgan County,10,16,341,159,182
Kentucky,Morgan County,10,17,248,107,141
Kentucky,Morgan County,10,18,234,93,141
Kentucky,Morgan County,11,0,13372,7651,5721
Kentucky,Morgan County,11,1,642,364,278
Kentucky,Morgan County,11,2,640,345,295
Kentucky,Morgan County,11,3,688,359,329
Kentucky,Morgan County,11,4,681,396,285
Kentucky,Morgan County,11,5,815,550,265
Kentucky,Morgan County,11,6,1069,728,341
Kentucky,Morgan County,11,7,954,637,317
Kentucky,Morgan County,11,8,935,556,379
Kentucky,Morgan County,11,9,933,573,360
Kentucky,Morgan County,11,10,1012,599,413
Kentucky,Morgan County,11,11,872,467,405
Kentucky,Morgan County,11,12,929,497,432
Kentucky,Morgan County,11,13,954,516,438
Kentucky,Morgan County,11,14,829,416,413
Kentucky,Morgan County,11,15,548,264,284
Kentucky,Morgan County,11,16,369,165,204
Kentucky,Morgan County,11,17,272,130,142
Kentucky,Morgan County,11,18,230,89,141
Kentucky,Morgan County,12,0,13309,7643,5666
Kentucky,Morgan County,12,1,615,337,278
Kentucky,Morgan County,12,2,626,353,273
Kentucky,Morgan County,12,3,686,367,319
Kentucky,Morgan County,12,4,667,378,289
Kentucky,Morgan County,12,5,799,556,243
Kentucky,Morgan County,12,6,1062,704,358
Kentucky,Morgan County,12,7,958,656,302
Kentucky,Morgan County,12,8,901,534,367
Kentucky,Morgan County,12,9,950,579,371
Kentucky,Morgan County,12,10,995,599,396
Kentucky,Morgan County,12,11,878,476,402
Kentucky,Morgan County,12,12,894,479,415
Kentucky,Morgan County,12,13,962,519,443
Kentucky,Morgan County,12,14,837,421,416
Kentucky,Morgan County,12,15,580,287,293
Kentucky,Morgan County,12,16,391,166,225
Kentucky,Morgan County,12,17,268,139,129
Kentucky,Morgan County,12,18,240,93,147
Kentucky,Muhlenberg County,1,0,31499,15909,15590
Kentucky,Muhlenberg County,1,1,1766,977,789
Kentucky,Muhlenberg County,1,2,1905,978,927
Kentucky,Muhlenberg County,1,3,1976,1011,965
Kentucky,Muhlenberg County,1,4,2021,1054,967
Kentucky,Muhlenberg County,1,5,1898,1034,864
Kentucky,Muhlenberg County,1,6,1772,962,810
Kentucky,Muhlenberg County,1,7,1996,1083,913
Kentucky,Muhlenberg County,1,8,2064,1113,951
Kentucky,Muhlenberg County,1,9,2100,1112,988
Kentucky,Muhlenberg County,1,10,2363,1189,1174
Kentucky,Muhlenberg County,1,11,2313,1164,1149
Kentucky,Muhlenberg County,1,12,2163,1065,1098
Kentucky,Muhlenberg County,1,13,2052,1002,1050
Kentucky,Muhlenberg County,1,14,1675,794,881
Kentucky,Muhlenberg County,1,15,1216,538,678
Kentucky,Muhlenberg County,1,16,925,385,540
Kentucky,Muhlenberg County,1,17,721,292,429
Kentucky,Muhlenberg County,1,18,573,156,417
Kentucky,Muhlenberg County,2,0,31499,15909,15590
Kentucky,Muhlenberg County,2,1,1766,977,789
Kentucky,Muhlenberg County,2,2,1905,978,927
Kentucky,Muhlenberg County,2,3,1976,1011,965
Kentucky,Muhlenberg County,2,4,2021,1054,967
Kentucky,Muhlenberg County,2,5,1898,1034,864
Kentucky,Muhlenberg County,2,6,1772,962,810
Kentucky,Muhlenberg County,2,7,1996,1083,913
Kentucky,Muhlenberg County,2,8,2064,1113,951
Kentucky,Muhlenberg County,2,9,2100,1112,988
Kentucky,Muhlenberg County,2,10,2363,1189,1174
Kentucky,Muhlenberg County,2,11,2313,1164,1149
Kentucky,Muhlenberg County,2,12,2163,1065,1098
Kentucky,Muhlenberg County,2,13,2052,1002,1050
Kentucky,Muhlenberg County,2,14,1675,794,881
Kentucky,Muhlenberg County,2,15,1216,538,678
Kentucky,Muhlenberg County,2,16,925,385,540
Kentucky,Muhlenberg County,2,17,721,292,429
Kentucky,Muhlenberg County,2,18,573,156,417
Kentucky,Muhlenberg County,3,0,31657,16010,15647
Kentucky,Muhlenberg County,3,1,1761,970,791
Kentucky,Muhlenberg County,3,2,1903,982,921
Kentucky,Muhlenberg County,3,3,1974,1011,963
Kentucky,Muhlenberg County,3,4,2055,1077,978
Kentucky,Muhlenberg County,3,5,1993,1097,896
Kentucky,Muhlenberg County,3,6,1788,971,817
Kentucky,Muhlenberg County,3,7,1996,1082,914
Kentucky,Muhlenberg County,3,8,2061,1107,954
Kentucky,Muhlenberg County,3,9,2097,1111,986
Kentucky,Muhlenberg County,3,10,2346,1185,1161
Kentucky,Muhlenberg County,3,11,2327,1166,1161
Kentucky,Muhlenberg County,3,12,2166,1067,1099
Kentucky,Muhlenberg County,3,13,2051,1007,1044
Kentucky,Muhlenberg County,3,14,1681,797,884
Kentucky,Muhlenberg County,3,15,1228,544,684
Kentucky,Muhlenberg County,3,16,928,388,540
Kentucky,Muhlenberg County,3,17,725,291,434
Kentucky,Muhlenberg County,3,18,577,157,420
Kentucky,Muhlenberg County,4,0,31528,15973,15555
Kentucky,Muhlenberg County,4,1,1690,912,778
Kentucky,Muhlenberg County,4,2,1888,998,890
Kentucky,Muhlenberg County,4,3,1989,1019,970
Kentucky,Muhlenberg County,4,4,1990,1044,946
Kentucky,Muhlenberg County,4,5,2003,1117,886
Kentucky,Muhlenberg County,4,6,1810,976,834
Kentucky,Muhlenberg County,4,7,1970,1069,901
Kentucky,Muhlenberg County,4,8,2032,1084,948
Kentucky,Muhlenberg County,4,9,2086,1103,983
Kentucky,Muhlenberg County,4,10,2257,1166,1091
Kentucky,Muhlenberg County,4,11,2361,1166,1195
Kentucky,Muhlenberg County,4,12,2165,1065,1100
Kentucky,Muhlenberg County,4,13,2090,1044,1046
Kentucky,Muhlenberg County,4,14,1699,817,882
Kentucky,Muhlenberg County,4,15,1270,559,711
Kentucky,Muhlenberg County,4,16,927,395,532
Kentucky,Muhlenberg County,4,17,733,282,451
Kentucky,Muhlenberg County,4,18,568,157,411
Kentucky,Muhlenberg County,5,0,31382,15929,15453
Kentucky,Muhlenberg County,5,1,1630,870,760
Kentucky,Muhlenberg County,5,2,1862,993,869
Kentucky,Muhlenberg County,5,3,1945,992,953
Kentucky,Muhlenberg County,5,4,1946,1037,909
Kentucky,Muhlenberg County,5,5,2036,1131,905
Kentucky,Muhlenberg County,5,6,1779,983,796
Kentucky,Muhlenberg County,5,7,1934,1056,878
Kentucky,Muhlenberg County,5,8,1966,1046,920
Kentucky,Muhlenberg County,5,9,2104,1111,993
Kentucky,Muhlenberg County,5,10,2182,1148,1034
Kentucky,Muhlenberg County,5,11,2366,1165,1201
Kentucky,Muhlenberg County,5,12,2198,1087,1111
Kentucky,Muhlenberg County,5,13,2065,1022,1043
Kentucky,Muhlenberg County,5,14,1772,842,930
Kentucky,Muhlenberg County,5,15,1346,604,742
Kentucky,Muhlenberg County,5,16,931,394,537
Kentucky,Muhlenberg County,5,17,714,275,439
Kentucky,Muhlenberg County,5,18,606,173,433
Kentucky,Muhlenberg County,6,0,31323,15885,15438
Kentucky,Muhlenberg County,6,1,1662,863,799
Kentucky,Muhlenberg County,6,2,1807,955,852
Kentucky,Muhlenberg County,6,3,1943,1011,932
Kentucky,Muhlenberg County,6,4,1950,1039,911
Kentucky,Muhlenberg County,6,5,2063,1149,914
Kentucky,Muhlenberg County,6,6,1782,970,812
Kentucky,Muhlenberg County,6,7,1891,1001,890
Kentucky,Muhlenberg County,6,8,1963,1059,904
Kentucky,Muhlenberg County,6,9,2072,1114,958
Kentucky,Muhlenberg County,6,10,2133,1119,1014
Kentucky,Muhlenberg County,6,11,2320,1152,1168
Kentucky,Muhlenberg County,6,12,2234,1102,1132
Kentucky,Muhlenberg County,6,13,2001,984,1017
Kentucky,Muhlenberg County,6,14,1840,880,960
Kentucky,Muhlenberg County,6,15,1378,620,758
Kentucky,Muhlenberg County,6,16,956,408,548
Kentucky,Muhlenberg County,6,17,679,262,417
Kentucky,Muhlenberg County,6,18,649,197,452
Kentucky,Muhlenberg County,7,0,31302,15928,15374
Kentucky,Muhlenberg County,7,1,1712,869,843
Kentucky,Muhlenberg County,7,2,1725,945,780
Kentucky,Muhlenberg County,7,3,1932,1014,918
Kentucky,Muhlenberg County,7,4,1963,1032,931
Kentucky,Muhlenberg County,7,5,2069,1171,898
Kentucky,Muhlenberg County,7,6,1854,1009,845
Kentucky,Muhlenberg County,7,7,1827,970,857
Kentucky,Muhlenberg County,7,8,1937,1056,881
Kentucky,Muhlenberg County,7,9,2074,1097,977
Kentucky,Muhlenberg County,7,10,2094,1117,977
Kentucky,Muhlenberg County,7,11,2291,1144,1147
Kentucky,Muhlenberg County,7,12,2200,1098,1102
Kentucky,Muhlenberg County,7,13,2009,978,1031
Kentucky,Muhlenberg County,7,14,1842,881,961
Kentucky,Muhlenberg County,7,15,1432,654,778
Kentucky,Muhlenberg County,7,16,986,403,583
Kentucky,Muhlenberg County,7,17,686,272,414
Kentucky,Muhlenberg County,7,18,669,218,451
Kentucky,Muhlenberg County,8,0,31245,15934,15311
Kentucky,Muhlenberg County,8,1,1705,896,809
Kentucky,Muhlenberg County,8,2,1723,915,808
Kentucky,Muhlenberg County,8,3,1875,976,899
Kentucky,Muhlenberg County,8,4,1988,1059,929
Kentucky,Muhlenberg County,8,5,2036,1166,870
Kentucky,Muhlenberg County,8,6,1894,1041,853
Kentucky,Muhlenberg County,8,7,1793,964,829
Kentucky,Muhlenberg County,8,8,1934,1030,904
Kentucky,Muhlenberg County,8,9,2051,1102,949
Kentucky,Muhlenberg County,8,10,2059,1078,981
Kentucky,Muhlenberg County,8,11,2270,1150,1120
Kentucky,Muhlenberg County,8,12,2195,1086,1109
Kentucky,Muhlenberg County,8,13,1997,979,1018
Kentucky,Muhlenberg County,8,14,1887,915,972
Kentucky,Muhlenberg County,8,15,1463,671,792
Kentucky,Muhlenberg County,8,16,984,411,573
Kentucky,Muhlenberg County,8,17,700,273,427
Kentucky,Muhlenberg County,8,18,691,222,469
Kentucky,Muhlenberg County,9,0,31150,15906,15244
Kentucky,Muhlenberg County,9,1,1728,931,797
Kentucky,Muhlenberg County,9,2,1668,881,787
Kentucky,Muhlenberg County,9,3,1864,979,885
Kentucky,Muhlenberg County,9,4,2015,1079,936
Kentucky,Muhlenberg County,9,5,1993,1126,867
Kentucky,Muhlenberg County,9,6,1918,1068,850
Kentucky,Muhlenberg County,9,7,1804,965,839
Kentucky,Muhlenberg County,9,8,1915,1017,898
Kentucky,Muhlenberg County,9,9,1986,1064,922
Kentucky,Muhlenberg County,9,10,2029,1069,960
Kentucky,Muhlenberg County,9,11,2191,1114,1077
Kentucky,Muhlenberg County,9,12,2217,1090,1127
Kentucky,Muhlenberg County,9,13,2031,994,1037
Kentucky,Muhlenberg County,9,14,1906,944,962
Kentucky,Muhlenberg County,9,15,1467,671,796
Kentucky,Muhlenberg County,9,16,1017,421,596
Kentucky,Muhlenberg County,9,17,707,275,432
Kentucky,Muhlenberg County,9,18,694,218,476
Kentucky,Muhlenberg County,10,0,30925,15829,15096
Kentucky,Muhlenberg County,10,1,1731,911,820
Kentucky,Muhlenberg County,10,2,1646,876,770
Kentucky,Muhlenberg County,10,3,1832,970,862
Kentucky,Muhlenberg County,10,4,1997,1063,934
Kentucky,Muhlenberg County,10,5,1928,1104,824
Kentucky,Muhlenberg County,10,6,1917,1062,855
Kentucky,Muhlenberg County,10,7,1786,988,798
Kentucky,Muhlenberg County,10,8,1920,1000,920
Kentucky,Muhlenberg County,10,9,1941,1045,896
Kentucky,Muhlenberg County,10,10,2009,1062,947
Kentucky,Muhlenberg County,10,11,2108,1095,1013
Kentucky,Muhlenberg County,10,12,2212,1069,1143
Kentucky,Muhlenberg County,10,13,2051,1007,1044
Kentucky,Muhlenberg County,10,14,1858,916,942
Kentucky,Muhlenberg County,10,15,1523,710,813
Kentucky,Muhlenberg County,10,16,1074,463,611
Kentucky,Muhlenberg County,10,17,703,268,435
Kentucky,Muhlenberg County,10,18,689,220,469
Kentucky,Muhlenberg County,11,0,30811,15746,15065
Kentucky,Muhlenberg County,11,1,1718,906,812
Kentucky,Muhlenberg County,11,2,1638,847,791
Kentucky,Muhlenberg County,11,3,1835,979,856
Kentucky,Muhlenberg County,11,4,1955,1046,909
Kentucky,Muhlenberg County,11,5,1949,1135,814
Kentucky,Muhlenberg County,11,6,1957,1069,888
Kentucky,Muhlenberg County,11,7,1773,973,800
Kentucky,Muhlenberg County,11,8,1871,957,914
Kentucky,Muhlenberg County,11,9,1930,1056,874
Kentucky,Muhlenberg County,11,10,1974,1049,925
Kentucky,Muhlenberg County,11,11,2021,1034,987
Kentucky,Muhlenberg County,11,12,2185,1077,1108
Kentucky,Muhlenberg County,11,13,2079,1004,1075
Kentucky,Muhlenberg County,11,14,1818,895,923
Kentucky,Muhlenberg County,11,15,1585,738,847
Kentucky,Muhlenberg County,11,16,1128,490,638
Kentucky,Muhlenberg County,11,17,729,284,445
Kentucky,Muhlenberg County,11,18,666,207,459
Kentucky,Muhlenberg County,12,0,30622,15628,14994
Kentucky,Muhlenberg County,12,1,1704,918,786
Kentucky,Muhlenberg County,12,2,1675,859,816
Kentucky,Muhlenberg County,12,3,1754,937,817
Kentucky,Muhlenberg County,12,4,1917,1030,887
Kentucky,Muhlenberg County,12,5,1960,1109,851
Kentucky,Muhlenberg County,12,6,1951,1101,850
Kentucky,Muhlenberg County,12,7,1811,969,842
Kentucky,Muhlenberg County,12,8,1803,931,872
Kentucky,Muhlenberg County,12,9,1895,1035,860
Kentucky,Muhlenberg County,12,10,1958,1034,924
Kentucky,Muhlenberg County,12,11,2007,1037,970
Kentucky,Muhlenberg County,12,12,2135,1047,1088
Kentucky,Muhlenberg County,12,13,2039,990,1049
Kentucky,Muhlenberg County,12,14,1836,885,951
Kentucky,Muhlenberg County,12,15,1584,738,846
Kentucky,Muhlenberg County,12,16,1183,517,666
Kentucky,Muhlenberg County,12,17,727,269,458
Kentucky,Muhlenberg County,12,18,683,222,461
Kentucky,Nelson County,1,0,43437,21368,22069
Kentucky,Nelson County,1,1,2993,1552,1441
Kentucky,Nelson County,1,2,3125,1589,1536
Kentucky,Nelson County,1,3,3250,1697,1553
Kentucky,Nelson County,1,4,3026,1539,1487
Kentucky,Nelson County,1,5,2357,1156,1201
Kentucky,Nelson County,1,6,2703,1332,1371
Kentucky,Nelson County,1,7,2843,1418,1425
Kentucky,Nelson County,1,8,2810,1403,1407
Kentucky,Nelson County,1,9,3141,1533,1608
Kentucky,Nelson County,1,10,3414,1658,1756
Kentucky,Nelson County,1,11,3319,1692,1627
Kentucky,Nelson County,1,12,2905,1392,1513
Kentucky,Nelson County,1,13,2454,1202,1252
Kentucky,Nelson County,1,14,1731,812,919
Kentucky,Nelson County,1,15,1255,586,669
Kentucky,Nelson County,1,16,891,410,481
Kentucky,Nelson County,1,17,628,226,402
Kentucky,Nelson County,1,18,592,171,421
Kentucky,Nelson County,2,0,43441,21371,22070
Kentucky,Nelson County,2,1,2993,1552,1441
Kentucky,Nelson County,2,2,3125,1589,1536
Kentucky,Nelson County,2,3,3251,1698,1553
Kentucky,Nelson County,2,4,3027,1540,1487
Kentucky,Nelson County,2,5,2357,1156,1201
Kentucky,Nelson County,2,6,2703,1332,1371
Kentucky,Nelson County,2,7,2843,1418,1425
Kentucky,Nelson County,2,8,2811,1403,1408
Kentucky,Nelson County,2,9,3142,1534,1608
Kentucky,Nelson County,2,10,3414,1658,1756
Kentucky,Nelson County,2,11,3319,1692,1627
Kentucky,Nelson County,2,12,2905,1392,1513
Kentucky,Nelson County,2,13,2452,1201,1251
Kentucky,Nelson County,2,14,1733,813,920
Kentucky,Nelson County,2,15,1255,586,669
Kentucky,Nelson County,2,16,891,410,481
Kentucky,Nelson County,2,17,628,226,402
Kentucky,Nelson County,2,18,592,171,421
Kentucky,Nelson County,3,0,43629,21463,22166
Kentucky,Nelson County,3,1,3008,1559,1449
Kentucky,Nelson County,3,2,3138,1594,1544
Kentucky,Nelson County,3,3,3246,1692,1554
Kentucky,Nelson County,3,4,3014,1536,1478
Kentucky,Nelson County,3,5,2396,1173,1223
Kentucky,Nelson County,3,6,2698,1328,1370
Kentucky,Nelson County,3,7,2875,1431,1444
Kentucky,Nelson County,3,8,2782,1391,1391
Kentucky,Nelson County,3,9,3133,1531,1602
Kentucky,Nelson County,3,10,3438,1673,1765
Kentucky,Nelson County,3,11,3342,1704,1638
Kentucky,Nelson County,3,12,2926,1405,1521
Kentucky,Nelson County,3,13,2498,1218,1280
Kentucky,Nelson County,3,14,1737,818,919
Kentucky,Nelson County,3,15,1264,591,673
Kentucky,Nelson County,3,16,909,418,491
Kentucky,Nelson County,3,17,633,231,402
Kentucky,Nelson County,3,18,592,170,422
Kentucky,Nelson County,4,0,44062,21674,22388
Kentucky,Nelson County,4,1,2998,1569,1429
Kentucky,Nelson County,4,2,3170,1659,1511
Kentucky,Nelson County,4,3,3230,1666,1564
Kentucky,Nelson County,4,4,2961,1500,1461
Kentucky,Nelson County,4,5,2504,1212,1292
Kentucky,Nelson County,4,6,2679,1321,1358
Kentucky,Nelson County,4,7,2977,1483,1494
Kentucky,Nelson County,4,8,2693,1339,1354
Kentucky,Nelson County,4,9,3086,1508,1578
Kentucky,Nelson County,4,10,3433,1678,1755
Kentucky,Nelson County,4,11,3374,1696,1678
Kentucky,Nelson County,4,12,3005,1458,1547
Kentucky,Nelson County,4,13,2674,1283,1391
Kentucky,Nelson County,4,14,1773,849,924
Kentucky,Nelson County,4,15,1309,602,707
Kentucky,Nelson County,4,16,957,434,523
Kentucky,Nelson County,4,17,634,241,393
Kentucky,Nelson County,4,18,605,176,429
Kentucky,Nelson County,5,0,44401,21879,22522
Kentucky,Nelson County,5,1,3014,1567,1447
Kentucky,Nelson County,5,2,3142,1645,1497
Kentucky,Nelson County,5,3,3218,1662,1556
Kentucky,Nelson County,5,4,2945,1531,1414
Kentucky,Nelson County,5,5,2588,1265,1323
Kentucky,Nelson County,5,6,2650,1280,1370
Kentucky,Nelson County,5,7,2987,1519,1468
Kentucky,Nelson County,5,8,2698,1339,1359
Kentucky,Nelson County,5,9,3044,1486,1558
Kentucky,Nelson County,5,10,3367,1641,1726
Kentucky,Nelson County,5,11,3434,1712,1722
Kentucky,Nelson County,5,12,3032,1494,1538
Kentucky,Nelson County,5,13,2677,1283,1394
Kentucky,Nelson County,5,14,1982,948,1034
Kentucky,Nelson County,5,15,1376,633,743
Kentucky,Nelson County,5,16,976,437,539
Kentucky,Nelson County,5,17,647,259,388
Kentucky,Nelson County,5,18,624,178,446
Kentucky,Nelson County,6,0,44540,21908,22632
Kentucky,Nelson County,6,1,3032,1531,1501
Kentucky,Nelson County,6,2,3113,1650,1463
Kentucky,Nelson County,6,3,3138,1641,1497
Kentucky,Nelson County,6,4,2942,1503,1439
Kentucky,Nelson County,6,5,2673,1320,1353
Kentucky,Nelson County,6,6,2644,1282,1362
Kentucky,Nelson County,6,7,2914,1444,1470
Kentucky,Nelson County,6,8,2742,1380,1362
Kentucky,Nelson County,6,9,2986,1464,1522
Kentucky,Nelson County,6,10,3218,1572,1646
Kentucky,Nelson County,6,11,3437,1698,1739
Kentucky,Nelson County,6,12,3128,1534,1594
Kentucky,Nelson County,6,13,2718,1309,1409
Kentucky,Nelson County,6,14,2100,1017,1083
Kentucky,Nelson County,6,15,1445,650,795
Kentucky,Nelson County,6,16,1005,450,555
Kentucky,Nelson County,6,17,671,281,390
Kentucky,Nelson County,6,18,634,182,452
Kentucky,Nelson County,7,0,44858,22079,22779
Kentucky,Nelson County,7,1,2947,1492,1455
Kentucky,Nelson County,7,2,3095,1660,1435
Kentucky,Nelson County,7,3,3128,1605,1523
Kentucky,Nelson County,7,4,2991,1555,1436
Kentucky,Nelson County,7,5,2781,1359,1422
Kentucky,Nelson County,7,6,2706,1329,1377
Kentucky,Nelson County,7,7,2847,1401,1446
Kentucky,Nelson County,7,8,2829,1413,1416
Kentucky,Nelson County,7,9,2941,1457,1484
Kentucky,Nelson County,7,10,3135,1545,1590
Kentucky,Nelson County,7,11,3420,1680,1740
Kentucky,Nelson County,7,12,3194,1591,1603
Kentucky,Nelson County,7,13,2738,1298,1440
Kentucky,Nelson County,7,14,2212,1066,1146
Kentucky,Nelson County,7,15,1523,689,834
Kentucky,Nelson County,7,16,1040,458,582
Kentucky,Nelson County,7,17,675,291,384
Kentucky,Nelson County,7,18,656,190,466
Kentucky,Nelson County,8,0,45114,22217,22897
Kentucky,Nelson County,8,1,2902,1471,1431
Kentucky,Nelson County,8,2,3049,1595,1454
Kentucky,Nelson County,8,3,3175,1658,1517
Kentucky,Nelson County,8,4,2983,1550,1433
Kentucky,Nelson County,8,5,2762,1361,1401
Kentucky,Nelson County,8,6,2720,1345,1375
Kentucky,Nelson County,8,7,2814,1377,1437
Kentucky,Nelson County,8,8,2927,1484,1443
Kentucky,Nelson County,8,9,2792,1403,1389
Kentucky,Nelson County,8,10,3144,1502,1642
Kentucky,Nelson County,8,11,3407,1667,1740
Kentucky,Nelson County,8,12,3277,1657,1620
Kentucky,Nelson County,8,13,2800,1331,1469
Kentucky,Nelson County,8,14,2370,1130,1240
Kentucky,Nelson County,8,15,1539,721,818
Kentucky,Nelson County,8,16,1090,468,622
Kentucky,Nelson County,8,17,705,309,396
Kentucky,Nelson County,8,18,658,188,470
Kentucky,Nelson County,9,0,45497,22489,23008
Kentucky,Nelson County,9,1,2905,1495,1410
Kentucky,Nelson County,9,2,3043,1612,1431
Kentucky,Nelson County,9,3,3165,1667,1498
Kentucky,Nelson County,9,4,2932,1524,1408
Kentucky,Nelson County,9,5,2732,1361,1371
Kentucky,Nelson County,9,6,2824,1385,1439
Kentucky,Nelson County,9,7,2777,1382,1395
Kentucky,Nelson County,9,8,3024,1508,1516
Kentucky,Nelson County,9,9,2705,1378,1327
Kentucky,Nelson County,9,10,3133,1490,1643
Kentucky,Nelson County,9,11,3427,1696,1731
Kentucky,Nelson County,9,12,3335,1690,1645
Kentucky,Nelson County,9,13,2899,1386,1513
Kentucky,Nelson County,9,14,2485,1176,1309
Kentucky,Nelson County,9,15,1598,753,845
Kentucky,Nelson County,9,16,1112,482,630
Kentucky,Nelson County,9,17,726,307,419
Kentucky,Nelson County,9,18,675,197,478
Kentucky,Nelson County,10,0,45591,22529,23062
Kentucky,Nelson County,10,1,2854,1486,1368
Kentucky,Nelson County,10,2,3048,1602,1446
Kentucky,Nelson County,10,3,3136,1653,1483
Kentucky,Nelson County,10,4,2877,1496,1381
Kentucky,Nelson County,10,5,2607,1319,1288
Kentucky,Nelson County,10,6,2983,1459,1524
Kentucky,Nelson County,10,7,2771,1360,1411
Kentucky,Nelson County,10,8,3050,1528,1522
Kentucky,Nelson County,10,9,2662,1332,1330
Kentucky,Nelson County,10,10,3095,1499,1596
Kentucky,Nelson County,10,11,3300,1622,1678
Kentucky,Nelson County,10,12,3372,1688,1684
Kentucky,Nelson County,10,13,2944,1433,1511
Kentucky,Nelson County,10,14,2545,1222,1323
Kentucky,Nelson County,10,15,1778,837,941
Kentucky,Nelson County,10,16,1143,491,652
Kentucky,Nelson County,10,17,748,301,447
Kentucky,Nelson County,10,18,678,201,477
Kentucky,Nelson County,11,0,45813,22627,23186
Kentucky,Nelson County,11,1,2857,1507,1350
Kentucky,Nelson County,11,2,3039,1585,1454
Kentucky,Nelson County,11,3,3086,1643,1443
Kentucky,Nelson County,11,4,2807,1448,1359
Kentucky,Nelson County,11,5,2623,1315,1308
Kentucky,Nelson County,11,6,3097,1527,1570
Kentucky,Nelson County,11,7,2745,1350,1395
Kentucky,Nelson County,11,8,3005,1501,1504
Kentucky,Nelson County,11,9,2706,1346,1360
Kentucky,Nelson County,11,10,3021,1486,1535
Kentucky,Nelson County,11,11,3176,1544,1632
Kentucky,Nelson County,11,12,3414,1688,1726
Kentucky,Nelson County,11,13,3080,1507,1573
Kentucky,Nelson County,11,14,2603,1246,1357
Kentucky,Nelson County,11,15,1878,904,974
Kentucky,Nelson County,11,16,1214,504,710
Kentucky,Nelson County,11,17,771,316,455
Kentucky,Nelson County,11,18,691,210,481
Kentucky,Nelson County,12,0,46233,22832,23401
Kentucky,Nelson County,12,1,2858,1506,1352
Kentucky,Nelson County,12,2,3068,1591,1477
Kentucky,Nelson County,12,3,3056,1638,1418
Kentucky,Nelson County,12,4,2809,1443,1366
Kentucky,Nelson County,12,5,2651,1335,1316
Kentucky,Nelson County,12,6,3178,1569,1609
Kentucky,Nelson County,12,7,2781,1393,1388
Kentucky,Nelson County,12,8,2935,1439,1496
Kentucky,Nelson County,12,9,2822,1401,1421
Kentucky,Nelson County,12,10,2953,1468,1485
Kentucky,Nelson County,12,11,3114,1523,1591
Kentucky,Nelson County,12,12,3380,1643,1737
Kentucky,Nelson County,12,13,3163,1561,1602
Kentucky,Nelson County,12,14,2674,1277,1397
Kentucky,Nelson County,12,15,2022,967,1055
Kentucky,Nelson County,12,16,1302,556,746
Kentucky,Nelson County,12,17,769,310,459
Kentucky,Nelson County,12,18,698,212,486
Kentucky,Nicholas County,1,0,7135,3546,3589
Kentucky,Nicholas County,1,1,450,220,230
Kentucky,Nicholas County,1,2,463,254,209
Kentucky,Nicholas County,1,3,506,283,223
Kentucky,Nicholas County,1,4,463,230,233
Kentucky,Nicholas County,1,5,339,173,166
Kentucky,Nicholas County,1,6,375,185,190
Kentucky,Nicholas County,1,7,453,233,220
Kentucky,Nicholas County,1,8,451,217,234
Kentucky,Nicholas County,1,9,542,281,261
Kentucky,Nicholas County,1,10,553,285,268
Kentucky,Nicholas County,1,11,508,259,249
Kentucky,Nicholas County,1,12,470,213,257
Kentucky,Nicholas County,1,13,452,217,235
Kentucky,Nicholas County,1,14,332,154,178
Kentucky,Nicholas County,1,15,293,139,154
Kentucky,Nicholas County,1,16,216,100,116
Kentucky,Nicholas County,1,17,137,55,82
Kentucky,Nicholas County,1,18,132,48,84
Kentucky,Nicholas County,2,0,7129,3543,3586
Kentucky,Nicholas County,2,1,450,220,230
Kentucky,Nicholas County,2,2,463,254,209
Kentucky,Nicholas County,2,3,505,282,223
Kentucky,Nicholas County,2,4,462,230,232
Kentucky,Nicholas County,2,5,339,173,166
Kentucky,Nicholas County,2,6,375,185,190
Kentucky,Nicholas County,2,7,453,233,220
Kentucky,Nicholas County,2,8,451,217,234
Kentucky,Nicholas County,2,9,541,280,261
Kentucky,Nicholas County,2,10,552,285,267
Kentucky,Nicholas County,2,11,507,258,249
Kentucky,Nicholas County,2,12,469,213,256
Kentucky,Nicholas County,2,13,452,217,235
Kentucky,Nicholas County,2,14,332,154,178
Kentucky,Nicholas County,2,15,293,139,154
Kentucky,Nicholas County,2,16,216,100,116
Kentucky,Nicholas County,2,17,137,55,82
Kentucky,Nicholas County,2,18,132,48,84
Kentucky,Nicholas County,3,0,7128,3548,3580
Kentucky,Nicholas County,3,1,447,218,229
Kentucky,Nicholas County,3,2,461,251,210
Kentucky,Nicholas County,3,3,500,280,220
Kentucky,Nicholas County,3,4,466,236,230
Kentucky,Nicholas County,3,5,338,171,167
Kentucky,Nicholas County,3,6,382,190,192
Kentucky,Nicholas County,3,7,448,231,217
Kentucky,Nicholas County,3,8,451,217,234
Kentucky,Nicholas County,3,9,533,277,256
Kentucky,Nicholas County,3,10,554,286,268
Kentucky,Nicholas County,3,11,514,264,250
Kentucky,Nicholas County,3,12,471,215,256
Kentucky,Nicholas County,3,13,451,213,238
Kentucky,Nicholas County,3,14,334,157,177
Kentucky,Nicholas County,3,15,291,138,153
Kentucky,Nicholas County,3,16,216,99,117
Kentucky,Nicholas County,3,17,136,56,80
Kentucky,Nicholas County,3,18,135,49,86
Kentucky,Nicholas County,4,0,7088,3509,3579
Kentucky,Nicholas County,4,1,439,207,232
Kentucky,Nicholas County,4,2,458,239,219
Kentucky,Nicholas County,4,3,485,260,225
Kentucky,Nicholas County,4,4,457,237,220
Kentucky,Nicholas County,4,5,338,172,166
Kentucky,Nicholas County,4,6,382,183,199
Kentucky,Nicholas County,4,7,427,214,213
Kentucky,Nicholas County,4,8,453,225,228
Kentucky,Nicholas County,4,9,515,268,247
Kentucky,Nicholas County,4,10,545,287,258
Kentucky,Nicholas County,4,11,541,281,260
Kentucky,Nicholas County,4,12,461,215,246
Kentucky,Nicholas County,4,13,468,213,255
Kentucky,Nicholas County,4,14,345,169,176
Kentucky,Nicholas County,4,15,278,132,146
Kentucky,Nicholas County,4,16,220,94,126
Kentucky,Nicholas County,4,17,138,65,73
Kentucky,Nicholas County,4,18,138,48,90
Kentucky,Nicholas County,5,0,7008,3489,3519
Kentucky,Nicholas County,5,1,434,208,226
Kentucky,Nicholas County,5,2,431,222,209
Kentucky,Nicholas County,5,3,456,239,217
Kentucky,Nicholas County,5,4,448,245,203
Kentucky,Nicholas County,5,5,379,190,189
Kentucky,Nicholas County,5,6,341,162,179
Kentucky,Nicholas County,5,7,436,216,220
Kentucky,Nicholas County,5,8,421,228,193
Kentucky,Nicholas County,5,9,493,245,248
Kentucky,Nicholas County,5,10,538,283,255
Kentucky,Nicholas County,5,11,542,272,270
Kentucky,Nicholas County,5,12,473,231,242
Kentucky,Nicholas County,5,13,460,213,247
Kentucky,Nicholas County,5,14,383,190,193
Kentucky,Nicholas County,5,15,271,126,145
Kentucky,Nicholas County,5,16,225,101,124
Kentucky,Nicholas County,5,17,144,66,78
Kentucky,Nicholas County,5,18,133,52,81
Kentucky,Nicholas County,6,0,7008,3503,3505
Kentucky,Nicholas County,6,1,416,212,204
Kentucky,Nicholas County,6,2,437,218,219
Kentucky,Nicholas County,6,3,471,242,229
Kentucky,Nicholas County,6,4,449,255,194
Kentucky,Nicholas County,6,5,383,183,200
Kentucky,Nicholas County,6,6,336,173,163
Kentucky,Nicholas County,6,7,431,214,217
Kentucky,Nicholas County,6,8,418,224,194
Kentucky,Nicholas County,6,9,468,221,247
Kentucky,Nicholas County,6,10,534,297,237
Kentucky,Nicholas County,6,11,557,278,279
Kentucky,Nicholas County,6,12,496,249,247
Kentucky,Nicholas County,6,13,452,201,251
Kentucky,Nicholas County,6,14,372,187,185
Kentucky,Nicholas County,6,15,291,130,161
Kentucky,Nicholas County,6,16,212,95,117
Kentucky,Nicholas County,6,17,161,74,87
Kentucky,Nicholas County,6,18,124,50,74
Kentucky,Nicholas County,7,0,7050,3512,3538
Kentucky,Nicholas County,7,1,441,236,205
Kentucky,Nicholas County,7,2,452,225,227
Kentucky,Nicholas County,7,3,455,235,220
Kentucky,Nicholas County,7,4,432,229,203
Kentucky,Nicholas County,7,5,402,193,209
Kentucky,Nicholas County,7,6,391,202,189
Kentucky,Nicholas County,7,7,394,185,209
Kentucky,Nicholas County,7,8,427,229,198
Kentucky,Nicholas County,7,9,456,217,239
Kentucky,Nicholas County,7,10,514,284,230
Kentucky,Nicholas County,7,11,548,274,274
Kentucky,Nicholas County,7,12,505,254,251
Kentucky,Nicholas County,7,13,452,208,244
Kentucky,Nicholas County,7,14,390,190,200
Kentucky,Nicholas County,7,15,285,128,157
Kentucky,Nicholas County,7,16,214,92,122
Kentucky,Nicholas County,7,17,161,77,84
Kentucky,Nicholas County,7,18,131,54,77
Kentucky,Nicholas County,8,0,7059,3534,3525
Kentucky,Nicholas County,8,1,448,244,204
Kentucky,Nicholas County,8,2,431,210,221
Kentucky,Nicholas County,8,3,468,254,214
Kentucky,Nicholas County,8,4,454,241,213
Kentucky,Nicholas County,8,5,398,191,207
Kentucky,Nicholas County,8,6,372,200,172
Kentucky,Nicholas County,8,7,373,172,201
Kentucky,Nicholas County,8,8,431,226,205
Kentucky,Nicholas County,8,9,438,213,225
Kentucky,Nicholas County,8,10,531,282,249
Kentucky,Nicholas County,8,11,548,281,267
Kentucky,Nicholas County,8,12,523,261,262
Kentucky,Nicholas County,8,13,454,209,245
Kentucky,Nicholas County,8,14,415,198,217
Kentucky,Nicholas County,8,15,277,133,144
Kentucky,Nicholas County,8,16,215,94,121
Kentucky,Nicholas County,8,17,147,65,82
Kentucky,Nicholas County,8,18,136,60,76
Kentucky,Nicholas County,9,0,7083,3517,3566
Kentucky,Nicholas County,9,1,459,239,220
Kentucky,Nicholas County,9,2,466,230,236
Kentucky,Nicholas County,9,3,469,247,222
Kentucky,Nicholas County,9,4,452,240,212
Kentucky,Nicholas County,9,5,413,201,212
Kentucky,Nicholas County,9,6,375,184,191
Kentucky,Nicholas County,9,7,388,182,206
Kentucky,Nicholas County,9,8,424,218,206
Kentucky,Nicholas County,9,9,436,216,220
Kentucky,Nicholas County,9,10,490,255,235
Kentucky,Nicholas County,9,11,539,289,250
Kentucky,Nicholas County,9,12,537,268,269
Kentucky,Nicholas County,9,13,436,197,239
Kentucky,Nicholas County,9,14,424,198,226
Kentucky,Nicholas County,9,15,287,138,149
Kentucky,Nicholas County,9,16,205,90,115
Kentucky,Nicholas County,9,17,140,58,82
Kentucky,Nicholas County,9,18,143,67,76
Kentucky,Nicholas County,10,0,7160,3545,3615
Kentucky,Nicholas County,10,1,479,239,240
Kentucky,Nicholas County,10,2,447,225,222
Kentucky,Nicholas County,10,3,472,239,233
Kentucky,Nicholas County,10,4,461,240,221
Kentucky,Nicholas County,10,5,410,200,210
Kentucky,Nicholas County,10,6,408,200,208
Kentucky,Nicholas County,10,7,377,180,197
Kentucky,Nicholas County,10,8,450,229,221
Kentucky,Nicholas County,10,9,425,223,202
Kentucky,Nicholas County,10,10,497,242,255
Kentucky,Nicholas County,10,11,535,289,246
Kentucky,Nicholas County,10,12,542,267,275
Kentucky,Nicholas County,10,13,449,212,237
Kentucky,Nicholas County,10,14,394,180,214
Kentucky,Nicholas County,10,15,341,171,170
Kentucky,Nicholas County,10,16,209,94,115
Kentucky,Nicholas County,10,17,135,54,81
Kentucky,Nicholas County,10,18,129,61,68
Kentucky,Nicholas County,11,0,7195,3573,3622
Kentucky,Nicholas County,11,1,465,240,225
Kentucky,Nicholas County,11,2,468,231,237
Kentucky,Nicholas County,11,3,473,237,236
Kentucky,Nicholas County,11,4,472,244,228
Kentucky,Nicholas County,11,5,405,216,189
Kentucky,Nicholas County,11,6,431,205,226
Kentucky,Nicholas County,11,7,346,173,173
Kentucky,Nicholas County,11,8,459,226,233
Kentucky,Nicholas County,11,9,435,226,209
Kentucky,Nicholas County,11,10,482,228,254
Kentucky,Nicholas County,11,11,533,294,239
Kentucky,Nicholas County,11,12,549,270,279
Kentucky,Nicholas County,11,13,469,228,241
Kentucky,Nicholas County,11,14,393,177,216
Kentucky,Nicholas County,11,15,341,171,170
Kentucky,Nicholas County,11,16,214,97,117
Kentucky,Nicholas County,11,17,132,52,80
Kentucky,Nicholas County,11,18,128,58,70
Kentucky,Nicholas County,12,0,7269,3586,3683
Kentucky,Nicholas County,12,1,466,222,244
Kentucky,Nicholas County,12,2,483,236,247
Kentucky,Nicholas County,12,3,498,248,250
Kentucky,Nicholas County,12,4,464,247,217
Kentucky,Nicholas County,12,5,412,212,200
Kentucky,Nicholas County,12,6,448,222,226
Kentucky,Nicholas County,12,7,386,196,190
Kentucky,Nicholas County,12,8,411,191,220
Kentucky,Nicholas County,12,9,441,223,218
Kentucky,Nicholas County,12,10,472,225,247
Kentucky,Nicholas County,12,11,542,298,244
Kentucky,Nicholas County,12,12,534,269,265
Kentucky,Nicholas County,12,13,474,233,241
Kentucky,Nicholas County,12,14,402,185,217
Kentucky,Nicholas County,12,15,360,173,187
Kentucky,Nicholas County,12,16,215,98,117
Kentucky,Nicholas County,12,17,132,50,82
Kentucky,Nicholas County,12,18,129,58,71
Kentucky,Ohio County,1,0,23842,11912,11930
Kentucky,Ohio County,1,1,1703,874,829
Kentucky,Ohio County,1,2,1625,873,752
Kentucky,Ohio County,1,3,1618,857,761
Kentucky,Ohio County,1,4,1600,835,765
Kentucky,Ohio County,1,5,1317,650,667
Kentucky,Ohio County,1,6,1384,698,686
Kentucky,Ohio County,1,7,1456,754,702
Kentucky,Ohio County,1,8,1509,752,757
Kentucky,Ohio County,1,9,1492,756,736
Kentucky,Ohio County,1,10,1694,831,863
Kentucky,Ohio County,1,11,1721,822,899
Kentucky,Ohio County,1,12,1579,810,769
Kentucky,Ohio County,1,13,1462,711,751
Kentucky,Ohio County,1,14,1223,626,597
Kentucky,Ohio County,1,15,902,443,459
Kentucky,Ohio County,1,16,624,285,339
Kentucky,Ohio County,1,17,486,211,275
Kentucky,Ohio County,1,18,447,124,323
Kentucky,Ohio County,2,0,23854,11917,11937
Kentucky,Ohio County,2,1,1704,875,829
Kentucky,Ohio County,2,2,1626,873,753
Kentucky,Ohio County,2,3,1619,857,762
Kentucky,Ohio County,2,4,1602,835,767
Kentucky,Ohio County,2,5,1317,650,667
Kentucky,Ohio County,2,6,1384,698,686
Kentucky,Ohio County,2,7,1457,754,703
Kentucky,Ohio County,2,8,1509,752,757
Kentucky,Ohio County,2,9,1494,758,736
Kentucky,Ohio County,2,10,1694,831,863
Kentucky,Ohio County,2,11,1721,822,899
Kentucky,Ohio County,2,12,1580,810,770
Kentucky,Ohio County,2,13,1463,712,751
Kentucky,Ohio County,2,14,1223,626,597
Kentucky,Ohio County,2,15,904,444,460
Kentucky,Ohio County,2,16,624,285,339
Kentucky,Ohio County,2,17,486,211,275
Kentucky,Ohio County,2,18,447,124,323
Kentucky,Ohio County,3,0,23834,11904,11930
Kentucky,Ohio County,3,1,1681,865,816
Kentucky,Ohio County,3,2,1634,875,759
Kentucky,Ohio County,3,3,1613,858,755
Kentucky,Ohio County,3,4,1592,825,767
Kentucky,Ohio County,3,5,1315,652,663
Kentucky,Ohio County,3,6,1382,697,685
Kentucky,Ohio County,3,7,1457,755,702
Kentucky,Ohio County,3,8,1507,747,760
Kentucky,Ohio County,3,9,1496,759,737
Kentucky,Ohio County,3,10,1695,831,864
Kentucky,Ohio County,3,11,1720,822,898
Kentucky,Ohio County,3,12,1584,813,771
Kentucky,Ohio County,3,13,1476,714,762
Kentucky,Ohio County,3,14,1213,618,595
Kentucky,Ohio County,3,15,914,453,461
Kentucky,Ohio County,3,16,621,283,338
Kentucky,Ohio County,3,17,483,211,272
Kentucky,Ohio County,3,18,451,126,325
Kentucky,Ohio County,4,0,23985,11951,12034
Kentucky,Ohio County,4,1,1610,828,782
Kentucky,Ohio County,4,2,1721,908,813
Kentucky,Ohio County,4,3,1634,875,759
Kentucky,Ohio County,4,4,1555,789,766
Kentucky,Ohio County,4,5,1334,678,656
Kentucky,Ohio County,4,6,1388,706,682
Kentucky,Ohio County,4,7,1496,749,747
Kentucky,Ohio County,4,8,1472,721,751
Kentucky,Ohio County,4,9,1494,758,736
Kentucky,Ohio County,4,10,1657,823,834
Kentucky,Ohio County,4,11,1741,839,902
Kentucky,Ohio County,4,12,1607,818,789
Kentucky,Ohio County,4,13,1543,750,793
Kentucky,Ohio County,4,14,1185,590,595
Kentucky,Ohio County,4,15,961,493,468
Kentucky,Ohio County,4,16,648,292,356
Kentucky,Ohio County,4,17,482,207,275
Kentucky,Ohio County,4,18,457,127,330
Kentucky,Ohio County,5,0,24021,11962,12059
Kentucky,Ohio County,5,1,1567,804,763
Kentucky,Ohio County,5,2,1805,914,891
Kentucky,Ohio County,5,3,1623,888,735
Kentucky,Ohio County,5,4,1474,750,724
Kentucky,Ohio County,5,5,1396,731,665
Kentucky,Ohio County,5,6,1420,723,697
Kentucky,Ohio County,5,7,1469,726,743
Kentucky,Ohio County,5,8,1420,705,715
Kentucky,Ohio County,5,9,1525,767,758
Kentucky,Ohio County,5,10,1597,794,803
Kentucky,Ohio County,5,11,1743,853,890
Kentucky,Ohio County,5,12,1623,811,812
Kentucky,Ohio County,5,13,1522,758,764
Kentucky,Ohio County,5,14,1258,608,650
Kentucky,Ohio County,5,15,970,496,474
Kentucky,Ohio County,5,16,672,300,372
Kentucky,Ohio County,5,17,492,210,282
Kentucky,Ohio County,5,18,445,124,321
Kentucky,Ohio County,6,0,23975,11973,12002
Kentucky,Ohio County,6,1,1513,762,751
Kentucky,Ohio County,6,2,1771,902,869
Kentucky,Ohio County,6,3,1613,895,718
Kentucky,Ohio County,6,4,1472,751,721
Kentucky,Ohio County,6,5,1386,755,631
Kentucky,Ohio County,6,6,1391,669,722
Kentucky,Ohio County,6,7,1461,732,729
Kentucky,Ohio County,6,8,1436,720,716
Kentucky,Ohio County,6,9,1522,765,757
Kentucky,Ohio County,6,10,1552,754,798
Kentucky,Ohio County,6,11,1755,886,869
Kentucky,Ohio County,6,12,1657,807,850
Kentucky,Ohio County,6,13,1508,746,762
Kentucky,Ohio County,6,14,1303,650,653
Kentucky,Ohio County,6,15,1026,517,509
Kentucky,Ohio County,6,16,681,310,371
Kentucky,Ohio County,6,17,472,215,257
Kentucky,Ohio County,6,18,456,137,319
Kentucky,Ohio County,7,0,23948,11968,11980
Kentucky,Ohio County,7,1,1473,727,746
Kentucky,Ohio County,7,2,1754,886,868
Kentucky,Ohio County,7,3,1638,897,741
Kentucky,Ohio County,7,4,1456,761,695
Kentucky,Ohio County,7,5,1423,773,650
Kentucky,Ohio County,7,6,1378,673,705
Kentucky,Ohio County,7,7,1409,705,704
Kentucky,Ohio County,7,8,1497,766,731
Kentucky,Ohio County,7,9,1528,769,759
Kentucky,Ohio County,7,10,1470,719,751
Kentucky,Ohio County,7,11,1700,847,853
Kentucky,Ohio County,7,12,1688,822,866
Kentucky,Ohio County,7,13,1512,761,751
Kentucky,Ohio County,7,14,1330,647,683
Kentucky,Ohio County,7,15,1032,514,518
Kentucky,Ohio County,7,16,728,344,384
Kentucky,Ohio County,7,17,462,206,256
Kentucky,Ohio County,7,18,470,151,319
Kentucky,Ohio County,8,0,24021,11982,12039
Kentucky,Ohio County,8,1,1442,721,721
Kentucky,Ohio County,8,2,1723,875,848
Kentucky,Ohio County,8,3,1723,908,815
Kentucky,Ohio County,8,4,1475,787,688
Kentucky,Ohio County,8,5,1391,740,651
Kentucky,Ohio County,8,6,1383,680,703
Kentucky,Ohio County,8,7,1405,711,694
Kentucky,Ohio County,8,8,1529,778,751
Kentucky,Ohio County,8,9,1504,756,748
Kentucky,Ohio County,8,10,1473,740,733
Kentucky,Ohio County,8,11,1668,817,851
Kentucky,Ohio County,8,12,1657,806,851
Kentucky,Ohio County,8,13,1560,790,770
Kentucky,Ohio County,8,14,1362,649,713
Kentucky,Ohio County,8,15,1039,512,527
Kentucky,Ohio County,8,16,751,367,384
Kentucky,Ohio County,8,17,457,192,265
Kentucky,Ohio County,8,18,479,153,326
Kentucky,Ohio County,9,0,24158,12022,12136
Kentucky,Ohio County,9,1,1436,708,728
Kentucky,Ohio County,9,2,1688,855,833
Kentucky,Ohio County,9,3,1775,909,866
Kentucky,Ohio County,9,4,1516,826,690
Kentucky,Ohio County,9,5,1355,704,651
Kentucky,Ohio County,9,6,1435,747,688
Kentucky,Ohio County,9,7,1406,695,711
Kentucky,Ohio County,9,8,1568,789,779
Kentucky,Ohio County,9,9,1482,729,753
Kentucky,Ohio County,9,10,1468,730,738
Kentucky,Ohio County,9,11,1643,825,818
Kentucky,Ohio County,9,12,1636,796,840
Kentucky,Ohio County,9,13,1577,805,772
Kentucky,Ohio County,9,14,1412,666,746
Kentucky,Ohio County,9,15,1016,485,531
Kentucky,Ohio County,9,16,791,397,394
Kentucky,Ohio County,9,17,476,202,274
Kentucky,Ohio County,9,18,478,154,324
Kentucky,Ohio County,10,0,24116,12035,12081
Kentucky,Ohio County,10,1,1489,751,738
Kentucky,Ohio County,10,2,1616,816,800
Kentucky,Ohio County,10,3,1812,920,892
Kentucky,Ohio County,10,4,1529,827,702
Kentucky,Ohio County,10,5,1305,691,614
Kentucky,Ohio County,10,6,1487,787,700
Kentucky,Ohio County,10,7,1345,663,682
Kentucky,Ohio County,10,8,1558,787,771
Kentucky,Ohio County,10,9,1448,702,746
Kentucky,Ohio County,10,10,1489,745,744
Kentucky,Ohio County,10,11,1594,807,787
Kentucky,Ohio County,10,12,1670,821,849
Kentucky,Ohio County,10,13,1566,773,793
Kentucky,Ohio County,10,14,1379,677,702
Kentucky,Ohio County,10,15,1102,518,584
Kentucky,Ohio County,10,16,770,386,384
Kentucky,Ohio County,10,17,480,203,277
Kentucky,Ohio County,10,18,477,161,316
Kentucky,Ohio County,11,0,24064,12010,12054
Kentucky,Ohio County,11,1,1469,762,707
Kentucky,Ohio County,11,2,1600,788,812
Kentucky,Ohio County,11,3,1812,913,899
Kentucky,Ohio County,11,4,1534,832,702
Kentucky,Ohio County,11,5,1285,675,610
Kentucky,Ohio County,11,6,1460,794,666
Kentucky,Ohio County,11,7,1352,648,704
Kentucky,Ohio County,11,8,1524,772,752
Kentucky,Ohio County,11,9,1467,734,733
Kentucky,Ohio County,11,10,1529,761,768
Kentucky,Ohio County,11,11,1527,751,776
Kentucky,Ohio County,11,12,1678,835,843
Kentucky,Ohio County,11,13,1558,758,800
Kentucky,Ohio County,11,14,1378,668,710
Kentucky,Ohio County,11,15,1118,547,571
Kentucky,Ohio County,11,16,803,396,407
Kentucky,Ohio County,11,17,494,209,285
Kentucky,Ohio County,11,18,476,167,309
Kentucky,Ohio County,12,0,23994,12027,11967
Kentucky,Ohio County,12,1,1478,782,696
Kentucky,Ohio County,12,2,1536,763,773
Kentucky,Ohio County,12,3,1809,909,900
Kentucky,Ohio County,12,4,1524,817,707
Kentucky,Ohio County,12,5,1271,695,576
Kentucky,Ohio County,12,6,1498,811,687
Kentucky,Ohio County,12,7,1345,652,693
Kentucky,Ohio County,12,8,1447,723,724
Kentucky,Ohio County,12,9,1522,781,741
Kentucky,Ohio County,12,10,1518,761,757
Kentucky,Ohio County,12,11,1478,725,753
Kentucky,Ohio County,12,12,1631,805,826
Kentucky,Ohio County,12,13,1594,770,824
Kentucky,Ohio County,12,14,1389,691,698
Kentucky,Ohio County,12,15,1160,559,601
Kentucky,Ohio County,12,16,795,393,402
Kentucky,Ohio County,12,17,532,236,296
Kentucky,Ohio County,12,18,467,154,313
Kentucky,Oldham County,1,0,60316,31737,28579
Kentucky,Oldham County,1,1,3420,1719,1701
Kentucky,Oldham County,1,2,4883,2477,2406
Kentucky,Oldham County,1,3,5374,2676,2698
Kentucky,Oldham County,1,4,4374,2309,2065
Kentucky,Oldham County,1,5,2509,1528,981
Kentucky,Oldham County,1,6,2790,1705,1085
Kentucky,Oldham County,1,7,3360,1895,1465
Kentucky,Oldham County,1,8,4485,2359,2126
Kentucky,Oldham County,1,9,5422,2861,2561
Kentucky,Oldham County,1,10,5662,2971,2691
Kentucky,Oldham County,1,11,5017,2701,2316
Kentucky,Oldham County,1,12,4001,2072,1929
Kentucky,Oldham County,1,13,3446,1778,1668
Kentucky,Oldham County,1,14,2326,1217,1109
Kentucky,Oldham County,1,15,1330,682,648
Kentucky,Oldham County,1,16,850,407,443
Kentucky,Oldham County,1,17,552,230,322
Kentucky,Oldham County,1,18,515,150,365
Kentucky,Oldham County,2,0,60356,31760,28596
Kentucky,Oldham County,2,1,3420,1719,1701
Kentucky,Oldham County,2,2,4886,2479,2407
Kentucky,Oldham County,2,3,5378,2679,2699
Kentucky,Oldham County,2,4,4377,2311,2066
Kentucky,Oldham County,2,5,2510,1529,981
Kentucky,Oldham County,2,6,2791,1706,1085
Kentucky,Oldham County,2,7,3360,1895,1465
Kentucky,Oldham County,2,8,4488,2360,2128
Kentucky,Oldham County,2,9,5427,2863,2564
Kentucky,Oldham County,2,10,5666,2973,2693
Kentucky,Oldham County,2,11,5018,2702,2316
Kentucky,Oldham County,2,12,4006,2074,1932
Kentucky,Oldham County,2,13,3448,1780,1668
Kentucky,Oldham County,2,14,2328,1217,1111
Kentucky,Oldham County,2,15,1334,684,650
Kentucky,Oldham County,2,16,851,408,443
Kentucky,Oldham County,2,17,553,231,322
Kentucky,Oldham County,2,18,515,150,365
Kentucky,Oldham County,3,0,60437,31796,28641
Kentucky,Oldham County,3,1,3382,1703,1679
Kentucky,Oldham County,3,2,4856,2462,2394
Kentucky,Oldham County,3,3,5424,2707,2717
Kentucky,Oldham County,3,4,4436,2333,2103
Kentucky,Oldham County,3,5,2524,1531,993
Kentucky,Oldham County,3,6,2802,1717,1085
Kentucky,Oldham County,3,7,3372,1907,1465
Kentucky,Oldham County,3,8,4424,2332,2092
Kentucky,Oldham County,3,9,5404,2843,2561
Kentucky,Oldham County,3,10,5663,2974,2689
Kentucky,Oldham County,3,11,5031,2707,2324
Kentucky,Oldham County,3,12,4029,2086,1943
Kentucky,Oldham County,3,13,3465,1783,1682
Kentucky,Oldham County,3,14,2347,1225,1122
Kentucky,Oldham County,3,15,1356,692,664
Kentucky,Oldham County,3,16,848,404,444
Kentucky,Oldham County,3,17,558,237,321
Kentucky,Oldham County,3,18,516,153,363
Kentucky,Oldham County,4,0,60772,31876,28896
Kentucky,Oldham County,4,1,3209,1629,1580
Kentucky,Oldham County,4,2,4670,2331,2339
Kentucky,Oldham County,4,3,5500,2766,2734
Kentucky,Oldham County,4,4,4624,2415,2209
Kentucky,Oldham County,4,5,2640,1572,1068
Kentucky,Oldham County,4,6,2807,1719,1088
Kentucky,Oldham County,4,7,3343,1910,1433
Kentucky,Oldham County,4,8,4120,2182,1938
Kentucky,Oldham County,4,9,5387,2786,2601
Kentucky,Oldham County,4,10,5595,2961,2634
Kentucky,Oldham County,4,11,5120,2748,2372
Kentucky,Oldham County,4,12,4138,2146,1992
Kentucky,Oldham County,4,13,3640,1849,1791
Kentucky,Oldham County,4,14,2457,1270,1187
Kentucky,Oldham County,4,15,1486,760,726
Kentucky,Oldham County,4,16,887,416,471
Kentucky,Oldham County,4,17,591,245,346
Kentucky,Oldham County,4,18,558,171,387
Kentucky,Oldham County,5,0,62105,32918,29187
Kentucky,Oldham County,5,1,3123,1585,1538
Kentucky,Oldham County,5,2,4612,2273,2339
Kentucky,Oldham County,5,3,5508,2805,2703
Kentucky,Oldham County,5,4,4803,2488,2315
Kentucky,Oldham County,5,5,2998,1786,1212
Kentucky,Oldham County,5,6,2841,1792,1049
Kentucky,Oldham County,5,7,3453,2043,1410
Kentucky,Oldham County,5,8,4156,2262,1894
Kentucky,Oldham County,5,9,5370,2811,2559
Kentucky,Oldham County,5,10,5643,3065,2578
Kentucky,Oldham County,5,11,5252,2836,2416
Kentucky,Oldham County,5,12,4249,2213,2036
Kentucky,Oldham County,5,13,3550,1814,1736
Kentucky,Oldham County,5,14,2733,1412,1321
Kentucky,Oldham County,5,15,1656,843,813
Kentucky,Oldham County,5,16,944,457,487
Kentucky,Oldham County,5,17,616,246,370
Kentucky,Oldham County,5,18,598,187,411
Kentucky,Oldham County,6,0,63062,33455,29607
Kentucky,Oldham County,6,1,3121,1565,1556
Kentucky,Oldham County,6,2,4594,2299,2295
Kentucky,Oldham County,6,3,5533,2823,2710
Kentucky,Oldham County,6,4,4921,2556,2365
Kentucky,Oldham County,6,5,3236,1924,1312
Kentucky,Oldham County,6,6,2819,1788,1031
Kentucky,Oldham County,6,7,3597,2067,1530
Kentucky,Oldham County,6,8,4169,2314,1855
Kentucky,Oldham County,6,9,5311,2806,2505
Kentucky,Oldham County,6,10,5542,3010,2532
Kentucky,Oldham County,6,11,5377,2895,2482
Kentucky,Oldham County,6,12,4260,2202,2058
Kentucky,Oldham County,6,13,3522,1804,1718
Kentucky,Oldham County,6,14,2926,1508,1418
Kentucky,Oldham County,6,15,1830,930,900
Kentucky,Oldham County,6,16,1048,513,535
Kentucky,Oldham County,6,17,622,250,372
Kentucky,Oldham County,6,18,634,201,433
Kentucky,Oldham County,7,0,63969,33892,30077
Kentucky,Oldham County,7,1,3139,1592,1547
Kentucky,Oldham County,7,2,4643,2336,2307
Kentucky,Oldham County,7,3,5524,2835,2689
Kentucky,Oldham County,7,4,4977,2538,2439
Kentucky,Oldham County,7,5,3548,2083,1465
Kentucky,Oldham County,7,6,2843,1786,1057
Kentucky,Oldham County,7,7,3542,2043,1499
Kentucky,Oldham County,7,8,4352,2407,1945
Kentucky,Oldham County,7,9,5196,2750,2446
Kentucky,Oldham County,7,10,5540,3007,2533
Kentucky,Oldham County,7,11,5397,2916,2481
Kentucky,Oldham County,7,12,4332,2231,2101
Kentucky,Oldham County,7,13,3526,1790,1736
Kentucky,Oldham County,7,14,3033,1551,1482
Kentucky,Oldham County,7,15,1965,984,981
Kentucky,Oldham County,7,16,1101,550,551
Kentucky,Oldham County,7,17,648,264,384
Kentucky,Oldham County,7,18,663,229,434
Kentucky,Oldham County,8,0,64556,34230,30326
Kentucky,Oldham County,8,1,3233,1645,1588
Kentucky,Oldham County,8,2,4527,2290,2237
Kentucky,Oldham County,8,3,5483,2770,2713
Kentucky,Oldham County,8,4,5038,2588,2450
Kentucky,Oldham County,8,5,3665,2157,1508
Kentucky,Oldham County,8,6,2910,1812,1098
Kentucky,Oldham County,8,7,3546,2072,1474
Kentucky,Oldham County,8,8,4517,2488,2029
Kentucky,Oldham County,8,9,5070,2686,2384
Kentucky,Oldham County,8,10,5472,3004,2468
Kentucky,Oldham County,8,11,5365,2870,2495
Kentucky,Oldham County,8,12,4412,2314,2098
Kentucky,Oldham County,8,13,3612,1820,1792
Kentucky,Oldham County,8,14,3126,1583,1543
Kentucky,Oldham County,8,15,2051,1037,1014
Kentucky,Oldham County,8,16,1164,569,595
Kentucky,Oldham County,8,17,664,278,386
Kentucky,Oldham County,8,18,701,247,454
Kentucky,Oldham County,9,0,65410,34631,30779
Kentucky,Oldham County,9,1,3294,1679,1615
Kentucky,Oldham County,9,2,4555,2292,2263
Kentucky,Oldham County,9,3,5445,2754,2691
Kentucky,Oldham County,9,4,5085,2635,2450
Kentucky,Oldham County,9,5,3747,2177,1570
Kentucky,Oldham County,9,6,2992,1819,1173
Kentucky,Oldham County,9,7,3664,2127,1537
Kentucky,Oldham County,9,8,4691,2629,2062
Kentucky,Oldham County,9,9,4856,2582,2274
Kentucky,Oldham County,9,10,5549,3005,2544
Kentucky,Oldham County,9,11,5294,2880,2414
Kentucky,Oldham County,9,12,4456,2303,2153
Kentucky,Oldham County,9,13,3700,1876,1824
Kentucky,Oldham County,9,14,3263,1637,1626
Kentucky,Oldham County,9,15,2161,1081,1080
Kentucky,Oldham County,9,16,1241,609,632
Kentucky,Oldham County,9,17,677,285,392
Kentucky,Oldham County,9,18,740,261,479
Kentucky,Oldham County,10,0,66557,35193,31364
Kentucky,Oldham County,10,1,3465,1745,1720
Kentucky,Oldham County,10,2,4629,2351,2278
Kentucky,Oldham County,10,3,5470,2722,2748
Kentucky,Oldham County,10,4,5111,2697,2414
Kentucky,Oldham County,10,5,3807,2181,1626
Kentucky,Oldham County,10,6,3110,1888,1222
Kentucky,Oldham County,10,7,3697,2097,1600
Kentucky,Oldham County,10,8,4853,2732,2121
Kentucky,Oldham County,10,9,4860,2620,2240
Kentucky,Oldham County,10,10,5622,3032,2590
Kentucky,Oldham County,10,11,5217,2870,2347
Kentucky,Oldham County,10,12,4511,2323,2188
Kentucky,Oldham County,10,13,3796,1912,1884
Kentucky,Oldham County,10,14,3149,1588,1561
Kentucky,Oldham County,10,15,2420,1203,1217
Kentucky,Oldham County,10,16,1359,661,698
Kentucky,Oldham County,10,17,714,309,405
Kentucky,Oldham County,10,18,767,262,505
Kentucky,Oldham County,11,0,66512,34823,31689
Kentucky,Oldham County,11,1,3446,1709,1737
Kentucky,Oldham County,11,2,4661,2332,2329
Kentucky,Oldham County,11,3,5443,2735,2708
Kentucky,Oldham County,11,4,5172,2709,2463
Kentucky,Oldham County,11,5,3738,2117,1621
Kentucky,Oldham County,11,6,3168,1896,1272
Kentucky,Oldham County,11,7,3541,2017,1524
Kentucky,Oldham County,11,8,4772,2574,2198
Kentucky,Oldham County,11,9,4910,2668,2242
Kentucky,Oldham County,11,10,5514,2940,2574
Kentucky,Oldham County,11,11,5066,2761,2305
Kentucky,Oldham County,11,12,4566,2329,2237
Kentucky,Oldham County,11,13,3768,1870,1898
Kentucky,Oldham County,11,14,3121,1558,1563
Kentucky,Oldham County,11,15,2558,1258,1300
Kentucky,Oldham County,11,16,1501,721,780
Kentucky,Oldham County,11,17,801,368,433
Kentucky,Oldham County,11,18,766,261,505
Kentucky,Oldham County,12,0,66799,34884,31915
Kentucky,Oldham County,12,1,3465,1725,1740
Kentucky,Oldham County,12,2,4654,2333,2321
Kentucky,Oldham County,12,3,5389,2707,2682
Kentucky,Oldham County,12,4,5183,2694,2489
Kentucky,Oldham County,12,5,3762,2119,1643
Kentucky,Oldham County,12,6,3204,1901,1303
Kentucky,Oldham County,12,7,3513,1981,1532
Kentucky,Oldham County,12,8,4671,2523,2148
Kentucky,Oldham County,12,9,5068,2744,2324
Kentucky,Oldham County,12,10,5361,2874,2487
Kentucky,Oldham County,12,11,4982,2698,2284
Kentucky,Oldham County,12,12,4597,2365,2232
Kentucky,Oldham County,12,13,3821,1914,1907
Kentucky,Oldham County,12,14,3157,1552,1605
Kentucky,Oldham County,12,15,2655,1300,1355
Kentucky,Oldham County,12,16,1663,787,876
Kentucky,Oldham County,12,17,859,408,451
Kentucky,Oldham County,12,18,795,259,536
Kentucky,Owen County,1,0,10841,5385,5456
Kentucky,Owen County,1,1,697,330,367
Kentucky,Owen County,1,2,747,353,394
Kentucky,Owen County,1,3,754,399,355
Kentucky,Owen County,1,4,725,387,338
Kentucky,Owen County,1,5,541,273,268
Kentucky,Owen County,1,6,540,263,277
Kentucky,Owen County,1,7,686,344,342
Kentucky,Owen County,1,8,718,359,359
Kentucky,Owen County,1,9,709,360,349
Kentucky,Owen County,1,10,849,405,444
Kentucky,Owen County,1,11,851,452,399
Kentucky,Owen County,1,12,796,406,390
Kentucky,Owen County,1,13,658,312,346
Kentucky,Owen County,1,14,564,299,265
Kentucky,Owen County,1,15,372,196,176
Kentucky,Owen County,1,16,277,119,158
Kentucky,Owen County,1,17,193,77,116
Kentucky,Owen County,1,18,164,51,113
Kentucky,Owen County,2,0,10837,5383,5454
Kentucky,Owen County,2,1,697,330,367
Kentucky,Owen County,2,2,749,354,395
Kentucky,Owen County,2,3,755,400,355
Kentucky,Owen County,2,4,725,387,338
Kentucky,Owen County,2,5,540,273,267
Kentucky,Owen County,2,6,540,263,277
Kentucky,Owen County,2,7,686,344,342
Kentucky,Owen County,2,8,718,359,359
Kentucky,Owen County,2,9,711,361,350
Kentucky,Owen County,2,10,847,404,443
Kentucky,Owen County,2,11,850,451,399
Kentucky,Owen County,2,12,795,405,390
Kentucky,Owen County,2,13,657,312,345
Kentucky,Owen County,2,14,563,298,265
Kentucky,Owen County,2,15,372,196,176
Kentucky,Owen County,2,16,275,118,157
Kentucky,Owen County,2,17,193,77,116
Kentucky,Owen County,2,18,164,51,113
Kentucky,Owen County,3,0,10850,5392,5458
Kentucky,Owen County,3,1,695,331,364
Kentucky,Owen County,3,2,748,354,394
Kentucky,Owen County,3,3,756,401,355
Kentucky,Owen County,3,4,718,381,337
Kentucky,Owen County,3,5,542,275,267
Kentucky,Owen County,3,6,537,256,281
Kentucky,Owen County,3,7,684,346,338
Kentucky,Owen County,3,8,707,358,349
Kentucky,Owen County,3,9,718,364,354
Kentucky,Owen County,3,10,838,403,435
Kentucky,Owen County,3,11,854,449,405
Kentucky,Owen County,3,12,799,407,392
Kentucky,Owen County,3,13,671,318,353
Kentucky,Owen County,3,14,561,300,261
Kentucky,Owen County,3,15,385,200,185
Kentucky,Owen County,3,16,276,121,155
Kentucky,Owen County,3,17,196,77,119
Kentucky,Owen County,3,18,165,51,114
Kentucky,Owen County,4,0,10825,5345,5480
Kentucky,Owen County,4,1,634,296,338
Kentucky,Owen County,4,2,786,369,417
Kentucky,Owen County,4,3,793,415,378
Kentucky,Owen County,4,4,675,347,328
Kentucky,Owen County,4,5,570,290,280
Kentucky,Owen County,4,6,514,238,276
Kentucky,Owen County,4,7,672,343,329
Kentucky,Owen County,4,8,662,340,322
Kentucky,Owen County,4,9,759,377,382
Kentucky,Owen County,4,10,776,382,394
Kentucky,Owen County,4,11,851,436,415
Kentucky,Owen County,4,12,806,407,399
Kentucky,Owen County,4,13,714,340,374
Kentucky,Owen County,4,14,557,296,261
Kentucky,Owen County,4,15,410,210,200
Kentucky,Owen County,4,16,276,124,152
Kentucky,Owen County,4,17,202,78,124
Kentucky,Owen County,4,18,168,57,111
Kentucky,Owen County,5,0,10762,5335,5427
Kentucky,Owen County,5,1,627,315,312
Kentucky,Owen County,5,2,740,345,395
Kentucky,Owen County,5,3,782,403,379
Kentucky,Owen County,5,4,684,348,336
Kentucky,Owen County,5,5,586,292,294
Kentucky,Owen County,5,6,514,242,272
Kentucky,Owen County,5,7,639,311,328
Kentucky,Owen County,5,8,644,335,309
Kentucky,Owen County,5,9,761,387,374
Kentucky,Owen County,5,10,716,360,356
Kentucky,Owen County,5,11,839,434,405
Kentucky,Owen County,5,12,848,428,420
Kentucky,Owen County,5,13,701,343,358
Kentucky,Owen County,5,14,587,294,293
Kentucky,Owen County,5,15,439,233,206
Kentucky,Owen County,5,16,284,132,152
Kentucky,Owen County,5,17,202,77,125
Kentucky,Owen County,5,18,169,56,113
Kentucky,Owen County,6,0,10645,5278,5367
Kentucky,Owen County,6,1,564,296,268
Kentucky,Owen County,6,2,736,339,397
Kentucky,Owen County,6,3,748,369,379
Kentucky,Owen County,6,4,686,356,330
Kentucky,Owen County,6,5,563,286,277
Kentucky,Owen County,6,6,516,252,264
Kentucky,Owen County,6,7,633,321,312
Kentucky,Owen County,6,8,624,304,320
Kentucky,Owen County,6,9,742,379,363
Kentucky,Owen County,6,10,712,370,342
Kentucky,Owen County,6,11,833,419,414
Kentucky,Owen County,6,12,854,422,432
Kentucky,Owen County,6,13,719,366,353
Kentucky,Owen County,6,14,588,281,307
Kentucky,Owen County,6,15,479,261,218
Kentucky,Owen County,6,16,282,136,146
Kentucky,Owen County,6,17,204,72,132
Kentucky,Owen County,6,18,162,49,113
Kentucky,Owen County,7,0,10657,5288,5369
Kentucky,Owen County,7,1,568,274,294
Kentucky,Owen County,7,2,724,351,373
Kentucky,Owen County,7,3,746,363,383
Kentucky,Owen County,7,4,686,367,319
Kentucky,Owen County,7,5,568,294,274
Kentucky,Owen County,7,6,530,262,268
Kentucky,Owen County,7,7,594,303,291
Kentucky,Owen County,7,8,655,327,328
Kentucky,Owen County,7,9,701,337,364
Kentucky,Owen County,7,10,707,374,333
Kentucky,Owen County,7,11,809,402,407
Kentucky,Owen County,7,12,830,428,402
Kentucky,Owen County,7,13,767,384,383
Kentucky,Owen County,7,14,600,276,324
Kentucky,Owen County,7,15,502,275,227
Kentucky,Owen County,7,16,296,148,148
Kentucky,Owen County,7,17,196,63,133
Kentucky,Owen County,7,18,178,60,118
Kentucky,Owen County,8,0,10736,5309,5427
Kentucky,Owen County,8,1,531,257,274
Kentucky,Owen County,8,2,724,366,358
Kentucky,Owen County,8,3,773,369,404
Kentucky,Owen County,8,4,693,369,324
Kentucky,Owen County,8,5,541,267,274
Kentucky,Owen County,8,6,572,290,282
Kentucky,Owen County,8,7,563,279,284
Kentucky,Owen County,8,8,696,340,356
Kentucky,Owen County,8,9,701,347,354
Kentucky,Owen County,8,10,708,371,337
Kentucky,Owen County,8,11,800,385,415
Kentucky,Owen County,8,12,832,439,393
Kentucky,Owen County,8,13,802,405,397
Kentucky,Owen County,8,14,616,287,329
Kentucky,Owen County,8,15,508,266,242
Kentucky,Owen County,8,16,298,148,150
Kentucky,Owen County,8,17,191,65,126
Kentucky,Owen County,8,18,187,59,128
Kentucky,Owen County,9,0,10668,5290,5378
Kentucky,Owen County,9,1,533,274,259
Kentucky,Owen County,9,2,658,332,326
Kentucky,Owen County,9,3,764,355,409
Kentucky,Owen County,9,4,693,367,326
Kentucky,Owen County,9,5,529,265,264
Kentucky,Owen County,9,6,585,298,287
Kentucky,Owen County,9,7,563,272,291
Kentucky,Owen County,9,8,664,339,325
Kentucky,Owen County,9,9,681,339,342
Kentucky,Owen County,9,10,729,371,358
Kentucky,Owen County,9,11,754,378,376
Kentucky,Owen County,9,12,848,436,412
Kentucky,Owen County,9,13,802,397,405
Kentucky,Owen County,9,14,664,320,344
Kentucky,Owen County,9,15,497,257,240
Kentucky,Owen County,9,16,329,163,166
Kentucky,Owen County,9,17,186,69,117
Kentucky,Owen County,9,18,189,58,131
Kentucky,Owen County,10,0,10794,5378,5416
Kentucky,Owen County,10,1,567,301,266
Kentucky,Owen County,10,2,673,343,330
Kentucky,Owen County,10,3,742,337,405
Kentucky,Owen County,10,4,685,363,322
Kentucky,Owen County,10,5,554,292,262
Kentucky,Owen County,10,6,629,298,331
Kentucky,Owen County,10,7,546,276,270
Kentucky,Owen County,10,8,673,339,334
Kentucky,Owen County,10,9,655,326,329
Kentucky,Owen County,10,10,761,393,368
Kentucky,Owen County,10,11,712,365,347
Kentucky,Owen County,10,12,828,418,410
Kentucky,Owen County,10,13,843,419,424
Kentucky,Owen County,10,14,671,338,333
Kentucky,Owen County,10,15,528,256,272
Kentucky,Owen County,10,16,353,185,168
Kentucky,Owen County,10,17,188,77,111
Kentucky,Owen County,10,18,186,52,134
Kentucky,Owen County,11,0,10881,5416,5465
Kentucky,Owen County,11,1,563,297,266
Kentucky,Owen County,11,2,643,341,302
Kentucky,Owen County,11,3,778,364,414
Kentucky,Owen County,11,4,679,339,340
Kentucky,Owen County,11,5,577,296,281
Kentucky,Owen County,11,6,639,304,335
Kentucky,Owen County,11,7,544,278,266
Kentucky,Owen County,11,8,683,361,322
Kentucky,Owen County,11,9,650,300,350
Kentucky,Owen County,11,10,759,382,377
Kentucky,Owen County,11,11,716,369,347
Kentucky,Owen County,11,12,822,418,404
Kentucky,Owen County,11,13,836,403,433
Kentucky,Owen County,11,14,702,365,337
Kentucky,Owen County,11,15,528,248,280
Kentucky,Owen County,11,16,388,209,179
Kentucky,Owen County,11,17,193,91,102
Kentucky,Owen County,11,18,181,51,130
Kentucky,Owen County,12,0,10901,5442,5459
Kentucky,Owen County,12,1,556,306,250
Kentucky,Owen County,12,2,627,320,307
Kentucky,Owen County,12,3,751,359,392
Kentucky,Owen County,12,4,680,336,344
Kentucky,Owen County,12,5,591,294,297
Kentucky,Owen County,12,6,613,320,293
Kentucky,Owen County,12,7,572,279,293
Kentucky,Owen County,12,8,652,339,313
Kentucky,Owen County,12,9,665,318,347
Kentucky,Owen County,12,10,746,361,385
Kentucky,Owen County,12,11,724,384,340
Kentucky,Owen County,12,12,825,410,415
Kentucky,Owen County,12,13,816,404,412
Kentucky,Owen County,12,14,748,389,359
Kentucky,Owen County,12,15,548,250,298
Kentucky,Owen County,12,16,406,220,186
Kentucky,Owen County,12,17,203,101,102
Kentucky,Owen County,12,18,178,52,126
Kentucky,Owsley County,1,0,4755,2356,2399
Kentucky,Owsley County,1,1,263,132,131
Kentucky,Owsley County,1,2,290,143,147
Kentucky,Owsley County,1,3,301,150,151
Kentucky,Owsley County,1,4,312,157,155
Kentucky,Owsley County,1,5,260,140,120
Kentucky,Owsley County,1,6,292,152,140
Kentucky,Owsley County,1,7,260,129,131
Kentucky,Owsley County,1,8,255,124,131
Kentucky,Owsley County,1,9,344,165,179
Kentucky,Owsley County,1,10,333,177,156
Kentucky,Owsley County,1,11,369,173,196
Kentucky,Owsley County,1,12,390,197,193
Kentucky,Owsley County,1,13,289,138,151
Kentucky,Owsley County,1,14,280,138,142
Kentucky,Owsley County,1,15,185,99,86
Kentucky,Owsley County,1,16,144,68,76
Kentucky,Owsley County,1,17,104,41,63
Kentucky,Owsley County,1,18,84,33,51
Kentucky,Owsley County,2,0,4755,2356,2399
Kentucky,Owsley County,2,1,263,132,131
Kentucky,Owsley County,2,2,290,143,147
Kentucky,Owsley County,2,3,301,150,151
Kentucky,Owsley County,2,4,312,157,155
Kentucky,Owsley County,2,5,260,140,120
Kentucky,Owsley County,2,6,292,152,140
Kentucky,Owsley County,2,7,260,129,131
Kentucky,Owsley County,2,8,255,124,131
Kentucky,Owsley County,2,9,344,165,179
Kentucky,Owsley County,2,10,333,177,156
Kentucky,Owsley County,2,11,369,173,196
Kentucky,Owsley County,2,12,390,197,193
Kentucky,Owsley County,2,13,289,138,151
Kentucky,Owsley County,2,14,280,138,142
Kentucky,Owsley County,2,15,185,99,86
Kentucky,Owsley County,2,16,144,68,76
Kentucky,Owsley County,2,17,104,41,63
Kentucky,Owsley County,2,18,84,33,51
Kentucky,Owsley County,3,0,4748,2355,2393
Kentucky,Owsley County,3,1,262,133,129
Kentucky,Owsley County,3,2,295,144,151
Kentucky,Owsley County,3,3,298,151,147
Kentucky,Owsley County,3,4,311,157,154
Kentucky,Owsley County,3,5,264,143,121
Kentucky,Owsley County,3,6,290,150,140
Kentucky,Owsley County,3,7,257,127,130
Kentucky,Owsley County,3,8,260,126,134
Kentucky,Owsley County,3,9,339,162,177
Kentucky,Owsley County,3,10,340,181,159
Kentucky,Owsley County,3,11,365,170,195
Kentucky,Owsley County,3,12,386,194,192
Kentucky,Owsley County,3,13,292,141,151
Kentucky,Owsley County,3,14,275,137,138
Kentucky,Owsley County,3,15,185,99,86
Kentucky,Owsley County,3,16,143,69,74
Kentucky,Owsley County,3,17,102,37,65
Kentucky,Owsley County,3,18,84,34,50
Kentucky,Owsley County,4,0,4806,2374,2432
Kentucky,Owsley County,4,1,265,127,138
Kentucky,Owsley County,4,2,314,157,157
Kentucky,Owsley County,4,3,300,155,145
Kentucky,Owsley County,4,4,299,144,155
Kentucky,Owsley County,4,5,281,153,128
Kentucky,Owsley County,4,6,306,161,145
Kentucky,Owsley County,4,7,257,122,135
Kentucky,Owsley County,4,8,275,145,130
Kentucky,Owsley County,4,9,320,148,172
Kentucky,Owsley County,4,10,348,182,166
Kentucky,Owsley County,4,11,361,169,192
Kentucky,Owsley County,4,12,374,182,192
Kentucky,Owsley County,4,13,325,160,165
Kentucky,Owsley County,4,14,254,129,125
Kentucky,Owsley County,4,15,193,99,94
Kentucky,Owsley County,4,16,145,70,75
Kentucky,Owsley County,4,17,102,34,68
Kentucky,Owsley County,4,18,87,37,50
Kentucky,Owsley County,5,0,4681,2304,2377
Kentucky,Owsley County,5,1,254,117,137
Kentucky,Owsley County,5,2,292,148,144
Kentucky,Owsley County,5,3,295,155,140
Kentucky,Owsley County,5,4,298,145,153
Kentucky,Owsley County,5,5,267,137,130
Kentucky,Owsley County,5,6,300,160,140
Kentucky,Owsley County,5,7,235,107,128
Kentucky,Owsley County,5,8,273,143,130
Kentucky,Owsley County,5,9,303,142,161
Kentucky,Owsley County,5,10,329,164,165
Kentucky,Owsley County,5,11,351,177,174
Kentucky,Owsley County,5,12,367,183,184
Kentucky,Owsley County,5,13,337,171,166
Kentucky,Owsley County,5,14,248,118,130
Kentucky,Owsley County,5,15,202,98,104
Kentucky,Owsley County,5,16,152,70,82
Kentucky,Owsley County,5,17,92,33,59
Kentucky,Owsley County,5,18,86,36,50
Kentucky,Owsley County,6,0,4599,2256,2343
Kentucky,Owsley County,6,1,232,104,128
Kentucky,Owsley County,6,2,281,150,131
Kentucky,Owsley County,6,3,284,142,142
Kentucky,Owsley County,6,4,286,133,153
Kentucky,Owsley County,6,5,261,134,127
Kentucky,Owsley County,6,6,299,156,143
Kentucky,Owsley County,6,7,256,126,130
Kentucky,Owsley County,6,8,267,142,125
Kentucky,Owsley County,6,9,284,133,151
Kentucky,Owsley County,6,10,329,152,177
Kentucky,Owsley County,6,11,330,182,148
Kentucky,Owsley County,6,12,360,175,185
Kentucky,Owsley County,6,13,353,173,180
Kentucky,Owsley County,6,14,247,119,128
Kentucky,Owsley County,6,15,215,107,108
Kentucky,Owsley County,6,16,144,62,82
Kentucky,Owsley County,6,17,87,32,55
Kentucky,Owsley County,6,18,84,34,50
Kentucky,Owsley County,7,0,4502,2208,2294
Kentucky,Owsley County,7,1,249,116,133
Kentucky,Owsley County,7,2,278,148,130
Kentucky,Owsley County,7,3,270,136,134
Kentucky,Owsley County,7,4,260,120,140
Kentucky,Owsley County,7,5,248,127,121
Kentucky,Owsley County,7,6,289,148,141
Kentucky,Owsley County,7,7,260,126,134
Kentucky,Owsley County,7,8,246,126,120
Kentucky,Owsley County,7,9,272,131,141
Kentucky,Owsley County,7,10,328,157,171
Kentucky,Owsley County,7,11,318,170,148
Kentucky,Owsley County,7,12,344,165,179
Kentucky,Owsley County,7,13,340,166,174
Kentucky,Owsley County,7,14,262,129,133
Kentucky,Owsley County,7,15,229,120,109
Kentucky,Owsley County,7,16,136,55,81
Kentucky,Owsley County,7,17,87,31,56
Kentucky,Owsley County,7,18,86,37,49
Kentucky,Owsley County,8,0,4445,2169,2276
Kentucky,Owsley County,8,1,256,117,139
Kentucky,Owsley County,8,2,257,123,134
Kentucky,Owsley County,8,3,284,145,139
Kentucky,Owsley County,8,4,247,117,130
Kentucky,Owsley County,8,5,228,110,118
Kentucky,Owsley County,8,6,271,145,126
Kentucky,Owsley County,8,7,293,149,144
Kentucky,Owsley County,8,8,240,117,123
Kentucky,Owsley County,8,9,263,130,133
Kentucky,Owsley County,8,10,318,152,166
Kentucky,Owsley County,8,11,306,161,145
Kentucky,Owsley County,8,12,336,160,176
Kentucky,Owsley County,8,13,355,178,177
Kentucky,Owsley County,8,14,262,132,130
Kentucky,Owsley County,8,15,221,105,116
Kentucky,Owsley County,8,16,137,68,69
Kentucky,Owsley County,8,17,87,28,59
Kentucky,Owsley County,8,18,84,32,52
Kentucky,Owsley County,9,0,4472,2185,2287
Kentucky,Owsley County,9,1,268,119,149
Kentucky,Owsley County,9,2,268,139,129
Kentucky,Owsley County,9,3,276,141,135
Kentucky,Owsley County,9,4,246,116,130
Kentucky,Owsley County,9,5,224,104,120
Kentucky,Owsley County,9,6,285,150,135
Kentucky,Owsley County,9,7,282,144,138
Kentucky,Owsley County,9,8,229,105,124
Kentucky,Owsley County,9,9,277,143,134
Kentucky,Owsley County,9,10,304,144,160
Kentucky,Owsley County,9,11,327,171,156
Kentucky,Owsley County,9,12,326,157,169
Kentucky,Owsley County,9,13,334,165,169
Kentucky,Owsley County,9,14,291,149,142
Kentucky,Owsley County,9,15,205,100,105
Kentucky,Owsley County,9,16,157,74,83
Kentucky,Owsley County,9,17,93,37,56
Kentucky,Owsley County,9,18,80,27,53
Kentucky,Owsley County,10,0,4402,2167,2235
Kentucky,Owsley County,10,1,277,147,130
Kentucky,Owsley County,10,2,250,116,134
Kentucky,Owsley County,10,3,273,148,125
Kentucky,Owsley County,10,4,247,112,135
Kentucky,Owsley County,10,5,208,97,111
Kentucky,Owsley County,10,6,283,144,139
Kentucky,Owsley County,10,7,274,147,127
Kentucky,Owsley County,10,8,229,109,120
Kentucky,Owsley County,10,9,260,135,125
Kentucky,Owsley County,10,10,288,137,151
Kentucky,Owsley County,10,11,314,158,156
Kentucky,Owsley County,10,12,325,162,163
Kentucky,Owsley County,10,13,325,160,165
Kentucky,Owsley County,10,14,296,153,143
Kentucky,Owsley County,10,15,205,98,107
Kentucky,Owsley County,10,16,165,73,92
Kentucky,Owsley County,10,17,100,37,63
Kentucky,Owsley County,10,18,83,34,49
Kentucky,Owsley County,11,0,4474,2209,2265
Kentucky,Owsley County,11,1,315,171,144
Kentucky,Owsley County,11,2,245,109,136
Kentucky,Owsley County,11,3,280,147,133
Kentucky,Owsley County,11,4,257,125,132
Kentucky,Owsley County,11,5,226,103,123
Kentucky,Owsley County,11,6,265,139,126
Kentucky,Owsley County,11,7,284,155,129
Kentucky,Owsley County,11,8,245,115,130
Kentucky,Owsley County,11,9,247,132,115
Kentucky,Owsley County,11,10,286,139,147
Kentucky,Owsley County,11,11,314,147,167
Kentucky,Owsley County,11,12,321,175,146
Kentucky,Owsley County,11,13,318,156,162
Kentucky,Owsley County,11,14,307,150,157
Kentucky,Owsley County,11,15,194,93,101
Kentucky,Owsley County,11,16,177,77,100
Kentucky,Owsley County,11,17,101,38,63
Kentucky,Owsley County,11,18,92,38,54
Kentucky,Owsley County,12,0,4415,2177,2238
Kentucky,Owsley County,12,1,304,164,140
Kentucky,Owsley County,12,2,263,119,144
Kentucky,Owsley County,12,3,265,135,130
Kentucky,Owsley County,12,4,250,128,122
Kentucky,Owsley County,12,5,212,97,115
Kentucky,Owsley County,12,6,262,139,123
Kentucky,Owsley County,12,7,268,144,124
Kentucky,Owsley County,12,8,259,124,135
Kentucky,Owsley County,12,9,237,124,113
Kentucky,Owsley County,12,10,272,129,143
Kentucky,Owsley County,12,11,312,148,164
Kentucky,Owsley County,12,12,322,173,149
Kentucky,Owsley County,12,13,307,148,159
Kentucky,Owsley County,12,14,302,148,154
Kentucky,Owsley County,12,15,197,94,103
Kentucky,Owsley County,12,16,183,84,99
Kentucky,Owsley County,12,17,101,34,67
Kentucky,Owsley County,12,18,99,45,54
Kentucky,Pendleton County,1,0,14877,7446,7431
Kentucky,Pendleton County,1,1,922,463,459
Kentucky,Pendleton County,1,2,975,464,511
Kentucky,Pendleton County,1,3,1049,557,492
Kentucky,Pendleton County,1,4,1154,592,562
Kentucky,Pendleton County,1,5,838,412,426
Kentucky,Pendleton County,1,6,825,417,408
Kentucky,Pendleton County,1,7,821,419,402
Kentucky,Pendleton County,1,8,974,508,466
Kentucky,Pendleton County,1,9,1103,568,535
Kentucky,Pendleton County,1,10,1290,664,626
Kentucky,Pendleton County,1,11,1245,641,604
Kentucky,Pendleton County,1,12,956,477,479
Kentucky,Pendleton County,1,13,898,472,426
Kentucky,Pendleton County,1,14,608,278,330
Kentucky,Pendleton County,1,15,456,218,238
Kentucky,Pendleton County,1,16,331,144,187
Kentucky,Pendleton County,1,17,228,94,134
Kentucky,Pendleton County,1,18,204,58,146
Kentucky,Pendleton County,2,0,14874,7444,7430
Kentucky,Pendleton County,2,1,922,463,459
Kentucky,Pendleton County,2,2,975,464,511
Kentucky,Pendleton County,2,3,1049,557,492
Kentucky,Pendleton County,2,4,1153,591,562
Kentucky,Pendleton County,2,5,838,412,426
Kentucky,Pendleton County,2,6,825,417,408
Kentucky,Pendleton County,2,7,821,419,402
Kentucky,Pendleton County,2,8,974,508,466
Kentucky,Pendleton County,2,9,1103,568,535
Kentucky,Pendleton County,2,10,1290,664,626
Kentucky,Pendleton County,2,11,1245,641,604
Kentucky,Pendleton County,2,12,955,476,479
Kentucky,Pendleton County,2,13,898,472,426
Kentucky,Pendleton County,2,14,608,278,330
Kentucky,Pendleton County,2,15,455,218,237
Kentucky,Pendleton County,2,16,331,144,187
Kentucky,Pendleton County,2,17,228,94,134
Kentucky,Pendleton County,2,18,204,58,146
Kentucky,Pendleton County,3,0,14915,7461,7454
Kentucky,Pendleton County,3,1,912,458,454
Kentucky,Pendleton County,3,2,979,461,518
Kentucky,Pendleton County,3,3,1049,552,497
Kentucky,Pendleton County,3,4,1144,596,548
Kentucky,Pendleton County,3,5,856,417,439
Kentucky,Pendleton County,3,6,812,410,402
Kentucky,Pendleton County,3,7,840,429,411
Kentucky,Pendleton County,3,8,964,505,459
Kentucky,Pendleton County,3,9,1102,562,540
Kentucky,Pendleton County,3,10,1283,665,618
Kentucky,Pendleton County,3,11,1259,650,609
Kentucky,Pendleton County,3,12,968,482,486
Kentucky,Pendleton County,3,13,901,472,429
Kentucky,Pendleton County,3,14,612,279,333
Kentucky,Pendleton County,3,15,463,222,241
Kentucky,Pendleton County,3,16,332,146,186
Kentucky,Pendleton County,3,17,234,97,137
Kentucky,Pendleton County,3,18,205,58,147
Kentucky,Pendleton County,4,0,14662,7324,7338
Kentucky,Pendleton County,4,1,857,438,419
Kentucky,Pendleton County,4,2,928,441,487
Kentucky,Pendleton County,4,3,1022,515,507
Kentucky,Pendleton County,4,4,1040,561,479
Kentucky,Pendleton County,4,5,932,441,491
Kentucky,Pendleton County,4,6,764,396,368
Kentucky,Pendleton County,4,7,859,433,426
Kentucky,Pendleton County,4,8,866,457,409
Kentucky,Pendleton County,4,9,1076,533,543
Kentucky,Pendleton County,4,10,1244,660,584
Kentucky,Pendleton County,4,11,1255,639,616
Kentucky,Pendleton County,4,12,1017,501,516
Kentucky,Pendleton County,4,13,926,488,438
Kentucky,Pendleton County,4,14,616,282,334
Kentucky,Pendleton County,4,15,473,224,249
Kentucky,Pendleton County,4,16,331,154,177
Kentucky,Pendleton County,4,17,238,95,143
Kentucky,Pendleton County,4,18,218,66,152
Kentucky,Pendleton County,5,0,14552,7294,7258
Kentucky,Pendleton County,5,1,822,425,397
Kentucky,Pendleton County,5,2,927,449,478
Kentucky,Pendleton County,5,3,1015,510,505
Kentucky,Pendleton County,5,4,979,529,450
Kentucky,Pendleton County,5,5,938,465,473
Kentucky,Pendleton County,5,6,774,386,388
Kentucky,Pendleton County,5,7,839,434,405
Kentucky,Pendleton County,5,8,824,431,393
Kentucky,Pendleton County,5,9,1060,530,530
Kentucky,Pendleton County,5,10,1205,634,571
Kentucky,Pendleton County,5,11,1218,623,595
Kentucky,Pendleton County,5,12,1073,528,545
Kentucky,Pendleton County,5,13,932,490,442
Kentucky,Pendleton County,5,14,675,323,352
Kentucky,Pendleton County,5,15,487,226,261
Kentucky,Pendleton County,5,16,327,150,177
Kentucky,Pendleton County,5,17,231,89,142
Kentucky,Pendleton County,5,18,226,72,154
Kentucky,Pendleton County,6,0,14565,7354,7211
Kentucky,Pendleton County,6,1,819,446,373
Kentucky,Pendleton County,6,2,934,457,477
Kentucky,Pendleton County,6,3,998,504,494
Kentucky,Pendleton County,6,4,939,514,425
Kentucky,Pendleton County,6,5,973,492,481
Kentucky,Pendleton County,6,6,776,385,391
Kentucky,Pendleton County,6,7,832,411,421
Kentucky,Pendleton County,6,8,845,445,400
Kentucky,Pendleton County,6,9,1029,532,497
Kentucky,Pendleton County,6,10,1138,589,549
Kentucky,Pendleton County,6,11,1207,626,581
Kentucky,Pendleton County,6,12,1117,565,552
Kentucky,Pendleton County,6,13,943,486,457
Kentucky,Pendleton County,6,14,704,340,364
Kentucky,Pendleton County,6,15,515,233,282
Kentucky,Pendleton County,6,16,333,161,172
Kentucky,Pendleton County,6,17,239,96,143
Kentucky,Pendleton County,6,18,224,72,152
Kentucky,Pendleton County,7,0,14476,7291,7185
Kentucky,Pendleton County,7,1,818,428,390
Kentucky,Pendleton County,7,2,928,479,449
Kentucky,Pendleton County,7,3,923,451,472
Kentucky,Pendleton County,7,4,904,484,420
Kentucky,Pendleton County,7,5,967,495,472
Kentucky,Pendleton County,7,6,809,407,402
Kentucky,Pendleton County,7,7,807,404,403
Kentucky,Pendleton County,7,8,827,424,403
Kentucky,Pendleton County,7,9,993,519,474
Kentucky,Pendleton County,7,10,1125,572,553
Kentucky,Pendleton County,7,11,1198,631,567
Kentucky,Pendleton County,7,12,1149,577,572
Kentucky,Pendleton County,7,13,915,457,458
Kentucky,Pendleton County,7,14,765,385,380
Kentucky,Pendleton County,7,15,529,237,292
Kentucky,Pendleton County,7,16,347,168,179
Kentucky,Pendleton County,7,17,244,96,148
Kentucky,Pendleton County,7,18,228,77,151
Kentucky,Pendleton County,8,0,14487,7296,7191
Kentucky,Pendleton County,8,1,828,421,407
Kentucky,Pendleton County,8,2,885,470,415
Kentucky,Pendleton County,8,3,959,474,485
Kentucky,Pendleton County,8,4,896,472,424
Kentucky,Pendleton County,8,5,900,465,435
Kentucky,Pendleton County,8,6,850,433,417
Kentucky,Pendleton County,8,7,801,405,396
Kentucky,Pendleton County,8,8,854,421,433
Kentucky,Pendleton County,8,9,944,497,447
Kentucky,Pendleton County,8,10,1089,563,526
Kentucky,Pendleton County,8,11,1204,621,583
Kentucky,Pendleton County,8,12,1199,618,581
Kentucky,Pendleton County,8,13,909,452,457
Kentucky,Pendleton County,8,14,814,408,406
Kentucky,Pendleton County,8,15,523,231,292
Kentucky,Pendleton County,8,16,370,179,191
Kentucky,Pendleton County,8,17,246,98,148
Kentucky,Pendleton County,8,18,216,68,148
Kentucky,Pendleton County,9,0,14595,7431,7164
Kentucky,Pendleton County,9,1,884,457,427
Kentucky,Pendleton County,9,2,880,481,399
Kentucky,Pendleton County,9,3,991,498,493
Kentucky,Pendleton County,9,4,885,462,423
Kentucky,Pendleton County,9,5,879,476,403
Kentucky,Pendleton County,9,6,925,457,468
Kentucky,Pendleton County,9,7,776,391,385
Kentucky,Pendleton County,9,8,862,440,422
Kentucky,Pendleton County,9,9,886,464,422
Kentucky,Pendleton County,9,10,1063,548,515
Kentucky,Pendleton County,9,11,1198,651,547
Kentucky,Pendleton County,9,12,1209,616,593
Kentucky,Pendleton County,9,13,956,462,494
Kentucky,Pendleton County,9,14,838,435,403
Kentucky,Pendleton County,9,15,538,242,296
Kentucky,Pendleton County,9,16,368,174,194
Kentucky,Pendleton County,9,17,247,107,140
Kentucky,Pendleton County,9,18,210,70,140
Kentucky,Pendleton County,10,0,14602,7469,7133
Kentucky,Pendleton County,10,1,875,475,400
Kentucky,Pendleton County,10,2,850,445,405
Kentucky,Pendleton County,10,3,971,514,457
Kentucky,Pendleton County,10,4,921,470,451
Kentucky,Pendleton County,10,5,841,468,373
Kentucky,Pendleton County,10,6,966,488,478
Kentucky,Pendleton County,10,7,761,384,377
Kentucky,Pendleton County,10,8,846,435,411
Kentucky,Pendleton County,10,9,850,458,392
Kentucky,Pendleton County,10,10,1055,541,514
Kentucky,Pendleton County,10,11,1204,634,570
Kentucky,Pendleton County,10,12,1156,585,571
Kentucky,Pendleton County,10,13,1020,503,517
Kentucky,Pendleton County,10,14,853,435,418
Kentucky,Pendleton County,10,15,579,271,308
Kentucky,Pendleton County,10,16,388,182,206
Kentucky,Pendleton County,10,17,242,106,136
Kentucky,Pendleton County,10,18,224,75,149
Kentucky,Pendleton County,11,0,14588,7445,7143
Kentucky,Pendleton County,11,1,888,485,403
Kentucky,Pendleton County,11,2,857,458,399
Kentucky,Pendleton County,11,3,970,508,462
Kentucky,Pendleton County,11,4,908,456,452
Kentucky,Pendleton County,11,5,806,454,352
Kentucky,Pendleton County,11,6,969,483,486
Kentucky,Pendleton County,11,7,778,393,385
Kentucky,Pendleton County,11,8,832,415,417
Kentucky,Pendleton County,11,9,839,448,391
Kentucky,Pendleton County,11,10,1016,526,490
Kentucky,Pendleton County,11,11,1141,595,546
Kentucky,Pendleton County,11,12,1175,595,580
Kentucky,Pendleton County,11,13,1070,549,521
Kentucky,Pendleton County,11,14,838,410,428
Kentucky,Pendleton County,11,15,606,291,315
Kentucky,Pendleton County,11,16,415,183,232
Kentucky,Pendleton County,11,17,244,111,133
Kentucky,Pendleton County,11,18,236,85,151
Kentucky,Pendleton County,12,0,14590,7457,7133
Kentucky,Pendleton County,12,1,918,513,405
Kentucky,Pendleton County,12,2,845,433,412
Kentucky,Pendleton County,12,3,981,522,459
Kentucky,Pendleton County,12,4,893,462,431
Kentucky,Pendleton County,12,5,765,407,358
Kentucky,Pendleton County,12,6,1018,540,478
Kentucky,Pendleton County,12,7,781,400,381
Kentucky,Pendleton County,12,8,807,399,408
Kentucky,Pendleton County,12,9,821,421,400
Kentucky,Pendleton County,12,10,962,505,457
Kentucky,Pendleton County,12,11,1102,565,537
Kentucky,Pendleton County,12,12,1162,600,562
Kentucky,Pendleton County,12,13,1132,581,551
Kentucky,Pendleton County,12,14,807,384,423
Kentucky,Pendleton County,12,15,662,339,323
Kentucky,Pendleton County,12,16,433,180,253
Kentucky,Pendleton County,12,17,252,122,130
Kentucky,Pendleton County,12,18,249,84,165
Kentucky,Perry County,1,0,28712,14206,14506
Kentucky,Perry County,1,1,1691,882,809
Kentucky,Perry County,1,2,1717,901,816
Kentucky,Perry County,1,3,1691,850,841
Kentucky,Perry County,1,4,1895,1004,891
Kentucky,Perry County,1,5,1730,897,833
Kentucky,Perry County,1,6,1730,862,868
Kentucky,Perry County,1,7,1895,913,982
Kentucky,Perry County,1,8,1896,954,942
Kentucky,Perry County,1,9,2134,1085,1049
Kentucky,Perry County,1,10,2170,1051,1119
Kentucky,Perry County,1,11,2348,1159,1189
Kentucky,Perry County,1,12,2180,1037,1143
Kentucky,Perry County,1,13,1790,860,930
Kentucky,Perry County,1,14,1282,598,684
Kentucky,Perry County,1,15,1023,514,509
Kentucky,Perry County,1,16,648,288,360
Kentucky,Perry County,1,17,498,202,296
Kentucky,Perry County,1,18,394,149,245
Kentucky,Perry County,2,0,28697,14195,14502
Kentucky,Perry County,2,1,1690,881,809
Kentucky,Perry County,2,2,1716,900,816
Kentucky,Perry County,2,3,1688,847,841
Kentucky,Perry County,2,4,1890,1000,890
Kentucky,Perry County,2,5,1730,897,833
Kentucky,Perry County,2,6,1732,863,869
Kentucky,Perry County,2,7,1894,913,981
Kentucky,Perry County,2,8,1896,953,943
Kentucky,Perry County,2,9,2132,1085,1047
Kentucky,Perry County,2,10,2168,1049,1119
Kentucky,Perry County,2,11,2346,1158,1188
Kentucky,Perry County,2,12,2180,1038,1142
Kentucky,Perry County,2,13,1790,860,930
Kentucky,Perry County,2,14,1282,598,684
Kentucky,Perry County,2,15,1023,514,509
Kentucky,Perry County,2,16,648,288,360
Kentucky,Perry County,2,17,498,202,296
Kentucky,Perry County,2,18,394,149,245
Kentucky,Perry County,3,0,28669,14194,14475
Kentucky,Perry County,3,1,1702,885,817
Kentucky,Perry County,3,2,1702,898,804
Kentucky,Perry County,3,3,1692,853,839
Kentucky,Perry County,3,4,1841,975,866
Kentucky,Perry County,3,5,1760,908,852
Kentucky,Perry County,3,6,1751,875,876
Kentucky,Perry County,3,7,1878,915,963
Kentucky,Perry County,3,8,1898,952,946
Kentucky,Perry County,3,9,2112,1074,1038
Kentucky,Perry County,3,10,2162,1044,1118
Kentucky,Perry County,3,11,2347,1160,1187
Kentucky,Perry County,3,12,2173,1033,1140
Kentucky,Perry County,3,13,1809,875,934
Kentucky,Perry County,3,14,1282,591,691
Kentucky,Perry County,3,15,1026,517,509
Kentucky,Perry County,3,16,647,288,359
Kentucky,Perry County,3,17,491,198,293
Kentucky,Perry County,3,18,396,153,243
Kentucky,Perry County,4,0,28698,14239,14459
Kentucky,Perry County,4,1,1804,951,853
Kentucky,Perry County,4,2,1658,885,773
Kentucky,Perry County,4,3,1737,874,863
Kentucky,Perry County,4,4,1723,908,815
Kentucky,Perry County,4,5,1830,959,871
Kentucky,Perry County,4,6,1824,919,905
Kentucky,Perry County,4,7,1837,909,928
Kentucky,Perry County,4,8,1892,934,958
Kentucky,Perry County,4,9,2057,1039,1018
Kentucky,Perry County,4,10,2081,1002,1079
Kentucky,Perry County,4,11,2348,1173,1175
Kentucky,Perry County,4,12,2161,1018,1143
Kentucky,Perry County,4,13,1909,941,968
Kentucky,Perry County,4,14,1270,566,704
Kentucky,Perry County,4,15,1032,522,510
Kentucky,Perry County,4,16,658,299,359
Kentucky,Perry County,4,17,476,188,288
Kentucky,Perry County,4,18,401,152,249
Kentucky,Perry County,5,0,28295,14006,14289
Kentucky,Perry County,5,1,1818,960,858
Kentucky,Perry County,5,2,1696,888,808
Kentucky,Perry County,5,3,1744,899,845
Kentucky,Perry County,5,4,1549,805,744
Kentucky,Perry County,5,5,1762,891,871
Kentucky,Perry County,5,6,1818,935,883
Kentucky,Perry County,5,7,1766,878,888
Kentucky,Perry County,5,8,1862,917,945
Kentucky,Perry County,5,9,1994,994,1000
Kentucky,Perry County,5,10,2036,982,1054
Kentucky,Perry County,5,11,2232,1108,1124
Kentucky,Perry County,5,12,2199,1043,1156
Kentucky,Perry County,5,13,1879,933,946
Kentucky,Perry County,5,14,1355,597,758
Kentucky,Perry County,5,15,1034,515,519
Kentucky,Perry County,5,16,688,322,366
Kentucky,Perry County,5,17,439,177,262
Kentucky,Perry County,5,18,424,162,262
Kentucky,Perry County,6,0,27982,13855,14127
Kentucky,Perry County,6,1,1828,987,841
Kentucky,Perry County,6,2,1653,857,796
Kentucky,Perry County,6,3,1685,868,817
Kentucky,Perry County,6,4,1521,775,746
Kentucky,Perry County,6,5,1749,881,868
Kentucky,Perry County,6,6,1781,933,848
Kentucky,Perry County,6,7,1730,857,873
Kentucky,Perry County,6,8,1828,910,918
Kentucky,Perry County,6,9,1903,939,964
Kentucky,Perry County,6,10,2063,1007,1056
Kentucky,Perry County,6,11,2122,1020,1102
Kentucky,Perry County,6,12,2162,1060,1102
Kentucky,Perry County,6,13,1935,931,1004
Kentucky,Perry County,6,14,1407,649,758
Kentucky,Perry County,6,15,1023,484,539
Kentucky,Perry County,6,16,738,351,387
Kentucky,Perry County,6,17,416,166,250
Kentucky,Perry County,6,18,438,180,258
Kentucky,Perry County,7,0,27554,13619,13935
Kentucky,Perry County,7,1,1793,949,844
Kentucky,Perry County,7,2,1631,861,770
Kentucky,Perry County,7,3,1624,836,788
Kentucky,Perry County,7,4,1451,741,710
Kentucky,Perry County,7,5,1702,878,824
Kentucky,Perry County,7,6,1777,917,860
Kentucky,Perry County,7,7,1714,848,866
Kentucky,Perry County,7,8,1808,891,917
Kentucky,Perry County,7,9,1846,884,962
Kentucky,Perry County,7,10,1972,991,981
Kentucky,Perry County,7,11,2049,976,1073
Kentucky,Perry County,7,12,2121,1040,1081
Kentucky,Perry County,7,13,1940,928,1012
Kentucky,Perry County,7,14,1476,702,774
Kentucky,Perry County,7,15,1023,450,573
Kentucky,Perry County,7,16,777,375,402
Kentucky,Perry County,7,17,418,187,231
Kentucky,Perry County,7,18,432,165,267
Kentucky,Perry County,8,0,27373,13469,13904
Kentucky,Perry County,8,1,1843,977,866
Kentucky,Perry County,8,2,1620,843,777
Kentucky,Perry County,8,3,1601,838,763
Kentucky,Perry County,8,4,1460,742,718
Kentucky,Perry County,8,5,1615,839,776
Kentucky,Perry County,8,6,1768,885,883
Kentucky,Perry County,8,7,1713,850,863
Kentucky,Perry County,8,8,1794,883,911
Kentucky,Perry County,8,9,1747,850,897
Kentucky,Perry County,8,10,1954,965,989
Kentucky,Perry County,8,11,1951,916,1035
Kentucky,Perry County,8,12,2123,1036,1087
Kentucky,Perry County,8,13,1958,909,1049
Kentucky,Perry County,8,14,1538,737,801
Kentucky,Perry County,8,15,1029,445,584
Kentucky,Perry County,8,16,779,386,393
Kentucky,Perry County,8,17,446,194,252
Kentucky,Perry County,8,18,434,174,260
Kentucky,Perry County,9,0,27197,13390,13807
Kentucky,Perry County,9,1,1858,968,890
Kentucky,Perry County,9,2,1700,895,805
Kentucky,Perry County,9,3,1595,862,733
Kentucky,Perry County,9,4,1475,756,719
Kentucky,Perry County,9,5,1466,754,712
Kentucky,Perry County,9,6,1743,864,879
Kentucky,Perry County,9,7,1696,847,849
Kentucky,Perry County,9,8,1735,854,881
Kentucky,Perry County,9,9,1729,854,875
Kentucky,Perry County,9,10,1902,923,979
Kentucky,Perry County,9,11,1934,904,1030
Kentucky,Perry County,9,12,2109,1022,1087
Kentucky,Perry County,9,13,1934,904,1030
Kentucky,Perry County,9,14,1614,783,831
Kentucky,Perry County,9,15,1020,432,588
Kentucky,Perry County,9,16,776,388,388
Kentucky,Perry County,9,17,477,205,272
Kentucky,Perry County,9,18,434,175,259
Kentucky,Perry County,10,0,26586,13069,13517
Kentucky,Perry County,10,1,1832,942,890
Kentucky,Perry County,10,2,1677,872,805
Kentucky,Perry County,10,3,1610,867,743
Kentucky,Perry County,10,4,1455,757,698
Kentucky,Perry County,10,5,1355,697,658
Kentucky,Perry County,10,6,1690,809,881
Kentucky,Perry County,10,7,1619,817,802
Kentucky,Perry County,10,8,1646,821,825
Kentucky,Perry County,10,9,1692,829,863
Kentucky,Perry County,10,10,1837,900,937
Kentucky,Perry County,10,11,1924,905,1019
Kentucky,Perry County,10,12,1964,927,1037
Kentucky,Perry County,10,13,1935,916,1019
Kentucky,Perry County,10,14,1578,779,799
Kentucky,Perry County,10,15,1105,467,638
Kentucky,Perry County,10,16,741,367,374
Kentucky,Perry County,10,17,503,222,281
Kentucky,Perry County,10,18,423,175,248
Kentucky,Perry County,11,0,26208,12912,13296
Kentucky,Perry County,11,1,1775,901,874
Kentucky,Perry County,11,2,1667,885,782
Kentucky,Perry County,11,3,1637,852,785
Kentucky,Perry County,11,4,1444,751,693
Kentucky,Perry County,11,5,1311,666,645
Kentucky,Perry County,11,6,1667,822,845
Kentucky,Perry County,11,7,1578,801,777
Kentucky,Perry County,11,8,1630,816,814
Kentucky,Perry County,11,9,1691,842,849
Kentucky,Perry County,11,10,1697,825,872
Kentucky,Perry County,11,11,1932,931,1001
Kentucky,Perry County,11,12,1858,838,1020
Kentucky,Perry County,11,13,1894,923,971
Kentucky,Perry County,11,14,1615,782,833
Kentucky,Perry County,11,15,1141,521,620
Kentucky,Perry County,11,16,748,349,399
Kentucky,Perry County,11,17,509,232,277
Kentucky,Perry County,11,18,414,175,239
Kentucky,Perry County,12,0,25758,12740,13018
Kentucky,Perry County,12,1,1691,863,828
Kentucky,Perry County,12,2,1651,871,780
Kentucky,Perry County,12,3,1620,866,754
Kentucky,Perry County,12,4,1448,756,692
Kentucky,Perry County,12,5,1286,670,616
Kentucky,Perry County,12,6,1622,804,818
Kentucky,Perry County,12,7,1588,804,784
Kentucky,Perry County,12,8,1537,765,772
Kentucky,Perry County,12,9,1644,802,842
Kentucky,Perry County,12,10,1668,794,874
Kentucky,Perry County,12,11,1814,904,910
Kentucky,Perry County,12,12,1840,840,1000
Kentucky,Perry County,12,13,1856,901,955
Kentucky,Perry County,12,14,1632,781,851
Kentucky,Perry County,12,15,1189,572,617
Kentucky,Perry County,12,16,759,337,422
Kentucky,Perry County,12,17,520,239,281
Kentucky,Perry County,12,18,393,171,222
Kentucky,Pike County,1,0,65024,31867,33157
Kentucky,Pike County,1,1,3812,1938,1874
Kentucky,Pike County,1,2,3831,1971,1860
Kentucky,Pike County,1,3,4053,2090,1963
Kentucky,Pike County,1,4,4253,2260,1993
Kentucky,Pike County,1,5,3682,1904,1778
Kentucky,Pike County,1,6,3868,1919,1949
Kentucky,Pike County,1,7,4275,2180,2095
Kentucky,Pike County,1,8,4414,2159,2255
Kentucky,Pike County,1,9,4600,2233,2367
Kentucky,Pike County,1,10,4922,2417,2505
Kentucky,Pike County,1,11,5214,2532,2682
Kentucky,Pike County,1,12,4868,2396,2472
Kentucky,Pike County,1,13,4310,2041,2269
Kentucky,Pike County,1,14,3011,1446,1565
Kentucky,Pike County,1,15,2247,1017,1230
Kentucky,Pike County,1,16,1612,645,967
Kentucky,Pike County,1,17,1170,450,720
Kentucky,Pike County,1,18,882,269,613
Kentucky,Pike County,2,0,65029,31870,33159
Kentucky,Pike County,2,1,3812,1938,1874
Kentucky,Pike County,2,2,3831,1971,1860
Kentucky,Pike County,2,3,4053,2090,1963
Kentucky,Pike County,2,4,4254,2261,1993
Kentucky,Pike County,2,5,3682,1904,1778
Kentucky,Pike County,2,6,3868,1919,1949
Kentucky,Pike County,2,7,4275,2180,2095
Kentucky,Pike County,2,8,4414,2159,2255
Kentucky,Pike County,2,9,4600,2233,2367
Kentucky,Pike County,2,10,4922,2417,2505
Kentucky,Pike County,2,11,5216,2533,2683
Kentucky,Pike County,2,12,4868,2396,2472
Kentucky,Pike County,2,13,4312,2042,2270
Kentucky,Pike County,2,14,3011,1446,1565
Kentucky,Pike County,2,15,2247,1017,1230
Kentucky,Pike County,2,16,1612,645,967
Kentucky,Pike County,2,17,1170,450,720
Kentucky,Pike County,2,18,882,269,613
Kentucky,Pike County,3,0,65074,31897,33177
Kentucky,Pike County,3,1,3783,1927,1856
Kentucky,Pike County,3,2,3825,1969,1856
Kentucky,Pike County,3,3,4026,2078,1948
Kentucky,Pike County,3,4,4263,2252,2011
Kentucky,Pike County,3,5,3805,1982,1823
Kentucky,Pike County,3,6,3863,1924,1939
Kentucky,Pike County,3,7,4243,2155,2088
Kentucky,Pike County,3,8,4410,2164,2246
Kentucky,Pike County,3,9,4595,2231,2364
Kentucky,Pike County,3,10,4902,2395,2507
Kentucky,Pike County,3,11,5191,2523,2668
Kentucky,Pike County,3,12,4886,2407,2479
Kentucky,Pike County,3,13,4325,2051,2274
Kentucky,Pike County,3,14,3032,1448,1584
Kentucky,Pike County,3,15,2259,1023,1236
Kentucky,Pike County,3,16,1604,642,962
Kentucky,Pike County,3,17,1169,452,717
Kentucky,Pike County,3,18,893,274,619
Kentucky,Pike County,4,0,64908,31815,33093
Kentucky,Pike County,4,1,3737,1888,1849
Kentucky,Pike County,4,2,3865,1983,1882
Kentucky,Pike County,4,3,3912,2023,1889
Kentucky,Pike County,4,4,4161,2163,1998
Kentucky,Pike County,4,5,4038,2168,1870
Kentucky,Pike County,4,6,3780,1899,1881
Kentucky,Pike County,4,7,4139,2079,2060
Kentucky,Pike County,4,8,4333,2147,2186
Kentucky,Pike County,4,9,4593,2223,2370
Kentucky,Pike County,4,10,4746,2293,2453
Kentucky,Pike County,4,11,5145,2519,2626
Kentucky,Pike County,4,12,4923,2408,2515
Kentucky,Pike County,4,13,4454,2128,2326
Kentucky,Pike County,4,14,3098,1466,1632
Kentucky,Pike County,4,15,2323,1046,1277
Kentucky,Pike County,4,16,1577,632,945
Kentucky,Pike County,4,17,1177,468,709
Kentucky,Pike County,4,18,907,282,625
Kentucky,Pike County,5,0,64582,31672,32910
Kentucky,Pike County,5,1,3710,1851,1859
Kentucky,Pike County,5,2,3856,1970,1886
Kentucky,Pike County,5,3,3853,1958,1895
Kentucky,Pike County,5,4,4050,2112,1938
Kentucky,Pike County,5,5,4221,2272,1949
Kentucky,Pike County,5,6,3642,1869,1773
Kentucky,Pike County,5,7,4022,2014,2008
Kentucky,Pike County,5,8,4257,2105,2152
Kentucky,Pike County,5,9,4620,2249,2371
Kentucky,Pike County,5,10,4609,2230,2379
Kentucky,Pike County,5,11,4988,2443,2545
Kentucky,Pike County,5,12,4932,2415,2517
Kentucky,Pike County,5,13,4387,2114,2273
Kentucky,Pike County,5,14,3315,1569,1746
Kentucky,Pike County,5,15,2405,1068,1337
Kentucky,Pike County,5,16,1592,660,932
Kentucky,Pike County,5,17,1179,466,713
Kentucky,Pike County,5,18,944,307,637
Kentucky,Pike County,6,0,63853,31355,32498
Kentucky,Pike County,6,1,3613,1831,1782
Kentucky,Pike County,6,2,3801,1894,1907
Kentucky,Pike County,6,3,3793,1973,1820
Kentucky,Pike County,6,4,3922,2043,1879
Kentucky,Pike County,6,5,4211,2257,1954
Kentucky,Pike County,6,6,3519,1827,1692
Kentucky,Pike County,6,7,3944,1980,1964
Kentucky,Pike County,6,8,4182,2087,2095
Kentucky,Pike County,6,9,4428,2133,2295
Kentucky,Pike County,6,10,4547,2202,2345
Kentucky,Pike County,6,11,4833,2372,2461
Kentucky,Pike County,6,12,4908,2393,2515
Kentucky,Pike County,6,13,4395,2178,2217
Kentucky,Pike County,6,14,3483,1605,1878
Kentucky,Pike County,6,15,2441,1078,1363
Kentucky,Pike County,6,16,1693,739,954
Kentucky,Pike County,6,17,1163,445,718
Kentucky,Pike County,6,18,977,318,659
Kentucky,Pike County,7,0,62931,30889,32042
Kentucky,Pike County,7,1,3550,1804,1746
Kentucky,Pike County,7,2,3642,1804,1838
Kentucky,Pike County,7,3,3743,1934,1809
Kentucky,Pike County,7,4,3851,2045,1806
Kentucky,Pike County,7,5,4119,2193,1926
Kentucky,Pike County,7,6,3561,1830,1731
Kentucky,Pike County,7,7,3708,1862,1846
Kentucky,Pike County,7,8,4161,2093,2068
Kentucky,Pike County,7,9,4197,2035,2162
Kentucky,Pike County,7,10,4454,2135,2319
Kentucky,Pike County,7,11,4686,2320,2366
Kentucky,Pike County,7,12,4880,2387,2493
Kentucky,Pike County,7,13,4397,2141,2256
Kentucky,Pike County,7,14,3619,1657,1962
Kentucky,Pike County,7,15,2484,1130,1354
Kentucky,Pike County,7,16,1745,768,977
Kentucky,Pike County,7,17,1146,425,721
Kentucky,Pike County,7,18,988,326,662
Kentucky,Pike County,8,0,61781,30331,31450
Kentucky,Pike County,8,1,3500,1791,1709
Kentucky,Pike County,8,2,3534,1775,1759
Kentucky,Pike County,8,3,3625,1869,1756
Kentucky,Pike County,8,4,3788,1985,1803
Kentucky,Pike County,8,5,3828,2046,1782
Kentucky,Pike County,8,6,3612,1845,1767
Kentucky,Pike County,8,7,3516,1746,1770
Kentucky,Pike County,8,8,4007,2033,1974
Kentucky,Pike County,8,9,4126,2007,2119
Kentucky,Pike County,8,10,4259,2074,2185
Kentucky,Pike County,8,11,4550,2203,2347
Kentucky,Pike County,8,12,4771,2326,2445
Kentucky,Pike County,8,13,4424,2183,2241
Kentucky,Pike County,8,14,3733,1717,2016
Kentucky,Pike County,8,15,2557,1187,1370
Kentucky,Pike County,8,16,1793,785,1008
Kentucky,Pike County,8,17,1129,422,707
Kentucky,Pike County,8,18,1029,337,692
Kentucky,Pike County,9,0,60431,29574,30857
Kentucky,Pike County,9,1,3401,1731,1670
Kentucky,Pike County,9,2,3434,1732,1702
Kentucky,Pike County,9,3,3537,1787,1750
Kentucky,Pike County,9,4,3637,1917,1720
Kentucky,Pike County,9,5,3565,1881,1684
Kentucky,Pike County,9,6,3565,1856,1709
Kentucky,Pike County,9,7,3384,1691,1693
Kentucky,Pike County,9,8,3804,1886,1918
Kentucky,Pike County,9,9,4008,1989,2019
Kentucky,Pike County,9,10,4140,1991,2149
Kentucky,Pike County,9,11,4368,2096,2272
Kentucky,Pike County,9,12,4700,2307,2393
Kentucky,Pike County,9,13,4430,2165,2265
Kentucky,Pike County,9,14,3836,1768,2068
Kentucky,Pike County,9,15,2593,1196,1397
Kentucky,Pike County,9,16,1864,809,1055
Kentucky,Pike County,9,17,1109,422,687
Kentucky,Pike County,9,18,1056,350,706
Kentucky,Pike County,10,0,58905,28759,30146
Kentucky,Pike County,10,1,3195,1618,1577
Kentucky,Pike County,10,2,3327,1693,1634
Kentucky,Pike County,10,3,3509,1766,1743
Kentucky,Pike County,10,4,3470,1814,1656
Kentucky,Pike County,10,5,3287,1728,1559
Kentucky,Pike County,10,6,3549,1855,1694
Kentucky,Pike County,10,7,3162,1598,1564
Kentucky,Pike County,10,8,3629,1787,1842
Kentucky,Pike County,10,9,3868,1934,1934
Kentucky,Pike County,10,10,4066,1951,2115
Kentucky,Pike County,10,11,4149,1976,2173
Kentucky,Pike County,10,12,4511,2198,2313
Kentucky,Pike County,10,13,4407,2148,2259
Kentucky,Pike County,10,14,3819,1783,2036
Kentucky,Pike County,10,15,2825,1302,1523
Kentucky,Pike County,10,16,1883,784,1099
Kentucky,Pike County,10,17,1120,457,663
Kentucky,Pike County,10,18,1129,367,762
Kentucky,Pike County,11,0,58492,28533,29959
Kentucky,Pike County,11,1,3138,1592,1546
Kentucky,Pike County,11,2,3312,1697,1615
Kentucky,Pike County,11,3,3518,1758,1760
Kentucky,Pike County,11,4,3458,1812,1646
Kentucky,Pike County,11,5,3257,1703,1554
Kentucky,Pike County,11,6,3489,1832,1657
Kentucky,Pike County,11,7,3056,1556,1500
Kentucky,Pike County,11,8,3539,1751,1788
Kentucky,Pike County,11,9,3872,1933,1939
Kentucky,Pike County,11,10,3941,1881,2060
Kentucky,Pike County,11,11,4089,1956,2133
Kentucky,Pike County,11,12,4395,2115,2280
Kentucky,Pike County,11,13,4414,2141,2273
Kentucky,Pike County,11,14,3811,1832,1979
Kentucky,Pike County,11,15,2967,1312,1655
Kentucky,Pike County,11,16,1898,782,1116
Kentucky,Pike County,11,17,1186,512,674
Kentucky,Pike County,11,18,1152,368,784
Kentucky,Pike County,12,0,57876,28266,29610
Kentucky,Pike County,12,1,3054,1567,1487
Kentucky,Pike County,12,2,3310,1690,1620
Kentucky,Pike County,12,3,3455,1718,1737
Kentucky,Pike County,12,4,3466,1806,1660
Kentucky,Pike County,12,5,3200,1721,1479
Kentucky,Pike County,12,6,3470,1792,1678
Kentucky,Pike County,12,7,3024,1539,1485
Kentucky,Pike County,12,8,3414,1701,1713
Kentucky,Pike County,12,9,3824,1904,1920
Kentucky,Pike County,12,10,3821,1837,1984
Kentucky,Pike County,12,11,4010,1912,2098
Kentucky,Pike County,12,12,4199,2050,2149
Kentucky,Pike County,12,13,4383,2134,2249
Kentucky,Pike County,12,14,3827,1823,2004
Kentucky,Pike County,12,15,3113,1362,1751
Kentucky,Pike County,12,16,1923,809,1114
Kentucky,Pike County,12,17,1208,524,684
Kentucky,Pike County,12,18,1175,377,798
Kentucky,Powell County,1,0,12613,6270,6343
Kentucky,Powell County,1,1,858,430,428
Kentucky,Powell County,1,2,817,414,403
Kentucky,Powell County,1,3,888,450,438
Kentucky,Powell County,1,4,857,420,437
Kentucky,Powell County,1,5,692,356,336
Kentucky,Powell County,1,6,782,407,375
Kentucky,Powell County,1,7,785,403,382
Kentucky,Powell County,1,8,879,436,443
Kentucky,Powell County,1,9,864,461,403
Kentucky,Powell County,1,10,940,470,470
Kentucky,Powell County,1,11,938,455,483
Kentucky,Powell County,1,12,896,438,458
Kentucky,Powell County,1,13,775,384,391
Kentucky,Powell County,1,14,584,292,292
Kentucky,Powell County,1,15,431,207,224
Kentucky,Powell County,1,16,324,134,190
Kentucky,Powell County,1,17,196,83,113
Kentucky,Powell County,1,18,107,30,77
Kentucky,Powell County,2,0,12613,6270,6343
Kentucky,Powell County,2,1,858,430,428
Kentucky,Powell County,2,2,817,414,403
Kentucky,Powell County,2,3,888,450,438
Kentucky,Powell County,2,4,857,420,437
Kentucky,Powell County,2,5,692,356,336
Kentucky,Powell County,2,6,782,407,375
Kentucky,Powell County,2,7,785,403,382
Kentucky,Powell County,2,8,879,436,443
Kentucky,Powell County,2,9,864,461,403
Kentucky,Powell County,2,10,940,470,470
Kentucky,Powell County,2,11,938,455,483
Kentucky,Powell County,2,12,896,438,458
Kentucky,Powell County,2,13,775,384,391
Kentucky,Powell County,2,14,584,292,292
Kentucky,Powell County,2,15,431,207,224
Kentucky,Powell County,2,16,324,134,190
Kentucky,Powell County,2,17,196,83,113
Kentucky,Powell County,2,18,107,30,77
Kentucky,Powell County,3,0,12643,6270,6373
Kentucky,Powell County,3,1,857,423,434
Kentucky,Powell County,3,2,824,416,408
Kentucky,Powell County,3,3,883,453,430
Kentucky,Powell County,3,4,853,415,438
Kentucky,Powell County,3,5,706,360,346
Kentucky,Powell County,3,6,781,404,377
Kentucky,Powell County,3,7,779,397,382
Kentucky,Powell County,3,8,881,436,445
Kentucky,Powell County,3,9,863,459,404
Kentucky,Powell County,3,10,939,469,470
Kentucky,Powell County,3,11,950,462,488
Kentucky,Powell County,3,12,897,438,459
Kentucky,Powell County,3,13,779,389,390
Kentucky,Powell County,3,14,585,291,294
Kentucky,Powell County,3,15,437,209,228
Kentucky,Powell County,3,16,325,136,189
Kentucky,Powell County,3,17,196,82,114
Kentucky,Powell County,3,18,108,31,77
Kentucky,Powell County,4,0,12618,6279,6339
Kentucky,Powell County,4,1,844,432,412
Kentucky,Powell County,4,2,822,408,414
Kentucky,Powell County,4,3,853,455,398
Kentucky,Powell County,4,4,823,399,424
Kentucky,Powell County,4,5,764,381,383
Kentucky,Powell County,4,6,772,386,386
Kentucky,Powell County,4,7,765,388,377
Kentucky,Powell County,4,8,851,428,423
Kentucky,Powell County,4,9,871,456,415
Kentucky,Powell County,4,10,940,485,455
Kentucky,Powell County,4,11,954,464,490
Kentucky,Powell County,4,12,896,436,460
Kentucky,Powell County,4,13,792,398,394
Kentucky,Powell County,4,14,590,294,296
Kentucky,Powell County,4,15,435,206,229
Kentucky,Powell County,4,16,334,145,189
Kentucky,Powell County,4,17,195,82,113
Kentucky,Powell County,4,18,117,36,81
Kentucky,Powell County,5,0,12471,6209,6262
Kentucky,Powell County,5,1,815,418,397
Kentucky,Powell County,5,2,819,402,417
Kentucky,Powell County,5,3,840,436,404
Kentucky,Powell County,5,4,794,396,398
Kentucky,Powell County,5,5,783,392,391
Kentucky,Powell County,5,6,749,383,366
Kentucky,Powell County,5,7,783,383,400
Kentucky,Powell County,5,8,790,402,388
Kentucky,Powell County,5,9,873,446,427
Kentucky,Powell County,5,10,927,496,431
Kentucky,Powell County,5,11,900,432,468
Kentucky,Powell County,5,12,909,447,462
Kentucky,Powell County,5,13,769,372,397
Kentucky,Powell County,5,14,626,310,316
Kentucky,Powell County,5,15,430,212,218
Kentucky,Powell County,5,16,337,150,187
Kentucky,Powell County,5,17,202,90,112
Kentucky,Powell County,5,18,125,42,83
Kentucky,Powell County,6,0,12470,6186,6284
Kentucky,Powell County,6,1,794,409,385
Kentucky,Powell County,6,2,862,442,420
Kentucky,Powell County,6,3,802,410,392
Kentucky,Powell County,6,4,819,400,419
Kentucky,Powell County,6,5,757,377,380
Kentucky,Powell County,6,6,740,368,372
Kentucky,Powell County,6,7,806,384,422
Kentucky,Powell County,6,8,788,414,374
Kentucky,Powell County,6,9,898,452,446
Kentucky,Powell County,6,10,881,477,404
Kentucky,Powell County,6,11,901,430,471
Kentucky,Powell County,6,12,916,454,462
Kentucky,Powell County,6,13,766,368,398
Kentucky,Powell County,6,14,648,316,332
Kentucky,Powell County,6,15,433,210,223
Kentucky,Powell County,6,16,317,129,188
Kentucky,Powell County,6,17,211,96,115
Kentucky,Powell County,6,18,131,50,81
Kentucky,Powell County,7,0,12349,6146,6203
Kentucky,Powell County,7,1,787,417,370
Kentucky,Powell County,7,2,816,421,395
Kentucky,Powell County,7,3,810,414,396
Kentucky,Powell County,7,4,775,379,396
Kentucky,Powell County,7,5,775,390,385
Kentucky,Powell County,7,6,748,375,373
Kentucky,Powell County,7,7,781,382,399
Kentucky,Powell County,7,8,797,404,393
Kentucky,Powell County,7,9,876,440,436
Kentucky,Powell County,7,10,841,460,381
Kentucky,Powell County,7,11,878,413,465
Kentucky,Powell County,7,12,915,450,465
Kentucky,Powell County,7,13,790,394,396
Kentucky,Powell County,7,14,674,326,348
Kentucky,Powell County,7,15,424,202,222
Kentucky,Powell County,7,16,314,134,180
Kentucky,Powell County,7,17,202,88,114
Kentucky,Powell County,7,18,146,57,89
Kentucky,Powell County,8,0,12226,6086,6140
Kentucky,Powell County,8,1,788,439,349
Kentucky,Powell County,8,2,828,427,401
Kentucky,Powell County,8,3,796,396,400
Kentucky,Powell County,8,4,792,402,390
Kentucky,Powell County,8,5,721,354,367
Kentucky,Powell County,8,6,746,392,354
Kentucky,Powell County,8,7,773,379,394
Kentucky,Powell County,8,8,788,389,399
Kentucky,Powell County,8,9,851,419,432
Kentucky,Powell County,8,10,807,435,372
Kentucky,Powell County,8,11,860,416,444
Kentucky,Powell County,8,12,887,429,458
Kentucky,Powell County,8,13,813,397,416
Kentucky,Powell County,8,14,679,327,352
Kentucky,Powell County,8,15,450,219,231
Kentucky,Powell County,8,16,293,125,168
Kentucky,Powell County,8,17,205,82,123
Kentucky,Powell County,8,18,149,59,90
Kentucky,Powell County,9,0,12266,6093,6173
Kentucky,Powell County,9,1,827,441,386
Kentucky,Powell County,9,2,781,406,375
Kentucky,Powell County,9,3,833,407,426
Kentucky,Powell County,9,4,781,413,368
Kentucky,Powell County,9,5,720,342,378
Kentucky,Powell County,9,6,777,416,361
Kentucky,Powell County,9,7,739,381,358
Kentucky,Powell County,9,8,779,379,400
Kentucky,Powell County,9,9,823,407,416
Kentucky,Powell County,9,10,815,429,386
Kentucky,Powell County,9,11,889,447,442
Kentucky,Powell County,9,12,868,412,456
Kentucky,Powell County,9,13,792,383,409
Kentucky,Powell County,9,14,707,340,367
Kentucky,Powell County,9,15,468,225,243
Kentucky,Powell County,9,16,325,135,190
Kentucky,Powell County,9,17,200,78,122
Kentucky,Powell County,9,18,142,52,90
Kentucky,Powell County,10,0,12297,6123,6174
Kentucky,Powell County,10,1,815,417,398
Kentucky,Powell County,10,2,807,421,386
Kentucky,Powell County,10,3,828,414,414
Kentucky,Powell County,10,4,773,405,368
Kentucky,Powell County,10,5,697,342,355
Kentucky,Powell County,10,6,804,426,378
Kentucky,Powell County,10,7,705,363,342
Kentucky,Powell County,10,8,830,411,419
Kentucky,Powell County,10,9,780,384,396
Kentucky,Powell County,10,10,832,435,397
Kentucky,Powell County,10,11,859,452,407
Kentucky,Powell County,10,12,851,390,461
Kentucky,Powell County,10,13,818,412,406
Kentucky,Powell County,10,14,692,321,371
Kentucky,Powell County,10,15,529,250,279
Kentucky,Powell County,10,16,324,147,177
Kentucky,Powell County,10,17,195,77,118
Kentucky,Powell County,10,18,158,56,102
Kentucky,Powell County,11,0,12371,6149,6222
Kentucky,Powell County,11,1,820,421,399
Kentucky,Powell County,11,2,820,418,402
Kentucky,Powell County,11,3,846,438,408
Kentucky,Powell County,11,4,764,401,363
Kentucky,Powell County,11,5,706,340,366
Kentucky,Powell County,11,6,811,417,394
Kentucky,Powell County,11,7,714,363,351
Kentucky,Powell County,11,8,833,416,417
Kentucky,Powell County,11,9,784,395,389
Kentucky,Powell County,11,10,848,430,418
Kentucky,Powell County,11,11,804,431,373
Kentucky,Powell County,11,12,851,389,462
Kentucky,Powell County,11,13,843,426,417
Kentucky,Powell County,11,14,683,316,367
Kentucky,Powell County,11,15,546,257,289
Kentucky,Powell County,11,16,340,160,180
Kentucky,Powell County,11,17,198,74,124
Kentucky,Powell County,11,18,160,57,103
Kentucky,Powell County,12,0,12359,6130,6229
Kentucky,Powell County,12,1,808,415,393
Kentucky,Powell County,12,2,844,447,397
Kentucky,Powell County,12,3,813,407,406
Kentucky,Powell County,12,4,738,378,360
Kentucky,Powell County,12,5,704,336,368
Kentucky,Powell County,12,6,834,422,412
Kentucky,Powell County,12,7,710,355,355
Kentucky,Powell County,12,8,811,421,390
Kentucky,Powell County,12,9,784,389,395
Kentucky,Powell County,12,10,840,428,412
Kentucky,Powell County,12,11,791,425,366
Kentucky,Powell County,12,12,836,384,452
Kentucky,Powell County,12,13,835,408,427
Kentucky,Powell County,12,14,717,348,369
Kentucky,Powell County,12,15,576,268,308
Kentucky,Powell County,12,16,349,162,187
Kentucky,Powell County,12,17,216,94,122
Kentucky,Powell County,12,18,153,43,110
Kentucky,Pulaski County,1,0,63063,30781,32282
Kentucky,Pulaski County,1,1,3838,1939,1899
Kentucky,Pulaski County,1,2,4082,2098,1984
Kentucky,Pulaski County,1,3,3998,2004,1994
Kentucky,Pulaski County,1,4,3966,2091,1875
Kentucky,Pulaski County,1,5,3296,1625,1671
Kentucky,Pulaski County,1,6,3559,1753,1806
Kentucky,Pulaski County,1,7,3834,1881,1953
Kentucky,Pulaski County,1,8,4031,2032,1999
Kentucky,Pulaski County,1,9,4308,2137,2171
Kentucky,Pulaski County,1,10,4715,2295,2420
Kentucky,Pulaski County,1,11,4651,2267,2384
Kentucky,Pulaski County,1,12,4438,2133,2305
Kentucky,Pulaski County,1,13,4106,1941,2165
Kentucky,Pulaski County,1,14,3293,1576,1717
Kentucky,Pulaski County,1,15,2594,1262,1332
Kentucky,Pulaski County,1,16,1950,854,1096
Kentucky,Pulaski County,1,17,1352,551,801
Kentucky,Pulaski County,1,18,1052,342,710
Kentucky,Pulaski County,2,0,63061,30780,32281
Kentucky,Pulaski County,2,1,3838,1939,1899
Kentucky,Pulaski County,2,2,4081,2097,1984
Kentucky,Pulaski County,2,3,3996,2003,1993
Kentucky,Pulaski County,2,4,3966,2091,1875
Kentucky,Pulaski County,2,5,3296,1625,1671
Kentucky,Pulaski County,2,6,3560,1754,1806
Kentucky,Pulaski County,2,7,3834,1881,1953
Kentucky,Pulaski County,2,8,4031,2032,1999
Kentucky,Pulaski County,2,9,4307,2137,2170
Kentucky,Pulaski County,2,10,4714,2294,2420
Kentucky,Pulaski County,2,11,4651,2267,2384
Kentucky,Pulaski County,2,12,4439,2133,2306
Kentucky,Pulaski County,2,13,4107,1942,2165
Kentucky,Pulaski County,2,14,3293,1576,1717
Kentucky,Pulaski County,2,15,2594,1262,1332
Kentucky,Pulaski County,2,16,1950,854,1096
Kentucky,Pulaski County,2,17,1352,551,801
Kentucky,Pulaski County,2,18,1052,342,710
Kentucky,Pulaski County,3,0,63190,30858,32332
Kentucky,Pulaski County,3,1,3838,1939,1899
Kentucky,Pulaski County,3,2,4096,2098,1998
Kentucky,Pulaski County,3,3,4003,2016,1987
Kentucky,Pulaski County,3,4,3931,2081,1850
Kentucky,Pulaski County,3,5,3340,1641,1699
Kentucky,Pulaski County,3,6,3556,1744,1812
Kentucky,Pulaski County,3,7,3854,1900,1954
Kentucky,Pulaski County,3,8,4003,2009,1994
Kentucky,Pulaski County,3,9,4325,2152,2173
Kentucky,Pulaski County,3,10,4717,2301,2416
Kentucky,Pulaski County,3,11,4659,2263,2396
Kentucky,Pulaski County,3,12,4445,2136,2309
Kentucky,Pulaski County,3,13,4137,1962,2175
Kentucky,Pulaski County,3,14,3315,1589,1726
Kentucky,Pulaski County,3,15,2597,1262,1335
Kentucky,Pulaski County,3,16,1959,860,1099
Kentucky,Pulaski County,3,17,1356,555,801
Kentucky,Pulaski County,3,18,1059,350,709
Kentucky,Pulaski County,4,0,63510,31002,32508
Kentucky,Pulaski County,4,1,3725,1934,1791
Kentucky,Pulaski County,4,2,4113,2089,2024
Kentucky,Pulaski County,4,3,4096,2078,2018
Kentucky,Pulaski County,4,4,3820,2027,1793
Kentucky,Pulaski County,4,5,3497,1714,1783
Kentucky,Pulaski County,4,6,3558,1714,1844
Kentucky,Pulaski County,4,7,3847,1911,1936
Kentucky,Pulaski County,4,8,3881,1915,1966
Kentucky,Pulaski County,4,9,4367,2166,2201
Kentucky,Pulaski County,4,10,4644,2290,2354
Kentucky,Pulaski County,4,11,4723,2278,2445
Kentucky,Pulaski County,4,12,4477,2157,2320
Kentucky,Pulaski County,4,13,4297,2045,2252
Kentucky,Pulaski County,4,14,3382,1608,1774
Kentucky,Pulaski County,4,15,2657,1287,1370
Kentucky,Pulaski County,4,16,1983,876,1107
Kentucky,Pulaski County,4,17,1354,563,791
Kentucky,Pulaski County,4,18,1089,350,739
Kentucky,Pulaski County,5,0,63514,31005,32509
Kentucky,Pulaski County,5,1,3776,1959,1817
Kentucky,Pulaski County,5,2,4082,2070,2012
Kentucky,Pulaski County,5,3,4102,2086,2016
Kentucky,Pulaski County,5,4,3721,1961,1760
Kentucky,Pulaski County,5,5,3605,1793,1812
Kentucky,Pulaski County,5,6,3563,1700,1863
Kentucky,Pulaski County,5,7,3791,1878,1913
Kentucky,Pulaski County,5,8,3849,1894,1955
Kentucky,Pulaski County,5,9,4309,2139,2170
Kentucky,Pulaski County,5,10,4536,2266,2270
Kentucky,Pulaski County,5,11,4682,2264,2418
Kentucky,Pulaski County,5,12,4534,2184,2350
Kentucky,Pulaski County,5,13,4182,1988,2194
Kentucky,Pulaski County,5,14,3592,1701,1891
Kentucky,Pulaski County,5,15,2733,1313,1420
Kentucky,Pulaski County,5,16,1988,877,1111
Kentucky,Pulaski County,5,17,1376,589,787
Kentucky,Pulaski County,5,18,1093,343,750
Kentucky,Pulaski County,6,0,63793,31172,32621
Kentucky,Pulaski County,6,1,3808,1973,1835
Kentucky,Pulaski County,6,2,4080,2064,2016
Kentucky,Pulaski County,6,3,4174,2178,1996
Kentucky,Pulaski County,6,4,3715,1901,1814
Kentucky,Pulaski County,6,5,3757,1898,1859
Kentucky,Pulaski County,6,6,3436,1645,1791
Kentucky,Pulaski County,6,7,3793,1866,1927
Kentucky,Pulaski County,6,8,3873,1915,1958
Kentucky,Pulaski County,6,9,4254,2116,2138
Kentucky,Pulaski County,6,10,4397,2204,2193
Kentucky,Pulaski County,6,11,4739,2278,2461
Kentucky,Pulaski County,6,12,4550,2195,2355
Kentucky,Pulaski County,6,13,4177,1991,2186
Kentucky,Pulaski County,6,14,3698,1744,1954
Kentucky,Pulaski County,6,15,2791,1322,1469
Kentucky,Pulaski County,6,16,2021,909,1112
Kentucky,Pulaski County,6,17,1419,612,807
Kentucky,Pulaski County,6,18,1111,361,750
Kentucky,Pulaski County,7,0,63866,31178,32688
Kentucky,Pulaski County,7,1,3755,1966,1789
Kentucky,Pulaski County,7,2,4034,2013,2021
Kentucky,Pulaski County,7,3,4200,2188,2012
Kentucky,Pulaski County,7,4,3715,1892,1823
Kentucky,Pulaski County,7,5,3723,1925,1798
Kentucky,Pulaski County,7,6,3474,1651,1823
Kentucky,Pulaski County,7,7,3757,1848,1909
Kentucky,Pulaski County,7,8,3871,1884,1987
Kentucky,Pulaski County,7,9,4200,2117,2083
Kentucky,Pulaski County,7,10,4308,2121,2187
Kentucky,Pulaski County,7,11,4719,2285,2434
Kentucky,Pulaski County,7,12,4541,2192,2349
Kentucky,Pulaski County,7,13,4266,2028,2238
Kentucky,Pulaski County,7,14,3794,1787,2007
Kentucky,Pulaski County,7,15,2910,1368,1542
Kentucky,Pulaski County,7,16,2071,958,1113
Kentucky,Pulaski County,7,17,1413,587,826
Kentucky,Pulaski County,7,18,1115,368,747
Kentucky,Pulaski County,8,0,63862,31220,32642
Kentucky,Pulaski County,8,1,3701,1954,1747
Kentucky,Pulaski County,8,2,3942,2010,1932
Kentucky,Pulaski County,8,3,4231,2181,2050
Kentucky,Pulaski County,8,4,3772,1918,1854
Kentucky,Pulaski County,8,5,3545,1824,1721
Kentucky,Pulaski County,8,6,3666,1772,1894
Kentucky,Pulaski County,8,7,3647,1796,1851
Kentucky,Pulaski County,8,8,3909,1893,2016
Kentucky,Pulaski County,8,9,4116,2104,2012
Kentucky,Pulaski County,8,10,4276,2114,2162
Kentucky,Pulaski County,8,11,4680,2233,2447
Kentucky,Pulaski County,8,12,4548,2189,2359
Kentucky,Pulaski County,8,13,4277,2041,2236
Kentucky,Pulaski County,8,14,3896,1839,2057
Kentucky,Pulaski County,8,15,2959,1384,1575
Kentucky,Pulaski County,8,16,2124,975,1149
Kentucky,Pulaski County,8,17,1403,587,816
Kentucky,Pulaski County,8,18,1170,406,764
Kentucky,Pulaski County,9,0,64013,31288,32725
Kentucky,Pulaski County,9,1,3713,1920,1793
Kentucky,Pulaski County,9,2,3914,2046,1868
Kentucky,Pulaski County,9,3,4207,2142,2065
Kentucky,Pulaski County,9,4,3770,1939,1831
Kentucky,Pulaski County,9,5,3421,1786,1635
Kentucky,Pulaski County,9,6,3884,1897,1987
Kentucky,Pulaski County,9,7,3586,1738,1848
Kentucky,Pulaski County,9,8,3907,1933,1974
Kentucky,Pulaski County,9,9,3918,1943,1975
Kentucky,Pulaski County,9,10,4360,2158,2202
Kentucky,Pulaski County,9,11,4591,2202,2389
Kentucky,Pulaski County,9,12,4591,2193,2398
Kentucky,Pulaski County,9,13,4302,2064,2238
Kentucky,Pulaski County,9,14,4068,1947,2121
Kentucky,Pulaski County,9,15,3016,1382,1634
Kentucky,Pulaski County,9,16,2142,979,1163
Kentucky,Pulaski County,9,17,1442,611,831
Kentucky,Pulaski County,9,18,1181,408,773
Kentucky,Pulaski County,10,0,64314,31376,32938
Kentucky,Pulaski County,10,1,3743,1900,1843
Kentucky,Pulaski County,10,2,3927,2077,1850
Kentucky,Pulaski County,10,3,4186,2100,2086
Kentucky,Pulaski County,10,4,3836,1996,1840
Kentucky,Pulaski County,10,5,3434,1774,1660
Kentucky,Pulaski County,10,6,3945,1943,2002
Kentucky,Pulaski County,10,7,3633,1749,1884
Kentucky,Pulaski County,10,8,3853,1898,1955
Kentucky,Pulaski County,10,9,3936,1943,1993
Kentucky,Pulaski County,10,10,4336,2157,2179
Kentucky,Pulaski County,10,11,4526,2173,2353
Kentucky,Pulaski County,10,12,4610,2218,2392
Kentucky,Pulaski County,10,13,4400,2097,2303
Kentucky,Pulaski County,10,14,3903,1843,2060
Kentucky,Pulaski County,10,15,3242,1483,1759
Kentucky,Pulaski County,10,16,2214,1019,1195
Kentucky,Pulaski County,10,17,1429,610,819
Kentucky,Pulaski County,10,18,1161,396,765
Kentucky,Pulaski County,11,0,64584,31528,33056
Kentucky,Pulaski County,11,1,3777,1920,1857
Kentucky,Pulaski County,11,2,3930,2077,1853
Kentucky,Pulaski County,11,3,4187,2116,2071
Kentucky,Pulaski County,11,4,3826,2019,1807
Kentucky,Pulaski County,11,5,3391,1714,1677
Kentucky,Pulaski County,11,6,4081,2046,2035
Kentucky,Pulaski County,11,7,3565,1709,1856
Kentucky,Pulaski County,11,8,3842,1858,1984
Kentucky,Pulaski County,11,9,3967,1970,1997
Kentucky,Pulaski County,11,10,4335,2132,2203
Kentucky,Pulaski County,11,11,4421,2155,2266
Kentucky,Pulaski County,11,12,4680,2228,2452
Kentucky,Pulaski County,11,13,4472,2140,2332
Kentucky,Pulaski County,11,14,3907,1846,2061
Kentucky,Pulaski County,11,15,3311,1540,1771
Kentucky,Pulaski County,11,16,2258,1023,1235
Kentucky,Pulaski County,11,17,1476,638,838
Kentucky,Pulaski County,11,18,1158,397,761
Kentucky,Pulaski County,12,0,64979,31708,33271
Kentucky,Pulaski County,12,1,3809,1923,1886
Kentucky,Pulaski County,12,2,3893,2049,1844
Kentucky,Pulaski County,12,3,4188,2100,2088
Kentucky,Pulaski County,12,4,3860,2023,1837
Kentucky,Pulaski County,12,5,3370,1715,1655
Kentucky,Pulaski County,12,6,4143,2090,2053
Kentucky,Pulaski County,12,7,3653,1751,1902
Kentucky,Pulaski County,12,8,3865,1885,1980
Kentucky,Pulaski County,12,9,3945,1930,2015
Kentucky,Pulaski County,12,10,4290,2148,2142
Kentucky,Pulaski County,12,11,4393,2120,2273
Kentucky,Pulaski County,12,12,4702,2239,2463
Kentucky,Pulaski County,12,13,4538,2204,2334
Kentucky,Pulaski County,12,14,3938,1825,2113
Kentucky,Pulaski County,12,15,3388,1588,1800
Kentucky,Pulaski County,12,16,2332,1046,1286
Kentucky,Pulaski County,12,17,1527,678,849
Kentucky,Pulaski County,12,18,1145,394,751
Kentucky,Robertson County,1,0,2282,1147,1135
Kentucky,Robertson County,1,1,140,67,73
Kentucky,Robertson County,1,2,121,71,50
Kentucky,Robertson County,1,3,128,68,60
Kentucky,Robertson County,1,4,173,93,80
Kentucky,Robertson County,1,5,117,56,61
Kentucky,Robertson County,1,6,107,50,57
Kentucky,Robertson County,1,7,124,63,61
Kentucky,Robertson County,1,8,103,49,54
Kentucky,Robertson County,1,9,165,85,80
Kentucky,Robertson County,1,10,186,95,91
Kentucky,Robertson County,1,11,165,73,92
Kentucky,Robertson County,1,12,171,96,75
Kentucky,Robertson County,1,13,155,78,77
Kentucky,Robertson County,1,14,143,71,72
Kentucky,Robertson County,1,15,95,51,44
Kentucky,Robertson County,1,16,77,33,44
Kentucky,Robertson County,1,17,59,28,31
Kentucky,Robertson County,1,18,53,20,33
Kentucky,Robertson County,2,0,2282,1147,1135
Kentucky,Robertson County,2,1,140,67,73
Kentucky,Robertson County,2,2,121,71,50
Kentucky,Robertson County,2,3,128,68,60
Kentucky,Robertson County,2,4,173,93,80
Kentucky,Robertson County,2,5,117,56,61
Kentucky,Robertson County,2,6,107,50,57
Kentucky,Robertson County,2,7,124,63,61
Kentucky,Robertson County,2,8,103,49,54
Kentucky,Robertson County,2,9,165,85,80
Kentucky,Robertson County,2,10,186,95,91
Kentucky,Robertson County,2,11,165,73,92
Kentucky,Robertson County,2,12,171,96,75
Kentucky,Robertson County,2,13,155,78,77
Kentucky,Robertson County,2,14,143,71,72
Kentucky,Robertson County,2,15,95,51,44
Kentucky,Robertson County,2,16,77,33,44
Kentucky,Robertson County,2,17,59,28,31
Kentucky,Robertson County,2,18,53,20,33
Kentucky,Robertson County,3,0,2275,1144,1131
Kentucky,Robertson County,3,1,136,65,71
Kentucky,Robertson County,3,2,121,70,51
Kentucky,Robertson County,3,3,126,67,59
Kentucky,Robertson County,3,4,169,91,78
Kentucky,Robertson County,3,5,120,58,62
Kentucky,Robertson County,3,6,107,52,55
Kentucky,Robertson County,3,7,128,63,65
Kentucky,Robertson County,3,8,104,50,54
Kentucky,Robertson County,3,9,161,82,79
Kentucky,Robertson County,3,10,187,97,90
Kentucky,Robertson County,3,11,166,74,92
Kentucky,Robertson County,3,12,170,95,75
Kentucky,Robertson County,3,13,152,77,75
Kentucky,Robertson County,3,14,145,71,74
Kentucky,Robertson County,3,15,95,50,45
Kentucky,Robertson County,3,16,77,34,43
Kentucky,Robertson County,3,17,61,28,33
Kentucky,Robertson County,3,18,50,20,30
Kentucky,Robertson County,4,0,2290,1143,1147
Kentucky,Robertson County,4,1,139,76,63
Kentucky,Robertson County,4,2,130,68,62
Kentucky,Robertson County,4,3,122,65,57
Kentucky,Robertson County,4,4,164,86,78
Kentucky,Robertson County,4,5,122,58,64
Kentucky,Robertson County,4,6,98,51,47
Kentucky,Robertson County,4,7,130,58,72
Kentucky,Robertson County,4,8,113,57,56
Kentucky,Robertson County,4,9,150,72,78
Kentucky,Robertson County,4,10,197,105,92
Kentucky,Robertson County,4,11,156,71,85
Kentucky,Robertson County,4,12,171,89,82
Kentucky,Robertson County,4,13,153,80,73
Kentucky,Robertson County,4,14,146,72,74
Kentucky,Robertson County,4,15,103,52,51
Kentucky,Robertson County,4,16,74,31,43
Kentucky,Robertson County,4,17,69,29,40
Kentucky,Robertson County,4,18,53,23,30
Kentucky,Robertson County,5,0,2214,1108,1106
Kentucky,Robertson County,5,1,133,67,66
Kentucky,Robertson County,5,2,119,62,57
Kentucky,Robertson County,5,3,126,72,54
Kentucky,Robertson County,5,4,134,70,64
Kentucky,Robertson County,5,5,122,64,58
Kentucky,Robertson County,5,6,105,51,54
Kentucky,Robertson County,5,7,109,48,61
Kentucky,Robertson County,5,8,106,54,52
Kentucky,Robertson County,5,9,136,62,74
Kentucky,Robertson County,5,10,192,104,88
Kentucky,Robertson County,5,11,166,79,87
Kentucky,Robertson County,5,12,163,78,85
Kentucky,Robertson County,5,13,140,79,61
Kentucky,Robertson County,5,14,154,72,82
Kentucky,Robertson County,5,15,103,52,51
Kentucky,Robertson County,5,16,78,39,39
Kentucky,Robertson County,5,17,71,27,44
Kentucky,Robertson County,5,18,57,28,29
Kentucky,Robertson County,6,0,2214,1112,1102
Kentucky,Robertson County,6,1,116,58,58
Kentucky,Robertson County,6,2,133,65,68
Kentucky,Robertson County,6,3,121,71,50
Kentucky,Robertson County,6,4,128,67,61
Kentucky,Robertson County,6,5,139,73,66
Kentucky,Robertson County,6,6,101,50,51
Kentucky,Robertson County,6,7,98,42,56
Kentucky,Robertson County,6,8,122,67,55
Kentucky,Robertson County,6,9,124,55,69
Kentucky,Robertson County,6,10,183,99,84
Kentucky,Robertson County,6,11,174,87,87
Kentucky,Robertson County,6,12,167,76,91
Kentucky,Robertson County,6,13,141,81,60
Kentucky,Robertson County,6,14,154,70,84
Kentucky,Robertson County,6,15,113,59,54
Kentucky,Robertson County,6,16,76,39,37
Kentucky,Robertson County,6,17,67,22,45
Kentucky,Robertson County,6,18,57,31,26
Kentucky,Robertson County,7,0,2185,1096,1089
Kentucky,Robertson County,7,1,117,59,58
Kentucky,Robertson County,7,2,133,61,72
Kentucky,Robertson County,7,3,121,73,48
Kentucky,Robertson County,7,4,104,53,51
Kentucky,Robertson County,7,5,147,72,75
Kentucky,Robertson County,7,6,109,58,51
Kentucky,Robertson County,7,7,102,45,57
Kentucky,Robertson County,7,8,104,58,46
Kentucky,Robertson County,7,9,126,63,63
Kentucky,Robertson County,7,10,157,83,74
Kentucky,Robertson County,7,11,188,100,88
Kentucky,Robertson County,7,12,161,69,92
Kentucky,Robertson County,7,13,146,83,63
Kentucky,Robertson County,7,14,148,69,79
Kentucky,Robertson County,7,15,115,58,57
Kentucky,Robertson County,7,16,83,38,45
Kentucky,Robertson County,7,17,62,21,41
Kentucky,Robertson County,7,18,62,33,29
Kentucky,Robertson County,8,0,2134,1075,1059
Kentucky,Robertson County,8,1,122,63,59
Kentucky,Robertson County,8,2,124,66,58
Kentucky,Robertson County,8,3,110,63,47
Kentucky,Robertson County,8,4,110,59,51
Kentucky,Robertson County,8,5,128,65,63
Kentucky,Robertson County,8,6,111,59,52
Kentucky,Robertson County,8,7,92,41,51
Kentucky,Robertson County,8,8,113,58,55
Kentucky,Robertson County,8,9,114,59,55
Kentucky,Robertson County,8,10,147,76,71
Kentucky,Robertson County,8,11,189,103,86
Kentucky,Robertson County,8,12,151,62,89
Kentucky,Robertson County,8,13,163,88,75
Kentucky,Robertson County,8,14,129,65,64
Kentucky,Robertson County,8,15,126,60,66
Kentucky,Robertson County,8,16,81,36,45
Kentucky,Robertson County,8,17,61,23,38
Kentucky,Robertson County,8,18,63,29,34
Kentucky,Robertson County,9,0,2125,1072,1053
Kentucky,Robertson County,9,1,113,60,53
Kentucky,Robertson County,9,2,119,64,55
Kentucky,Robertson County,9,3,123,66,57
Kentucky,Robertson County,9,4,116,68,48
Kentucky,Robertson County,9,5,127,64,63
Kentucky,Robertson County,9,6,102,53,49
Kentucky,Robertson County,9,7,89,47,42
Kentucky,Robertson County,9,8,127,59,68
Kentucky,Robertson County,9,9,118,65,53
Kentucky,Robertson County,9,10,135,66,69
Kentucky,Robertson County,9,11,183,99,84
Kentucky,Robertson County,9,12,153,62,91
Kentucky,Robertson County,9,13,158,83,75
Kentucky,Robertson County,9,14,121,62,59
Kentucky,Robertson County,9,15,135,63,72
Kentucky,Robertson County,9,16,87,42,45
Kentucky,Robertson County,9,17,58,20,38
Kentucky,Robertson County,9,18,61,29,32
Kentucky,Robertson County,10,0,2120,1063,1057
Kentucky,Robertson County,10,1,110,56,54
Kentucky,Robertson County,10,2,130,65,65
Kentucky,Robertson County,10,3,123,63,60
Kentucky,Robertson County,10,4,124,66,58
Kentucky,Robertson County,10,5,111,57,54
Kentucky,Robertson County,10,6,112,62,50
Kentucky,Robertson County,10,7,105,56,49
Kentucky,Robertson County,10,8,107,48,59
Kentucky,Robertson County,10,9,121,68,53
Kentucky,Robertson County,10,10,132,59,73
Kentucky,Robertson County,10,11,174,97,77
Kentucky,Robertson County,10,12,167,78,89
Kentucky,Robertson County,10,13,151,72,79
Kentucky,Robertson County,10,14,118,67,51
Kentucky,Robertson County,10,15,129,53,76
Kentucky,Robertson County,10,16,85,42,43
Kentucky,Robertson County,10,17,55,23,32
Kentucky,Robertson County,10,18,66,31,35
Kentucky,Robertson County,11,0,2130,1067,1063
Kentucky,Robertson County,11,1,113,61,52
Kentucky,Robertson County,11,2,119,59,60
Kentucky,Robertson County,11,3,136,67,69
Kentucky,Robertson County,11,4,116,65,51
Kentucky,Robertson County,11,5,114,62,52
Kentucky,Robertson County,11,6,116,56,60
Kentucky,Robertson County,11,7,105,55,50
Kentucky,Robertson County,11,8,94,42,52
Kentucky,Robertson County,11,9,130,72,58
Kentucky,Robertson County,11,10,131,60,71
Kentucky,Robertson County,11,11,166,94,72
Kentucky,Robertson County,11,12,181,84,97
Kentucky,Robertson County,11,13,155,71,84
Kentucky,Robertson County,11,14,115,67,48
Kentucky,Robertson County,11,15,117,46,71
Kentucky,Robertson County,11,16,100,52,48
Kentucky,Robertson County,11,17,54,24,30
Kentucky,Robertson County,11,18,68,30,38
Kentucky,Robertson County,12,0,2108,1060,1048
Kentucky,Robertson County,12,1,112,59,53
Kentucky,Robertson County,12,2,110,54,56
Kentucky,Robertson County,12,3,140,65,75
Kentucky,Robertson County,12,4,109,66,43
Kentucky,Robertson County,12,5,98,53,45
Kentucky,Robertson County,12,6,135,67,68
Kentucky,Robertson County,12,7,98,55,43
Kentucky,Robertson County,12,8,93,39,54
Kentucky,Robertson County,12,9,122,66,56
Kentucky,Robertson County,12,10,136,62,74
Kentucky,Robertson County,12,11,150,80,70
Kentucky,Robertson County,12,12,183,97,86
Kentucky,Robertson County,12,13,159,70,89
Kentucky,Robertson County,12,14,128,74,54
Kentucky,Robertson County,12,15,112,46,66
Kentucky,Robertson County,12,16,97,49,48
Kentucky,Robertson County,12,17,54,23,31
Kentucky,Robertson County,12,18,72,35,37
Kentucky,Rockcastle County,1,0,17056,8378,8678
Kentucky,Rockcastle County,1,1,964,472,492
Kentucky,Rockcastle County,1,2,1148,575,573
Kentucky,Rockcastle County,1,3,1120,568,552
Kentucky,Rockcastle County,1,4,1151,619,532
Kentucky,Rockcastle County,1,5,935,457,478
Kentucky,Rockcastle County,1,6,898,438,460
Kentucky,Rockcastle County,1,7,1028,500,528
Kentucky,Rockcastle County,1,8,1142,550,592
Kentucky,Rockcastle County,1,9,1244,664,580
Kentucky,Rockcastle County,1,10,1377,684,693
Kentucky,Rockcastle County,1,11,1319,659,660
Kentucky,Rockcastle County,1,12,1132,546,586
Kentucky,Rockcastle County,1,13,1069,507,562
Kentucky,Rockcastle County,1,14,872,408,464
Kentucky,Rockcastle County,1,15,667,322,345
Kentucky,Rockcastle County,1,16,474,221,253
Kentucky,Rockcastle County,1,17,306,122,184
Kentucky,Rockcastle County,1,18,210,66,144
Kentucky,Rockcastle County,2,0,17056,8378,8678
Kentucky,Rockcastle County,2,1,964,472,492
Kentucky,Rockcastle County,2,2,1148,575,573
Kentucky,Rockcastle County,2,3,1120,568,552
Kentucky,Rockcastle County,2,4,1151,619,532
Kentucky,Rockcastle County,2,5,935,457,478
Kentucky,Rockcastle County,2,6,898,438,460
Kentucky,Rockcastle County,2,7,1028,500,528
Kentucky,Rockcastle County,2,8,1142,550,592
Kentucky,Rockcastle County,2,9,1244,664,580
Kentucky,Rockcastle County,2,10,1377,684,693
Kentucky,Rockcastle County,2,11,1319,659,660
Kentucky,Rockcastle County,2,12,1132,546,586
Kentucky,Rockcastle County,2,13,1069,507,562
Kentucky,Rockcastle County,2,14,872,408,464
Kentucky,Rockcastle County,2,15,667,322,345
Kentucky,Rockcastle County,2,16,474,221,253
Kentucky,Rockcastle County,2,17,306,122,184
Kentucky,Rockcastle County,2,18,210,66,144
Kentucky,Rockcastle County,3,0,17081,8391,8690
Kentucky,Rockcastle County,3,1,956,471,485
Kentucky,Rockcastle County,3,2,1143,574,569
Kentucky,Rockcastle County,3,3,1124,571,553
Kentucky,Rockcastle County,3,4,1136,606,530
Kentucky,Rockcastle County,3,5,944,469,475
Kentucky,Rockcastle County,3,6,899,435,464
Kentucky,Rockcastle County,3,7,1029,500,529
Kentucky,Rockcastle County,3,8,1134,547,587
Kentucky,Rockcastle County,3,9,1234,653,581
Kentucky,Rockcastle County,3,10,1383,691,692
Kentucky,Rockcastle County,3,11,1328,663,665
Kentucky,Rockcastle County,3,12,1135,552,583
Kentucky,Rockcastle County,3,13,1081,508,573
Kentucky,Rockcastle County,3,14,875,412,463
Kentucky,Rockcastle County,3,15,675,322,353
Kentucky,Rockcastle County,3,16,480,224,256
Kentucky,Rockcastle County,3,17,310,124,186
Kentucky,Rockcastle County,3,18,215,69,146
Kentucky,Rockcastle County,4,0,17108,8374,8734
Kentucky,Rockcastle County,4,1,980,476,504
Kentucky,Rockcastle County,4,2,1117,545,572
Kentucky,Rockcastle County,4,3,1119,575,544
Kentucky,Rockcastle County,4,4,1105,584,521
Kentucky,Rockcastle County,4,5,1006,508,498
Kentucky,Rockcastle County,4,6,914,433,481
Kentucky,Rockcastle County,4,7,981,482,499
Kentucky,Rockcastle County,4,8,1100,527,573
Kentucky,Rockcastle County,4,9,1245,632,613
Kentucky,Rockcastle County,4,10,1372,698,674
Kentucky,Rockcastle County,4,11,1333,661,672
Kentucky,Rockcastle County,4,12,1129,577,552
Kentucky,Rockcastle County,4,13,1116,507,609
Kentucky,Rockcastle County,4,14,859,413,446
Kentucky,Rockcastle County,4,15,699,328,371
Kentucky,Rockcastle County,4,16,495,231,264
Kentucky,Rockcastle County,4,17,316,123,193
Kentucky,Rockcastle County,4,18,222,74,148
Kentucky,Rockcastle County,5,0,17057,8341,8716
Kentucky,Rockcastle County,5,1,938,459,479
Kentucky,Rockcastle County,5,2,1089,522,567
Kentucky,Rockcastle County,5,3,1154,595,559
Kentucky,Rockcastle County,5,4,1073,563,510
Kentucky,Rockcastle County,5,5,1017,506,511
Kentucky,Rockcastle County,5,6,941,471,470
Kentucky,Rockcastle County,5,7,937,465,472
Kentucky,Rockcastle County,5,8,1085,518,567
Kentucky,Rockcastle County,5,9,1209,600,609
Kentucky,Rockcastle County,5,10,1359,701,658
Kentucky,Rockcastle County,5,11,1293,627,666
Kentucky,Rockcastle County,5,12,1188,618,570
Kentucky,Rockcastle County,5,13,1099,504,595
Kentucky,Rockcastle County,5,14,915,431,484
Kentucky,Rockcastle County,5,15,702,329,373
Kentucky,Rockcastle County,5,16,501,228,273
Kentucky,Rockcastle County,5,17,326,127,199
Kentucky,Rockcastle County,5,18,231,77,154
Kentucky,Rockcastle County,6,0,16742,8180,8562
Kentucky,Rockcastle County,6,1,876,437,439
Kentucky,Rockcastle County,6,2,1037,487,550
Kentucky,Rockcastle County,6,3,1133,586,547
Kentucky,Rockcastle County,6,4,1013,529,484
Kentucky,Rockcastle County,6,5,982,492,490
Kentucky,Rockcastle County,6,6,938,469,469
Kentucky,Rockcastle County,6,7,884,438,446
Kentucky,Rockcastle County,6,8,1027,479,548
Kentucky,Rockcastle County,6,9,1180,574,606
Kentucky,Rockcastle County,6,10,1303,683,620
Kentucky,Rockcastle County,6,11,1297,634,663
Kentucky,Rockcastle County,6,12,1218,629,589
Kentucky,Rockcastle County,6,13,1104,524,580
Kentucky,Rockcastle County,6,14,931,422,509
Kentucky,Rockcastle County,6,15,738,351,387
Kentucky,Rockcastle County,6,16,514,238,276
Kentucky,Rockcastle County,6,17,312,123,189
Kentucky,Rockcastle County,6,18,255,85,170
Kentucky,Rockcastle County,7,0,16826,8204,8622
Kentucky,Rockcastle County,7,1,892,438,454
Kentucky,Rockcastle County,7,2,1017,477,540
Kentucky,Rockcastle County,7,3,1158,592,566
Kentucky,Rockcastle County,7,4,1005,533,472
Kentucky,Rockcastle County,7,5,996,501,495
Kentucky,Rockcastle County,7,6,966,481,485
Kentucky,Rockcastle County,7,7,898,439,459
Kentucky,Rockcastle County,7,8,1021,479,542
Kentucky,Rockcastle County,7,9,1127,539,588
Kentucky,Rockcastle County,7,10,1301,693,608
Kentucky,Rockcastle County,7,11,1304,638,666
Kentucky,Rockcastle County,7,12,1244,631,613
Kentucky,Rockcastle County,7,13,1101,525,576
Kentucky,Rockcastle County,7,14,936,420,516
Kentucky,Rockcastle County,7,15,756,348,408
Kentucky,Rockcastle County,7,16,523,254,269
Kentucky,Rockcastle County,7,17,327,133,194
Kentucky,Rockcastle County,7,18,254,83,171
Kentucky,Rockcastle County,8,0,16932,8223,8709
Kentucky,Rockcastle County,8,1,903,446,457
Kentucky,Rockcastle County,8,2,996,471,525
Kentucky,Rockcastle County,8,3,1136,549,587
Kentucky,Rockcastle County,8,4,1004,527,477
Kentucky,Rockcastle County,8,5,994,519,475
Kentucky,Rockcastle County,8,6,1015,500,515
Kentucky,Rockcastle County,8,7,898,434,464
Kentucky,Rockcastle County,8,8,1022,492,530
Kentucky,Rockcastle County,8,9,1114,527,587
Kentucky,Rockcastle County,8,10,1243,666,577
Kentucky,Rockcastle County,8,11,1334,644,690
Kentucky,Rockcastle County,8,12,1276,642,634
Kentucky,Rockcastle County,8,13,1113,535,578
Kentucky,Rockcastle County,8,14,983,437,546
Kentucky,Rockcastle County,8,15,774,354,420
Kentucky,Rockcastle County,8,16,514,245,269
Kentucky,Rockcastle County,8,17,353,151,202
Kentucky,Rockcastle County,8,18,260,84,176
Kentucky,Rockcastle County,9,0,16872,8232,8640
Kentucky,Rockcastle County,9,1,928,473,455
Kentucky,Rockcastle County,9,2,955,455,500
Kentucky,Rockcastle County,9,3,1106,542,564
Kentucky,Rockcastle County,9,4,1009,529,480
Kentucky,Rockcastle County,9,5,992,508,484
Kentucky,Rockcastle County,9,6,1013,519,494
Kentucky,Rockcastle County,9,7,907,433,474
Kentucky,Rockcastle County,9,8,958,454,504
Kentucky,Rockcastle County,9,9,1068,513,555
Kentucky,Rockcastle County,9,10,1264,645,619
Kentucky,Rockcastle County,9,11,1312,666,646
Kentucky,Rockcastle County,9,12,1295,641,654
Kentucky,Rockcastle County,9,13,1100,551,549
Kentucky,Rockcastle County,9,14,1030,457,573
Kentucky,Rockcastle County,9,15,773,366,407
Kentucky,Rockcastle County,9,16,531,233,298
Kentucky,Rockcastle County,9,17,350,152,198
Kentucky,Rockcastle County,9,18,281,95,186
Kentucky,Rockcastle County,10,0,16778,8183,8595
Kentucky,Rockcastle County,10,1,900,468,432
Kentucky,Rockcastle County,10,2,960,465,495
Kentucky,Rockcastle County,10,3,1054,509,545
Kentucky,Rockcastle County,10,4,1027,533,494
Kentucky,Rockcastle County,10,5,914,466,448
Kentucky,Rockcastle County,10,6,1063,543,520
Kentucky,Rockcastle County,10,7,916,461,455
Kentucky,Rockcastle County,10,8,887,411,476
Kentucky,Rockcastle County,10,9,1055,503,552
Kentucky,Rockcastle County,10,10,1220,593,627
Kentucky,Rockcastle County,10,11,1327,692,635
Kentucky,Rockcastle County,10,12,1246,596,650
Kentucky,Rockcastle County,10,13,1165,601,564
Kentucky,Rockcastle County,10,14,1003,450,553
Kentucky,Rockcastle County,10,15,829,386,443
Kentucky,Rockcastle County,10,16,556,248,308
Kentucky,Rockcastle County,10,17,354,148,206
Kentucky,Rockcastle County,10,18,302,110,192
Kentucky,Rockcastle County,11,0,16823,8216,8607
Kentucky,Rockcastle County,11,1,907,464,443
Kentucky,Rockcastle County,11,2,932,464,468
Kentucky,Rockcastle County,11,3,1083,513,570
Kentucky,Rockcastle County,11,4,1037,544,493
Kentucky,Rockcastle County,11,5,867,436,431
Kentucky,Rockcastle County,11,6,1063,539,524
Kentucky,Rockcastle County,11,7,928,462,466
Kentucky,Rockcastle County,11,8,906,432,474
Kentucky,Rockcastle County,11,9,1038,485,553
Kentucky,Rockcastle County,11,10,1201,591,610
Kentucky,Rockcastle County,11,11,1311,685,626
Kentucky,Rockcastle County,11,12,1259,608,651
Kentucky,Rockcastle County,11,13,1189,614,575
Kentucky,Rockcastle County,11,14,992,462,530
Kentucky,Rockcastle County,11,15,841,376,465
Kentucky,Rockcastle County,11,16,608,279,329
Kentucky,Rockcastle County,11,17,371,160,211
Kentucky,Rockcastle County,11,18,290,102,188
Kentucky,Rockcastle County,12,0,16695,8195,8500
Kentucky,Rockcastle County,12,1,894,483,411
Kentucky,Rockcastle County,12,2,921,458,463
Kentucky,Rockcastle County,12,3,1040,499,541
Kentucky,Rockcastle County,12,4,1036,529,507
Kentucky,Rockcastle County,12,5,870,448,422
Kentucky,Rockcastle County,12,6,1014,523,491
Kentucky,Rockcastle County,12,7,976,482,494
Kentucky,Rockcastle County,12,8,916,438,478
Kentucky,Rockcastle County,12,9,994,458,536
Kentucky,Rockcastle County,12,10,1128,562,566
Kentucky,Rockcastle County,12,11,1317,695,622
Kentucky,Rockcastle County,12,12,1249,601,648
Kentucky,Rockcastle County,12,13,1207,615,592
Kentucky,Rockcastle County,12,14,1007,475,532
Kentucky,Rockcastle County,12,15,844,370,474
Kentucky,Rockcastle County,12,16,633,292,341
Kentucky,Rockcastle County,12,17,366,169,197
Kentucky,Rockcastle County,12,18,283,98,185
Kentucky,Rowan County,1,0,23333,11342,11991
Kentucky,Rowan County,1,1,1353,686,667
Kentucky,Rowan County,1,2,1203,634,569
Kentucky,Rowan County,1,3,1249,629,620
Kentucky,Rowan County,1,4,2462,1150,1312
Kentucky,Rowan County,1,5,3396,1666,1730
Kentucky,Rowan County,1,6,1559,824,735
Kentucky,Rowan County,1,7,1291,655,636
Kentucky,Rowan County,1,8,1274,644,630
Kentucky,Rowan County,1,9,1439,673,766
Kentucky,Rowan County,1,10,1406,691,715
Kentucky,Rowan County,1,11,1412,700,712
Kentucky,Rowan County,1,12,1280,593,687
Kentucky,Rowan County,1,13,1149,547,602
Kentucky,Rowan County,1,14,922,419,503
Kentucky,Rowan County,1,15,766,351,415
Kentucky,Rowan County,1,16,510,219,291
Kentucky,Rowan County,1,17,365,168,197
Kentucky,Rowan County,1,18,297,93,204
Kentucky,Rowan County,2,0,23336,11343,11993
Kentucky,Rowan County,2,1,1354,686,668
Kentucky,Rowan County,2,2,1203,634,569
Kentucky,Rowan County,2,3,1249,629,620
Kentucky,Rowan County,2,4,2462,1150,1312
Kentucky,Rowan County,2,5,3396,1667,1729
Kentucky,Rowan County,2,6,1558,823,735
Kentucky,Rowan County,2,7,1291,655,636
Kentucky,Rowan County,2,8,1276,645,631
Kentucky,Rowan County,2,9,1439,673,766
Kentucky,Rowan County,2,10,1406,691,715
Kentucky,Rowan County,2,11,1411,699,712
Kentucky,Rowan County,2,12,1279,593,686
Kentucky,Rowan County,2,13,1149,547,602
Kentucky,Rowan County,2,14,923,419,504
Kentucky,Rowan County,2,15,766,351,415
Kentucky,Rowan County,2,16,510,219,291
Kentucky,Rowan County,2,17,366,169,197
Kentucky,Rowan County,2,18,298,93,205
Kentucky,Rowan County,3,0,23376,11375,12001
Kentucky,Rowan County,3,1,1350,681,669
Kentucky,Rowan County,3,2,1201,632,569
Kentucky,Rowan County,3,3,1257,638,619
Kentucky,Rowan County,3,4,2462,1149,1313
Kentucky,Rowan County,3,5,3445,1700,1745
Kentucky,Rowan County,3,6,1548,818,730
Kentucky,Rowan County,3,7,1301,667,634
Kentucky,Rowan County,3,8,1272,645,627
Kentucky,Rowan County,3,9,1429,668,761
Kentucky,Rowan County,3,10,1404,690,714
Kentucky,Rowan County,3,11,1405,693,712
Kentucky,Rowan County,3,12,1285,598,687
Kentucky,Rowan County,3,13,1149,545,604
Kentucky,Rowan County,3,14,921,417,504
Kentucky,Rowan County,3,15,767,353,414
Kentucky,Rowan County,3,16,517,220,297
Kentucky,Rowan County,3,17,360,165,195
Kentucky,Rowan County,3,18,303,96,207
Kentucky,Rowan County,4,0,23558,11483,12075
Kentucky,Rowan County,4,1,1369,697,672
Kentucky,Rowan County,4,2,1218,641,577
Kentucky,Rowan County,4,3,1250,633,617
Kentucky,Rowan County,4,4,2399,1109,1290
Kentucky,Rowan County,4,5,3583,1780,1803
Kentucky,Rowan County,4,6,1447,759,688
Kentucky,Rowan County,4,7,1338,695,643
Kentucky,Rowan County,4,8,1240,623,617
Kentucky,Rowan County,4,9,1430,680,750
Kentucky,Rowan County,4,10,1425,693,732
Kentucky,Rowan County,4,11,1431,703,728
Kentucky,Rowan County,4,12,1317,615,702
Kentucky,Rowan County,4,13,1201,575,626
Kentucky,Rowan County,4,14,924,417,507
Kentucky,Rowan County,4,15,763,354,409
Kentucky,Rowan County,4,16,554,250,304
Kentucky,Rowan County,4,17,360,158,202
Kentucky,Rowan County,4,18,309,101,208
Kentucky,Rowan County,5,0,23796,11569,12227
Kentucky,Rowan County,5,1,1287,673,614
Kentucky,Rowan County,5,2,1226,635,591
Kentucky,Rowan County,5,3,1246,640,606
Kentucky,Rowan County,5,4,2491,1148,1343
Kentucky,Rowan County,5,5,3836,1890,1946
Kentucky,Rowan County,5,6,1400,716,684
Kentucky,Rowan County,5,7,1331,686,645
Kentucky,Rowan County,5,8,1212,604,608
Kentucky,Rowan County,5,9,1370,658,712
Kentucky,Rowan County,5,10,1454,699,755
Kentucky,Rowan County,5,11,1380,676,704
Kentucky,Rowan County,5,12,1375,649,726
Kentucky,Rowan County,5,13,1167,562,605
Kentucky,Rowan County,5,14,1003,450,553
Kentucky,Rowan County,5,15,768,352,416
Kentucky,Rowan County,5,16,577,268,309
Kentucky,Rowan County,5,17,367,158,209
Kentucky,Rowan County,5,18,306,105,201
Kentucky,Rowan County,6,0,24210,11724,12486
Kentucky,Rowan County,6,1,1306,694,612
Kentucky,Rowan County,6,2,1278,657,621
Kentucky,Rowan County,6,3,1232,623,609
Kentucky,Rowan County,6,4,2604,1180,1424
Kentucky,Rowan County,6,5,3962,1939,2023
Kentucky,Rowan County,6,6,1483,762,721
Kentucky,Rowan County,6,7,1275,659,616
Kentucky,Rowan County,6,8,1234,611,623
Kentucky,Rowan County,6,9,1338,643,695
Kentucky,Rowan County,6,10,1428,695,733
Kentucky,Rowan County,6,11,1378,678,700
Kentucky,Rowan County,6,12,1424,673,751
Kentucky,Rowan County,6,13,1177,564,613
Kentucky,Rowan County,6,14,1032,463,569
Kentucky,Rowan County,6,15,794,356,438
Kentucky,Rowan County,6,16,605,277,328
Kentucky,Rowan County,6,17,352,140,212
Kentucky,Rowan County,6,18,308,110,198
Kentucky,Rowan County,7,0,24250,11778,12472
Kentucky,Rowan County,7,1,1322,674,648
Kentucky,Rowan County,7,2,1295,679,616
Kentucky,Rowan County,7,3,1213,634,579
Kentucky,Rowan County,7,4,2565,1162,1403
Kentucky,Rowan County,7,5,3904,1897,2007
Kentucky,Rowan County,7,6,1519,844,675
Kentucky,Rowan County,7,7,1311,662,649
Kentucky,Rowan County,7,8,1226,598,628
Kentucky,Rowan County,7,9,1284,619,665
Kentucky,Rowan County,7,10,1403,667,736
Kentucky,Rowan County,7,11,1426,699,727
Kentucky,Rowan County,7,12,1409,683,726
Kentucky,Rowan County,7,13,1217,567,650
Kentucky,Rowan County,7,14,1048,487,561
Kentucky,Rowan County,7,15,796,348,448
Kentucky,Rowan County,7,16,637,294,343
Kentucky,Rowan County,7,17,342,138,204
Kentucky,Rowan County,7,18,333,126,207
Kentucky,Rowan County,8,0,24642,12004,12638
Kentucky,Rowan County,8,1,1342,672,670
Kentucky,Rowan County,8,2,1336,692,644
Kentucky,Rowan County,8,3,1243,666,577
Kentucky,Rowan County,8,4,2702,1224,1478
Kentucky,Rowan County,8,5,3965,1961,2004
Kentucky,Rowan County,8,6,1580,848,732
Kentucky,Rowan County,8,7,1262,638,624
Kentucky,Rowan County,8,8,1252,633,619
Kentucky,Rowan County,8,9,1223,592,631
Kentucky,Rowan County,8,10,1422,670,752
Kentucky,Rowan County,8,11,1438,702,736
Kentucky,Rowan County,8,12,1425,697,728
Kentucky,Rowan County,8,13,1226,557,669
Kentucky,Rowan County,8,14,1064,496,568
Kentucky,Rowan County,8,15,808,367,441
Kentucky,Rowan County,8,16,634,282,352
Kentucky,Rowan County,8,17,387,167,220
Kentucky,Rowan County,8,18,333,140,193
Kentucky,Rowan County,9,0,24416,11899,12517
Kentucky,Rowan County,9,1,1333,652,681
Kentucky,Rowan County,9,2,1298,692,606
Kentucky,Rowan County,9,3,1196,662,534
Kentucky,Rowan County,9,4,2659,1210,1449
Kentucky,Rowan County,9,5,3863,1899,1964
Kentucky,Rowan County,9,6,1693,922,771
Kentucky,Rowan County,9,7,1204,598,606
Kentucky,Rowan County,9,8,1266,644,622
Kentucky,Rowan County,9,9,1183,580,603
Kentucky,Rowan County,9,10,1376,654,722
Kentucky,Rowan County,9,11,1410,688,722
Kentucky,Rowan County,9,12,1397,669,728
Kentucky,Rowan County,9,13,1283,590,693
Kentucky,Rowan County,9,14,1098,508,590
Kentucky,Rowan County,9,15,803,355,448
Kentucky,Rowan County,9,16,630,275,355
Kentucky,Rowan County,9,17,404,171,233
Kentucky,Rowan County,9,18,320,130,190
Kentucky,Rowan County,10,0,24514,11908,12606
Kentucky,Rowan County,10,1,1341,649,692
Kentucky,Rowan County,10,2,1290,677,613
Kentucky,Rowan County,10,3,1249,665,584
Kentucky,Rowan County,10,4,2668,1237,1431
Kentucky,Rowan County,10,5,3827,1896,1931
Kentucky,Rowan County,10,6,1761,947,814
Kentucky,Rowan County,10,7,1184,590,594
Kentucky,Rowan County,10,8,1260,644,616
Kentucky,Rowan County,10,9,1191,575,616
Kentucky,Rowan County,10,10,1322,636,686
Kentucky,Rowan County,10,11,1407,679,728
Kentucky,Rowan County,10,12,1344,637,707
Kentucky,Rowan County,10,13,1325,619,706
Kentucky,Rowan County,10,14,1075,491,584
Kentucky,Rowan County,10,15,891,388,503
Kentucky,Rowan County,10,16,619,268,351
Kentucky,Rowan County,10,17,416,175,241
Kentucky,Rowan County,10,18,344,135,209
Kentucky,Rowan County,11,0,24503,11837,12666
Kentucky,Rowan County,11,1,1355,656,699
Kentucky,Rowan County,11,2,1342,693,649
Kentucky,Rowan County,11,3,1303,686,617
Kentucky,Rowan County,11,4,2579,1202,1377
Kentucky,Rowan County,11,5,3635,1797,1838
Kentucky,Rowan County,11,6,1794,952,842
Kentucky,Rowan County,11,7,1230,606,624
Kentucky,Rowan County,11,8,1237,621,616
Kentucky,Rowan County,11,9,1210,589,621
Kentucky,Rowan County,11,10,1293,623,670
Kentucky,Rowan County,11,11,1397,662,735
Kentucky,Rowan County,11,12,1343,631,712
Kentucky,Rowan County,11,13,1350,629,721
Kentucky,Rowan County,11,14,1083,490,593
Kentucky,Rowan County,11,15,920,398,522
Kentucky,Rowan County,11,16,650,282,368
Kentucky,Rowan County,11,17,433,187,246
Kentucky,Rowan County,11,18,349,133,216
Kentucky,Rowan County,12,0,24460,11782,12678
Kentucky,Rowan County,12,1,1325,650,675
Kentucky,Rowan County,12,2,1354,688,666
Kentucky,Rowan County,12,3,1312,684,628
Kentucky,Rowan County,12,4,2585,1215,1370
Kentucky,Rowan County,12,5,3559,1750,1809
Kentucky,Rowan County,12,6,1797,933,864
Kentucky,Rowan County,12,7,1262,639,623
Kentucky,Rowan County,12,8,1244,620,624
Kentucky,Rowan County,12,9,1186,564,622
Kentucky,Rowan County,12,10,1258,618,640
Kentucky,Rowan County,12,11,1333,618,715
Kentucky,Rowan County,12,12,1382,656,726
Kentucky,Rowan County,12,13,1320,625,695
Kentucky,Rowan County,12,14,1107,477,630
Kentucky,Rowan County,12,15,928,418,510
Kentucky,Rowan County,12,16,680,293,387
Kentucky,Rowan County,12,17,468,195,273
Kentucky,Rowan County,12,18,360,139,221
Kentucky,Russell County,1,0,17565,8595,8970
Kentucky,Russell County,1,1,1058,544,514
Kentucky,Russell County,1,2,1107,549,558
Kentucky,Russell County,1,3,1056,518,538
Kentucky,Russell County,1,4,1089,575,514
Kentucky,Russell County,1,5,927,474,453
Kentucky,Russell County,1,6,942,495,447
Kentucky,Russell County,1,7,986,489,497
Kentucky,Russell County,1,8,1138,573,565
Kentucky,Russell County,1,9,1165,557,608
Kentucky,Russell County,1,10,1316,654,662
Kentucky,Russell County,1,11,1319,628,691
Kentucky,Russell County,1,12,1223,588,635
Kentucky,Russell County,1,13,1189,612,577
Kentucky,Russell County,1,14,935,442,493
Kentucky,Russell County,1,15,752,369,383
Kentucky,Russell County,1,16,617,271,346
Kentucky,Russell County,1,17,418,150,268
Kentucky,Russell County,1,18,328,107,221
Kentucky,Russell County,2,0,17565,8595,8970
Kentucky,Russell County,2,1,1058,544,514
Kentucky,Russell County,2,2,1107,549,558
Kentucky,Russell County,2,3,1056,518,538
Kentucky,Russell County,2,4,1089,575,514
Kentucky,Russell County,2,5,927,474,453
Kentucky,Russell County,2,6,942,495,447
Kentucky,Russell County,2,7,986,489,497
Kentucky,Russell County,2,8,1138,573,565
Kentucky,Russell County,2,9,1165,557,608
Kentucky,Russell County,2,10,1316,654,662
Kentucky,Russell County,2,11,1319,628,691
Kentucky,Russell County,2,12,1223,588,635
Kentucky,Russell County,2,13,1189,612,577
Kentucky,Russell County,2,14,935,442,493
Kentucky,Russell County,2,15,752,369,383
Kentucky,Russell County,2,16,617,271,346
Kentucky,Russell County,2,17,418,150,268
Kentucky,Russell County,2,18,328,107,221
Kentucky,Russell County,3,0,17573,8605,8968
Kentucky,Russell County,3,1,1071,548,523
Kentucky,Russell County,3,2,1091,544,547
Kentucky,Russell County,3,3,1050,515,535
Kentucky,Russell County,3,4,1086,575,511
Kentucky,Russell County,3,5,934,474,460
Kentucky,Russell County,3,6,928,493,435
Kentucky,Russell County,3,7,988,491,497
Kentucky,Russell County,3,8,1124,568,556
Kentucky,Russell County,3,9,1160,555,605
Kentucky,Russell County,3,10,1323,657,666
Kentucky,Russell County,3,11,1321,628,693
Kentucky,Russell County,3,12,1238,595,643
Kentucky,Russell County,3,13,1188,616,572
Kentucky,Russell County,3,14,936,443,493
Kentucky,Russell County,3,15,768,376,392
Kentucky,Russell County,3,16,616,270,346
Kentucky,Russell County,3,17,419,149,270
Kentucky,Russell County,3,18,332,108,224
Kentucky,Russell County,4,0,17700,8698,9002
Kentucky,Russell County,4,1,1099,557,542
Kentucky,Russell County,4,2,1066,539,527
Kentucky,Russell County,4,3,1068,518,550
Kentucky,Russell County,4,4,1085,577,508
Kentucky,Russell County,4,5,976,499,477
Kentucky,Russell County,4,6,892,464,428
Kentucky,Russell County,4,7,1024,524,500
Kentucky,Russell County,4,8,1074,545,529
Kentucky,Russell County,4,9,1170,574,596
Kentucky,Russell County,4,10,1330,656,674
Kentucky,Russell County,4,11,1320,629,691
Kentucky,Russell County,4,12,1276,609,667
Kentucky,Russell County,4,13,1210,631,579
Kentucky,Russell County,4,14,938,453,485
Kentucky,Russell County,4,15,804,395,409
Kentucky,Russell County,4,16,617,280,337
Kentucky,Russell County,4,17,415,146,269
Kentucky,Russell County,4,18,336,102,234
Kentucky,Russell County,5,0,17637,8656,8981
Kentucky,Russell County,5,1,1129,555,574
Kentucky,Russell County,5,2,1042,534,508
Kentucky,Russell County,5,3,1058,519,539
Kentucky,Russell County,5,4,1032,543,489
Kentucky,Russell County,5,5,980,501,479
Kentucky,Russell County,5,6,902,470,432
Kentucky,Russell County,5,7,1017,504,513
Kentucky,Russell County,5,8,1003,501,502
Kentucky,Russell County,5,9,1189,592,597
Kentucky,Russell County,5,10,1291,640,651
Kentucky,Russell County,5,11,1296,620,676
Kentucky,Russell County,5,12,1303,628,675
Kentucky,Russell County,5,13,1193,619,574
Kentucky,Russell County,5,14,1014,487,527
Kentucky,Russell County,5,15,810,405,405
Kentucky,Russell County,5,16,612,284,328
Kentucky,Russell County,5,17,422,154,268
Kentucky,Russell County,5,18,344,100,244
Kentucky,Russell County,6,0,17749,8728,9021
Kentucky,Russell County,6,1,1113,568,545
Kentucky,Russell County,6,2,1091,561,530
Kentucky,Russell County,6,3,1091,536,555
Kentucky,Russell County,6,4,993,505,488
Kentucky,Russell County,6,5,1003,522,481
Kentucky,Russell County,6,6,921,487,434
Kentucky,Russell County,6,7,998,497,501
Kentucky,Russell County,6,8,1005,485,520
Kentucky,Russell County,6,9,1170,598,572
Kentucky,Russell County,6,10,1298,633,665
Kentucky,Russell County,6,11,1282,630,652
Kentucky,Russell County,6,12,1286,613,673
Kentucky,Russell County,6,13,1211,601,610
Kentucky,Russell County,6,14,1053,526,527
Kentucky,Russell County,6,15,822,400,422
Kentucky,Russell County,6,16,610,287,323
Kentucky,Russell County,6,17,448,175,273
Kentucky,Russell County,6,18,354,104,250
Kentucky,Russell County,7,0,17787,8775,9012
Kentucky,Russell County,7,1,1099,568,531
Kentucky,Russell County,7,2,1126,578,548
Kentucky,Russell County,7,3,1102,544,558
Kentucky,Russell County,7,4,998,508,490
Kentucky,Russell County,7,5,1002,511,491
Kentucky,Russell County,7,6,961,510,451
Kentucky,Russell County,7,7,950,470,480
Kentucky,Russell County,7,8,1008,487,521
Kentucky,Russell County,7,9,1152,590,562
Kentucky,Russell County,7,10,1223,589,634
Kentucky,Russell County,7,11,1299,659,640
Kentucky,Russell County,7,12,1320,624,696
Kentucky,Russell County,7,13,1204,587,617
Kentucky,Russell County,7,14,1096,558,538
Kentucky,Russell County,7,15,803,387,416
Kentucky,Russell County,7,16,626,311,315
Kentucky,Russell County,7,17,433,175,258
Kentucky,Russell County,7,18,385,119,266
Kentucky,Russell County,8,0,17685,8700,8985
Kentucky,Russell County,8,1,1090,574,516
Kentucky,Russell County,8,2,1123,568,555
Kentucky,Russell County,8,3,1092,536,556
Kentucky,Russell County,8,4,992,505,487
Kentucky,Russell County,8,5,1003,508,495
Kentucky,Russell County,8,6,982,507,475
Kentucky,Russell County,8,7,908,462,446
Kentucky,Russell County,8,8,981,480,501
Kentucky,Russell County,8,9,1123,558,565
Kentucky,Russell County,8,10,1148,555,593
Kentucky,Russell County,8,11,1300,655,645
Kentucky,Russell County,8,12,1325,624,701
Kentucky,Russell County,8,13,1214,577,637
Kentucky,Russell County,8,14,1132,586,546
Kentucky,Russell County,8,15,804,383,421
Kentucky,Russell County,8,16,628,309,319
Kentucky,Russell County,8,17,455,193,262
Kentucky,Russell County,8,18,385,120,265
Kentucky,Russell County,9,0,17769,8744,9025
Kentucky,Russell County,9,1,1135,600,535
Kentucky,Russell County,9,2,1133,578,555
Kentucky,Russell County,9,3,1082,535,547
Kentucky,Russell County,9,4,1018,517,501
Kentucky,Russell County,9,5,944,487,457
Kentucky,Russell County,9,6,1026,509,517
Kentucky,Russell County,9,7,886,462,424
Kentucky,Russell County,9,8,993,489,504
Kentucky,Russell County,9,9,1069,520,549
Kentucky,Russell County,9,10,1192,585,607
Kentucky,Russell County,9,11,1303,654,649
Kentucky,Russell County,9,12,1302,610,692
Kentucky,Russell County,9,13,1252,590,662
Kentucky,Russell County,9,14,1141,599,542
Kentucky,Russell County,9,15,811,393,418
Kentucky,Russell County,9,16,650,314,336
Kentucky,Russell County,9,17,440,190,250
Kentucky,Russell County,9,18,392,112,280
Kentucky,Russell County,10,0,17723,8732,8991
Kentucky,Russell County,10,1,1103,605,498
Kentucky,Russell County,10,2,1157,585,572
Kentucky,Russell County,10,3,1079,545,534
Kentucky,Russell County,10,4,994,515,479
Kentucky,Russell County,10,5,941,481,460
Kentucky,Russell County,10,6,1011,505,506
Kentucky,Russell County,10,7,871,439,432
Kentucky,Russell County,10,8,1006,488,518
Kentucky,Russell County,10,9,1010,494,516
Kentucky,Russell County,10,10,1242,605,637
Kentucky,Russell County,10,11,1279,626,653
Kentucky,Russell County,10,12,1274,605,669
Kentucky,Russell County,10,13,1282,597,685
Kentucky,Russell County,10,14,1139,595,544
Kentucky,Russell County,10,15,878,430,448
Kentucky,Russell County,10,16,634,314,320
Kentucky,Russell County,10,17,421,181,240
Kentucky,Russell County,10,18,402,122,280
Kentucky,Russell County,11,0,17790,8761,9029
Kentucky,Russell County,11,1,1086,589,497
Kentucky,Russell County,11,2,1175,600,575
Kentucky,Russell County,11,3,1104,551,553
Kentucky,Russell County,11,4,1002,514,488
Kentucky,Russell County,11,5,897,463,434
Kentucky,Russell County,11,6,1019,500,519
Kentucky,Russell County,11,7,915,472,443
Kentucky,Russell County,11,8,979,480,499
Kentucky,Russell County,11,9,1023,482,541
Kentucky,Russell County,11,10,1202,605,597
Kentucky,Russell County,11,11,1300,631,669
Kentucky,Russell County,11,12,1256,614,642
Kentucky,Russell County,11,13,1273,585,688
Kentucky,Russell County,11,14,1161,582,579
Kentucky,Russell County,11,15,915,466,449
Kentucky,Russell County,11,16,646,311,335
Kentucky,Russell County,11,17,425,185,240
Kentucky,Russell County,11,18,412,131,281
Kentucky,Russell County,12,0,17923,8814,9109
Kentucky,Russell County,12,1,1095,591,504
Kentucky,Russell County,12,2,1169,588,581
Kentucky,Russell County,12,3,1126,566,560
Kentucky,Russell County,12,4,1018,533,485
Kentucky,Russell County,12,5,895,469,426
Kentucky,Russell County,12,6,1045,513,532
Kentucky,Russell County,12,7,955,490,465
Kentucky,Russell County,12,8,947,462,485
Kentucky,Russell County,12,9,1003,474,529
Kentucky,Russell County,12,10,1173,585,588
Kentucky,Russell County,12,11,1256,594,662
Kentucky,Russell County,12,12,1286,630,656
Kentucky,Russell County,12,13,1328,615,713
Kentucky,Russell County,12,14,1174,571,603
Kentucky,Russell County,12,15,958,499,459
Kentucky,Russell County,12,16,628,297,331
Kentucky,Russell County,12,17,445,203,242
Kentucky,Russell County,12,18,422,134,288
Kentucky,Scott County,1,0,47173,23254,23919
Kentucky,Scott County,1,1,3544,1784,1760
Kentucky,Scott County,1,2,3664,1862,1802
Kentucky,Scott County,1,3,3452,1805,1647
Kentucky,Scott County,1,4,3438,1774,1664
Kentucky,Scott County,1,5,2923,1452,1471
Kentucky,Scott County,1,6,3104,1502,1602
Kentucky,Scott County,1,7,3468,1687,1781
Kentucky,Scott County,1,8,3725,1850,1875
Kentucky,Scott County,1,9,3635,1824,1811
Kentucky,Scott County,1,10,3549,1799,1750
Kentucky,Scott County,1,11,3216,1559,1657
Kentucky,Scott County,1,12,2912,1426,1486
Kentucky,Scott County,1,13,2176,1021,1155
Kentucky,Scott County,1,14,1563,753,810
Kentucky,Scott County,1,15,1049,502,547
Kentucky,Scott County,1,16,765,313,452
Kentucky,Scott County,1,17,536,217,319
Kentucky,Scott County,1,18,454,124,330
Kentucky,Scott County,2,0,47096,23212,23884
Kentucky,Scott County,2,1,3532,1778,1754
Kentucky,Scott County,2,2,3661,1861,1800
Kentucky,Scott County,2,3,3450,1803,1647
Kentucky,Scott County,2,4,3434,1772,1662
Kentucky,Scott County,2,5,2909,1446,1463
Kentucky,Scott County,2,6,3091,1491,1600
Kentucky,Scott County,2,7,3460,1683,1777
Kentucky,Scott County,2,8,3722,1847,1875
Kentucky,Scott County,2,9,3632,1822,1810
Kentucky,Scott County,2,10,3546,1797,1749
Kentucky,Scott County,2,11,3213,1558,1655
Kentucky,Scott County,2,12,2909,1425,1484
Kentucky,Scott County,2,13,2176,1021,1155
Kentucky,Scott County,2,14,1558,752,806
Kentucky,Scott County,2,15,1047,501,546
Kentucky,Scott County,2,16,767,314,453
Kentucky,Scott County,2,17,536,217,319
Kentucky,Scott County,2,18,453,124,329
Kentucky,Scott County,3,0,47274,23304,23970
Kentucky,Scott County,3,1,3519,1765,1754
Kentucky,Scott County,3,2,3680,1874,1806
Kentucky,Scott County,3,3,3469,1809,1660
Kentucky,Scott County,3,4,3411,1765,1646
Kentucky,Scott County,3,5,2871,1428,1443
Kentucky,Scott County,3,6,3068,1484,1584
Kentucky,Scott County,3,7,3478,1695,1783
Kentucky,Scott County,3,8,3726,1844,1882
Kentucky,Scott County,3,9,3655,1828,1827
Kentucky,Scott County,3,10,3593,1824,1769
Kentucky,Scott County,3,11,3221,1569,1652
Kentucky,Scott County,3,12,2935,1435,1500
Kentucky,Scott County,3,13,2230,1049,1181
Kentucky,Scott County,3,14,1580,765,815
Kentucky,Scott County,3,15,1064,508,556
Kentucky,Scott County,3,16,772,318,454
Kentucky,Scott County,3,17,544,219,325
Kentucky,Scott County,3,18,458,125,333
Kentucky,Scott County,4,0,47913,23571,24342
Kentucky,Scott County,4,1,3380,1682,1698
Kentucky,Scott County,4,2,3773,1915,1858
Kentucky,Scott County,4,3,3546,1825,1721
Kentucky,Scott County,4,4,3494,1820,1674
Kentucky,Scott County,4,5,2924,1462,1462
Kentucky,Scott County,4,6,2906,1413,1493
Kentucky,Scott County,4,7,3457,1647,1810
Kentucky,Scott County,4,8,3748,1841,1907
Kentucky,Scott County,4,9,3688,1827,1861
Kentucky,Scott County,4,10,3674,1865,1809
Kentucky,Scott County,4,11,3290,1645,1645
Kentucky,Scott County,4,12,3010,1481,1529
Kentucky,Scott County,4,13,2439,1150,1289
Kentucky,Scott County,4,14,1634,780,854
Kentucky,Scott County,4,15,1129,534,595
Kentucky,Scott County,4,16,794,334,460
Kentucky,Scott County,4,17,564,223,341
Kentucky,Scott County,4,18,463,127,336
Kentucky,Scott County,5,0,48970,24081,24889
Kentucky,Scott County,5,1,3385,1666,1719
Kentucky,Scott County,5,2,3762,1930,1832
Kentucky,Scott County,5,3,3670,1869,1801
Kentucky,Scott County,5,4,3536,1841,1695
Kentucky,Scott County,5,5,3086,1562,1524
Kentucky,Scott County,5,6,2798,1334,1464
Kentucky,Scott County,5,7,3515,1697,1818
Kentucky,Scott County,5,8,3694,1792,1902
Kentucky,Scott County,5,9,3866,1942,1924
Kentucky,Scott County,5,10,3694,1848,1846
Kentucky,Scott County,5,11,3454,1747,1707
Kentucky,Scott County,5,12,3075,1489,1586
Kentucky,Scott County,5,13,2550,1224,1326
Kentucky,Scott County,5,14,1781,847,934
Kentucky,Scott County,5,15,1179,563,616
Kentucky,Scott County,5,16,834,354,480
Kentucky,Scott County,5,17,594,228,366
Kentucky,Scott County,5,18,497,148,349
Kentucky,Scott County,6,0,50000,24578,25422
Kentucky,Scott County,6,1,3404,1700,1704
Kentucky,Scott County,6,2,3773,1933,1840
Kentucky,Scott County,6,3,3770,1899,1871
Kentucky,Scott County,6,4,3590,1865,1725
Kentucky,Scott County,6,5,3280,1637,1643
Kentucky,Scott County,6,6,2854,1395,1459
Kentucky,Scott County,6,7,3513,1694,1819
Kentucky,Scott County,6,8,3738,1806,1932
Kentucky,Scott County,6,9,3912,1950,1962
Kentucky,Scott County,6,10,3640,1820,1820
Kentucky,Scott County,6,11,3558,1799,1759
Kentucky,Scott County,6,12,3132,1510,1622
Kentucky,Scott County,6,13,2672,1302,1370
Kentucky,Scott County,6,14,1875,884,991
Kentucky,Scott County,6,15,1291,616,675
Kentucky,Scott County,6,16,853,366,487
Kentucky,Scott County,6,17,612,225,387
Kentucky,Scott County,6,18,533,177,356
Kentucky,Scott County,7,0,51219,25167,26052
Kentucky,Scott County,7,1,3429,1701,1728
Kentucky,Scott County,7,2,3787,1935,1852
Kentucky,Scott County,7,3,3903,1963,1940
Kentucky,Scott County,7,4,3609,1848,1761
Kentucky,Scott County,7,5,3432,1741,1691
Kentucky,Scott County,7,6,2986,1469,1517
Kentucky,Scott County,7,7,3584,1737,1847
Kentucky,Scott County,7,8,3768,1841,1927
Kentucky,Scott County,7,9,3967,1991,1976
Kentucky,Scott County,7,10,3659,1786,1873
Kentucky,Scott County,7,11,3643,1846,1797
Kentucky,Scott County,7,12,3212,1572,1640
Kentucky,Scott County,7,13,2727,1340,1387
Kentucky,Scott County,7,14,2050,950,1100
Kentucky,Scott County,7,15,1385,637,748
Kentucky,Scott County,7,16,881,389,492
Kentucky,Scott County,7,17,642,235,407
Kentucky,Scott County,7,18,555,186,369
Kentucky,Scott County,8,0,52155,25634,26521
Kentucky,Scott County,8,1,3457,1766,1691
Kentucky,Scott County,8,2,3834,1923,1911
Kentucky,Scott County,8,3,3941,1931,2010
Kentucky,Scott County,8,4,3599,1851,1748
Kentucky,Scott County,8,5,3557,1828,1729
Kentucky,Scott County,8,6,3132,1547,1585
Kentucky,Scott County,8,7,3568,1723,1845
Kentucky,Scott County,8,8,3709,1829,1880
Kentucky,Scott County,8,9,3993,1990,2003
Kentucky,Scott County,8,10,3717,1843,1874
Kentucky,Scott County,8,11,3714,1871,1843
Kentucky,Scott County,8,12,3294,1616,1678
Kentucky,Scott County,8,13,2851,1382,1469
Kentucky,Scott County,8,14,2153,991,1162
Kentucky,Scott County,8,15,1469,673,796
Kentucky,Scott County,8,16,940,431,509
Kentucky,Scott County,8,17,645,238,407
Kentucky,Scott County,8,18,582,201,381
Kentucky,Scott County,9,0,53425,26287,27138
Kentucky,Scott County,9,1,3585,1839,1746
Kentucky,Scott County,9,2,3861,1901,1960
Kentucky,Scott County,9,3,4018,2021,1997
Kentucky,Scott County,9,4,3633,1824,1809
Kentucky,Scott County,9,5,3630,1879,1751
Kentucky,Scott County,9,6,3442,1739,1703
Kentucky,Scott County,9,7,3549,1734,1815
Kentucky,Scott County,9,8,3860,1866,1994
Kentucky,Scott County,9,9,3912,1951,1961
Kentucky,Scott County,9,10,3850,1902,1948
Kentucky,Scott County,9,11,3740,1891,1849
Kentucky,Scott County,9,12,3334,1650,1684
Kentucky,Scott County,9,13,2883,1388,1495
Kentucky,Scott County,9,14,2374,1104,1270
Kentucky,Scott County,9,15,1516,701,815
Kentucky,Scott County,9,16,981,445,536
Kentucky,Scott County,9,17,641,235,406
Kentucky,Scott County,9,18,616,217,399
Kentucky,Scott County,10,0,54782,26908,27874
Kentucky,Scott County,10,1,3662,1849,1813
Kentucky,Scott County,10,2,3881,1893,1988
Kentucky,Scott County,10,3,4077,2076,2001
Kentucky,Scott County,10,4,3752,1864,1888
Kentucky,Scott County,10,5,3711,1903,1808
Kentucky,Scott County,10,6,3694,1849,1845
Kentucky,Scott County,10,7,3619,1792,1827
Kentucky,Scott County,10,8,3945,1931,2014
Kentucky,Scott County,10,9,3922,1898,2024
Kentucky,Scott County,10,10,3966,1999,1967
Kentucky,Scott County,10,11,3684,1847,1837
Kentucky,Scott County,10,12,3494,1751,1743
Kentucky,Scott County,10,13,2908,1378,1530
Kentucky,Scott County,10,14,2489,1165,1324
Kentucky,Scott County,10,15,1654,766,888
Kentucky,Scott County,10,16,1046,477,569
Kentucky,Scott County,10,17,655,257,398
Kentucky,Scott County,10,18,623,213,410
Kentucky,Scott County,11,0,55968,27557,28411
Kentucky,Scott County,11,1,3685,1859,1826
Kentucky,Scott County,11,2,3943,1989,1954
Kentucky,Scott County,11,3,4125,2071,2054
Kentucky,Scott County,11,4,3855,1906,1949
Kentucky,Scott County,11,5,3639,1878,1761
Kentucky,Scott County,11,6,4041,2074,1967
Kentucky,Scott County,11,7,3636,1793,1843
Kentucky,Scott County,11,8,4047,1967,2080
Kentucky,Scott County,11,9,3913,1872,2041
Kentucky,Scott County,11,10,4050,2062,1988
Kentucky,Scott County,11,11,3691,1853,1838
Kentucky,Scott County,11,12,3536,1778,1758
Kentucky,Scott County,11,13,3059,1439,1620
Kentucky,Scott County,11,14,2567,1226,1341
Kentucky,Scott County,11,15,1754,800,954
Kentucky,Scott County,11,16,1155,527,628
Kentucky,Scott County,11,17,653,256,397
Kentucky,Scott County,11,18,619,207,412
Kentucky,Scott County,12,0,57004,28066,28938
Kentucky,Scott County,12,1,3694,1875,1819
Kentucky,Scott County,12,2,3968,1980,1988
Kentucky,Scott County,12,3,4184,2093,2091
Kentucky,Scott County,12,4,3953,1976,1977
Kentucky,Scott County,12,5,3636,1847,1789
Kentucky,Scott County,12,6,4134,2120,2014
Kentucky,Scott County,12,7,3784,1880,1904
Kentucky,Scott County,12,8,4063,1994,2069
Kentucky,Scott County,12,9,4000,1939,2061
Kentucky,Scott County,12,10,4125,2080,2045
Kentucky,Scott County,12,11,3704,1838,1866
Kentucky,Scott County,12,12,3586,1800,1786
Kentucky,Scott County,12,13,3123,1493,1630
Kentucky,Scott County,12,14,2608,1246,1362
Kentucky,Scott County,12,15,1916,874,1042
Kentucky,Scott County,12,16,1239,542,697
Kentucky,Scott County,12,17,673,289,384
Kentucky,Scott County,12,18,614,200,414
Kentucky,Shelby County,1,0,42074,20243,21831
Kentucky,Shelby County,1,1,2769,1427,1342
Kentucky,Shelby County,1,2,3008,1539,1469
Kentucky,Shelby County,1,3,2886,1473,1413
Kentucky,Shelby County,1,4,2790,1427,1363
Kentucky,Shelby County,1,5,2311,1132,1179
Kentucky,Shelby County,1,6,2645,1240,1405
Kentucky,Shelby County,1,7,2736,1234,1502
Kentucky,Shelby County,1,8,2999,1402,1597
Kentucky,Shelby County,1,9,3076,1457,1619
Kentucky,Shelby County,1,10,3321,1576,1745
Kentucky,Shelby County,1,11,3051,1470,1581
Kentucky,Shelby County,1,12,2825,1323,1502
Kentucky,Shelby County,1,13,2597,1259,1338
Kentucky,Shelby County,1,14,1849,921,928
Kentucky,Shelby County,1,15,1206,584,622
Kentucky,Shelby County,1,16,847,370,477
Kentucky,Shelby County,1,17,604,242,362
Kentucky,Shelby County,1,18,554,167,387
Kentucky,Shelby County,2,0,41971,20193,21778
Kentucky,Shelby County,2,1,2759,1422,1337
Kentucky,Shelby County,2,2,3000,1534,1466
Kentucky,Shelby County,2,3,2883,1472,1411
Kentucky,Shelby County,2,4,2785,1426,1359
Kentucky,Shelby County,2,5,2309,1131,1178
Kentucky,Shelby County,2,6,2645,1240,1405
Kentucky,Shelby County,2,7,2729,1231,1498
Kentucky,Shelby County,2,8,2992,1398,1594
Kentucky,Shelby County,2,9,3068,1454,1614
Kentucky,Shelby County,2,10,3315,1574,1741
Kentucky,Shelby County,2,11,3040,1463,1577
Kentucky,Shelby County,2,12,2812,1316,1496
Kentucky,Shelby County,2,13,2586,1253,1333
Kentucky,Shelby County,2,14,1847,921,926
Kentucky,Shelby County,2,15,1204,584,620
Kentucky,Shelby County,2,16,845,369,476
Kentucky,Shelby County,2,17,601,240,361
Kentucky,Shelby County,2,18,551,165,386
Kentucky,Shelby County,3,0,42189,20409,21780
Kentucky,Shelby County,3,1,2782,1430,1352
Kentucky,Shelby County,3,2,2985,1532,1453
Kentucky,Shelby County,3,3,2896,1480,1416
Kentucky,Shelby County,3,4,2861,1471,1390
Kentucky,Shelby County,3,5,2387,1181,1206
Kentucky,Shelby County,3,6,2639,1260,1379
Kentucky,Shelby County,3,7,2729,1245,1484
Kentucky,Shelby County,3,8,2952,1392,1560
Kentucky,Shelby County,3,9,3051,1457,1594
Kentucky,Shelby County,3,10,3309,1579,1730
Kentucky,Shelby County,3,11,3052,1479,1573
Kentucky,Shelby County,3,12,2830,1327,1503
Kentucky,Shelby County,3,13,2608,1269,1339
Kentucky,Shelby County,3,14,1867,926,941
Kentucky,Shelby County,3,15,1228,595,633
Kentucky,Shelby County,3,16,851,376,475
Kentucky,Shelby County,3,17,601,239,362
Kentucky,Shelby County,3,18,561,171,390
Kentucky,Shelby County,4,0,42848,20633,22215
Kentucky,Shelby County,4,1,2869,1483,1386
Kentucky,Shelby County,4,2,2879,1476,1403
Kentucky,Shelby County,4,3,2933,1497,1436
Kentucky,Shelby County,4,4,2914,1515,1399
Kentucky,Shelby County,4,5,2407,1161,1246
Kentucky,Shelby County,4,6,2658,1246,1412
Kentucky,Shelby County,4,7,2846,1312,1534
Kentucky,Shelby County,4,8,2881,1342,1539
Kentucky,Shelby County,4,9,3067,1443,1624
Kentucky,Shelby County,4,10,3296,1585,1711
Kentucky,Shelby County,4,11,3173,1537,1636
Kentucky,Shelby County,4,12,2880,1347,1533
Kentucky,Shelby County,4,13,2740,1326,1414
Kentucky,Shelby County,4,14,1929,932,997
Kentucky,Shelby County,4,15,1292,616,676
Kentucky,Shelby County,4,16,884,389,495
Kentucky,Shelby County,4,17,604,240,364
Kentucky,Shelby County,4,18,596,186,410
Kentucky,Shelby County,5,0,43656,21050,22606
Kentucky,Shelby County,5,1,2896,1535,1361
Kentucky,Shelby County,5,2,2906,1450,1456
Kentucky,Shelby County,5,3,2974,1514,1460
Kentucky,Shelby County,5,4,2959,1573,1386
Kentucky,Shelby County,5,5,2502,1208,1294
Kentucky,Shelby County,5,6,2610,1204,1406
Kentucky,Shelby County,5,7,2913,1329,1584
Kentucky,Shelby County,5,8,2902,1332,1570
Kentucky,Shelby County,5,9,3165,1506,1659
Kentucky,Shelby County,5,10,3255,1583,1672
Kentucky,Shelby County,5,11,3280,1566,1714
Kentucky,Shelby County,5,12,2904,1353,1551
Kentucky,Shelby County,5,13,2687,1311,1376
Kentucky,Shelby County,5,14,2171,1052,1119
Kentucky,Shelby County,5,15,1412,690,722
Kentucky,Shelby County,5,16,901,401,500
Kentucky,Shelby County,5,17,621,249,372
Kentucky,Shelby County,5,18,598,194,404
Kentucky,Shelby County,6,0,44460,21522,22938
Kentucky,Shelby County,6,1,2936,1583,1353
Kentucky,Shelby County,6,2,2895,1457,1438
Kentucky,Shelby County,6,3,3024,1554,1470
Kentucky,Shelby County,6,4,3016,1591,1425
Kentucky,Shelby County,6,5,2707,1322,1385
Kentucky,Shelby County,6,6,2572,1159,1413
Kentucky,Shelby County,6,7,2963,1338,1625
Kentucky,Shelby County,6,8,2915,1365,1550
Kentucky,Shelby County,6,9,3168,1509,1659
Kentucky,Shelby County,6,10,3269,1577,1692
Kentucky,Shelby County,6,11,3324,1624,1700
Kentucky,Shelby County,6,12,2983,1410,1573
Kentucky,Shelby County,6,13,2613,1258,1355
Kentucky,Shelby County,6,14,2290,1106,1184
Kentucky,Shelby County,6,15,1555,770,785
Kentucky,Shelby County,6,16,957,436,521
Kentucky,Shelby County,6,17,646,258,388
Kentucky,Shelby County,6,18,627,205,422
Kentucky,Shelby County,7,0,45089,21841,23248
Kentucky,Shelby County,7,1,2989,1604,1385
Kentucky,Shelby County,7,2,2880,1483,1397
Kentucky,Shelby County,7,3,3032,1546,1486
Kentucky,Shelby County,7,4,2947,1523,1424
Kentucky,Shelby County,7,5,2794,1397,1397
Kentucky,Shelby County,7,6,2554,1136,1418
Kentucky,Shelby County,7,7,2962,1389,1573
Kentucky,Shelby County,7,8,2972,1361,1611
Kentucky,Shelby County,7,9,3206,1560,1646
Kentucky,Shelby County,7,10,3233,1537,1696
Kentucky,Shelby County,7,11,3408,1646,1762
Kentucky,Shelby County,7,12,3044,1472,1572
Kentucky,Shelby County,7,13,2687,1270,1417
Kentucky,Shelby County,7,14,2399,1163,1236
Kentucky,Shelby County,7,15,1661,816,845
Kentucky,Shelby County,7,16,1013,459,554
Kentucky,Shelby County,7,17,651,265,386
Kentucky,Shelby County,7,18,657,214,443
Kentucky,Shelby County,8,0,45787,22221,23566
Kentucky,Shelby County,8,1,3048,1621,1427
Kentucky,Shelby County,8,2,2926,1554,1372
Kentucky,Shelby County,8,3,2994,1524,1470
Kentucky,Shelby County,8,4,3027,1518,1509
Kentucky,Shelby County,8,5,2902,1504,1398
Kentucky,Shelby County,8,6,2639,1135,1504
Kentucky,Shelby County,8,7,2956,1402,1554
Kentucky,Shelby County,8,8,2984,1393,1591
Kentucky,Shelby County,8,9,3163,1535,1628
Kentucky,Shelby County,8,10,3211,1541,1670
Kentucky,Shelby County,8,11,3418,1645,1773
Kentucky,Shelby County,8,12,3184,1555,1629
Kentucky,Shelby County,8,13,2760,1296,1464
Kentucky,Shelby County,8,14,2443,1180,1263
Kentucky,Shelby County,8,15,1742,847,895
Kentucky,Shelby County,8,16,1055,480,575
Kentucky,Shelby County,8,17,664,275,389
Kentucky,Shelby County,8,18,671,216,455
Kentucky,Shelby County,9,0,46548,22566,23982
Kentucky,Shelby County,9,1,3017,1588,1429
Kentucky,Shelby County,9,2,2989,1574,1415
Kentucky,Shelby County,9,3,3010,1530,1480
Kentucky,Shelby County,9,4,3088,1542,1546
Kentucky,Shelby County,9,5,2976,1532,1444
Kentucky,Shelby County,9,6,2681,1208,1473
Kentucky,Shelby County,9,7,2961,1366,1595
Kentucky,Shelby County,9,8,3123,1474,1649
Kentucky,Shelby County,9,9,3073,1468,1605
Kentucky,Shelby County,9,10,3264,1559,1705
Kentucky,Shelby County,9,11,3437,1694,1743
Kentucky,Shelby County,9,12,3251,1602,1649
Kentucky,Shelby County,9,13,2829,1315,1514
Kentucky,Shelby County,9,14,2530,1218,1312
Kentucky,Shelby County,9,15,1799,858,941
Kentucky,Shelby County,9,16,1148,521,627
Kentucky,Shelby County,9,17,678,291,387
Kentucky,Shelby County,9,18,694,226,468
Kentucky,Shelby County,10,0,47209,22927,24282
Kentucky,Shelby County,10,1,2949,1503,1446
Kentucky,Shelby County,10,2,2987,1599,1388
Kentucky,Shelby County,10,3,3005,1537,1468
Kentucky,Shelby County,10,4,3090,1537,1553
Kentucky,Shelby County,10,5,3039,1562,1477
Kentucky,Shelby County,10,6,2805,1297,1508
Kentucky,Shelby County,10,7,2940,1365,1575
Kentucky,Shelby County,10,8,3190,1515,1675
Kentucky,Shelby County,10,9,3015,1442,1573
Kentucky,Shelby County,10,10,3335,1605,1730
Kentucky,Shelby County,10,11,3405,1686,1719
Kentucky,Shelby County,10,12,3366,1644,1722
Kentucky,Shelby County,10,13,2924,1370,1554
Kentucky,Shelby County,10,14,2521,1208,1313
Kentucky,Shelby County,10,15,1974,948,1026
Kentucky,Shelby County,10,16,1256,576,680
Kentucky,Shelby County,10,17,689,286,403
Kentucky,Shelby County,10,18,719,247,472
Kentucky,Shelby County,11,0,48059,23376,24683
Kentucky,Shelby County,11,1,2929,1484,1445
Kentucky,Shelby County,11,2,3024,1643,1381
Kentucky,Shelby County,11,3,2979,1518,1461
Kentucky,Shelby County,11,4,3157,1603,1554
Kentucky,Shelby County,11,5,3022,1520,1502
Kentucky,Shelby County,11,6,2984,1381,1603
Kentucky,Shelby County,11,7,2937,1362,1575
Kentucky,Shelby County,11,8,3204,1517,1687
Kentucky,Shelby County,11,9,3083,1463,1620
Kentucky,Shelby County,11,10,3392,1643,1749
Kentucky,Shelby County,11,11,3429,1674,1755
Kentucky,Shelby County,11,12,3445,1709,1736
Kentucky,Shelby County,11,13,3038,1448,1590
Kentucky,Shelby County,11,14,2557,1216,1341
Kentucky,Shelby County,11,15,2060,984,1076
Kentucky,Shelby County,11,16,1357,630,727
Kentucky,Shelby County,11,17,737,330,407
Kentucky,Shelby County,11,18,725,251,474
Kentucky,Shelby County,12,0,49024,23898,25126
Kentucky,Shelby County,12,1,2937,1480,1457
Kentucky,Shelby County,12,2,3080,1673,1407
Kentucky,Shelby County,12,3,3009,1539,1470
Kentucky,Shelby County,12,4,3138,1622,1516
Kentucky,Shelby County,12,5,3053,1501,1552
Kentucky,Shelby County,12,6,3196,1514,1682
Kentucky,Shelby County,12,7,2979,1370,1609
Kentucky,Shelby County,12,8,3247,1545,1702
Kentucky,Shelby County,12,9,3117,1480,1637
Kentucky,Shelby County,12,10,3408,1654,1754
Kentucky,Shelby County,12,11,3428,1667,1761
Kentucky,Shelby County,12,12,3543,1747,1796
Kentucky,Shelby County,12,13,3135,1519,1616
Kentucky,Shelby County,12,14,2669,1258,1411
Kentucky,Shelby County,12,15,2171,1040,1131
Kentucky,Shelby County,12,16,1424,683,741
Kentucky,Shelby County,12,17,752,337,415
Kentucky,Shelby County,12,18,738,269,469
Kentucky,Simpson County,1,0,17327,8472,8855
Kentucky,Simpson County,1,1,1157,607,550
Kentucky,Simpson County,1,2,1186,590,596
Kentucky,Simpson County,1,3,1217,609,608
Kentucky,Simpson County,1,4,1095,578,517
Kentucky,Simpson County,1,5,1000,527,473
Kentucky,Simpson County,1,6,1004,477,527
Kentucky,Simpson County,1,7,1078,544,534
Kentucky,Simpson County,1,8,1092,542,550
Kentucky,Simpson County,1,9,1203,614,589
Kentucky,Simpson County,1,10,1346,670,676
Kentucky,Simpson County,1,11,1303,633,670
Kentucky,Simpson County,1,12,1141,564,577
Kentucky,Simpson County,1,13,1034,483,551
Kentucky,Simpson County,1,14,819,378,441
Kentucky,Simpson County,1,15,608,274,334
Kentucky,Simpson County,1,16,439,178,261
Kentucky,Simpson County,1,17,306,114,192
Kentucky,Simpson County,1,18,299,90,209
Kentucky,Simpson County,2,0,17329,8474,8855
Kentucky,Simpson County,2,1,1157,607,550
Kentucky,Simpson County,2,2,1186,590,596
Kentucky,Simpson County,2,3,1217,609,608
Kentucky,Simpson County,2,4,1095,578,517
Kentucky,Simpson County,2,5,1001,528,473
Kentucky,Simpson County,2,6,1004,477,527
Kentucky,Simpson County,2,7,1078,544,534
Kentucky,Simpson County,2,8,1092,542,550
Kentucky,Simpson County,2,9,1203,614,589
Kentucky,Simpson County,2,10,1346,670,676
Kentucky,Simpson County,2,11,1304,633,671
Kentucky,Simpson County,2,12,1141,565,576
Kentucky,Simpson County,2,13,1034,483,551
Kentucky,Simpson County,2,14,819,378,441
Kentucky,Simpson County,2,15,608,274,334
Kentucky,Simpson County,2,16,439,178,261
Kentucky,Simpson County,2,17,306,114,192
Kentucky,Simpson County,2,18,299,90,209
Kentucky,Simpson County,3,0,17336,8469,8867
Kentucky,Simpson County,3,1,1174,618,556
Kentucky,Simpson County,3,2,1185,589,596
Kentucky,Simpson County,3,3,1224,612,612
Kentucky,Simpson County,3,4,1080,564,516
Kentucky,Simpson County,3,5,1008,535,473
Kentucky,Simpson County,3,6,997,477,520
Kentucky,Simpson County,3,7,1084,538,546
Kentucky,Simpson County,3,8,1083,540,543
Kentucky,Simpson County,3,9,1199,616,583
Kentucky,Simpson County,3,10,1344,664,680
Kentucky,Simpson County,3,11,1314,635,679
Kentucky,Simpson County,3,12,1131,563,568
Kentucky,Simpson County,3,13,1037,487,550
Kentucky,Simpson County,3,14,821,377,444
Kentucky,Simpson County,3,15,609,275,334
Kentucky,Simpson County,3,16,443,178,265
Kentucky,Simpson County,3,17,307,114,193
Kentucky,Simpson County,3,18,296,87,209
Kentucky,Simpson County,4,0,17302,8485,8817
Kentucky,Simpson County,4,1,1202,633,569
Kentucky,Simpson County,4,2,1171,590,581
Kentucky,Simpson County,4,3,1231,631,600
Kentucky,Simpson County,4,4,1039,533,506
Kentucky,Simpson County,4,5,1025,551,474
Kentucky,Simpson County,4,6,958,473,485
Kentucky,Simpson County,4,7,1114,534,580
Kentucky,Simpson County,4,8,1045,521,524
Kentucky,Simpson County,4,9,1165,610,555
Kentucky,Simpson County,4,10,1300,624,676
Kentucky,Simpson County,4,11,1330,648,682
Kentucky,Simpson County,4,12,1119,557,562
Kentucky,Simpson County,4,13,1071,509,562
Kentucky,Simpson County,4,14,865,402,463
Kentucky,Simpson County,4,15,618,274,344
Kentucky,Simpson County,4,16,460,192,268
Kentucky,Simpson County,4,17,302,119,183
Kentucky,Simpson County,4,18,287,84,203
Kentucky,Simpson County,5,0,17543,8547,8996
Kentucky,Simpson County,5,1,1221,623,598
Kentucky,Simpson County,5,2,1197,613,584
Kentucky,Simpson County,5,3,1243,620,623
Kentucky,Simpson County,5,4,1082,563,519
Kentucky,Simpson County,5,5,1076,567,509
Kentucky,Simpson County,5,6,976,483,493
Kentucky,Simpson County,5,7,1070,518,552
Kentucky,Simpson County,5,8,1037,505,532
Kentucky,Simpson County,5,9,1176,590,586
Kentucky,Simpson County,5,10,1299,633,666
Kentucky,Simpson County,5,11,1350,660,690
Kentucky,Simpson County,5,12,1151,556,595
Kentucky,Simpson County,5,13,1045,503,542
Kentucky,Simpson County,5,14,940,451,489
Kentucky,Simpson County,5,15,645,280,365
Kentucky,Simpson County,5,16,445,187,258
Kentucky,Simpson County,5,17,303,117,186
Kentucky,Simpson County,5,18,287,78,209
Kentucky,Simpson County,6,0,17681,8652,9029
Kentucky,Simpson County,6,1,1151,596,555
Kentucky,Simpson County,6,2,1218,623,595
Kentucky,Simpson County,6,3,1237,622,615
Kentucky,Simpson County,6,4,1107,559,548
Kentucky,Simpson County,6,5,1068,574,494
Kentucky,Simpson County,6,6,1019,503,516
Kentucky,Simpson County,6,7,1071,538,533
Kentucky,Simpson County,6,8,1066,509,557
Kentucky,Simpson County,6,9,1173,595,578
Kentucky,Simpson County,6,10,1249,627,622
Kentucky,Simpson County,6,11,1371,660,711
Kentucky,Simpson County,6,12,1199,581,618
Kentucky,Simpson County,6,13,1061,508,553
Kentucky,Simpson County,6,14,944,443,501
Kentucky,Simpson County,6,15,679,306,373
Kentucky,Simpson County,6,16,460,194,266
Kentucky,Simpson County,6,17,323,133,190
Kentucky,Simpson County,6,18,285,81,204
Kentucky,Simpson County,7,0,17753,8718,9035
Kentucky,Simpson County,7,1,1117,592,525
Kentucky,Simpson County,7,2,1212,625,587
Kentucky,Simpson County,7,3,1245,631,614
Kentucky,Simpson County,7,4,1137,564,573
Kentucky,Simpson County,7,5,1095,593,502
Kentucky,Simpson County,7,6,1072,543,529
Kentucky,Simpson County,7,7,1018,485,533
Kentucky,Simpson County,7,8,1087,543,544
Kentucky,Simpson County,7,9,1144,577,567
Kentucky,Simpson County,7,10,1187,596,591
Kentucky,Simpson County,7,11,1328,648,680
Kentucky,Simpson County,7,12,1270,611,659
Kentucky,Simpson County,7,13,1085,516,569
Kentucky,Simpson County,7,14,949,441,508
Kentucky,Simpson County,7,15,712,321,391
Kentucky,Simpson County,7,16,486,204,282
Kentucky,Simpson County,7,17,319,133,186
Kentucky,Simpson County,7,18,290,95,195
Kentucky,Simpson County,8,0,17901,8798,9103
Kentucky,Simpson County,8,1,1145,594,551
Kentucky,Simpson County,8,2,1197,633,564
Kentucky,Simpson County,8,3,1242,630,612
Kentucky,Simpson County,8,4,1201,610,591
Kentucky,Simpson County,8,5,1056,544,512
Kentucky,Simpson County,8,6,1152,626,526
Kentucky,Simpson County,8,7,1022,480,542
Kentucky,Simpson County,8,8,1112,543,569
Kentucky,Simpson County,8,9,1105,544,561
Kentucky,Simpson County,8,10,1170,599,571
Kentucky,Simpson County,8,11,1306,634,672
Kentucky,Simpson County,8,12,1285,611,674
Kentucky,Simpson County,8,13,1103,551,552
Kentucky,Simpson County,8,14,949,427,522
Kentucky,Simpson County,8,15,732,322,410
Kentucky,Simpson County,8,16,508,218,290
Kentucky,Simpson County,8,17,324,130,194
Kentucky,Simpson County,8,18,292,102,190
Kentucky,Simpson County,9,0,17992,8827,9165
Kentucky,Simpson County,9,1,1155,601,554
Kentucky,Simpson County,9,2,1216,625,591
Kentucky,Simpson County,9,3,1233,618,615
Kentucky,Simpson County,9,4,1193,619,574
Kentucky,Simpson County,9,5,1068,541,527
Kentucky,Simpson County,9,6,1227,677,550
Kentucky,Simpson County,9,7,1004,480,524
Kentucky,Simpson County,9,8,1093,506,587
Kentucky,Simpson County,9,9,1073,533,540
Kentucky,Simpson County,9,10,1156,592,564
Kentucky,Simpson County,9,11,1286,619,667
Kentucky,Simpson County,9,12,1292,623,669
Kentucky,Simpson County,9,13,1071,527,544
Kentucky,Simpson County,9,14,1011,463,548
Kentucky,Simpson County,9,15,763,353,410
Kentucky,Simpson County,9,16,515,211,304
Kentucky,Simpson County,9,17,338,138,200
Kentucky,Simpson County,9,18,298,101,197
Kentucky,Simpson County,10,0,18046,8862,9184
Kentucky,Simpson County,10,1,1158,577,581
Kentucky,Simpson County,10,2,1206,621,585
Kentucky,Simpson County,10,3,1216,635,581
Kentucky,Simpson County,10,4,1193,621,572
Kentucky,Simpson County,10,5,1049,536,513
Kentucky,Simpson County,10,6,1221,672,549
Kentucky,Simpson County,10,7,1045,508,537
Kentucky,Simpson County,10,8,1086,506,580
Kentucky,Simpson County,10,9,1044,528,516
Kentucky,Simpson County,10,10,1181,582,599
Kentucky,Simpson County,10,11,1255,610,645
Kentucky,Simpson County,10,12,1318,661,657
Kentucky,Simpson County,10,13,1127,531,596
Kentucky,Simpson County,10,14,964,443,521
Kentucky,Simpson County,10,15,821,375,446
Kentucky,Simpson County,10,16,534,220,314
Kentucky,Simpson County,10,17,331,139,192
Kentucky,Simpson County,10,18,297,97,200
Kentucky,Simpson County,11,0,18403,9023,9380
Kentucky,Simpson County,11,1,1181,588,593
Kentucky,Simpson County,11,2,1212,643,569
Kentucky,Simpson County,11,3,1243,620,623
Kentucky,Simpson County,11,4,1221,654,567
Kentucky,Simpson County,11,5,1082,535,547
Kentucky,Simpson County,11,6,1285,701,584
Kentucky,Simpson County,11,7,1079,514,565
Kentucky,Simpson County,11,8,1101,540,561
Kentucky,Simpson County,11,9,1042,509,533
Kentucky,Simpson County,11,10,1219,599,620
Kentucky,Simpson County,11,11,1232,599,633
Kentucky,Simpson County,11,12,1329,668,661
Kentucky,Simpson County,11,13,1153,556,597
Kentucky,Simpson County,11,14,996,457,539
Kentucky,Simpson County,11,15,818,357,461
Kentucky,Simpson County,11,16,564,235,329
Kentucky,Simpson County,11,17,339,145,194
Kentucky,Simpson County,11,18,307,103,204
Kentucky,Simpson County,12,0,18572,9119,9453
Kentucky,Simpson County,12,1,1182,586,596
Kentucky,Simpson County,12,2,1223,659,564
Kentucky,Simpson County,12,3,1260,648,612
Kentucky,Simpson County,12,4,1182,606,576
Kentucky,Simpson County,12,5,1102,551,551
Kentucky,Simpson County,12,6,1311,716,595
Kentucky,Simpson County,12,7,1099,539,560
Kentucky,Simpson County,12,8,1059,509,550
Kentucky,Simpson County,12,9,1093,550,543
Kentucky,Simpson County,12,10,1168,564,604
Kentucky,Simpson County,12,11,1208,592,616
Kentucky,Simpson County,12,12,1352,664,688
Kentucky,Simpson County,12,13,1230,599,631
Kentucky,Simpson County,12,14,995,455,540
Kentucky,Simpson County,12,15,840,367,473
Kentucky,Simpson County,12,16,591,247,344
Kentucky,Simpson County,12,17,361,157,204
Kentucky,Simpson County,12,18,316,110,206
Kentucky,Spencer County,1,0,17061,8659,8402
Kentucky,Spencer County,1,1,1106,586,520
Kentucky,Spencer County,1,2,1240,656,584
Kentucky,Spencer County,1,3,1260,663,597
Kentucky,Spencer County,1,4,1194,649,545
Kentucky,Spencer County,1,5,740,386,354
Kentucky,Spencer County,1,6,898,416,482
Kentucky,Spencer County,1,7,1084,550,534
Kentucky,Spencer County,1,8,1332,639,693
Kentucky,Spencer County,1,9,1412,716,696
Kentucky,Spencer County,1,10,1559,768,791
Kentucky,Spencer County,1,11,1401,714,687
Kentucky,Spencer County,1,12,1126,580,546
Kentucky,Spencer County,1,13,961,465,496
Kentucky,Spencer County,1,14,690,364,326
Kentucky,Spencer County,1,15,418,223,195
Kentucky,Spencer County,1,16,300,154,146
Kentucky,Spencer County,1,17,175,74,101
Kentucky,Spencer County,1,18,165,56,109
Kentucky,Spencer County,2,0,17142,8700,8442
Kentucky,Spencer County,2,1,1115,590,525
Kentucky,Spencer County,2,2,1246,660,586
Kentucky,Spencer County,2,3,1261,662,599
Kentucky,Spencer County,2,4,1199,653,546
Kentucky,Spencer County,2,5,741,387,354
Kentucky,Spencer County,2,6,899,417,482
Kentucky,Spencer County,2,7,1089,552,537
Kentucky,Spencer County,2,8,1340,644,696
Kentucky,Spencer County,2,9,1418,718,700
Kentucky,Spencer County,2,10,1562,769,793
Kentucky,Spencer County,2,11,1409,719,690
Kentucky,Spencer County,2,12,1138,586,552
Kentucky,Spencer County,2,13,972,472,500
Kentucky,Spencer County,2,14,689,363,326
Kentucky,Spencer County,2,15,421,223,198
Kentucky,Spencer County,2,16,300,153,147
Kentucky,Spencer County,2,17,177,75,102
Kentucky,Spencer County,2,18,166,57,109
Kentucky,Spencer County,3,0,17201,8741,8460
Kentucky,Spencer County,3,1,1084,582,502
Kentucky,Spencer County,3,2,1236,658,578
Kentucky,Spencer County,3,3,1269,669,600
Kentucky,Spencer County,3,4,1197,651,546
Kentucky,Spencer County,3,5,754,388,366
Kentucky,Spencer County,3,6,892,415,477
Kentucky,Spencer County,3,7,1098,556,542
Kentucky,Spencer County,3,8,1331,642,689
Kentucky,Spencer County,3,9,1428,725,703
Kentucky,Spencer County,3,10,1566,767,799
Kentucky,Spencer County,3,11,1425,731,694
Kentucky,Spencer County,3,12,1155,589,566
Kentucky,Spencer County,3,13,974,478,496
Kentucky,Spencer County,3,14,707,369,338
Kentucky,Spencer County,3,15,428,229,199
Kentucky,Spencer County,3,16,302,153,149
Kentucky,Spencer County,3,17,185,80,105
Kentucky,Spencer County,3,18,170,59,111
Kentucky,Spencer County,4,0,17466,8817,8649
Kentucky,Spencer County,4,1,1079,555,524
Kentucky,Spencer County,4,2,1252,657,595
Kentucky,Spencer County,4,3,1300,691,609
Kentucky,Spencer County,4,4,1181,629,552
Kentucky,Spencer County,4,5,822,425,397
Kentucky,Spencer County,4,6,840,389,451
Kentucky,Spencer County,4,7,1109,552,557
Kentucky,Spencer County,4,8,1286,626,660
Kentucky,Spencer County,4,9,1473,747,726
Kentucky,Spencer County,4,10,1537,740,797
Kentucky,Spencer County,4,11,1460,750,710
Kentucky,Spencer County,4,12,1216,612,604
Kentucky,Spencer County,4,13,1004,503,501
Kentucky,Spencer County,4,14,756,384,372
Kentucky,Spencer County,4,15,472,251,221
Kentucky,Spencer County,4,16,311,154,157
Kentucky,Spencer County,4,17,196,91,105
Kentucky,Spencer County,4,18,172,61,111
Kentucky,Spencer County,5,0,17518,8859,8659
Kentucky,Spencer County,5,1,1019,510,509
Kentucky,Spencer County,5,2,1245,663,582
Kentucky,Spencer County,5,3,1330,702,628
Kentucky,Spencer County,5,4,1178,641,537
Kentucky,Spencer County,5,5,849,441,408
Kentucky,Spencer County,5,6,797,376,421
Kentucky,Spencer County,5,7,1091,531,560
Kentucky,Spencer County,5,8,1225,604,621
Kentucky,Spencer County,5,9,1500,760,740
Kentucky,Spencer County,5,10,1510,746,764
Kentucky,Spencer County,5,11,1473,751,722
Kentucky,Spencer County,5,12,1277,642,635
Kentucky,Spencer County,5,13,997,492,505
Kentucky,Spencer County,5,14,814,410,404
Kentucky,Spencer County,5,15,534,283,251
Kentucky,Spencer County,5,16,303,145,158
Kentucky,Spencer County,5,17,196,95,101
Kentucky,Spencer County,5,18,180,67,113
Kentucky,Spencer County,6,0,17678,8921,8757
Kentucky,Spencer County,6,1,985,500,485
Kentucky,Spencer County,6,2,1223,644,579
Kentucky,Spencer County,6,3,1327,684,643
Kentucky,Spencer County,6,4,1154,604,550
Kentucky,Spencer County,6,5,906,479,427
Kentucky,Spencer County,6,6,798,386,412
Kentucky,Spencer County,6,7,1076,515,561
Kentucky,Spencer County,6,8,1186,585,601
Kentucky,Spencer County,6,9,1494,759,735
Kentucky,Spencer County,6,10,1476,737,739
Kentucky,Spencer County,6,11,1537,775,762
Kentucky,Spencer County,6,12,1343,697,646
Kentucky,Spencer County,6,13,1066,521,545
Kentucky,Spencer County,6,14,834,412,422
Kentucky,Spencer County,6,15,571,297,274
Kentucky,Spencer County,6,16,309,152,157
Kentucky,Spencer County,6,17,203,96,107
Kentucky,Spencer County,6,18,190,78,112
Kentucky,Spencer County,7,0,17813,8980,8833
Kentucky,Spencer County,7,1,959,472,487
Kentucky,Spencer County,7,2,1228,656,572
Kentucky,Spencer County,7,3,1306,662,644
Kentucky,Spencer County,7,4,1148,614,534
Kentucky,Spencer County,7,5,935,498,437
Kentucky,Spencer County,7,6,809,401,408
Kentucky,Spencer County,7,7,1074,506,568
Kentucky,Spencer County,7,8,1177,592,585
Kentucky,Spencer County,7,9,1451,721,730
Kentucky,Spencer County,7,10,1451,724,727
Kentucky,Spencer County,7,11,1581,798,783
Kentucky,Spencer County,7,12,1394,715,679
Kentucky,Spencer County,7,13,1096,541,555
Kentucky,Spencer County,7,14,863,433,430
Kentucky,Spencer County,7,15,597,302,295
Kentucky,Spencer County,7,16,333,162,171
Kentucky,Spencer County,7,17,218,104,114
Kentucky,Spencer County,7,18,193,79,114
Kentucky,Spencer County,8,0,18072,9131,8941
Kentucky,Spencer County,8,1,980,493,487
Kentucky,Spencer County,8,2,1165,610,555
Kentucky,Spencer County,8,3,1327,696,631
Kentucky,Spencer County,8,4,1183,631,552
Kentucky,Spencer County,8,5,949,508,441
Kentucky,Spencer County,8,6,842,426,416
Kentucky,Spencer County,8,7,1059,492,567
Kentucky,Spencer County,8,8,1199,607,592
Kentucky,Spencer County,8,9,1401,684,717
Kentucky,Spencer County,8,10,1489,765,724
Kentucky,Spencer County,8,11,1573,779,794
Kentucky,Spencer County,8,12,1468,749,719
Kentucky,Spencer County,8,13,1118,558,560
Kentucky,Spencer County,8,14,922,460,462
Kentucky,Spencer County,8,15,610,307,303
Kentucky,Spencer County,8,16,373,188,185
Kentucky,Spencer County,8,17,218,97,121
Kentucky,Spencer County,8,18,196,81,115
Kentucky,Spencer County,9,0,18336,9285,9051
Kentucky,Spencer County,9,1,994,516,478
Kentucky,Spencer County,9,2,1121,584,537
Kentucky,Spencer County,9,3,1310,692,618
Kentucky,Spencer County,9,4,1221,644,577
Kentucky,Spencer County,9,5,963,489,474
Kentucky,Spencer County,9,6,897,453,444
Kentucky,Spencer County,9,7,1018,486,532
Kentucky,Spencer County,9,8,1249,635,614
Kentucky,Spencer County,9,9,1336,660,676
Kentucky,Spencer County,9,10,1500,784,716
Kentucky,Spencer County,9,11,1564,763,801
Kentucky,Spencer County,9,12,1528,789,739
Kentucky,Spencer County,9,13,1203,598,605
Kentucky,Spencer County,9,14,961,490,471
Kentucky,Spencer County,9,15,648,322,326
Kentucky,Spencer County,9,16,411,202,209
Kentucky,Spencer County,9,17,217,100,117
Kentucky,Spencer County,9,18,195,78,117
Kentucky,Spencer County,10,0,18619,9461,9158
Kentucky,Spencer County,10,1,1019,547,472
Kentucky,Spencer County,10,2,1092,581,511
Kentucky,Spencer County,10,3,1337,705,632
Kentucky,Spencer County,10,4,1223,647,576
Kentucky,Spencer County,10,5,948,482,466
Kentucky,Spencer County,10,6,903,443,460
Kentucky,Spencer County,10,7,1089,538,551
Kentucky,Spencer County,10,8,1230,607,623
Kentucky,Spencer County,10,9,1316,650,666
Kentucky,Spencer County,10,10,1547,813,734
Kentucky,Spencer County,10,11,1558,769,789
Kentucky,Spencer County,10,12,1526,786,740
Kentucky,Spencer County,10,13,1291,648,643
Kentucky,Spencer County,10,14,965,491,474
Kentucky,Spencer County,10,15,707,344,363
Kentucky,Spencer County,10,16,448,217,231
Kentucky,Spencer County,10,17,225,107,118
Kentucky,Spencer County,10,18,195,86,109
Kentucky,Spencer County,11,0,19021,9651,9370
Kentucky,Spencer County,11,1,1084,580,504
Kentucky,Spencer County,11,2,1110,575,535
Kentucky,Spencer County,11,3,1310,697,613
Kentucky,Spencer County,11,4,1244,653,591
Kentucky,Spencer County,11,5,948,485,463
Kentucky,Spencer County,11,6,983,491,492
Kentucky,Spencer County,11,7,1093,545,548
Kentucky,Spencer County,11,8,1286,625,661
Kentucky,Spencer County,11,9,1296,646,650
Kentucky,Spencer County,11,10,1535,787,748
Kentucky,Spencer County,11,11,1527,761,766
Kentucky,Spencer County,11,12,1585,800,785
Kentucky,Spencer County,11,13,1335,701,634
Kentucky,Spencer County,11,14,1025,509,516
Kentucky,Spencer County,11,15,727,346,381
Kentucky,Spencer County,11,16,470,231,239
Kentucky,Spencer County,11,17,242,118,124
Kentucky,Spencer County,11,18,221,101,120
Kentucky,Spencer County,12,0,19351,9813,9538
Kentucky,Spencer County,12,1,1095,579,516
Kentucky,Spencer County,12,2,1151,574,577
Kentucky,Spencer County,12,3,1317,692,625
Kentucky,Spencer County,12,4,1216,643,573
Kentucky,Spencer County,12,5,959,491,468
Kentucky,Spencer County,12,6,990,501,489
Kentucky,Spencer County,12,7,1165,589,576
Kentucky,Spencer County,12,8,1261,610,651
Kentucky,Spencer County,12,9,1323,670,653
Kentucky,Spencer County,12,10,1518,763,755
Kentucky,Spencer County,12,11,1485,739,746
Kentucky,Spencer County,12,12,1648,838,810
Kentucky,Spencer County,12,13,1405,733,672
Kentucky,Spencer County,12,14,1082,539,543
Kentucky,Spencer County,12,15,746,362,384
Kentucky,Spencer County,12,16,495,247,248
Kentucky,Spencer County,12,17,250,122,128
Kentucky,Spencer County,12,18,245,121,124
Kentucky,Taylor County,1,0,24512,11850,12662
Kentucky,Taylor County,1,1,1558,806,752
Kentucky,Taylor County,1,2,1478,747,731
Kentucky,Taylor County,1,3,1543,797,746
Kentucky,Taylor County,1,4,1814,917,897
Kentucky,Taylor County,1,5,1916,955,961
Kentucky,Taylor County,1,6,1507,763,744
Kentucky,Taylor County,1,7,1288,653,635
Kentucky,Taylor County,1,8,1337,668,669
Kentucky,Taylor County,1,9,1486,696,790
Kentucky,Taylor County,1,10,1796,859,937
Kentucky,Taylor County,1,11,1781,828,953
Kentucky,Taylor County,1,12,1551,748,803
Kentucky,Taylor County,1,13,1534,746,788
Kentucky,Taylor County,1,14,1163,546,617
Kentucky,Taylor County,1,15,1007,461,546
Kentucky,Taylor County,1,16,779,331,448
Kentucky,Taylor County,1,17,554,203,351
Kentucky,Taylor County,1,18,420,126,294
Kentucky,Taylor County,2,0,24511,11849,12662
Kentucky,Taylor County,2,1,1556,804,752
Kentucky,Taylor County,2,2,1476,746,730
Kentucky,Taylor County,2,3,1544,798,746
Kentucky,Taylor County,2,4,1815,918,897
Kentucky,Taylor County,2,5,1917,955,962
Kentucky,Taylor County,2,6,1509,764,745
Kentucky,Taylor County,2,7,1286,653,633
Kentucky,Taylor County,2,8,1336,667,669
Kentucky,Taylor County,2,9,1486,695,791
Kentucky,Taylor County,2,10,1797,860,937
Kentucky,Taylor County,2,11,1780,827,953
Kentucky,Taylor County,2,12,1553,749,804
Kentucky,Taylor County,2,13,1532,746,786
Kentucky,Taylor County,2,14,1162,545,617
Kentucky,Taylor County,2,15,1008,461,547
Kentucky,Taylor County,2,16,780,332,448
Kentucky,Taylor County,2,17,555,203,352
Kentucky,Taylor County,2,18,419,126,293
Kentucky,Taylor County,3,0,24673,11907,12766
Kentucky,Taylor County,3,1,1567,802,765
Kentucky,Taylor County,3,2,1483,746,737
Kentucky,Taylor County,3,3,1539,799,740
Kentucky,Taylor County,3,4,1875,946,929
Kentucky,Taylor County,3,5,1976,987,989
Kentucky,Taylor County,3,6,1530,769,761
Kentucky,Taylor County,3,7,1308,664,644
Kentucky,Taylor County,3,8,1317,659,658
Kentucky,Taylor County,3,9,1485,695,790
Kentucky,Taylor County,3,10,1789,856,933
Kentucky,Taylor County,3,11,1781,822,959
Kentucky,Taylor County,3,12,1568,758,810
Kentucky,Taylor County,3,13,1534,742,792
Kentucky,Taylor County,3,14,1160,539,621
Kentucky,Taylor County,3,15,1007,462,545
Kentucky,Taylor County,3,16,777,330,447
Kentucky,Taylor County,3,17,553,205,348
Kentucky,Taylor County,3,18,424,126,298
Kentucky,Taylor County,4,0,24991,12077,12914
Kentucky,Taylor County,4,1,1567,795,772
Kentucky,Taylor County,4,2,1498,750,748
Kentucky,Taylor County,4,3,1529,784,745
Kentucky,Taylor County,4,4,1933,978,955
Kentucky,Taylor County,4,5,2081,1050,1031
Kentucky,Taylor County,4,6,1559,799,760
Kentucky,Taylor County,4,7,1415,722,693
Kentucky,Taylor County,4,8,1228,619,609
Kentucky,Taylor County,4,9,1506,717,789
Kentucky,Taylor County,4,10,1690,810,880
Kentucky,Taylor County,4,11,1810,829,981
Kentucky,Taylor County,4,12,1629,791,838
Kentucky,Taylor County,4,13,1591,759,832
Kentucky,Taylor County,4,14,1162,543,619
Kentucky,Taylor County,4,15,1022,465,557
Kentucky,Taylor County,4,16,796,342,454
Kentucky,Taylor County,4,17,539,198,341
Kentucky,Taylor County,4,18,436,126,310
Kentucky,Taylor County,5,0,25069,12131,12938
Kentucky,Taylor County,5,1,1578,794,784
Kentucky,Taylor County,5,2,1500,742,758
Kentucky,Taylor County,5,3,1508,761,747
Kentucky,Taylor County,5,4,1937,1001,936
Kentucky,Taylor County,5,5,2112,1055,1057
Kentucky,Taylor County,5,6,1537,791,746
Kentucky,Taylor County,5,7,1415,733,682
Kentucky,Taylor County,5,8,1221,613,608
Kentucky,Taylor County,5,9,1476,696,780
Kentucky,Taylor County,5,10,1599,777,822
Kentucky,Taylor County,5,11,1856,864,992
Kentucky,Taylor County,5,12,1686,802,884
Kentucky,Taylor County,5,13,1529,726,803
Kentucky,Taylor County,5,14,1281,607,674
Kentucky,Taylor County,5,15,1034,474,560
Kentucky,Taylor County,5,16,800,354,446
Kentucky,Taylor County,5,17,546,196,350
Kentucky,Taylor County,5,18,454,145,309
Kentucky,Taylor County,6,0,25159,12246,12913
Kentucky,Taylor County,6,1,1598,833,765
Kentucky,Taylor County,6,2,1508,775,733
Kentucky,Taylor County,6,3,1532,756,776
Kentucky,Taylor County,6,4,1970,1018,952
Kentucky,Taylor County,6,5,2064,1059,1005
Kentucky,Taylor County,6,6,1566,780,786
Kentucky,Taylor County,6,7,1452,772,680
Kentucky,Taylor County,6,8,1237,614,623
Kentucky,Taylor County,6,9,1428,675,753
Kentucky,Taylor County,6,10,1574,766,808
Kentucky,Taylor County,6,11,1792,849,943
Kentucky,Taylor County,6,12,1705,787,918
Kentucky,Taylor County,6,13,1525,729,796
Kentucky,Taylor County,6,14,1327,639,688
Kentucky,Taylor County,6,15,1054,482,572
Kentucky,Taylor County,6,16,807,344,463
Kentucky,Taylor County,6,17,537,207,330
Kentucky,Taylor County,6,18,483,161,322
Kentucky,Taylor County,7,0,25360,12377,12983
Kentucky,Taylor County,7,1,1621,837,784
Kentucky,Taylor County,7,2,1528,793,735
Kentucky,Taylor County,7,3,1499,747,752
Kentucky,Taylor County,7,4,2047,1050,997
Kentucky,Taylor County,7,5,2086,1066,1020
Kentucky,Taylor County,7,6,1580,809,771
Kentucky,Taylor County,7,7,1449,763,686
Kentucky,Taylor County,7,8,1281,644,637
Kentucky,Taylor County,7,9,1350,656,694
Kentucky,Taylor County,7,10,1558,754,804
Kentucky,Taylor County,7,11,1760,843,917
Kentucky,Taylor County,7,12,1735,795,940
Kentucky,Taylor County,7,13,1542,730,812
Kentucky,Taylor County,7,14,1390,669,721
Kentucky,Taylor County,7,15,1058,490,568
Kentucky,Taylor County,7,16,819,349,470
Kentucky,Taylor County,7,17,563,227,336
Kentucky,Taylor County,7,18,494,155,339
Kentucky,Taylor County,8,0,25586,12450,13136
Kentucky,Taylor County,8,1,1649,831,818
Kentucky,Taylor County,8,2,1538,780,758
Kentucky,Taylor County,8,3,1516,765,751
Kentucky,Taylor County,8,4,2048,1042,1006
Kentucky,Taylor County,8,5,2057,1059,998
Kentucky,Taylor County,8,6,1641,827,814
Kentucky,Taylor County,8,7,1480,776,704
Kentucky,Taylor County,8,8,1355,680,675
Kentucky,Taylor County,8,9,1318,657,661
Kentucky,Taylor County,8,10,1523,731,792
Kentucky,Taylor County,8,11,1739,844,895
Kentucky,Taylor County,8,12,1768,804,964
Kentucky,Taylor County,8,13,1545,745,800
Kentucky,Taylor County,8,14,1452,680,772
Kentucky,Taylor County,8,15,1041,479,562
Kentucky,Taylor County,8,16,834,375,459
Kentucky,Taylor County,8,17,580,227,353
Kentucky,Taylor County,8,18,502,148,354
Kentucky,Taylor County,9,0,25441,12383,13058
Kentucky,Taylor County,9,1,1631,819,812
Kentucky,Taylor County,9,2,1599,822,777
Kentucky,Taylor County,9,3,1485,721,764
Kentucky,Taylor County,9,4,1990,998,992
Kentucky,Taylor County,9,5,1996,1040,956
Kentucky,Taylor County,9,6,1669,843,826
Kentucky,Taylor County,9,7,1459,756,703
Kentucky,Taylor County,9,8,1412,717,695
Kentucky,Taylor County,9,9,1244,629,615
Kentucky,Taylor County,9,10,1489,726,763
Kentucky,Taylor County,9,11,1646,805,841
Kentucky,Taylor County,9,12,1782,806,976
Kentucky,Taylor County,9,13,1574,764,810
Kentucky,Taylor County,9,14,1472,695,777
Kentucky,Taylor County,9,15,1070,485,585
Kentucky,Taylor County,9,16,826,371,455
Kentucky,Taylor County,9,17,597,241,356
Kentucky,Taylor County,9,18,500,145,355
Kentucky,Taylor County,10,0,25544,12510,13034
Kentucky,Taylor County,10,1,1671,848,823
Kentucky,Taylor County,10,2,1571,818,753
Kentucky,Taylor County,10,3,1490,734,756
Kentucky,Taylor County,10,4,2028,1026,1002
Kentucky,Taylor County,10,5,1978,1047,931
Kentucky,Taylor County,10,6,1669,854,815
Kentucky,Taylor County,10,7,1472,765,707
Kentucky,Taylor County,10,8,1424,714,710
Kentucky,Taylor County,10,9,1255,643,612
Kentucky,Taylor County,10,10,1448,709,739
Kentucky,Taylor County,10,11,1582,777,805
Kentucky,Taylor County,10,12,1798,817,981
Kentucky,Taylor County,10,13,1630,778,852
Kentucky,Taylor County,10,14,1416,666,750
Kentucky,Taylor County,10,15,1146,530,616
Kentucky,Taylor County,10,16,857,384,473
Kentucky,Taylor County,10,17,599,246,353
Kentucky,Taylor County,10,18,510,154,356
Kentucky,Taylor County,11,0,25514,12476,13038
Kentucky,Taylor County,11,1,1628,827,801
Kentucky,Taylor County,11,2,1574,821,753
Kentucky,Taylor County,11,3,1513,779,734
Kentucky,Taylor County,11,4,1966,966,1000
Kentucky,Taylor County,11,5,1941,994,947
Kentucky,Taylor County,11,6,1670,876,794
Kentucky,Taylor County,11,7,1506,772,734
Kentucky,Taylor County,11,8,1447,747,700
Kentucky,Taylor County,11,9,1253,621,632
Kentucky,Taylor County,11,10,1381,665,716
Kentucky,Taylor County,11,11,1575,766,809
Kentucky,Taylor County,11,12,1752,820,932
Kentucky,Taylor County,11,13,1686,782,904
Kentucky,Taylor County,11,14,1409,662,747
Kentucky,Taylor County,11,15,1177,546,631
Kentucky,Taylor County,11,16,892,414,478
Kentucky,Taylor County,11,17,631,243,388
Kentucky,Taylor County,11,18,513,175,338
Kentucky,Taylor County,12,0,25769,12601,13168
Kentucky,Taylor County,12,1,1653,857,796
Kentucky,Taylor County,12,2,1635,820,815
Kentucky,Taylor County,12,3,1559,819,740
Kentucky,Taylor County,12,4,1931,937,994
Kentucky,Taylor County,12,5,1992,1018,974
Kentucky,Taylor County,12,6,1633,859,774
Kentucky,Taylor County,12,7,1573,809,764
Kentucky,Taylor County,12,8,1482,758,724
Kentucky,Taylor County,12,9,1300,643,657
Kentucky,Taylor County,12,10,1341,665,676
Kentucky,Taylor County,12,11,1521,731,790
Kentucky,Taylor County,12,12,1747,832,915
Kentucky,Taylor County,12,13,1686,774,912
Kentucky,Taylor County,12,14,1425,653,772
Kentucky,Taylor County,12,15,1223,576,647
Kentucky,Taylor County,12,16,878,413,465
Kentucky,Taylor County,12,17,664,263,401
Kentucky,Taylor County,12,18,526,174,352
Kentucky,Todd County,1,0,12460,6152,6308
Kentucky,Todd County,1,1,984,508,476
Kentucky,Todd County,1,2,963,506,457
Kentucky,Todd County,1,3,926,481,445
Kentucky,Todd County,1,4,807,407,400
Kentucky,Todd County,1,5,787,385,402
Kentucky,Todd County,1,6,711,372,339
Kentucky,Todd County,1,7,757,373,384
Kentucky,Todd County,1,8,775,371,404
Kentucky,Todd County,1,9,811,403,408
Kentucky,Todd County,1,10,914,463,451
Kentucky,Todd County,1,11,868,428,440
Kentucky,Todd County,1,12,718,348,370
Kentucky,Todd County,1,13,667,326,341
Kentucky,Todd County,1,14,579,287,292
Kentucky,Todd County,1,15,430,208,222
Kentucky,Todd County,1,16,334,140,194
Kentucky,Todd County,1,17,232,86,146
Kentucky,Todd County,1,18,197,60,137
Kentucky,Todd County,2,0,12463,6154,6309
Kentucky,Todd County,2,1,984,508,476
Kentucky,Todd County,2,2,963,506,457
Kentucky,Todd County,2,3,926,481,445
Kentucky,Todd County,2,4,807,407,400
Kentucky,Todd County,2,5,787,385,402
Kentucky,Todd County,2,6,711,372,339
Kentucky,Todd County,2,7,757,373,384
Kentucky,Todd County,2,8,775,371,404
Kentucky,Todd County,2,9,812,403,409
Kentucky,Todd County,2,10,915,464,451
Kentucky,Todd County,2,11,868,428,440
Kentucky,Todd County,2,12,718,348,370
Kentucky,Todd County,2,13,667,326,341
Kentucky,Todd County,2,14,580,288,292
Kentucky,Todd County,2,15,430,208,222
Kentucky,Todd County,2,16,334,140,194
Kentucky,Todd County,2,17,232,86,146
Kentucky,Todd County,2,18,197,60,137
Kentucky,Todd County,3,0,12432,6138,6294
Kentucky,Todd County,3,1,970,500,470
Kentucky,Todd County,3,2,965,508,457
Kentucky,Todd County,3,3,930,485,445
Kentucky,Todd County,3,4,795,403,392
Kentucky,Todd County,3,5,793,388,405
Kentucky,Todd County,3,6,722,377,345
Kentucky,Todd County,3,7,753,369,384
Kentucky,Todd County,3,8,763,364,399
Kentucky,Todd County,3,9,807,400,407
Kentucky,Todd County,3,10,915,463,452
Kentucky,Todd County,3,11,866,422,444
Kentucky,Todd County,3,12,722,356,366
Kentucky,Todd County,3,13,662,323,339
Kentucky,Todd County,3,14,576,282,294
Kentucky,Todd County,3,15,428,208,220
Kentucky,Todd County,3,16,334,141,193
Kentucky,Todd County,3,17,237,91,146
Kentucky,Todd County,3,18,194,58,136
Kentucky,Todd County,4,0,12428,6127,6301
Kentucky,Todd County,4,1,918,467,451
Kentucky,Todd County,4,2,973,508,465
Kentucky,Todd County,4,3,977,507,470
Kentucky,Todd County,4,4,804,400,404
Kentucky,Todd County,4,5,763,365,398
Kentucky,Todd County,4,6,738,387,351
Kentucky,Todd County,4,7,747,364,383
Kentucky,Todd County,4,8,738,352,386
Kentucky,Todd County,4,9,807,407,400
Kentucky,Todd County,4,10,894,456,438
Kentucky,Todd County,4,11,857,414,443
Kentucky,Todd County,4,12,743,385,358
Kentucky,Todd County,4,13,671,319,352
Kentucky,Todd County,4,14,590,288,302
Kentucky,Todd County,4,15,422,204,218
Kentucky,Todd County,4,16,332,142,190
Kentucky,Todd County,4,17,250,101,149
Kentucky,Todd County,4,18,204,61,143
Kentucky,Todd County,5,0,12618,6254,6364
Kentucky,Todd County,5,1,944,502,442
Kentucky,Todd County,5,2,1002,496,506
Kentucky,Todd County,5,3,985,509,476
Kentucky,Todd County,5,4,841,437,404
Kentucky,Todd County,5,5,769,366,403
Kentucky,Todd County,5,6,772,410,362
Kentucky,Todd County,5,7,734,346,388
Kentucky,Todd County,5,8,747,372,375
Kentucky,Todd County,5,9,806,412,394
Kentucky,Todd County,5,10,903,466,437
Kentucky,Todd County,5,11,851,405,446
Kentucky,Todd County,5,12,769,400,369
Kentucky,Todd County,5,13,659,307,352
Kentucky,Todd County,5,14,616,308,308
Kentucky,Todd County,5,15,418,196,222
Kentucky,Todd County,5,16,340,159,181
Kentucky,Todd County,5,17,244,94,150
Kentucky,Todd County,5,18,218,69,149
Kentucky,Todd County,6,0,12475,6176,6299
Kentucky,Todd County,6,1,908,465,443
Kentucky,Todd County,6,2,979,498,481
Kentucky,Todd County,6,3,969,489,480
Kentucky,Todd County,6,4,822,428,394
Kentucky,Todd County,6,5,778,382,396
Kentucky,Todd County,6,6,759,381,378
Kentucky,Todd County,6,7,702,337,365
Kentucky,Todd County,6,8,714,352,362
Kentucky,Todd County,6,9,816,421,395
Kentucky,Todd County,6,10,857,437,420
Kentucky,Todd County,6,11,853,427,426
Kentucky,Todd County,6,12,789,396,393
Kentucky,Todd County,6,13,670,315,355
Kentucky,Todd County,6,14,628,317,311
Kentucky,Todd County,6,15,434,202,232
Kentucky,Todd County,6,16,335,161,174
Kentucky,Todd County,6,17,246,103,143
Kentucky,Todd County,6,18,216,65,151
Kentucky,Todd County,7,0,12429,6153,6276
Kentucky,Todd County,7,1,895,448,447
Kentucky,Todd County,7,2,988,501,487
Kentucky,Todd County,7,3,933,479,454
Kentucky,Todd County,7,4,824,426,398
Kentucky,Todd County,7,5,767,375,392
Kentucky,Todd County,7,6,783,380,403
Kentucky,Todd County,7,7,672,341,331
Kentucky,Todd County,7,8,717,353,364
Kentucky,Todd County,7,9,794,411,383
Kentucky,Todd County,7,10,810,414,396
Kentucky,Todd County,7,11,862,420,442
Kentucky,Todd County,7,12,808,409,399
Kentucky,Todd County,7,13,674,328,346
Kentucky,Todd County,7,14,617,303,314
Kentucky,Todd County,7,15,487,239,248
Kentucky,Todd County,7,16,323,154,169
Kentucky,Todd County,7,17,251,104,147
Kentucky,Todd County,7,18,224,68,156
Kentucky,Todd County,8,0,12447,6177,6270
Kentucky,Todd County,8,1,915,451,464
Kentucky,Todd County,8,2,947,480,467
Kentucky,Todd County,8,3,939,486,453
Kentucky,Todd County,8,4,833,433,400
Kentucky,Todd County,8,5,704,358,346
Kentucky,Todd County,8,6,778,371,407
Kentucky,Todd County,8,7,685,355,330
Kentucky,Todd County,8,8,770,378,392
Kentucky,Todd County,8,9,754,380,374
Kentucky,Todd County,8,10,772,392,380
Kentucky,Todd County,8,11,878,443,435
Kentucky,Todd County,8,12,825,409,416
Kentucky,Todd County,8,13,695,345,350
Kentucky,Todd County,8,14,630,301,329
Kentucky,Todd County,8,15,498,253,245
Kentucky,Todd County,8,16,339,161,178
Kentucky,Todd County,8,17,242,96,146
Kentucky,Todd County,8,18,243,85,158
Kentucky,Todd County,9,0,12357,6113,6244
Kentucky,Todd County,9,1,927,441,486
Kentucky,Todd County,9,2,889,453,436
Kentucky,Todd County,9,3,933,490,443
Kentucky,Todd County,9,4,866,455,411
Kentucky,Todd County,9,5,713,361,352
Kentucky,Todd County,9,6,765,352,413
Kentucky,Todd County,9,7,709,367,342
Kentucky,Todd County,9,8,710,343,367
Kentucky,Todd County,9,9,740,373,367
Kentucky,Todd County,9,10,773,394,379
Kentucky,Todd County,9,11,858,438,420
Kentucky,Todd County,9,12,833,407,426
Kentucky,Todd County,9,13,720,368,352
Kentucky,Todd County,9,14,624,291,333
Kentucky,Todd County,9,15,495,242,253
Kentucky,Todd County,9,16,322,153,169
Kentucky,Todd County,9,17,236,107,129
Kentucky,Todd County,9,18,244,78,166
Kentucky,Todd County,10,0,12177,6040,6137
Kentucky,Todd County,10,1,880,433,447
Kentucky,Todd County,10,2,848,438,410
Kentucky,Todd County,10,3,925,462,463
Kentucky,Todd County,10,4,869,447,422
Kentucky,Todd County,10,5,685,372,313
Kentucky,Todd County,10,6,742,359,383
Kentucky,Todd County,10,7,689,366,323
Kentucky,Todd County,10,8,727,342,385
Kentucky,Todd County,10,9,730,372,358
Kentucky,Todd County,10,10,755,375,380
Kentucky,Todd County,10,11,843,441,402
Kentucky,Todd County,10,12,813,387,426
Kentucky,Todd County,10,13,724,368,356
Kentucky,Todd County,10,14,630,292,338
Kentucky,Todd County,10,15,504,242,262
Kentucky,Todd County,10,16,336,155,181
Kentucky,Todd County,10,17,246,118,128
Kentucky,Todd County,10,18,231,71,160
Kentucky,Todd County,11,0,12306,6133,6173
Kentucky,Todd County,11,1,872,433,439
Kentucky,Todd County,11,2,889,453,436
Kentucky,Todd County,11,3,968,487,481
Kentucky,Todd County,11,4,868,451,417
Kentucky,Todd County,11,5,697,370,327
Kentucky,Todd County,11,6,748,377,371
Kentucky,Todd County,11,7,698,347,351
Kentucky,Todd County,11,8,708,357,351
Kentucky,Todd County,11,9,725,364,361
Kentucky,Todd County,11,10,760,385,375
Kentucky,Todd County,11,11,801,408,393
Kentucky,Todd County,11,12,836,415,421
Kentucky,Todd County,11,13,763,388,375
Kentucky,Todd County,11,14,624,288,336
Kentucky,Todd County,11,15,517,256,261
Kentucky,Todd County,11,16,361,169,192
Kentucky,Todd County,11,17,253,120,133
Kentucky,Todd County,11,18,218,65,153
Kentucky,Todd County,12,0,12294,6117,6177
Kentucky,Todd County,12,1,912,454,458
Kentucky,Todd County,12,2,855,422,433
Kentucky,Todd County,12,3,953,488,465
Kentucky,Todd County,12,4,835,435,400
Kentucky,Todd County,12,5,734,383,351
Kentucky,Todd County,12,6,725,384,341
Kentucky,Todd County,12,7,721,338,383
Kentucky,Todd County,12,8,684,355,329
Kentucky,Todd County,12,9,717,359,358
Kentucky,Todd County,12,10,766,385,381
Kentucky,Todd County,12,11,769,384,385
Kentucky,Todd County,12,12,852,419,433
Kentucky,Todd County,12,13,776,406,370
Kentucky,Todd County,12,14,616,284,332
Kentucky,Todd County,12,15,517,250,267
Kentucky,Todd County,12,16,409,197,212
Kentucky,Todd County,12,17,243,112,131
Kentucky,Todd County,12,18,210,62,148
Kentucky,Trigg County,1,0,14339,7039,7300
Kentucky,Trigg County,1,1,819,370,449
Kentucky,Trigg County,1,2,908,447,461
Kentucky,Trigg County,1,3,925,478,447
Kentucky,Trigg County,1,4,927,502,425
Kentucky,Trigg County,1,5,636,332,304
Kentucky,Trigg County,1,6,646,303,343
Kentucky,Trigg County,1,7,659,318,341
Kentucky,Trigg County,1,8,858,421,437
Kentucky,Trigg County,1,9,960,455,505
Kentucky,Trigg County,1,10,1054,524,530
Kentucky,Trigg County,1,11,1031,488,543
Kentucky,Trigg County,1,12,1087,530,557
Kentucky,Trigg County,1,13,1102,531,571
Kentucky,Trigg County,1,14,956,473,483
Kentucky,Trigg County,1,15,738,404,334
Kentucky,Trigg County,1,16,483,231,252
Kentucky,Trigg County,1,17,306,141,165
Kentucky,Trigg County,1,18,244,91,153
Kentucky,Trigg County,2,0,14327,7035,7292
Kentucky,Trigg County,2,1,817,369,448
Kentucky,Trigg County,2,2,907,447,460
Kentucky,Trigg County,2,3,923,478,445
Kentucky,Trigg County,2,4,927,502,425
Kentucky,Trigg County,2,5,636,332,304
Kentucky,Trigg County,2,6,646,303,343
Kentucky,Trigg County,2,7,658,317,341
Kentucky,Trigg County,2,8,857,421,436
Kentucky,Trigg County,2,9,960,455,505
Kentucky,Trigg County,2,10,1053,523,530
Kentucky,Trigg County,2,11,1029,488,541
Kentucky,Trigg County,2,12,1087,530,557
Kentucky,Trigg County,2,13,1102,531,571
Kentucky,Trigg County,2,14,956,473,483
Kentucky,Trigg County,2,15,737,403,334
Kentucky,Trigg County,2,16,482,231,251
Kentucky,Trigg County,2,17,306,141,165
Kentucky,Trigg County,2,18,244,91,153
Kentucky,Trigg County,3,0,14322,7031,7291
Kentucky,Trigg County,3,1,810,365,445
Kentucky,Trigg County,3,2,906,447,459
Kentucky,Trigg County,3,3,932,478,454
Kentucky,Trigg County,3,4,914,492,422
Kentucky,Trigg County,3,5,649,340,309
Kentucky,Trigg County,3,6,656,309,347
Kentucky,Trigg County,3,7,659,314,345
Kentucky,Trigg County,3,8,844,415,429
Kentucky,Trigg County,3,9,960,458,502
Kentucky,Trigg County,3,10,1056,524,532
Kentucky,Trigg County,3,11,1027,489,538
Kentucky,Trigg County,3,12,1090,533,557
Kentucky,Trigg County,3,13,1094,526,568
Kentucky,Trigg County,3,14,955,472,483
Kentucky,Trigg County,3,15,747,409,338
Kentucky,Trigg County,3,16,482,232,250
Kentucky,Trigg County,3,17,300,138,162
Kentucky,Trigg County,3,18,241,90,151
Kentucky,Trigg County,4,0,14214,6997,7217
Kentucky,Trigg County,4,1,769,353,416
Kentucky,Trigg County,4,2,872,439,433
Kentucky,Trigg County,4,3,912,462,450
Kentucky,Trigg County,4,4,878,460,418
Kentucky,Trigg County,4,5,680,360,320
Kentucky,Trigg County,4,6,658,330,328
Kentucky,Trigg County,4,7,657,312,345
Kentucky,Trigg County,4,8,798,392,406
Kentucky,Trigg County,4,9,939,453,486
Kentucky,Trigg County,4,10,1047,510,537
Kentucky,Trigg County,4,11,1038,502,536
Kentucky,Trigg County,4,12,1104,541,563
Kentucky,Trigg County,4,13,1104,538,566
Kentucky,Trigg County,4,14,952,466,486
Kentucky,Trigg County,4,15,763,415,348
Kentucky,Trigg County,4,16,500,241,259
Kentucky,Trigg County,4,17,297,134,163
Kentucky,Trigg County,4,18,246,89,157
Kentucky,Trigg County,5,0,14410,7057,7353
Kentucky,Trigg County,5,1,790,375,415
Kentucky,Trigg County,5,2,887,440,447
Kentucky,Trigg County,5,3,938,463,475
Kentucky,Trigg County,5,4,899,461,438
Kentucky,Trigg County,5,5,688,351,337
Kentucky,Trigg County,5,6,677,327,350
Kentucky,Trigg County,5,7,652,310,342
Kentucky,Trigg County,5,8,796,394,402
Kentucky,Trigg County,5,9,956,475,481
Kentucky,Trigg County,5,10,1031,497,534
Kentucky,Trigg County,5,11,1055,515,540
Kentucky,Trigg County,5,12,1066,518,548
Kentucky,Trigg County,5,13,1110,533,577
Kentucky,Trigg County,5,14,1018,499,519
Kentucky,Trigg County,5,15,788,426,362
Kentucky,Trigg County,5,16,500,234,266
Kentucky,Trigg County,5,17,302,144,158
Kentucky,Trigg County,5,18,257,95,162
Kentucky,Trigg County,6,0,14300,7042,7258
Kentucky,Trigg County,6,1,759,378,381
Kentucky,Trigg County,6,2,876,425,451
Kentucky,Trigg County,6,3,950,468,482
Kentucky,Trigg County,6,4,854,444,410
Kentucky,Trigg County,6,5,702,371,331
Kentucky,Trigg County,6,6,654,322,332
Kentucky,Trigg County,6,7,641,307,334
Kentucky,Trigg County,6,8,763,374,389
Kentucky,Trigg County,6,9,931,463,468
Kentucky,Trigg County,6,10,1029,489,540
Kentucky,Trigg County,6,11,1083,549,534
Kentucky,Trigg County,6,12,1075,501,574
Kentucky,Trigg County,6,13,1066,523,543
Kentucky,Trigg County,6,14,1027,510,517
Kentucky,Trigg County,6,15,816,416,400
Kentucky,Trigg County,6,16,512,265,247
Kentucky,Trigg County,6,17,313,145,168
Kentucky,Trigg County,6,18,249,92,157
Kentucky,Trigg County,7,0,14131,6899,7232
Kentucky,Trigg County,7,1,742,367,375
Kentucky,Trigg County,7,2,822,385,437
Kentucky,Trigg County,7,3,960,480,480
Kentucky,Trigg County,7,4,832,428,404
Kentucky,Trigg County,7,5,712,374,338
Kentucky,Trigg County,7,6,622,296,326
Kentucky,Trigg County,7,7,681,323,358
Kentucky,Trigg County,7,8,694,325,369
Kentucky,Trigg County,7,9,917,445,472
Kentucky,Trigg County,7,10,965,467,498
Kentucky,Trigg County,7,11,1077,530,547
Kentucky,Trigg County,7,12,1067,499,568
Kentucky,Trigg County,7,13,1051,512,539
Kentucky,Trigg County,7,14,1052,527,525
Kentucky,Trigg County,7,15,810,394,416
Kentucky,Trigg County,7,16,556,310,246
Kentucky,Trigg County,7,17,322,141,181
Kentucky,Trigg County,7,18,249,96,153
Kentucky,Trigg County,8,0,14218,6988,7230
Kentucky,Trigg County,8,1,753,377,376
Kentucky,Trigg County,8,2,827,385,442
Kentucky,Trigg County,8,3,917,457,460
Kentucky,Trigg County,8,4,848,451,397
Kentucky,Trigg County,8,5,712,382,330
Kentucky,Trigg County,8,6,651,325,326
Kentucky,Trigg County,8,7,681,320,361
Kentucky,Trigg County,8,8,715,338,377
Kentucky,Trigg County,8,9,850,417,433
Kentucky,Trigg County,8,10,966,458,508
Kentucky,Trigg County,8,11,1068,524,544
Kentucky,Trigg County,8,12,1064,515,549
Kentucky,Trigg County,8,13,1103,536,567
Kentucky,Trigg County,8,14,1056,514,542
Kentucky,Trigg County,8,15,824,409,415
Kentucky,Trigg County,8,16,595,322,273
Kentucky,Trigg County,8,17,349,163,186
Kentucky,Trigg County,8,18,239,95,144
Kentucky,Trigg County,9,0,14302,7051,7251
Kentucky,Trigg County,9,1,789,419,370
Kentucky,Trigg County,9,2,826,384,442
Kentucky,Trigg County,9,3,907,457,450
Kentucky,Trigg County,9,4,851,439,412
Kentucky,Trigg County,9,5,676,363,313
Kentucky,Trigg County,9,6,726,374,352
Kentucky,Trigg County,9,7,673,313,360
Kentucky,Trigg County,9,8,709,331,378
Kentucky,Trigg County,9,9,817,410,407
Kentucky,Trigg County,9,10,946,450,496
Kentucky,Trigg County,9,11,1063,522,541
Kentucky,Trigg County,9,12,1088,524,564
Kentucky,Trigg County,9,13,1103,535,568
Kentucky,Trigg County,9,14,1071,523,548
Kentucky,Trigg County,9,15,845,413,432
Kentucky,Trigg County,9,16,612,329,283
Kentucky,Trigg County,9,17,361,176,185
Kentucky,Trigg County,9,18,239,89,150
Kentucky,Trigg County,10,0,14418,7134,7284
Kentucky,Trigg County,10,1,797,427,370
Kentucky,Trigg County,10,2,858,405,453
Kentucky,Trigg County,10,3,893,441,452
Kentucky,Trigg County,10,4,848,451,397
Kentucky,Trigg County,10,5,654,350,304
Kentucky,Trigg County,10,6,741,379,362
Kentucky,Trigg County,10,7,696,330,366
Kentucky,Trigg County,10,8,719,342,377
Kentucky,Trigg County,10,9,787,396,391
Kentucky,Trigg County,10,10,942,460,482
Kentucky,Trigg County,10,11,1037,501,536
Kentucky,Trigg County,10,12,1141,550,591
Kentucky,Trigg County,10,13,1090,526,564
Kentucky,Trigg County,10,14,1066,515,551
Kentucky,Trigg County,10,15,877,439,438
Kentucky,Trigg County,10,16,643,351,292
Kentucky,Trigg County,10,17,368,168,200
Kentucky,Trigg County,10,18,261,103,158
Kentucky,Trigg County,11,0,14658,7291,7367
Kentucky,Trigg County,11,1,792,437,355
Kentucky,Trigg County,11,2,870,444,426
Kentucky,Trigg County,11,3,947,464,483
Kentucky,Trigg County,11,4,881,451,430
Kentucky,Trigg County,11,5,664,358,306
Kentucky,Trigg County,11,6,764,400,364
Kentucky,Trigg County,11,7,702,336,366
Kentucky,Trigg County,11,8,738,345,393
Kentucky,Trigg County,11,9,783,393,390
Kentucky,Trigg County,11,10,920,456,464
Kentucky,Trigg County,11,11,1040,495,545
Kentucky,Trigg County,11,12,1136,562,574
Kentucky,Trigg County,11,13,1151,538,613
Kentucky,Trigg County,11,14,1031,507,524
Kentucky,Trigg County,11,15,912,450,462
Kentucky,Trigg County,11,16,651,337,314
Kentucky,Trigg County,11,17,397,208,189
Kentucky,Trigg County,11,18,279,110,169
Kentucky,Trigg County,12,0,14651,7288,7363
Kentucky,Trigg County,12,1,757,415,342
Kentucky,Trigg County,12,2,854,446,408
Kentucky,Trigg County,12,3,920,443,477
Kentucky,Trigg County,12,4,879,454,425
Kentucky,Trigg County,12,5,683,346,337
Kentucky,Trigg County,12,6,747,414,333
Kentucky,Trigg County,12,7,690,336,354
Kentucky,Trigg County,12,8,749,352,397
Kentucky,Trigg County,12,9,756,369,387
Kentucky,Trigg County,12,10,936,477,459
Kentucky,Trigg County,12,11,1001,474,527
Kentucky,Trigg County,12,12,1167,559,608
Kentucky,Trigg County,12,13,1118,526,592
Kentucky,Trigg County,12,14,1063,529,534
Kentucky,Trigg County,12,15,946,469,477
Kentucky,Trigg County,12,16,654,319,335
Kentucky,Trigg County,12,17,430,240,190
Kentucky,Trigg County,12,18,301,120,181
Kentucky,Trimble County,1,0,8809,4483,4326
Kentucky,Trimble County,1,1,552,285,267
Kentucky,Trimble County,1,2,591,327,264
Kentucky,Trimble County,1,3,655,341,314
Kentucky,Trimble County,1,4,592,308,284
Kentucky,Trimble County,1,5,473,257,216
Kentucky,Trimble County,1,6,472,225,247
Kentucky,Trimble County,1,7,519,276,243
Kentucky,Trimble County,1,8,632,312,320
Kentucky,Trimble County,1,9,645,345,300
Kentucky,Trimble County,1,10,691,350,341
Kentucky,Trimble County,1,11,689,358,331
Kentucky,Trimble County,1,12,590,293,297
Kentucky,Trimble County,1,13,568,277,291
Kentucky,Trimble County,1,14,391,192,199
Kentucky,Trimble County,1,15,298,150,148
Kentucky,Trimble County,1,16,177,75,102
Kentucky,Trimble County,1,17,141,67,74
Kentucky,Trimble County,1,18,133,45,88
Kentucky,Trimble County,2,0,8809,4483,4326
Kentucky,Trimble County,2,1,552,285,267
Kentucky,Trimble County,2,2,591,327,264
Kentucky,Trimble County,2,3,655,341,314
Kentucky,Trimble County,2,4,592,308,284
Kentucky,Trimble County,2,5,473,257,216
Kentucky,Trimble County,2,6,472,225,247
Kentucky,Trimble County,2,7,519,276,243
Kentucky,Trimble County,2,8,632,312,320
Kentucky,Trimble County,2,9,645,345,300
Kentucky,Trimble County,2,10,691,350,341
Kentucky,Trimble County,2,11,689,358,331
Kentucky,Trimble County,2,12,590,293,297
Kentucky,Trimble County,2,13,568,277,291
Kentucky,Trimble County,2,14,391,192,199
Kentucky,Trimble County,2,15,298,150,148
Kentucky,Trimble County,2,16,177,75,102
Kentucky,Trimble County,2,17,141,67,74
Kentucky,Trimble County,2,18,133,45,88
Kentucky,Trimble County,3,0,8812,4479,4333
Kentucky,Trimble County,3,1,552,278,274
Kentucky,Trimble County,3,2,586,323,263
Kentucky,Trimble County,3,3,654,342,312
Kentucky,Trimble County,3,4,589,309,280
Kentucky,Trimble County,3,5,470,251,219
Kentucky,Trimble County,3,6,470,228,242
Kentucky,Trimble County,3,7,517,273,244
Kentucky,Trimble County,3,8,622,306,316
Kentucky,Trimble County,3,9,656,353,303
Kentucky,Trimble County,3,10,686,347,339
Kentucky,Trimble County,3,11,693,363,330
Kentucky,Trimble County,3,12,591,293,298
Kentucky,Trimble County,3,13,566,274,292
Kentucky,Trimble County,3,14,401,197,204
Kentucky,Trimble County,3,15,299,149,150
Kentucky,Trimble County,3,16,183,79,104
Kentucky,Trimble County,3,17,145,69,76
Kentucky,Trimble County,3,18,132,45,87
Kentucky,Trimble County,4,0,8814,4455,4359
Kentucky,Trimble County,4,1,528,263,265
Kentucky,Trimble County,4,2,592,324,268
Kentucky,Trimble County,4,3,637,324,313
Kentucky,Trimble County,4,4,603,323,280
Kentucky,Trimble County,4,5,479,247,232
Kentucky,Trimble County,4,6,470,235,235
Kentucky,Trimble County,4,7,510,267,243
Kentucky,Trimble County,4,8,571,271,300
Kentucky,Trimble County,4,9,682,366,316
Kentucky,Trimble County,4,10,672,335,337
Kentucky,Trimble County,4,11,703,379,324
Kentucky,Trimble County,4,12,576,279,297
Kentucky,Trimble County,4,13,570,271,299
Kentucky,Trimble County,4,14,436,222,214
Kentucky,Trimble County,4,15,302,143,159
Kentucky,Trimble County,4,16,207,94,113
Kentucky,Trimble County,4,17,146,70,76
Kentucky,Trimble County,4,18,130,42,88
Kentucky,Trimble County,5,0,8844,4466,4378
Kentucky,Trimble County,5,1,549,264,285
Kentucky,Trimble County,5,2,606,332,274
Kentucky,Trimble County,5,3,606,320,286
Kentucky,Trimble County,5,4,602,319,283
Kentucky,Trimble County,5,5,482,247,235
Kentucky,Trimble County,5,6,448,219,229
Kentucky,Trimble County,5,7,541,281,260
Kentucky,Trimble County,5,8,526,244,282
Kentucky,Trimble County,5,9,682,356,326
Kentucky,Trimble County,5,10,659,333,326
Kentucky,Trimble County,5,11,705,381,324
Kentucky,Trimble County,5,12,586,293,293
Kentucky,Trimble County,5,13,561,273,288
Kentucky,Trimble County,5,14,496,252,244
Kentucky,Trimble County,5,15,290,131,159
Kentucky,Trimble County,5,16,231,106,125
Kentucky,Trimble County,5,17,144,69,75
Kentucky,Trimble County,5,18,130,46,84
Kentucky,Trimble County,6,0,8805,4446,4359
Kentucky,Trimble County,6,1,514,264,250
Kentucky,Trimble County,6,2,585,305,280
Kentucky,Trimble County,6,3,599,323,276
Kentucky,Trimble County,6,4,585,296,289
Kentucky,Trimble County,6,5,502,264,238
Kentucky,Trimble County,6,6,436,220,216
Kentucky,Trimble County,6,7,539,260,279
Kentucky,Trimble County,6,8,514,256,258
Kentucky,Trimble County,6,9,666,342,324
Kentucky,Trimble County,6,10,628,317,311
Kentucky,Trimble County,6,11,701,373,328
Kentucky,Trimble County,6,12,632,323,309
Kentucky,Trimble County,6,13,543,269,274
Kentucky,Trimble County,6,14,530,270,260
Kentucky,Trimble County,6,15,311,134,177
Kentucky,Trimble County,6,16,238,109,129
Kentucky,Trimble County,6,17,138,63,75
Kentucky,Trimble County,6,18,144,58,86
Kentucky,Trimble County,7,0,8722,4402,4320
Kentucky,Trimble County,7,1,490,253,237
Kentucky,Trimble County,7,2,584,303,281
Kentucky,Trimble County,7,3,582,321,261
Kentucky,Trimble County,7,4,575,283,292
Kentucky,Trimble County,7,5,477,248,229
Kentucky,Trimble County,7,6,461,236,225
Kentucky,Trimble County,7,7,510,243,267
Kentucky,Trimble County,7,8,510,260,250
Kentucky,Trimble County,7,9,621,318,303
Kentucky,Trimble County,7,10,627,331,296
Kentucky,Trimble County,7,11,695,359,336
Kentucky,Trimble County,7,12,646,331,315
Kentucky,Trimble County,7,13,545,266,279
Kentucky,Trimble County,7,14,540,269,271
Kentucky,Trimble County,7,15,326,142,184
Kentucky,Trimble County,7,16,253,122,131
Kentucky,Trimble County,7,17,124,53,71
Kentucky,Trimble County,7,18,156,64,92
Kentucky,Trimble County,8,0,8733,4396,4337
Kentucky,Trimble County,8,1,504,259,245
Kentucky,Trimble County,8,2,558,289,269
Kentucky,Trimble County,8,3,573,305,268
Kentucky,Trimble County,8,4,565,285,280
Kentucky,Trimble County,8,5,506,269,237
Kentucky,Trimble County,8,6,479,238,241
Kentucky,Trimble County,8,7,489,227,262
Kentucky,Trimble County,8,8,499,258,241
Kentucky,Trimble County,8,9,599,290,309
Kentucky,Trimble County,8,10,662,357,305
Kentucky,Trimble County,8,11,677,341,336
Kentucky,Trimble County,8,12,662,344,318
Kentucky,Trimble County,8,13,542,267,275
Kentucky,Trimble County,8,14,534,264,270
Kentucky,Trimble County,8,15,343,160,183
Kentucky,Trimble County,8,16,265,124,141
Kentucky,Trimble County,8,17,121,50,71
Kentucky,Trimble County,8,18,155,69,86
Kentucky,Trimble County,9,0,8596,4339,4257
Kentucky,Trimble County,9,1,491,254,237
Kentucky,Trimble County,9,2,537,286,251
Kentucky,Trimble County,9,3,558,298,260
Kentucky,Trimble County,9,4,552,284,268
Kentucky,Trimble County,9,5,507,274,233
Kentucky,Trimble County,9,6,479,248,231
Kentucky,Trimble County,9,7,454,204,250
Kentucky,Trimble County,9,8,520,274,246
Kentucky,Trimble County,9,9,538,252,286
Kentucky,Trimble County,9,10,673,357,316
Kentucky,Trimble County,9,11,659,322,337
Kentucky,Trimble County,9,12,657,353,304
Kentucky,Trimble County,9,13,529,251,278
Kentucky,Trimble County,9,14,552,267,285
Kentucky,Trimble County,9,15,373,182,191
Kentucky,Trimble County,9,16,239,109,130
Kentucky,Trimble County,9,17,140,59,81
Kentucky,Trimble County,9,18,138,65,73
Kentucky,Trimble County,10,0,8521,4284,4237
Kentucky,Trimble County,10,1,487,245,242
Kentucky,Trimble County,10,2,511,265,246
Kentucky,Trimble County,10,3,542,288,254
Kentucky,Trimble County,10,4,510,273,237
Kentucky,Trimble County,10,5,512,262,250
Kentucky,Trimble County,10,6,506,259,247
Kentucky,Trimble County,10,7,420,200,220
Kentucky,Trimble County,10,8,538,282,256
Kentucky,Trimble County,10,9,512,239,273
Kentucky,Trimble County,10,10,660,337,323
Kentucky,Trimble County,10,11,646,322,324
Kentucky,Trimble County,10,12,663,355,308
Kentucky,Trimble County,10,13,538,260,278
Kentucky,Trimble County,10,14,511,248,263
Kentucky,Trimble County,10,15,437,218,219
Kentucky,Trimble County,10,16,239,101,138
Kentucky,Trimble County,10,17,152,69,83
Kentucky,Trimble County,10,18,137,61,76
Kentucky,Trimble County,11,0,8468,4239,4229
Kentucky,Trimble County,11,1,461,238,223
Kentucky,Trimble County,11,2,510,267,243
Kentucky,Trimble County,11,3,569,296,273
Kentucky,Trimble County,11,4,496,260,236
Kentucky,Trimble County,11,5,475,234,241
Kentucky,Trimble County,11,6,528,271,257
Kentucky,Trimble County,11,7,427,212,215
Kentucky,Trimble County,11,8,508,239,269
Kentucky,Trimble County,11,9,499,244,255
Kentucky,Trimble County,11,10,639,321,318
Kentucky,Trimble County,11,11,608,311,297
Kentucky,Trimble County,11,12,669,360,309
Kentucky,Trimble County,11,13,591,293,298
Kentucky,Trimble County,11,14,474,224,250
Kentucky,Trimble County,11,15,463,238,225
Kentucky,Trimble County,11,16,252,99,153
Kentucky,Trimble County,11,17,159,73,86
Kentucky,Trimble County,11,18,140,59,81
Kentucky,Trimble County,12,0,8471,4251,4220
Kentucky,Trimble County,12,1,458,253,205
Kentucky,Trimble County,12,2,500,260,240
Kentucky,Trimble County,12,3,558,285,273
Kentucky,Trimble County,12,4,495,265,230
Kentucky,Trimble County,12,5,460,221,239
Kentucky,Trimble County,12,6,550,278,272
Kentucky,Trimble County,12,7,450,230,220
Kentucky,Trimble County,12,8,501,233,268
Kentucky,Trimble County,12,9,482,239,243
Kentucky,Trimble County,12,10,602,294,308
Kentucky,Trimble County,12,11,627,337,290
Kentucky,Trimble County,12,12,687,351,336
Kentucky,Trimble County,12,13,590,296,294
Kentucky,Trimble County,12,14,474,224,250
Kentucky,Trimble County,12,15,459,235,224
Kentucky,Trimble County,12,16,272,115,157
Kentucky,Trimble County,12,17,170,79,91
Kentucky,Trimble County,12,18,136,56,80
Kentucky,Union County,1,0,15007,7670,7337
Kentucky,Union County,1,1,920,472,448
Kentucky,Union County,1,2,919,452,467
Kentucky,Union County,1,3,950,479,471
Kentucky,Union County,1,4,1432,864,568
Kentucky,Union County,1,5,1385,911,474
Kentucky,Union County,1,6,832,423,409
Kentucky,Union County,1,7,846,424,422
Kentucky,Union County,1,8,834,406,428
Kentucky,Union County,1,9,835,408,427
Kentucky,Union County,1,10,985,478,507
Kentucky,Union County,1,11,1086,510,576
Kentucky,Union County,1,12,1047,534,513
Kentucky,Union County,1,13,879,435,444
Kentucky,Union County,1,14,627,298,329
Kentucky,Union County,1,15,474,225,249
Kentucky,Union County,1,16,414,175,239
Kentucky,Union County,1,17,286,108,178
Kentucky,Union County,1,18,256,68,188
Kentucky,Union County,2,0,15007,7670,7337
Kentucky,Union County,2,1,920,472,448
Kentucky,Union County,2,2,919,452,467
Kentucky,Union County,2,3,950,479,471
Kentucky,Union County,2,4,1432,864,568
Kentucky,Union County,2,5,1385,911,474
Kentucky,Union County,2,6,832,423,409
Kentucky,Union County,2,7,846,424,422
Kentucky,Union County,2,8,834,406,428
Kentucky,Union County,2,9,835,408,427
Kentucky,Union County,2,10,985,478,507
Kentucky,Union County,2,11,1086,510,576
Kentucky,Union County,2,12,1047,534,513
Kentucky,Union County,2,13,879,435,444
Kentucky,Union County,2,14,627,298,329
Kentucky,Union County,2,15,474,225,249
Kentucky,Union County,2,16,414,175,239
Kentucky,Union County,2,17,286,108,178
Kentucky,Union County,2,18,256,68,188
Kentucky,Union County,3,0,15276,7897,7379
Kentucky,Union County,3,1,920,476,444
Kentucky,Union County,3,2,912,447,465
Kentucky,Union County,3,3,947,483,464
Kentucky,Union County,3,4,1529,943,586
Kentucky,Union County,3,5,1549,1040,509
Kentucky,Union County,3,6,841,433,408
Kentucky,Union County,3,7,850,424,426
Kentucky,Union County,3,8,841,409,432
Kentucky,Union County,3,9,836,412,424
Kentucky,Union County,3,10,979,474,505
Kentucky,Union County,3,11,1078,504,574
Kentucky,Union County,3,12,1044,532,512
Kentucky,Union County,3,13,898,447,451
Kentucky,Union County,3,14,626,301,325
Kentucky,Union County,3,15,479,224,255
Kentucky,Union County,3,16,412,175,237
Kentucky,Union County,3,17,278,105,173
Kentucky,Union County,3,18,257,68,189
Kentucky,Union County,4,0,15262,7901,7361
Kentucky,Union County,4,1,877,455,422
Kentucky,Union County,4,2,875,416,459
Kentucky,Union County,4,3,920,477,443
Kentucky,Union County,4,4,1497,927,570
Kentucky,Union County,4,5,1644,1099,545
Kentucky,Union County,4,6,808,427,381
Kentucky,Union County,4,7,868,425,443
Kentucky,Union County,4,8,839,397,442
Kentucky,Union County,4,9,851,428,423
Kentucky,Union County,4,10,966,468,498
Kentucky,Union County,4,11,1052,486,566
Kentucky,Union County,4,12,1047,538,509
Kentucky,Union County,4,13,969,481,488
Kentucky,Union County,4,14,626,305,321
Kentucky,Union County,4,15,485,220,265
Kentucky,Union County,4,16,405,175,230
Kentucky,Union County,4,17,273,105,168
Kentucky,Union County,4,18,260,72,188
Kentucky,Union County,5,0,15082,7781,7301
Kentucky,Union County,5,1,811,424,387
Kentucky,Union County,5,2,852,408,444
Kentucky,Union County,5,3,877,438,439
Kentucky,Union County,5,4,1465,920,545
Kentucky,Union County,5,5,1636,1082,554
Kentucky,Union County,5,6,792,424,368
Kentucky,Union County,5,7,879,413,466
Kentucky,Union County,5,8,824,404,420
Kentucky,Union County,5,9,847,419,428
Kentucky,Union County,5,10,927,449,478
Kentucky,Union County,5,11,1038,485,553
Kentucky,Union County,5,12,1033,521,512
Kentucky,Union County,5,13,960,474,486
Kentucky,Union County,5,14,723,353,370
Kentucky,Union County,5,15,469,212,257
Kentucky,Union County,5,16,403,171,232
Kentucky,Union County,5,17,282,111,171
Kentucky,Union County,5,18,264,73,191
Kentucky,Union County,6,0,15061,7781,7280
Kentucky,Union County,6,1,814,423,391
Kentucky,Union County,6,2,839,421,418
Kentucky,Union County,6,3,849,415,434
Kentucky,Union County,6,4,1434,902,532
Kentucky,Union County,6,5,1668,1088,580
Kentucky,Union County,6,6,791,437,354
Kentucky,Union County,6,7,877,412,465
Kentucky,Union County,6,8,825,414,411
Kentucky,Union County,6,9,846,418,428
Kentucky,Union County,6,10,908,433,475
Kentucky,Union County,6,11,981,472,509
Kentucky,Union County,6,12,1069,521,548
Kentucky,Union County,6,13,968,474,494
Kentucky,Union County,6,14,769,388,381
Kentucky,Union County,6,15,484,208,276
Kentucky,Union County,6,16,390,176,214
Kentucky,Union County,6,17,280,100,180
Kentucky,Union County,6,18,269,79,190
Kentucky,Union County,7,0,15072,7853,7219
Kentucky,Union County,7,1,807,422,385
Kentucky,Union County,7,2,792,400,392
Kentucky,Union County,7,3,842,403,439
Kentucky,Union County,7,4,1382,884,498
Kentucky,Union County,7,5,1687,1128,559
Kentucky,Union County,7,6,825,455,370
Kentucky,Union County,7,7,838,394,444
Kentucky,Union County,7,8,863,438,425
Kentucky,Union County,7,9,840,415,425
Kentucky,Union County,7,10,887,427,460
Kentucky,Union County,7,11,978,481,497
Kentucky,Union County,7,12,1076,497,579
Kentucky,Union County,7,13,1010,513,497
Kentucky,Union County,7,14,812,405,407
Kentucky,Union County,7,15,496,230,266
Kentucky,Union County,7,16,381,174,207
Kentucky,Union County,7,17,289,107,182
Kentucky,Union County,7,18,267,80,187
Kentucky,Union County,8,0,14951,7818,7133
Kentucky,Union County,8,1,772,389,383
Kentucky,Union County,8,2,783,404,379
Kentucky,Union County,8,3,810,401,409
Kentucky,Union County,8,4,1347,867,480
Kentucky,Union County,8,5,1681,1137,544
Kentucky,Union County,8,6,846,462,384
Kentucky,Union County,8,7,812,402,410
Kentucky,Union County,8,8,856,430,426
Kentucky,Union County,8,9,852,422,430
Kentucky,Union County,8,10,848,418,430
Kentucky,Union County,8,11,995,480,515
Kentucky,Union County,8,12,1062,491,571
Kentucky,Union County,8,13,1005,509,496
Kentucky,Union County,8,14,836,407,429
Kentucky,Union County,8,15,535,254,281
Kentucky,Union County,8,16,365,164,201
Kentucky,Union County,8,17,286,109,177
Kentucky,Union County,8,18,260,72,188
Kentucky,Union County,9,0,14765,7713,7052
Kentucky,Union County,9,1,759,386,373
Kentucky,Union County,9,2,767,391,376
Kentucky,Union County,9,3,755,375,380
Kentucky,Union County,9,4,1308,848,460
Kentucky,Union County,9,5,1635,1117,518
Kentucky,Union County,9,6,848,449,399
Kentucky,Union County,9,7,807,399,408
Kentucky,Union County,9,8,867,436,431
Kentucky,Union County,9,9,847,409,438
Kentucky,Union County,9,10,823,422,401
Kentucky,Union County,9,11,960,467,493
Kentucky,Union County,9,12,1041,469,572
Kentucky,Union County,9,13,1001,511,490
Kentucky,Union County,9,14,891,434,457
Kentucky,Union County,9,15,544,266,278
Kentucky,Union County,9,16,373,156,217
Kentucky,Union County,9,17,279,115,164
Kentucky,Union County,9,18,260,63,197
Kentucky,Union County,10,0,14620,7624,6996
Kentucky,Union County,10,1,753,388,365
Kentucky,Union County,10,2,698,365,333
Kentucky,Union County,10,3,745,376,369
Kentucky,Union County,10,4,1324,848,476
Kentucky,Union County,10,5,1580,1083,497
Kentucky,Union County,10,6,862,449,413
Kentucky,Union County,10,7,766,392,374
Kentucky,Union County,10,8,878,416,462
Kentucky,Union County,10,9,842,414,428
Kentucky,Union County,10,10,842,426,416
Kentucky,Union County,10,11,935,460,475
Kentucky,Union County,10,12,1016,469,547
Kentucky,Union County,10,13,1004,504,500
Kentucky,Union County,10,14,878,420,458
Kentucky,Union County,10,15,591,288,303
Kentucky,Union County,10,16,389,163,226
Kentucky,Union County,10,17,263,105,158
Kentucky,Union County,10,18,254,58,196
Kentucky,Union County,11,0,14471,7525,6946
Kentucky,Union County,11,1,727,373,354
Kentucky,Union County,11,2,692,360,332
Kentucky,Union County,11,3,713,356,357
Kentucky,Union County,11,4,1289,816,473
Kentucky,Union County,11,5,1561,1075,486
Kentucky,Union County,11,6,866,447,419
Kentucky,Union County,11,7,770,394,376
Kentucky,Union County,11,8,862,404,458
Kentucky,Union County,11,9,833,418,415
Kentucky,Union County,11,10,841,415,426
Kentucky,Union County,11,11,913,446,467
Kentucky,Union County,11,12,944,447,497
Kentucky,Union County,11,13,1043,501,542
Kentucky,Union County,11,14,877,426,451
Kentucky,Union County,11,15,634,316,318
Kentucky,Union County,11,16,385,159,226
Kentucky,Union County,11,17,261,106,155
Kentucky,Union County,11,18,260,66,194
Kentucky,Union County,12,0,14381,7524,6857
Kentucky,Union County,12,1,680,344,336
Kentucky,Union County,12,2,707,390,317
Kentucky,Union County,12,3,696,346,350
Kentucky,Union County,12,4,1280,807,473
Kentucky,Union County,12,5,1530,1064,466
Kentucky,Union County,12,6,881,475,406
Kentucky,Union County,12,7,775,385,390
Kentucky,Union County,12,8,832,405,427
Kentucky,Union County,12,9,846,420,426
Kentucky,Union County,12,10,847,418,429
Kentucky,Union County,12,11,858,420,438
Kentucky,Union County,12,12,928,449,479
Kentucky,Union County,12,13,1046,475,571
Kentucky,Union County,12,14,895,441,454
Kentucky,Union County,12,15,665,334,331
Kentucky,Union County,12,16,397,175,222
Kentucky,Union County,12,17,264,105,159
Kentucky,Union County,12,18,254,71,183
Kentucky,Warren County,1,0,113792,55696,58096
Kentucky,Warren County,1,1,7239,3728,3511
Kentucky,Warren County,1,2,7265,3681,3584
Kentucky,Warren County,1,3,7111,3701,3410
Kentucky,Warren County,1,4,9860,4803,5057
Kentucky,Warren County,1,5,12849,6396,6453
Kentucky,Warren County,1,6,8457,4295,4162
Kentucky,Warren County,1,7,7437,3748,3689
Kentucky,Warren County,1,8,7211,3598,3613
Kentucky,Warren County,1,9,6836,3366,3470
Kentucky,Warren County,1,10,7633,3693,3940
Kentucky,Warren County,1,11,7366,3562,3804
Kentucky,Warren County,1,12,6467,3069,3398
Kentucky,Warren County,1,13,5621,2768,2853
Kentucky,Warren County,1,14,4076,1945,2131
Kentucky,Warren County,1,15,2945,1356,1589
Kentucky,Warren County,1,16,2224,930,1294
Kentucky,Warren County,1,17,1630,603,1027
Kentucky,Warren County,1,18,1565,454,1111
Kentucky,Warren County,2,0,113781,55691,58090
Kentucky,Warren County,2,1,7239,3728,3511
Kentucky,Warren County,2,2,7265,3681,3584
Kentucky,Warren County,2,3,7111,3701,3410
Kentucky,Warren County,2,4,9859,4803,5056
Kentucky,Warren County,2,5,12850,6396,6454
Kentucky,Warren County,2,6,8454,4294,4160
Kentucky,Warren County,2,7,7437,3749,3688
Kentucky,Warren County,2,8,7210,3597,3613
Kentucky,Warren County,2,9,6837,3366,3471
Kentucky,Warren County,2,10,7630,3692,3938
Kentucky,Warren County,2,11,7363,3560,3803
Kentucky,Warren County,2,12,6465,3067,3398
Kentucky,Warren County,2,13,5623,2770,2853
Kentucky,Warren County,2,14,4076,1945,2131
Kentucky,Warren County,2,15,2945,1356,1589
Kentucky,Warren County,2,16,2223,930,1293
Kentucky,Warren County,2,17,1629,602,1027
Kentucky,Warren County,2,18,1565,454,1111
Kentucky,Warren County,3,0,114341,55972,58369
Kentucky,Warren County,3,1,7243,3732,3511
Kentucky,Warren County,3,2,7272,3695,3577
Kentucky,Warren County,3,3,7150,3725,3425
Kentucky,Warren County,3,4,9989,4868,5121
Kentucky,Warren County,3,5,13018,6460,6558
Kentucky,Warren County,3,6,8406,4274,4132
Kentucky,Warren County,3,7,7488,3776,3712
Kentucky,Warren County,3,8,7202,3603,3599
Kentucky,Warren County,3,9,6841,3367,3474
Kentucky,Warren County,3,10,7628,3697,3931
Kentucky,Warren County,3,11,7374,3557,3817
Kentucky,Warren County,3,12,6526,3101,3425
Kentucky,Warren County,3,13,5652,2773,2879
Kentucky,Warren County,3,14,4099,1968,2131
Kentucky,Warren County,3,15,2985,1369,1616
Kentucky,Warren County,3,16,2241,939,1302
Kentucky,Warren County,3,17,1647,609,1038
Kentucky,Warren County,3,18,1580,459,1121
Kentucky,Warren County,4,0,115862,56662,59200
Kentucky,Warren County,4,1,7293,3751,3542
Kentucky,Warren County,4,2,7309,3706,3603
Kentucky,Warren County,4,3,7234,3781,3453
Kentucky,Warren County,4,4,10085,4906,5179
Kentucky,Warren County,4,5,13645,6738,6907
Kentucky,Warren County,4,6,8213,4169,4044
Kentucky,Warren County,4,7,7619,3816,3803
Kentucky,Warren County,4,8,7112,3531,3581
Kentucky,Warren County,4,9,6922,3410,3512
Kentucky,Warren County,4,10,7504,3683,3821
Kentucky,Warren County,4,11,7454,3581,3873
Kentucky,Warren County,4,12,6705,3200,3505
Kentucky,Warren County,4,13,5900,2855,3045
Kentucky,Warren County,4,14,4200,2036,2164
Kentucky,Warren County,4,15,3133,1432,1701
Kentucky,Warren County,4,16,2279,969,1310
Kentucky,Warren County,4,17,1673,640,1033
Kentucky,Warren County,4,18,1582,458,1124
Kentucky,Warren County,5,0,117389,57319,60070
Kentucky,Warren County,5,1,7302,3681,3621
Kentucky,Warren County,5,2,7462,3758,3704
Kentucky,Warren County,5,3,7264,3799,3465
Kentucky,Warren County,5,4,9994,4903,5091
Kentucky,Warren County,5,5,14180,7028,7152
Kentucky,Warren County,5,6,8071,4104,3967
Kentucky,Warren County,5,7,7785,3867,3918
Kentucky,Warren County,5,8,7109,3520,3589
Kentucky,Warren County,5,9,7073,3534,3539
Kentucky,Warren County,5,10,7300,3555,3745
Kentucky,Warren County,5,11,7555,3663,3892
Kentucky,Warren County,5,12,6855,3253,3602
Kentucky,Warren County,5,13,5910,2843,3067
Kentucky,Warren County,5,14,4609,2207,2402
Kentucky,Warren County,5,15,3310,1514,1796
Kentucky,Warren County,5,16,2298,987,1311
Kentucky,Warren County,5,17,1660,644,1016
Kentucky,Warren County,5,18,1652,459,1193
Kentucky,Warren County,6,0,119575,58487,61088
Kentucky,Warren County,6,1,7527,3782,3745
Kentucky,Warren County,6,2,7635,3844,3791
Kentucky,Warren County,6,3,7325,3776,3549
Kentucky,Warren County,6,4,10369,5137,5232
Kentucky,Warren County,6,5,14764,7396,7368
Kentucky,Warren County,6,6,7947,4093,3854
Kentucky,Warren County,6,7,7949,3955,3994
Kentucky,Warren County,6,8,7209,3523,3686
Kentucky,Warren County,6,9,7089,3551,3538
Kentucky,Warren County,6,10,7087,3401,3686
Kentucky,Warren County,6,11,7663,3764,3899
Kentucky,Warren County,6,12,7015,3352,3663
Kentucky,Warren County,6,13,5996,2835,3161
Kentucky,Warren County,6,14,4842,2333,2509
Kentucky,Warren County,6,15,3427,1559,1868
Kentucky,Warren County,6,16,2395,1059,1336
Kentucky,Warren County,6,17,1665,643,1022
Kentucky,Warren County,6,18,1671,484,1187
Kentucky,Warren County,7,0,121394,59354,62040
Kentucky,Warren County,7,1,7622,3835,3787
Kentucky,Warren County,7,2,7728,3899,3829
Kentucky,Warren County,7,3,7459,3783,3676
Kentucky,Warren County,7,4,10424,5173,5251
Kentucky,Warren County,7,5,15022,7561,7461
Kentucky,Warren County,7,6,8033,4083,3950
Kentucky,Warren County,7,7,7985,4006,3979
Kentucky,Warren County,7,8,7398,3596,3802
Kentucky,Warren County,7,9,7248,3601,3647
Kentucky,Warren County,7,10,6921,3374,3547
Kentucky,Warren County,7,11,7669,3730,3939
Kentucky,Warren County,7,12,7125,3388,3737
Kentucky,Warren County,7,13,6200,2907,3293
Kentucky,Warren County,7,14,5079,2476,2603
Kentucky,Warren County,7,15,3601,1662,1939
Kentucky,Warren County,7,16,2454,1095,1359
Kentucky,Warren County,7,17,1689,664,1025
Kentucky,Warren County,7,18,1737,521,1216
Kentucky,Warren County,8,0,124122,60820,63302
Kentucky,Warren County,8,1,7796,3913,3883
Kentucky,Warren County,8,2,7873,4001,3872
Kentucky,Warren County,8,3,7588,3829,3759
Kentucky,Warren County,8,4,10648,5254,5394
Kentucky,Warren County,8,5,15308,7840,7468
Kentucky,Warren County,8,6,8583,4316,4267
Kentucky,Warren County,8,7,7820,3974,3846
Kentucky,Warren County,8,8,7726,3733,3993
Kentucky,Warren County,8,9,7341,3657,3684
Kentucky,Warren County,8,10,6946,3399,3547
Kentucky,Warren County,8,11,7745,3754,3991
Kentucky,Warren County,8,12,7209,3440,3769
Kentucky,Warren County,8,13,6381,2990,3391
Kentucky,Warren County,8,14,5338,2581,2757
Kentucky,Warren County,8,15,3753,1758,1995
Kentucky,Warren County,8,16,2548,1146,1402
Kentucky,Warren County,8,17,1728,690,1038
Kentucky,Warren County,8,18,1791,545,1246
Kentucky,Warren County,9,0,126419,61976,64443
Kentucky,Warren County,9,1,8049,4005,4044
Kentucky,Warren County,9,2,7973,4039,3934
Kentucky,Warren County,9,3,7899,3976,3923
Kentucky,Warren County,9,4,10586,5198,5388
Kentucky,Warren County,9,5,15212,7765,7447
Kentucky,Warren County,9,6,9059,4633,4426
Kentucky,Warren County,9,7,7735,3937,3798
Kentucky,Warren County,9,8,8089,3967,4122
Kentucky,Warren County,9,9,7389,3672,3717
Kentucky,Warren County,9,10,7105,3503,3602
Kentucky,Warren County,9,11,7762,3812,3950
Kentucky,Warren County,9,12,7261,3436,3825
Kentucky,Warren County,9,13,6542,3053,3489
Kentucky,Warren County,9,14,5600,2673,2927
Kentucky,Warren County,9,15,3873,1822,2051
Kentucky,Warren County,9,16,2710,1212,1498
Kentucky,Warren County,9,17,1730,706,1024
Kentucky,Warren County,9,18,1845,567,1278
Kentucky,Warren County,10,0,129074,63169,65905
Kentucky,Warren County,10,1,8362,4173,4189
Kentucky,Warren County,10,2,8062,4050,4012
Kentucky,Warren County,10,3,8119,4080,4039
Kentucky,Warren County,10,4,11021,5357,5664
Kentucky,Warren County,10,5,15191,7727,7464
Kentucky,Warren County,10,6,9646,4976,4670
Kentucky,Warren County,10,7,7816,3956,3860
Kentucky,Warren County,10,8,8213,4051,4162
Kentucky,Warren County,10,9,7482,3645,3837
Kentucky,Warren County,10,10,7315,3632,3683
Kentucky,Warren County,10,11,7537,3693,3844
Kentucky,Warren County,10,12,7393,3541,3852
Kentucky,Warren County,10,13,6666,3124,3542
Kentucky,Warren County,10,14,5584,2628,2956
Kentucky,Warren County,10,15,4217,1966,2251
Kentucky,Warren County,10,16,2809,1259,1550
Kentucky,Warren County,10,17,1761,725,1036
Kentucky,Warren County,10,18,1880,586,1294
Kentucky,Warren County,11,0,130750,63997,66753
Kentucky,Warren County,11,1,8513,4259,4254
Kentucky,Warren County,11,2,8214,4132,4082
Kentucky,Warren County,11,3,8320,4200,4120
Kentucky,Warren County,11,4,10943,5277,5666
Kentucky,Warren County,11,5,15133,7713,7420
Kentucky,Warren County,11,6,9766,4970,4796
Kentucky,Warren County,11,7,7927,4059,3868
Kentucky,Warren County,11,8,8386,4163,4223
Kentucky,Warren County,11,9,7565,3686,3879
Kentucky,Warren County,11,10,7506,3755,3751
Kentucky,Warren County,11,11,7338,3538,3800
Kentucky,Warren County,11,12,7538,3648,3890
Kentucky,Warren County,11,13,6781,3156,3625
Kentucky,Warren County,11,14,5632,2624,3008
Kentucky,Warren County,11,15,4468,2088,2380
Kentucky,Warren County,11,16,2965,1320,1645
Kentucky,Warren County,11,17,1828,785,1043
Kentucky,Warren County,11,18,1927,624,1303
Kentucky,Warren County,12,0,132896,65096,67800
Kentucky,Warren County,12,1,8572,4305,4267
Kentucky,Warren County,12,2,8361,4221,4140
Kentucky,Warren County,12,3,8427,4228,4199
Kentucky,Warren County,12,4,11482,5521,5961
Kentucky,Warren County,12,5,15163,7686,7477
Kentucky,Warren County,12,6,9839,5111,4728
Kentucky,Warren County,12,7,8082,4075,4007
Kentucky,Warren County,12,8,8384,4189,4195
Kentucky,Warren County,12,9,7765,3741,4024
Kentucky,Warren County,12,10,7704,3831,3873
Kentucky,Warren County,12,11,7173,3536,3637
Kentucky,Warren County,12,12,7553,3666,3887
Kentucky,Warren County,12,13,6928,3235,3693
Kentucky,Warren County,12,14,5782,2683,3099
Kentucky,Warren County,12,15,4696,2202,2494
Kentucky,Warren County,12,16,3113,1399,1714
Kentucky,Warren County,12,17,1907,803,1104
Kentucky,Warren County,12,18,1965,664,1301
Kentucky,Washington County,1,0,11717,5736,5981
Kentucky,Washington County,1,1,697,355,342
Kentucky,Washington County,1,2,759,384,375
Kentucky,Washington County,1,3,803,399,404
Kentucky,Washington County,1,4,838,425,413
Kentucky,Washington County,1,5,682,353,329
Kentucky,Washington County,1,6,571,296,275
Kentucky,Washington County,1,7,676,329,347
Kentucky,Washington County,1,8,710,353,357
Kentucky,Washington County,1,9,798,405,393
Kentucky,Washington County,1,10,978,498,480
Kentucky,Washington County,1,11,877,438,439
Kentucky,Washington County,1,12,792,394,398
Kentucky,Washington County,1,13,674,339,335
Kentucky,Washington County,1,14,566,283,283
Kentucky,Washington County,1,15,429,191,238
Kentucky,Washington County,1,16,319,129,190
Kentucky,Washington County,1,17,271,96,175
Kentucky,Washington County,1,18,277,69,208
Kentucky,Washington County,2,0,11713,5734,5979
Kentucky,Washington County,2,1,695,354,341
Kentucky,Washington County,2,2,759,384,375
Kentucky,Washington County,2,3,803,399,404
Kentucky,Washington County,2,4,838,425,413
Kentucky,Washington County,2,5,682,353,329
Kentucky,Washington County,2,6,571,296,275
Kentucky,Washington County,2,7,675,329,346
Kentucky,Washington County,2,8,710,353,357
Kentucky,Washington County,2,9,797,404,393
Kentucky,Washington County,2,10,978,498,480
Kentucky,Washington County,2,11,877,438,439
Kentucky,Washington County,2,12,792,394,398
Kentucky,Washington County,2,13,674,339,335
Kentucky,Washington County,2,14,566,283,283
Kentucky,Washington County,2,15,429,191,238
Kentucky,Washington County,2,16,319,129,190
Kentucky,Washington County,2,17,271,96,175
Kentucky,Washington County,2,18,277,69,208
Kentucky,Washington County,3,0,11695,5711,5984
Kentucky,Washington County,3,1,686,350,336
Kentucky,Washington County,3,2,766,386,380
Kentucky,Washington County,3,3,803,402,401
Kentucky,Washington County,3,4,825,414,411
Kentucky,Washington County,3,5,673,346,327
Kentucky,Washington County,3,6,571,295,276
Kentucky,Washington County,3,7,672,328,344
Kentucky,Washington County,3,8,709,355,354
Kentucky,Washington County,3,9,793,396,397
Kentucky,Washington County,3,10,978,500,478
Kentucky,Washington County,3,11,886,443,443
Kentucky,Washington County,3,12,785,389,396
Kentucky,Washington County,3,13,692,347,345
Kentucky,Washington County,3,14,563,281,282
Kentucky,Washington County,3,15,430,191,239
Kentucky,Washington County,3,16,313,126,187
Kentucky,Washington County,3,17,271,93,178
Kentucky,Washington County,3,18,279,69,210
Kentucky,Washington County,4,0,11690,5699,5991
Kentucky,Washington County,4,1,665,352,313
Kentucky,Washington County,4,2,772,390,382
Kentucky,Washington County,4,3,817,413,404
Kentucky,Washington County,4,4,799,399,400
Kentucky,Washington County,4,5,697,355,342
Kentucky,Washington County,4,6,564,285,279
Kentucky,Washington County,4,7,669,324,345
Kentucky,Washington County,4,8,675,336,339
Kentucky,Washington County,4,9,792,372,420
Kentucky,Washington County,4,10,937,484,453
Kentucky,Washington County,4,11,914,460,454
Kentucky,Washington County,4,12,778,386,392
Kentucky,Washington County,4,13,755,377,378
Kentucky,Washington County,4,14,532,273,259
Kentucky,Washington County,4,15,455,204,251
Kentucky,Washington County,4,16,320,127,193
Kentucky,Washington County,4,17,271,96,175
Kentucky,Washington County,4,18,278,66,212
Kentucky,Washington County,5,0,11821,5782,6039
Kentucky,Washington County,5,1,699,372,327
Kentucky,Washington County,5,2,762,389,373
Kentucky,Washington County,5,3,791,394,397
Kentucky,Washington County,5,4,856,428,428
Kentucky,Washington County,5,5,796,418,378
Kentucky,Washington County,5,6,563,277,286
Kentucky,Washington County,5,7,663,333,330
Kentucky,Washington County,5,8,633,314,319
Kentucky,Washington County,5,9,793,366,427
Kentucky,Washington County,5,10,930,481,449
Kentucky,Washington County,5,11,897,448,449
Kentucky,Washington County,5,12,794,386,408
Kentucky,Washington County,5,13,768,392,376
Kentucky,Washington County,5,14,562,285,277
Kentucky,Washington County,5,15,458,210,248
Kentucky,Washington County,5,16,317,128,189
Kentucky,Washington County,5,17,271,99,172
Kentucky,Washington County,5,18,268,62,206
Kentucky,Washington County,6,0,11849,5789,6060
Kentucky,Washington County,6,1,700,371,329
Kentucky,Washington County,6,2,730,375,355
Kentucky,Washington County,6,3,797,407,390
Kentucky,Washington County,6,4,904,466,438
Kentucky,Washington County,6,5,793,412,381
Kentucky,Washington County,6,6,599,286,313
Kentucky,Washington County,6,7,623,316,307
Kentucky,Washington County,6,8,640,308,332
Kentucky,Washington County,6,9,777,356,421
Kentucky,Washington County,6,10,873,459,414
Kentucky,Washington County,6,11,909,443,466
Kentucky,Washington County,6,12,809,404,405
Kentucky,Washington County,6,13,782,384,398
Kentucky,Washington County,6,14,577,286,291
Kentucky,Washington County,6,15,459,222,237
Kentucky,Washington County,6,16,346,140,206
Kentucky,Washington County,6,17,264,94,170
Kentucky,Washington County,6,18,267,60,207
Kentucky,Washington County,7,0,11901,5826,6075
Kentucky,Washington County,7,1,728,379,349
Kentucky,Washington County,7,2,725,374,351
Kentucky,Washington County,7,3,780,398,382
Kentucky,Washington County,7,4,898,477,421
Kentucky,Washington County,7,5,811,421,390
Kentucky,Washington County,7,6,595,294,301
Kentucky,Washington County,7,7,614,301,313
Kentucky,Washington County,7,8,654,317,337
Kentucky,Washington County,7,9,751,350,401
Kentucky,Washington County,7,10,816,428,388
Kentucky,Washington County,7,11,957,469,488
Kentucky,Washington County,7,12,811,399,412
Kentucky,Washington County,7,13,788,384,404
Kentucky,Washington County,7,14,606,299,307
Kentucky,Washington County,7,15,472,225,247
Kentucky,Washington County,7,16,353,147,206
Kentucky,Washington County,7,17,259,88,171
Kentucky,Washington County,7,18,283,76,207
Kentucky,Washington County,8,0,12007,5897,6110
Kentucky,Washington County,8,1,712,371,341
Kentucky,Washington County,8,2,734,389,345
Kentucky,Washington County,8,3,807,399,408
Kentucky,Washington County,8,4,909,496,413
Kentucky,Washington County,8,5,810,410,400
Kentucky,Washington County,8,6,637,318,319
Kentucky,Washington County,8,7,604,303,301
Kentucky,Washington County,8,8,671,323,348
Kentucky,Washington County,8,9,723,341,382
Kentucky,Washington County,8,10,797,406,391
Kentucky,Washington County,8,11,941,473,468
Kentucky,Washington County,8,12,857,426,431
Kentucky,Washington County,8,13,776,372,404
Kentucky,Washington County,8,14,643,312,331
Kentucky,Washington County,8,15,482,240,242
Kentucky,Washington County,8,16,362,149,213
Kentucky,Washington County,8,17,270,93,177
Kentucky,Washington County,8,18,272,76,196
Kentucky,Washington County,9,0,12109,5928,6181
Kentucky,Washington County,9,1,765,390,375
Kentucky,Washington County,9,2,724,380,344
Kentucky,Washington County,9,3,801,406,395
Kentucky,Washington County,9,4,895,472,423
Kentucky,Washington County,9,5,785,412,373
Kentucky,Washington County,9,6,674,331,343
Kentucky,Washington County,9,7,588,301,287
Kentucky,Washington County,9,8,706,337,369
Kentucky,Washington County,9,9,715,349,366
Kentucky,Washington County,9,10,788,383,405
Kentucky,Washington County,9,11,923,466,457
Kentucky,Washington County,9,12,861,431,430
Kentucky,Washington County,9,13,787,380,407
Kentucky,Washington County,9,14,708,336,372
Kentucky,Washington County,9,15,474,238,236
Kentucky,Washington County,9,16,367,149,218
Kentucky,Washington County,9,17,270,95,175
Kentucky,Washington County,9,18,278,72,206
Kentucky,Washington County,10,0,11880,5827,6053
Kentucky,Washington County,10,1,754,394,360
Kentucky,Washington County,10,2,746,391,355
Kentucky,Washington County,10,3,775,412,363
Kentucky,Washington County,10,4,773,417,356
Kentucky,Washington County,10,5,662,349,313
Kentucky,Washington County,10,6,701,338,363
Kentucky,Washington County,10,7,562,279,283
Kentucky,Washington County,10,8,718,358,360
Kentucky,Washington County,10,9,710,345,365
Kentucky,Washington County,10,10,782,368,414
Kentucky,Washington County,10,11,933,477,456
Kentucky,Washington County,10,12,843,416,427
Kentucky,Washington County,10,13,787,374,413
Kentucky,Washington County,10,14,720,351,369
Kentucky,Washington County,10,15,491,243,248
Kentucky,Washington County,10,16,369,152,217
Kentucky,Washington County,10,17,276,91,185
Kentucky,Washington County,10,18,278,72,206
Kentucky,Washington County,11,0,12023,5928,6095
Kentucky,Washington County,11,1,787,419,368
Kentucky,Washington County,11,2,750,382,368
Kentucky,Washington County,11,3,778,409,369
Kentucky,Washington County,11,4,759,422,337
Kentucky,Washington County,11,5,694,356,338
Kentucky,Washington County,11,6,719,360,359
Kentucky,Washington County,11,7,601,283,318
Kentucky,Washington County,11,8,662,344,318
Kentucky,Washington County,11,9,702,351,351
Kentucky,Washington County,11,10,790,379,411
Kentucky,Washington County,11,11,897,465,432
Kentucky,Washington County,11,12,885,429,456
Kentucky,Washington County,11,13,811,397,414
Kentucky,Washington County,11,14,724,347,377
Kentucky,Washington County,11,15,511,244,267
Kentucky,Washington County,11,16,375,168,207
Kentucky,Washington County,11,17,299,99,200
Kentucky,Washington County,11,18,279,74,205
Kentucky,Washington County,12,0,12095,5986,6109
Kentucky,Washington County,12,1,756,411,345
Kentucky,Washington County,12,2,773,404,369
Kentucky,Washington County,12,3,770,403,367
Kentucky,Washington County,12,4,747,403,344
Kentucky,Washington County,12,5,713,375,338
Kentucky,Washington County,12,6,757,381,376
Kentucky,Washington County,12,7,613,295,318
Kentucky,Washington County,12,8,644,335,309
Kentucky,Washington County,12,9,716,358,358
Kentucky,Washington County,12,10,790,379,411
Kentucky,Washington County,12,11,842,441,401
Kentucky,Washington County,12,12,927,453,474
Kentucky,Washington County,12,13,812,398,414
Kentucky,Washington County,12,14,731,348,383
Kentucky,Washington County,12,15,523,248,275
Kentucky,Washington County,12,16,397,184,213
Kentucky,Washington County,12,17,302,98,204
Kentucky,Washington County,12,18,282,72,210
Kentucky,Wayne County,1,0,20813,10295,10518
Kentucky,Wayne County,1,1,1260,630,630
Kentucky,Wayne County,1,2,1238,604,634
Kentucky,Wayne County,1,3,1391,706,685
Kentucky,Wayne County,1,4,1348,714,634
Kentucky,Wayne County,1,5,1153,591,562
Kentucky,Wayne County,1,6,1152,577,575
Kentucky,Wayne County,1,7,1250,661,589
Kentucky,Wayne County,1,8,1266,638,628
Kentucky,Wayne County,1,9,1416,693,723
Kentucky,Wayne County,1,10,1481,749,732
Kentucky,Wayne County,1,11,1587,787,800
Kentucky,Wayne County,1,12,1527,744,783
Kentucky,Wayne County,1,13,1418,697,721
Kentucky,Wayne County,1,14,1147,532,615
Kentucky,Wayne County,1,15,879,433,446
Kentucky,Wayne County,1,16,595,259,336
Kentucky,Wayne County,1,17,398,173,225
Kentucky,Wayne County,1,18,307,107,200
Kentucky,Wayne County,2,0,20813,10295,10518
Kentucky,Wayne County,2,1,1260,630,630
Kentucky,Wayne County,2,2,1238,604,634
Kentucky,Wayne County,2,3,1391,706,685
Kentucky,Wayne County,2,4,1348,714,634
Kentucky,Wayne County,2,5,1153,591,562
Kentucky,Wayne County,2,6,1152,577,575
Kentucky,Wayne County,2,7,1250,661,589
Kentucky,Wayne County,2,8,1266,638,628
Kentucky,Wayne County,2,9,1416,693,723
Kentucky,Wayne County,2,10,1481,749,732
Kentucky,Wayne County,2,11,1587,787,800
Kentucky,Wayne County,2,12,1527,744,783
Kentucky,Wayne County,2,13,1418,697,721
Kentucky,Wayne County,2,14,1147,532,615
Kentucky,Wayne County,2,15,879,433,446
Kentucky,Wayne County,2,16,595,259,336
Kentucky,Wayne County,2,17,398,173,225
Kentucky,Wayne County,2,18,307,107,200
Kentucky,Wayne County,3,0,20850,10301,10549
Kentucky,Wayne County,3,1,1255,625,630
Kentucky,Wayne County,3,2,1234,608,626
Kentucky,Wayne County,3,3,1384,695,689
Kentucky,Wayne County,3,4,1329,716,613
Kentucky,Wayne County,3,5,1176,594,582
Kentucky,Wayne County,3,6,1140,572,568
Kentucky,Wayne County,3,7,1263,663,600
Kentucky,Wayne County,3,8,1261,634,627
Kentucky,Wayne County,3,9,1414,693,721
Kentucky,Wayne County,3,10,1473,748,725
Kentucky,Wayne County,3,11,1592,780,812
Kentucky,Wayne County,3,12,1544,753,791
Kentucky,Wayne County,3,13,1423,700,723
Kentucky,Wayne County,3,14,1155,536,619
Kentucky,Wayne County,3,15,893,438,455
Kentucky,Wayne County,3,16,602,258,344
Kentucky,Wayne County,3,17,399,178,221
Kentucky,Wayne County,3,18,313,110,203
Kentucky,Wayne County,4,0,20901,10317,10584
Kentucky,Wayne County,4,1,1189,587,602
Kentucky,Wayne County,4,2,1234,609,625
Kentucky,Wayne County,4,3,1366,662,704
Kentucky,Wayne County,4,4,1301,720,581
Kentucky,Wayne County,4,5,1233,609,624
Kentucky,Wayne County,4,6,1101,562,539
Kentucky,Wayne County,4,7,1291,674,617
Kentucky,Wayne County,4,8,1235,622,613
Kentucky,Wayne County,4,9,1431,714,717
Kentucky,Wayne County,4,10,1425,723,702
Kentucky,Wayne County,4,11,1574,759,815
Kentucky,Wayne County,4,12,1562,761,801
Kentucky,Wayne County,4,13,1473,734,739
Kentucky,Wayne County,4,14,1162,537,625
Kentucky,Wayne County,4,15,946,467,479
Kentucky,Wayne County,4,16,636,266,370
Kentucky,Wayne County,4,17,411,187,224
Kentucky,Wayne County,4,18,331,124,207
Kentucky,Wayne County,5,0,20824,10297,10527
Kentucky,Wayne County,5,1,1168,593,575
Kentucky,Wayne County,5,2,1256,630,626
Kentucky,Wayne County,5,3,1295,622,673
Kentucky,Wayne County,5,4,1264,698,566
Kentucky,Wayne County,5,5,1276,615,661
Kentucky,Wayne County,5,6,1100,561,539
Kentucky,Wayne County,5,7,1258,662,596
Kentucky,Wayne County,5,8,1209,614,595
Kentucky,Wayne County,5,9,1410,717,693
Kentucky,Wayne County,5,10,1428,708,720
Kentucky,Wayne County,5,11,1524,731,793
Kentucky,Wayne County,5,12,1543,755,788
Kentucky,Wayne County,5,13,1459,746,713
Kentucky,Wayne County,5,14,1254,576,678
Kentucky,Wayne County,5,15,960,463,497
Kentucky,Wayne County,5,16,652,285,367
Kentucky,Wayne County,5,17,424,184,240
Kentucky,Wayne County,5,18,344,137,207
Kentucky,Wayne County,6,0,20782,10278,10504
Kentucky,Wayne County,6,1,1189,599,590
Kentucky,Wayne County,6,2,1214,612,602
Kentucky,Wayne County,6,3,1284,618,666
Kentucky,Wayne County,6,4,1251,682,569
Kentucky,Wayne County,6,5,1265,624,641
Kentucky,Wayne County,6,6,1117,566,551
Kentucky,Wayne County,6,7,1219,642,577
Kentucky,Wayne County,6,8,1185,607,578
Kentucky,Wayne County,6,9,1413,720,693
Kentucky,Wayne County,6,10,1390,683,707
Kentucky,Wayne County,6,11,1502,712,790
Kentucky,Wayne County,6,12,1548,756,792
Kentucky,Wayne County,6,13,1468,755,713
Kentucky,Wayne County,6,14,1285,605,680
Kentucky,Wayne County,6,15,979,461,518
Kentucky,Wayne County,6,16,693,311,382
Kentucky,Wayne County,6,17,412,170,242
Kentucky,Wayne County,6,18,368,155,213
Kentucky,Wayne County,7,0,20618,10232,10386
Kentucky,Wayne County,7,1,1151,594,557
Kentucky,Wayne County,7,2,1181,597,584
Kentucky,Wayne County,7,3,1217,590,627
Kentucky,Wayne County,7,4,1261,691,570
Kentucky,Wayne County,7,5,1234,606,628
Kentucky,Wayne County,7,6,1148,610,538
Kentucky,Wayne County,7,7,1161,594,567
Kentucky,Wayne County,7,8,1203,613,590
Kentucky,Wayne County,7,9,1323,684,639
Kentucky,Wayne County,7,10,1411,692,719
Kentucky,Wayne County,7,11,1468,695,773
Kentucky,Wayne County,7,12,1553,765,788
Kentucky,Wayne County,7,13,1456,742,714
Kentucky,Wayne County,7,14,1309,623,686
Kentucky,Wayne County,7,15,1026,485,541
Kentucky,Wayne County,7,16,731,330,401
Kentucky,Wayne County,7,17,429,172,257
Kentucky,Wayne County,7,18,356,149,207
Kentucky,Wayne County,8,0,20609,10228,10381
Kentucky,Wayne County,8,1,1158,603,555
Kentucky,Wayne County,8,2,1190,592,598
Kentucky,Wayne County,8,3,1196,597,599
Kentucky,Wayne County,8,4,1286,688,598
Kentucky,Wayne County,8,5,1186,595,591
Kentucky,Wayne County,8,6,1186,614,572
Kentucky,Wayne County,8,7,1105,560,545
Kentucky,Wayne County,8,8,1251,649,602
Kentucky,Wayne County,8,9,1279,653,626
Kentucky,Wayne County,8,10,1380,671,709
Kentucky,Wayne County,8,11,1427,706,721
Kentucky,Wayne County,8,12,1567,772,795
Kentucky,Wayne County,8,13,1468,728,740
Kentucky,Wayne County,8,14,1327,643,684
Kentucky,Wayne County,8,15,1052,475,577
Kentucky,Wayne County,8,16,762,363,399
Kentucky,Wayne County,8,17,450,176,274
Kentucky,Wayne County,8,18,339,143,196
Kentucky,Wayne County,9,0,20728,10300,10428
Kentucky,Wayne County,9,1,1187,640,547
Kentucky,Wayne County,9,2,1185,587,598
Kentucky,Wayne County,9,3,1168,597,571
Kentucky,Wayne County,9,4,1243,650,593
Kentucky,Wayne County,9,5,1155,607,548
Kentucky,Wayne County,9,6,1285,642,643
Kentucky,Wayne County,9,7,1067,542,525
Kentucky,Wayne County,9,8,1262,650,612
Kentucky,Wayne County,9,9,1233,628,605
Kentucky,Wayne County,9,10,1408,702,706
Kentucky,Wayne County,9,11,1405,691,714
Kentucky,Wayne County,9,12,1552,740,812
Kentucky,Wayne County,9,13,1512,745,767
Kentucky,Wayne County,9,14,1379,682,697
Kentucky,Wayne County,9,15,1039,456,583
Kentucky,Wayne County,9,16,809,396,413
Kentucky,Wayne County,9,17,472,188,284
Kentucky,Wayne County,9,18,367,157,210
Kentucky,Wayne County,10,0,20628,10262,10366
Kentucky,Wayne County,10,1,1185,641,544
Kentucky,Wayne County,10,2,1145,563,582
Kentucky,Wayne County,10,3,1189,612,577
Kentucky,Wayne County,10,4,1184,607,577
Kentucky,Wayne County,10,5,1120,594,526
Kentucky,Wayne County,10,6,1301,652,649
Kentucky,Wayne County,10,7,1097,550,547
Kentucky,Wayne County,10,8,1234,642,592
Kentucky,Wayne County,10,9,1176,598,578
Kentucky,Wayne County,10,10,1385,713,672
Kentucky,Wayne County,10,11,1412,678,734
Kentucky,Wayne County,10,12,1509,726,783
Kentucky,Wayne County,10,13,1505,732,773
Kentucky,Wayne County,10,14,1375,696,679
Kentucky,Wayne County,10,15,1109,495,614
Kentucky,Wayne County,10,16,818,386,432
Kentucky,Wayne County,10,17,496,216,280
Kentucky,Wayne County,10,18,388,161,227
Kentucky,Wayne County,11,0,20430,10158,10272
Kentucky,Wayne County,11,1,1116,596,520
Kentucky,Wayne County,11,2,1177,595,582
Kentucky,Wayne County,11,3,1175,589,586
Kentucky,Wayne County,11,4,1140,596,544
Kentucky,Wayne County,11,5,1069,559,510
Kentucky,Wayne County,11,6,1254,622,632
Kentucky,Wayne County,11,7,1114,564,550
Kentucky,Wayne County,11,8,1174,616,558
Kentucky,Wayne County,11,9,1166,602,564
Kentucky,Wayne County,11,10,1377,700,677
Kentucky,Wayne County,11,11,1375,674,701
Kentucky,Wayne County,11,12,1482,693,789
Kentucky,Wayne County,11,13,1513,733,780
Kentucky,Wayne County,11,14,1384,702,682
Kentucky,Wayne County,11,15,1130,510,620
Kentucky,Wayne County,11,16,834,386,448
Kentucky,Wayne County,11,17,543,250,293
Kentucky,Wayne County,11,18,407,171,236
Kentucky,Wayne County,12,0,20333,10125,10208
Kentucky,Wayne County,12,1,1119,599,520
Kentucky,Wayne County,12,2,1151,581,570
Kentucky,Wayne County,12,3,1144,576,568
Kentucky,Wayne County,12,4,1112,582,530
Kentucky,Wayne County,12,5,1060,567,493
Kentucky,Wayne County,12,6,1259,620,639
Kentucky,Wayne County,12,7,1121,601,520
Kentucky,Wayne County,12,8,1113,566,547
Kentucky,Wayne County,12,9,1186,596,590
Kentucky,Wayne County,12,10,1284,658,626
Kentucky,Wayne County,12,11,1373,685,688
Kentucky,Wayne County,12,12,1481,688,793
Kentucky,Wayne County,12,13,1497,715,782
Kentucky,Wayne County,12,14,1388,701,687
Kentucky,Wayne County,12,15,1172,529,643
Kentucky,Wayne County,12,16,864,411,453
Kentucky,Wayne County,12,17,581,270,311
Kentucky,Wayne County,12,18,428,180,248
Kentucky,Webster County,1,0,13621,6765,6856
Kentucky,Webster County,1,1,921,484,437
Kentucky,Webster County,1,2,858,419,439
Kentucky,Webster County,1,3,859,432,427
Kentucky,Webster County,1,4,886,438,448
Kentucky,Webster County,1,5,791,409,382
Kentucky,Webster County,1,6,789,422,367
Kentucky,Webster County,1,7,837,454,383
Kentucky,Webster County,1,8,852,441,411
Kentucky,Webster County,1,9,932,460,472
Kentucky,Webster County,1,10,953,463,490
Kentucky,Webster County,1,11,1037,532,505
Kentucky,Webster County,1,12,1044,527,517
Kentucky,Webster County,1,13,802,392,410
Kentucky,Webster County,1,14,619,314,305
Kentucky,Webster County,1,15,523,249,274
Kentucky,Webster County,1,16,361,142,219
Kentucky,Webster County,1,17,286,107,179
Kentucky,Webster County,1,18,271,80,191
Kentucky,Webster County,2,0,13621,6765,6856
Kentucky,Webster County,2,1,921,484,437
Kentucky,Webster County,2,2,858,419,439
Kentucky,Webster County,2,3,859,432,427
Kentucky,Webster County,2,4,886,438,448
Kentucky,Webster County,2,5,791,409,382
Kentucky,Webster County,2,6,789,422,367
Kentucky,Webster County,2,7,837,454,383
Kentucky,Webster County,2,8,852,441,411
Kentucky,Webster County,2,9,932,460,472
Kentucky,Webster County,2,10,953,463,490
Kentucky,Webster County,2,11,1037,532,505
Kentucky,Webster County,2,12,1044,527,517
Kentucky,Webster County,2,13,802,392,410
Kentucky,Webster County,2,14,619,314,305
Kentucky,Webster County,2,15,523,249,274
Kentucky,Webster County,2,16,361,142,219
Kentucky,Webster County,2,17,286,107,179
Kentucky,Webster County,2,18,271,80,191
Kentucky,Webster County,3,0,13579,6751,6828
Kentucky,Webster County,3,1,913,482,431
Kentucky,Webster County,3,2,863,421,442
Kentucky,Webster County,3,3,861,432,429
Kentucky,Webster County,3,4,857,427,430
Kentucky,Webster County,3,5,795,410,385
Kentucky,Webster County,3,6,780,413,367
Kentucky,Webster County,3,7,845,460,385
Kentucky,Webster County,3,8,850,443,407
Kentucky,Webster County,3,9,927,459,468
Kentucky,Webster County,3,10,950,463,487
Kentucky,Webster County,3,11,1025,520,505
Kentucky,Webster County,3,12,1041,524,517
Kentucky,Webster County,3,13,825,407,418
Kentucky,Webster County,3,14,619,315,304
Kentucky,Webster County,3,15,514,242,272
Kentucky,Webster County,3,16,361,145,216
Kentucky,Webster County,3,17,279,105,174
Kentucky,Webster County,3,18,274,83,191
Kentucky,Webster County,4,0,13528,6714,6814
Kentucky,Webster County,4,1,917,476,441
Kentucky,Webster County,4,2,869,426,443
Kentucky,Webster County,4,3,862,429,433
Kentucky,Webster County,4,4,800,406,394
Kentucky,Webster County,4,5,815,412,403
Kentucky,Webster County,4,6,755,395,360
Kentucky,Webster County,4,7,853,460,393
Kentucky,Webster County,4,8,830,430,400
Kentucky,Webster County,4,9,923,471,452
Kentucky,Webster County,4,10,925,450,475
Kentucky,Webster County,4,11,1017,501,516
Kentucky,Webster County,4,12,1027,514,513
Kentucky,Webster County,4,13,914,455,459
Kentucky,Webster County,4,14,622,323,299
Kentucky,Webster County,4,15,500,235,265
Kentucky,Webster County,4,16,364,154,210
Kentucky,Webster County,4,17,257,91,166
Kentucky,Webster County,4,18,278,86,192
Kentucky,Webster County,5,0,13460,6663,6797
Kentucky,Webster County,5,1,866,429,437
Kentucky,Webster County,5,2,870,438,432
Kentucky,Webster County,5,3,874,426,448
Kentucky,Webster County,5,4,761,382,379
Kentucky,Webster County,5,5,836,424,412
Kentucky,Webster County,5,6,787,405,382
Kentucky,Webster County,5,7,813,425,388
Kentucky,Webster County,5,8,834,455,379
Kentucky,Webster County,5,9,918,467,451
Kentucky,Webster County,5,10,907,449,458
Kentucky,Webster County,5,11,1019,491,528
Kentucky,Webster County,5,12,1019,504,515
Kentucky,Webster County,5,13,887,443,444
Kentucky,Webster County,5,14,668,348,320
Kentucky,Webster County,5,15,504,241,263
Kentucky,Webster County,5,16,363,149,214
Kentucky,Webster County,5,17,255,99,156
Kentucky,Webster County,5,18,279,88,191
Kentucky,Webster County,6,0,13357,6618,6739
Kentucky,Webster County,6,1,838,405,433
Kentucky,Webster County,6,2,892,451,441
Kentucky,Webster County,6,3,839,423,416
Kentucky,Webster County,6,4,759,372,387
Kentucky,Webster County,6,5,848,445,403
Kentucky,Webster County,6,6,778,398,380
Kentucky,Webster County,6,7,811,419,392
Kentucky,Webster County,6,8,832,454,378
Kentucky,Webster County,6,9,895,452,443
Kentucky,Webster County,6,10,886,441,445
Kentucky,Webster County,6,11,962,463,499
Kentucky,Webster County,6,12,1014,503,511
Kentucky,Webster County,6,13,903,453,450
Kentucky,Webster County,6,14,673,339,334
Kentucky,Webster County,6,15,527,263,264
Kentucky,Webster County,6,16,376,153,223
Kentucky,Webster County,6,17,249,97,152
Kentucky,Webster County,6,18,275,87,188
Kentucky,Webster County,7,0,13184,6524,6660
Kentucky,Webster County,7,1,797,393,404
Kentucky,Webster County,7,2,912,463,449
Kentucky,Webster County,7,3,821,388,433
Kentucky,Webster County,7,4,742,365,377
Kentucky,Webster County,7,5,799,439,360
Kentucky,Webster County,7,6,769,378,391
Kentucky,Webster County,7,7,800,425,375
Kentucky,Webster County,7,8,807,439,368
Kentucky,Webster County,7,9,860,452,408
Kentucky,Webster County,7,10,891,432,459
Kentucky,Webster County,7,11,937,438,499
Kentucky,Webster County,7,12,981,506,475
Kentucky,Webster County,7,13,929,450,479
Kentucky,Webster County,7,14,695,343,352
Kentucky,Webster County,7,15,528,268,260
Kentucky,Webster County,7,16,398,172,226
Kentucky,Webster County,7,17,240,88,152
Kentucky,Webster County,7,18,278,85,193
Kentucky,Webster County,8,0,13155,6513,6642
Kentucky,Webster County,8,1,778,374,404
Kentucky,Webster County,8,2,905,460,445
Kentucky,Webster County,8,3,842,403,439
Kentucky,Webster County,8,4,734,353,381
Kentucky,Webster County,8,5,764,399,365
Kentucky,Webster County,8,6,817,428,389
Kentucky,Webster County,8,7,762,407,355
Kentucky,Webster County,8,8,845,455,390
Kentucky,Webster County,8,9,829,432,397
Kentucky,Webster County,8,10,877,426,451
Kentucky,Webster County,8,11,920,436,484
Kentucky,Webster County,8,12,985,502,483
Kentucky,Webster County,8,13,936,459,477
Kentucky,Webster County,8,14,714,349,365
Kentucky,Webster County,8,15,524,270,254
Kentucky,Webster County,8,16,413,186,227
Kentucky,Webster County,8,17,246,93,153
Kentucky,Webster County,8,18,264,81,183
Kentucky,Webster County,9,0,13181,6495,6686
Kentucky,Webster County,9,1,787,372,415
Kentucky,Webster County,9,2,898,445,453
Kentucky,Webster County,9,3,864,420,444
Kentucky,Webster County,9,4,742,352,390
Kentucky,Webster County,9,5,745,393,352
Kentucky,Webster County,9,6,781,397,384
Kentucky,Webster County,9,7,792,413,379
Kentucky,Webster County,9,8,863,455,408
Kentucky,Webster County,9,9,818,433,385
Kentucky,Webster County,9,10,862,426,436
Kentucky,Webster County,9,11,880,421,459
Kentucky,Webster County,9,12,991,489,502
Kentucky,Webster County,9,13,931,457,474
Kentucky,Webster County,9,14,776,383,393
Kentucky,Webster County,9,15,511,270,241
Kentucky,Webster County,9,16,419,183,236
Kentucky,Webster County,9,17,252,102,150
Kentucky,Webster County,9,18,269,84,185
Kentucky,Webster County,10,0,13012,6423,6589
Kentucky,Webster County,10,1,817,394,423
Kentucky,Webster County,10,2,841,408,433
Kentucky,Webster County,10,3,840,426,414
Kentucky,Webster County,10,4,745,362,383
Kentucky,Webster County,10,5,693,369,324
Kentucky,Webster County,10,6,806,416,390
Kentucky,Webster County,10,7,779,404,375
Kentucky,Webster County,10,8,837,435,402
Kentucky,Webster County,10,9,802,427,375
Kentucky,Webster County,10,10,849,420,429
Kentucky,Webster County,10,11,851,423,428
Kentucky,Webster County,10,12,958,458,500
Kentucky,Webster County,10,13,949,460,489
Kentucky,Webster County,10,14,766,376,390
Kentucky,Webster County,10,15,561,283,278
Kentucky,Webster County,10,16,402,180,222
Kentucky,Webster County,10,17,258,94,164
Kentucky,Webster County,10,18,258,88,170
Kentucky,Webster County,11,0,13051,6463,6588
Kentucky,Webster County,11,1,864,401,463
Kentucky,Webster County,11,2,822,430,392
Kentucky,Webster County,11,3,883,442,441
Kentucky,Webster County,11,4,705,348,357
Kentucky,Webster County,11,5,684,355,329
Kentucky,Webster County,11,6,848,446,402
Kentucky,Webster County,11,7,773,406,367
Kentucky,Webster County,11,8,820,435,385
Kentucky,Webster County,11,9,815,425,390
Kentucky,Webster County,11,10,840,419,421
Kentucky,Webster County,11,11,854,427,427
Kentucky,Webster County,11,12,911,430,481
Kentucky,Webster County,11,13,950,465,485
Kentucky,Webster County,11,14,782,387,395
Kentucky,Webster County,11,15,575,278,297
Kentucky,Webster County,11,16,399,182,217
Kentucky,Webster County,11,17,270,96,174
Kentucky,Webster County,11,18,256,91,165
Kentucky,Webster County,12,0,12942,6409,6533
Kentucky,Webster County,12,1,869,425,444
Kentucky,Webster County,12,2,800,394,406
Kentucky,Webster County,12,3,874,439,435
Kentucky,Webster County,12,4,710,359,351
Kentucky,Webster County,12,5,681,353,328
Kentucky,Webster County,12,6,796,425,371
Kentucky,Webster County,12,7,767,400,367
Kentucky,Webster County,12,8,812,424,388
Kentucky,Webster County,12,9,821,441,380
Kentucky,Webster County,12,10,798,404,394
Kentucky,Webster County,12,11,861,426,435
Kentucky,Webster County,12,12,900,419,481
Kentucky,Webster County,12,13,910,462,448
Kentucky,Webster County,12,14,818,391,427
Kentucky,Webster County,12,15,596,279,317
Kentucky,Webster County,12,16,385,177,208
Kentucky,Webster County,12,17,298,103,195
Kentucky,Webster County,12,18,246,88,158
Kentucky,Whitley County,1,0,35637,17328,18309
Kentucky,Whitley County,1,1,2164,1102,1062
Kentucky,Whitley County,1,2,2312,1182,1130
Kentucky,Whitley County,1,3,2461,1265,1196
Kentucky,Whitley County,1,4,2899,1428,1471
Kentucky,Whitley County,1,5,2611,1301,1310
Kentucky,Whitley County,1,6,1941,940,1001
Kentucky,Whitley County,1,7,2117,1048,1069
Kentucky,Whitley County,1,8,2160,1057,1103
Kentucky,Whitley County,1,9,2412,1144,1268
Kentucky,Whitley County,1,10,2536,1268,1268
Kentucky,Whitley County,1,11,2504,1208,1296
Kentucky,Whitley County,1,12,2281,1123,1158
Kentucky,Whitley County,1,13,2155,1039,1116
Kentucky,Whitley County,1,14,1701,774,927
Kentucky,Whitley County,1,15,1308,631,677
Kentucky,Whitley County,1,16,891,371,520
Kentucky,Whitley County,1,17,655,269,386
Kentucky,Whitley County,1,18,529,178,351
Kentucky,Whitley County,2,0,35633,17327,18306
Kentucky,Whitley County,2,1,2164,1102,1062
Kentucky,Whitley County,2,2,2311,1182,1129
Kentucky,Whitley County,2,3,2460,1265,1195
Kentucky,Whitley County,2,4,2899,1428,1471
Kentucky,Whitley County,2,5,2611,1301,1310
Kentucky,Whitley County,2,6,1940,940,1000
Kentucky,Whitley County,2,7,2116,1047,1069
Kentucky,Whitley County,2,8,2160,1057,1103
Kentucky,Whitley County,2,9,2412,1144,1268
Kentucky,Whitley County,2,10,2536,1268,1268
Kentucky,Whitley County,2,11,2504,1208,1296
Kentucky,Whitley County,2,12,2281,1123,1158
Kentucky,Whitley County,2,13,2155,1039,1116
Kentucky,Whitley County,2,14,1701,774,927
Kentucky,Whitley County,2,15,1308,631,677
Kentucky,Whitley County,2,16,891,371,520
Kentucky,Whitley County,2,17,655,269,386
Kentucky,Whitley County,2,18,529,178,351
Kentucky,Whitley County,3,0,35718,17368,18350
Kentucky,Whitley County,3,1,2177,1101,1076
Kentucky,Whitley County,3,2,2295,1179,1116
Kentucky,Whitley County,3,3,2451,1258,1193
Kentucky,Whitley County,3,4,2901,1431,1470
Kentucky,Whitley County,3,5,2677,1337,1340
Kentucky,Whitley County,3,6,1945,946,999
Kentucky,Whitley County,3,7,2115,1046,1069
Kentucky,Whitley County,3,8,2152,1051,1101
Kentucky,Whitley County,3,9,2395,1139,1256
Kentucky,Whitley County,3,10,2534,1261,1273
Kentucky,Whitley County,3,11,2495,1200,1295
Kentucky,Whitley County,3,12,2315,1139,1176
Kentucky,Whitley County,3,13,2164,1046,1118
Kentucky,Whitley County,3,14,1701,777,924
Kentucky,Whitley County,3,15,1319,633,686
Kentucky,Whitley County,3,16,890,374,516
Kentucky,Whitley County,3,17,661,271,390
Kentucky,Whitley County,3,18,531,179,352
Kentucky,Whitley County,4,0,35854,17446,18408
Kentucky,Whitley County,4,1,2273,1122,1151
Kentucky,Whitley County,4,2,2295,1202,1093
Kentucky,Whitley County,4,3,2375,1228,1147
Kentucky,Whitley County,4,4,2841,1419,1422
Kentucky,Whitley County,4,5,2826,1435,1391
Kentucky,Whitley County,4,6,1973,955,1018
Kentucky,Whitley County,4,7,2085,1040,1045
Kentucky,Whitley County,4,8,2145,1033,1112
Kentucky,Whitley County,4,9,2323,1116,1207
Kentucky,Whitley County,4,10,2495,1228,1267
Kentucky,Whitley County,4,11,2473,1187,1286
Kentucky,Whitley County,4,12,2376,1155,1221
Kentucky,Whitley County,4,13,2229,1079,1150
Kentucky,Whitley County,4,14,1695,799,896
Kentucky,Whitley County,4,15,1346,628,718
Kentucky,Whitley County,4,16,885,380,505
Kentucky,Whitley County,4,17,667,262,405
Kentucky,Whitley County,4,18,552,178,374
Kentucky,Whitley County,5,0,35768,17432,18336
Kentucky,Whitley County,5,1,2336,1176,1160
Kentucky,Whitley County,5,2,2277,1205,1072
Kentucky,Whitley County,5,3,2367,1194,1173
Kentucky,Whitley County,5,4,2766,1398,1368
Kentucky,Whitley County,5,5,2878,1467,1411
Kentucky,Whitley County,5,6,2021,992,1029
Kentucky,Whitley County,5,7,2059,1021,1038
Kentucky,Whitley County,5,8,2055,989,1066
Kentucky,Whitley County,5,9,2278,1092,1186
Kentucky,Whitley County,5,10,2444,1192,1252
Kentucky,Whitley County,5,11,2426,1180,1246
Kentucky,Whitley County,5,12,2405,1165,1240
Kentucky,Whitley County,5,13,2149,1036,1113
Kentucky,Whitley County,5,14,1802,862,940
Kentucky,Whitley County,5,15,1412,653,759
Kentucky,Whitley County,5,16,891,377,514
Kentucky,Whitley County,5,17,654,255,399
Kentucky,Whitley County,5,18,548,178,370
Kentucky,Whitley County,6,0,35870,17539,18331
Kentucky,Whitley County,6,1,2394,1203,1191
Kentucky,Whitley County,6,2,2283,1223,1060
Kentucky,Whitley County,6,3,2386,1211,1175
Kentucky,Whitley County,6,4,2735,1398,1337
Kentucky,Whitley County,6,5,2896,1468,1428
Kentucky,Whitley County,6,6,2047,1005,1042
Kentucky,Whitley County,6,7,2079,1036,1043
Kentucky,Whitley County,6,8,2065,1021,1044
Kentucky,Whitley County,6,9,2220,1074,1146
Kentucky,Whitley County,6,10,2448,1175,1273
Kentucky,Whitley County,6,11,2374,1166,1208
Kentucky,Whitley County,6,12,2401,1143,1258
Kentucky,Whitley County,6,13,2108,1026,1082
Kentucky,Whitley County,6,14,1843,884,959
Kentucky,Whitley County,6,15,1453,664,789
Kentucky,Whitley County,6,16,955,418,537
Kentucky,Whitley County,6,17,618,235,383
Kentucky,Whitley County,6,18,565,189,376
Kentucky,Whitley County,7,0,35833,17617,18216
Kentucky,Whitley County,7,1,2569,1334,1235
Kentucky,Whitley County,7,2,2254,1187,1067
Kentucky,Whitley County,7,3,2370,1228,1142
Kentucky,Whitley County,7,4,2681,1368,1313
Kentucky,Whitley County,7,5,2953,1482,1471
Kentucky,Whitley County,7,6,2105,1065,1040
Kentucky,Whitley County,7,7,1988,984,1004
Kentucky,Whitley County,7,8,2073,1024,1049
Kentucky,Whitley County,7,9,2139,1053,1086
Kentucky,Whitley County,7,10,2354,1112,1242
Kentucky,Whitley County,7,11,2392,1194,1198
Kentucky,Whitley County,7,12,2329,1101,1228
Kentucky,Whitley County,7,13,2112,1038,1074
Kentucky,Whitley County,7,14,1890,910,980
Kentucky,Whitley County,7,15,1446,658,788
Kentucky,Whitley County,7,16,995,446,549
Kentucky,Whitley County,7,17,618,235,383
Kentucky,Whitley County,7,18,565,198,367
Kentucky,Whitley County,8,0,36109,17798,18311
Kentucky,Whitley County,8,1,2745,1470,1275
Kentucky,Whitley County,8,2,2317,1200,1117
Kentucky,Whitley County,8,3,2342,1224,1118
Kentucky,Whitley County,8,4,2730,1405,1325
Kentucky,Whitley County,8,5,2906,1498,1408
Kentucky,Whitley County,8,6,2177,1080,1097
Kentucky,Whitley County,8,7,1953,967,986
Kentucky,Whitley County,8,8,2123,1048,1075
Kentucky,Whitley County,8,9,2102,1026,1076
Kentucky,Whitley County,8,10,2273,1090,1183
Kentucky,Whitley County,8,11,2411,1171,1240
Kentucky,Whitley County,8,12,2325,1118,1207
Kentucky,Whitley County,8,13,2116,1023,1093
Kentucky,Whitley County,8,14,1904,919,985
Kentucky,Whitley County,8,15,1425,631,794
Kentucky,Whitley County,8,16,1047,486,561
Kentucky,Whitley County,8,17,640,252,388
Kentucky,Whitley County,8,18,573,190,383
Kentucky,Whitley County,9,0,36108,17772,18336
Kentucky,Whitley County,9,1,2741,1449,1292
Kentucky,Whitley County,9,2,2394,1190,1204
Kentucky,Whitley County,9,3,2369,1275,1094
Kentucky,Whitley County,9,4,2659,1380,1279
Kentucky,Whitley County,9,5,2843,1460,1383
Kentucky,Whitley County,9,6,2293,1146,1147
Kentucky,Whitley County,9,7,1965,967,998
Kentucky,Whitley County,9,8,2128,1063,1065
Kentucky,Whitley County,9,9,2079,999,1080
Kentucky,Whitley County,9,10,2231,1076,1155
Kentucky,Whitley County,9,11,2317,1121,1196
Kentucky,Whitley County,9,12,2282,1083,1199
Kentucky,Whitley County,9,13,2146,1025,1121
Kentucky,Whitley County,9,14,1947,949,998
Kentucky,Whitley County,9,15,1431,657,774
Kentucky,Whitley County,9,16,1045,472,573
Kentucky,Whitley County,9,17,655,263,392
Kentucky,Whitley County,9,18,583,197,386
Kentucky,Whitley County,10,0,36074,17691,18383
Kentucky,Whitley County,10,1,2771,1440,1331
Kentucky,Whitley County,10,2,2424,1223,1201
Kentucky,Whitley County,10,3,2397,1299,1098
Kentucky,Whitley County,10,4,2649,1342,1307
Kentucky,Whitley County,10,5,2761,1425,1336
Kentucky,Whitley County,10,6,2361,1170,1191
Kentucky,Whitley County,10,7,1999,976,1023
Kentucky,Whitley County,10,8,2053,1013,1040
Kentucky,Whitley County,10,9,2000,964,1036
Kentucky,Whitley County,10,10,2244,1087,1157
Kentucky,Whitley County,10,11,2263,1084,1179
Kentucky,Whitley County,10,12,2267,1101,1166
Kentucky,Whitley County,10,13,2205,1046,1159
Kentucky,Whitley County,10,14,1857,891,966
Kentucky,Whitley County,10,15,1497,702,795
Kentucky,Whitley County,10,16,1080,475,605
Kentucky,Whitley County,10,17,661,264,397
Kentucky,Whitley County,10,18,585,189,396
Kentucky,Whitley County,11,0,36101,17721,18380
Kentucky,Whitley County,11,1,2766,1426,1340
Kentucky,Whitley County,11,2,2502,1284,1218
Kentucky,Whitley County,11,3,2381,1277,1104
Kentucky,Whitley County,11,4,2661,1344,1317
Kentucky,Whitley County,11,5,2785,1454,1331
Kentucky,Whitley County,11,6,2378,1169,1209
Kentucky,Whitley County,11,7,1986,989,997
Kentucky,Whitley County,11,8,2057,1008,1049
Kentucky,Whitley County,11,9,1991,985,1006
Kentucky,Whitley County,11,10,2141,1042,1099
Kentucky,Whitley County,11,11,2286,1072,1214
Kentucky,Whitley County,11,12,2206,1074,1132
Kentucky,Whitley County,11,13,2221,1044,1177
Kentucky,Whitley County,11,14,1874,908,966
Kentucky,Whitley County,11,15,1469,684,785
Kentucky,Whitley County,11,16,1136,486,650
Kentucky,Whitley County,11,17,690,296,394
Kentucky,Whitley County,11,18,571,179,392
Kentucky,Whitley County,12,0,36264,17840,18424
Kentucky,Whitley County,12,1,2694,1379,1315
Kentucky,Whitley County,12,2,2608,1380,1228
Kentucky,Whitley County,12,3,2415,1265,1150
Kentucky,Whitley County,12,4,2703,1370,1333
Kentucky,Whitley County,12,5,2772,1455,1317
Kentucky,Whitley County,12,6,2411,1195,1216
Kentucky,Whitley County,12,7,2062,1008,1054
Kentucky,Whitley County,12,8,2015,998,1017
Kentucky,Whitley County,12,9,2037,1005,1032
Kentucky,Whitley County,12,10,2080,1022,1058
Kentucky,Whitley County,12,11,2225,1039,1186
Kentucky,Whitley County,12,12,2244,1108,1136
Kentucky,Whitley County,12,13,2183,1028,1155
Kentucky,Whitley County,12,14,1894,913,981
Kentucky,Whitley County,12,15,1502,714,788
Kentucky,Whitley County,12,16,1124,472,652
Kentucky,Whitley County,12,17,731,308,423
Kentucky,Whitley County,12,18,564,181,383
Kentucky,Wolfe County,1,0,7355,3608,3747
Kentucky,Wolfe County,1,1,480,259,221
Kentucky,Wolfe County,1,2,499,258,241
Kentucky,Wolfe County,1,3,483,234,249
Kentucky,Wolfe County,1,4,483,258,225
Kentucky,Wolfe County,1,5,331,166,165
Kentucky,Wolfe County,1,6,398,162,236
Kentucky,Wolfe County,1,7,473,235,238
Kentucky,Wolfe County,1,8,447,216,231
Kentucky,Wolfe County,1,9,467,230,237
Kentucky,Wolfe County,1,10,578,295,283
Kentucky,Wolfe County,1,11,583,293,290
Kentucky,Wolfe County,1,12,518,231,287
Kentucky,Wolfe County,1,13,470,264,206
Kentucky,Wolfe County,1,14,396,182,214
Kentucky,Wolfe County,1,15,301,141,160
Kentucky,Wolfe County,1,16,214,91,123
Kentucky,Wolfe County,1,17,127,55,72
Kentucky,Wolfe County,1,18,107,38,69
Kentucky,Wolfe County,2,0,7355,3607,3748
Kentucky,Wolfe County,2,1,480,259,221
Kentucky,Wolfe County,2,2,499,258,241
Kentucky,Wolfe County,2,3,484,234,250
Kentucky,Wolfe County,2,4,484,259,225
Kentucky,Wolfe County,2,5,330,166,164
Kentucky,Wolfe County,2,6,397,161,236
Kentucky,Wolfe County,2,7,473,235,238
Kentucky,Wolfe County,2,8,447,216,231
Kentucky,Wolfe County,2,9,467,229,238
Kentucky,Wolfe County,2,10,579,296,283
Kentucky,Wolfe County,2,11,583,293,290
Kentucky,Wolfe County,2,12,518,231,287
Kentucky,Wolfe County,2,13,470,264,206
Kentucky,Wolfe County,2,14,395,181,214
Kentucky,Wolfe County,2,15,301,141,160
Kentucky,Wolfe County,2,16,214,91,123
Kentucky,Wolfe County,2,17,127,55,72
Kentucky,Wolfe County,2,18,107,38,69
Kentucky,Wolfe County,3,0,7361,3608,3753
Kentucky,Wolfe County,3,1,479,254,225
Kentucky,Wolfe County,3,2,491,256,235
Kentucky,Wolfe County,3,3,490,233,257
Kentucky,Wolfe County,3,4,477,256,221
Kentucky,Wolfe County,3,5,336,169,167
Kentucky,Wolfe County,3,6,395,163,232
Kentucky,Wolfe County,3,7,466,233,233
Kentucky,Wolfe County,3,8,452,217,235
Kentucky,Wolfe County,3,9,466,231,235
Kentucky,Wolfe County,3,10,579,294,285
Kentucky,Wolfe County,3,11,577,288,289
Kentucky,Wolfe County,3,12,519,232,287
Kentucky,Wolfe County,3,13,476,269,207
Kentucky,Wolfe County,3,14,401,183,218
Kentucky,Wolfe County,3,15,299,141,158
Kentucky,Wolfe County,3,16,224,94,130
Kentucky,Wolfe County,3,17,127,57,70
Kentucky,Wolfe County,3,18,107,38,69
Kentucky,Wolfe County,4,0,7362,3627,3735
Kentucky,Wolfe County,4,1,495,274,221
Kentucky,Wolfe County,4,2,503,268,235
Kentucky,Wolfe County,4,3,493,234,259
Kentucky,Wolfe County,4,4,450,251,199
Kentucky,Wolfe County,4,5,355,175,180
Kentucky,Wolfe County,4,6,382,162,220
Kentucky,Wolfe County,4,7,459,230,229
Kentucky,Wolfe County,4,8,438,208,230
Kentucky,Wolfe County,4,9,440,223,217
Kentucky,Wolfe County,4,10,575,287,288
Kentucky,Wolfe County,4,11,578,284,294
Kentucky,Wolfe County,4,12,507,230,277
Kentucky,Wolfe County,4,13,506,277,229
Kentucky,Wolfe County,4,14,404,192,212
Kentucky,Wolfe County,4,15,292,139,153
Kentucky,Wolfe County,4,16,243,99,144
Kentucky,Wolfe County,4,17,136,61,75
Kentucky,Wolfe County,4,18,106,33,73
Kentucky,Wolfe County,5,0,7194,3528,3666
Kentucky,Wolfe County,5,1,438,240,198
Kentucky,Wolfe County,5,2,503,264,239
Kentucky,Wolfe County,5,3,485,238,247
Kentucky,Wolfe County,5,4,403,225,178
Kentucky,Wolfe County,5,5,364,189,175
Kentucky,Wolfe County,5,6,364,162,202
Kentucky,Wolfe County,5,7,439,210,229
Kentucky,Wolfe County,5,8,434,200,234
Kentucky,Wolfe County,5,9,412,209,203
Kentucky,Wolfe County,5,10,536,274,262
Kentucky,Wolfe County,5,11,601,286,315
Kentucky,Wolfe County,5,12,500,234,266
Kentucky,Wolfe County,5,13,491,251,240
Kentucky,Wolfe County,5,14,428,218,210
Kentucky,Wolfe County,5,15,291,127,164
Kentucky,Wolfe County,5,16,255,108,147
Kentucky,Wolfe County,5,17,142,61,81
Kentucky,Wolfe County,5,18,108,32,76
Kentucky,Wolfe County,6,0,7279,3554,3725
Kentucky,Wolfe County,6,1,439,230,209
Kentucky,Wolfe County,6,2,494,255,239
Kentucky,Wolfe County,6,3,528,266,262
Kentucky,Wolfe County,6,4,413,225,188
Kentucky,Wolfe County,6,5,385,206,179
Kentucky,Wolfe County,6,6,358,165,193
Kentucky,Wolfe County,6,7,448,200,248
Kentucky,Wolfe County,6,8,431,206,225
Kentucky,Wolfe County,6,9,421,200,221
Kentucky,Wolfe County,6,10,520,265,255
Kentucky,Wolfe County,6,11,593,291,302
Kentucky,Wolfe County,6,12,510,236,274
Kentucky,Wolfe County,6,13,498,255,243
Kentucky,Wolfe County,6,14,425,216,209
Kentucky,Wolfe County,6,15,306,133,173
Kentucky,Wolfe County,6,16,254,114,140
Kentucky,Wolfe County,6,17,146,59,87
Kentucky,Wolfe County,6,18,110,32,78
Kentucky,Wolfe County,7,0,7252,3559,3693
Kentucky,Wolfe County,7,1,443,239,204
Kentucky,Wolfe County,7,2,466,243,223
Kentucky,Wolfe County,7,3,503,249,254
Kentucky,Wolfe County,7,4,440,234,206
Kentucky,Wolfe County,7,5,384,203,181
Kentucky,Wolfe County,7,6,359,175,184
Kentucky,Wolfe County,7,7,416,187,229
Kentucky,Wolfe County,7,8,439,212,227
Kentucky,Wolfe County,7,9,412,202,210
Kentucky,Wolfe County,7,10,476,231,245
Kentucky,Wolfe County,7,11,577,291,286
Kentucky,Wolfe County,7,12,533,256,277
Kentucky,Wolfe County,7,13,508,244,264
Kentucky,Wolfe County,7,14,441,241,200
Kentucky,Wolfe County,7,15,335,147,188
Kentucky,Wolfe County,7,16,247,109,138
Kentucky,Wolfe County,7,17,160,62,98
Kentucky,Wolfe County,7,18,113,34,79
Kentucky,Wolfe County,8,0,7241,3549,3692
Kentucky,Wolfe County,8,1,445,231,214
Kentucky,Wolfe County,8,2,446,239,207
Kentucky,Wolfe County,8,3,495,251,244
Kentucky,Wolfe County,8,4,430,216,214
Kentucky,Wolfe County,8,5,367,188,179
Kentucky,Wolfe County,8,6,375,187,188
Kentucky,Wolfe County,8,7,416,181,235
Kentucky,Wolfe County,8,8,460,233,227
Kentucky,Wolfe County,8,9,421,211,210
Kentucky,Wolfe County,8,10,434,207,227
Kentucky,Wolfe County,8,11,575,288,287
Kentucky,Wolfe County,8,12,549,276,273
Kentucky,Wolfe County,8,13,501,223,278
Kentucky,Wolfe County,8,14,443,246,197
Kentucky,Wolfe County,8,15,361,162,199
Kentucky,Wolfe County,8,16,230,107,123
Kentucky,Wolfe County,8,17,168,60,108
Kentucky,Wolfe County,8,18,125,43,82
Kentucky,Wolfe County,9,0,7189,3511,3678
Kentucky,Wolfe County,9,1,428,223,205
Kentucky,Wolfe County,9,2,471,259,212
Kentucky,Wolfe County,9,3,483,246,237
Kentucky,Wolfe County,9,4,427,207,220
Kentucky,Wolfe County,9,5,346,180,166
Kentucky,Wolfe County,9,6,387,202,185
Kentucky,Wolfe County,9,7,406,165,241
Kentucky,Wolfe County,9,8,448,239,209
Kentucky,Wolfe County,9,9,427,198,229
Kentucky,Wolfe County,9,10,416,208,208
Kentucky,Wolfe County,9,11,558,269,289
Kentucky,Wolfe County,9,12,547,268,279
Kentucky,Wolfe County,9,13,485,217,268
Kentucky,Wolfe County,9,14,471,255,216
Kentucky,Wolfe County,9,15,364,168,196
Kentucky,Wolfe County,9,16,227,101,126
Kentucky,Wolfe County,9,17,177,66,111
Kentucky,Wolfe County,9,18,121,40,81
Kentucky,Wolfe County,10,0,7248,3544,3704
Kentucky,Wolfe County,10,1,465,242,223
Kentucky,Wolfe County,10,2,425,227,198
Kentucky,Wolfe County,10,3,507,262,245
Kentucky,Wolfe County,10,4,425,211,214
Kentucky,Wolfe County,10,5,350,184,166
Kentucky,Wolfe County,10,6,402,205,197
Kentucky,Wolfe County,10,7,384,166,218
Kentucky,Wolfe County,10,8,463,239,224
Kentucky,Wolfe County,10,9,445,209,236
Kentucky,Wolfe County,10,10,416,204,212
Kentucky,Wolfe County,10,11,518,260,258
Kentucky,Wolfe County,10,12,584,282,302
Kentucky,Wolfe County,10,13,487,229,258
Kentucky,Wolfe County,10,14,464,233,231
Kentucky,Wolfe County,10,15,376,188,188
Kentucky,Wolfe County,10,16,223,80,143
Kentucky,Wolfe County,10,17,183,85,98
Kentucky,Wolfe County,10,18,131,38,93
Kentucky,Wolfe County,11,0,7199,3522,3677
Kentucky,Wolfe County,11,1,454,240,214
Kentucky,Wolfe County,11,2,412,216,196
Kentucky,Wolfe County,11,3,484,253,231
Kentucky,Wolfe County,11,4,440,219,221
Kentucky,Wolfe County,11,5,347,184,163
Kentucky,Wolfe County,11,6,390,206,184
Kentucky,Wolfe County,11,7,375,173,202
Kentucky,Wolfe County,11,8,443,209,234
Kentucky,Wolfe County,11,9,454,219,235
Kentucky,Wolfe County,11,10,422,200,222
Kentucky,Wolfe County,11,11,509,256,253
Kentucky,Wolfe County,11,12,575,278,297
Kentucky,Wolfe County,11,13,496,232,264
Kentucky,Wolfe County,11,14,469,241,228
Kentucky,Wolfe County,11,15,374,184,190
Kentucky,Wolfe County,11,16,244,90,154
Kentucky,Wolfe County,11,17,166,79,87
Kentucky,Wolfe County,11,18,145,43,102
Kentucky,Wolfe County,12,0,7157,3503,3654
Kentucky,Wolfe County,12,1,477,246,231
Kentucky,Wolfe County,12,2,415,221,194
Kentucky,Wolfe County,12,3,440,233,207
Kentucky,Wolfe County,12,4,440,223,217
Kentucky,Wolfe County,12,5,358,186,172
Kentucky,Wolfe County,12,6,395,209,186
Kentucky,Wolfe County,12,7,375,183,192
Kentucky,Wolfe County,12,8,402,182,220
Kentucky,Wolfe County,12,9,458,226,232
Kentucky,Wolfe County,12,10,431,211,220
Kentucky,Wolfe County,12,11,461,212,249
Kentucky,Wolfe County,12,12,571,277,294
Kentucky,Wolfe County,12,13,512,244,268
Kentucky,Wolfe County,12,14,472,227,245
Kentucky,Wolfe County,12,15,372,201,171
Kentucky,Wolfe County,12,16,291,112,179
Kentucky,Wolfe County,12,17,155,70,85
Kentucky,Wolfe County,12,18,132,40,92
Kentucky,Woodford County,1,0,24939,11969,12970
Kentucky,Woodford County,1,1,1435,733,702
Kentucky,Woodford County,1,2,1708,851,857
Kentucky,Woodford County,1,3,1735,847,888
Kentucky,Woodford County,1,4,1705,812,893
Kentucky,Woodford County,1,5,1218,556,662
Kentucky,Woodford County,1,6,1299,620,679
Kentucky,Woodford County,1,7,1389,688,701
Kentucky,Woodford County,1,8,1622,798,824
Kentucky,Woodford County,1,9,1736,838,898
Kentucky,Woodford County,1,10,2125,999,1126
Kentucky,Woodford County,1,11,2154,1046,1108
Kentucky,Woodford County,1,12,1910,926,984
Kentucky,Woodford County,1,13,1662,844,818
Kentucky,Woodford County,1,14,1129,527,602
Kentucky,Woodford County,1,15,785,368,417
Kentucky,Woodford County,1,16,564,236,328
Kentucky,Woodford County,1,17,415,161,254
Kentucky,Woodford County,1,18,348,119,229
Kentucky,Woodford County,2,0,24946,11974,12972
Kentucky,Woodford County,2,1,1435,733,702
Kentucky,Woodford County,2,2,1708,851,857
Kentucky,Woodford County,2,3,1733,847,886
Kentucky,Woodford County,2,4,1706,813,893
Kentucky,Woodford County,2,5,1218,556,662
Kentucky,Woodford County,2,6,1301,621,680
Kentucky,Woodford County,2,7,1389,688,701
Kentucky,Woodford County,2,8,1622,798,824
Kentucky,Woodford County,2,9,1736,838,898
Kentucky,Woodford County,2,10,2126,1000,1126
Kentucky,Woodford County,2,11,2154,1046,1108
Kentucky,Woodford County,2,12,1915,928,987
Kentucky,Woodford County,2,13,1662,844,818
Kentucky,Woodford County,2,14,1129,527,602
Kentucky,Woodford County,2,15,785,368,417
Kentucky,Woodford County,2,16,564,236,328
Kentucky,Woodford County,2,17,415,161,254
Kentucky,Woodford County,2,18,348,119,229
Kentucky,Woodford County,3,0,25040,12013,13027
Kentucky,Woodford County,3,1,1460,746,714
Kentucky,Woodford County,3,2,1707,854,853
Kentucky,Woodford County,3,3,1730,848,882
Kentucky,Woodford County,3,4,1721,815,906
Kentucky,Woodford County,3,5,1230,557,673
Kentucky,Woodford County,3,6,1310,630,680
Kentucky,Woodford County,3,7,1388,685,703
Kentucky,Woodford County,3,8,1605,787,818
Kentucky,Woodford County,3,9,1743,843,900
Kentucky,Woodford County,3,10,2107,994,1113
Kentucky,Woodford County,3,11,2148,1039,1109
Kentucky,Woodford County,3,12,1932,930,1002
Kentucky,Woodford County,3,13,1689,865,824
Kentucky,Woodford County,3,14,1142,529,613
Kentucky,Woodford County,3,15,791,369,422
Kentucky,Woodford County,3,16,569,241,328
Kentucky,Woodford County,3,17,414,159,255
Kentucky,Woodford County,3,18,354,122,232
Kentucky,Woodford County,4,0,24944,11998,12946
Kentucky,Woodford County,4,1,1443,727,716
Kentucky,Woodford County,4,2,1610,808,802
Kentucky,Woodford County,4,3,1723,854,869
Kentucky,Woodford County,4,4,1702,794,908
Kentucky,Woodford County,4,5,1271,606,665
Kentucky,Woodford County,4,6,1254,641,613
Kentucky,Woodford County,4,7,1376,672,704
Kentucky,Woodford County,4,8,1502,739,763
Kentucky,Woodford County,4,9,1782,869,913
Kentucky,Woodford County,4,10,2026,948,1078
Kentucky,Woodford County,4,11,2132,1023,1109
Kentucky,Woodford County,4,12,1948,917,1031
Kentucky,Woodford County,4,13,1807,942,865
Kentucky,Woodford County,4,14,1169,541,628
Kentucky,Woodford County,4,15,822,377,445
Kentucky,Woodford County,4,16,593,256,337
Kentucky,Woodford County,4,17,409,152,257
Kentucky,Woodford County,4,18,375,132,243
Kentucky,Woodford County,5,0,25117,12056,13061
Kentucky,Woodford County,5,1,1408,700,708
Kentucky,Woodford County,5,2,1566,774,792
Kentucky,Woodford County,5,3,1752,862,890
Kentucky,Woodford County,5,4,1737,820,917
Kentucky,Woodford County,5,5,1354,632,722
Kentucky,Woodford County,5,6,1226,639,587
Kentucky,Woodford County,5,7,1363,667,696
Kentucky,Woodford County,5,8,1484,729,755
Kentucky,Woodford County,5,9,1787,870,917
Kentucky,Woodford County,5,10,1921,898,1023
Kentucky,Woodford County,5,11,2143,1038,1105
Kentucky,Woodford County,5,12,1961,929,1032
Kentucky,Woodford County,5,13,1812,911,901
Kentucky,Woodford County,5,14,1316,632,684
Kentucky,Woodford County,5,15,861,398,463
Kentucky,Woodford County,5,16,619,271,348
Kentucky,Woodford County,5,17,417,158,259
Kentucky,Woodford County,5,18,390,128,262
Kentucky,Woodford County,6,0,25345,12160,13185
Kentucky,Woodford County,6,1,1400,692,708
Kentucky,Woodford County,6,2,1568,759,809
Kentucky,Woodford County,6,3,1750,886,864
Kentucky,Woodford County,6,4,1729,819,910
Kentucky,Woodford County,6,5,1383,644,739
Kentucky,Woodford County,6,6,1265,656,609
Kentucky,Woodford County,6,7,1405,680,725
Kentucky,Woodford County,6,8,1503,731,772
Kentucky,Woodford County,6,9,1753,868,885
Kentucky,Woodford County,6,10,1841,865,976
Kentucky,Woodford County,6,11,2143,1041,1102
Kentucky,Woodford County,6,12,1955,929,1026
Kentucky,Woodford County,6,13,1847,895,952
Kentucky,Woodford County,6,14,1398,685,713
Kentucky,Woodford County,6,15,933,425,508
Kentucky,Woodford County,6,16,654,296,358
Kentucky,Woodford County,6,17,420,161,259
Kentucky,Woodford County,6,18,398,128,270
Kentucky,Woodford County,7,0,25586,12288,13298
Kentucky,Woodford County,7,1,1460,723,737
Kentucky,Woodford County,7,2,1514,721,793
Kentucky,Woodford County,7,3,1795,901,894
Kentucky,Woodford County,7,4,1695,807,888
Kentucky,Woodford County,7,5,1416,655,761
Kentucky,Woodford County,7,6,1235,606,629
Kentucky,Woodford County,7,7,1470,743,727
Kentucky,Woodford County,7,8,1542,775,767
Kentucky,Woodford County,7,9,1674,817,857
Kentucky,Woodford County,7,10,1763,849,914
Kentucky,Woodford County,7,11,2143,1049,1094
Kentucky,Woodford County,7,12,2011,958,1053
Kentucky,Woodford County,7,13,1848,868,980
Kentucky,Woodford County,7,14,1516,759,757
Kentucky,Woodford County,7,15,979,448,531
Kentucky,Woodford County,7,16,691,314,377
Kentucky,Woodford County,7,17,437,163,274
Kentucky,Woodford County,7,18,397,132,265
Kentucky,Woodford County,8,0,25860,12437,13423
Kentucky,Woodford County,8,1,1470,741,729
Kentucky,Woodford County,8,2,1567,770,797
Kentucky,Woodford County,8,3,1716,849,867
Kentucky,Woodford County,8,4,1712,812,900
Kentucky,Woodford County,8,5,1501,679,822
Kentucky,Woodford County,8,6,1203,591,612
Kentucky,Woodford County,8,7,1473,739,734
Kentucky,Woodford County,8,8,1543,762,781
Kentucky,Woodford County,8,9,1645,809,836
Kentucky,Woodford County,8,10,1745,856,889
Kentucky,Woodford County,8,11,2092,1008,1084
Kentucky,Woodford County,8,12,2080,1009,1071
Kentucky,Woodford County,8,13,1865,876,989
Kentucky,Woodford County,8,14,1592,807,785
Kentucky,Woodford County,8,15,1084,497,587
Kentucky,Woodford County,8,16,700,312,388
Kentucky,Woodford County,8,17,462,178,284
Kentucky,Woodford County,8,18,410,142,268
Kentucky,Woodford County,9,0,26118,12582,13536
Kentucky,Woodford County,9,1,1503,769,734
Kentucky,Woodford County,9,2,1588,769,819
Kentucky,Woodford County,9,3,1707,854,853
Kentucky,Woodford County,9,4,1713,807,906
Kentucky,Woodford County,9,5,1443,666,777
Kentucky,Woodford County,9,6,1286,646,640
Kentucky,Woodford County,9,7,1413,703,710
Kentucky,Woodford County,9,8,1577,791,786
Kentucky,Woodford County,9,9,1610,802,808
Kentucky,Woodford County,9,10,1803,869,934
Kentucky,Woodford County,9,11,1964,944,1020
Kentucky,Woodford County,9,12,2106,1012,1094
Kentucky,Woodford County,9,13,1925,894,1031
Kentucky,Woodford County,9,14,1697,864,833
Kentucky,Woodford County,9,15,1115,519,596
Kentucky,Woodford County,9,16,749,324,425
Kentucky,Woodford County,9,17,495,207,288
Kentucky,Woodford County,9,18,424,142,282
Kentucky,Woodford County,10,0,26385,12668,13717
Kentucky,Woodford County,10,1,1541,811,730
Kentucky,Woodford County,10,2,1611,778,833
Kentucky,Woodford County,10,3,1677,830,847
Kentucky,Woodford County,10,4,1738,805,933
Kentucky,Woodford County,10,5,1524,671,853
Kentucky,Woodford County,10,6,1314,661,653
Kentucky,Woodford County,10,7,1358,679,679
Kentucky,Woodford County,10,8,1595,793,802
Kentucky,Woodford County,10,9,1609,805,804
Kentucky,Woodford County,10,10,1792,868,924
Kentucky,Woodford County,10,11,1889,901,988
Kentucky,Woodford County,10,12,2110,1014,1096
Kentucky,Woodford County,10,13,1922,912,1010
Kentucky,Woodford County,10,14,1718,837,881
Kentucky,Woodford County,10,15,1248,596,652
Kentucky,Woodford County,10,16,781,346,435
Kentucky,Woodford County,10,17,518,221,297
Kentucky,Woodford County,10,18,440,140,300
Kentucky,Woodford County,11,0,26491,12723,13768
Kentucky,Woodford County,11,1,1524,807,717
Kentucky,Woodford County,11,2,1592,793,799
Kentucky,Woodford County,11,3,1670,806,864
Kentucky,Woodford County,11,4,1695,793,902
Kentucky,Woodford County,11,5,1497,670,827
Kentucky,Woodford County,11,6,1354,662,692
Kentucky,Woodford County,11,7,1364,692,672
Kentucky,Woodford County,11,8,1585,774,811
Kentucky,Woodford County,11,9,1628,824,804
Kentucky,Woodford County,11,10,1751,863,888
Kentucky,Woodford County,11,11,1807,850,957
Kentucky,Woodford County,11,12,2143,1035,1108
Kentucky,Woodford County,11,13,1932,918,1014
Kentucky,Woodford County,11,14,1772,834,938
Kentucky,Woodford County,11,15,1332,652,680
Kentucky,Woodford County,11,16,828,366,462
Kentucky,Woodford County,11,17,562,237,325
Kentucky,Woodford County,11,18,455,147,308
Kentucky,Woodford County,12,0,26734,12826,13908
Kentucky,Woodford County,12,1,1461,786,675
Kentucky,Woodford County,12,2,1652,833,819
Kentucky,Woodford County,12,3,1648,800,848
Kentucky,Woodford County,12,4,1769,827,942
Kentucky,Woodford County,12,5,1533,649,884
Kentucky,Woodford County,12,6,1343,657,686
Kentucky,Woodford County,12,7,1373,693,680
Kentucky,Woodford County,12,8,1611,798,813
Kentucky,Woodford County,12,9,1672,835,837
Kentucky,Woodford County,12,10,1675,832,843
Kentucky,Woodford County,12,11,1701,815,886
Kentucky,Woodford County,12,12,2111,1019,1092
Kentucky,Woodford County,12,13,2005,955,1050
Kentucky,Woodford County,12,14,1788,826,962
Kentucky,Woodford County,12,15,1448,710,738
Kentucky,Woodford County,12,16,878,393,485
Kentucky,Woodford County,12,17,568,231,337
Kentucky,Woodford County,12,18,498,167,331
