Area,AreaName,Year,AgeGroup,Total,Male,Female
000,Alaska,2010,0,710231,369628,340603
000,Alaska,2010,1,53996,27896,26100
000,Alaska,2010,2,50887,26038,24849
000,Alaska,2010,3,50816,26147,24669
000,Alaska,2010,4,52141,27179,24962
000,Alaska,2010,5,54419,29706,24713
000,Alaska,2010,6,55419,29307,26112
000,Alaska,2010,7,47706,24861,22845
000,Alaska,2010,8,45833,23731,22102
000,Alaska,2010,9,47141,24646,22495
000,Alaska,2010,10,54726,28398,26328
000,Alaska,2010,11,56300,29288,27012
000,Alaska,2010,12,49971,26394,23577
000,Alaska,2010,13,35938,19231,16707
000,Alaska,2010,14,22202,11714,10488
000,Alaska,2010,15,13148,6662,6486
000,Alaska,2010,16,8892,4150,4742
000,Alaska,2010,17,5985,2620,3365
000,Alaska,2010,18,4711,1660,3051
013,Aleutians East Borough,2010,0,3141,2093,1048
013,Aleutians East Borough,2010,1,123,68,55
013,Aleutians East Borough,2010,2,105,55,50
013,Aleutians East Borough,2010,3,88,40,48
013,Aleutians East Borough,2010,4,104,63,41
013,Aleutians East Borough,2010,5,249,187,62
013,Aleutians East Borough,2010,6,301,208,93
013,Aleutians East Borough,2010,7,213,144,69
013,Aleutians East Borough,2010,8,242,182,60
013,Aleutians East Borough,2010,9,355,251,104
013,Aleutians East Borough,2010,10,431,299,132
013,Aleutians East Borough,2010,11,340,223,117
013,Aleutians East Borough,2010,12,264,174,90
013,Aleutians East Borough,2010,13,171,104,67
013,Aleutians East Borough,2010,14,75,46,29
013,Aleutians East Borough,2010,15,33,18,15
013,Aleutians East Borough,2010,16,25,14,11
013,Aleutians East Borough,2010,17,15,12,3
013,Aleutians East Borough,2010,18,7,5,2
016,Aleutians West Census Area,2010,0,5561,3723,1838
016,Aleutians West Census Area,2010,1,205,106,99
016,Aleutians West Census Area,2010,2,227,113,114
016,Aleutians West Census Area,2010,3,226,129,97
016,Aleutians West Census Area,2010,4,249,149,100
016,Aleutians West Census Area,2010,5,334,233,101
016,Aleutians West Census Area,2010,6,517,375,142
016,Aleutians West Census Area,2010,7,455,319,136
016,Aleutians West Census Area,2010,8,477,344,133
016,Aleutians West Census Area,2010,9,660,464,196
016,Aleutians West Census Area,2010,10,627,432,195
016,Aleutians West Census Area,2010,11,605,420,185
016,Aleutians West Census Area,2010,12,458,299,159
016,Aleutians West Census Area,2010,13,328,222,106
016,Aleutians West Census Area,2010,14,110,70,40
016,Aleutians West Census Area,2010,15,47,34,13
016,Aleutians West Census Area,2010,16,17,8,9
016,Aleutians West Census Area,2010,17,14,6,8
016,Aleutians West Census Area,2010,18,5,0,5
020,Anchorage Municipality,2010,0,291826,148209,143617
020,Anchorage Municipality,2010,1,21961,11349,10612
020,Anchorage Municipality,2010,2,20618,10542,10076
020,Anchorage Municipality,2010,3,20443,10407,10036
020,Anchorage Municipality,2010,4,21187,10990,10197
020,Anchorage Municipality,2010,5,24379,13059,11320
020,Anchorage Municipality,2010,6,24820,12820,12000
020,Anchorage Municipality,2010,7,20620,10458,10162
020,Anchorage Municipality,2010,8,19569,9843,9726
020,Anchorage Municipality,2010,9,19493,9892,9601
020,Anchorage Municipality,2010,10,22394,11157,11237
020,Anchorage Municipality,2010,11,22175,11084,11091
020,Anchorage Municipality,2010,12,19088,9755,9333
020,Anchorage Municipality,2010,13,13940,7186,6754
020,Anchorage Municipality,2010,14,8347,4169,4178
020,Anchorage Municipality,2010,15,4962,2328,2634
020,Anchorage Municipality,2010,16,3482,1533,1949
020,Anchorage Municipality,2010,17,2386,978,1408
020,Anchorage Municipality,2010,18,1962,659,1303
050,Bethel Census Area,2010,0,17013,8898,8115
050,Bethel Census Area,2010,1,1796,911,885
050,Bethel Census Area,2010,2,1762,919,843
050,Bethel Census Area,2010,3,1669,871,798
050,Bethel Census Area,2010,4,1618,832,786
050,Bethel Census Area,2010,5,1349,688,661
050,Bethel Census Area,2010,6,1210,621,589
050,Bethel Census Area,2010,7,1047,536,511
050,Bethel Census Area,2010,8,893,457,436
050,Bethel Census Area,2010,9,965,534,431
050,Bethel Census Area,2010,10,1162,655,507
050,Bethel Census Area,2010,11,1048,579,469
050,Bethel Census Area,2010,12,850,451,399
050,Bethel Census Area,2010,13,603,330,273
050,Bethel Census Area,2010,14,451,234,217
050,Bethel Census Area,2010,15,213,117,96
050,Bethel Census Area,2010,16,194,76,118
050,Bethel Census Area,2010,17,114,56,58
050,Bethel Census Area,2010,18,69,31,38
060,Bristol Bay Borough,2010,0,997,540,457
060,Bristol Bay Borough,2010,1,48,25,23
060,Bristol Bay Borough,2010,2,59,26,33
060,Bristol Bay Borough,2010,3,72,34,38
060,Bristol Bay Borough,2010,4,65,37,28
060,Bristol Bay Borough,2010,5,49,30,19
060,Bristol Bay Borough,2010,6,65,35,30
060,Bristol Bay Borough,2010,7,47,26,21
060,Bristol Bay Borough,2010,8,58,30,28
060,Bristol Bay Borough,2010,9,67,40,27
060,Bristol Bay Borough,2010,10,109,57,52
060,Bristol Bay Borough,2010,11,116,63,53
060,Bristol Bay Borough,2010,12,103,58,45
060,Bristol Bay Borough,2010,13,56,35,21
060,Bristol Bay Borough,2010,14,37,23,14
060,Bristol Bay Borough,2010,15,21,10,11
060,Bristol Bay Borough,2010,16,15,7,8
060,Bristol Bay Borough,2010,17,6,4,2
060,Bristol Bay Borough,2010,18,4,0,4
063,Chugach Census Area,2010,0,6684,3576,3108
063,Chugach Census Area,2010,1,441,215,226
063,Chugach Census Area,2010,2,419,217,202
063,Chugach Census Area,2010,3,464,231,233
063,Chugach Census Area,2010,4,471,253,218
063,Chugach Census Area,2010,5,402,233,169
063,Chugach Census Area,2010,6,451,254,197
063,Chugach Census Area,2010,7,385,213,172
063,Chugach Census Area,2010,8,402,206,196
063,Chugach Census Area,2010,9,492,259,233
063,Chugach Census Area,2010,10,617,342,275
063,Chugach Census Area,2010,11,708,382,326
063,Chugach Census Area,2010,12,569,319,250
063,Chugach Census Area,2010,13,386,208,178
063,Chugach Census Area,2010,14,218,125,93
063,Chugach Census Area,2010,15,117,59,58
063,Chugach Census Area,2010,16,64,32,32
063,Chugach Census Area,2010,17,41,18,23
063,Chugach Census Area,2010,18,37,10,27
066,Copper River Census Area,2010,0,2955,1569,1386
066,Copper River Census Area,2010,1,180,94,86
066,Copper River Census Area,2010,2,206,101,105
066,Copper River Census Area,2010,3,215,96,119
066,Copper River Census Area,2010,4,201,107,94
066,Copper River Census Area,2010,5,150,75,75
066,Copper River Census Area,2010,6,144,81,63
066,Copper River Census Area,2010,7,158,76,82
066,Copper River Census Area,2010,8,152,78,74
066,Copper River Census Area,2010,9,171,94,77
066,Copper River Census Area,2010,10,234,121,113
066,Copper River Census Area,2010,11,304,158,146
066,Copper River Census Area,2010,12,280,163,117
066,Copper River Census Area,2010,13,237,144,93
066,Copper River Census Area,2010,14,137,82,55
066,Copper River Census Area,2010,15,79,40,39
066,Copper River Census Area,2010,16,54,35,19
066,Copper River Census Area,2010,17,29,14,15
066,Copper River Census Area,2010,18,24,10,14
068,Denali Borough,2010,0,1826,1002,824
068,Denali Borough,2010,1,114,64,50
068,Denali Borough,2010,2,114,59,55
068,Denali Borough,2010,3,118,54,64
068,Denali Borough,2010,4,97,52,45
068,Denali Borough,2010,5,49,28,21
068,Denali Borough,2010,6,96,40,56
068,Denali Borough,2010,7,136,66,70
068,Denali Borough,2010,8,138,70,68
068,Denali Borough,2010,9,131,73,58
068,Denali Borough,2010,10,189,109,80
068,Denali Borough,2010,11,191,110,81
068,Denali Borough,2010,12,198,111,87
068,Denali Borough,2010,13,118,81,37
068,Denali Borough,2010,14,73,44,29
068,Denali Borough,2010,15,37,22,15
068,Denali Borough,2010,16,19,14,5
068,Denali Borough,2010,17,5,3,2
068,Denali Borough,2010,18,3,2,1
070,Dillingham Census Area,2010,0,4847,2541,2306
070,Dillingham Census Area,2010,1,452,243,209
070,Dillingham Census Area,2010,2,409,220,189
070,Dillingham Census Area,2010,3,452,236,216
070,Dillingham Census Area,2010,4,463,241,222
070,Dillingham Census Area,2010,5,394,191,203
070,Dillingham Census Area,2010,6,311,161,150
070,Dillingham Census Area,2010,7,265,139,126
070,Dillingham Census Area,2010,8,208,112,96
070,Dillingham Census Area,2010,9,273,137,136
070,Dillingham Census Area,2010,10,381,202,179
070,Dillingham Census Area,2010,11,360,186,174
070,Dillingham Census Area,2010,12,327,175,152
070,Dillingham Census Area,2010,13,185,102,83
070,Dillingham Census Area,2010,14,140,71,69
070,Dillingham Census Area,2010,15,96,56,40
070,Dillingham Census Area,2010,16,63,35,28
070,Dillingham Census Area,2010,17,40,20,20
070,Dillingham Census Area,2010,18,28,14,14
090,Fairbanks North Star Borough,2010,0,97581,51531,46050
090,Fairbanks North Star Borough,2010,1,7922,4114,3808
090,Fairbanks North Star Borough,2010,2,6985,3567,3418
090,Fairbanks North Star Borough,2010,3,6298,3274,3024
090,Fairbanks North Star Borough,2010,4,6778,3529,3249
090,Fairbanks North Star Borough,2010,5,10095,5789,4306
090,Fairbanks North Star Borough,2010,6,9030,5017,4013
090,Fairbanks North Star Borough,2010,7,7210,3809,3401
090,Fairbanks North Star Borough,2010,8,6492,3417,3075
090,Fairbanks North Star Borough,2010,9,5975,3105,2870
090,Fairbanks North Star Borough,2010,10,6625,3364,3261
090,Fairbanks North Star Borough,2010,11,6920,3536,3384
090,Fairbanks North Star Borough,2010,12,6301,3321,2980
090,Fairbanks North Star Borough,2010,13,4575,2501,2074
090,Fairbanks North Star Borough,2010,14,2637,1421,1216
090,Fairbanks North Star Borough,2010,15,1533,794,739
090,Fairbanks North Star Borough,2010,16,965,465,500
090,Fairbanks North Star Borough,2010,17,719,330,389
090,Fairbanks North Star Borough,2010,18,521,178,343
100,Haines Borough,2010,0,2508,1274,1234
100,Haines Borough,2010,1,128,61,67
100,Haines Borough,2010,2,135,62,73
100,Haines Borough,2010,3,141,84,57
100,Haines Borough,2010,4,135,64,71
100,Haines Borough,2010,5,79,41,38
100,Haines Borough,2010,6,115,55,60
100,Haines Borough,2010,7,131,67,64
100,Haines Borough,2010,8,144,70,74
100,Haines Borough,2010,9,161,83,78
100,Haines Borough,2010,10,228,119,109
100,Haines Borough,2010,11,250,132,118
100,Haines Borough,2010,12,274,140,134
100,Haines Borough,2010,13,242,131,111
100,Haines Borough,2010,14,138,70,68
100,Haines Borough,2010,15,78,37,41
100,Haines Borough,2010,16,67,28,39
100,Haines Borough,2010,17,32,19,13
100,Haines Borough,2010,18,30,11,19
105,Hoonah-Angoon Census Area,2010,0,2149,1164,985
105,Hoonah-Angoon Census Area,2010,1,125,68,57
105,Hoonah-Angoon Census Area,2010,2,110,41,69
105,Hoonah-Angoon Census Area,2010,3,109,47,62
105,Hoonah-Angoon Census Area,2010,4,137,80,57
105,Hoonah-Angoon Census Area,2010,5,94,51,43
105,Hoonah-Angoon Census Area,2010,6,124,72,52
105,Hoonah-Angoon Census Area,2010,7,116,56,60
105,Hoonah-Angoon Census Area,2010,8,101,47,54
105,Hoonah-Angoon Census Area,2010,9,125,76,49
105,Hoonah-Angoon Census Area,2010,10,183,98,85
105,Hoonah-Angoon Census Area,2010,11,208,114,94
105,Hoonah-Angoon Census Area,2010,12,235,124,111
105,Hoonah-Angoon Census Area,2010,13,194,117,77
105,Hoonah-Angoon Census Area,2010,14,126,74,52
105,Hoonah-Angoon Census Area,2010,15,81,50,31
105,Hoonah-Angoon Census Area,2010,16,45,34,11
105,Hoonah-Angoon Census Area,2010,17,17,10,7
105,Hoonah-Angoon Census Area,2010,18,19,5,14
110,Juneau City and Borough,2010,0,31275,15950,15325
110,Juneau City and Borough,2010,1,1982,1017,965
110,Juneau City and Borough,2010,2,1972,998,974
110,Juneau City and Borough,2010,3,2011,1031,980
110,Juneau City and Borough,2010,4,2212,1160,1052
110,Juneau City and Borough,2010,5,1934,992,942
110,Juneau City and Borough,2010,6,2308,1164,1144
110,Juneau City and Borough,2010,7,2019,1059,960
110,Juneau City and Borough,2010,8,2033,1052,981
110,Juneau City and Borough,2010,9,2293,1171,1122
110,Juneau City and Borough,2010,10,2669,1385,1284
110,Juneau City and Borough,2010,11,2772,1407,1365
110,Juneau City and Borough,2010,12,2575,1306,1269
110,Juneau City and Borough,2010,13,1860,984,876
110,Juneau City and Borough,2010,14,1055,515,540
110,Juneau City and Borough,2010,15,667,344,323
110,Juneau City and Borough,2010,16,368,156,212
110,Juneau City and Borough,2010,17,298,122,176
110,Juneau City and Borough,2010,18,247,87,160
122,Kenai Peninsula Borough,2010,0,55400,29038,26362
122,Kenai Peninsula Borough,2010,1,3464,1713,1751
122,Kenai Peninsula Borough,2010,2,3434,1773,1661
122,Kenai Peninsula Borough,2010,3,3762,1897,1865
122,Kenai Peninsula Borough,2010,4,3959,2123,1836
122,Kenai Peninsula Borough,2010,5,3066,1731,1335
122,Kenai Peninsula Borough,2010,6,3245,1746,1499
122,Kenai Peninsula Borough,2010,7,3045,1622,1423
122,Kenai Peninsula Borough,2010,8,3311,1754,1557
122,Kenai Peninsula Borough,2010,9,3544,1838,1706
122,Kenai Peninsula Borough,2010,10,4384,2287,2097
122,Kenai Peninsula Borough,2010,11,5143,2661,2482
122,Kenai Peninsula Borough,2010,12,5057,2646,2411
122,Kenai Peninsula Borough,2010,13,3710,1989,1721
122,Kenai Peninsula Borough,2010,14,2585,1441,1144
122,Kenai Peninsula Borough,2010,15,1479,794,685
122,Kenai Peninsula Borough,2010,16,1040,531,509
122,Kenai Peninsula Borough,2010,17,639,289,350
122,Kenai Peninsula Borough,2010,18,533,203,330
130,Ketchikan Gateway Borough,2010,0,13477,6911,6566
130,Ketchikan Gateway Borough,2010,1,903,454,449
130,Ketchikan Gateway Borough,2010,2,857,455,402
130,Ketchikan Gateway Borough,2010,3,876,435,441
130,Ketchikan Gateway Borough,2010,4,937,491,446
130,Ketchikan Gateway Borough,2010,5,824,445,379
130,Ketchikan Gateway Borough,2010,6,983,521,462
130,Ketchikan Gateway Borough,2010,7,834,432,402
130,Ketchikan Gateway Borough,2010,8,783,379,404
130,Ketchikan Gateway Borough,2010,9,916,463,453
130,Ketchikan Gateway Borough,2010,10,1124,587,537
130,Ketchikan Gateway Borough,2010,11,1175,613,562
130,Ketchikan Gateway Borough,2010,12,1073,544,529
130,Ketchikan Gateway Borough,2010,13,825,430,395
130,Ketchikan Gateway Borough,2010,14,520,271,249
130,Ketchikan Gateway Borough,2010,15,317,164,153
130,Ketchikan Gateway Borough,2010,16,201,89,112
130,Ketchikan Gateway Borough,2010,17,166,79,87
130,Ketchikan Gateway Borough,2010,18,163,59,104
150,Kodiak Island Borough,2010,0,13592,7197,6395
150,Kodiak Island Borough,2010,1,1151,587,564
150,Kodiak Island Borough,2010,2,979,504,475
150,Kodiak Island Borough,2010,3,1123,601,522
150,Kodiak Island Borough,2010,4,1004,541,463
150,Kodiak Island Borough,2010,5,962,567,395
150,Kodiak Island Borough,2010,6,1068,576,492
150,Kodiak Island Borough,2010,7,955,489,466
150,Kodiak Island Borough,2010,8,854,446,408
150,Kodiak Island Borough,2010,9,936,474,462
150,Kodiak Island Borough,2010,10,1089,579,510
150,Kodiak Island Borough,2010,11,1041,573,468
150,Kodiak Island Borough,2010,12,875,471,404
150,Kodiak Island Borough,2010,13,640,345,295
150,Kodiak Island Borough,2010,14,403,201,202
150,Kodiak Island Borough,2010,15,238,122,116
150,Kodiak Island Borough,2010,16,126,59,67
150,Kodiak Island Borough,2010,17,76,31,45
150,Kodiak Island Borough,2010,18,72,31,41
158,Kusilvak Census Area,2010,0,7459,3944,3515
158,Kusilvak Census Area,2010,1,903,495,408
158,Kusilvak Census Area,2010,2,829,424,405
158,Kusilvak Census Area,2010,3,861,459,402
158,Kusilvak Census Area,2010,4,821,414,407
158,Kusilvak Census Area,2010,5,724,407,317
158,Kusilvak Census Area,2010,6,480,241,239
158,Kusilvak Census Area,2010,7,367,191,176
158,Kusilvak Census Area,2010,8,374,211,163
158,Kusilvak Census Area,2010,9,405,208,197
158,Kusilvak Census Area,2010,10,423,224,199
158,Kusilvak Census Area,2010,11,365,208,157
158,Kusilvak Census Area,2010,12,285,156,129
158,Kusilvak Census Area,2010,13,218,117,101
158,Kusilvak Census Area,2010,14,139,75,64
158,Kusilvak Census Area,2010,15,105,45,60
158,Kusilvak Census Area,2010,16,79,37,42
158,Kusilvak Census Area,2010,17,40,17,23
158,Kusilvak Census Area,2010,18,41,15,26
164,Lake and Peninsula Borough,2010,0,1631,859,772
164,Lake and Peninsula Borough,2010,1,138,67,71
164,Lake and Peninsula Borough,2010,2,122,63,59
164,Lake and Peninsula Borough,2010,3,138,67,71
164,Lake and Peninsula Borough,2010,4,149,73,76
164,Lake and Peninsula Borough,2010,5,129,63,66
164,Lake and Peninsula Borough,2010,6,124,64,60
164,Lake and Peninsula Borough,2010,7,102,58,44
164,Lake and Peninsula Borough,2010,8,76,41,35
164,Lake and Peninsula Borough,2010,9,86,49,37
164,Lake and Peninsula Borough,2010,10,134,80,54
164,Lake and Peninsula Borough,2010,11,140,83,57
164,Lake and Peninsula Borough,2010,12,95,47,48
164,Lake and Peninsula Borough,2010,13,71,36,35
164,Lake and Peninsula Borough,2010,14,56,31,25
164,Lake and Peninsula Borough,2010,15,35,19,16
164,Lake and Peninsula Borough,2010,16,15,9,6
164,Lake and Peninsula Borough,2010,17,11,7,4
164,Lake and Peninsula Borough,2010,18,10,2,8
170,Matanuska-Susitna Borough,2010,0,88995,46040,42955
170,Matanuska-Susitna Borough,2010,1,6900,3616,3284
170,Matanuska-Susitna Borough,2010,2,7082,3631,3451
170,Matanuska-Susitna Borough,2010,3,7189,3741,3448
170,Matanuska-Susitna Borough,2010,4,6985,3580,3405
170,Matanuska-Susitna Borough,2010,5,5009,2670,2339
170,Matanuska-Susitna Borough,2010,6,5849,3011,2838
170,Matanuska-Susitna Borough,2010,7,5738,2944,2794
170,Matanuska-Susitna Borough,2010,8,5946,3006,2940
170,Matanuska-Susitna Borough,2010,9,6234,3236,2998
170,Matanuska-Susitna Borough,2010,10,7067,3642,3425
170,Matanuska-Susitna Borough,2010,11,7279,3837,3442
170,Matanuska-Susitna Borough,2010,12,6364,3341,3023
170,Matanuska-Susitna Borough,2010,13,4284,2219,2065
170,Matanuska-Susitna Borough,2010,14,2913,1559,1354
170,Matanuska-Susitna Borough,2010,15,1712,890,822
170,Matanuska-Susitna Borough,2010,16,1188,589,599
170,Matanuska-Susitna Borough,2010,17,730,338,392
170,Matanuska-Susitna Borough,2010,18,526,190,336
180,Nome Census Area,2010,0,9492,5058,4434
180,Nome Census Area,2010,1,1017,534,483
180,Nome Census Area,2010,2,898,450,448
180,Nome Census Area,2010,3,857,455,402
180,Nome Census Area,2010,4,862,447,415
180,Nome Census Area,2010,5,730,385,345
180,Nome Census Area,2010,6,716,387,329
180,Nome Census Area,2010,7,626,327,299
180,Nome Census Area,2010,8,514,269,245
180,Nome Census Area,2010,9,541,299,242
180,Nome Census Area,2010,10,611,339,272
180,Nome Census Area,2010,11,622,343,279
180,Nome Census Area,2010,12,534,288,246
180,Nome Census Area,2010,13,361,221,140
180,Nome Census Area,2010,14,248,140,108
180,Nome Census Area,2010,15,141,80,61
180,Nome Census Area,2010,16,105,44,61
180,Nome Census Area,2010,17,73,31,42
180,Nome Census Area,2010,18,36,19,17
185,North Slope Borough,2010,0,9430,5904,3526
185,North Slope Borough,2010,1,747,382,365
185,North Slope Borough,2010,2,620,317,303
185,North Slope Borough,2010,3,553,291,262
185,North Slope Borough,2010,4,629,324,305
185,North Slope Borough,2010,5,752,443,309
185,North Slope Borough,2010,6,750,453,297
185,North Slope Borough,2010,7,650,426,224
185,North Slope Borough,2010,8,585,411,174
185,North Slope Borough,2010,9,638,428,210
185,North Slope Borough,2010,10,837,555,282
185,North Slope Borough,2010,11,974,689,285
185,North Slope Borough,2010,12,839,635,204
185,North Slope Borough,2010,13,454,324,130
185,North Slope Borough,2010,14,191,124,67
185,North Slope Borough,2010,15,90,50,40
185,North Slope Borough,2010,16,53,22,31
185,North Slope Borough,2010,17,47,22,25
185,North Slope Borough,2010,18,21,8,13
188,Northwest Arctic Borough,2010,0,7523,4029,3494
188,Northwest Arctic Borough,2010,1,882,464,418
188,Northwest Arctic Borough,2010,2,688,343,345
188,Northwest Arctic Borough,2010,3,699,344,355
188,Northwest Arctic Borough,2010,4,710,373,337
188,Northwest Arctic Borough,2010,5,708,388,320
188,Northwest Arctic Borough,2010,6,550,270,280
188,Northwest Arctic Borough,2010,7,430,244,186
188,Northwest Arctic Borough,2010,8,399,220,179
188,Northwest Arctic Borough,2010,9,442,267,175
188,Northwest Arctic Borough,2010,10,488,282,206
188,Northwest Arctic Borough,2010,11,454,258,196
188,Northwest Arctic Borough,2010,12,356,220,136
188,Northwest Arctic Borough,2010,13,262,141,121
188,Northwest Arctic Borough,2010,14,146,80,66
188,Northwest Arctic Borough,2010,15,118,69,49
188,Northwest Arctic Borough,2010,16,94,36,58
188,Northwest Arctic Borough,2010,17,61,19,42
188,Northwest Arctic Borough,2010,18,36,11,25
195,Petersburg Borough,2010,0,3203,1650,1553
195,Petersburg Borough,2010,1,186,93,93
195,Petersburg Borough,2010,2,183,79,104
195,Petersburg Borough,2010,3,243,140,103
195,Petersburg Borough,2010,4,203,94,109
195,Petersburg Borough,2010,5,165,85,80
195,Petersburg Borough,2010,6,196,97,99
195,Petersburg Borough,2010,7,174,91,83
195,Petersburg Borough,2010,8,176,84,92
195,Petersburg Borough,2010,9,215,111,104
195,Petersburg Borough,2010,10,262,135,127
195,Petersburg Borough,2010,11,300,144,156
195,Petersburg Borough,2010,12,296,162,134
195,Petersburg Borough,2010,13,235,127,108
195,Petersburg Borough,2010,14,168,109,59
195,Petersburg Borough,2010,15,66,36,30
195,Petersburg Borough,2010,16,54,24,30
195,Petersburg Borough,2010,17,44,21,23
195,Petersburg Borough,2010,18,37,18,19
198,Prince of Wales-Hyder Census Area,2010,0,6172,3403,2769
198,Prince of Wales-Hyder Census Area,2010,1,457,239,218
198,Prince of Wales-Hyder Census Area,2010,2,402,210,192
198,Prince of Wales-Hyder Census Area,2010,3,456,251,205
198,Prince of Wales-Hyder Census Area,2010,4,390,229,161
198,Prince of Wales-Hyder Census Area,2010,5,340,180,160
198,Prince of Wales-Hyder Census Area,2010,6,325,177,148
198,Prince of Wales-Hyder Census Area,2010,7,338,181,157
198,Prince of Wales-Hyder Census Area,2010,8,376,192,184
198,Prince of Wales-Hyder Census Area,2010,9,419,224,195
198,Prince of Wales-Hyder Census Area,2010,10,528,297,231
198,Prince of Wales-Hyder Census Area,2010,11,535,287,248
198,Prince of Wales-Hyder Census Area,2010,12,564,319,245
198,Prince of Wales-Hyder Census Area,2010,13,414,251,163
198,Prince of Wales-Hyder Census Area,2010,14,285,167,118
198,Prince of Wales-Hyder Census Area,2010,15,162,102,60
198,Prince of Wales-Hyder Census Area,2010,16,102,60,42
198,Prince of Wales-Hyder Census Area,2010,17,52,23,29
198,Prince of Wales-Hyder Census Area,2010,18,27,14,13
220,Sitka City and Borough,2010,0,8881,4481,4400
220,Sitka City and Borough,2010,1,624,343,281
220,Sitka City and Borough,2010,2,561,278,283
220,Sitka City and Borough,2010,3,546,302,244
220,Sitka City and Borough,2010,4,560,283,277
220,Sitka City and Borough,2010,5,519,242,277
220,Sitka City and Borough,2010,6,613,299,314
220,Sitka City and Borough,2010,7,641,330,311
220,Sitka City and Borough,2010,8,604,311,293
220,Sitka City and Borough,2010,9,561,297,264
220,Sitka City and Borough,2010,10,649,333,316
220,Sitka City and Borough,2010,11,787,391,396
220,Sitka City and Borough,2010,12,696,350,346
220,Sitka City and Borough,2010,13,512,281,231
220,Sitka City and Borough,2010,14,319,166,153
220,Sitka City and Borough,2010,15,257,119,138
220,Sitka City and Borough,2010,16,165,68,97
220,Sitka City and Borough,2010,17,130,53,77
220,Sitka City and Borough,2010,18,137,35,102
230,"Skagway Borough, Municipality",2010,0,968,500,468
230,"Skagway Borough, Municipality",2010,1,49,27,22
230,"Skagway Borough, Municipality",2010,2,33,18,15
230,"Skagway Borough, Municipality",2010,3,35,17,18
230,"Skagway Borough, Municipality",2010,4,46,20,26
230,"Skagway Borough, Municipality",2010,5,39,19,20
230,"Skagway Borough, Municipality",2010,6,82,36,46
230,"Skagway Borough, Municipality",2010,7,107,47,60
230,"Skagway Borough, Municipality",2010,8,66,40,26
230,"Skagway Borough, Municipality",2010,9,93,52,41
230,"Skagway Borough, Municipality",2010,10,68,36,32
230,"Skagway Borough, Municipality",2010,11,88,48,40
230,"Skagway Borough, Municipality",2010,12,103,61,42
230,"Skagway Borough, Municipality",2010,13,71,41,30
230,"Skagway Borough, Municipality",2010,14,41,16,25
230,"Skagway Borough, Municipality",2010,15,22,14,8
230,"Skagway Borough, Municipality",2010,16,9,2,7
230,"Skagway Borough, Municipality",2010,17,10,4,6
230,"Skagway Borough, Municipality",2010,18,6,2,4
240,Southeast Fairbanks Census Area,2010,0,7026,3915,3111
240,Southeast Fairbanks Census Area,2010,1,486,236,250
240,Southeast Fairbanks Census Area,2010,2,529,304,225
240,Southeast Fairbanks Census Area,2010,3,509,273,236
240,Southeast Fairbanks Census Area,2010,4,510,267,243
240,Southeast Fairbanks Census Area,2010,5,377,192,185
240,Southeast Fairbanks Census Area,2010,6,433,246,187
240,Southeast Fairbanks Census Area,2010,7,460,267,193
240,Southeast Fairbanks Census Area,2010,8,429,235,194
240,Southeast Fairbanks Census Area,2010,9,483,284,199
240,Southeast Fairbanks Census Area,2010,10,566,334,232
240,Southeast Fairbanks Census Area,2010,11,605,328,277
240,Southeast Fairbanks Census Area,2010,12,562,330,232
240,Southeast Fairbanks Census Area,2010,13,415,254,161
240,Southeast Fairbanks Census Area,2010,14,274,173,101
240,Southeast Fairbanks Census Area,2010,15,188,100,88
240,Southeast Fairbanks Census Area,2010,16,99,52,47
240,Southeast Fairbanks Census Area,2010,17,63,29,34
240,Southeast Fairbanks Census Area,2010,18,38,11,27
275,Wrangell City and Borough,2010,0,2369,1242,1127
275,Wrangell City and Borough,2010,1,129,60,69
275,Wrangell City and Borough,2010,2,136,65,71
275,Wrangell City and Borough,2010,3,155,84,71
275,Wrangell City and Borough,2010,4,152,86,66
275,Wrangell City and Borough,2010,5,116,70,46
275,Wrangell City and Borough,2010,6,115,60,55
275,Wrangell City and Borough,2010,7,88,42,46
275,Wrangell City and Borough,2010,8,114,59,55
275,Wrangell City and Borough,2010,9,127,57,70
275,Wrangell City and Borough,2010,10,186,102,84
275,Wrangell City and Borough,2010,11,243,130,113
275,Wrangell City and Borough,2010,12,235,123,112
275,Wrangell City and Borough,2010,13,199,110,89
275,Wrangell City and Borough,2010,14,123,64,59
275,Wrangell City and Borough,2010,15,110,62,48
275,Wrangell City and Borough,2010,16,66,36,30
275,Wrangell City and Borough,2010,17,42,21,21
275,Wrangell City and Borough,2010,18,33,11,22
282,Yakutat City and Borough,2010,0,662,360,302
282,Yakutat City and Borough,2010,1,40,17,23
282,Yakutat City and Borough,2010,2,42,22,20
282,Yakutat City and Borough,2010,3,41,19,22
282,Yakutat City and Borough,2010,4,53,28,25
282,Yakutat City and Borough,2010,5,34,16,18
282,Yakutat City and Borough,2010,6,42,27,15
282,Yakutat City and Borough,2010,7,36,17,19
282,Yakutat City and Borough,2010,8,46,28,18
282,Yakutat City and Borough,2010,9,48,28,20
282,Yakutat City and Borough,2010,10,56,35,21
282,Yakutat City and Borough,2010,11,54,32,22
282,Yakutat City and Borough,2010,12,60,39,21
282,Yakutat City and Borough,2010,13,46,24,22
282,Yakutat City and Borough,2010,14,23,14,9
282,Yakutat City and Borough,2010,15,20,12,8
282,Yakutat City and Borough,2010,16,9,1,8
282,Yakutat City and Borough,2010,17,7,0,7
282,Yakutat City and Borough,2010,18,5,1,4
290,Yukon-Koyukuk Census Area,2010,0,5588,3027,2561
290,Yukon-Koyukuk Census Area,2010,1,443,234,209
290,Yukon-Koyukuk Census Area,2010,2,371,182,189
290,Yukon-Koyukuk Census Area,2010,3,467,237,230
290,Yukon-Koyukuk Census Area,2010,4,454,249,205
290,Yukon-Koyukuk Census Area,2010,5,368,206,162
290,Yukon-Koyukuk Census Area,2010,6,356,193,163
290,Yukon-Koyukuk Census Area,2010,7,313,185,128
290,Yukon-Koyukuk Census Area,2010,8,271,137,134
290,Yukon-Koyukuk Census Area,2010,9,292,152,140
290,Yukon-Koyukuk Census Area,2010,10,405,211,194
290,Yukon-Koyukuk Census Area,2010,11,498,269,229
290,Yukon-Koyukuk Census Area,2010,12,455,266,189
290,Yukon-Koyukuk Census Area,2010,13,326,176,150
290,Yukon-Koyukuk Census Area,2010,14,224,139,85
290,Yukon-Koyukuk Census Area,2010,15,124,75,49
290,Yukon-Koyukuk Census Area,2010,16,109,54,55
290,Yukon-Koyukuk Census Area,2010,17,78,44,34
290,Yukon-Koyukuk Census Area,2010,18,34,18,16
000,Alaska,2011,0,722473,375468,347005
000,Alaska,2011,1,55281,28466,26815
000,Alaska,2011,2,51504,26402,25102
000,Alaska,2011,3,51298,26359,24939
000,Alaska,2011,4,50648,26395,24253
000,Alaska,2011,5,55220,30096,25124
000,Alaska,2011,6,57268,30339,26929
000,Alaska,2011,7,50483,26214,24269
000,Alaska,2011,8,44792,23225,21567
000,Alaska,2011,9,47115,24559,22556
000,Alaska,2011,10,52228,27039,25189
000,Alaska,2011,11,56549,29419,27130
000,Alaska,2011,12,51923,27145,24778
000,Alaska,2011,13,39378,20983,18395
000,Alaska,2011,14,23672,12452,11220
000,Alaska,2011,15,14406,7392,7014
000,Alaska,2011,16,9274,4401,4873
000,Alaska,2011,17,6331,2787,3544
000,Alaska,2011,18,5103,1795,3308
013,Aleutians East Borough,2011,0,3148,2096,1052
013,Aleutians East Borough,2011,1,124,67,57
013,Aleutians East Borough,2011,2,112,55,57
013,Aleutians East Borough,2011,3,77,37,40
013,Aleutians East Borough,2011,4,107,61,46
013,Aleutians East Borough,2011,5,263,197,66
013,Aleutians East Borough,2011,6,245,181,64
013,Aleutians East Borough,2011,7,243,151,92
013,Aleutians East Borough,2011,8,235,160,75
013,Aleutians East Borough,2011,9,325,249,76
013,Aleutians East Borough,2011,10,404,285,119
013,Aleutians East Borough,2011,11,369,231,138
013,Aleutians East Borough,2011,12,291,206,85
013,Aleutians East Borough,2011,13,176,107,69
013,Aleutians East Borough,2011,14,94,58,36
013,Aleutians East Borough,2011,15,45,25,20
013,Aleutians East Borough,2011,16,16,8,8
013,Aleutians East Borough,2011,17,16,13,3
013,Aleutians East Borough,2011,18,6,5,1
016,Aleutians West Census Area,2011,0,5522,3716,1806
016,Aleutians West Census Area,2011,1,209,103,106
016,Aleutians West Census Area,2011,2,203,109,94
016,Aleutians West Census Area,2011,3,221,128,93
016,Aleutians West Census Area,2011,4,262,159,103
016,Aleutians West Census Area,2011,5,299,201,98
016,Aleutians West Census Area,2011,6,492,379,113
016,Aleutians West Census Area,2011,7,454,319,135
016,Aleutians West Census Area,2011,8,491,349,142
016,Aleutians West Census Area,2011,9,592,422,170
016,Aleutians West Census Area,2011,10,599,406,193
016,Aleutians West Census Area,2011,11,663,452,211
016,Aleutians West Census Area,2011,12,458,313,145
016,Aleutians West Census Area,2011,13,341,229,112
016,Aleutians West Census Area,2011,14,150,96,54
016,Aleutians West Census Area,2011,15,51,33,18
016,Aleutians West Census Area,2011,16,15,10,5
016,Aleutians West Census Area,2011,17,15,6,9
016,Aleutians West Census Area,2011,18,7,2,5
020,Anchorage Municipality,2011,0,295713,150110,145603
020,Anchorage Municipality,2011,1,22339,11586,10753
020,Anchorage Municipality,2011,2,20671,10579,10092
020,Anchorage Municipality,2011,3,20605,10578,10027
020,Anchorage Municipality,2011,4,20447,10516,9931
020,Anchorage Municipality,2011,5,24644,13194,11450
020,Anchorage Municipality,2011,6,25550,13215,12335
020,Anchorage Municipality,2011,7,21848,11050,10798
020,Anchorage Municipality,2011,8,18895,9530,9365
020,Anchorage Municipality,2011,9,19691,9987,9704
020,Anchorage Municipality,2011,10,21323,10571,10752
020,Anchorage Municipality,2011,11,22230,11155,11075
020,Anchorage Municipality,2011,12,19846,9998,9848
020,Anchorage Municipality,2011,13,15034,7709,7325
020,Anchorage Municipality,2011,14,9070,4552,4518
020,Anchorage Municipality,2011,15,5274,2506,2768
020,Anchorage Municipality,2011,16,3639,1636,2003
020,Anchorage Municipality,2011,17,2524,1033,1491
020,Anchorage Municipality,2011,18,2083,715,1368
050,Bethel Census Area,2011,0,17450,9059,8391
050,Bethel Census Area,2011,1,1850,940,910
050,Bethel Census Area,2011,2,1755,917,838
050,Bethel Census Area,2011,3,1742,892,850
050,Bethel Census Area,2011,4,1588,810,778
050,Bethel Census Area,2011,5,1418,697,721
050,Bethel Census Area,2011,6,1326,692,634
050,Bethel Census Area,2011,7,1065,536,529
050,Bethel Census Area,2011,8,890,446,444
050,Bethel Census Area,2011,9,964,512,452
050,Bethel Census Area,2011,10,1152,651,501
050,Bethel Census Area,2011,11,1074,611,463
050,Bethel Census Area,2011,12,910,481,429
050,Bethel Census Area,2011,13,639,336,303
050,Bethel Census Area,2011,14,427,230,197
050,Bethel Census Area,2011,15,255,132,123
050,Bethel Census Area,2011,16,216,92,124
050,Bethel Census Area,2011,17,108,47,61
050,Bethel Census Area,2011,18,71,37,34
060,Bristol Bay Borough,2011,0,1024,555,469
060,Bristol Bay Borough,2011,1,40,22,18
060,Bristol Bay Borough,2011,2,58,30,28
060,Bristol Bay Borough,2011,3,64,34,30
060,Bristol Bay Borough,2011,4,78,36,42
060,Bristol Bay Borough,2011,5,48,28,20
060,Bristol Bay Borough,2011,6,88,46,42
060,Bristol Bay Borough,2011,7,43,22,21
060,Bristol Bay Borough,2011,8,58,29,29
060,Bristol Bay Borough,2011,9,79,47,32
060,Bristol Bay Borough,2011,10,97,51,46
060,Bristol Bay Borough,2011,11,112,63,49
060,Bristol Bay Borough,2011,12,97,53,44
060,Bristol Bay Borough,2011,13,71,46,25
060,Bristol Bay Borough,2011,14,42,24,18
060,Bristol Bay Borough,2011,15,17,10,7
060,Bristol Bay Borough,2011,16,18,8,10
060,Bristol Bay Borough,2011,17,9,6,3
060,Bristol Bay Borough,2011,18,5,0,5
063,Chugach Census Area,2011,0,6805,3630,3175
063,Chugach Census Area,2011,1,478,229,249
063,Chugach Census Area,2011,2,412,209,203
063,Chugach Census Area,2011,3,435,212,223
063,Chugach Census Area,2011,4,449,248,201
063,Chugach Census Area,2011,5,399,222,177
063,Chugach Census Area,2011,6,515,292,223
063,Chugach Census Area,2011,7,422,232,190
063,Chugach Census Area,2011,8,402,218,184
063,Chugach Census Area,2011,9,490,254,236
063,Chugach Census Area,2011,10,564,309,255
063,Chugach Census Area,2011,11,690,379,311
063,Chugach Census Area,2011,12,617,333,284
063,Chugach Census Area,2011,13,420,230,190
063,Chugach Census Area,2011,14,235,136,99
063,Chugach Census Area,2011,15,116,52,64
063,Chugach Census Area,2011,16,77,43,34
063,Chugach Census Area,2011,17,47,22,25
063,Chugach Census Area,2011,18,37,10,27
066,Copper River Census Area,2011,0,3030,1607,1423
066,Copper River Census Area,2011,1,193,96,97
066,Copper River Census Area,2011,2,201,104,97
066,Copper River Census Area,2011,3,220,99,121
066,Copper River Census Area,2011,4,211,109,102
066,Copper River Census Area,2011,5,157,76,81
066,Copper River Census Area,2011,6,141,80,61
066,Copper River Census Area,2011,7,179,85,94
066,Copper River Census Area,2011,8,134,69,65
066,Copper River Census Area,2011,9,171,93,78
066,Copper River Census Area,2011,10,208,102,106
066,Copper River Census Area,2011,11,321,167,154
066,Copper River Census Area,2011,12,288,168,120
066,Copper River Census Area,2011,13,272,173,99
066,Copper River Census Area,2011,14,130,74,56
066,Copper River Census Area,2011,15,93,50,43
066,Copper River Census Area,2011,16,58,37,21
066,Copper River Census Area,2011,17,27,16,11
066,Copper River Census Area,2011,18,26,9,17
068,Denali Borough,2011,0,1835,1023,812
068,Denali Borough,2011,1,113,75,38
068,Denali Borough,2011,2,111,65,46
068,Denali Borough,2011,3,123,55,68
068,Denali Borough,2011,4,95,42,53
068,Denali Borough,2011,5,45,25,20
068,Denali Borough,2011,6,98,45,53
068,Denali Borough,2011,7,145,78,67
068,Denali Borough,2011,8,120,61,59
068,Denali Borough,2011,9,134,68,66
068,Denali Borough,2011,10,182,98,84
068,Denali Borough,2011,11,183,116,67
068,Denali Borough,2011,12,197,111,86
068,Denali Borough,2011,13,129,89,40
068,Denali Borough,2011,14,73,41,32
068,Denali Borough,2011,15,54,32,22
068,Denali Borough,2011,16,22,17,5
068,Denali Borough,2011,17,9,3,6
068,Denali Borough,2011,18,2,2,0
070,Dillingham Census Area,2011,0,4935,2582,2353
070,Dillingham Census Area,2011,1,487,257,230
070,Dillingham Census Area,2011,2,410,215,195
070,Dillingham Census Area,2011,3,440,231,209
070,Dillingham Census Area,2011,4,464,248,216
070,Dillingham Census Area,2011,5,398,201,197
070,Dillingham Census Area,2011,6,340,176,164
070,Dillingham Census Area,2011,7,288,141,147
070,Dillingham Census Area,2011,8,219,120,99
070,Dillingham Census Area,2011,9,249,133,116
070,Dillingham Census Area,2011,10,372,182,190
070,Dillingham Census Area,2011,11,347,190,157
070,Dillingham Census Area,2011,12,335,174,161
070,Dillingham Census Area,2011,13,204,111,93
070,Dillingham Census Area,2011,14,144,81,63
070,Dillingham Census Area,2011,15,113,55,58
070,Dillingham Census Area,2011,16,61,34,27
070,Dillingham Census Area,2011,17,38,20,18
070,Dillingham Census Area,2011,18,26,13,13
090,Fairbanks North Star Borough,2011,0,98285,51795,46490
090,Fairbanks North Star Borough,2011,1,8030,4162,3868
090,Fairbanks North Star Borough,2011,2,7002,3527,3475
090,Fairbanks North Star Borough,2011,3,6387,3295,3092
090,Fairbanks North Star Borough,2011,4,6437,3370,3067
090,Fairbanks North Star Borough,2011,5,9878,5658,4220
090,Fairbanks North Star Borough,2011,6,9209,5091,4118
090,Fairbanks North Star Borough,2011,7,7595,4089,3506
090,Fairbanks North Star Borough,2011,8,6371,3317,3054
090,Fairbanks North Star Borough,2011,9,6004,3171,2833
090,Fairbanks North Star Borough,2011,10,6318,3196,3122
090,Fairbanks North Star Borough,2011,11,6834,3494,3340
090,Fairbanks North Star Borough,2011,12,6473,3336,3137
090,Fairbanks North Star Borough,2011,13,4915,2648,2267
090,Fairbanks North Star Borough,2011,14,2831,1534,1297
090,Fairbanks North Star Borough,2011,15,1703,876,827
090,Fairbanks North Star Borough,2011,16,997,511,486
090,Fairbanks North Star Borough,2011,17,733,334,399
090,Fairbanks North Star Borough,2011,18,568,186,382
100,Haines Borough,2011,0,2613,1328,1285
100,Haines Borough,2011,1,133,57,76
100,Haines Borough,2011,2,144,75,69
100,Haines Borough,2011,3,133,78,55
100,Haines Borough,2011,4,136,66,70
100,Haines Borough,2011,5,84,49,35
100,Haines Borough,2011,6,126,69,57
100,Haines Borough,2011,7,148,68,80
100,Haines Borough,2011,8,145,67,78
100,Haines Borough,2011,9,185,94,91
100,Haines Borough,2011,10,196,104,92
100,Haines Borough,2011,11,241,123,118
100,Haines Borough,2011,12,290,153,137
100,Haines Borough,2011,13,253,136,117
100,Haines Borough,2011,14,160,79,81
100,Haines Borough,2011,15,88,44,44
100,Haines Borough,2011,16,63,26,37
100,Haines Borough,2011,17,51,24,27
100,Haines Borough,2011,18,37,16,21
105,Hoonah-Angoon Census Area,2011,0,2150,1166,984
105,Hoonah-Angoon Census Area,2011,1,127,66,61
105,Hoonah-Angoon Census Area,2011,2,108,47,61
105,Hoonah-Angoon Census Area,2011,3,123,54,69
105,Hoonah-Angoon Census Area,2011,4,114,65,49
105,Hoonah-Angoon Census Area,2011,5,99,54,45
105,Hoonah-Angoon Census Area,2011,6,125,70,55
105,Hoonah-Angoon Census Area,2011,7,111,58,53
105,Hoonah-Angoon Census Area,2011,8,113,53,60
105,Hoonah-Angoon Census Area,2011,9,111,66,45
105,Hoonah-Angoon Census Area,2011,10,149,78,71
105,Hoonah-Angoon Census Area,2011,11,215,112,103
105,Hoonah-Angoon Census Area,2011,12,239,128,111
105,Hoonah-Angoon Census Area,2011,13,205,121,84
105,Hoonah-Angoon Census Area,2011,14,135,84,51
105,Hoonah-Angoon Census Area,2011,15,83,53,30
105,Hoonah-Angoon Census Area,2011,16,49,36,13
105,Hoonah-Angoon Census Area,2011,17,21,14,7
105,Hoonah-Angoon Census Area,2011,18,23,7,16
110,Juneau City and Borough,2011,0,32345,16486,15859
110,Juneau City and Borough,2011,1,2043,1028,1015
110,Juneau City and Borough,2011,2,2005,1021,984
110,Juneau City and Borough,2011,3,2047,1049,998
110,Juneau City and Borough,2011,4,2170,1150,1020
110,Juneau City and Borough,2011,5,1993,1013,980
110,Juneau City and Borough,2011,6,2538,1301,1237
110,Juneau City and Borough,2011,7,2158,1132,1026
110,Juneau City and Borough,2011,8,2038,1048,990
110,Juneau City and Borough,2011,9,2286,1174,1112
110,Juneau City and Borough,2011,10,2589,1331,1258
110,Juneau City and Borough,2011,11,2909,1498,1411
110,Juneau City and Borough,2011,12,2622,1296,1326
110,Juneau City and Borough,2011,13,2104,1124,980
110,Juneau City and Borough,2011,14,1140,559,581
110,Juneau City and Borough,2011,15,721,370,351
110,Juneau City and Borough,2011,16,400,171,229
110,Juneau City and Borough,2011,17,312,130,182
110,Juneau City and Borough,2011,18,270,91,179
122,Kenai Peninsula Borough,2011,0,56512,29594,26918
122,Kenai Peninsula Borough,2011,1,3582,1786,1796
122,Kenai Peninsula Borough,2011,2,3490,1789,1701
122,Kenai Peninsula Borough,2011,3,3773,1894,1879
122,Kenai Peninsula Borough,2011,4,3831,2048,1783
122,Kenai Peninsula Borough,2011,5,3156,1783,1373
122,Kenai Peninsula Borough,2011,6,3390,1883,1507
122,Kenai Peninsula Borough,2011,7,3172,1646,1526
122,Kenai Peninsula Borough,2011,8,3194,1685,1509
122,Kenai Peninsula Borough,2011,9,3590,1892,1698
122,Kenai Peninsula Borough,2011,10,4080,2111,1969
122,Kenai Peninsula Borough,2011,11,5102,2612,2490
122,Kenai Peninsula Borough,2011,12,5289,2749,2540
122,Kenai Peninsula Borough,2011,13,4138,2217,1921
122,Kenai Peninsula Borough,2011,14,2719,1497,1222
122,Kenai Peninsula Borough,2011,15,1613,891,722
122,Kenai Peninsula Borough,2011,16,1104,556,548
122,Kenai Peninsula Borough,2011,17,696,332,364
122,Kenai Peninsula Borough,2011,18,593,223,370
130,Ketchikan Gateway Borough,2011,0,13732,7034,6698
130,Ketchikan Gateway Borough,2011,1,938,456,482
130,Ketchikan Gateway Borough,2011,2,849,452,397
130,Ketchikan Gateway Borough,2011,3,871,448,423
130,Ketchikan Gateway Borough,2011,4,912,485,427
130,Ketchikan Gateway Borough,2011,5,869,464,405
130,Ketchikan Gateway Borough,2011,6,1007,523,484
130,Ketchikan Gateway Borough,2011,7,874,463,411
130,Ketchikan Gateway Borough,2011,8,774,378,396
130,Ketchikan Gateway Borough,2011,9,946,470,476
130,Ketchikan Gateway Borough,2011,10,1028,532,496
130,Ketchikan Gateway Borough,2011,11,1155,602,553
130,Ketchikan Gateway Borough,2011,12,1130,569,561
130,Ketchikan Gateway Borough,2011,13,921,487,434
130,Ketchikan Gateway Borough,2011,14,544,276,268
130,Ketchikan Gateway Borough,2011,15,367,193,174
130,Ketchikan Gateway Borough,2011,16,196,92,104
130,Ketchikan Gateway Borough,2011,17,193,91,102
130,Ketchikan Gateway Borough,2011,18,158,53,105
150,Kodiak Island Borough,2011,0,13837,7308,6529
150,Kodiak Island Borough,2011,1,1211,633,578
150,Kodiak Island Borough,2011,2,990,493,497
150,Kodiak Island Borough,2011,3,1092,575,517
150,Kodiak Island Borough,2011,4,980,525,455
150,Kodiak Island Borough,2011,5,1010,582,428
150,Kodiak Island Borough,2011,6,1081,609,472
150,Kodiak Island Borough,2011,7,1059,525,534
150,Kodiak Island Borough,2011,8,819,449,370
150,Kodiak Island Borough,2011,9,885,442,443
150,Kodiak Island Borough,2011,10,1028,538,490
150,Kodiak Island Borough,2011,11,1087,593,494
150,Kodiak Island Borough,2011,12,917,503,414
150,Kodiak Island Borough,2011,13,677,347,330
150,Kodiak Island Borough,2011,14,424,217,207
150,Kodiak Island Borough,2011,15,261,135,126
150,Kodiak Island Borough,2011,16,148,69,79
150,Kodiak Island Borough,2011,17,87,37,50
150,Kodiak Island Borough,2011,18,81,36,45
158,Kusilvak Census Area,2011,0,7675,4016,3659
158,Kusilvak Census Area,2011,1,942,498,444
158,Kusilvak Census Area,2011,2,844,436,408
158,Kusilvak Census Area,2011,3,888,460,428
158,Kusilvak Census Area,2011,4,800,403,397
158,Kusilvak Census Area,2011,5,738,411,327
158,Kusilvak Census Area,2011,6,559,275,284
158,Kusilvak Census Area,2011,7,378,204,174
158,Kusilvak Census Area,2011,8,387,212,175
158,Kusilvak Census Area,2011,9,387,196,191
158,Kusilvak Census Area,2011,10,410,221,189
158,Kusilvak Census Area,2011,11,389,212,177
158,Kusilvak Census Area,2011,12,290,160,130
158,Kusilvak Census Area,2011,13,246,129,117
158,Kusilvak Census Area,2011,14,156,88,68
158,Kusilvak Census Area,2011,15,93,42,51
158,Kusilvak Census Area,2011,16,82,36,46
158,Kusilvak Census Area,2011,17,39,16,23
158,Kusilvak Census Area,2011,18,47,17,30
164,Lake and Peninsula Borough,2011,0,1677,900,777
164,Lake and Peninsula Borough,2011,1,148,76,72
164,Lake and Peninsula Borough,2011,2,127,68,59
164,Lake and Peninsula Borough,2011,3,117,51,66
164,Lake and Peninsula Borough,2011,4,143,81,62
164,Lake and Peninsula Borough,2011,5,140,69,71
164,Lake and Peninsula Borough,2011,6,121,59,62
164,Lake and Peninsula Borough,2011,7,116,66,50
164,Lake and Peninsula Borough,2011,8,96,52,44
164,Lake and Peninsula Borough,2011,9,66,38,28
164,Lake and Peninsula Borough,2011,10,133,76,57
164,Lake and Peninsula Borough,2011,11,142,82,60
164,Lake and Peninsula Borough,2011,12,119,70,49
164,Lake and Peninsula Borough,2011,13,70,35,35
164,Lake and Peninsula Borough,2011,14,61,35,26
164,Lake and Peninsula Borough,2011,15,37,19,18
164,Lake and Peninsula Borough,2011,16,14,9,5
164,Lake and Peninsula Borough,2011,17,14,11,3
164,Lake and Peninsula Borough,2011,18,13,3,10
170,Matanuska-Susitna Borough,2011,0,91712,47325,44387
170,Matanuska-Susitna Borough,2011,1,7015,3618,3397
170,Matanuska-Susitna Borough,2011,2,7431,3852,3579
170,Matanuska-Susitna Borough,2011,3,7318,3765,3553
170,Matanuska-Susitna Borough,2011,4,7098,3697,3401
170,Matanuska-Susitna Borough,2011,5,5212,2808,2404
170,Matanuska-Susitna Borough,2011,6,5948,3013,2935
170,Matanuska-Susitna Borough,2011,7,6106,3072,3034
170,Matanuska-Susitna Borough,2011,8,5810,2964,2846
170,Matanuska-Susitna Borough,2011,9,6361,3264,3097
170,Matanuska-Susitna Borough,2011,10,6837,3556,3281
170,Matanuska-Susitna Borough,2011,11,7411,3866,3545
170,Matanuska-Susitna Borough,2011,12,6614,3468,3146
170,Matanuska-Susitna Borough,2011,13,4939,2562,2377
170,Matanuska-Susitna Borough,2011,14,3046,1590,1456
170,Matanuska-Susitna Borough,2011,15,1991,1069,922
170,Matanuska-Susitna Borough,2011,16,1191,583,608
170,Matanuska-Susitna Borough,2011,17,779,372,407
170,Matanuska-Susitna Borough,2011,18,605,206,399
180,Nome Census Area,2011,0,9712,5189,4523
180,Nome Census Area,2011,1,1067,562,505
180,Nome Census Area,2011,2,927,470,457
180,Nome Census Area,2011,3,891,473,418
180,Nome Census Area,2011,4,819,435,384
180,Nome Census Area,2011,5,774,409,365
180,Nome Census Area,2011,6,765,415,350
180,Nome Census Area,2011,7,608,324,284
180,Nome Census Area,2011,8,564,296,268
180,Nome Census Area,2011,9,501,282,219
180,Nome Census Area,2011,10,606,327,279
180,Nome Census Area,2011,11,631,349,282
180,Nome Census Area,2011,12,545,294,251
180,Nome Census Area,2011,13,401,236,165
180,Nome Census Area,2011,14,242,133,109
180,Nome Census Area,2011,15,148,88,60
180,Nome Census Area,2011,16,116,48,68
180,Nome Census Area,2011,17,68,29,39
180,Nome Census Area,2011,18,39,19,20
185,North Slope Borough,2011,0,9579,5993,3586
185,North Slope Borough,2011,1,765,386,379
185,North Slope Borough,2011,2,667,340,327
185,North Slope Borough,2011,3,566,299,267
185,North Slope Borough,2011,4,569,288,281
185,North Slope Borough,2011,5,795,476,319
185,North Slope Borough,2011,6,790,478,312
185,North Slope Borough,2011,7,684,443,241
185,North Slope Borough,2011,8,592,422,170
185,North Slope Borough,2011,9,529,343,186
185,North Slope Borough,2011,10,883,608,275
185,North Slope Borough,2011,11,933,655,278
185,North Slope Borough,2011,12,902,675,227
185,North Slope Borough,2011,13,487,345,142
185,North Slope Borough,2011,14,209,141,68
185,North Slope Borough,2011,15,91,49,42
185,North Slope Borough,2011,16,52,19,33
185,North Slope Borough,2011,17,39,18,21
185,North Slope Borough,2011,18,26,8,18
188,Northwest Arctic Borough,2011,0,7641,4087,3554
188,Northwest Arctic Borough,2011,1,903,480,423
188,Northwest Arctic Borough,2011,2,726,357,369
188,Northwest Arctic Borough,2011,3,698,347,351
188,Northwest Arctic Borough,2011,4,633,324,309
188,Northwest Arctic Borough,2011,5,772,421,351
188,Northwest Arctic Borough,2011,6,578,289,289
188,Northwest Arctic Borough,2011,7,482,275,207
188,Northwest Arctic Borough,2011,8,377,209,168
188,Northwest Arctic Borough,2011,9,403,232,171
188,Northwest Arctic Borough,2011,10,477,279,198
188,Northwest Arctic Borough,2011,11,464,265,199
188,Northwest Arctic Borough,2011,12,389,236,153
188,Northwest Arctic Borough,2011,13,270,156,114
188,Northwest Arctic Borough,2011,14,160,78,82
188,Northwest Arctic Borough,2011,15,126,73,53
188,Northwest Arctic Borough,2011,16,85,34,51
188,Northwest Arctic Borough,2011,17,62,21,41
188,Northwest Arctic Borough,2011,18,36,11,25
195,Petersburg Borough,2011,0,3293,1707,1586
195,Petersburg Borough,2011,1,211,107,104
195,Petersburg Borough,2011,2,166,78,88
195,Petersburg Borough,2011,3,253,143,110
195,Petersburg Borough,2011,4,202,101,101
195,Petersburg Borough,2011,5,182,89,93
195,Petersburg Borough,2011,6,198,101,97
195,Petersburg Borough,2011,7,191,98,93
195,Petersburg Borough,2011,8,172,83,89
195,Petersburg Borough,2011,9,224,119,105
195,Petersburg Borough,2011,10,257,125,132
195,Petersburg Borough,2011,11,278,140,138
195,Petersburg Borough,2011,12,308,161,147
195,Petersburg Borough,2011,13,255,142,113
195,Petersburg Borough,2011,14,180,116,64
195,Petersburg Borough,2011,15,88,44,44
195,Petersburg Borough,2011,16,48,28,20
195,Petersburg Borough,2011,17,40,16,24
195,Petersburg Borough,2011,18,40,16,24
198,Prince of Wales-Hyder Census Area,2011,0,6462,3551,2911
198,Prince of Wales-Hyder Census Area,2011,1,469,229,240
198,Prince of Wales-Hyder Census Area,2011,2,451,248,203
198,Prince of Wales-Hyder Census Area,2011,3,451,245,206
198,Prince of Wales-Hyder Census Area,2011,4,410,238,172
198,Prince of Wales-Hyder Census Area,2011,5,364,202,162
198,Prince of Wales-Hyder Census Area,2011,6,350,195,155
198,Prince of Wales-Hyder Census Area,2011,7,379,200,179
198,Prince of Wales-Hyder Census Area,2011,8,369,197,172
198,Prince of Wales-Hyder Census Area,2011,9,434,220,214
198,Prince of Wales-Hyder Census Area,2011,10,502,284,218
198,Prince of Wales-Hyder Census Area,2011,11,553,284,269
198,Prince of Wales-Hyder Census Area,2011,12,589,339,250
198,Prince of Wales-Hyder Census Area,2011,13,449,266,183
198,Prince of Wales-Hyder Census Area,2011,14,294,173,121
198,Prince of Wales-Hyder Census Area,2011,15,190,119,71
198,Prince of Wales-Hyder Census Area,2011,16,118,72,46
198,Prince of Wales-Hyder Census Area,2011,17,62,24,38
198,Prince of Wales-Hyder Census Area,2011,18,28,16,12
220,Sitka City and Borough,2011,0,9013,4513,4500
220,Sitka City and Borough,2011,1,657,335,322
220,Sitka City and Borough,2011,2,555,277,278
220,Sitka City and Borough,2011,3,531,290,241
220,Sitka City and Borough,2011,4,550,276,274
220,Sitka City and Borough,2011,5,501,251,250
220,Sitka City and Borough,2011,6,653,285,368
220,Sitka City and Borough,2011,7,662,350,312
220,Sitka City and Borough,2011,8,614,319,295
220,Sitka City and Borough,2011,9,555,293,262
220,Sitka City and Borough,2011,10,611,324,287
220,Sitka City and Borough,2011,11,747,365,382
220,Sitka City and Borough,2011,12,721,352,369
220,Sitka City and Borough,2011,13,595,325,270
220,Sitka City and Borough,2011,14,324,166,158
220,Sitka City and Borough,2011,15,281,142,139
220,Sitka City and Borough,2011,16,178,68,110
220,Sitka City and Borough,2011,17,132,57,75
220,Sitka City and Borough,2011,18,146,38,108
230,"Skagway Borough, Municipality",2011,0,964,488,476
230,"Skagway Borough, Municipality",2011,1,54,25,29
230,"Skagway Borough, Municipality",2011,2,23,11,12
230,"Skagway Borough, Municipality",2011,3,35,18,17
230,"Skagway Borough, Municipality",2011,4,40,17,23
230,"Skagway Borough, Municipality",2011,5,40,22,18
230,"Skagway Borough, Municipality",2011,6,74,33,41
230,"Skagway Borough, Municipality",2011,7,102,47,55
230,"Skagway Borough, Municipality",2011,8,60,36,24
230,"Skagway Borough, Municipality",2011,9,91,43,48
230,"Skagway Borough, Municipality",2011,10,76,43,33
230,"Skagway Borough, Municipality",2011,11,86,44,42
230,"Skagway Borough, Municipality",2011,12,105,67,38
230,"Skagway Borough, Municipality",2011,13,77,40,37
230,"Skagway Borough, Municipality",2011,14,40,17,23
230,"Skagway Borough, Municipality",2011,15,27,17,10
230,"Skagway Borough, Municipality",2011,16,17,3,14
230,"Skagway Borough, Municipality",2011,17,9,0,9
230,"Skagway Borough, Municipality",2011,18,8,5,3
240,Southeast Fairbanks Census Area,2011,0,7104,3947,3157
240,Southeast Fairbanks Census Area,2011,1,508,247,261
240,Southeast Fairbanks Census Area,2011,2,522,292,230
240,Southeast Fairbanks Census Area,2011,3,525,280,245
240,Southeast Fairbanks Census Area,2011,4,483,257,226
240,Southeast Fairbanks Census Area,2011,5,410,207,203
240,Southeast Fairbanks Census Area,2011,6,437,256,181
240,Southeast Fairbanks Census Area,2011,7,511,271,240
240,Southeast Fairbanks Census Area,2011,8,414,236,178
240,Southeast Fairbanks Census Area,2011,9,455,265,190
240,Southeast Fairbanks Census Area,2011,10,529,309,220
240,Southeast Fairbanks Census Area,2011,11,612,347,265
240,Southeast Fairbanks Census Area,2011,12,568,317,251
240,Southeast Fairbanks Census Area,2011,13,461,290,171
240,Southeast Fairbanks Census Area,2011,14,252,161,91
240,Southeast Fairbanks Census Area,2011,15,203,108,95
240,Southeast Fairbanks Census Area,2011,16,106,60,46
240,Southeast Fairbanks Census Area,2011,17,68,29,39
240,Southeast Fairbanks Census Area,2011,18,40,15,25
275,Wrangell City and Borough,2011,0,2409,1258,1151
275,Wrangell City and Borough,2011,1,140,67,73
275,Wrangell City and Borough,2011,2,136,71,65
275,Wrangell City and Borough,2011,3,166,90,76
275,Wrangell City and Borough,2011,4,135,76,59
275,Wrangell City and Borough,2011,5,122,65,57
275,Wrangell City and Borough,2011,6,140,71,69
275,Wrangell City and Borough,2011,7,92,50,42
275,Wrangell City and Borough,2011,8,105,50,55
275,Wrangell City and Borough,2011,9,116,48,68
275,Wrangell City and Borough,2011,10,174,103,71
275,Wrangell City and Borough,2011,11,233,117,116
275,Wrangell City and Borough,2011,12,257,133,124
275,Wrangell City and Borough,2011,13,201,115,86
275,Wrangell City and Borough,2011,14,132,66,66
275,Wrangell City and Borough,2011,15,108,60,48
275,Wrangell City and Borough,2011,16,77,41,36
275,Wrangell City and Borough,2011,17,40,23,17
275,Wrangell City and Borough,2011,18,35,12,23
282,Yakutat City and Borough,2011,0,641,347,294
282,Yakutat City and Borough,2011,1,36,15,21
282,Yakutat City and Borough,2011,2,38,20,18
282,Yakutat City and Borough,2011,3,42,17,25
282,Yakutat City and Borough,2011,4,55,31,24
282,Yakutat City and Borough,2011,5,33,17,16
282,Yakutat City and Borough,2011,6,35,24,11
282,Yakutat City and Borough,2011,7,31,13,18
282,Yakutat City and Borough,2011,8,39,23,16
282,Yakutat City and Borough,2011,9,46,25,21
282,Yakutat City and Borough,2011,10,43,26,17
282,Yakutat City and Borough,2011,11,57,38,19
282,Yakutat City and Borough,2011,12,59,37,22
282,Yakutat City and Borough,2011,13,48,27,21
282,Yakutat City and Borough,2011,14,33,15,18
282,Yakutat City and Borough,2011,15,24,18,6
282,Yakutat City and Borough,2011,16,7,0,7
282,Yakutat City and Borough,2011,17,11,1,10
282,Yakutat City and Borough,2011,18,4,0,4
290,Yukon-Koyukuk Census Area,2011,0,5655,3058,2597
290,Yukon-Koyukuk Census Area,2011,1,469,258,211
290,Yukon-Koyukuk Census Area,2011,2,370,195,175
290,Yukon-Koyukuk Census Area,2011,3,464,222,242
290,Yukon-Koyukuk Census Area,2011,4,430,233,197
290,Yukon-Koyukuk Census Area,2011,5,377,205,172
290,Yukon-Koyukuk Census Area,2011,6,349,193,156
290,Yukon-Koyukuk Census Area,2011,7,337,206,131
290,Yukon-Koyukuk Census Area,2011,8,295,147,148
290,Yukon-Koyukuk Census Area,2011,9,245,117,128
290,Yukon-Koyukuk Census Area,2011,10,401,213,188
290,Yukon-Koyukuk Census Area,2011,11,481,257,224
290,Yukon-Koyukuk Census Area,2011,12,458,265,193
290,Yukon-Koyukuk Census Area,2011,13,380,205,175
290,Yukon-Koyukuk Census Area,2011,14,225,135,90
290,Yukon-Koyukuk Census Area,2011,15,145,87,58
290,Yukon-Koyukuk Census Area,2011,16,104,54,50
290,Yukon-Koyukuk Census Area,2011,17,82,42,40
290,Yukon-Koyukuk Census Area,2011,18,43,24,19
000,Alaska,2012,0,731005,378825,352180
000,Alaska,2012,1,54682,28142,26540
000,Alaska,2012,2,52686,26989,25697
000,Alaska,2012,3,51246,26317,24929
000,Alaska,2012,4,49708,26049,23659
000,Alaska,2012,5,55691,29953,25738
000,Alaska,2012,6,57760,30372,27388
000,Alaska,2012,7,52394,27230,25164
000,Alaska,2012,8,45326,23326,22000
000,Alaska,2012,9,46926,24407,22519
000,Alaska,2012,10,50225,25992,24233
000,Alaska,2012,11,56348,29218,27130
000,Alaska,2012,12,53391,27755,25636
000,Alaska,2012,13,40907,21638,19269
000,Alaska,2012,14,26338,13956,12382
000,Alaska,2012,15,15539,7918,7621
000,Alaska,2012,16,9803,4705,5098
000,Alaska,2012,17,6581,2915,3666
000,Alaska,2012,18,5454,1943,3511
013,Aleutians East Borough,2012,0,3148,2107,1041
013,Aleutians East Borough,2012,1,129,72,57
013,Aleutians East Borough,2012,2,108,57,51
013,Aleutians East Borough,2012,3,80,36,44
013,Aleutians East Borough,2012,4,98,60,38
013,Aleutians East Borough,2012,5,249,178,71
013,Aleutians East Borough,2012,6,241,183,58
013,Aleutians East Borough,2012,7,243,146,97
013,Aleutians East Borough,2012,8,246,174,72
013,Aleutians East Borough,2012,9,328,253,75
013,Aleutians East Borough,2012,10,375,262,113
013,Aleutians East Borough,2012,11,388,248,140
013,Aleutians East Borough,2012,12,307,223,84
013,Aleutians East Borough,2012,13,162,94,68
013,Aleutians East Borough,2012,14,112,72,40
013,Aleutians East Borough,2012,15,35,17,18
013,Aleutians East Borough,2012,16,24,14,10
013,Aleutians East Borough,2012,17,13,11,2
013,Aleutians East Borough,2012,18,10,7,3
016,Aleutians West Census Area,2012,0,5610,3798,1812
016,Aleutians West Census Area,2012,1,186,99,87
016,Aleutians West Census Area,2012,2,207,113,94
016,Aleutians West Census Area,2012,3,216,121,95
016,Aleutians West Census Area,2012,4,237,138,99
016,Aleutians West Census Area,2012,5,310,217,93
016,Aleutians West Census Area,2012,6,529,405,124
016,Aleutians West Census Area,2012,7,489,345,144
016,Aleutians West Census Area,2012,8,508,359,149
016,Aleutians West Census Area,2012,9,544,383,161
016,Aleutians West Census Area,2012,10,581,392,189
016,Aleutians West Census Area,2012,11,661,464,197
016,Aleutians West Census Area,2012,12,492,331,161
016,Aleutians West Census Area,2012,13,374,260,114
016,Aleutians West Census Area,2012,14,178,112,66
016,Aleutians West Census Area,2012,15,57,40,17
016,Aleutians West Census Area,2012,16,17,10,7
016,Aleutians West Census Area,2012,17,12,7,5
016,Aleutians West Census Area,2012,18,12,2,10
020,Anchorage Municipality,2012,0,298306,150932,147374
020,Anchorage Municipality,2012,1,21935,11374,10561
020,Anchorage Municipality,2012,2,20930,10686,10244
020,Anchorage Municipality,2012,3,20569,10606,9963
020,Anchorage Municipality,2012,4,20138,10342,9796
020,Anchorage Municipality,2012,5,24826,13122,11704
020,Anchorage Municipality,2012,6,25358,13076,12282
020,Anchorage Municipality,2012,7,22605,11374,11231
020,Anchorage Municipality,2012,8,18871,9459,9412
020,Anchorage Municipality,2012,9,19770,9961,9809
020,Anchorage Municipality,2012,10,20440,10153,10287
020,Anchorage Municipality,2012,11,22189,11078,11111
020,Anchorage Municipality,2012,12,20613,10343,10270
020,Anchorage Municipality,2012,13,15438,7795,7643
020,Anchorage Municipality,2012,14,10123,5191,4932
020,Anchorage Municipality,2012,15,5736,2747,2989
020,Anchorage Municipality,2012,16,3816,1719,2097
020,Anchorage Municipality,2012,17,2706,1133,1573
020,Anchorage Municipality,2012,18,2243,773,1470
050,Bethel Census Area,2012,0,17555,9091,8464
050,Bethel Census Area,2012,1,1816,928,888
050,Bethel Census Area,2012,2,1791,911,880
050,Bethel Census Area,2012,3,1719,890,829
050,Bethel Census Area,2012,4,1570,815,755
050,Bethel Census Area,2012,5,1442,699,743
050,Bethel Census Area,2012,6,1387,725,662
050,Bethel Census Area,2012,7,1112,556,556
050,Bethel Census Area,2012,8,885,435,450
050,Bethel Census Area,2012,9,934,488,446
050,Bethel Census Area,2012,10,1134,654,480
050,Bethel Census Area,2012,11,1067,606,461
050,Bethel Census Area,2012,12,929,495,434
050,Bethel Census Area,2012,13,677,351,326
050,Bethel Census Area,2012,14,436,234,202
050,Bethel Census Area,2012,15,264,129,135
050,Bethel Census Area,2012,16,204,93,111
050,Bethel Census Area,2012,17,120,51,69
050,Bethel Census Area,2012,18,68,31,37
060,Bristol Bay Borough,2012,0,984,545,439
060,Bristol Bay Borough,2012,1,46,29,17
060,Bristol Bay Borough,2012,2,47,26,21
060,Bristol Bay Borough,2012,3,65,31,34
060,Bristol Bay Borough,2012,4,73,33,40
060,Bristol Bay Borough,2012,5,43,24,19
060,Bristol Bay Borough,2012,6,88,48,40
060,Bristol Bay Borough,2012,7,37,20,17
060,Bristol Bay Borough,2012,8,56,30,26
060,Bristol Bay Borough,2012,9,76,46,30
060,Bristol Bay Borough,2012,10,87,48,39
060,Bristol Bay Borough,2012,11,106,57,49
060,Bristol Bay Borough,2012,12,102,59,43
060,Bristol Bay Borough,2012,13,74,47,27
060,Bristol Bay Borough,2012,14,28,18,10
060,Bristol Bay Borough,2012,15,25,16,9
060,Bristol Bay Borough,2012,16,17,6,11
060,Bristol Bay Borough,2012,17,9,7,2
060,Bristol Bay Borough,2012,18,5,0,5
063,Chugach Census Area,2012,0,6907,3650,3257
063,Chugach Census Area,2012,1,494,229,265
063,Chugach Census Area,2012,2,439,221,218
063,Chugach Census Area,2012,3,446,216,230
063,Chugach Census Area,2012,4,442,247,195
063,Chugach Census Area,2012,5,375,206,169
063,Chugach Census Area,2012,6,550,303,247
063,Chugach Census Area,2012,7,448,243,205
063,Chugach Census Area,2012,8,445,247,198
063,Chugach Census Area,2012,9,459,238,221
063,Chugach Census Area,2012,10,522,281,241
063,Chugach Census Area,2012,11,676,380,296
063,Chugach Census Area,2012,12,630,322,308
063,Chugach Census Area,2012,13,437,248,189
063,Chugach Census Area,2012,14,265,139,126
063,Chugach Census Area,2012,15,121,54,67
063,Chugach Census Area,2012,16,80,48,32
063,Chugach Census Area,2012,17,42,15,27
063,Chugach Census Area,2012,18,36,13,23
066,Copper River Census Area,2012,0,3034,1610,1424
066,Copper River Census Area,2012,1,195,107,88
066,Copper River Census Area,2012,2,205,106,99
066,Copper River Census Area,2012,3,235,107,128
066,Copper River Census Area,2012,4,204,97,107
066,Copper River Census Area,2012,5,147,75,72
066,Copper River Census Area,2012,6,151,87,64
066,Copper River Census Area,2012,7,174,91,83
066,Copper River Census Area,2012,8,148,68,80
066,Copper River Census Area,2012,9,161,92,69
066,Copper River Census Area,2012,10,202,99,103
066,Copper River Census Area,2012,11,294,153,141
066,Copper River Census Area,2012,12,281,155,126
066,Copper River Census Area,2012,13,287,177,110
066,Copper River Census Area,2012,14,138,83,55
066,Copper River Census Area,2012,15,102,52,50
066,Copper River Census Area,2012,16,55,37,18
066,Copper River Census Area,2012,17,26,15,11
066,Copper River Census Area,2012,18,29,9,20
068,Denali Borough,2012,0,1849,1031,818
068,Denali Borough,2012,1,114,64,50
068,Denali Borough,2012,2,111,73,38
068,Denali Borough,2012,3,132,59,73
068,Denali Borough,2012,4,92,39,53
068,Denali Borough,2012,5,46,26,20
068,Denali Borough,2012,6,97,46,51
068,Denali Borough,2012,7,144,72,72
068,Denali Borough,2012,8,114,51,63
068,Denali Borough,2012,9,147,82,65
068,Denali Borough,2012,10,168,94,74
068,Denali Borough,2012,11,171,109,62
068,Denali Borough,2012,12,189,109,80
068,Denali Borough,2012,13,166,114,52
068,Denali Borough,2012,14,64,35,29
068,Denali Borough,2012,15,57,35,22
068,Denali Borough,2012,16,25,17,8
068,Denali Borough,2012,17,9,3,6
068,Denali Borough,2012,18,3,3,0
070,Dillingham Census Area,2012,0,4979,2600,2379
070,Dillingham Census Area,2012,1,498,256,242
070,Dillingham Census Area,2012,2,433,231,202
070,Dillingham Census Area,2012,3,412,217,195
070,Dillingham Census Area,2012,4,442,229,213
070,Dillingham Census Area,2012,5,406,212,194
070,Dillingham Census Area,2012,6,344,180,164
070,Dillingham Census Area,2012,7,290,142,148
070,Dillingham Census Area,2012,8,243,133,110
070,Dillingham Census Area,2012,9,231,127,104
070,Dillingham Census Area,2012,10,352,165,187
070,Dillingham Census Area,2012,11,357,195,162
070,Dillingham Census Area,2012,12,343,181,162
070,Dillingham Census Area,2012,13,248,137,111
070,Dillingham Census Area,2012,14,135,68,67
070,Dillingham Census Area,2012,15,114,58,56
070,Dillingham Census Area,2012,16,63,37,26
070,Dillingham Census Area,2012,17,43,22,21
070,Dillingham Census Area,2012,18,25,10,15
090,Fairbanks North Star Borough,2012,0,100695,52863,47832
090,Fairbanks North Star Borough,2012,1,8065,4175,3890
090,Fairbanks North Star Borough,2012,2,7341,3714,3627
090,Fairbanks North Star Borough,2012,3,6474,3373,3101
090,Fairbanks North Star Borough,2012,4,6368,3374,2994
090,Fairbanks North Star Borough,2012,5,9870,5524,4346
090,Fairbanks North Star Borough,2012,6,9407,5089,4318
090,Fairbanks North Star Borough,2012,7,8031,4357,3674
090,Fairbanks North Star Borough,2012,8,6543,3329,3214
090,Fairbanks North Star Borough,2012,9,6155,3281,2874
090,Fairbanks North Star Borough,2012,10,6135,3112,3023
090,Fairbanks North Star Borough,2012,11,6978,3557,3421
090,Fairbanks North Star Borough,2012,12,6621,3364,3257
090,Fairbanks North Star Borough,2012,13,5158,2798,2360
090,Fairbanks North Star Borough,2012,14,3228,1763,1465
090,Fairbanks North Star Borough,2012,15,1859,940,919
090,Fairbanks North Star Borough,2012,16,1051,544,507
090,Fairbanks North Star Borough,2012,17,775,344,431
090,Fairbanks North Star Borough,2012,18,636,225,411
100,Haines Borough,2012,0,2613,1311,1302
100,Haines Borough,2012,1,134,72,62
100,Haines Borough,2012,2,151,65,86
100,Haines Borough,2012,3,141,81,60
100,Haines Borough,2012,4,131,65,66
100,Haines Borough,2012,5,99,60,39
100,Haines Borough,2012,6,118,59,59
100,Haines Borough,2012,7,151,72,79
100,Haines Borough,2012,8,145,68,77
100,Haines Borough,2012,9,175,86,89
100,Haines Borough,2012,10,191,104,87
100,Haines Borough,2012,11,229,115,114
100,Haines Borough,2012,12,287,149,138
100,Haines Borough,2012,13,251,130,121
100,Haines Borough,2012,14,179,83,96
100,Haines Borough,2012,15,81,41,40
100,Haines Borough,2012,16,61,24,37
100,Haines Borough,2012,17,50,23,27
100,Haines Borough,2012,18,39,14,25
105,Hoonah-Angoon Census Area,2012,0,2200,1196,1004
105,Hoonah-Angoon Census Area,2012,1,147,83,64
105,Hoonah-Angoon Census Area,2012,2,109,51,58
105,Hoonah-Angoon Census Area,2012,3,123,53,70
105,Hoonah-Angoon Census Area,2012,4,104,56,48
105,Hoonah-Angoon Census Area,2012,5,100,55,45
105,Hoonah-Angoon Census Area,2012,6,122,71,51
105,Hoonah-Angoon Census Area,2012,7,122,58,64
105,Hoonah-Angoon Census Area,2012,8,116,60,56
105,Hoonah-Angoon Census Area,2012,9,122,72,50
105,Hoonah-Angoon Census Area,2012,10,149,75,74
105,Hoonah-Angoon Census Area,2012,11,206,109,97
105,Hoonah-Angoon Census Area,2012,12,224,123,101
105,Hoonah-Angoon Census Area,2012,13,228,124,104
105,Hoonah-Angoon Census Area,2012,14,151,94,57
105,Hoonah-Angoon Census Area,2012,15,83,51,32
105,Hoonah-Angoon Census Area,2012,16,55,39,16
105,Hoonah-Angoon Census Area,2012,17,22,15,7
105,Hoonah-Angoon Census Area,2012,18,17,7,10
110,Juneau City and Borough,2012,0,32676,16609,16067
110,Juneau City and Borough,2012,1,2038,1026,1012
110,Juneau City and Borough,2012,2,2072,1041,1031
110,Juneau City and Borough,2012,3,2069,1081,988
110,Juneau City and Borough,2012,4,2128,1122,1006
110,Juneau City and Borough,2012,5,2046,1043,1003
110,Juneau City and Borough,2012,6,2532,1259,1273
110,Juneau City and Borough,2012,7,2286,1205,1081
110,Juneau City and Borough,2012,8,2062,1046,1016
110,Juneau City and Borough,2012,9,2272,1157,1115
110,Juneau City and Borough,2012,10,2458,1251,1207
110,Juneau City and Borough,2012,11,2873,1491,1382
110,Juneau City and Borough,2012,12,2661,1321,1340
110,Juneau City and Borough,2012,13,2119,1122,997
110,Juneau City and Borough,2012,14,1279,657,622
110,Juneau City and Borough,2012,15,759,378,381
110,Juneau City and Borough,2012,16,438,186,252
110,Juneau City and Borough,2012,17,303,126,177
110,Juneau City and Borough,2012,18,281,97,184
122,Kenai Peninsula Borough,2012,0,56624,29485,27139
122,Kenai Peninsula Borough,2012,1,3512,1766,1746
122,Kenai Peninsula Borough,2012,2,3491,1788,1703
122,Kenai Peninsula Borough,2012,3,3705,1798,1907
122,Kenai Peninsula Borough,2012,4,3680,1969,1711
122,Kenai Peninsula Borough,2012,5,3135,1769,1366
122,Kenai Peninsula Borough,2012,6,3380,1851,1529
122,Kenai Peninsula Borough,2012,7,3263,1689,1574
122,Kenai Peninsula Borough,2012,8,3192,1684,1508
122,Kenai Peninsula Borough,2012,9,3513,1862,1651
122,Kenai Peninsula Borough,2012,10,3888,1987,1901
122,Kenai Peninsula Borough,2012,11,4936,2523,2413
122,Kenai Peninsula Borough,2012,12,5316,2686,2630
122,Kenai Peninsula Borough,2012,13,4309,2324,1985
122,Kenai Peninsula Borough,2012,14,3002,1649,1353
122,Kenai Peninsula Borough,2012,15,1816,974,842
122,Kenai Peninsula Borough,2012,16,1166,588,578
122,Kenai Peninsula Borough,2012,17,697,338,359
122,Kenai Peninsula Borough,2012,18,623,240,383
130,Ketchikan Gateway Borough,2012,0,13893,7105,6788
130,Ketchikan Gateway Borough,2012,1,930,437,493
130,Ketchikan Gateway Borough,2012,2,848,449,399
130,Ketchikan Gateway Borough,2012,3,870,455,415
130,Ketchikan Gateway Borough,2012,4,883,470,413
130,Ketchikan Gateway Borough,2012,5,910,487,423
130,Ketchikan Gateway Borough,2012,6,957,498,459
130,Ketchikan Gateway Borough,2012,7,938,477,461
130,Ketchikan Gateway Borough,2012,8,811,397,414
130,Ketchikan Gateway Borough,2012,9,893,449,444
130,Ketchikan Gateway Borough,2012,10,975,489,486
130,Ketchikan Gateway Borough,2012,11,1182,642,540
130,Ketchikan Gateway Borough,2012,12,1179,592,587
130,Ketchikan Gateway Borough,2012,13,944,501,443
130,Ketchikan Gateway Borough,2012,14,619,310,309
130,Ketchikan Gateway Borough,2012,15,381,198,183
130,Ketchikan Gateway Borough,2012,16,232,117,115
130,Ketchikan Gateway Borough,2012,17,175,79,96
130,Ketchikan Gateway Borough,2012,18,166,58,108
150,Kodiak Island Borough,2012,0,13981,7405,6576
150,Kodiak Island Borough,2012,1,1142,592,550
150,Kodiak Island Borough,2012,2,1018,524,494
150,Kodiak Island Borough,2012,3,1043,556,487
150,Kodiak Island Borough,2012,4,1000,530,470
150,Kodiak Island Borough,2012,5,1043,590,453
150,Kodiak Island Borough,2012,6,1129,618,511
150,Kodiak Island Borough,2012,7,1068,567,501
150,Kodiak Island Borough,2012,8,842,452,390
150,Kodiak Island Borough,2012,9,839,432,407
150,Kodiak Island Borough,2012,10,985,501,484
150,Kodiak Island Borough,2012,11,1089,589,500
150,Kodiak Island Borough,2012,12,993,553,440
150,Kodiak Island Borough,2012,13,698,366,332
150,Kodiak Island Borough,2012,14,470,234,236
150,Kodiak Island Borough,2012,15,293,154,139
150,Kodiak Island Borough,2012,16,155,77,78
150,Kodiak Island Borough,2012,17,91,33,58
150,Kodiak Island Borough,2012,18,83,37,46
158,Kusilvak Census Area,2012,0,7675,3985,3690
158,Kusilvak Census Area,2012,1,911,487,424
158,Kusilvak Census Area,2012,2,884,460,424
158,Kusilvak Census Area,2012,3,838,424,414
158,Kusilvak Census Area,2012,4,803,406,397
158,Kusilvak Census Area,2012,5,772,408,364
158,Kusilvak Census Area,2012,6,608,308,300
158,Kusilvak Census Area,2012,7,364,192,172
158,Kusilvak Census Area,2012,8,376,208,168
158,Kusilvak Census Area,2012,9,363,177,186
158,Kusilvak Census Area,2012,10,411,216,195
158,Kusilvak Census Area,2012,11,391,206,185
158,Kusilvak Census Area,2012,12,314,179,135
158,Kusilvak Census Area,2012,13,232,123,109
158,Kusilvak Census Area,2012,14,156,84,72
158,Kusilvak Census Area,2012,15,95,46,49
158,Kusilvak Census Area,2012,16,82,33,49
158,Kusilvak Census Area,2012,17,38,18,20
158,Kusilvak Census Area,2012,18,37,10,27
164,Lake and Peninsula Borough,2012,0,1679,893,786
164,Lake and Peninsula Borough,2012,1,144,74,70
164,Lake and Peninsula Borough,2012,2,137,75,62
164,Lake and Peninsula Borough,2012,3,118,51,67
164,Lake and Peninsula Borough,2012,4,132,77,55
164,Lake and Peninsula Borough,2012,5,136,63,73
164,Lake and Peninsula Borough,2012,6,137,73,64
164,Lake and Peninsula Borough,2012,7,118,67,51
164,Lake and Peninsula Borough,2012,8,97,49,48
164,Lake and Peninsula Borough,2012,9,56,35,21
164,Lake and Peninsula Borough,2012,10,118,62,56
164,Lake and Peninsula Borough,2012,11,150,86,64
164,Lake and Peninsula Borough,2012,12,114,68,46
164,Lake and Peninsula Borough,2012,13,86,40,46
164,Lake and Peninsula Borough,2012,14,57,32,25
164,Lake and Peninsula Borough,2012,15,38,17,21
164,Lake and Peninsula Borough,2012,16,15,11,4
164,Lake and Peninsula Borough,2012,17,17,11,6
164,Lake and Peninsula Borough,2012,18,9,2,7
170,Matanuska-Susitna Borough,2012,0,93664,48270,45394
170,Matanuska-Susitna Borough,2012,1,7004,3625,3379
170,Matanuska-Susitna Borough,2012,2,7674,3934,3740
170,Matanuska-Susitna Borough,2012,3,7350,3745,3605
170,Matanuska-Susitna Borough,2012,4,7047,3750,3297
170,Matanuska-Susitna Borough,2012,5,5381,2856,2525
170,Matanuska-Susitna Borough,2012,6,6148,3081,3067
170,Matanuska-Susitna Borough,2012,7,6285,3198,3087
170,Matanuska-Susitna Borough,2012,8,5949,3021,2928
170,Matanuska-Susitna Borough,2012,9,6387,3297,3090
170,Matanuska-Susitna Borough,2012,10,6571,3414,3157
170,Matanuska-Susitna Borough,2012,11,7504,3854,3650
170,Matanuska-Susitna Borough,2012,12,6821,3607,3214
170,Matanuska-Susitna Borough,2012,13,5270,2720,2550
170,Matanuska-Susitna Borough,2012,14,3373,1748,1625
170,Matanuska-Susitna Borough,2012,15,2159,1161,998
170,Matanuska-Susitna Borough,2012,16,1281,635,646
170,Matanuska-Susitna Borough,2012,17,830,405,425
170,Matanuska-Susitna Borough,2012,18,630,219,411
180,Nome Census Area,2012,0,9847,5255,4592
180,Nome Census Area,2012,1,1085,578,507
180,Nome Census Area,2012,2,937,479,458
180,Nome Census Area,2012,3,893,466,427
180,Nome Census Area,2012,4,773,428,345
180,Nome Census Area,2012,5,823,421,402
180,Nome Census Area,2012,6,801,440,361
180,Nome Census Area,2012,7,615,325,290
180,Nome Census Area,2012,8,568,302,266
180,Nome Census Area,2012,9,515,270,245
180,Nome Census Area,2012,10,594,329,265
180,Nome Census Area,2012,11,611,338,273
180,Nome Census Area,2012,12,559,297,262
180,Nome Census Area,2012,13,437,241,196
180,Nome Census Area,2012,14,266,155,111
180,Nome Census Area,2012,15,150,93,57
180,Nome Census Area,2012,16,112,46,66
180,Nome Census Area,2012,17,63,27,36
180,Nome Census Area,2012,18,45,20,25
185,North Slope Borough,2012,0,9710,6061,3649
185,North Slope Borough,2012,1,764,385,379
185,North Slope Borough,2012,2,694,368,326
185,North Slope Borough,2012,3,596,310,286
185,North Slope Borough,2012,4,542,289,253
185,North Slope Borough,2012,5,800,476,324
185,North Slope Borough,2012,6,839,513,326
185,North Slope Borough,2012,7,764,495,269
185,North Slope Borough,2012,8,574,401,173
185,North Slope Borough,2012,9,540,357,183
185,North Slope Borough,2012,10,864,608,256
185,North Slope Borough,2012,11,899,598,301
185,North Slope Borough,2012,12,915,685,230
185,North Slope Borough,2012,13,494,331,163
185,North Slope Borough,2012,14,216,150,66
185,North Slope Borough,2012,15,87,45,42
185,North Slope Borough,2012,16,58,24,34
185,North Slope Borough,2012,17,40,16,24
185,North Slope Borough,2012,18,24,10,14
188,Northwest Arctic Borough,2012,0,7712,4136,3576
188,Northwest Arctic Borough,2012,1,887,468,419
188,Northwest Arctic Borough,2012,2,750,375,375
188,Northwest Arctic Borough,2012,3,705,356,349
188,Northwest Arctic Borough,2012,4,597,300,297
188,Northwest Arctic Borough,2012,5,768,421,347
188,Northwest Arctic Borough,2012,6,617,331,286
188,Northwest Arctic Borough,2012,7,503,271,232
188,Northwest Arctic Borough,2012,8,402,226,176
188,Northwest Arctic Borough,2012,9,369,211,158
188,Northwest Arctic Borough,2012,10,473,282,191
188,Northwest Arctic Borough,2012,11,466,266,200
188,Northwest Arctic Borough,2012,12,405,239,166
188,Northwest Arctic Borough,2012,13,278,165,113
188,Northwest Arctic Borough,2012,14,181,86,95
188,Northwest Arctic Borough,2012,15,123,68,55
188,Northwest Arctic Borough,2012,16,88,36,52
188,Northwest Arctic Borough,2012,17,59,22,37
188,Northwest Arctic Borough,2012,18,41,13,28
195,Petersburg Borough,2012,0,3244,1671,1573
195,Petersburg Borough,2012,1,215,105,110
195,Petersburg Borough,2012,2,167,83,84
195,Petersburg Borough,2012,3,239,128,111
195,Petersburg Borough,2012,4,191,98,93
195,Petersburg Borough,2012,5,151,70,81
195,Petersburg Borough,2012,6,203,97,106
195,Petersburg Borough,2012,7,193,100,93
195,Petersburg Borough,2012,8,177,92,85
195,Petersburg Borough,2012,9,207,99,108
195,Petersburg Borough,2012,10,238,125,113
195,Petersburg Borough,2012,11,252,122,130
195,Petersburg Borough,2012,12,317,167,150
195,Petersburg Borough,2012,13,261,143,118
195,Petersburg Borough,2012,14,194,119,75
195,Petersburg Borough,2012,15,104,57,47
195,Petersburg Borough,2012,16,47,30,17
195,Petersburg Borough,2012,17,41,14,27
195,Petersburg Borough,2012,18,47,22,25
198,Prince of Wales-Hyder Census Area,2012,0,6462,3535,2927
198,Prince of Wales-Hyder Census Area,2012,1,481,217,264
198,Prince of Wales-Hyder Census Area,2012,2,439,240,199
198,Prince of Wales-Hyder Census Area,2012,3,434,240,194
198,Prince of Wales-Hyder Census Area,2012,4,397,234,163
198,Prince of Wales-Hyder Census Area,2012,5,364,215,149
198,Prince of Wales-Hyder Census Area,2012,6,339,171,168
198,Prince of Wales-Hyder Census Area,2012,7,377,202,175
198,Prince of Wales-Hyder Census Area,2012,8,372,188,184
198,Prince of Wales-Hyder Census Area,2012,9,407,202,205
198,Prince of Wales-Hyder Census Area,2012,10,516,303,213
198,Prince of Wales-Hyder Census Area,2012,11,548,289,259
198,Prince of Wales-Hyder Census Area,2012,12,572,313,259
198,Prince of Wales-Hyder Census Area,2012,13,469,284,185
198,Prince of Wales-Hyder Census Area,2012,14,335,199,136
198,Prince of Wales-Hyder Census Area,2012,15,196,117,79
198,Prince of Wales-Hyder Census Area,2012,16,125,79,46
198,Prince of Wales-Hyder Census Area,2012,17,60,22,38
198,Prince of Wales-Hyder Census Area,2012,18,31,20,11
220,Sitka City and Borough,2012,0,9063,4526,4537
220,Sitka City and Borough,2012,1,607,297,310
220,Sitka City and Borough,2012,2,573,304,269
220,Sitka City and Borough,2012,3,552,293,259
220,Sitka City and Borough,2012,4,531,280,251
220,Sitka City and Borough,2012,5,509,251,258
220,Sitka City and Borough,2012,6,640,278,362
220,Sitka City and Borough,2012,7,657,344,313
220,Sitka City and Borough,2012,8,602,325,277
220,Sitka City and Borough,2012,9,553,275,278
220,Sitka City and Borough,2012,10,577,303,274
220,Sitka City and Borough,2012,11,749,378,371
220,Sitka City and Borough,2012,12,739,367,372
220,Sitka City and Borough,2012,13,609,318,291
220,Sitka City and Borough,2012,14,378,193,185
220,Sitka City and Borough,2012,15,289,142,147
220,Sitka City and Borough,2012,16,204,83,121
220,Sitka City and Borough,2012,17,128,56,72
220,Sitka City and Borough,2012,18,166,39,127
230,"Skagway Borough, Municipality",2012,0,957,493,464
230,"Skagway Borough, Municipality",2012,1,62,26,36
230,"Skagway Borough, Municipality",2012,2,29,15,14
230,"Skagway Borough, Municipality",2012,3,32,15,17
230,"Skagway Borough, Municipality",2012,4,30,16,14
230,"Skagway Borough, Municipality",2012,5,36,17,19
230,"Skagway Borough, Municipality",2012,6,77,41,36
230,"Skagway Borough, Municipality",2012,7,95,52,43
230,"Skagway Borough, Municipality",2012,8,63,33,30
230,"Skagway Borough, Municipality",2012,9,88,44,44
230,"Skagway Borough, Municipality",2012,10,79,41,38
230,"Skagway Borough, Municipality",2012,11,74,39,35
230,"Skagway Borough, Municipality",2012,12,100,62,38
230,"Skagway Borough, Municipality",2012,13,78,47,31
230,"Skagway Borough, Municipality",2012,14,49,19,30
230,"Skagway Borough, Municipality",2012,15,32,18,14
230,"Skagway Borough, Municipality",2012,16,17,3,14
230,"Skagway Borough, Municipality",2012,17,10,2,8
230,"Skagway Borough, Municipality",2012,18,6,3,3
240,Southeast Fairbanks Census Area,2012,0,7200,3981,3219
240,Southeast Fairbanks Census Area,2012,1,499,241,258
240,Southeast Fairbanks Census Area,2012,2,536,298,238
240,Southeast Fairbanks Census Area,2012,3,545,298,247
240,Southeast Fairbanks Census Area,2012,4,468,245,223
240,Southeast Fairbanks Census Area,2012,5,411,207,204
240,Southeast Fairbanks Census Area,2012,6,408,240,168
240,Southeast Fairbanks Census Area,2012,7,545,287,258
240,Southeast Fairbanks Census Area,2012,8,455,262,193
240,Southeast Fairbanks Census Area,2012,9,415,235,180
240,Southeast Fairbanks Census Area,2012,10,547,317,230
240,Southeast Fairbanks Census Area,2012,11,567,335,232
240,Southeast Fairbanks Census Area,2012,12,598,321,277
240,Southeast Fairbanks Census Area,2012,13,462,281,181
240,Southeast Fairbanks Census Area,2012,14,292,185,107
240,Southeast Fairbanks Census Area,2012,15,217,118,99
240,Southeast Fairbanks Census Area,2012,16,116,65,51
240,Southeast Fairbanks Census Area,2012,17,63,31,32
240,Southeast Fairbanks Census Area,2012,18,56,15,41
275,Wrangell City and Borough,2012,0,2444,1271,1173
275,Wrangell City and Borough,2012,1,135,60,75
275,Wrangell City and Borough,2012,2,143,66,77
275,Wrangell City and Borough,2012,3,155,82,73
275,Wrangell City and Borough,2012,4,154,89,65
275,Wrangell City and Borough,2012,5,108,53,55
275,Wrangell City and Borough,2012,6,145,74,71
275,Wrangell City and Borough,2012,7,101,58,43
275,Wrangell City and Borough,2012,8,101,46,55
275,Wrangell City and Borough,2012,9,120,58,62
275,Wrangell City and Borough,2012,10,173,96,77
275,Wrangell City and Borough,2012,11,227,114,113
275,Wrangell City and Borough,2012,12,259,143,116
275,Wrangell City and Borough,2012,13,210,114,96
275,Wrangell City and Borough,2012,14,153,79,74
275,Wrangell City and Borough,2012,15,104,58,46
275,Wrangell City and Borough,2012,16,82,45,37
275,Wrangell City and Borough,2012,17,41,22,19
275,Wrangell City and Borough,2012,18,33,14,19
282,Yakutat City and Borough,2012,0,621,334,287
282,Yakutat City and Borough,2012,1,32,13,19
282,Yakutat City and Borough,2012,2,30,14,16
282,Yakutat City and Borough,2012,3,45,16,29
282,Yakutat City and Borough,2012,4,45,27,18
282,Yakutat City and Borough,2012,5,32,17,15
282,Yakutat City and Borough,2012,6,32,18,14
282,Yakutat City and Borough,2012,7,33,19,14
282,Yakutat City and Borough,2012,8,43,24,19
282,Yakutat City and Borough,2012,9,43,24,19
282,Yakutat City and Borough,2012,10,46,26,20
282,Yakutat City and Borough,2012,11,55,36,19
282,Yakutat City and Borough,2012,12,53,33,20
282,Yakutat City and Borough,2012,13,54,30,24
282,Yakutat City and Borough,2012,14,32,17,15
282,Yakutat City and Borough,2012,15,22,17,5
282,Yakutat City and Borough,2012,16,9,1,8
282,Yakutat City and Borough,2012,17,10,1,9
282,Yakutat City and Borough,2012,18,5,1,4
290,Yukon-Koyukuk Census Area,2012,0,5673,3076,2597
290,Yukon-Koyukuk Census Area,2012,1,475,257,218
290,Yukon-Koyukuk Census Area,2012,2,392,222,170
290,Yukon-Koyukuk Census Area,2012,3,445,213,232
290,Yukon-Koyukuk Census Area,2012,4,408,224,184
290,Yukon-Koyukuk Census Area,2012,5,353,191,162
290,Yukon-Koyukuk Census Area,2012,6,376,209,167
290,Yukon-Koyukuk Census Area,2012,7,343,206,137
290,Yukon-Koyukuk Census Area,2012,8,320,157,163
290,Yukon-Koyukuk Census Area,2012,9,244,114,130
290,Yukon-Koyukuk Census Area,2012,10,376,203,173
290,Yukon-Koyukuk Census Area,2012,11,453,241,212
290,Yukon-Koyukuk Census Area,2012,12,458,268,190
290,Yukon-Koyukuk Census Area,2012,13,397,213,184
290,Yukon-Koyukuk Census Area,2012,14,249,148,101
290,Yukon-Koyukuk Census Area,2012,15,140,77,63
290,Yukon-Koyukuk Census Area,2012,16,108,58,50
290,Yukon-Koyukuk Census Area,2012,17,88,46,42
290,Yukon-Koyukuk Census Area,2012,18,48,29,19
000,Alaska,2013,0,736552,380827,355725
000,Alaska,2013,1,54240,27980,26260
000,Alaska,2013,2,53850,27621,26229
000,Alaska,2013,3,51821,26705,25116
000,Alaska,2013,4,49050,25595,23455
000,Alaska,2013,5,54934,29497,25437
000,Alaska,2013,6,57186,29785,27401
000,Alaska,2013,7,54284,28103,26181
000,Alaska,2013,8,45850,23663,22187
000,Alaska,2013,9,46510,23932,22578
000,Alaska,2013,10,47909,24714,23195
000,Alaska,2013,11,56007,29014,26993
000,Alaska,2013,12,54102,27868,26234
000,Alaska,2013,13,43039,22787,20252
000,Alaska,2013,14,28053,14813,13240
000,Alaska,2013,15,16918,8653,8265
000,Alaska,2013,16,10393,5055,5338
000,Alaska,2013,17,6764,2994,3770
000,Alaska,2013,18,5642,2048,3594
013,Aleutians East Borough,2013,0,3151,2082,1069
013,Aleutians East Borough,2013,1,107,56,51
013,Aleutians East Borough,2013,2,98,49,49
013,Aleutians East Borough,2013,3,91,42,49
013,Aleutians East Borough,2013,4,113,69,44
013,Aleutians East Borough,2013,5,238,172,66
013,Aleutians East Borough,2013,6,206,151,55
013,Aleutians East Borough,2013,7,269,178,91
013,Aleutians East Borough,2013,8,286,211,75
013,Aleutians East Borough,2013,9,253,187,66
013,Aleutians East Borough,2013,10,353,236,117
013,Aleutians East Borough,2013,11,408,266,142
013,Aleutians East Borough,2013,12,318,212,106
013,Aleutians East Borough,2013,13,188,110,78
013,Aleutians East Borough,2013,14,122,77,45
013,Aleutians East Borough,2013,15,44,25,19
013,Aleutians East Borough,2013,16,31,20,11
013,Aleutians East Borough,2013,17,14,12,2
013,Aleutians East Borough,2013,18,12,9,3
016,Aleutians West Census Area,2013,0,5624,3729,1895
016,Aleutians West Census Area,2013,1,192,101,91
016,Aleutians West Census Area,2013,2,240,124,116
016,Aleutians West Census Area,2013,3,205,116,89
016,Aleutians West Census Area,2013,4,260,157,103
016,Aleutians West Census Area,2013,5,302,196,106
016,Aleutians West Census Area,2013,6,474,357,117
016,Aleutians West Census Area,2013,7,501,338,163
016,Aleutians West Census Area,2013,8,517,358,159
016,Aleutians West Census Area,2013,9,480,334,146
016,Aleutians West Census Area,2013,10,567,388,179
016,Aleutians West Census Area,2013,11,660,433,227
016,Aleutians West Census Area,2013,12,510,359,151
016,Aleutians West Census Area,2013,13,401,267,134
016,Aleutians West Census Area,2013,14,212,139,73
016,Aleutians West Census Area,2013,15,63,43,20
016,Aleutians West Census Area,2013,16,16,9,7
016,Aleutians West Census Area,2013,17,11,7,4
016,Aleutians West Census Area,2013,18,13,3,10
020,Anchorage Municipality,2013,0,301223,152191,149032
020,Anchorage Municipality,2013,1,21913,11448,10465
020,Anchorage Municipality,2013,2,21436,10973,10463
020,Anchorage Municipality,2013,3,20746,10739,10007
020,Anchorage Municipality,2013,4,19848,10094,9754
020,Anchorage Municipality,2013,5,24723,12995,11728
020,Anchorage Municipality,2013,6,25439,13046,12393
020,Anchorage Municipality,2013,7,23646,11896,11750
020,Anchorage Municipality,2013,8,19111,9589,9522
020,Anchorage Municipality,2013,9,19526,9764,9762
020,Anchorage Municipality,2013,10,19540,9701,9839
020,Anchorage Municipality,2013,11,22220,11087,11133
020,Anchorage Municipality,2013,12,20779,10315,10464
020,Anchorage Municipality,2013,13,16122,8212,7910
020,Anchorage Municipality,2013,14,10771,5479,5292
020,Anchorage Municipality,2013,15,6245,3026,3219
020,Anchorage Municipality,2013,16,4074,1851,2223
020,Anchorage Municipality,2013,17,2753,1162,1591
020,Anchorage Municipality,2013,18,2331,814,1517
050,Bethel Census Area,2013,0,17901,9253,8648
050,Bethel Census Area,2013,1,1875,959,916
050,Bethel Census Area,2013,2,1837,922,915
050,Bethel Census Area,2013,3,1736,922,814
050,Bethel Census Area,2013,4,1585,818,767
050,Bethel Census Area,2013,5,1476,722,754
050,Bethel Census Area,2013,6,1442,743,699
050,Bethel Census Area,2013,7,1166,583,583
050,Bethel Census Area,2013,8,889,441,448
050,Bethel Census Area,2013,9,911,449,462
050,Bethel Census Area,2013,10,1069,615,454
050,Bethel Census Area,2013,11,1106,627,479
050,Bethel Census Area,2013,12,988,521,467
050,Bethel Census Area,2013,13,721,380,341
050,Bethel Census Area,2013,14,433,234,199
050,Bethel Census Area,2013,15,275,135,140
050,Bethel Census Area,2013,16,199,105,94
050,Bethel Census Area,2013,17,130,49,81
050,Bethel Census Area,2013,18,63,28,35
060,Bristol Bay Borough,2013,0,933,513,420
060,Bristol Bay Borough,2013,1,43,25,18
060,Bristol Bay Borough,2013,2,45,25,20
060,Bristol Bay Borough,2013,3,57,26,31
060,Bristol Bay Borough,2013,4,73,35,38
060,Bristol Bay Borough,2013,5,36,23,13
060,Bristol Bay Borough,2013,6,81,45,36
060,Bristol Bay Borough,2013,7,40,20,20
060,Bristol Bay Borough,2013,8,56,26,30
060,Bristol Bay Borough,2013,9,62,41,21
060,Bristol Bay Borough,2013,10,77,43,34
060,Bristol Bay Borough,2013,11,100,54,46
060,Bristol Bay Borough,2013,12,99,61,38
060,Bristol Bay Borough,2013,13,76,40,36
060,Bristol Bay Borough,2013,14,28,18,10
060,Bristol Bay Borough,2013,15,23,15,8
060,Bristol Bay Borough,2013,16,24,9,15
060,Bristol Bay Borough,2013,17,9,7,2
060,Bristol Bay Borough,2013,18,4,0,4
063,Chugach Census Area,2013,0,6849,3601,3248
063,Chugach Census Area,2013,1,468,218,250
063,Chugach Census Area,2013,2,448,232,216
063,Chugach Census Area,2013,3,435,212,223
063,Chugach Census Area,2013,4,429,225,204
063,Chugach Census Area,2013,5,359,196,163
063,Chugach Census Area,2013,6,567,319,248
063,Chugach Census Area,2013,7,481,258,223
063,Chugach Census Area,2013,8,403,220,183
063,Chugach Census Area,2013,9,454,245,209
063,Chugach Census Area,2013,10,484,245,239
063,Chugach Census Area,2013,11,680,381,299
063,Chugach Census Area,2013,12,617,314,303
063,Chugach Census Area,2013,13,440,243,197
063,Chugach Census Area,2013,14,297,157,140
063,Chugach Census Area,2013,15,136,64,72
063,Chugach Census Area,2013,16,76,44,32
063,Chugach Census Area,2013,17,46,17,29
063,Chugach Census Area,2013,18,29,11,18
066,Copper River Census Area,2013,0,2967,1573,1394
066,Copper River Census Area,2013,1,174,94,80
066,Copper River Census Area,2013,2,205,111,94
066,Copper River Census Area,2013,3,250,115,135
066,Copper River Census Area,2013,4,190,91,99
066,Copper River Census Area,2013,5,124,69,55
066,Copper River Census Area,2013,6,141,74,67
066,Copper River Census Area,2013,7,176,80,96
066,Copper River Census Area,2013,8,162,78,84
066,Copper River Census Area,2013,9,146,84,62
066,Copper River Census Area,2013,10,200,106,94
066,Copper River Census Area,2013,11,278,146,132
066,Copper River Census Area,2013,12,290,160,130
066,Copper River Census Area,2013,13,269,166,103
066,Copper River Census Area,2013,14,156,91,65
066,Copper River Census Area,2013,15,98,54,44
066,Copper River Census Area,2013,16,58,34,24
066,Copper River Census Area,2013,17,23,13,10
066,Copper River Census Area,2013,18,27,7,20
068,Denali Borough,2013,0,1781,978,803
068,Denali Borough,2013,1,104,59,45
068,Denali Borough,2013,2,104,61,43
068,Denali Borough,2013,3,108,48,60
068,Denali Borough,2013,4,89,42,47
068,Denali Borough,2013,5,47,23,24
068,Denali Borough,2013,6,78,35,43
068,Denali Borough,2013,7,143,70,73
068,Denali Borough,2013,8,128,61,67
068,Denali Borough,2013,9,137,79,58
068,Denali Borough,2013,10,163,81,82
068,Denali Borough,2013,11,167,105,62
068,Denali Borough,2013,12,165,90,75
068,Denali Borough,2013,13,186,126,60
068,Denali Borough,2013,14,66,38,28
068,Denali Borough,2013,15,51,33,18
068,Denali Borough,2013,16,25,13,12
068,Denali Borough,2013,17,18,12,6
068,Denali Borough,2013,18,2,2,0
070,Dillingham Census Area,2013,0,5029,2596,2433
070,Dillingham Census Area,2013,1,495,240,255
070,Dillingham Census Area,2013,2,441,238,203
070,Dillingham Census Area,2013,3,416,218,198
070,Dillingham Census Area,2013,4,433,223,210
070,Dillingham Census Area,2013,5,392,199,193
070,Dillingham Census Area,2013,6,381,200,181
070,Dillingham Census Area,2013,7,295,154,141
070,Dillingham Census Area,2013,8,251,126,125
070,Dillingham Census Area,2013,9,234,122,112
070,Dillingham Census Area,2013,10,302,142,160
070,Dillingham Census Area,2013,11,351,187,164
070,Dillingham Census Area,2013,12,362,193,169
070,Dillingham Census Area,2013,13,279,149,130
070,Dillingham Census Area,2013,14,136,70,66
070,Dillingham Census Area,2013,15,125,60,65
070,Dillingham Census Area,2013,16,55,34,21
070,Dillingham Census Area,2013,17,55,29,26
070,Dillingham Census Area,2013,18,26,12,14
090,Fairbanks North Star Borough,2013,0,100094,52575,47519
090,Fairbanks North Star Borough,2013,1,7563,3898,3665
090,Fairbanks North Star Borough,2013,2,7305,3766,3539
090,Fairbanks North Star Borough,2013,3,6597,3429,3168
090,Fairbanks North Star Borough,2013,4,6209,3295,2914
090,Fairbanks North Star Borough,2013,5,9584,5467,4117
090,Fairbanks North Star Borough,2013,6,8964,4811,4153
090,Fairbanks North Star Borough,2013,7,8112,4363,3749
090,Fairbanks North Star Borough,2013,8,6509,3346,3163
090,Fairbanks North Star Borough,2013,9,6176,3276,2900
090,Fairbanks North Star Borough,2013,10,5835,2907,2928
090,Fairbanks North Star Borough,2013,11,6875,3509,3366
090,Fairbanks North Star Borough,2013,12,6769,3407,3362
090,Fairbanks North Star Borough,2013,13,5507,3021,2486
090,Fairbanks North Star Borough,2013,14,3462,1865,1597
090,Fairbanks North Star Borough,2013,15,2082,1057,1025
090,Fairbanks North Star Borough,2013,16,1116,586,530
090,Fairbanks North Star Borough,2013,17,756,336,420
090,Fairbanks North Star Borough,2013,18,673,236,437
100,Haines Borough,2013,0,2532,1263,1269
100,Haines Borough,2013,1,115,62,53
100,Haines Borough,2013,2,143,66,77
100,Haines Borough,2013,3,130,74,56
100,Haines Borough,2013,4,134,65,69
100,Haines Borough,2013,5,73,44,29
100,Haines Borough,2013,6,126,65,61
100,Haines Borough,2013,7,142,61,81
100,Haines Borough,2013,8,141,73,68
100,Haines Borough,2013,9,159,75,84
100,Haines Borough,2013,10,171,90,81
100,Haines Borough,2013,11,237,118,119
100,Haines Borough,2013,12,273,139,134
100,Haines Borough,2013,13,255,127,128
100,Haines Borough,2013,14,183,95,88
100,Haines Borough,2013,15,93,44,49
100,Haines Borough,2013,16,60,23,37
100,Haines Borough,2013,17,55,21,34
100,Haines Borough,2013,18,42,21,21
105,Hoonah-Angoon Census Area,2013,0,2183,1172,1011
105,Hoonah-Angoon Census Area,2013,1,144,84,60
105,Hoonah-Angoon Census Area,2013,2,122,62,60
105,Hoonah-Angoon Census Area,2013,3,115,39,76
105,Hoonah-Angoon Census Area,2013,4,102,54,48
105,Hoonah-Angoon Census Area,2013,5,81,49,32
105,Hoonah-Angoon Census Area,2013,6,124,68,56
105,Hoonah-Angoon Census Area,2013,7,113,57,56
105,Hoonah-Angoon Census Area,2013,8,123,55,68
105,Hoonah-Angoon Census Area,2013,9,116,72,44
105,Hoonah-Angoon Census Area,2013,10,137,71,66
105,Hoonah-Angoon Census Area,2013,11,218,111,107
105,Hoonah-Angoon Census Area,2013,12,211,114,97
105,Hoonah-Angoon Census Area,2013,13,239,125,114
105,Hoonah-Angoon Census Area,2013,14,141,96,45
105,Hoonah-Angoon Census Area,2013,15,94,52,42
105,Hoonah-Angoon Census Area,2013,16,65,43,22
105,Hoonah-Angoon Census Area,2013,17,22,14,8
105,Hoonah-Angoon Census Area,2013,18,16,6,10
110,Juneau City and Borough,2013,0,32963,16738,16225
110,Juneau City and Borough,2013,1,2014,1037,977
110,Juneau City and Borough,2013,2,2122,1050,1072
110,Juneau City and Borough,2013,3,2072,1071,1001
110,Juneau City and Borough,2013,4,2022,1078,944
110,Juneau City and Borough,2013,5,2073,1043,1030
110,Juneau City and Borough,2013,6,2530,1276,1254
110,Juneau City and Borough,2013,7,2441,1270,1171
110,Juneau City and Borough,2013,8,2090,1053,1037
110,Juneau City and Borough,2013,9,2225,1127,1098
110,Juneau City and Borough,2013,10,2375,1206,1169
110,Juneau City and Borough,2013,11,2902,1515,1387
110,Juneau City and Borough,2013,12,2650,1343,1307
110,Juneau City and Borough,2013,13,2197,1118,1079
110,Juneau City and Borough,2013,14,1401,732,669
110,Juneau City and Borough,2013,15,810,395,415
110,Juneau City and Borough,2013,16,471,205,266
110,Juneau City and Borough,2013,17,289,121,168
110,Juneau City and Borough,2013,18,279,98,181
122,Kenai Peninsula Borough,2013,0,56909,29498,27411
122,Kenai Peninsula Borough,2013,1,3573,1795,1778
122,Kenai Peninsula Borough,2013,2,3546,1774,1772
122,Kenai Peninsula Borough,2013,3,3726,1832,1894
122,Kenai Peninsula Borough,2013,4,3677,1946,1731
122,Kenai Peninsula Borough,2013,5,2997,1667,1330
122,Kenai Peninsula Borough,2013,6,3274,1772,1502
122,Kenai Peninsula Borough,2013,7,3393,1748,1645
122,Kenai Peninsula Borough,2013,8,3263,1736,1527
122,Kenai Peninsula Borough,2013,9,3488,1854,1634
122,Kenai Peninsula Borough,2013,10,3675,1853,1822
122,Kenai Peninsula Borough,2013,11,4732,2434,2298
122,Kenai Peninsula Borough,2013,12,5255,2620,2635
122,Kenai Peninsula Borough,2013,13,4533,2437,2096
122,Kenai Peninsula Borough,2013,14,3117,1708,1409
122,Kenai Peninsula Borough,2013,15,2076,1101,975
122,Kenai Peninsula Borough,2013,16,1187,605,582
122,Kenai Peninsula Borough,2013,17,723,353,370
122,Kenai Peninsula Borough,2013,18,674,263,411
130,Ketchikan Gateway Borough,2013,0,13847,7068,6779
130,Ketchikan Gateway Borough,2013,1,870,423,447
130,Ketchikan Gateway Borough,2013,2,882,470,412
130,Ketchikan Gateway Borough,2013,3,887,465,422
130,Ketchikan Gateway Borough,2013,4,891,458,433
130,Ketchikan Gateway Borough,2013,5,857,462,395
130,Ketchikan Gateway Borough,2013,6,905,473,432
130,Ketchikan Gateway Borough,2013,7,903,474,429
130,Ketchikan Gateway Borough,2013,8,823,392,431
130,Ketchikan Gateway Borough,2013,9,839,403,436
130,Ketchikan Gateway Borough,2013,10,941,474,467
130,Ketchikan Gateway Borough,2013,11,1176,630,546
130,Ketchikan Gateway Borough,2013,12,1210,613,597
130,Ketchikan Gateway Borough,2013,13,955,481,474
130,Ketchikan Gateway Borough,2013,14,677,339,338
130,Ketchikan Gateway Borough,2013,15,433,229,204
130,Ketchikan Gateway Borough,2013,16,258,140,118
130,Ketchikan Gateway Borough,2013,17,169,72,97
130,Ketchikan Gateway Borough,2013,18,171,70,101
150,Kodiak Island Borough,2013,0,13823,7239,6584
150,Kodiak Island Borough,2013,1,1117,566,551
150,Kodiak Island Borough,2013,2,981,497,484
150,Kodiak Island Borough,2013,3,1051,548,503
150,Kodiak Island Borough,2013,4,957,505,452
150,Kodiak Island Borough,2013,5,988,555,433
150,Kodiak Island Borough,2013,6,1111,605,506
150,Kodiak Island Borough,2013,7,1054,540,514
150,Kodiak Island Borough,2013,8,856,444,412
150,Kodiak Island Borough,2013,9,809,410,399
150,Kodiak Island Borough,2013,10,935,490,445
150,Kodiak Island Borough,2013,11,1030,554,476
150,Kodiak Island Borough,2013,12,1079,584,495
150,Kodiak Island Borough,2013,13,723,392,331
150,Kodiak Island Borough,2013,14,505,250,255
150,Kodiak Island Borough,2013,15,290,150,140
150,Kodiak Island Borough,2013,16,162,81,81
150,Kodiak Island Borough,2013,17,98,40,58
150,Kodiak Island Borough,2013,18,77,28,49
158,Kusilvak Census Area,2013,0,7952,4172,3780
158,Kusilvak Census Area,2013,1,954,519,435
158,Kusilvak Census Area,2013,2,885,466,419
158,Kusilvak Census Area,2013,3,870,439,431
158,Kusilvak Census Area,2013,4,789,407,382
158,Kusilvak Census Area,2013,5,821,434,387
158,Kusilvak Census Area,2013,6,638,327,311
158,Kusilvak Census Area,2013,7,424,228,196
158,Kusilvak Census Area,2013,8,381,208,173
158,Kusilvak Census Area,2013,9,367,176,191
158,Kusilvak Census Area,2013,10,416,222,194
158,Kusilvak Census Area,2013,11,398,214,184
158,Kusilvak Census Area,2013,12,332,192,140
158,Kusilvak Census Area,2013,13,245,131,114
158,Kusilvak Census Area,2013,14,185,103,82
158,Kusilvak Census Area,2013,15,90,44,46
158,Kusilvak Census Area,2013,16,83,33,50
158,Kusilvak Census Area,2013,17,49,20,29
158,Kusilvak Census Area,2013,18,25,9,16
164,Lake and Peninsula Borough,2013,0,1700,911,789
164,Lake and Peninsula Borough,2013,1,156,84,72
164,Lake and Peninsula Borough,2013,2,149,80,69
164,Lake and Peninsula Borough,2013,3,106,47,59
164,Lake and Peninsula Borough,2013,4,128,72,56
164,Lake and Peninsula Borough,2013,5,132,63,69
164,Lake and Peninsula Borough,2013,6,129,69,60
164,Lake and Peninsula Borough,2013,7,133,70,63
164,Lake and Peninsula Borough,2013,8,105,51,54
164,Lake and Peninsula Borough,2013,9,56,35,21
164,Lake and Peninsula Borough,2013,10,107,58,49
164,Lake and Peninsula Borough,2013,11,144,88,56
164,Lake and Peninsula Borough,2013,12,127,73,54
164,Lake and Peninsula Borough,2013,13,84,41,43
164,Lake and Peninsula Borough,2013,14,57,35,22
164,Lake and Peninsula Borough,2013,15,42,20,22
164,Lake and Peninsula Borough,2013,16,19,11,8
164,Lake and Peninsula Borough,2013,17,17,12,5
164,Lake and Peninsula Borough,2013,18,9,2,7
170,Matanuska-Susitna Borough,2013,0,95948,49365,46583
170,Matanuska-Susitna Borough,2013,1,7186,3718,3468
170,Matanuska-Susitna Borough,2013,2,7950,4060,3890
170,Matanuska-Susitna Borough,2013,3,7528,3905,3623
170,Matanuska-Susitna Borough,2013,4,7043,3765,3278
170,Matanuska-Susitna Borough,2013,5,5398,2842,2556
170,Matanuska-Susitna Borough,2013,6,6155,3040,3115
170,Matanuska-Susitna Borough,2013,7,6501,3255,3246
170,Matanuska-Susitna Borough,2013,8,6051,3142,2909
170,Matanuska-Susitna Borough,2013,9,6509,3294,3215
170,Matanuska-Susitna Borough,2013,10,6398,3325,3073
170,Matanuska-Susitna Borough,2013,11,7507,3845,3662
170,Matanuska-Susitna Borough,2013,12,7074,3719,3355
170,Matanuska-Susitna Borough,2013,13,5692,2918,2774
170,Matanuska-Susitna Borough,2013,14,3620,1871,1749
170,Matanuska-Susitna Borough,2013,15,2383,1287,1096
170,Matanuska-Susitna Borough,2013,16,1389,703,686
170,Matanuska-Susitna Borough,2013,17,894,432,462
170,Matanuska-Susitna Borough,2013,18,670,244,426
180,Nome Census Area,2013,0,9874,5255,4619
180,Nome Census Area,2013,1,1053,564,489
180,Nome Census Area,2013,2,949,486,463
180,Nome Census Area,2013,3,920,474,446
180,Nome Census Area,2013,4,766,417,349
180,Nome Census Area,2013,5,832,435,397
180,Nome Census Area,2013,6,767,407,360
180,Nome Census Area,2013,7,629,333,296
180,Nome Census Area,2013,8,578,298,280
180,Nome Census Area,2013,9,527,291,236
180,Nome Census Area,2013,10,542,302,240
180,Nome Census Area,2013,11,640,352,288
180,Nome Census Area,2013,12,549,288,261
180,Nome Census Area,2013,13,458,250,208
180,Nome Census Area,2013,14,290,176,114
180,Nome Census Area,2013,15,144,85,59
180,Nome Census Area,2013,16,116,46,70
180,Nome Census Area,2013,17,76,33,43
180,Nome Census Area,2013,18,38,18,20
185,North Slope Borough,2013,0,9876,6121,3755
185,North Slope Borough,2013,1,775,373,402
185,North Slope Borough,2013,2,745,397,348
185,North Slope Borough,2013,3,621,319,302
185,North Slope Borough,2013,4,537,296,241
185,North Slope Borough,2013,5,795,457,338
185,North Slope Borough,2013,6,858,523,335
185,North Slope Borough,2013,7,789,519,270
185,North Slope Borough,2013,8,635,436,199
185,North Slope Borough,2013,9,521,337,184
185,North Slope Borough,2013,10,806,579,227
185,North Slope Borough,2013,11,886,571,315
185,North Slope Borough,2013,12,927,678,249
185,North Slope Borough,2013,13,542,381,161
185,North Slope Borough,2013,14,217,146,71
185,North Slope Borough,2013,15,93,54,39
185,North Slope Borough,2013,16,62,24,38
185,North Slope Borough,2013,17,45,21,24
185,North Slope Borough,2013,18,22,10,12
188,Northwest Arctic Borough,2013,0,7809,4180,3629
188,Northwest Arctic Borough,2013,1,895,483,412
188,Northwest Arctic Borough,2013,2,781,398,383
188,Northwest Arctic Borough,2013,3,713,345,368
188,Northwest Arctic Borough,2013,4,632,319,313
188,Northwest Arctic Borough,2013,5,720,401,319
188,Northwest Arctic Borough,2013,6,622,324,298
188,Northwest Arctic Borough,2013,7,546,303,243
188,Northwest Arctic Borough,2013,8,388,218,170
188,Northwest Arctic Borough,2013,9,389,206,183
188,Northwest Arctic Borough,2013,10,441,264,177
188,Northwest Arctic Borough,2013,11,466,266,200
188,Northwest Arctic Borough,2013,12,402,237,165
188,Northwest Arctic Borough,2013,13,298,181,117
188,Northwest Arctic Borough,2013,14,207,98,109
188,Northwest Arctic Borough,2013,15,116,65,51
188,Northwest Arctic Borough,2013,16,84,40,44
188,Northwest Arctic Borough,2013,17,62,19,43
188,Northwest Arctic Borough,2013,18,47,13,34
195,Petersburg Borough,2013,0,3202,1653,1549
195,Petersburg Borough,2013,1,240,116,124
195,Petersburg Borough,2013,2,165,81,84
195,Petersburg Borough,2013,3,221,112,109
195,Petersburg Borough,2013,4,174,100,74
195,Petersburg Borough,2013,5,141,64,77
195,Petersburg Borough,2013,6,200,91,109
195,Petersburg Borough,2013,7,192,103,89
195,Petersburg Borough,2013,8,176,88,88
195,Petersburg Borough,2013,9,204,103,101
195,Petersburg Borough,2013,10,218,116,102
195,Petersburg Borough,2013,11,241,121,120
195,Petersburg Borough,2013,12,297,146,151
195,Petersburg Borough,2013,13,272,153,119
195,Petersburg Borough,2013,14,208,128,80
195,Petersburg Borough,2013,15,106,60,46
195,Petersburg Borough,2013,16,61,35,26
195,Petersburg Borough,2013,17,43,15,28
195,Petersburg Borough,2013,18,43,21,22
198,Prince of Wales-Hyder Census Area,2013,0,6515,3535,2980
198,Prince of Wales-Hyder Census Area,2013,1,459,202,257
198,Prince of Wales-Hyder Census Area,2013,2,482,258,224
198,Prince of Wales-Hyder Census Area,2013,3,452,243,209
198,Prince of Wales-Hyder Census Area,2013,4,404,224,180
198,Prince of Wales-Hyder Census Area,2013,5,341,204,137
198,Prince of Wales-Hyder Census Area,2013,6,343,177,166
198,Prince of Wales-Hyder Census Area,2013,7,394,213,181
198,Prince of Wales-Hyder Census Area,2013,8,374,190,184
198,Prince of Wales-Hyder Census Area,2013,9,400,193,207
198,Prince of Wales-Hyder Census Area,2013,10,469,274,195
198,Prince of Wales-Hyder Census Area,2013,11,580,317,263
198,Prince of Wales-Hyder Census Area,2013,12,557,301,256
198,Prince of Wales-Hyder Census Area,2013,13,501,296,205
198,Prince of Wales-Hyder Census Area,2013,14,344,205,139
198,Prince of Wales-Hyder Census Area,2013,15,196,115,81
198,Prince of Wales-Hyder Census Area,2013,16,121,78,43
198,Prince of Wales-Hyder Census Area,2013,17,67,26,41
198,Prince of Wales-Hyder Census Area,2013,18,31,19,12
220,Sitka City and Borough,2013,0,9066,4506,4560
220,Sitka City and Borough,2013,1,585,281,304
220,Sitka City and Borough,2013,2,604,335,269
220,Sitka City and Borough,2013,3,563,297,266
220,Sitka City and Borough,2013,4,515,258,257
220,Sitka City and Borough,2013,5,484,242,242
220,Sitka City and Borough,2013,6,620,256,364
220,Sitka City and Borough,2013,7,654,337,317
220,Sitka City and Borough,2013,8,614,330,284
220,Sitka City and Borough,2013,9,579,281,298
220,Sitka City and Borough,2013,10,549,287,262
220,Sitka City and Borough,2013,11,701,366,335
220,Sitka City and Borough,2013,12,774,370,404
220,Sitka City and Borough,2013,13,632,332,300
220,Sitka City and Borough,2013,14,403,206,197
220,Sitka City and Borough,2013,15,262,133,129
220,Sitka City and Borough,2013,16,240,100,140
220,Sitka City and Borough,2013,17,125,52,73
220,Sitka City and Borough,2013,18,162,43,119
230,"Skagway Borough, Municipality",2013,0,983,510,473
230,"Skagway Borough, Municipality",2013,1,60,27,33
230,"Skagway Borough, Municipality",2013,2,44,28,16
230,"Skagway Borough, Municipality",2013,3,26,12,14
230,"Skagway Borough, Municipality",2013,4,23,13,10
230,"Skagway Borough, Municipality",2013,5,48,21,27
230,"Skagway Borough, Municipality",2013,6,67,33,34
230,"Skagway Borough, Municipality",2013,7,101,55,46
230,"Skagway Borough, Municipality",2013,8,73,35,38
230,"Skagway Borough, Municipality",2013,9,80,45,35
230,"Skagway Borough, Municipality",2013,10,82,43,39
230,"Skagway Borough, Municipality",2013,11,72,38,34
230,"Skagway Borough, Municipality",2013,12,104,61,43
230,"Skagway Borough, Municipality",2013,13,82,49,33
230,"Skagway Borough, Municipality",2013,14,60,27,33
230,"Skagway Borough, Municipality",2013,15,29,13,16
230,"Skagway Borough, Municipality",2013,16,21,5,16
230,"Skagway Borough, Municipality",2013,17,5,2,3
230,"Skagway Borough, Municipality",2013,18,6,3,3
240,Southeast Fairbanks Census Area,2013,0,7093,3914,3179
240,Southeast Fairbanks Census Area,2013,1,469,225,244
240,Southeast Fairbanks Census Area,2013,2,542,293,249
240,Southeast Fairbanks Census Area,2013,3,540,297,243
240,Southeast Fairbanks Census Area,2013,4,452,248,204
240,Southeast Fairbanks Census Area,2013,5,392,200,192
240,Southeast Fairbanks Census Area,2013,6,399,220,179
240,Southeast Fairbanks Census Area,2013,7,539,297,242
240,Southeast Fairbanks Census Area,2013,8,421,238,183
240,Southeast Fairbanks Census Area,2013,9,441,249,192
240,Southeast Fairbanks Census Area,2013,10,499,287,212
240,Southeast Fairbanks Census Area,2013,11,534,308,226
240,Southeast Fairbanks Census Area,2013,12,598,319,279
240,Southeast Fairbanks Census Area,2013,13,466,289,177
240,Southeast Fairbanks Census Area,2013,14,315,193,122
240,Southeast Fairbanks Census Area,2013,15,240,134,106
240,Southeast Fairbanks Census Area,2013,16,120,66,54
240,Southeast Fairbanks Census Area,2013,17,63,35,28
240,Southeast Fairbanks Census Area,2013,18,63,16,47
275,Wrangell City and Borough,2013,0,2457,1251,1206
275,Wrangell City and Borough,2013,1,146,63,83
275,Wrangell City and Borough,2013,2,150,71,79
275,Wrangell City and Borough,2013,3,156,84,72
275,Wrangell City and Borough,2013,4,141,76,65
275,Wrangell City and Borough,2013,5,96,45,51
275,Wrangell City and Borough,2013,6,147,66,81
275,Wrangell City and Borough,2013,7,113,62,51
275,Wrangell City and Borough,2013,8,90,43,47
275,Wrangell City and Borough,2013,9,123,57,66
275,Wrangell City and Borough,2013,10,170,93,77
275,Wrangell City and Borough,2013,11,208,103,105
275,Wrangell City and Borough,2013,12,271,151,120
275,Wrangell City and Borough,2013,13,220,114,106
275,Wrangell City and Borough,2013,14,149,78,71
275,Wrangell City and Borough,2013,15,104,57,47
275,Wrangell City and Borough,2013,16,94,52,42
275,Wrangell City and Borough,2013,17,48,23,25
275,Wrangell City and Borough,2013,18,31,13,18
282,Yakutat City and Borough,2013,0,619,338,281
282,Yakutat City and Borough,2013,1,36,16,20
282,Yakutat City and Borough,2013,2,30,17,13
282,Yakutat City and Borough,2013,3,38,15,23
282,Yakutat City and Borough,2013,4,39,23,16
282,Yakutat City and Borough,2013,5,38,22,16
282,Yakutat City and Borough,2013,6,26,16,10
282,Yakutat City and Borough,2013,7,36,19,17
282,Yakutat City and Borough,2013,8,37,20,17
282,Yakutat City and Borough,2013,9,41,23,18
282,Yakutat City and Borough,2013,10,56,32,24
282,Yakutat City and Borough,2013,11,47,32,15
282,Yakutat City and Borough,2013,12,48,27,21
282,Yakutat City and Borough,2013,13,60,37,23
282,Yakutat City and Borough,2013,14,38,17,21
282,Yakutat City and Borough,2013,15,19,16,3
282,Yakutat City and Borough,2013,16,11,4,7
282,Yakutat City and Borough,2013,17,13,1,12
282,Yakutat City and Borough,2013,18,6,1,5
290,Yukon-Koyukuk Census Area,2013,0,5649,3047,2602
290,Yukon-Koyukuk Census Area,2013,1,459,244,215
290,Yukon-Koyukuk Census Area,2013,2,419,231,188
290,Yukon-Koyukuk Census Area,2013,3,445,220,225
290,Yukon-Koyukuk Census Area,2013,4,395,222,173
290,Yukon-Koyukuk Census Area,2013,5,346,185,161
290,Yukon-Koyukuk Census Area,2013,6,372,196,176
290,Yukon-Koyukuk Census Area,2013,7,358,219,139
290,Yukon-Koyukuk Census Area,2013,8,319,157,162
290,Yukon-Koyukuk Census Area,2013,9,258,120,138
290,Yukon-Koyukuk Census Area,2013,10,332,184,148
290,Yukon-Koyukuk Census Area,2013,11,443,236,207
290,Yukon-Koyukuk Census Area,2013,12,467,261,206
290,Yukon-Koyukuk Census Area,2013,13,396,221,175
290,Yukon-Koyukuk Census Area,2013,14,253,142,111
290,Yukon-Koyukuk Census Area,2013,15,156,87,69
290,Yukon-Koyukuk Census Area,2013,16,95,56,39
290,Yukon-Koyukuk Census Area,2013,17,86,38,48
290,Yukon-Koyukuk Census Area,2013,18,50,28,22
000,Alaska,2014,0,737053,381625,355428
000,Alaska,2014,1,53438,27251,26187
000,Alaska,2014,2,53989,28020,25969
000,Alaska,2014,3,51222,26307,24915
000,Alaska,2014,4,48490,25338,23152
000,Alaska,2014,5,54487,29567,24920
000,Alaska,2014,6,57726,30205,27521
000,Alaska,2014,7,55925,28954,26971
000,Alaska,2014,8,46612,24100,22512
000,Alaska,2014,9,45168,23349,21819
000,Alaska,2014,10,46326,23939,22387
000,Alaska,2014,11,54556,28372,26184
000,Alaska,2014,12,53628,27545,26083
000,Alaska,2014,13,44282,23307,20975
000,Alaska,2014,14,29660,15659,14001
000,Alaska,2014,15,18028,9205,8823
000,Alaska,2014,16,10760,5265,5495
000,Alaska,2014,17,6883,3077,3806
000,Alaska,2014,18,5873,2165,3708
013,Aleutians East Borough,2014,0,3097,2021,1076
013,Aleutians East Borough,2014,1,108,53,55
013,Aleutians East Borough,2014,2,98,49,49
013,Aleutians East Borough,2014,3,79,39,40
013,Aleutians East Borough,2014,4,115,64,51
013,Aleutians East Borough,2014,5,222,160,62
013,Aleutians East Borough,2014,6,216,162,54
013,Aleutians East Borough,2014,7,306,203,103
013,Aleutians East Borough,2014,8,249,162,87
013,Aleutians East Borough,2014,9,226,174,52
013,Aleutians East Borough,2014,10,304,216,88
013,Aleutians East Borough,2014,11,417,261,156
013,Aleutians East Borough,2014,12,351,221,130
013,Aleutians East Borough,2014,13,176,108,68
013,Aleutians East Borough,2014,14,124,82,42
013,Aleutians East Borough,2014,15,47,27,20
013,Aleutians East Borough,2014,16,31,18,13
013,Aleutians East Borough,2014,17,13,10,3
013,Aleutians East Borough,2014,18,15,12,3
016,Aleutians West Census Area,2014,0,5598,3725,1873
016,Aleutians West Census Area,2014,1,189,100,89
016,Aleutians West Census Area,2014,2,245,119,126
016,Aleutians West Census Area,2014,3,206,122,84
016,Aleutians West Census Area,2014,4,241,141,100
016,Aleutians West Census Area,2014,5,315,215,100
016,Aleutians West Census Area,2014,6,471,332,139
016,Aleutians West Census Area,2014,7,496,350,146
016,Aleutians West Census Area,2014,8,526,364,162
016,Aleutians West Census Area,2014,9,439,319,120
016,Aleutians West Census Area,2014,10,562,378,184
016,Aleutians West Census Area,2014,11,673,460,213
016,Aleutians West Census Area,2014,12,484,339,145
016,Aleutians West Census Area,2014,13,397,263,134
016,Aleutians West Census Area,2014,14,248,164,84
016,Aleutians West Census Area,2014,15,58,36,22
016,Aleutians West Census Area,2014,16,20,9,11
016,Aleutians West Census Area,2014,17,14,10,4
016,Aleutians West Census Area,2014,18,14,4,10
020,Anchorage Municipality,2014,0,300252,151972,148280
020,Anchorage Municipality,2014,1,21642,11165,10477
020,Anchorage Municipality,2014,2,21294,11004,10290
020,Anchorage Municipality,2014,3,20308,10468,9840
020,Anchorage Municipality,2014,4,19442,9904,9538
020,Anchorage Municipality,2014,5,24683,13219,11464
020,Anchorage Municipality,2014,6,25697,13290,12407
020,Anchorage Municipality,2014,7,24235,12194,12041
020,Anchorage Municipality,2014,8,19425,9724,9701
020,Anchorage Municipality,2014,9,18862,9511,9351
020,Anchorage Municipality,2014,10,18755,9273,9482
020,Anchorage Municipality,2014,11,21713,10919,10794
020,Anchorage Municipality,2014,12,20527,10167,10360
020,Anchorage Municipality,2014,13,16439,8317,8122
020,Anchorage Municipality,2014,14,11256,5695,5561
020,Anchorage Municipality,2014,15,6559,3207,3352
020,Anchorage Municipality,2014,16,4189,1879,2310
020,Anchorage Municipality,2014,17,2762,1178,1584
020,Anchorage Municipality,2014,18,2464,858,1606
050,Bethel Census Area,2014,0,18091,9374,8717
050,Bethel Census Area,2014,1,1843,942,901
050,Bethel Census Area,2014,2,1849,920,929
050,Bethel Census Area,2014,3,1725,896,829
050,Bethel Census Area,2014,4,1606,855,751
050,Bethel Census Area,2014,5,1487,720,767
050,Bethel Census Area,2014,6,1482,773,709
050,Bethel Census Area,2014,7,1219,615,604
050,Bethel Census Area,2014,8,913,471,442
050,Bethel Census Area,2014,9,902,447,455
050,Bethel Census Area,2014,10,998,560,438
050,Bethel Census Area,2014,11,1126,643,483
050,Bethel Census Area,2014,12,997,515,482
050,Bethel Census Area,2014,13,779,429,350
050,Bethel Census Area,2014,14,451,245,206
050,Bethel Census Area,2014,15,314,154,160
050,Bethel Census Area,2014,16,189,104,85
050,Bethel Census Area,2014,17,135,45,90
050,Bethel Census Area,2014,18,76,40,36
060,Bristol Bay Borough,2014,0,944,527,417
060,Bristol Bay Borough,2014,1,44,27,17
060,Bristol Bay Borough,2014,2,41,23,18
060,Bristol Bay Borough,2014,3,55,26,29
060,Bristol Bay Borough,2014,4,73,37,36
060,Bristol Bay Borough,2014,5,43,29,14
060,Bristol Bay Borough,2014,6,80,41,39
060,Bristol Bay Borough,2014,7,48,25,23
060,Bristol Bay Borough,2014,8,48,24,24
060,Bristol Bay Borough,2014,9,67,41,26
060,Bristol Bay Borough,2014,10,66,36,30
060,Bristol Bay Borough,2014,11,96,51,45
060,Bristol Bay Borough,2014,12,110,67,43
060,Bristol Bay Borough,2014,13,81,50,31
060,Bristol Bay Borough,2014,14,32,17,15
060,Bristol Bay Borough,2014,15,23,17,6
060,Bristol Bay Borough,2014,16,22,9,13
060,Bristol Bay Borough,2014,17,9,6,3
060,Bristol Bay Borough,2014,18,6,1,5
063,Chugach Census Area,2014,0,6789,3573,3216
063,Chugach Census Area,2014,1,463,214,249
063,Chugach Census Area,2014,2,439,220,219
063,Chugach Census Area,2014,3,440,220,220
063,Chugach Census Area,2014,4,398,209,189
063,Chugach Census Area,2014,5,370,206,164
063,Chugach Census Area,2014,6,576,328,248
063,Chugach Census Area,2014,7,484,258,226
063,Chugach Census Area,2014,8,416,227,189
063,Chugach Census Area,2014,9,433,221,212
063,Chugach Census Area,2014,10,479,251,228
063,Chugach Census Area,2014,11,593,337,256
063,Chugach Census Area,2014,12,627,325,302
063,Chugach Census Area,2014,13,461,255,206
063,Chugach Census Area,2014,14,286,147,139
063,Chugach Census Area,2014,15,164,77,87
063,Chugach Census Area,2014,16,79,47,32
063,Chugach Census Area,2014,17,42,17,25
063,Chugach Census Area,2014,18,39,14,25
066,Copper River Census Area,2014,0,2812,1494,1318
066,Copper River Census Area,2014,1,179,92,87
066,Copper River Census Area,2014,2,211,108,103
066,Copper River Census Area,2014,3,214,102,112
066,Copper River Census Area,2014,4,183,86,97
066,Copper River Census Area,2014,5,105,60,45
066,Copper River Census Area,2014,6,128,63,65
066,Copper River Census Area,2014,7,179,88,91
066,Copper River Census Area,2014,8,141,70,71
066,Copper River Census Area,2014,9,139,74,65
066,Copper River Census Area,2014,10,180,100,80
066,Copper River Census Area,2014,11,246,128,118
066,Copper River Census Area,2014,12,285,159,126
066,Copper River Census Area,2014,13,267,163,104
066,Copper River Census Area,2014,14,142,85,57
066,Copper River Census Area,2014,15,103,56,47
066,Copper River Census Area,2014,16,63,38,25
066,Copper River Census Area,2014,17,21,14,7
066,Copper River Census Area,2014,18,26,8,18
068,Denali Borough,2014,0,1778,996,782
068,Denali Borough,2014,1,101,60,41
068,Denali Borough,2014,2,99,59,40
068,Denali Borough,2014,3,117,56,61
068,Denali Borough,2014,4,93,44,49
068,Denali Borough,2014,5,45,26,19
068,Denali Borough,2014,6,87,38,49
068,Denali Borough,2014,7,136,68,68
068,Denali Borough,2014,8,123,56,67
068,Denali Borough,2014,9,132,72,60
068,Denali Borough,2014,10,156,91,65
068,Denali Borough,2014,11,168,105,63
068,Denali Borough,2014,12,153,82,71
068,Denali Borough,2014,13,201,137,64
068,Denali Borough,2014,14,55,34,21
068,Denali Borough,2014,15,61,36,25
068,Denali Borough,2014,16,27,14,13
068,Denali Borough,2014,17,21,15,6
068,Denali Borough,2014,18,3,3,0
070,Dillingham Census Area,2014,0,5066,2618,2448
070,Dillingham Census Area,2014,1,502,233,269
070,Dillingham Census Area,2014,2,448,236,212
070,Dillingham Census Area,2014,3,400,211,189
070,Dillingham Census Area,2014,4,435,226,209
070,Dillingham Census Area,2014,5,402,204,198
070,Dillingham Census Area,2014,6,368,197,171
070,Dillingham Census Area,2014,7,316,159,157
070,Dillingham Census Area,2014,8,248,126,122
070,Dillingham Census Area,2014,9,240,122,118
070,Dillingham Census Area,2014,10,299,143,156
070,Dillingham Census Area,2014,11,335,191,144
070,Dillingham Census Area,2014,12,387,206,181
070,Dillingham Census Area,2014,13,273,147,126
070,Dillingham Census Area,2014,14,141,75,66
070,Dillingham Census Area,2014,15,126,59,67
070,Dillingham Census Area,2014,16,72,46,26
070,Dillingham Census Area,2014,17,43,19,24
070,Dillingham Census Area,2014,18,31,18,13
090,Fairbanks North Star Borough,2014,0,98828,51848,46980
090,Fairbanks North Star Borough,2014,1,7237,3671,3566
090,Fairbanks North Star Borough,2014,2,7088,3708,3380
090,Fairbanks North Star Borough,2014,3,6462,3384,3078
090,Fairbanks North Star Borough,2014,4,6190,3267,2923
090,Fairbanks North Star Borough,2014,5,9140,5240,3900
090,Fairbanks North Star Borough,2014,6,8775,4724,4051
090,Fairbanks North Star Borough,2014,7,8091,4312,3779
090,Fairbanks North Star Borough,2014,8,6403,3283,3120
090,Fairbanks North Star Borough,2014,9,6044,3207,2837
090,Fairbanks North Star Borough,2014,10,5628,2841,2787
090,Fairbanks North Star Borough,2014,11,6775,3427,3348
090,Fairbanks North Star Borough,2014,12,6749,3437,3312
090,Fairbanks North Star Borough,2014,13,5687,3017,2670
090,Fairbanks North Star Borough,2014,14,3715,2024,1691
090,Fairbanks North Star Borough,2014,15,2246,1130,1116
090,Fairbanks North Star Borough,2014,16,1143,592,551
090,Fairbanks North Star Borough,2014,17,769,339,430
090,Fairbanks North Star Borough,2014,18,686,245,441
100,Haines Borough,2014,0,2552,1279,1273
100,Haines Borough,2014,1,123,62,61
100,Haines Borough,2014,2,132,62,70
100,Haines Borough,2014,3,128,72,56
100,Haines Borough,2014,4,123,63,60
100,Haines Borough,2014,5,86,48,38
100,Haines Borough,2014,6,128,70,58
100,Haines Borough,2014,7,135,65,70
100,Haines Borough,2014,8,150,74,76
100,Haines Borough,2014,9,154,79,75
100,Haines Borough,2014,10,167,85,82
100,Haines Borough,2014,11,235,119,116
100,Haines Borough,2014,12,279,134,145
100,Haines Borough,2014,13,255,127,128
100,Haines Borough,2014,14,199,105,94
100,Haines Borough,2014,15,110,53,57
100,Haines Borough,2014,16,52,22,30
100,Haines Borough,2014,17,56,21,35
100,Haines Borough,2014,18,40,18,22
105,Hoonah-Angoon Census Area,2014,0,2139,1150,989
105,Hoonah-Angoon Census Area,2014,1,125,69,56
105,Hoonah-Angoon Census Area,2014,2,129,67,62
105,Hoonah-Angoon Census Area,2014,3,105,39,66
105,Hoonah-Angoon Census Area,2014,4,96,45,51
105,Hoonah-Angoon Census Area,2014,5,83,51,32
105,Hoonah-Angoon Census Area,2014,6,109,56,53
105,Hoonah-Angoon Census Area,2014,7,118,68,50
105,Hoonah-Angoon Census Area,2014,8,123,52,71
105,Hoonah-Angoon Census Area,2014,9,109,66,43
105,Hoonah-Angoon Census Area,2014,10,127,69,58
105,Hoonah-Angoon Census Area,2014,11,197,98,99
105,Hoonah-Angoon Census Area,2014,12,214,114,100
105,Hoonah-Angoon Census Area,2014,13,233,122,111
105,Hoonah-Angoon Census Area,2014,14,164,106,58
105,Hoonah-Angoon Census Area,2014,15,88,52,36
105,Hoonah-Angoon Census Area,2014,16,78,50,28
105,Hoonah-Angoon Census Area,2014,17,28,21,7
105,Hoonah-Angoon Census Area,2014,18,13,5,8
110,Juneau City and Borough,2014,0,33027,16771,16256
110,Juneau City and Borough,2014,1,1991,1020,971
110,Juneau City and Borough,2014,2,2131,1057,1074
110,Juneau City and Borough,2014,3,2052,1038,1014
110,Juneau City and Borough,2014,4,1999,1072,927
110,Juneau City and Borough,2014,5,2044,1028,1016
110,Juneau City and Borough,2014,6,2569,1298,1271
110,Juneau City and Borough,2014,7,2617,1355,1262
110,Juneau City and Borough,2014,8,2100,1073,1027
110,Juneau City and Borough,2014,9,2104,1040,1064
110,Juneau City and Borough,2014,10,2368,1239,1129
110,Juneau City and Borough,2014,11,2722,1403,1319
110,Juneau City and Borough,2014,12,2619,1330,1289
110,Juneau City and Borough,2014,13,2247,1164,1083
110,Juneau City and Borough,2014,14,1516,775,741
110,Juneau City and Borough,2014,15,851,430,421
110,Juneau City and Borough,2014,16,524,222,302
110,Juneau City and Borough,2014,17,287,124,163
110,Juneau City and Borough,2014,18,286,103,183
122,Kenai Peninsula Borough,2014,0,57442,29866,27576
122,Kenai Peninsula Borough,2014,1,3586,1763,1823
122,Kenai Peninsula Borough,2014,2,3692,1914,1778
122,Kenai Peninsula Borough,2014,3,3694,1815,1879
122,Kenai Peninsula Borough,2014,4,3628,1888,1740
122,Kenai Peninsula Borough,2014,5,3084,1782,1302
122,Kenai Peninsula Borough,2014,6,3328,1760,1568
122,Kenai Peninsula Borough,2014,7,3567,1849,1718
122,Kenai Peninsula Borough,2014,8,3384,1798,1586
122,Kenai Peninsula Borough,2014,9,3399,1794,1605
122,Kenai Peninsula Borough,2014,10,3563,1839,1724
122,Kenai Peninsula Borough,2014,11,4518,2355,2163
122,Kenai Peninsula Borough,2014,12,5118,2523,2595
122,Kenai Peninsula Borough,2014,13,4717,2515,2202
122,Kenai Peninsula Borough,2014,14,3287,1816,1471
122,Kenai Peninsula Borough,2014,15,2224,1187,1037
122,Kenai Peninsula Borough,2014,16,1242,639,603
122,Kenai Peninsula Borough,2014,17,739,362,377
122,Kenai Peninsula Borough,2014,18,672,267,405
130,Ketchikan Gateway Borough,2014,0,13903,7084,6819
130,Ketchikan Gateway Borough,2014,1,886,437,449
130,Ketchikan Gateway Borough,2014,2,856,454,402
130,Ketchikan Gateway Borough,2014,3,881,456,425
130,Ketchikan Gateway Borough,2014,4,896,455,441
130,Ketchikan Gateway Borough,2014,5,852,475,377
130,Ketchikan Gateway Borough,2014,6,928,492,436
130,Ketchikan Gateway Borough,2014,7,945,489,456
130,Ketchikan Gateway Borough,2014,8,818,384,434
130,Ketchikan Gateway Borough,2014,9,816,406,410
130,Ketchikan Gateway Borough,2014,10,912,445,467
130,Ketchikan Gateway Borough,2014,11,1145,610,535
130,Ketchikan Gateway Borough,2014,12,1178,588,590
130,Ketchikan Gateway Borough,2014,13,1001,520,481
130,Ketchikan Gateway Borough,2014,14,695,343,352
130,Ketchikan Gateway Borough,2014,15,475,232,243
130,Ketchikan Gateway Borough,2014,16,269,150,119
130,Ketchikan Gateway Borough,2014,17,172,73,99
130,Ketchikan Gateway Borough,2014,18,178,75,103
150,Kodiak Island Borough,2014,0,13812,7248,6564
150,Kodiak Island Borough,2014,1,1092,565,527
150,Kodiak Island Borough,2014,2,1019,512,507
150,Kodiak Island Borough,2014,3,967,510,457
150,Kodiak Island Borough,2014,4,999,540,459
150,Kodiak Island Borough,2014,5,986,539,447
150,Kodiak Island Borough,2014,6,1138,630,508
150,Kodiak Island Borough,2014,7,1044,541,503
150,Kodiak Island Borough,2014,8,872,462,410
150,Kodiak Island Borough,2014,9,788,397,391
150,Kodiak Island Borough,2014,10,887,454,433
150,Kodiak Island Borough,2014,11,1025,537,488
150,Kodiak Island Borough,2014,12,1044,575,469
150,Kodiak Island Borough,2014,13,734,402,332
150,Kodiak Island Borough,2014,14,551,260,291
150,Kodiak Island Borough,2014,15,326,169,157
150,Kodiak Island Borough,2014,16,172,90,82
150,Kodiak Island Borough,2014,17,97,43,54
150,Kodiak Island Borough,2014,18,71,22,49
158,Kusilvak Census Area,2014,0,8087,4230,3857
158,Kusilvak Census Area,2014,1,927,485,442
158,Kusilvak Census Area,2014,2,927,508,419
158,Kusilvak Census Area,2014,3,892,446,446
158,Kusilvak Census Area,2014,4,797,417,380
158,Kusilvak Census Area,2014,5,802,425,377
158,Kusilvak Census Area,2014,6,680,351,329
158,Kusilvak Census Area,2014,7,474,247,227
158,Kusilvak Census Area,2014,8,390,214,176
158,Kusilvak Census Area,2014,9,343,166,177
158,Kusilvak Census Area,2014,10,405,213,192
158,Kusilvak Census Area,2014,11,398,205,193
158,Kusilvak Census Area,2014,12,352,204,148
158,Kusilvak Census Area,2014,13,258,132,126
158,Kusilvak Census Area,2014,14,187,106,81
158,Kusilvak Census Area,2014,15,99,43,56
158,Kusilvak Census Area,2014,16,76,36,40
158,Kusilvak Census Area,2014,17,55,21,34
158,Kusilvak Census Area,2014,18,25,11,14
164,Lake and Peninsula Borough,2014,0,1689,897,792
164,Lake and Peninsula Borough,2014,1,139,75,64
164,Lake and Peninsula Borough,2014,2,141,80,61
164,Lake and Peninsula Borough,2014,3,109,50,59
164,Lake and Peninsula Borough,2014,4,123,64,59
164,Lake and Peninsula Borough,2014,5,123,54,69
164,Lake and Peninsula Borough,2014,6,143,76,67
164,Lake and Peninsula Borough,2014,7,130,62,68
164,Lake and Peninsula Borough,2014,8,120,71,49
164,Lake and Peninsula Borough,2014,9,64,37,27
164,Lake and Peninsula Borough,2014,10,89,47,42
164,Lake and Peninsula Borough,2014,11,140,81,59
164,Lake and Peninsula Borough,2014,12,125,73,52
164,Lake and Peninsula Borough,2014,13,92,43,49
164,Lake and Peninsula Borough,2014,14,52,33,19
164,Lake and Peninsula Borough,2014,15,49,22,27
164,Lake and Peninsula Borough,2014,16,22,12,10
164,Lake and Peninsula Borough,2014,17,19,14,5
164,Lake and Peninsula Borough,2014,18,9,3,6
170,Matanuska-Susitna Borough,2014,0,98268,50750,47518
170,Matanuska-Susitna Borough,2014,1,7323,3727,3596
170,Matanuska-Susitna Borough,2014,2,8113,4251,3862
170,Matanuska-Susitna Borough,2014,3,7802,4033,3769
170,Matanuska-Susitna Borough,2014,4,7051,3782,3269
170,Matanuska-Susitna Borough,2014,5,5528,2905,2623
170,Matanuska-Susitna Borough,2014,6,6278,3156,3122
170,Matanuska-Susitna Borough,2014,7,6916,3489,3427
170,Matanuska-Susitna Borough,2014,8,6306,3280,3026
170,Matanuska-Susitna Borough,2014,9,6409,3265,3144
170,Matanuska-Susitna Borough,2014,10,6381,3347,3034
170,Matanuska-Susitna Borough,2014,11,7324,3733,3591
170,Matanuska-Susitna Borough,2014,12,7143,3750,3393
170,Matanuska-Susitna Borough,2014,13,6057,3100,2957
170,Matanuska-Susitna Borough,2014,14,3942,2059,1883
170,Matanuska-Susitna Borough,2014,15,2609,1377,1232
170,Matanuska-Susitna Borough,2014,16,1436,755,681
170,Matanuska-Susitna Borough,2014,17,951,474,477
170,Matanuska-Susitna Borough,2014,18,699,267,432
180,Nome Census Area,2014,0,9972,5285,4687
180,Nome Census Area,2014,1,1007,532,475
180,Nome Census Area,2014,2,1022,531,491
180,Nome Census Area,2014,3,910,467,443
180,Nome Census Area,2014,4,760,405,355
180,Nome Census Area,2014,5,799,421,378
180,Nome Census Area,2014,6,857,447,410
180,Nome Census Area,2014,7,651,338,313
180,Nome Census Area,2014,8,585,299,286
180,Nome Census Area,2014,9,523,290,233
180,Nome Census Area,2014,10,524,292,232
180,Nome Census Area,2014,11,607,340,267
180,Nome Census Area,2014,12,548,290,258
180,Nome Census Area,2014,13,492,261,231
180,Nome Census Area,2014,14,305,190,115
180,Nome Census Area,2014,15,157,85,72
180,Nome Census Area,2014,16,112,46,66
180,Nome Census Area,2014,17,78,37,41
180,Nome Census Area,2014,18,35,14,21
185,North Slope Borough,2014,0,9737,6057,3680
185,North Slope Borough,2014,1,746,371,375
185,North Slope Borough,2014,2,719,383,336
185,North Slope Borough,2014,3,644,332,312
185,North Slope Borough,2014,4,500,262,238
185,North Slope Borough,2014,5,727,426,301
185,North Slope Borough,2014,6,834,502,332
185,North Slope Borough,2014,7,874,579,295
185,North Slope Borough,2014,8,699,495,204
185,North Slope Borough,2014,9,532,350,182
185,North Slope Borough,2014,10,710,503,207
185,North Slope Borough,2014,11,855,571,284
185,North Slope Borough,2014,12,893,636,257
185,North Slope Borough,2014,13,551,380,171
185,North Slope Borough,2014,14,236,159,77
185,North Slope Borough,2014,15,97,59,38
185,North Slope Borough,2014,16,55,23,32
185,North Slope Borough,2014,17,42,14,28
185,North Slope Borough,2014,18,23,12,11
188,Northwest Arctic Borough,2014,0,7799,4174,3625
188,Northwest Arctic Borough,2014,1,828,432,396
188,Northwest Arctic Borough,2014,2,804,423,381
188,Northwest Arctic Borough,2014,3,687,337,350
188,Northwest Arctic Borough,2014,4,645,339,306
188,Northwest Arctic Borough,2014,5,673,356,317
188,Northwest Arctic Borough,2014,6,662,358,304
188,Northwest Arctic Borough,2014,7,553,303,250
188,Northwest Arctic Borough,2014,8,409,231,178
188,Northwest Arctic Borough,2014,9,383,195,188
188,Northwest Arctic Borough,2014,10,416,256,160
188,Northwest Arctic Borough,2014,11,504,291,213
188,Northwest Arctic Borough,2014,12,412,239,173
188,Northwest Arctic Borough,2014,13,281,167,114
188,Northwest Arctic Borough,2014,14,220,109,111
188,Northwest Arctic Borough,2014,15,116,62,54
188,Northwest Arctic Borough,2014,16,85,42,43
188,Northwest Arctic Borough,2014,17,67,23,44
188,Northwest Arctic Borough,2014,18,54,11,43
195,Petersburg Borough,2014,0,3202,1663,1539
195,Petersburg Borough,2014,1,233,121,112
195,Petersburg Borough,2014,2,172,85,87
195,Petersburg Borough,2014,3,220,110,110
195,Petersburg Borough,2014,4,173,103,70
195,Petersburg Borough,2014,5,136,68,68
195,Petersburg Borough,2014,6,190,92,98
195,Petersburg Borough,2014,7,196,95,101
195,Petersburg Borough,2014,8,196,100,96
195,Petersburg Borough,2014,9,183,92,91
195,Petersburg Borough,2014,10,232,118,114
195,Petersburg Borough,2014,11,228,126,102
195,Petersburg Borough,2014,12,300,137,163
195,Petersburg Borough,2014,13,260,149,111
195,Petersburg Borough,2014,14,214,126,88
195,Petersburg Borough,2014,15,119,69,50
195,Petersburg Borough,2014,16,64,36,28
195,Petersburg Borough,2014,17,43,15,28
195,Petersburg Borough,2014,18,43,21,22
198,Prince of Wales-Hyder Census Area,2014,0,6520,3563,2957
198,Prince of Wales-Hyder Census Area,2014,1,442,216,226
198,Prince of Wales-Hyder Census Area,2014,2,503,264,239
198,Prince of Wales-Hyder Census Area,2014,3,441,237,204
198,Prince of Wales-Hyder Census Area,2014,4,398,228,170
198,Prince of Wales-Hyder Census Area,2014,5,332,194,138
198,Prince of Wales-Hyder Census Area,2014,6,358,179,179
198,Prince of Wales-Hyder Census Area,2014,7,391,218,173
198,Prince of Wales-Hyder Census Area,2014,8,382,205,177
198,Prince of Wales-Hyder Census Area,2014,9,399,202,197
198,Prince of Wales-Hyder Census Area,2014,10,443,245,198
198,Prince of Wales-Hyder Census Area,2014,11,597,338,259
198,Prince of Wales-Hyder Census Area,2014,12,540,287,253
198,Prince of Wales-Hyder Census Area,2014,13,493,281,212
198,Prince of Wales-Hyder Census Area,2014,14,359,216,143
198,Prince of Wales-Hyder Census Area,2014,15,210,121,89
198,Prince of Wales-Hyder Census Area,2014,16,133,84,49
198,Prince of Wales-Hyder Census Area,2014,17,65,29,36
198,Prince of Wales-Hyder Census Area,2014,18,34,19,15
220,Sitka City and Borough,2014,0,9078,4522,4556
220,Sitka City and Borough,2014,1,570,265,305
220,Sitka City and Borough,2014,2,625,364,261
220,Sitka City and Borough,2014,3,548,267,281
220,Sitka City and Borough,2014,4,514,277,237
220,Sitka City and Borough,2014,5,519,244,275
220,Sitka City and Borough,2014,6,633,282,351
220,Sitka City and Borough,2014,7,644,320,324
220,Sitka City and Borough,2014,8,648,347,301
220,Sitka City and Borough,2014,9,551,287,264
220,Sitka City and Borough,2014,10,555,276,279
220,Sitka City and Borough,2014,11,660,339,321
220,Sitka City and Borough,2014,12,777,383,394
220,Sitka City and Borough,2014,13,609,319,290
220,Sitka City and Borough,2014,14,428,219,209
220,Sitka City and Borough,2014,15,250,128,122
220,Sitka City and Borough,2014,16,253,105,148
220,Sitka City and Borough,2014,17,133,57,76
220,Sitka City and Borough,2014,18,161,43,118
230,"Skagway Borough, Municipality",2014,0,1039,533,506
230,"Skagway Borough, Municipality",2014,1,58,30,28
230,"Skagway Borough, Municipality",2014,2,49,27,22
230,"Skagway Borough, Municipality",2014,3,30,14,16
230,"Skagway Borough, Municipality",2014,4,26,14,12
230,"Skagway Borough, Municipality",2014,5,55,26,29
230,"Skagway Borough, Municipality",2014,6,67,25,42
230,"Skagway Borough, Municipality",2014,7,108,56,52
230,"Skagway Borough, Municipality",2014,8,83,43,40
230,"Skagway Borough, Municipality",2014,9,89,43,46
230,"Skagway Borough, Municipality",2014,10,99,55,44
230,"Skagway Borough, Municipality",2014,11,69,42,27
230,"Skagway Borough, Municipality",2014,12,87,52,35
230,"Skagway Borough, Municipality",2014,13,88,53,35
230,"Skagway Borough, Municipality",2014,14,67,28,39
230,"Skagway Borough, Municipality",2014,15,31,15,16
230,"Skagway Borough, Municipality",2014,16,19,5,14
230,"Skagway Borough, Municipality",2014,17,9,3,6
230,"Skagway Borough, Municipality",2014,18,5,2,3
240,Southeast Fairbanks Census Area,2014,0,6978,3866,3112
240,Southeast Fairbanks Census Area,2014,1,455,220,235
240,Southeast Fairbanks Census Area,2014,2,522,272,250
240,Southeast Fairbanks Census Area,2014,3,517,277,240
240,Southeast Fairbanks Census Area,2014,4,422,227,195
240,Southeast Fairbanks Census Area,2014,5,378,193,185
240,Southeast Fairbanks Census Area,2014,6,397,220,177
240,Southeast Fairbanks Census Area,2014,7,538,305,233
240,Southeast Fairbanks Census Area,2014,8,428,246,182
240,Southeast Fairbanks Census Area,2014,9,424,242,182
240,Southeast Fairbanks Census Area,2014,10,501,289,212
240,Southeast Fairbanks Census Area,2014,11,532,320,212
240,Southeast Fairbanks Census Area,2014,12,566,296,270
240,Southeast Fairbanks Census Area,2014,13,474,297,177
240,Southeast Fairbanks Census Area,2014,14,331,204,127
240,Southeast Fairbanks Census Area,2014,15,229,136,93
240,Southeast Fairbanks Census Area,2014,16,139,71,68
240,Southeast Fairbanks Census Area,2014,17,60,33,27
240,Southeast Fairbanks Census Area,2014,18,65,18,47
275,Wrangell City and Borough,2014,0,2416,1233,1183
275,Wrangell City and Borough,2014,1,155,73,82
275,Wrangell City and Borough,2014,2,144,66,78
275,Wrangell City and Borough,2014,3,137,70,67
275,Wrangell City and Borough,2014,4,132,74,58
275,Wrangell City and Borough,2014,5,107,54,53
275,Wrangell City and Borough,2014,6,151,63,88
275,Wrangell City and Borough,2014,7,121,69,52
275,Wrangell City and Borough,2014,8,78,38,40
275,Wrangell City and Borough,2014,9,124,60,64
275,Wrangell City and Borough,2014,10,145,73,72
275,Wrangell City and Borough,2014,11,199,96,103
275,Wrangell City and Borough,2014,12,268,141,127
275,Wrangell City and Borough,2014,13,220,118,102
275,Wrangell City and Borough,2014,14,163,91,72
275,Wrangell City and Borough,2014,15,106,55,51
275,Wrangell City and Borough,2014,16,88,57,31
275,Wrangell City and Borough,2014,17,47,23,24
275,Wrangell City and Borough,2014,18,31,12,19
282,Yakutat City and Borough,2014,0,624,345,279
282,Yakutat City and Borough,2014,1,36,17,19
282,Yakutat City and Borough,2014,2,31,14,17
282,Yakutat City and Borough,2014,3,37,15,22
282,Yakutat City and Borough,2014,4,34,20,14
282,Yakutat City and Borough,2014,5,36,22,14
282,Yakutat City and Borough,2014,6,26,12,14
282,Yakutat City and Borough,2014,7,37,22,15
282,Yakutat City and Borough,2014,8,44,28,16
282,Yakutat City and Borough,2014,9,36,21,15
282,Yakutat City and Borough,2014,10,65,39,26
282,Yakutat City and Borough,2014,11,50,36,14
282,Yakutat City and Borough,2014,12,40,20,20
282,Yakutat City and Borough,2014,13,59,37,22
282,Yakutat City and Borough,2014,14,43,20,23
282,Yakutat City and Borough,2014,15,19,16,3
282,Yakutat City and Borough,2014,16,11,4,7
282,Yakutat City and Borough,2014,17,13,1,12
282,Yakutat City and Borough,2014,18,7,1,6
290,Yukon-Koyukuk Census Area,2014,0,5514,2961,2553
290,Yukon-Koyukuk Census Area,2014,1,408,214,194
290,Yukon-Koyukuk Census Area,2014,2,446,240,206
290,Yukon-Koyukuk Census Area,2014,3,415,198,217
290,Yukon-Koyukuk Census Area,2014,4,398,230,168
290,Yukon-Koyukuk Census Area,2014,5,325,177,148
290,Yukon-Koyukuk Census Area,2014,6,370,188,182
290,Yukon-Koyukuk Census Area,2014,7,356,212,144
290,Yukon-Koyukuk Census Area,2014,8,305,153,152
290,Yukon-Koyukuk Census Area,2014,9,254,129,125
290,Yukon-Koyukuk Census Area,2014,10,310,166,144
290,Yukon-Koyukuk Census Area,2014,11,409,210,199
290,Yukon-Koyukuk Census Area,2014,12,455,255,200
290,Yukon-Koyukuk Census Area,2014,13,400,234,166
290,Yukon-Koyukuk Census Area,2014,14,251,126,125
290,Yukon-Koyukuk Census Area,2014,15,162,95,67
290,Yukon-Koyukuk Census Area,2014,16,95,60,35
290,Yukon-Koyukuk Census Area,2014,17,93,36,57
290,Yukon-Koyukuk Census Area,2014,18,62,38,24
000,Alaska,2015,0,737786,382202,355584
000,Alaska,2015,1,53084,27096,25988
000,Alaska,2015,2,54177,28057,26120
000,Alaska,2015,3,50906,26111,24795
000,Alaska,2015,4,48091,25217,22874
000,Alaska,2015,5,52934,28843,24091
000,Alaska,2015,6,58242,30546,27696
000,Alaska,2015,7,56987,29574,27413
000,Alaska,2015,8,47858,24756,23102
000,Alaska,2015,9,43994,22751,21243
000,Alaska,2015,10,45314,23359,21955
000,Alaska,2015,11,52608,27399,25209
000,Alaska,2015,12,53137,27407,25730
000,Alaska,2015,13,45595,23808,21787
000,Alaska,2015,14,31495,16620,14875
000,Alaska,2015,15,19103,9753,9350
000,Alaska,2015,16,11165,5492,5673
000,Alaska,2015,17,7012,3148,3864
000,Alaska,2015,18,6084,2265,3819
013,Aleutians East Borough,2015,0,3052,2012,1040
013,Aleutians East Borough,2015,1,89,43,46
013,Aleutians East Borough,2015,2,95,46,49
013,Aleutians East Borough,2015,3,72,41,31
013,Aleutians East Borough,2015,4,104,58,46
013,Aleutians East Borough,2015,5,222,172,50
013,Aleutians East Borough,2015,6,197,144,53
013,Aleutians East Borough,2015,7,282,189,93
013,Aleutians East Borough,2015,8,263,179,84
013,Aleutians East Borough,2015,9,254,171,83
013,Aleutians East Borough,2015,10,325,238,87
013,Aleutians East Borough,2015,11,408,258,150
013,Aleutians East Borough,2015,12,341,223,118
013,Aleutians East Borough,2015,13,174,109,65
013,Aleutians East Borough,2015,14,108,69,39
013,Aleutians East Borough,2015,15,61,35,26
013,Aleutians East Borough,2015,16,28,17,11
013,Aleutians East Borough,2015,17,14,8,6
013,Aleutians East Borough,2015,18,15,12,3
016,Aleutians West Census Area,2015,0,5518,3668,1850
016,Aleutians West Census Area,2015,1,206,105,101
016,Aleutians West Census Area,2015,2,224,116,108
016,Aleutians West Census Area,2015,3,201,116,85
016,Aleutians West Census Area,2015,4,231,137,94
016,Aleutians West Census Area,2015,5,288,196,92
016,Aleutians West Census Area,2015,6,487,346,141
016,Aleutians West Census Area,2015,7,480,317,163
016,Aleutians West Census Area,2015,8,522,366,156
016,Aleutians West Census Area,2015,9,426,311,115
016,Aleutians West Census Area,2015,10,528,348,180
016,Aleutians West Census Area,2015,11,625,443,182
016,Aleutians West Census Area,2015,12,495,331,164
016,Aleutians West Census Area,2015,13,415,284,131
016,Aleutians West Census Area,2015,14,283,190,93
016,Aleutians West Census Area,2015,15,65,44,21
016,Aleutians West Census Area,2015,16,16,6,10
016,Aleutians West Census Area,2015,17,15,9,6
016,Aleutians West Census Area,2015,18,11,3,8
020,Anchorage Municipality,2015,0,298933,151228,147705
020,Anchorage Municipality,2015,1,21313,10992,10321
020,Anchorage Municipality,2015,2,21124,10894,10230
020,Anchorage Municipality,2015,3,19999,10303,9696
020,Anchorage Municipality,2015,4,19082,9708,9374
020,Anchorage Municipality,2015,5,23955,12888,11067
020,Anchorage Municipality,2015,6,25735,13268,12467
020,Anchorage Municipality,2015,7,24694,12538,12156
020,Anchorage Municipality,2015,8,19937,9931,10006
020,Anchorage Municipality,2015,9,18206,9123,9083
020,Anchorage Municipality,2015,10,18270,9074,9196
020,Anchorage Municipality,2015,11,20861,10409,10452
020,Anchorage Municipality,2015,12,20264,10061,10203
020,Anchorage Municipality,2015,13,17046,8646,8400
020,Anchorage Municipality,2015,14,11824,5969,5855
020,Anchorage Municipality,2015,15,6971,3414,3557
020,Anchorage Municipality,2015,16,4307,1901,2406
020,Anchorage Municipality,2015,17,2827,1219,1608
020,Anchorage Municipality,2015,18,2518,890,1628
050,Bethel Census Area,2015,0,18189,9425,8764
050,Bethel Census Area,2015,1,1870,966,904
050,Bethel Census Area,2015,2,1864,933,931
050,Bethel Census Area,2015,3,1726,891,835
050,Bethel Census Area,2015,4,1618,863,755
050,Bethel Census Area,2015,5,1433,699,734
050,Bethel Census Area,2015,6,1533,786,747
050,Bethel Census Area,2015,7,1226,627,599
050,Bethel Census Area,2015,8,967,492,475
050,Bethel Census Area,2015,9,879,432,447
050,Bethel Census Area,2015,10,961,542,419
050,Bethel Census Area,2015,11,1096,614,482
050,Bethel Census Area,2015,12,985,520,465
050,Bethel Census Area,2015,13,806,442,364
050,Bethel Census Area,2015,14,494,266,228
050,Bethel Census Area,2015,15,337,169,168
050,Bethel Census Area,2015,16,176,97,79
050,Bethel Census Area,2015,17,141,48,93
050,Bethel Census Area,2015,18,77,38,39
060,Bristol Bay Borough,2015,0,888,480,408
060,Bristol Bay Borough,2015,1,46,24,22
060,Bristol Bay Borough,2015,2,34,17,17
060,Bristol Bay Borough,2015,3,48,23,25
060,Bristol Bay Borough,2015,4,67,36,31
060,Bristol Bay Borough,2015,5,36,23,13
060,Bristol Bay Borough,2015,6,62,29,33
060,Bristol Bay Borough,2015,7,55,27,28
060,Bristol Bay Borough,2015,8,41,21,20
060,Bristol Bay Borough,2015,9,66,39,27
060,Bristol Bay Borough,2015,10,56,29,27
060,Bristol Bay Borough,2015,11,88,49,39
060,Bristol Bay Borough,2015,12,105,62,43
060,Bristol Bay Borough,2015,13,87,54,33
060,Bristol Bay Borough,2015,14,35,16,19
060,Bristol Bay Borough,2015,15,24,18,6
060,Bristol Bay Borough,2015,16,24,8,16
060,Bristol Bay Borough,2015,17,6,3,3
060,Bristol Bay Borough,2015,18,8,2,6
063,Chugach Census Area,2015,0,6818,3610,3208
063,Chugach Census Area,2015,1,476,237,239
063,Chugach Census Area,2015,2,451,220,231
063,Chugach Census Area,2015,3,429,216,213
063,Chugach Census Area,2015,4,402,218,184
063,Chugach Census Area,2015,5,362,207,155
063,Chugach Census Area,2015,6,581,330,251
063,Chugach Census Area,2015,7,465,245,220
063,Chugach Census Area,2015,8,423,225,198
063,Chugach Census Area,2015,9,419,221,198
063,Chugach Census Area,2015,10,481,243,238
063,Chugach Census Area,2015,11,581,336,245
063,Chugach Census Area,2015,12,622,325,297
063,Chugach Census Area,2015,13,502,282,220
063,Chugach Census Area,2015,14,291,146,145
063,Chugach Census Area,2015,15,156,78,78
063,Chugach Census Area,2015,16,89,45,44
063,Chugach Census Area,2015,17,44,21,23
063,Chugach Census Area,2015,18,44,15,29
066,Copper River Census Area,2015,0,2718,1443,1275
066,Copper River Census Area,2015,1,173,88,85
066,Copper River Census Area,2015,2,203,105,98
066,Copper River Census Area,2015,3,197,88,109
066,Copper River Census Area,2015,4,171,86,85
066,Copper River Census Area,2015,5,104,57,47
066,Copper River Census Area,2015,6,120,59,61
066,Copper River Census Area,2015,7,179,93,86
066,Copper River Census Area,2015,8,134,68,66
066,Copper River Census Area,2015,9,110,58,52
066,Copper River Census Area,2015,10,181,94,87
066,Copper River Census Area,2015,11,224,121,103
066,Copper River Census Area,2015,12,292,158,134
066,Copper River Census Area,2015,13,268,164,104
066,Copper River Census Area,2015,14,145,86,59
066,Copper River Census Area,2015,15,98,58,40
066,Copper River Census Area,2015,16,74,42,32
066,Copper River Census Area,2015,17,17,9,8
066,Copper River Census Area,2015,18,28,9,19
068,Denali Borough,2015,0,1777,988,789
068,Denali Borough,2015,1,95,60,35
068,Denali Borough,2015,2,103,60,43
068,Denali Borough,2015,3,108,54,54
068,Denali Borough,2015,4,93,42,51
068,Denali Borough,2015,5,48,24,24
068,Denali Borough,2015,6,100,39,61
068,Denali Borough,2015,7,147,79,68
068,Denali Borough,2015,8,132,62,70
068,Denali Borough,2015,9,116,60,56
068,Denali Borough,2015,10,145,83,62
068,Denali Borough,2015,11,165,98,67
068,Denali Borough,2015,12,152,92,60
068,Denali Borough,2015,13,183,123,60
068,Denali Borough,2015,14,70,42,28
068,Denali Borough,2015,15,57,28,29
068,Denali Borough,2015,16,31,18,13
068,Denali Borough,2015,17,29,21,8
068,Denali Borough,2015,18,3,3,0
070,Dillingham Census Area,2015,0,5013,2589,2424
070,Dillingham Census Area,2015,1,467,211,256
070,Dillingham Census Area,2015,2,455,247,208
070,Dillingham Census Area,2015,3,391,197,194
070,Dillingham Census Area,2015,4,418,215,203
070,Dillingham Census Area,2015,5,389,209,180
070,Dillingham Census Area,2015,6,430,230,200
070,Dillingham Census Area,2015,7,284,135,149
070,Dillingham Census Area,2015,8,267,134,133
070,Dillingham Census Area,2015,9,208,109,99
070,Dillingham Census Area,2015,10,284,139,145
070,Dillingham Census Area,2015,11,349,190,159
070,Dillingham Census Area,2015,12,358,188,170
070,Dillingham Census Area,2015,13,286,163,123
070,Dillingham Census Area,2015,14,145,72,73
070,Dillingham Census Area,2015,15,126,63,63
070,Dillingham Census Area,2015,16,75,49,26
070,Dillingham Census Area,2015,17,48,21,27
070,Dillingham Census Area,2015,18,33,17,16
090,Fairbanks North Star Borough,2015,0,98808,51849,46959
090,Fairbanks North Star Borough,2015,1,7311,3682,3629
090,Fairbanks North Star Borough,2015,2,7057,3719,3338
090,Fairbanks North Star Borough,2015,3,6485,3351,3134
090,Fairbanks North Star Borough,2015,4,6107,3271,2836
090,Fairbanks North Star Borough,2015,5,8991,5209,3782
090,Fairbanks North Star Borough,2015,6,8591,4609,3982
090,Fairbanks North Star Borough,2015,7,8165,4319,3846
090,Fairbanks North Star Borough,2015,8,6440,3331,3109
090,Fairbanks North Star Borough,2015,9,5918,3116,2802
090,Fairbanks North Star Borough,2015,10,5537,2805,2732
090,Fairbanks North Star Borough,2015,11,6579,3335,3244
090,Fairbanks North Star Borough,2015,12,6655,3405,3250
090,Fairbanks North Star Borough,2015,13,5860,3039,2821
090,Fairbanks North Star Borough,2015,14,3984,2161,1823
090,Fairbanks North Star Borough,2015,15,2427,1238,1189
090,Fairbanks North Star Borough,2015,16,1207,632,575
090,Fairbanks North Star Borough,2015,17,785,358,427
090,Fairbanks North Star Borough,2015,18,709,269,440
100,Haines Borough,2015,0,2495,1256,1239
100,Haines Borough,2015,1,105,49,56
100,Haines Borough,2015,2,144,74,70
100,Haines Borough,2015,3,113,62,51
100,Haines Borough,2015,4,122,64,58
100,Haines Borough,2015,5,76,42,34
100,Haines Borough,2015,6,117,63,54
100,Haines Borough,2015,7,150,75,75
100,Haines Borough,2015,8,138,66,72
100,Haines Borough,2015,9,126,66,60
100,Haines Borough,2015,10,182,94,88
100,Haines Borough,2015,11,214,108,106
100,Haines Borough,2015,12,268,133,135
100,Haines Borough,2015,13,258,131,127
100,Haines Borough,2015,14,208,104,104
100,Haines Borough,2015,15,118,60,58
100,Haines Borough,2015,16,62,25,37
100,Haines Borough,2015,17,48,21,27
100,Haines Borough,2015,18,46,19,27
105,Hoonah-Angoon Census Area,2015,0,2179,1165,1014
105,Hoonah-Angoon Census Area,2015,1,125,63,62
105,Hoonah-Angoon Census Area,2015,2,131,76,55
105,Hoonah-Angoon Census Area,2015,3,125,54,71
105,Hoonah-Angoon Census Area,2015,4,107,47,60
105,Hoonah-Angoon Census Area,2015,5,80,46,34
105,Hoonah-Angoon Census Area,2015,6,112,61,51
105,Hoonah-Angoon Census Area,2015,7,121,70,51
105,Hoonah-Angoon Census Area,2015,8,115,48,67
105,Hoonah-Angoon Census Area,2015,9,112,64,48
105,Hoonah-Angoon Census Area,2015,10,132,80,52
105,Hoonah-Angoon Census Area,2015,11,181,84,97
105,Hoonah-Angoon Census Area,2015,12,226,116,110
105,Hoonah-Angoon Census Area,2015,13,230,122,108
105,Hoonah-Angoon Census Area,2015,14,179,109,70
105,Hoonah-Angoon Census Area,2015,15,89,53,36
105,Hoonah-Angoon Census Area,2015,16,73,48,25
105,Hoonah-Angoon Census Area,2015,17,26,19,7
105,Hoonah-Angoon Census Area,2015,18,15,5,10
110,Juneau City and Borough,2015,0,33162,16855,16307
110,Juneau City and Borough,2015,1,2037,1070,967
110,Juneau City and Borough,2015,2,2101,1031,1070
110,Juneau City and Borough,2015,3,2047,1026,1021
110,Juneau City and Borough,2015,4,2006,1064,942
110,Juneau City and Borough,2015,5,1951,996,955
110,Juneau City and Borough,2015,6,2609,1324,1285
110,Juneau City and Borough,2015,7,2678,1378,1300
110,Juneau City and Borough,2015,8,2221,1143,1078
110,Juneau City and Borough,2015,9,2083,1066,1017
110,Juneau City and Borough,2015,10,2262,1146,1116
110,Juneau City and Borough,2015,11,2652,1367,1285
110,Juneau City and Borough,2015,12,2590,1322,1268
110,Juneau City and Borough,2015,13,2282,1171,1111
110,Juneau City and Borough,2015,14,1609,819,790
110,Juneau City and Borough,2015,15,893,449,444
110,Juneau City and Borough,2015,16,541,241,300
110,Juneau City and Borough,2015,17,305,131,174
110,Juneau City and Borough,2015,18,295,111,184
122,Kenai Peninsula Borough,2015,0,57728,30174,27554
122,Kenai Peninsula Borough,2015,1,3549,1821,1728
122,Kenai Peninsula Borough,2015,2,3746,1909,1837
122,Kenai Peninsula Borough,2015,3,3707,1854,1853
122,Kenai Peninsula Borough,2015,4,3545,1873,1672
122,Kenai Peninsula Borough,2015,5,2971,1686,1285
122,Kenai Peninsula Borough,2015,6,3487,1866,1621
122,Kenai Peninsula Borough,2015,7,3690,1968,1722
122,Kenai Peninsula Borough,2015,8,3450,1855,1595
122,Kenai Peninsula Borough,2015,9,3365,1767,1598
122,Kenai Peninsula Borough,2015,10,3565,1858,1707
122,Kenai Peninsula Borough,2015,11,4280,2224,2056
122,Kenai Peninsula Borough,2015,12,5021,2520,2501
122,Kenai Peninsula Borough,2015,13,4763,2483,2280
122,Kenai Peninsula Borough,2015,14,3490,1905,1585
122,Kenai Peninsula Borough,2015,15,2319,1262,1057
122,Kenai Peninsula Borough,2015,16,1319,684,635
122,Kenai Peninsula Borough,2015,17,769,375,394
122,Kenai Peninsula Borough,2015,18,692,264,428
130,Ketchikan Gateway Borough,2015,0,13841,7054,6787
130,Ketchikan Gateway Borough,2015,1,894,436,458
130,Ketchikan Gateway Borough,2015,2,835,438,397
130,Ketchikan Gateway Borough,2015,3,857,442,415
130,Ketchikan Gateway Borough,2015,4,930,484,446
130,Ketchikan Gateway Borough,2015,5,811,439,372
130,Ketchikan Gateway Borough,2015,6,971,513,458
130,Ketchikan Gateway Borough,2015,7,890,457,433
130,Ketchikan Gateway Borough,2015,8,838,417,421
130,Ketchikan Gateway Borough,2015,9,800,393,407
130,Ketchikan Gateway Borough,2015,10,899,431,468
130,Ketchikan Gateway Borough,2015,11,1077,585,492
130,Ketchikan Gateway Borough,2015,12,1132,568,564
130,Ketchikan Gateway Borough,2015,13,1036,519,517
130,Ketchikan Gateway Borough,2015,14,735,370,365
130,Ketchikan Gateway Borough,2015,15,505,257,248
130,Ketchikan Gateway Borough,2015,16,277,158,119
130,Ketchikan Gateway Borough,2015,17,171,72,99
130,Ketchikan Gateway Borough,2015,18,183,75,108
150,Kodiak Island Borough,2015,0,13761,7245,6516
150,Kodiak Island Borough,2015,1,1031,528,503
150,Kodiak Island Borough,2015,2,1034,518,516
150,Kodiak Island Borough,2015,3,951,485,466
150,Kodiak Island Borough,2015,4,997,554,443
150,Kodiak Island Borough,2015,5,913,493,420
150,Kodiak Island Borough,2015,6,1163,670,493
150,Kodiak Island Borough,2015,7,1042,553,489
150,Kodiak Island Borough,2015,8,889,459,430
150,Kodiak Island Borough,2015,9,768,381,387
150,Kodiak Island Borough,2015,10,867,433,434
150,Kodiak Island Borough,2015,11,988,524,464
150,Kodiak Island Borough,2015,12,1049,610,439
150,Kodiak Island Borough,2015,13,780,411,369
150,Kodiak Island Borough,2015,14,580,275,305
150,Kodiak Island Borough,2015,15,348,186,162
150,Kodiak Island Borough,2015,16,183,97,86
150,Kodiak Island Borough,2015,17,102,42,60
150,Kodiak Island Borough,2015,18,76,26,50
158,Kusilvak Census Area,2015,0,8204,4274,3930
158,Kusilvak Census Area,2015,1,898,461,437
158,Kusilvak Census Area,2015,2,953,525,428
158,Kusilvak Census Area,2015,3,898,439,459
158,Kusilvak Census Area,2015,4,821,424,397
158,Kusilvak Census Area,2015,5,762,405,357
158,Kusilvak Census Area,2015,6,757,401,356
158,Kusilvak Census Area,2015,7,467,240,227
158,Kusilvak Census Area,2015,8,379,206,173
158,Kusilvak Census Area,2015,9,354,185,169
158,Kusilvak Census Area,2015,10,413,206,207
158,Kusilvak Census Area,2015,11,408,211,197
158,Kusilvak Census Area,2015,12,368,216,152
158,Kusilvak Census Area,2015,13,257,127,130
158,Kusilvak Census Area,2015,14,200,114,86
158,Kusilvak Census Area,2015,15,112,48,64
158,Kusilvak Census Area,2015,16,71,34,37
158,Kusilvak Census Area,2015,17,57,23,34
158,Kusilvak Census Area,2015,18,29,9,20
164,Lake and Peninsula Borough,2015,0,1677,900,777
164,Lake and Peninsula Borough,2015,1,142,75,67
164,Lake and Peninsula Borough,2015,2,151,89,62
164,Lake and Peninsula Borough,2015,3,114,55,59
164,Lake and Peninsula Borough,2015,4,118,55,63
164,Lake and Peninsula Borough,2015,5,120,60,60
164,Lake and Peninsula Borough,2015,6,130,73,57
164,Lake and Peninsula Borough,2015,7,138,63,75
164,Lake and Peninsula Borough,2015,8,118,68,50
164,Lake and Peninsula Borough,2015,9,68,36,32
164,Lake and Peninsula Borough,2015,10,71,42,29
164,Lake and Peninsula Borough,2015,11,136,80,56
164,Lake and Peninsula Borough,2015,12,130,80,50
164,Lake and Peninsula Borough,2015,13,87,39,48
164,Lake and Peninsula Borough,2015,14,56,33,23
164,Lake and Peninsula Borough,2015,15,44,25,19
164,Lake and Peninsula Borough,2015,16,21,9,12
164,Lake and Peninsula Borough,2015,17,21,16,5
164,Lake and Peninsula Borough,2015,18,12,2,10
170,Matanuska-Susitna Borough,2015,0,100144,51782,48362
170,Matanuska-Susitna Borough,2015,1,7466,3776,3690
170,Matanuska-Susitna Borough,2015,2,8325,4349,3976
170,Matanuska-Susitna Borough,2015,3,7890,4072,3818
170,Matanuska-Susitna Borough,2015,4,7076,3835,3241
170,Matanuska-Susitna Borough,2015,5,5569,2917,2652
170,Matanuska-Susitna Borough,2015,6,6382,3244,3138
170,Matanuska-Susitna Borough,2015,7,7266,3690,3576
170,Matanuska-Susitna Borough,2015,8,6605,3425,3180
170,Matanuska-Susitna Borough,2015,9,6270,3242,3028
170,Matanuska-Susitna Borough,2015,10,6370,3313,3057
170,Matanuska-Susitna Borough,2015,11,7164,3744,3420
170,Matanuska-Susitna Borough,2015,12,7231,3763,3468
170,Matanuska-Susitna Borough,2015,13,6248,3162,3086
170,Matanuska-Susitna Borough,2015,14,4312,2260,2052
170,Matanuska-Susitna Borough,2015,15,2745,1404,1341
170,Matanuska-Susitna Borough,2015,16,1535,828,707
170,Matanuska-Susitna Borough,2015,17,946,458,488
170,Matanuska-Susitna Borough,2015,18,744,300,444
180,Nome Census Area,2015,0,10030,5364,4666
180,Nome Census Area,2015,1,994,516,478
180,Nome Census Area,2015,2,1024,536,488
180,Nome Census Area,2015,3,940,484,456
180,Nome Census Area,2015,4,775,423,352
180,Nome Census Area,2015,5,754,393,361
180,Nome Census Area,2015,6,865,467,398
180,Nome Census Area,2015,7,713,373,340
180,Nome Census Area,2015,8,620,334,286
180,Nome Census Area,2015,9,536,300,236
180,Nome Census Area,2015,10,488,264,224
180,Nome Census Area,2015,11,586,342,244
180,Nome Census Area,2015,12,558,290,268
180,Nome Census Area,2015,13,477,255,222
180,Nome Census Area,2015,14,307,192,115
180,Nome Census Area,2015,15,178,92,86
180,Nome Census Area,2015,16,100,51,49
180,Nome Census Area,2015,17,75,39,36
180,Nome Census Area,2015,18,40,13,27
185,North Slope Borough,2015,0,9898,6120,3778
185,North Slope Borough,2015,1,740,354,386
185,North Slope Borough,2015,2,745,391,354
185,North Slope Borough,2015,3,640,331,309
185,North Slope Borough,2015,4,545,292,253
185,North Slope Borough,2015,5,696,415,281
185,North Slope Borough,2015,6,904,567,337
185,North Slope Borough,2015,7,932,603,329
185,North Slope Borough,2015,8,718,506,212
185,North Slope Borough,2015,9,526,339,187
185,North Slope Borough,2015,10,626,435,191
185,North Slope Borough,2015,11,845,570,275
185,North Slope Borough,2015,12,924,648,276
185,North Slope Borough,2015,13,585,392,193
185,North Slope Borough,2015,14,249,170,79
185,North Slope Borough,2015,15,102,60,42
185,North Slope Borough,2015,16,52,24,28
185,North Slope Borough,2015,17,41,12,29
185,North Slope Borough,2015,18,28,11,17
188,Northwest Arctic Borough,2015,0,7883,4227,3656
188,Northwest Arctic Borough,2015,1,798,441,357
188,Northwest Arctic Borough,2015,2,836,413,423
188,Northwest Arctic Borough,2015,3,705,356,349
188,Northwest Arctic Borough,2015,4,649,338,311
188,Northwest Arctic Borough,2015,5,612,327,285
188,Northwest Arctic Borough,2015,6,705,378,327
188,Northwest Arctic Borough,2015,7,578,312,266
188,Northwest Arctic Borough,2015,8,407,219,188
188,Northwest Arctic Borough,2015,9,392,201,191
188,Northwest Arctic Borough,2015,10,407,256,151
188,Northwest Arctic Borough,2015,11,508,283,225
188,Northwest Arctic Borough,2015,12,426,248,178
188,Northwest Arctic Borough,2015,13,302,193,109
188,Northwest Arctic Borough,2015,14,221,110,111
188,Northwest Arctic Borough,2015,15,133,73,60
188,Northwest Arctic Borough,2015,16,82,44,38
188,Northwest Arctic Borough,2015,17,64,21,43
188,Northwest Arctic Borough,2015,18,58,14,44
195,Petersburg Borough,2015,0,3181,1638,1543
195,Petersburg Borough,2015,1,216,105,111
195,Petersburg Borough,2015,2,195,101,94
195,Petersburg Borough,2015,3,194,96,98
195,Petersburg Borough,2015,4,176,100,76
195,Petersburg Borough,2015,5,130,62,68
195,Petersburg Borough,2015,6,193,93,100
195,Petersburg Borough,2015,7,180,84,96
195,Petersburg Borough,2015,8,208,101,107
195,Petersburg Borough,2015,9,171,87,84
195,Petersburg Borough,2015,10,229,128,101
195,Petersburg Borough,2015,11,221,117,104
195,Petersburg Borough,2015,12,279,125,154
195,Petersburg Borough,2015,13,270,159,111
195,Petersburg Borough,2015,14,228,132,96
195,Petersburg Borough,2015,15,140,75,65
195,Petersburg Borough,2015,16,62,33,29
195,Petersburg Borough,2015,17,39,18,21
195,Petersburg Borough,2015,18,50,22,28
198,Prince of Wales-Hyder Census Area,2015,0,6518,3563,2955
198,Prince of Wales-Hyder Census Area,2015,1,416,215,201
198,Prince of Wales-Hyder Census Area,2015,2,512,254,258
198,Prince of Wales-Hyder Census Area,2015,3,451,242,209
198,Prince of Wales-Hyder Census Area,2015,4,381,213,168
198,Prince of Wales-Hyder Census Area,2015,5,321,189,132
198,Prince of Wales-Hyder Census Area,2015,6,367,191,176
198,Prince of Wales-Hyder Census Area,2015,7,393,207,186
198,Prince of Wales-Hyder Census Area,2015,8,381,206,175
198,Prince of Wales-Hyder Census Area,2015,9,382,197,185
198,Prince of Wales-Hyder Census Area,2015,10,437,239,198
198,Prince of Wales-Hyder Census Area,2015,11,548,309,239
198,Prince of Wales-Hyder Census Area,2015,12,562,310,252
198,Prince of Wales-Hyder Census Area,2015,13,497,274,223
198,Prince of Wales-Hyder Census Area,2015,14,395,242,153
198,Prince of Wales-Hyder Census Area,2015,15,231,134,97
198,Prince of Wales-Hyder Census Area,2015,16,140,88,52
198,Prince of Wales-Hyder Census Area,2015,17,65,31,34
198,Prince of Wales-Hyder Census Area,2015,18,39,22,17
220,Sitka City and Borough,2015,0,8881,4434,4447
220,Sitka City and Borough,2015,1,508,237,271
220,Sitka City and Borough,2015,2,621,356,265
220,Sitka City and Borough,2015,3,529,255,274
220,Sitka City and Borough,2015,4,523,280,243
220,Sitka City and Borough,2015,5,501,246,255
220,Sitka City and Borough,2015,6,597,276,321
220,Sitka City and Borough,2015,7,621,292,329
220,Sitka City and Borough,2015,8,661,359,302
220,Sitka City and Borough,2015,9,541,281,260
220,Sitka City and Borough,2015,10,535,267,268
220,Sitka City and Borough,2015,11,636,328,308
220,Sitka City and Borough,2015,12,747,371,376
220,Sitka City and Borough,2015,13,619,317,302
220,Sitka City and Borough,2015,14,426,236,190
220,Sitka City and Borough,2015,15,274,131,143
220,Sitka City and Borough,2015,16,258,106,152
220,Sitka City and Borough,2015,17,131,53,78
220,Sitka City and Borough,2015,18,153,43,110
230,"Skagway Borough, Municipality",2015,0,1045,523,522
230,"Skagway Borough, Municipality",2015,1,59,25,34
230,"Skagway Borough, Municipality",2015,2,49,30,19
230,"Skagway Borough, Municipality",2015,3,32,14,18
230,"Skagway Borough, Municipality",2015,4,22,8,14
230,"Skagway Borough, Municipality",2015,5,50,23,27
230,"Skagway Borough, Municipality",2015,6,70,26,44
230,"Skagway Borough, Municipality",2015,7,110,54,56
230,"Skagway Borough, Municipality",2015,8,79,42,37
230,"Skagway Borough, Municipality",2015,9,95,55,40
230,"Skagway Borough, Municipality",2015,10,102,49,53
230,"Skagway Borough, Municipality",2015,11,73,43,30
230,"Skagway Borough, Municipality",2015,12,75,44,31
230,"Skagway Borough, Municipality",2015,13,93,53,40
230,"Skagway Borough, Municipality",2015,14,66,32,34
230,"Skagway Borough, Municipality",2015,15,29,12,17
230,"Skagway Borough, Municipality",2015,16,18,6,12
230,"Skagway Borough, Municipality",2015,17,17,5,12
230,"Skagway Borough, Municipality",2015,18,6,2,4
240,Southeast Fairbanks Census Area,2015,0,6899,3814,3085
240,Southeast Fairbanks Census Area,2015,1,448,208,240
240,Southeast Fairbanks Census Area,2015,2,526,288,238
240,Southeast Fairbanks Census Area,2015,3,517,284,233
240,Southeast Fairbanks Census Area,2015,4,424,219,205
240,Southeast Fairbanks Census Area,2015,5,347,185,162
240,Southeast Fairbanks Census Area,2015,6,410,220,190
240,Southeast Fairbanks Census Area,2015,7,521,293,228
240,Southeast Fairbanks Census Area,2015,8,429,240,189
240,Southeast Fairbanks Census Area,2015,9,411,239,172
240,Southeast Fairbanks Census Area,2015,10,488,280,208
240,Southeast Fairbanks Census Area,2015,11,491,302,189
240,Southeast Fairbanks Census Area,2015,12,542,281,261
240,Southeast Fairbanks Census Area,2015,13,492,302,190
240,Southeast Fairbanks Census Area,2015,14,352,221,131
240,Southeast Fairbanks Census Area,2015,15,219,120,99
240,Southeast Fairbanks Census Area,2015,16,137,74,63
240,Southeast Fairbanks Census Area,2015,17,74,39,35
240,Southeast Fairbanks Census Area,2015,18,71,19,52
275,Wrangell City and Borough,2015,0,2447,1245,1202
275,Wrangell City and Borough,2015,1,142,72,70
275,Wrangell City and Borough,2015,2,143,56,87
275,Wrangell City and Borough,2015,3,132,72,60
275,Wrangell City and Borough,2015,4,125,70,55
275,Wrangell City and Borough,2015,5,115,64,51
275,Wrangell City and Borough,2015,6,158,61,97
275,Wrangell City and Borough,2015,7,129,72,57
275,Wrangell City and Borough,2015,8,88,42,46
275,Wrangell City and Borough,2015,9,110,55,55
275,Wrangell City and Borough,2015,10,141,74,67
275,Wrangell City and Borough,2015,11,191,88,103
275,Wrangell City and Borough,2015,12,266,142,124
275,Wrangell City and Borough,2015,13,236,115,121
275,Wrangell City and Borough,2015,14,176,106,70
275,Wrangell City and Borough,2015,15,115,56,59
275,Wrangell City and Borough,2015,16,101,64,37
275,Wrangell City and Borough,2015,17,43,19,24
275,Wrangell City and Borough,2015,18,36,17,19
282,Yakutat City and Borough,2015,0,605,335,270
282,Yakutat City and Borough,2015,1,41,22,19
282,Yakutat City and Borough,2015,2,26,12,14
282,Yakutat City and Borough,2015,3,41,18,23
282,Yakutat City and Borough,2015,4,32,16,16
282,Yakutat City and Borough,2015,5,36,21,15
282,Yakutat City and Borough,2015,6,21,7,14
282,Yakutat City and Borough,2015,7,40,26,14
282,Yakutat City and Borough,2015,8,47,29,18
282,Yakutat City and Borough,2015,9,31,20,11
282,Yakutat City and Borough,2015,10,63,38,25
282,Yakutat City and Borough,2015,11,49,30,19
282,Yakutat City and Borough,2015,12,36,18,18
282,Yakutat City and Borough,2015,13,52,34,18
282,Yakutat City and Borough,2015,14,44,24,20
282,Yakutat City and Borough,2015,15,18,13,5
282,Yakutat City and Borough,2015,16,12,6,6
282,Yakutat City and Borough,2015,17,10,0,10
282,Yakutat City and Borough,2015,18,6,1,5
290,Yukon-Koyukuk Census Area,2015,0,5494,2942,2552
290,Yukon-Koyukuk Census Area,2015,1,429,214,215
290,Yukon-Koyukuk Census Area,2015,2,470,254,216
290,Yukon-Koyukuk Census Area,2015,3,367,190,177
290,Yukon-Koyukuk Census Area,2015,4,424,224,200
290,Yukon-Koyukuk Census Area,2015,5,291,150,141
290,Yukon-Koyukuk Census Area,2015,6,388,205,183
290,Yukon-Koyukuk Census Area,2015,7,351,195,156
290,Yukon-Koyukuk Census Area,2015,8,341,182,159
290,Yukon-Koyukuk Census Area,2015,9,251,137,114
290,Yukon-Koyukuk Census Area,2015,10,269,131,138
290,Yukon-Koyukuk Census Area,2015,11,384,207,177
290,Yukon-Koyukuk Census Area,2015,12,438,237,201
290,Yukon-Koyukuk Census Area,2015,13,404,243,161
290,Yukon-Koyukuk Census Area,2015,14,283,149,134
290,Yukon-Koyukuk Census Area,2015,15,169,98,71
290,Yukon-Koyukuk Census Area,2015,16,94,57,37
290,Yukon-Koyukuk Census Area,2015,17,82,37,45
290,Yukon-Koyukuk Census Area,2015,18,59,32,27
000,Alaska,2016,0,740637,382584,358053
000,Alaska,2016,1,53040,27101,25939
000,Alaska,2016,2,54785,28292,26493
000,Alaska,2016,3,51304,26320,24984
000,Alaska,2016,4,48156,25354,22802
000,Alaska,2016,5,50670,27301,23369
000,Alaska,2016,6,57948,30235,27713
000,Alaska,2016,7,57754,29855,27899
000,Alaska,2016,8,49678,25690,23988
000,Alaska,2016,9,42828,22090,20738
000,Alaska,2016,10,44962,23169,21793
000,Alaska,2016,11,50319,26071,24248
000,Alaska,2016,12,53137,27385,25752
000,Alaska,2016,13,46957,24296,22661
000,Alaska,2016,14,33686,17743,15943
000,Alaska,2016,15,20055,10180,9875
000,Alaska,2016,16,11830,5859,5971
000,Alaska,2016,17,7229,3273,3956
000,Alaska,2016,18,6299,2370,3929
013,Aleutians East Borough,2016,0,3004,2010,994
013,Aleutians East Borough,2016,1,75,36,39
013,Aleutians East Borough,2016,2,96,40,56
013,Aleutians East Borough,2016,3,64,32,32
013,Aleutians East Borough,2016,4,85,50,35
013,Aleutians East Borough,2016,5,201,143,58
013,Aleutians East Borough,2016,6,215,162,53
013,Aleutians East Borough,2016,7,272,201,71
013,Aleutians East Borough,2016,8,307,207,100
013,Aleutians East Borough,2016,9,255,176,79
013,Aleutians East Borough,2016,10,325,255,70
013,Aleutians East Borough,2016,11,353,232,121
013,Aleutians East Borough,2016,12,359,216,143
013,Aleutians East Borough,2016,13,185,129,56
013,Aleutians East Borough,2016,14,95,58,37
013,Aleutians East Borough,2016,15,63,37,26
013,Aleutians East Borough,2016,16,28,19,9
013,Aleutians East Borough,2016,17,9,4,5
013,Aleutians East Borough,2016,18,17,13,4
016,Aleutians West Census Area,2016,0,5471,3623,1848
016,Aleutians West Census Area,2016,1,187,91,96
016,Aleutians West Census Area,2016,2,234,113,121
016,Aleutians West Census Area,2016,3,186,114,72
016,Aleutians West Census Area,2016,4,216,130,86
016,Aleutians West Census Area,2016,5,321,234,87
016,Aleutians West Census Area,2016,6,429,286,143
016,Aleutians West Census Area,2016,7,529,378,151
016,Aleutians West Census Area,2016,8,489,329,160
016,Aleutians West Census Area,2016,9,452,339,113
016,Aleutians West Census Area,2016,10,457,292,165
016,Aleutians West Census Area,2016,11,634,409,225
016,Aleutians West Census Area,2016,12,515,348,167
016,Aleutians West Census Area,2016,13,406,293,113
016,Aleutians West Census Area,2016,14,297,201,96
016,Aleutians West Census Area,2016,15,69,43,26
016,Aleutians West Census Area,2016,16,18,7,11
016,Aleutians West Census Area,2016,17,17,11,6
016,Aleutians West Census Area,2016,18,15,5,10
020,Anchorage Municipality,2016,0,299330,150857,148473
020,Anchorage Municipality,2016,1,21241,10885,10356
020,Anchorage Municipality,2016,2,21322,10957,10365
020,Anchorage Municipality,2016,3,20034,10291,9743
020,Anchorage Municipality,2016,4,19204,9877,9327
020,Anchorage Municipality,2016,5,22671,12005,10666
020,Anchorage Municipality,2016,6,25671,13169,12502
020,Anchorage Municipality,2016,7,24888,12550,12338
020,Anchorage Municipality,2016,8,20672,10336,10336
020,Anchorage Municipality,2016,9,17606,8810,8796
020,Anchorage Municipality,2016,10,18305,9141,9164
020,Anchorage Municipality,2016,11,19906,9822,10084
020,Anchorage Municipality,2016,12,20186,10054,10132
020,Anchorage Municipality,2016,13,17582,8812,8770
020,Anchorage Municipality,2016,14,12557,6346,6211
020,Anchorage Municipality,2016,15,7404,3572,3832
020,Anchorage Municipality,2016,16,4503,2021,2482
020,Anchorage Municipality,2016,17,2935,1272,1663
020,Anchorage Municipality,2016,18,2643,937,1706
050,Bethel Census Area,2016,0,18127,9399,8728
050,Bethel Census Area,2016,1,1821,953,868
050,Bethel Census Area,2016,2,1864,930,934
050,Bethel Census Area,2016,3,1729,886,843
050,Bethel Census Area,2016,4,1603,875,728
050,Bethel Census Area,2016,5,1410,689,721
050,Bethel Census Area,2016,6,1527,780,747
050,Bethel Census Area,2016,7,1278,655,623
050,Bethel Census Area,2016,8,983,494,489
050,Bethel Census Area,2016,9,838,430,408
050,Bethel Census Area,2016,10,912,495,417
050,Bethel Census Area,2016,11,1093,618,475
050,Bethel Census Area,2016,12,974,520,454
050,Bethel Census Area,2016,13,845,450,395
050,Bethel Census Area,2016,14,496,266,230
050,Bethel Census Area,2016,15,330,173,157
050,Bethel Census Area,2016,16,200,100,100
050,Bethel Census Area,2016,17,147,54,93
050,Bethel Census Area,2016,18,77,31,46
060,Bristol Bay Borough,2016,0,877,473,404
060,Bristol Bay Borough,2016,1,39,19,20
060,Bristol Bay Borough,2016,2,30,16,14
060,Bristol Bay Borough,2016,3,48,23,25
060,Bristol Bay Borough,2016,4,64,33,31
060,Bristol Bay Borough,2016,5,41,24,17
060,Bristol Bay Borough,2016,6,66,33,33
060,Bristol Bay Borough,2016,7,55,29,26
060,Bristol Bay Borough,2016,8,34,18,16
060,Bristol Bay Borough,2016,9,64,36,28
060,Bristol Bay Borough,2016,10,68,37,31
060,Bristol Bay Borough,2016,11,74,40,34
060,Bristol Bay Borough,2016,12,107,64,43
060,Bristol Bay Borough,2016,13,82,50,32
060,Bristol Bay Borough,2016,14,47,19,28
060,Bristol Bay Borough,2016,15,23,17,6
060,Bristol Bay Borough,2016,16,20,7,13
060,Bristol Bay Borough,2016,17,7,5,2
060,Bristol Bay Borough,2016,18,8,3,5
063,Chugach Census Area,2016,0,6807,3581,3226
063,Chugach Census Area,2016,1,484,232,252
063,Chugach Census Area,2016,2,465,244,221
063,Chugach Census Area,2016,3,427,210,217
063,Chugach Census Area,2016,4,393,211,182
063,Chugach Census Area,2016,5,331,188,143
063,Chugach Census Area,2016,6,560,296,264
063,Chugach Census Area,2016,7,496,275,221
063,Chugach Census Area,2016,8,462,234,228
063,Chugach Census Area,2016,9,386,199,187
063,Chugach Census Area,2016,10,490,261,229
063,Chugach Census Area,2016,11,515,294,221
063,Chugach Census Area,2016,12,634,338,296
063,Chugach Census Area,2016,13,517,272,245
063,Chugach Census Area,2016,14,304,165,139
063,Chugach Census Area,2016,15,163,84,79
063,Chugach Census Area,2016,16,92,41,51
063,Chugach Census Area,2016,17,52,28,24
063,Chugach Census Area,2016,18,36,9,27
066,Copper River Census Area,2016,0,2705,1431,1274
066,Copper River Census Area,2016,1,173,77,96
066,Copper River Census Area,2016,2,200,101,99
066,Copper River Census Area,2016,3,185,93,92
066,Copper River Census Area,2016,4,168,84,84
066,Copper River Census Area,2016,5,104,61,43
066,Copper River Census Area,2016,6,117,60,57
066,Copper River Census Area,2016,7,156,77,79
066,Copper River Census Area,2016,8,150,80,70
066,Copper River Census Area,2016,9,96,43,53
066,Copper River Census Area,2016,10,196,112,84
066,Copper River Census Area,2016,11,203,100,103
066,Copper River Census Area,2016,12,300,155,145
066,Copper River Census Area,2016,13,268,168,100
066,Copper River Census Area,2016,14,169,102,67
066,Copper River Census Area,2016,15,97,51,46
066,Copper River Census Area,2016,16,81,48,33
066,Copper River Census Area,2016,17,21,11,10
066,Copper River Census Area,2016,18,21,8,13
068,Denali Borough,2016,0,1872,1039,833
068,Denali Borough,2016,1,100,56,44
068,Denali Borough,2016,2,121,73,48
068,Denali Borough,2016,3,103,56,47
068,Denali Borough,2016,4,109,51,58
068,Denali Borough,2016,5,45,23,22
068,Denali Borough,2016,6,121,55,66
068,Denali Borough,2016,7,135,67,68
068,Denali Borough,2016,8,150,73,77
068,Denali Borough,2016,9,112,59,53
068,Denali Borough,2016,10,162,81,81
068,Denali Borough,2016,11,161,96,65
068,Denali Borough,2016,12,163,99,64
068,Denali Borough,2016,13,191,128,63
068,Denali Borough,2016,14,80,52,28
068,Denali Borough,2016,15,49,23,26
068,Denali Borough,2016,16,41,26,15
068,Denali Borough,2016,17,25,19,6
068,Denali Borough,2016,18,4,2,2
070,Dillingham Census Area,2016,0,4965,2561,2404
070,Dillingham Census Area,2016,1,460,191,269
070,Dillingham Census Area,2016,2,483,258,225
070,Dillingham Census Area,2016,3,377,190,187
070,Dillingham Census Area,2016,4,392,207,185
070,Dillingham Census Area,2016,5,384,199,185
070,Dillingham Census Area,2016,6,411,225,186
070,Dillingham Census Area,2016,7,310,154,156
070,Dillingham Census Area,2016,8,273,135,138
070,Dillingham Census Area,2016,9,206,108,98
070,Dillingham Census Area,2016,10,263,132,131
070,Dillingham Census Area,2016,11,333,179,154
070,Dillingham Census Area,2016,12,353,204,149
070,Dillingham Census Area,2016,13,298,162,136
070,Dillingham Census Area,2016,14,146,70,76
070,Dillingham Census Area,2016,15,127,68,59
070,Dillingham Census Area,2016,16,79,45,34
070,Dillingham Census Area,2016,17,41,20,21
070,Dillingham Census Area,2016,18,29,14,15
090,Fairbanks North Star Borough,2016,0,99098,51880,47218
090,Fairbanks North Star Borough,2016,1,7274,3724,3550
090,Fairbanks North Star Borough,2016,2,7197,3790,3407
090,Fairbanks North Star Borough,2016,3,6432,3257,3175
090,Fairbanks North Star Borough,2016,4,6183,3311,2872
090,Fairbanks North Star Borough,2016,5,8827,5072,3755
090,Fairbanks North Star Borough,2016,6,8398,4525,3873
090,Fairbanks North Star Borough,2016,7,8299,4339,3960
090,Fairbanks North Star Borough,2016,8,6655,3450,3205
090,Fairbanks North Star Borough,2016,9,5781,3008,2773
090,Fairbanks North Star Borough,2016,10,5520,2862,2658
090,Fairbanks North Star Borough,2016,11,6229,3141,3088
090,Fairbanks North Star Borough,2016,12,6642,3380,3262
090,Fairbanks North Star Borough,2016,13,6016,3095,2921
090,Fairbanks North Star Borough,2016,14,4253,2271,1982
090,Fairbanks North Star Borough,2016,15,2568,1327,1241
090,Fairbanks North Star Borough,2016,16,1334,700,634
090,Fairbanks North Star Borough,2016,17,784,367,417
090,Fairbanks North Star Borough,2016,18,706,261,445
100,Haines Borough,2016,0,2468,1220,1248
100,Haines Borough,2016,1,99,39,60
100,Haines Borough,2016,2,156,74,82
100,Haines Borough,2016,3,119,67,52
100,Haines Borough,2016,4,110,54,56
100,Haines Borough,2016,5,70,37,33
100,Haines Borough,2016,6,119,65,54
100,Haines Borough,2016,7,157,78,79
100,Haines Borough,2016,8,149,73,76
100,Haines Borough,2016,9,121,58,63
100,Haines Borough,2016,10,150,78,72
100,Haines Borough,2016,11,199,108,91
100,Haines Borough,2016,12,256,125,131
100,Haines Borough,2016,13,262,132,130
100,Haines Borough,2016,14,215,107,108
100,Haines Borough,2016,15,125,61,64
100,Haines Borough,2016,16,67,30,37
100,Haines Borough,2016,17,40,14,26
100,Haines Borough,2016,18,54,20,34
105,Hoonah-Angoon Census Area,2016,0,2190,1149,1041
105,Hoonah-Angoon Census Area,2016,1,119,53,66
105,Hoonah-Angoon Census Area,2016,2,146,82,64
105,Hoonah-Angoon Census Area,2016,3,124,48,76
105,Hoonah-Angoon Census Area,2016,4,108,47,61
105,Hoonah-Angoon Census Area,2016,5,78,43,35
105,Hoonah-Angoon Census Area,2016,6,110,59,51
105,Hoonah-Angoon Census Area,2016,7,111,63,48
105,Hoonah-Angoon Census Area,2016,8,129,57,72
105,Hoonah-Angoon Census Area,2016,9,112,59,53
105,Hoonah-Angoon Census Area,2016,10,134,76,58
105,Hoonah-Angoon Census Area,2016,11,157,79,78
105,Hoonah-Angoon Census Area,2016,12,223,111,112
105,Hoonah-Angoon Census Area,2016,13,229,125,104
105,Hoonah-Angoon Census Area,2016,14,196,112,84
105,Hoonah-Angoon Census Area,2016,15,90,55,35
105,Hoonah-Angoon Census Area,2016,16,76,49,27
105,Hoonah-Angoon Census Area,2016,17,33,25,8
105,Hoonah-Angoon Census Area,2016,18,15,6,9
110,Juneau City and Borough,2016,0,32747,16608,16139
110,Juneau City and Borough,2016,1,1973,1022,951
110,Juneau City and Borough,2016,2,2104,1047,1057
110,Juneau City and Borough,2016,3,1996,1002,994
110,Juneau City and Borough,2016,4,1974,1049,925
110,Juneau City and Borough,2016,5,1834,941,893
110,Juneau City and Borough,2016,6,2447,1213,1234
110,Juneau City and Borough,2016,7,2681,1366,1315
110,Juneau City and Borough,2016,8,2256,1170,1086
110,Juneau City and Borough,2016,9,2034,1024,1010
110,Juneau City and Borough,2016,10,2221,1147,1074
110,Juneau City and Borough,2016,11,2460,1267,1193
110,Juneau City and Borough,2016,12,2615,1331,1284
110,Juneau City and Borough,2016,13,2321,1178,1143
110,Juneau City and Borough,2016,14,1698,867,831
110,Juneau City and Borough,2016,15,968,483,485
110,Juneau City and Borough,2016,16,548,246,302
110,Juneau City and Borough,2016,17,326,145,181
110,Juneau City and Borough,2016,18,291,110,181
122,Kenai Peninsula Borough,2016,0,58110,30207,27903
122,Kenai Peninsula Borough,2016,1,3609,1793,1816
122,Kenai Peninsula Borough,2016,2,3747,1951,1796
122,Kenai Peninsula Borough,2016,3,3760,1896,1864
122,Kenai Peninsula Borough,2016,4,3522,1836,1686
122,Kenai Peninsula Borough,2016,5,2753,1552,1201
122,Kenai Peninsula Borough,2016,6,3485,1836,1649
122,Kenai Peninsula Borough,2016,7,3689,1938,1751
122,Kenai Peninsula Borough,2016,8,3604,1901,1703
122,Kenai Peninsula Borough,2016,9,3210,1678,1532
122,Kenai Peninsula Borough,2016,10,3577,1870,1707
122,Kenai Peninsula Borough,2016,11,4050,2082,1968
122,Kenai Peninsula Borough,2016,12,5007,2484,2523
122,Kenai Peninsula Borough,2016,13,4947,2585,2362
122,Kenai Peninsula Borough,2016,14,3763,2055,1708
122,Kenai Peninsula Borough,2016,15,2452,1325,1127
122,Kenai Peninsula Borough,2016,16,1396,744,652
122,Kenai Peninsula Borough,2016,17,836,401,435
122,Kenai Peninsula Borough,2016,18,703,280,423
130,Ketchikan Gateway Borough,2016,0,13781,6982,6799
130,Ketchikan Gateway Borough,2016,1,828,425,403
130,Ketchikan Gateway Borough,2016,2,893,456,437
130,Ketchikan Gateway Borough,2016,3,861,430,431
130,Ketchikan Gateway Borough,2016,4,902,476,426
130,Ketchikan Gateway Borough,2016,5,795,429,366
130,Ketchikan Gateway Borough,2016,6,905,459,446
130,Ketchikan Gateway Borough,2016,7,902,451,451
130,Ketchikan Gateway Borough,2016,8,871,441,430
130,Ketchikan Gateway Borough,2016,9,757,360,397
130,Ketchikan Gateway Borough,2016,10,934,446,488
130,Ketchikan Gateway Borough,2016,11,1011,539,472
130,Ketchikan Gateway Borough,2016,12,1098,562,536
130,Ketchikan Gateway Borough,2016,13,1056,517,539
130,Ketchikan Gateway Borough,2016,14,789,400,389
130,Ketchikan Gateway Borough,2016,15,522,257,265
130,Ketchikan Gateway Borough,2016,16,300,175,125
130,Ketchikan Gateway Borough,2016,17,162,75,87
130,Ketchikan Gateway Borough,2016,18,195,84,111
150,Kodiak Island Borough,2016,0,13549,7145,6404
150,Kodiak Island Borough,2016,1,1017,526,491
150,Kodiak Island Borough,2016,2,1025,524,501
150,Kodiak Island Borough,2016,3,917,471,446
150,Kodiak Island Borough,2016,4,936,525,411
150,Kodiak Island Borough,2016,5,870,460,410
150,Kodiak Island Borough,2016,6,1141,645,496
150,Kodiak Island Borough,2016,7,1039,566,473
150,Kodiak Island Borough,2016,8,919,477,442
150,Kodiak Island Borough,2016,9,740,374,366
150,Kodiak Island Borough,2016,10,821,408,413
150,Kodiak Island Borough,2016,11,941,492,449
150,Kodiak Island Borough,2016,12,1030,593,437
150,Kodiak Island Borough,2016,13,815,446,369
150,Kodiak Island Borough,2016,14,585,268,317
150,Kodiak Island Borough,2016,15,368,196,172
150,Kodiak Island Borough,2016,16,186,99,87
150,Kodiak Island Borough,2016,17,114,47,67
150,Kodiak Island Borough,2016,18,85,28,57
158,Kusilvak Census Area,2016,0,8210,4283,3927
158,Kusilvak Census Area,2016,1,868,443,425
158,Kusilvak Census Area,2016,2,953,518,435
158,Kusilvak Census Area,2016,3,896,450,446
158,Kusilvak Census Area,2016,4,834,431,403
158,Kusilvak Census Area,2016,5,739,387,352
158,Kusilvak Census Area,2016,6,759,416,343
158,Kusilvak Census Area,2016,7,505,257,248
158,Kusilvak Census Area,2016,8,372,206,166
158,Kusilvak Census Area,2016,9,348,169,179
158,Kusilvak Census Area,2016,10,385,190,195
158,Kusilvak Census Area,2016,11,392,212,180
158,Kusilvak Census Area,2016,12,411,230,181
158,Kusilvak Census Area,2016,13,265,137,128
158,Kusilvak Census Area,2016,14,212,122,90
158,Kusilvak Census Area,2016,15,115,53,62
158,Kusilvak Census Area,2016,16,68,34,34
158,Kusilvak Census Area,2016,17,51,18,33
158,Kusilvak Census Area,2016,18,37,10,27
164,Lake and Peninsula Borough,2016,0,1642,864,778
164,Lake and Peninsula Borough,2016,1,152,76,76
164,Lake and Peninsula Borough,2016,2,135,78,57
164,Lake and Peninsula Borough,2016,3,118,57,61
164,Lake and Peninsula Borough,2016,4,111,53,58
164,Lake and Peninsula Borough,2016,5,115,61,54
164,Lake and Peninsula Borough,2016,6,130,72,58
164,Lake and Peninsula Borough,2016,7,135,61,74
164,Lake and Peninsula Borough,2016,8,124,67,57
164,Lake and Peninsula Borough,2016,9,68,37,31
164,Lake and Peninsula Borough,2016,10,60,32,28
164,Lake and Peninsula Borough,2016,11,124,67,57
164,Lake and Peninsula Borough,2016,12,122,71,51
164,Lake and Peninsula Borough,2016,13,102,52,50
164,Lake and Peninsula Borough,2016,14,62,38,24
164,Lake and Peninsula Borough,2016,15,42,22,20
164,Lake and Peninsula Borough,2016,16,18,9,9
164,Lake and Peninsula Borough,2016,17,12,7,5
164,Lake and Peninsula Borough,2016,18,12,4,8
170,Matanuska-Susitna Borough,2016,0,102839,53027,49812
170,Matanuska-Susitna Borough,2016,1,7852,4059,3793
170,Matanuska-Susitna Borough,2016,2,8409,4337,4072
170,Matanuska-Susitna Borough,2016,3,8350,4376,3974
170,Matanuska-Susitna Borough,2016,4,7156,3822,3334
170,Matanuska-Susitna Borough,2016,5,5503,2854,2649
170,Matanuska-Susitna Borough,2016,6,6644,3402,3242
170,Matanuska-Susitna Borough,2016,7,7408,3740,3668
170,Matanuska-Susitna Borough,2016,8,7050,3634,3416
170,Matanuska-Susitna Borough,2016,9,6255,3249,3006
170,Matanuska-Susitna Borough,2016,10,6409,3270,3139
170,Matanuska-Susitna Borough,2016,11,6963,3619,3344
170,Matanuska-Susitna Borough,2016,12,7381,3831,3550
170,Matanuska-Susitna Borough,2016,13,6396,3213,3183
170,Matanuska-Susitna Borough,2016,14,4799,2503,2296
170,Matanuska-Susitna Borough,2016,15,2857,1451,1406
170,Matanuska-Susitna Borough,2016,16,1668,881,787
170,Matanuska-Susitna Borough,2016,17,935,444,491
170,Matanuska-Susitna Borough,2016,18,804,342,462
180,Nome Census Area,2016,0,10054,5397,4657
180,Nome Census Area,2016,1,939,476,463
180,Nome Census Area,2016,2,1028,554,474
180,Nome Census Area,2016,3,937,482,455
180,Nome Census Area,2016,4,804,443,361
180,Nome Census Area,2016,5,743,405,338
180,Nome Census Area,2016,6,862,454,408
180,Nome Census Area,2016,7,734,376,358
180,Nome Census Area,2016,8,599,324,275
180,Nome Census Area,2016,9,560,322,238
180,Nome Census Area,2016,10,475,257,218
180,Nome Census Area,2016,11,586,342,244
180,Nome Census Area,2016,12,567,290,277
180,Nome Census Area,2016,13,481,258,223
180,Nome Census Area,2016,14,331,209,122
180,Nome Census Area,2016,15,177,96,81
180,Nome Census Area,2016,16,109,56,53
180,Nome Census Area,2016,17,82,37,45
180,Nome Census Area,2016,18,40,16,24
185,North Slope Borough,2016,0,9814,6080,3734
185,North Slope Borough,2016,1,713,362,351
185,North Slope Borough,2016,2,739,386,353
185,North Slope Borough,2016,3,673,349,324
185,North Slope Borough,2016,4,554,305,249
185,North Slope Borough,2016,5,587,337,250
185,North Slope Borough,2016,6,880,529,351
185,North Slope Borough,2016,7,992,670,322
185,North Slope Borough,2016,8,721,499,222
185,North Slope Borough,2016,9,522,328,194
185,North Slope Borough,2016,10,527,355,172
185,North Slope Borough,2016,11,978,699,279
185,North Slope Borough,2016,12,843,587,256
185,North Slope Borough,2016,13,594,389,205
185,North Slope Borough,2016,14,257,173,84
185,North Slope Borough,2016,15,105,61,44
185,North Slope Borough,2016,16,49,21,28
185,North Slope Borough,2016,17,49,17,32
185,North Slope Borough,2016,18,31,13,18
188,Northwest Arctic Borough,2016,0,7947,4292,3655
188,Northwest Arctic Borough,2016,1,806,439,367
188,Northwest Arctic Borough,2016,2,851,433,418
188,Northwest Arctic Borough,2016,3,718,365,353
188,Northwest Arctic Borough,2016,4,655,349,306
188,Northwest Arctic Borough,2016,5,565,298,267
188,Northwest Arctic Borough,2016,6,742,402,340
188,Northwest Arctic Borough,2016,7,588,328,260
188,Northwest Arctic Borough,2016,8,451,247,204
188,Northwest Arctic Borough,2016,9,371,197,174
188,Northwest Arctic Borough,2016,10,389,229,160
188,Northwest Arctic Borough,2016,11,489,283,206
188,Northwest Arctic Borough,2016,12,435,259,176
188,Northwest Arctic Borough,2016,13,333,198,135
188,Northwest Arctic Borough,2016,14,210,110,100
188,Northwest Arctic Borough,2016,15,136,74,62
188,Northwest Arctic Borough,2016,16,82,44,38
188,Northwest Arctic Borough,2016,17,71,27,44
188,Northwest Arctic Borough,2016,18,55,10,45
195,Petersburg Borough,2016,0,3179,1638,1541
195,Petersburg Borough,2016,1,217,101,116
195,Petersburg Borough,2016,2,205,106,99
195,Petersburg Borough,2016,3,194,99,95
195,Petersburg Borough,2016,4,166,95,71
195,Petersburg Borough,2016,5,120,58,62
195,Petersburg Borough,2016,6,195,90,105
195,Petersburg Borough,2016,7,194,95,99
195,Petersburg Borough,2016,8,210,101,109
195,Petersburg Borough,2016,9,156,72,84
195,Petersburg Borough,2016,10,230,131,99
195,Petersburg Borough,2016,11,205,112,93
195,Petersburg Borough,2016,12,260,120,140
195,Petersburg Borough,2016,13,283,157,126
195,Petersburg Borough,2016,14,246,145,101
195,Petersburg Borough,2016,15,132,73,59
195,Petersburg Borough,2016,16,77,40,37
195,Petersburg Borough,2016,17,35,20,15
195,Petersburg Borough,2016,18,54,23,31
198,Prince of Wales-Hyder Census Area,2016,0,6445,3519,2926
198,Prince of Wales-Hyder Census Area,2016,1,422,232,190
198,Prince of Wales-Hyder Census Area,2016,2,494,219,275
198,Prince of Wales-Hyder Census Area,2016,3,432,241,191
198,Prince of Wales-Hyder Census Area,2016,4,369,211,158
198,Prince of Wales-Hyder Census Area,2016,5,297,169,128
198,Prince of Wales-Hyder Census Area,2016,6,374,195,179
198,Prince of Wales-Hyder Census Area,2016,7,405,205,200
198,Prince of Wales-Hyder Census Area,2016,8,356,198,158
198,Prince of Wales-Hyder Census Area,2016,9,355,190,165
198,Prince of Wales-Hyder Census Area,2016,10,421,224,197
198,Prince of Wales-Hyder Census Area,2016,11,514,295,219
198,Prince of Wales-Hyder Census Area,2016,12,559,304,255
198,Prince of Wales-Hyder Census Area,2016,13,539,295,244
198,Prince of Wales-Hyder Census Area,2016,14,411,253,158
198,Prince of Wales-Hyder Census Area,2016,15,224,129,95
198,Prince of Wales-Hyder Census Area,2016,16,161,100,61
198,Prince of Wales-Hyder Census Area,2016,17,73,38,35
198,Prince of Wales-Hyder Census Area,2016,18,39,21,18
220,Sitka City and Borough,2016,0,8903,4469,4434
220,Sitka City and Borough,2016,1,493,241,252
220,Sitka City and Borough,2016,2,614,342,272
220,Sitka City and Borough,2016,3,547,271,276
220,Sitka City and Borough,2016,4,527,288,239
220,Sitka City and Borough,2016,5,488,241,247
220,Sitka City and Borough,2016,6,604,288,316
220,Sitka City and Borough,2016,7,617,275,342
220,Sitka City and Borough,2016,8,697,391,306
220,Sitka City and Borough,2016,9,540,279,261
220,Sitka City and Borough,2016,10,542,273,269
220,Sitka City and Borough,2016,11,590,303,287
220,Sitka City and Borough,2016,12,715,354,361
220,Sitka City and Borough,2016,13,644,325,319
220,Sitka City and Borough,2016,14,475,258,217
220,Sitka City and Borough,2016,15,271,129,142
220,Sitka City and Borough,2016,16,257,110,147
220,Sitka City and Borough,2016,17,136,49,87
220,Sitka City and Borough,2016,18,146,52,94
230,"Skagway Borough, Municipality",2016,0,1072,550,522
230,"Skagway Borough, Municipality",2016,1,56,27,29
230,"Skagway Borough, Municipality",2016,2,58,38,20
230,"Skagway Borough, Municipality",2016,3,38,15,23
230,"Skagway Borough, Municipality",2016,4,31,16,15
230,"Skagway Borough, Municipality",2016,5,49,25,24
230,"Skagway Borough, Municipality",2016,6,66,18,48
230,"Skagway Borough, Municipality",2016,7,116,67,49
230,"Skagway Borough, Municipality",2016,8,83,44,39
230,"Skagway Borough, Municipality",2016,9,91,47,44
230,"Skagway Borough, Municipality",2016,10,100,49,51
230,"Skagway Borough, Municipality",2016,11,75,45,30
230,"Skagway Borough, Municipality",2016,12,82,47,35
230,"Skagway Borough, Municipality",2016,13,76,47,29
230,"Skagway Borough, Municipality",2016,14,80,37,43
230,"Skagway Borough, Municipality",2016,15,33,17,16
230,"Skagway Borough, Municipality",2016,16,16,5,11
230,"Skagway Borough, Municipality",2016,17,16,5,11
230,"Skagway Borough, Municipality",2016,18,6,1,5
240,Southeast Fairbanks Census Area,2016,0,6927,3823,3104
240,Southeast Fairbanks Census Area,2016,1,434,215,219
240,Southeast Fairbanks Census Area,2016,2,545,293,252
240,Southeast Fairbanks Census Area,2016,3,495,269,226
240,Southeast Fairbanks Census Area,2016,4,427,224,203
240,Southeast Fairbanks Census Area,2016,5,330,165,165
240,Southeast Fairbanks Census Area,2016,6,408,227,181
240,Southeast Fairbanks Census Area,2016,7,543,298,245
240,Southeast Fairbanks Census Area,2016,8,450,252,198
240,Southeast Fairbanks Census Area,2016,9,387,227,160
240,Southeast Fairbanks Census Area,2016,10,444,251,193
240,Southeast Fairbanks Census Area,2016,11,482,275,207
240,Southeast Fairbanks Census Area,2016,12,568,317,251
240,Southeast Fairbanks Census Area,2016,13,489,285,204
240,Southeast Fairbanks Census Area,2016,14,390,246,144
240,Southeast Fairbanks Census Area,2016,15,218,122,96
240,Southeast Fairbanks Census Area,2016,16,152,77,75
240,Southeast Fairbanks Census Area,2016,17,86,53,33
240,Southeast Fairbanks Census Area,2016,18,79,27,52
275,Wrangell City and Borough,2016,0,2459,1253,1206
275,Wrangell City and Borough,2016,1,138,76,62
275,Wrangell City and Borough,2016,2,158,62,96
275,Wrangell City and Borough,2016,3,130,71,59
275,Wrangell City and Borough,2016,4,129,77,52
275,Wrangell City and Borough,2016,5,101,53,48
275,Wrangell City and Borough,2016,6,157,59,98
275,Wrangell City and Borough,2016,7,133,76,57
275,Wrangell City and Borough,2016,8,96,51,45
275,Wrangell City and Borough,2016,9,104,47,57
275,Wrangell City and Borough,2016,10,139,70,69
275,Wrangell City and Borough,2016,11,181,91,90
275,Wrangell City and Borough,2016,12,263,134,129
275,Wrangell City and Borough,2016,13,266,125,141
275,Wrangell City and Borough,2016,14,180,111,69
275,Wrangell City and Borough,2016,15,113,56,57
275,Wrangell City and Borough,2016,16,91,60,31
275,Wrangell City and Borough,2016,17,50,22,28
275,Wrangell City and Borough,2016,18,30,12,18
282,Yakutat City and Borough,2016,0,591,319,272
282,Yakutat City and Borough,2016,1,37,21,16
282,Yakutat City and Borough,2016,2,30,11,19
282,Yakutat City and Borough,2016,3,36,17,19
282,Yakutat City and Borough,2016,4,32,15,17
282,Yakutat City and Borough,2016,5,32,17,15
282,Yakutat City and Borough,2016,6,27,13,14
282,Yakutat City and Borough,2016,7,37,24,13
282,Yakutat City and Borough,2016,8,44,26,18
282,Yakutat City and Borough,2016,9,25,18,7
282,Yakutat City and Borough,2016,10,60,30,30
282,Yakutat City and Borough,2016,11,43,28,15
282,Yakutat City and Borough,2016,12,43,24,19
282,Yakutat City and Borough,2016,13,55,34,21
282,Yakutat City and Borough,2016,14,40,19,21
282,Yakutat City and Borough,2016,15,22,14,8
282,Yakutat City and Borough,2016,16,14,8,6
282,Yakutat City and Borough,2016,17,9,0,9
282,Yakutat City and Borough,2016,18,5,0,5
290,Yukon-Koyukuk Census Area,2016,0,5454,2905,2549
290,Yukon-Koyukuk Census Area,2016,1,414,211,203
290,Yukon-Koyukuk Census Area,2016,2,483,259,224
290,Yukon-Koyukuk Census Area,2016,3,378,192,186
290,Yukon-Koyukuk Census Area,2016,4,392,209,183
290,Yukon-Koyukuk Census Area,2016,5,266,131,135
290,Yukon-Koyukuk Census Area,2016,6,378,202,176
290,Yukon-Koyukuk Census Area,2016,7,350,196,154
290,Yukon-Koyukuk Census Area,2016,8,322,175,147
290,Yukon-Koyukuk Census Area,2016,9,276,147,129
290,Yukon-Koyukuk Census Area,2016,10,246,115,131
290,Yukon-Koyukuk Census Area,2016,11,378,202,176
290,Yukon-Koyukuk Census Area,2016,12,426,233,193
290,Yukon-Koyukuk Census Area,2016,13,414,239,175
290,Yukon-Koyukuk Census Area,2016,14,303,160,143
290,Yukon-Koyukuk Census Area,2016,15,192,111,81
290,Yukon-Koyukuk Census Area,2016,16,99,57,42
290,Yukon-Koyukuk Census Area,2016,17,75,38,37
290,Yukon-Koyukuk Census Area,2016,18,62,28,34
000,Alaska,2017,0,738920,380411,358509
000,Alaska,2017,1,52579,26730,25849
000,Alaska,2017,2,54272,27926,26346
000,Alaska,2017,3,52185,26763,25422
000,Alaska,2017,4,47843,25151,22692
000,Alaska,2017,5,48833,26368,22465
000,Alaska,2017,6,57449,29710,27739
000,Alaska,2017,7,57581,29722,27859
000,Alaska,2017,8,51015,26329,24686
000,Alaska,2017,9,42706,21860,20846
000,Alaska,2017,10,44169,22791,21378
000,Alaska,2017,11,47770,24666,23104
000,Alaska,2017,12,52261,26876,25385
000,Alaska,2017,13,47337,24218,23119
000,Alaska,2017,14,34438,18009,16429
000,Alaska,2017,15,21908,11232,10676
000,Alaska,2017,16,12601,6194,6407
000,Alaska,2017,17,7563,3439,4124
000,Alaska,2017,18,6410,2427,3983
013,Aleutians East Borough,2017,0,2984,1993,991
013,Aleutians East Borough,2017,1,77,37,40
013,Aleutians East Borough,2017,2,87,37,50
013,Aleutians East Borough,2017,3,67,32,35
013,Aleutians East Borough,2017,4,92,48,44
013,Aleutians East Borough,2017,5,217,168,49
013,Aleutians East Borough,2017,6,184,129,55
013,Aleutians East Borough,2017,7,279,210,69
013,Aleutians East Borough,2017,8,293,182,111
013,Aleutians East Borough,2017,9,293,207,86
013,Aleutians East Borough,2017,10,317,266,51
013,Aleutians East Borough,2017,11,325,202,123
013,Aleutians East Borough,2017,12,360,226,134
013,Aleutians East Borough,2017,13,193,131,62
013,Aleutians East Borough,2017,14,83,47,36
013,Aleutians East Borough,2017,15,75,45,30
013,Aleutians East Borough,2017,16,22,15,7
013,Aleutians East Borough,2017,17,11,6,5
013,Aleutians East Borough,2017,18,9,5,4
016,Aleutians West Census Area,2017,0,5353,3507,1846
016,Aleutians West Census Area,2017,1,198,96,102
016,Aleutians West Census Area,2017,2,216,102,114
016,Aleutians West Census Area,2017,3,188,114,74
016,Aleutians West Census Area,2017,4,230,139,91
016,Aleutians West Census Area,2017,5,270,179,91
016,Aleutians West Census Area,2017,6,471,339,132
016,Aleutians West Census Area,2017,7,507,362,145
016,Aleutians West Census Area,2017,8,458,290,168
016,Aleutians West Census Area,2017,9,438,328,110
016,Aleutians West Census Area,2017,10,443,272,171
016,Aleutians West Census Area,2017,11,601,377,224
016,Aleutians West Census Area,2017,12,522,362,160
016,Aleutians West Census Area,2017,13,379,268,111
016,Aleutians West Census Area,2017,14,303,201,102
016,Aleutians West Census Area,2017,15,82,54,28
016,Aleutians West Census Area,2017,16,20,10,10
016,Aleutians West Census Area,2017,17,14,7,7
016,Aleutians West Census Area,2017,18,13,7,6
020,Anchorage Municipality,2017,0,298176,149826,148350
020,Anchorage Municipality,2017,1,21037,10705,10332
020,Anchorage Municipality,2017,2,21093,10776,10317
020,Anchorage Municipality,2017,3,20182,10356,9826
020,Anchorage Municipality,2017,4,19056,9795,9261
020,Anchorage Municipality,2017,5,22041,11665,10376
020,Anchorage Municipality,2017,6,25203,12847,12356
020,Anchorage Municipality,2017,7,24669,12456,12213
020,Anchorage Municipality,2017,8,21293,10605,10688
020,Anchorage Municipality,2017,9,17385,8655,8730
020,Anchorage Municipality,2017,10,18130,9049,9081
020,Anchorage Municipality,2017,11,18934,9375,9559
020,Anchorage Municipality,2017,12,19933,9915,10018
020,Anchorage Municipality,2017,13,17850,8870,8980
020,Anchorage Municipality,2017,14,12751,6334,6417
020,Anchorage Municipality,2017,15,8058,3976,4082
020,Anchorage Municipality,2017,16,4772,2148,2624
020,Anchorage Municipality,2017,17,3061,1316,1745
020,Anchorage Municipality,2017,18,2728,983,1745
050,Bethel Census Area,2017,0,18173,9441,8732
050,Bethel Census Area,2017,1,1824,972,852
050,Bethel Census Area,2017,2,1871,961,910
050,Bethel Census Area,2017,3,1737,860,877
050,Bethel Census Area,2017,4,1630,888,742
050,Bethel Census Area,2017,5,1374,685,689
050,Bethel Census Area,2017,6,1556,766,790
050,Bethel Census Area,2017,7,1312,690,622
050,Bethel Census Area,2017,8,1009,511,498
050,Bethel Census Area,2017,9,837,419,418
050,Bethel Census Area,2017,10,870,473,397
050,Bethel Census Area,2017,11,1045,602,443
050,Bethel Census Area,2017,12,974,525,449
050,Bethel Census Area,2017,13,830,436,394
050,Bethel Census Area,2017,14,548,300,248
050,Bethel Census Area,2017,15,321,166,155
050,Bethel Census Area,2017,16,215,100,115
050,Bethel Census Area,2017,17,145,60,85
050,Bethel Census Area,2017,18,75,27,48
060,Bristol Bay Borough,2017,0,894,474,420
060,Bristol Bay Borough,2017,1,52,21,31
060,Bristol Bay Borough,2017,2,42,25,17
060,Bristol Bay Borough,2017,3,44,21,23
060,Bristol Bay Borough,2017,4,67,32,35
060,Bristol Bay Borough,2017,5,44,25,19
060,Bristol Bay Borough,2017,6,61,28,33
060,Bristol Bay Borough,2017,7,53,31,22
060,Bristol Bay Borough,2017,8,32,16,16
060,Bristol Bay Borough,2017,9,56,33,23
060,Bristol Bay Borough,2017,10,65,32,33
060,Bristol Bay Borough,2017,11,65,38,27
060,Bristol Bay Borough,2017,12,107,61,46
060,Bristol Bay Borough,2017,13,95,59,36
060,Bristol Bay Borough,2017,14,49,19,30
060,Bristol Bay Borough,2017,15,20,14,6
060,Bristol Bay Borough,2017,16,27,12,15
060,Bristol Bay Borough,2017,17,7,4,3
060,Bristol Bay Borough,2017,18,8,3,5
063,Chugach Census Area,2017,0,6719,3503,3216
063,Chugach Census Area,2017,1,479,222,257
063,Chugach Census Area,2017,2,449,232,217
063,Chugach Census Area,2017,3,406,195,211
063,Chugach Census Area,2017,4,412,225,187
063,Chugach Census Area,2017,5,330,178,152
063,Chugach Census Area,2017,6,538,287,251
063,Chugach Census Area,2017,7,537,290,247
063,Chugach Census Area,2017,8,467,240,227
063,Chugach Census Area,2017,9,380,194,186
063,Chugach Census Area,2017,10,447,246,201
063,Chugach Census Area,2017,11,464,260,204
063,Chugach Census Area,2017,12,603,322,281
063,Chugach Census Area,2017,13,511,260,251
063,Chugach Census Area,2017,14,317,180,137
063,Chugach Census Area,2017,15,190,89,101
063,Chugach Census Area,2017,16,97,45,52
063,Chugach Census Area,2017,17,51,28,23
063,Chugach Census Area,2017,18,41,10,31
066,Copper River Census Area,2017,0,2689,1414,1275
066,Copper River Census Area,2017,1,177,73,104
066,Copper River Census Area,2017,2,188,103,85
066,Copper River Census Area,2017,3,189,83,106
066,Copper River Census Area,2017,4,169,86,83
066,Copper River Census Area,2017,5,104,56,48
066,Copper River Census Area,2017,6,118,60,58
066,Copper River Census Area,2017,7,158,75,83
066,Copper River Census Area,2017,8,166,88,78
066,Copper River Census Area,2017,9,118,56,62
066,Copper River Census Area,2017,10,165,95,70
066,Copper River Census Area,2017,11,203,106,97
066,Copper River Census Area,2017,12,263,139,124
066,Copper River Census Area,2017,13,274,162,112
066,Copper River Census Area,2017,14,172,105,67
066,Copper River Census Area,2017,15,99,59,40
066,Copper River Census Area,2017,16,80,45,35
066,Copper River Census Area,2017,17,24,17,7
066,Copper River Census Area,2017,18,22,6,16
068,Denali Borough,2017,0,1836,1008,828
068,Denali Borough,2017,1,107,56,51
068,Denali Borough,2017,2,113,63,50
068,Denali Borough,2017,3,104,60,44
068,Denali Borough,2017,4,98,47,51
068,Denali Borough,2017,5,43,20,23
068,Denali Borough,2017,6,117,56,61
068,Denali Borough,2017,7,134,72,62
068,Denali Borough,2017,8,167,83,84
068,Denali Borough,2017,9,96,43,53
068,Denali Borough,2017,10,165,87,78
068,Denali Borough,2017,11,138,77,61
068,Denali Borough,2017,12,170,104,66
068,Denali Borough,2017,13,171,113,58
068,Denali Borough,2017,14,101,64,37
068,Denali Borough,2017,15,43,23,20
068,Denali Borough,2017,16,33,21,12
068,Denali Borough,2017,17,32,17,15
068,Denali Borough,2017,18,4,2,2
070,Dillingham Census Area,2017,0,4933,2549,2384
070,Dillingham Census Area,2017,1,465,198,267
070,Dillingham Census Area,2017,2,479,251,228
070,Dillingham Census Area,2017,3,386,198,188
070,Dillingham Census Area,2017,4,361,196,165
070,Dillingham Census Area,2017,5,359,183,176
070,Dillingham Census Area,2017,6,443,248,195
070,Dillingham Census Area,2017,7,314,149,165
070,Dillingham Census Area,2017,8,268,136,132
070,Dillingham Census Area,2017,9,215,110,105
070,Dillingham Census Area,2017,10,211,108,103
070,Dillingham Census Area,2017,11,324,173,151
070,Dillingham Census Area,2017,12,359,198,161
070,Dillingham Census Area,2017,13,291,163,128
070,Dillingham Census Area,2017,14,179,88,91
070,Dillingham Census Area,2017,15,118,58,60
070,Dillingham Census Area,2017,16,79,52,27
070,Dillingham Census Area,2017,17,52,25,27
070,Dillingham Census Area,2017,18,30,15,15
090,Fairbanks North Star Borough,2017,0,97975,51146,46829
090,Fairbanks North Star Borough,2017,1,7108,3625,3483
090,Fairbanks North Star Borough,2017,2,7061,3697,3364
090,Fairbanks North Star Borough,2017,3,6543,3338,3205
090,Fairbanks North Star Borough,2017,4,6086,3259,2827
090,Fairbanks North Star Borough,2017,5,8268,4761,3507
090,Fairbanks North Star Borough,2017,6,8150,4291,3859
090,Fairbanks North Star Borough,2017,7,8190,4318,3872
090,Fairbanks North Star Borough,2017,8,6783,3564,3219
090,Fairbanks North Star Borough,2017,9,5723,2936,2787
090,Fairbanks North Star Borough,2017,10,5440,2798,2642
090,Fairbanks North Star Borough,2017,11,5899,2985,2914
090,Fairbanks North Star Borough,2017,12,6542,3305,3237
090,Fairbanks North Star Borough,2017,13,5984,3019,2965
090,Fairbanks North Star Borough,2017,14,4361,2332,2029
090,Fairbanks North Star Borough,2017,15,2873,1508,1365
090,Fairbanks North Star Borough,2017,16,1425,743,682
090,Fairbanks North Star Borough,2017,17,824,387,437
090,Fairbanks North Star Borough,2017,18,715,280,435
100,Haines Borough,2017,0,2462,1214,1248
100,Haines Borough,2017,1,91,35,56
100,Haines Borough,2017,2,160,83,77
100,Haines Borough,2017,3,122,63,59
100,Haines Borough,2017,4,110,53,57
100,Haines Borough,2017,5,63,38,25
100,Haines Borough,2017,6,111,56,55
100,Haines Borough,2017,7,154,74,80
100,Haines Borough,2017,8,149,72,77
100,Haines Borough,2017,9,142,72,70
100,Haines Borough,2017,10,148,77,71
100,Haines Borough,2017,11,186,98,88
100,Haines Borough,2017,12,245,124,121
100,Haines Borough,2017,13,264,129,135
100,Haines Borough,2017,14,211,106,105
100,Haines Borough,2017,15,141,68,73
100,Haines Borough,2017,16,71,32,39
100,Haines Borough,2017,17,41,16,25
100,Haines Borough,2017,18,53,18,35
105,Hoonah-Angoon Census Area,2017,0,2127,1113,1014
105,Hoonah-Angoon Census Area,2017,1,121,56,65
105,Hoonah-Angoon Census Area,2017,2,136,80,56
105,Hoonah-Angoon Census Area,2017,3,120,52,68
105,Hoonah-Angoon Census Area,2017,4,100,38,62
105,Hoonah-Angoon Census Area,2017,5,70,35,35
105,Hoonah-Angoon Census Area,2017,6,110,63,47
105,Hoonah-Angoon Census Area,2017,7,104,56,48
105,Hoonah-Angoon Census Area,2017,8,129,59,70
105,Hoonah-Angoon Census Area,2017,9,105,54,51
105,Hoonah-Angoon Census Area,2017,10,130,68,62
105,Hoonah-Angoon Census Area,2017,11,149,76,73
105,Hoonah-Angoon Census Area,2017,12,203,105,98
105,Hoonah-Angoon Census Area,2017,13,223,117,106
105,Hoonah-Angoon Census Area,2017,14,203,109,94
105,Hoonah-Angoon Census Area,2017,15,95,61,34
105,Hoonah-Angoon Census Area,2017,16,72,46,26
105,Hoonah-Angoon Census Area,2017,17,41,30,11
105,Hoonah-Angoon Census Area,2017,18,16,8,8
110,Juneau City and Borough,2017,0,32347,16370,15977
110,Juneau City and Borough,2017,1,1928,989,939
110,Juneau City and Borough,2017,2,2006,1007,999
110,Juneau City and Borough,2017,3,2028,1023,1005
110,Juneau City and Borough,2017,4,1938,1033,905
110,Juneau City and Borough,2017,5,1766,900,866
110,Juneau City and Borough,2017,6,2422,1223,1199
110,Juneau City and Borough,2017,7,2623,1323,1300
110,Juneau City and Borough,2017,8,2312,1186,1126
110,Juneau City and Borough,2017,9,1980,990,990
110,Juneau City and Borough,2017,10,2149,1096,1053
110,Juneau City and Borough,2017,11,2340,1196,1144
110,Juneau City and Borough,2017,12,2526,1303,1223
110,Juneau City and Borough,2017,13,2302,1152,1150
110,Juneau City and Borough,2017,14,1755,893,862
110,Juneau City and Borough,2017,15,1059,558,501
110,Juneau City and Borough,2017,16,569,241,328
110,Juneau City and Borough,2017,17,359,154,205
110,Juneau City and Borough,2017,18,285,103,182
122,Kenai Peninsula Borough,2017,0,58193,30170,28023
122,Kenai Peninsula Borough,2017,1,3576,1792,1784
122,Kenai Peninsula Borough,2017,2,3742,1946,1796
122,Kenai Peninsula Borough,2017,3,3821,1947,1874
122,Kenai Peninsula Borough,2017,4,3503,1816,1687
122,Kenai Peninsula Borough,2017,5,2623,1476,1147
122,Kenai Peninsula Borough,2017,6,3543,1856,1687
122,Kenai Peninsula Borough,2017,7,3641,1904,1737
122,Kenai Peninsula Borough,2017,8,3731,1954,1777
122,Kenai Peninsula Borough,2017,9,3229,1696,1533
122,Kenai Peninsula Borough,2017,10,3467,1818,1649
122,Kenai Peninsula Borough,2017,11,3901,1991,1910
122,Kenai Peninsula Borough,2017,12,4848,2399,2449
122,Kenai Peninsula Borough,2017,13,4955,2541,2414
122,Kenai Peninsula Borough,2017,14,3824,2087,1737
122,Kenai Peninsula Borough,2017,15,2685,1439,1246
122,Kenai Peninsula Borough,2017,16,1551,805,746
122,Kenai Peninsula Borough,2017,17,847,417,430
122,Kenai Peninsula Borough,2017,18,706,286,420
130,Ketchikan Gateway Borough,2017,0,13813,7012,6801
130,Ketchikan Gateway Borough,2017,1,811,426,385
130,Ketchikan Gateway Borough,2017,2,890,449,441
130,Ketchikan Gateway Borough,2017,3,883,445,438
130,Ketchikan Gateway Borough,2017,4,883,471,412
130,Ketchikan Gateway Borough,2017,5,775,420,355
130,Ketchikan Gateway Borough,2017,6,949,501,448
130,Ketchikan Gateway Borough,2017,7,916,455,461
130,Ketchikan Gateway Borough,2017,8,920,454,466
130,Ketchikan Gateway Borough,2017,9,751,367,384
130,Ketchikan Gateway Borough,2017,10,903,440,463
130,Ketchikan Gateway Borough,2017,11,933,471,462
130,Ketchikan Gateway Borough,2017,12,1101,578,523
130,Ketchikan Gateway Borough,2017,13,1047,505,542
130,Ketchikan Gateway Borough,2017,14,786,409,377
130,Ketchikan Gateway Borough,2017,15,570,280,290
130,Ketchikan Gateway Borough,2017,16,312,171,141
130,Ketchikan Gateway Borough,2017,17,196,94,102
130,Ketchikan Gateway Borough,2017,18,187,76,111
150,Kodiak Island Borough,2017,0,13281,6968,6313
150,Kodiak Island Borough,2017,1,1041,539,502
150,Kodiak Island Borough,2017,2,959,480,479
150,Kodiak Island Borough,2017,3,927,494,433
150,Kodiak Island Borough,2017,4,896,497,399
150,Kodiak Island Borough,2017,5,833,449,384
150,Kodiak Island Borough,2017,6,1064,588,476
150,Kodiak Island Borough,2017,7,1040,554,486
150,Kodiak Island Borough,2017,8,889,466,423
150,Kodiak Island Borough,2017,9,743,375,368
150,Kodiak Island Borough,2017,10,760,374,386
150,Kodiak Island Borough,2017,11,879,444,435
150,Kodiak Island Borough,2017,12,979,570,409
150,Kodiak Island Borough,2017,13,865,472,393
150,Kodiak Island Borough,2017,14,574,273,301
150,Kodiak Island Borough,2017,15,410,199,211
150,Kodiak Island Borough,2017,16,214,119,95
150,Kodiak Island Borough,2017,17,110,46,64
150,Kodiak Island Borough,2017,18,98,29,69
158,Kusilvak Census Area,2017,0,8230,4293,3937
158,Kusilvak Census Area,2017,1,867,437,430
158,Kusilvak Census Area,2017,2,945,515,430
158,Kusilvak Census Area,2017,3,948,483,465
158,Kusilvak Census Area,2017,4,783,395,388
158,Kusilvak Census Area,2017,5,738,403,335
158,Kusilvak Census Area,2017,6,770,392,378
158,Kusilvak Census Area,2017,7,541,287,254
158,Kusilvak Census Area,2017,8,385,223,162
158,Kusilvak Census Area,2017,9,344,171,173
158,Kusilvak Census Area,2017,10,355,175,180
158,Kusilvak Census Area,2017,11,386,201,185
158,Kusilvak Census Area,2017,12,403,220,183
158,Kusilvak Census Area,2017,13,289,154,135
158,Kusilvak Census Area,2017,14,194,111,83
158,Kusilvak Census Area,2017,15,117,57,60
158,Kusilvak Census Area,2017,16,74,41,33
158,Kusilvak Census Area,2017,17,55,18,37
158,Kusilvak Census Area,2017,18,36,10,26
164,Lake and Peninsula Borough,2017,0,1725,906,819
164,Lake and Peninsula Borough,2017,1,174,84,90
164,Lake and Peninsula Borough,2017,2,148,84,64
164,Lake and Peninsula Borough,2017,3,129,60,69
164,Lake and Peninsula Borough,2017,4,110,52,58
164,Lake and Peninsula Borough,2017,5,106,59,47
164,Lake and Peninsula Borough,2017,6,139,72,67
164,Lake and Peninsula Borough,2017,7,149,77,72
164,Lake and Peninsula Borough,2017,8,126,64,62
164,Lake and Peninsula Borough,2017,9,85,49,36
164,Lake and Peninsula Borough,2017,10,58,33,25
164,Lake and Peninsula Borough,2017,11,111,59,52
164,Lake and Peninsula Borough,2017,12,137,84,53
164,Lake and Peninsula Borough,2017,13,97,46,51
164,Lake and Peninsula Borough,2017,14,74,43,31
164,Lake and Peninsula Borough,2017,15,41,23,18
164,Lake and Peninsula Borough,2017,16,21,10,11
164,Lake and Peninsula Borough,2017,17,7,4,3
164,Lake and Peninsula Borough,2017,18,13,3,10
170,Matanuska-Susitna Borough,2017,0,104607,53690,50917
170,Matanuska-Susitna Borough,2017,1,7951,4103,3848
170,Matanuska-Susitna Borough,2017,2,8492,4348,4144
170,Matanuska-Susitna Borough,2017,3,8703,4517,4186
170,Matanuska-Susitna Borough,2017,4,7251,3885,3366
170,Matanuska-Susitna Borough,2017,5,5408,2835,2573
170,Matanuska-Susitna Borough,2017,6,6740,3424,3316
170,Matanuska-Susitna Borough,2017,7,7537,3728,3809
170,Matanuska-Susitna Borough,2017,8,7316,3780,3536
170,Matanuska-Susitna Borough,2017,9,6381,3249,3132
170,Matanuska-Susitna Borough,2017,10,6518,3392,3126
170,Matanuska-Susitna Borough,2017,11,6608,3381,3227
170,Matanuska-Susitna Borough,2017,12,7421,3799,3622
170,Matanuska-Susitna Borough,2017,13,6492,3276,3216
170,Matanuska-Susitna Borough,2017,14,4986,2578,2408
170,Matanuska-Susitna Borough,2017,15,3134,1596,1538
170,Matanuska-Susitna Borough,2017,16,1834,970,864
170,Matanuska-Susitna Borough,2017,17,994,471,523
170,Matanuska-Susitna Borough,2017,18,841,358,483
180,Nome Census Area,2017,0,10009,5288,4721
180,Nome Census Area,2017,1,899,433,466
180,Nome Census Area,2017,2,1056,568,488
180,Nome Census Area,2017,3,949,491,458
180,Nome Census Area,2017,4,778,417,361
180,Nome Census Area,2017,5,701,390,311
180,Nome Census Area,2017,6,892,439,453
180,Nome Census Area,2017,7,748,385,363
180,Nome Census Area,2017,8,626,343,283
180,Nome Census Area,2017,9,541,303,238
180,Nome Census Area,2017,10,466,244,222
180,Nome Census Area,2017,11,569,327,242
180,Nome Census Area,2017,12,554,285,269
180,Nome Census Area,2017,13,493,256,237
180,Nome Census Area,2017,14,340,207,133
180,Nome Census Area,2017,15,175,98,77
180,Nome Census Area,2017,16,108,53,55
180,Nome Census Area,2017,17,80,37,43
180,Nome Census Area,2017,18,34,12,22
185,North Slope Borough,2017,0,9876,6096,3780
185,North Slope Borough,2017,1,698,353,345
185,North Slope Borough,2017,2,765,394,371
185,North Slope Borough,2017,3,693,356,337
185,North Slope Borough,2017,4,550,298,252
185,North Slope Borough,2017,5,586,343,243
185,North Slope Borough,2017,6,958,583,375
185,North Slope Borough,2017,7,981,653,328
185,North Slope Borough,2017,8,783,539,244
185,North Slope Borough,2017,9,500,314,186
185,North Slope Borough,2017,10,513,350,163
185,North Slope Borough,2017,11,928,680,248
185,North Slope Borough,2017,12,825,545,280
185,North Slope Borough,2017,13,606,406,200
185,North Slope Borough,2017,14,258,168,90
185,North Slope Borough,2017,15,111,66,45
185,North Slope Borough,2017,16,42,20,22
185,North Slope Borough,2017,17,50,15,35
185,North Slope Borough,2017,18,29,13,16
188,Northwest Arctic Borough,2017,0,7865,4223,3642
188,Northwest Arctic Borough,2017,1,759,401,358
188,Northwest Arctic Borough,2017,2,841,434,407
188,Northwest Arctic Borough,2017,3,740,378,362
188,Northwest Arctic Borough,2017,4,643,343,300
188,Northwest Arctic Borough,2017,5,537,272,265
188,Northwest Arctic Borough,2017,6,730,389,341
188,Northwest Arctic Borough,2017,7,615,351,264
188,Northwest Arctic Borough,2017,8,464,243,221
188,Northwest Arctic Borough,2017,9,359,189,170
188,Northwest Arctic Borough,2017,10,368,217,151
188,Northwest Arctic Borough,2017,11,478,285,193
188,Northwest Arctic Borough,2017,12,426,245,181
188,Northwest Arctic Borough,2017,13,346,206,140
188,Northwest Arctic Borough,2017,14,220,123,97
188,Northwest Arctic Borough,2017,15,147,73,74
188,Northwest Arctic Borough,2017,16,73,38,35
188,Northwest Arctic Borough,2017,17,65,26,39
188,Northwest Arctic Borough,2017,18,54,10,44
195,Petersburg Borough,2017,0,3141,1598,1543
195,Petersburg Borough,2017,1,191,90,101
195,Petersburg Borough,2017,2,221,106,115
195,Petersburg Borough,2017,3,199,98,101
195,Petersburg Borough,2017,4,167,90,77
195,Petersburg Borough,2017,5,110,57,53
195,Petersburg Borough,2017,6,180,83,97
195,Petersburg Borough,2017,7,197,100,97
195,Petersburg Borough,2017,8,209,101,108
195,Petersburg Borough,2017,9,167,82,85
195,Petersburg Borough,2017,10,224,117,107
195,Petersburg Borough,2017,11,181,101,80
195,Petersburg Borough,2017,12,235,108,127
195,Petersburg Borough,2017,13,289,155,134
195,Petersburg Borough,2017,14,238,143,95
195,Petersburg Borough,2017,15,153,72,81
195,Petersburg Borough,2017,16,95,54,41
195,Petersburg Borough,2017,17,31,18,13
195,Petersburg Borough,2017,18,54,23,31
198,Prince of Wales-Hyder Census Area,2017,0,6383,3489,2894
198,Prince of Wales-Hyder Census Area,2017,1,408,236,172
198,Prince of Wales-Hyder Census Area,2017,2,501,221,280
198,Prince of Wales-Hyder Census Area,2017,3,417,235,182
198,Prince of Wales-Hyder Census Area,2017,4,372,215,157
198,Prince of Wales-Hyder Census Area,2017,5,270,151,119
198,Prince of Wales-Hyder Census Area,2017,6,374,195,179
198,Prince of Wales-Hyder Census Area,2017,7,418,209,209
198,Prince of Wales-Hyder Census Area,2017,8,382,211,171
198,Prince of Wales-Hyder Census Area,2017,9,338,181,157
198,Prince of Wales-Hyder Census Area,2017,10,391,212,179
198,Prince of Wales-Hyder Census Area,2017,11,489,280,209
198,Prince of Wales-Hyder Census Area,2017,12,548,294,254
198,Prince of Wales-Hyder Census Area,2017,13,516,268,248
198,Prince of Wales-Hyder Census Area,2017,14,428,272,156
198,Prince of Wales-Hyder Census Area,2017,15,242,139,103
198,Prince of Wales-Hyder Census Area,2017,16,175,105,70
198,Prince of Wales-Hyder Census Area,2017,17,75,42,33
198,Prince of Wales-Hyder Census Area,2017,18,39,23,16
220,Sitka City and Borough,2017,0,8746,4372,4374
220,Sitka City and Borough,2017,1,457,222,235
220,Sitka City and Borough,2017,2,559,311,248
220,Sitka City and Borough,2017,3,558,292,266
220,Sitka City and Borough,2017,4,539,282,257
220,Sitka City and Borough,2017,5,472,244,228
220,Sitka City and Borough,2017,6,593,276,317
220,Sitka City and Borough,2017,7,614,270,344
220,Sitka City and Borough,2017,8,654,369,285
220,Sitka City and Borough,2017,9,558,277,281
220,Sitka City and Borough,2017,10,534,262,272
220,Sitka City and Borough,2017,11,542,279,263
220,Sitka City and Borough,2017,12,710,360,350
220,Sitka City and Borough,2017,13,650,334,316
220,Sitka City and Borough,2017,14,468,238,230
220,Sitka City and Borough,2017,15,310,146,164
220,Sitka City and Borough,2017,16,240,105,135
220,Sitka City and Borough,2017,17,147,56,91
220,Sitka City and Borough,2017,18,141,49,92
230,"Skagway Borough, Municipality",2017,0,1091,552,539
230,"Skagway Borough, Municipality",2017,1,70,32,38
230,"Skagway Borough, Municipality",2017,2,50,32,18
230,"Skagway Borough, Municipality",2017,3,42,20,22
230,"Skagway Borough, Municipality",2017,4,33,15,18
230,"Skagway Borough, Municipality",2017,5,42,22,20
230,"Skagway Borough, Municipality",2017,6,61,22,39
230,"Skagway Borough, Municipality",2017,7,113,64,49
230,"Skagway Borough, Municipality",2017,8,86,48,38
230,"Skagway Borough, Municipality",2017,9,101,43,58
230,"Skagway Borough, Municipality",2017,10,102,54,48
230,"Skagway Borough, Municipality",2017,11,76,39,37
230,"Skagway Borough, Municipality",2017,12,72,41,31
230,"Skagway Borough, Municipality",2017,13,86,51,35
230,"Skagway Borough, Municipality",2017,14,81,38,43
230,"Skagway Borough, Municipality",2017,15,36,21,15
230,"Skagway Borough, Municipality",2017,16,23,5,18
230,"Skagway Borough, Municipality",2017,17,13,4,9
230,"Skagway Borough, Municipality",2017,18,4,1,3
240,Southeast Fairbanks Census Area,2017,0,6993,3853,3140
240,Southeast Fairbanks Census Area,2017,1,436,213,223
240,Southeast Fairbanks Census Area,2017,2,540,292,248
240,Southeast Fairbanks Census Area,2017,3,506,272,234
240,Southeast Fairbanks Census Area,2017,4,449,243,206
240,Southeast Fairbanks Census Area,2017,5,322,162,160
240,Southeast Fairbanks Census Area,2017,6,427,231,196
240,Southeast Fairbanks Census Area,2017,7,544,316,228
240,Southeast Fairbanks Census Area,2017,8,454,244,210
240,Southeast Fairbanks Census Area,2017,9,419,244,175
240,Southeast Fairbanks Census Area,2017,10,418,237,181
240,Southeast Fairbanks Census Area,2017,11,470,269,201
240,Southeast Fairbanks Census Area,2017,12,526,298,228
240,Southeast Fairbanks Census Area,2017,13,505,278,227
240,Southeast Fairbanks Census Area,2017,14,394,250,144
240,Southeast Fairbanks Census Area,2017,15,250,141,109
240,Southeast Fairbanks Census Area,2017,16,163,82,81
240,Southeast Fairbanks Census Area,2017,17,93,56,37
240,Southeast Fairbanks Census Area,2017,18,77,25,52
275,Wrangell City and Borough,2017,0,2393,1209,1184
275,Wrangell City and Borough,2017,1,134,70,64
275,Wrangell City and Borough,2017,2,163,69,94
275,Wrangell City and Borough,2017,3,126,60,66
275,Wrangell City and Borough,2017,4,131,76,55
275,Wrangell City and Borough,2017,5,86,49,37
275,Wrangell City and Borough,2017,6,146,58,88
275,Wrangell City and Borough,2017,7,123,60,63
275,Wrangell City and Borough,2017,8,105,60,45
275,Wrangell City and Borough,2017,9,100,44,56
275,Wrangell City and Borough,2017,10,132,70,62
275,Wrangell City and Borough,2017,11,162,79,83
275,Wrangell City and Borough,2017,12,240,124,116
275,Wrangell City and Borough,2017,13,264,126,138
275,Wrangell City and Borough,2017,14,186,107,79
275,Wrangell City and Borough,2017,15,127,68,59
275,Wrangell City and Borough,2017,16,84,49,35
275,Wrangell City and Borough,2017,17,49,25,24
275,Wrangell City and Borough,2017,18,35,15,20
282,Yakutat City and Borough,2017,0,544,286,258
282,Yakutat City and Borough,2017,1,39,21,18
282,Yakutat City and Borough,2017,2,25,8,17
282,Yakutat City and Borough,2017,3,32,12,20
282,Yakutat City and Borough,2017,4,24,9,15
282,Yakutat City and Borough,2017,5,29,14,15
282,Yakutat City and Borough,2017,6,28,16,12
282,Yakutat City and Borough,2017,7,31,16,15
282,Yakutat City and Borough,2017,8,37,23,14
282,Yakutat City and Borough,2017,9,31,24,7
282,Yakutat City and Borough,2017,10,51,27,24
282,Yakutat City and Borough,2017,11,40,23,17
282,Yakutat City and Borough,2017,12,31,20,11
282,Yakutat City and Borough,2017,13,47,28,19
282,Yakutat City and Borough,2017,14,43,20,23
282,Yakutat City and Borough,2017,15,25,15,10
282,Yakutat City and Borough,2017,16,12,7,5
282,Yakutat City and Borough,2017,17,15,3,12
282,Yakutat City and Borough,2017,18,4,0,4
290,Yukon-Koyukuk Census Area,2017,0,5362,2848,2514
290,Yukon-Koyukuk Census Area,2017,1,404,193,211
290,Yukon-Koyukuk Census Area,2017,2,474,252,222
290,Yukon-Koyukuk Census Area,2017,3,396,208,188
290,Yukon-Koyukuk Census Area,2017,4,382,208,174
290,Yukon-Koyukuk Census Area,2017,5,246,129,117
290,Yukon-Koyukuk Census Area,2017,6,371,192,179
290,Yukon-Koyukuk Census Area,2017,7,339,187,152
290,Yukon-Koyukuk Census Area,2017,8,322,175,147
290,Yukon-Koyukuk Census Area,2017,9,291,155,136
290,Yukon-Koyukuk Census Area,2017,10,229,102,127
290,Yukon-Koyukuk Census Area,2017,11,344,192,152
290,Yukon-Koyukuk Census Area,2017,12,398,217,181
290,Yukon-Koyukuk Census Area,2017,13,423,237,186
290,Yukon-Koyukuk Census Area,2017,14,311,164,147
290,Yukon-Koyukuk Census Area,2017,15,201,120,81
290,Yukon-Koyukuk Census Area,2017,16,98,50,48
290,Yukon-Koyukuk Census Area,2017,17,74,40,34
290,Yukon-Koyukuk Census Area,2017,18,59,27,32
000,Alaska,2018,0,735367,378371,356996
000,Alaska,2018,1,51106,25921,25185
000,Alaska,2018,2,53540,27546,25994
000,Alaska,2018,3,52555,27012,25543
000,Alaska,2018,4,47508,25035,22473
000,Alaska,2018,5,47355,25587,21768
000,Alaska,2018,6,56295,29312,26983
000,Alaska,2018,7,56787,29029,27758
000,Alaska,2018,8,52596,27209,25387
000,Alaska,2018,9,42928,22086,20842
000,Alaska,2018,10,43426,22258,21168
000,Alaska,2018,11,45146,23287,21859
000,Alaska,2018,12,51307,26427,24880
000,Alaska,2018,13,47623,24259,23364
000,Alaska,2018,14,36051,18805,17246
000,Alaska,2018,15,23177,11804,11373
000,Alaska,2018,16,13471,6682,6789
000,Alaska,2018,17,7926,3640,4286
000,Alaska,2018,18,6570,2472,4098
013,Aleutians East Borough,2018,0,2957,1951,1006
013,Aleutians East Borough,2018,1,73,41,32
013,Aleutians East Borough,2018,2,81,36,45
013,Aleutians East Borough,2018,3,65,33,32
013,Aleutians East Borough,2018,4,89,47,42
013,Aleutians East Borough,2018,5,216,164,52
013,Aleutians East Borough,2018,6,148,96,52
013,Aleutians East Borough,2018,7,227,163,64
013,Aleutians East Borough,2018,8,333,205,128
013,Aleutians East Borough,2018,9,302,218,84
013,Aleutians East Borough,2018,10,281,224,57
013,Aleutians East Borough,2018,11,345,213,132
013,Aleutians East Borough,2018,12,387,262,125
013,Aleutians East Borough,2018,13,189,117,72
013,Aleutians East Borough,2018,14,97,59,38
013,Aleutians East Borough,2018,15,79,46,33
013,Aleutians East Borough,2018,16,22,14,8
013,Aleutians East Borough,2018,17,17,10,7
013,Aleutians East Borough,2018,18,6,3,3
016,Aleutians West Census Area,2018,0,5326,3488,1838
016,Aleutians West Census Area,2018,1,193,88,105
016,Aleutians West Census Area,2018,2,232,117,115
016,Aleutians West Census Area,2018,3,203,119,84
016,Aleutians West Census Area,2018,4,222,136,86
016,Aleutians West Census Area,2018,5,286,192,94
016,Aleutians West Census Area,2018,6,493,361,132
016,Aleutians West Census Area,2018,7,463,317,146
016,Aleutians West Census Area,2018,8,453,294,159
016,Aleutians West Census Area,2018,9,459,343,116
016,Aleutians West Census Area,2018,10,406,251,155
016,Aleutians West Census Area,2018,11,587,371,216
016,Aleutians West Census Area,2018,12,519,356,163
016,Aleutians West Census Area,2018,13,389,274,115
016,Aleutians West Census Area,2018,14,294,191,103
016,Aleutians West Census Area,2018,15,80,56,24
016,Aleutians West Census Area,2018,16,23,11,12
016,Aleutians West Census Area,2018,17,12,5,7
016,Aleutians West Census Area,2018,18,12,6,6
020,Anchorage Municipality,2018,0,294973,148207,146766
020,Anchorage Municipality,2018,1,20321,10257,10064
020,Anchorage Municipality,2018,2,20635,10601,10034
020,Anchorage Municipality,2018,3,20226,10387,9839
020,Anchorage Municipality,2018,4,18774,9740,9034
020,Anchorage Municipality,2018,5,21288,11207,10081
020,Anchorage Municipality,2018,6,24567,12615,11952
020,Anchorage Municipality,2018,7,24140,12172,11968
020,Anchorage Municipality,2018,8,21779,10872,10907
020,Anchorage Municipality,2018,9,17265,8642,8623
020,Anchorage Municipality,2018,10,17839,8864,8975
020,Anchorage Municipality,2018,11,17822,8815,9007
020,Anchorage Municipality,2018,12,19711,9801,9910
020,Anchorage Municipality,2018,13,17764,8708,9056
020,Anchorage Municipality,2018,14,13243,6650,6593
020,Anchorage Municipality,2018,15,8593,4206,4387
020,Anchorage Municipality,2018,16,5037,2315,2722
020,Anchorage Municipality,2018,17,3182,1359,1823
020,Anchorage Municipality,2018,18,2787,996,1791
050,Bethel Census Area,2018,0,18068,9367,8701
050,Bethel Census Area,2018,1,1751,917,834
050,Bethel Census Area,2018,2,1861,955,906
050,Bethel Census Area,2018,3,1747,864,883
050,Bethel Census Area,2018,4,1585,877,708
050,Bethel Census Area,2018,5,1375,689,686
050,Bethel Census Area,2018,6,1548,762,786
050,Bethel Census Area,2018,7,1333,700,633
050,Bethel Census Area,2018,8,1017,515,502
050,Bethel Census Area,2018,9,811,400,411
050,Bethel Census Area,2018,10,849,439,410
050,Bethel Census Area,2018,11,982,577,405
050,Bethel Census Area,2018,12,1008,544,464
050,Bethel Census Area,2018,13,842,447,395
050,Bethel Census Area,2018,14,606,331,275
050,Bethel Census Area,2018,15,323,168,155
050,Bethel Census Area,2018,16,217,101,116
050,Bethel Census Area,2018,17,133,58,75
050,Bethel Census Area,2018,18,80,23,57
060,Bristol Bay Borough,2018,0,879,460,419
060,Bristol Bay Borough,2018,1,49,17,32
060,Bristol Bay Borough,2018,2,47,30,17
060,Bristol Bay Borough,2018,3,43,21,22
060,Bristol Bay Borough,2018,4,58,25,33
060,Bristol Bay Borough,2018,5,38,21,17
060,Bristol Bay Borough,2018,6,75,29,46
060,Bristol Bay Borough,2018,7,59,31,28
060,Bristol Bay Borough,2018,8,32,19,13
060,Bristol Bay Borough,2018,9,52,26,26
060,Bristol Bay Borough,2018,10,52,30,22
060,Bristol Bay Borough,2018,11,49,28,21
060,Bristol Bay Borough,2018,12,113,65,48
060,Bristol Bay Borough,2018,13,95,65,30
060,Bristol Bay Borough,2018,14,57,17,40
060,Bristol Bay Borough,2018,15,23,17,6
060,Bristol Bay Borough,2018,16,22,11,11
060,Bristol Bay Borough,2018,17,9,5,4
060,Bristol Bay Borough,2018,18,6,3,3
063,Chugach Census Area,2018,0,6718,3534,3184
063,Chugach Census Area,2018,1,484,248,236
063,Chugach Census Area,2018,2,455,227,228
063,Chugach Census Area,2018,3,418,210,208
063,Chugach Census Area,2018,4,396,219,177
063,Chugach Census Area,2018,5,300,155,145
063,Chugach Census Area,2018,6,528,294,234
063,Chugach Census Area,2018,7,553,306,247
063,Chugach Census Area,2018,8,486,253,233
063,Chugach Census Area,2018,9,399,202,197
063,Chugach Census Area,2018,10,406,219,187
063,Chugach Census Area,2018,11,454,250,204
063,Chugach Census Area,2018,12,576,306,270
063,Chugach Census Area,2018,13,527,272,255
063,Chugach Census Area,2018,14,334,181,153
063,Chugach Census Area,2018,15,213,110,103
063,Chugach Census Area,2018,16,99,46,53
063,Chugach Census Area,2018,17,47,25,22
063,Chugach Census Area,2018,18,43,11,32
066,Copper River Census Area,2018,0,2720,1434,1286
066,Copper River Census Area,2018,1,169,64,105
066,Copper River Census Area,2018,2,189,101,88
066,Copper River Census Area,2018,3,183,89,94
066,Copper River Census Area,2018,4,182,91,91
066,Copper River Census Area,2018,5,112,61,51
066,Copper River Census Area,2018,6,109,59,50
066,Copper River Census Area,2018,7,154,72,82
066,Copper River Census Area,2018,8,181,94,87
066,Copper River Census Area,2018,9,129,65,64
066,Copper River Census Area,2018,10,147,87,60
066,Copper River Census Area,2018,11,197,102,95
066,Copper River Census Area,2018,12,246,131,115
066,Copper River Census Area,2018,13,293,168,125
066,Copper River Census Area,2018,14,178,111,67
066,Copper River Census Area,2018,15,117,64,53
066,Copper River Census Area,2018,16,85,52,33
066,Copper River Census Area,2018,17,28,15,13
066,Copper River Census Area,2018,18,21,8,13
068,Denali Borough,2018,0,1824,992,832
068,Denali Borough,2018,1,94,49,45
068,Denali Borough,2018,2,112,65,47
068,Denali Borough,2018,3,102,57,45
068,Denali Borough,2018,4,93,39,54
068,Denali Borough,2018,5,46,22,24
068,Denali Borough,2018,6,114,58,56
068,Denali Borough,2018,7,131,61,70
068,Denali Borough,2018,8,145,71,74
068,Denali Borough,2018,9,121,66,55
068,Denali Borough,2018,10,168,84,84
068,Denali Borough,2018,11,135,78,57
068,Denali Borough,2018,12,172,103,69
068,Denali Borough,2018,13,152,96,56
068,Denali Borough,2018,14,125,80,45
068,Denali Borough,2018,15,48,28,20
068,Denali Borough,2018,16,31,19,12
068,Denali Borough,2018,17,26,9,17
068,Denali Borough,2018,18,9,7,2
070,Dillingham Census Area,2018,0,5014,2601,2413
070,Dillingham Census Area,2018,1,457,212,245
070,Dillingham Census Area,2018,2,481,244,237
070,Dillingham Census Area,2018,3,411,215,196
070,Dillingham Census Area,2018,4,362,189,173
070,Dillingham Census Area,2018,5,362,185,177
070,Dillingham Census Area,2018,6,420,235,185
070,Dillingham Census Area,2018,7,345,167,178
070,Dillingham Census Area,2018,8,276,157,119
070,Dillingham Census Area,2018,9,230,103,127
070,Dillingham Census Area,2018,10,231,118,113
070,Dillingham Census Area,2018,11,295,157,138
070,Dillingham Census Area,2018,12,357,194,163
070,Dillingham Census Area,2018,13,304,177,127
070,Dillingham Census Area,2018,14,197,99,98
070,Dillingham Census Area,2018,15,115,54,61
070,Dillingham Census Area,2018,16,85,52,33
070,Dillingham Census Area,2018,17,51,26,25
070,Dillingham Census Area,2018,18,35,17,18
090,Fairbanks North Star Borough,2018,0,96988,50580,46408
090,Fairbanks North Star Borough,2018,1,6889,3515,3374
090,Fairbanks North Star Borough,2018,2,6856,3549,3307
090,Fairbanks North Star Borough,2018,3,6544,3379,3165
090,Fairbanks North Star Borough,2018,4,6181,3284,2897
090,Fairbanks North Star Borough,2018,5,8019,4639,3380
090,Fairbanks North Star Borough,2018,6,7837,4178,3659
090,Fairbanks North Star Borough,2018,7,7901,4112,3789
090,Fairbanks North Star Borough,2018,8,7031,3707,3324
090,Fairbanks North Star Borough,2018,9,5786,2977,2809
090,Fairbanks North Star Borough,2018,10,5338,2762,2576
090,Fairbanks North Star Borough,2018,11,5520,2768,2752
090,Fairbanks North Star Borough,2018,12,6371,3205,3166
090,Fairbanks North Star Borough,2018,13,6037,3032,3005
090,Fairbanks North Star Borough,2018,14,4550,2454,2096
090,Fairbanks North Star Borough,2018,15,2994,1531,1463
090,Fairbanks North Star Borough,2018,16,1551,808,743
090,Fairbanks North Star Borough,2018,17,866,401,465
090,Fairbanks North Star Borough,2018,18,717,279,438
100,Haines Borough,2018,0,2476,1217,1259
100,Haines Borough,2018,1,112,48,64
100,Haines Borough,2018,2,163,73,90
100,Haines Borough,2018,3,124,67,57
100,Haines Borough,2018,4,103,49,54
100,Haines Borough,2018,5,74,46,28
100,Haines Borough,2018,6,96,53,43
100,Haines Borough,2018,7,154,68,86
100,Haines Borough,2018,8,163,70,93
100,Haines Borough,2018,9,144,78,66
100,Haines Borough,2018,10,146,72,74
100,Haines Borough,2018,11,171,92,79
100,Haines Borough,2018,12,243,119,124
100,Haines Borough,2018,13,253,132,121
100,Haines Borough,2018,14,215,107,108
100,Haines Borough,2018,15,148,77,71
100,Haines Borough,2018,16,75,31,44
100,Haines Borough,2018,17,39,15,24
100,Haines Borough,2018,18,53,20,33
105,Hoonah-Angoon Census Area,2018,0,2168,1140,1028
105,Hoonah-Angoon Census Area,2018,1,122,54,68
105,Hoonah-Angoon Census Area,2018,2,135,79,56
105,Hoonah-Angoon Census Area,2018,3,136,60,76
105,Hoonah-Angoon Census Area,2018,4,103,41,62
105,Hoonah-Angoon Census Area,2018,5,72,38,34
105,Hoonah-Angoon Census Area,2018,6,114,67,47
105,Hoonah-Angoon Census Area,2018,7,110,60,50
105,Hoonah-Angoon Census Area,2018,8,135,68,67
105,Hoonah-Angoon Census Area,2018,9,116,54,62
105,Hoonah-Angoon Census Area,2018,10,115,63,52
105,Hoonah-Angoon Census Area,2018,11,149,77,72
105,Hoonah-Angoon Census Area,2018,12,183,97,86
105,Hoonah-Angoon Census Area,2018,13,214,113,101
105,Hoonah-Angoon Census Area,2018,14,212,106,106
105,Hoonah-Angoon Census Area,2018,15,105,72,33
105,Hoonah-Angoon Census Area,2018,16,85,50,35
105,Hoonah-Angoon Census Area,2018,17,48,34,14
105,Hoonah-Angoon Census Area,2018,18,14,7,7
110,Juneau City and Borough,2018,0,32231,16313,15918
110,Juneau City and Borough,2018,1,1898,953,945
110,Juneau City and Borough,2018,2,1996,1030,966
110,Juneau City and Borough,2018,3,2068,1048,1020
110,Juneau City and Borough,2018,4,1930,1004,926
110,Juneau City and Borough,2018,5,1682,882,800
110,Juneau City and Borough,2018,6,2395,1196,1199
110,Juneau City and Borough,2018,7,2563,1281,1282
110,Juneau City and Borough,2018,8,2398,1221,1177
110,Juneau City and Borough,2018,9,1991,995,996
110,Juneau City and Borough,2018,10,2117,1095,1022
110,Juneau City and Borough,2018,11,2215,1118,1097
110,Juneau City and Borough,2018,12,2498,1298,1200
110,Juneau City and Borough,2018,13,2266,1159,1107
110,Juneau City and Borough,2018,14,1797,878,919
110,Juneau City and Borough,2018,15,1164,637,527
110,Juneau City and Borough,2018,16,589,245,344
110,Juneau City and Borough,2018,17,378,169,209
110,Juneau City and Borough,2018,18,286,104,182
122,Kenai Peninsula Borough,2018,0,58387,30238,28149
122,Kenai Peninsula Borough,2018,1,3525,1764,1761
122,Kenai Peninsula Borough,2018,2,3789,1973,1816
122,Kenai Peninsula Borough,2018,3,3809,1930,1879
122,Kenai Peninsula Borough,2018,4,3465,1805,1660
122,Kenai Peninsula Borough,2018,5,2589,1445,1144
122,Kenai Peninsula Borough,2018,6,3465,1831,1634
122,Kenai Peninsula Borough,2018,7,3644,1860,1784
122,Kenai Peninsula Borough,2018,8,3908,2062,1846
122,Kenai Peninsula Borough,2018,9,3245,1733,1512
122,Kenai Peninsula Borough,2018,10,3462,1794,1668
122,Kenai Peninsula Borough,2018,11,3661,1862,1799
122,Kenai Peninsula Borough,2018,12,4653,2330,2323
122,Kenai Peninsula Borough,2018,13,4940,2501,2439
122,Kenai Peninsula Borough,2018,14,4056,2211,1845
122,Kenai Peninsula Borough,2018,15,2757,1476,1281
122,Kenai Peninsula Borough,2018,16,1785,922,863
122,Kenai Peninsula Borough,2018,17,890,445,445
122,Kenai Peninsula Borough,2018,18,744,294,450
130,Ketchikan Gateway Borough,2018,0,13843,7024,6819
130,Ketchikan Gateway Borough,2018,1,764,396,368
130,Ketchikan Gateway Borough,2018,2,885,464,421
130,Ketchikan Gateway Borough,2018,3,915,447,468
130,Ketchikan Gateway Borough,2018,4,889,472,417
130,Ketchikan Gateway Borough,2018,5,768,418,350
130,Ketchikan Gateway Borough,2018,6,928,482,446
130,Ketchikan Gateway Borough,2018,7,941,455,486
130,Ketchikan Gateway Borough,2018,8,945,482,463
130,Ketchikan Gateway Borough,2018,9,789,389,400
130,Ketchikan Gateway Borough,2018,10,864,415,449
130,Ketchikan Gateway Borough,2018,11,871,433,438
130,Ketchikan Gateway Borough,2018,12,1076,566,510
130,Ketchikan Gateway Borough,2018,13,1049,527,522
130,Ketchikan Gateway Borough,2018,14,811,406,405
130,Ketchikan Gateway Borough,2018,15,594,283,311
130,Ketchikan Gateway Borough,2018,16,363,204,159
130,Ketchikan Gateway Borough,2018,17,213,110,103
130,Ketchikan Gateway Borough,2018,18,178,75,103
150,Kodiak Island Borough,2018,0,13121,6873,6248
150,Kodiak Island Borough,2018,1,960,508,452
150,Kodiak Island Borough,2018,2,985,494,491
150,Kodiak Island Borough,2018,3,945,494,451
150,Kodiak Island Borough,2018,4,872,490,382
150,Kodiak Island Borough,2018,5,789,421,368
150,Kodiak Island Borough,2018,6,1046,571,475
150,Kodiak Island Borough,2018,7,1036,544,492
150,Kodiak Island Borough,2018,8,914,493,421
150,Kodiak Island Borough,2018,9,746,361,385
150,Kodiak Island Borough,2018,10,733,358,375
150,Kodiak Island Borough,2018,11,815,427,388
150,Kodiak Island Borough,2018,12,928,529,399
150,Kodiak Island Borough,2018,13,908,499,409
150,Kodiak Island Borough,2018,14,603,283,320
150,Kodiak Island Borough,2018,15,414,204,210
150,Kodiak Island Borough,2018,16,214,109,105
150,Kodiak Island Borough,2018,17,117,57,60
150,Kodiak Island Borough,2018,18,96,31,65
158,Kusilvak Census Area,2018,0,8320,4339,3981
158,Kusilvak Census Area,2018,1,893,455,438
158,Kusilvak Census Area,2018,2,952,507,445
158,Kusilvak Census Area,2018,3,910,469,441
158,Kusilvak Census Area,2018,4,806,405,401
158,Kusilvak Census Area,2018,5,722,399,323
158,Kusilvak Census Area,2018,6,773,398,375
158,Kusilvak Census Area,2018,7,579,316,263
158,Kusilvak Census Area,2018,8,409,226,183
158,Kusilvak Census Area,2018,9,340,165,175
158,Kusilvak Census Area,2018,10,344,165,179
158,Kusilvak Census Area,2018,11,379,197,182
158,Kusilvak Census Area,2018,12,405,218,187
158,Kusilvak Census Area,2018,13,307,169,138
158,Kusilvak Census Area,2018,14,207,119,88
158,Kusilvak Census Area,2018,15,138,64,74
158,Kusilvak Census Area,2018,16,65,35,30
158,Kusilvak Census Area,2018,17,52,21,31
158,Kusilvak Census Area,2018,18,39,11,28
164,Lake and Peninsula Borough,2018,0,1662,871,791
164,Lake and Peninsula Borough,2018,1,170,80,90
164,Lake and Peninsula Borough,2018,2,134,71,63
164,Lake and Peninsula Borough,2018,3,130,64,66
164,Lake and Peninsula Borough,2018,4,91,43,48
164,Lake and Peninsula Borough,2018,5,96,51,45
164,Lake and Peninsula Borough,2018,6,144,75,69
164,Lake and Peninsula Borough,2018,7,129,72,57
164,Lake and Peninsula Borough,2018,8,142,70,72
164,Lake and Peninsula Borough,2018,9,82,48,34
164,Lake and Peninsula Borough,2018,10,53,29,24
164,Lake and Peninsula Borough,2018,11,108,54,54
164,Lake and Peninsula Borough,2018,12,131,81,50
164,Lake and Peninsula Borough,2018,13,101,51,50
164,Lake and Peninsula Borough,2018,14,67,37,30
164,Lake and Peninsula Borough,2018,15,43,26,17
164,Lake and Peninsula Borough,2018,16,19,10,9
164,Lake and Peninsula Borough,2018,17,12,7,5
164,Lake and Peninsula Borough,2018,18,10,2,8
170,Matanuska-Susitna Borough,2018,0,105685,54212,51473
170,Matanuska-Susitna Borough,2018,1,7794,4037,3757
170,Matanuska-Susitna Borough,2018,2,8544,4356,4188
170,Matanuska-Susitna Borough,2018,3,8759,4534,4225
170,Matanuska-Susitna Borough,2018,4,7248,3905,3343
170,Matanuska-Susitna Borough,2018,5,5300,2798,2502
170,Matanuska-Susitna Borough,2018,6,6834,3483,3351
170,Matanuska-Susitna Borough,2018,7,7496,3669,3827
170,Matanuska-Susitna Borough,2018,8,7655,3928,3727
170,Matanuska-Susitna Borough,2018,9,6467,3350,3117
170,Matanuska-Susitna Borough,2018,10,6414,3286,3128
170,Matanuska-Susitna Borough,2018,11,6430,3289,3141
170,Matanuska-Susitna Borough,2018,12,7324,3763,3561
170,Matanuska-Susitna Borough,2018,13,6783,3447,3336
170,Matanuska-Susitna Borough,2018,14,5360,2725,2635
170,Matanuska-Susitna Borough,2018,15,3331,1665,1666
170,Matanuska-Susitna Borough,2018,16,1993,1085,908
170,Matanuska-Susitna Borough,2018,17,1067,504,563
170,Matanuska-Susitna Borough,2018,18,886,388,498
180,Nome Census Area,2018,0,9970,5274,4696
180,Nome Census Area,2018,1,908,421,487
180,Nome Census Area,2018,2,1019,562,457
180,Nome Census Area,2018,3,944,486,458
180,Nome Census Area,2018,4,801,436,365
180,Nome Census Area,2018,5,684,377,307
180,Nome Census Area,2018,6,883,460,423
180,Nome Census Area,2018,7,750,375,375
180,Nome Census Area,2018,8,633,349,284
180,Nome Census Area,2018,9,569,313,256
180,Nome Census Area,2018,10,472,243,229
180,Nome Census Area,2018,11,504,294,210
180,Nome Census Area,2018,12,567,285,282
180,Nome Census Area,2018,13,497,265,232
180,Nome Census Area,2018,14,324,193,131
180,Nome Census Area,2018,15,198,120,78
180,Nome Census Area,2018,16,101,47,54
180,Nome Census Area,2018,17,83,36,47
180,Nome Census Area,2018,18,33,12,21
185,North Slope Borough,2018,0,9917,6090,3827
185,North Slope Borough,2018,1,698,356,342
185,North Slope Borough,2018,2,775,394,381
185,North Slope Borough,2018,3,731,382,349
185,North Slope Borough,2018,4,553,285,268
185,North Slope Borough,2018,5,541,335,206
185,North Slope Borough,2018,6,945,556,389
185,North Slope Borough,2018,7,1040,690,350
185,North Slope Borough,2018,8,822,574,248
185,North Slope Borough,2018,9,531,319,212
185,North Slope Borough,2018,10,525,359,166
185,North Slope Borough,2018,11,837,621,216
185,North Slope Borough,2018,12,803,522,281
185,North Slope Borough,2018,13,588,389,199
185,North Slope Borough,2018,14,284,183,101
185,North Slope Borough,2018,15,120,72,48
185,North Slope Borough,2018,16,46,19,27
185,North Slope Borough,2018,17,50,24,26
185,North Slope Borough,2018,18,28,10,18
188,Northwest Arctic Borough,2018,0,7779,4175,3604
188,Northwest Arctic Borough,2018,1,707,363,344
188,Northwest Arctic Borough,2018,2,831,436,395
188,Northwest Arctic Borough,2018,3,760,394,366
188,Northwest Arctic Borough,2018,4,639,334,305
188,Northwest Arctic Borough,2018,5,533,276,257
188,Northwest Arctic Borough,2018,6,659,358,301
188,Northwest Arctic Borough,2018,7,615,344,271
188,Northwest Arctic Borough,2018,8,497,263,234
188,Northwest Arctic Borough,2018,9,345,183,162
188,Northwest Arctic Borough,2018,10,376,211,165
188,Northwest Arctic Borough,2018,11,470,287,183
188,Northwest Arctic Borough,2018,12,413,243,170
188,Northwest Arctic Borough,2018,13,363,207,156
188,Northwest Arctic Borough,2018,14,224,130,94
188,Northwest Arctic Borough,2018,15,155,73,82
188,Northwest Arctic Borough,2018,16,72,37,35
188,Northwest Arctic Borough,2018,17,59,27,32
188,Northwest Arctic Borough,2018,18,61,9,52
195,Petersburg Borough,2018,0,3195,1601,1594
195,Petersburg Borough,2018,1,202,91,111
195,Petersburg Borough,2018,2,223,104,119
195,Petersburg Borough,2018,3,203,104,99
195,Petersburg Borough,2018,4,170,84,86
195,Petersburg Borough,2018,5,118,67,51
195,Petersburg Borough,2018,6,174,73,101
195,Petersburg Borough,2018,7,206,99,107
195,Petersburg Borough,2018,8,205,103,102
195,Petersburg Borough,2018,9,172,80,92
195,Petersburg Borough,2018,10,226,116,110
195,Petersburg Borough,2018,11,178,102,76
195,Petersburg Borough,2018,12,235,109,126
195,Petersburg Borough,2018,13,273,141,132
195,Petersburg Borough,2018,14,246,148,98
195,Petersburg Borough,2018,15,172,80,92
195,Petersburg Borough,2018,16,97,57,40
195,Petersburg Borough,2018,17,43,22,21
195,Petersburg Borough,2018,18,52,21,31
198,Prince of Wales-Hyder Census Area,2018,0,6239,3387,2852
198,Prince of Wales-Hyder Census Area,2018,1,382,222,160
198,Prince of Wales-Hyder Census Area,2018,2,458,208,250
198,Prince of Wales-Hyder Census Area,2018,3,461,253,208
198,Prince of Wales-Hyder Census Area,2018,4,363,207,156
198,Prince of Wales-Hyder Census Area,2018,5,252,137,115
198,Prince of Wales-Hyder Census Area,2018,6,353,188,165
198,Prince of Wales-Hyder Census Area,2018,7,431,202,229
198,Prince of Wales-Hyder Census Area,2018,8,374,202,172
198,Prince of Wales-Hyder Census Area,2018,9,342,186,156
198,Prince of Wales-Hyder Census Area,2018,10,360,190,170
198,Prince of Wales-Hyder Census Area,2018,11,451,259,192
198,Prince of Wales-Hyder Census Area,2018,12,530,306,224
198,Prince of Wales-Hyder Census Area,2018,13,506,249,257
198,Prince of Wales-Hyder Census Area,2018,14,452,274,178
198,Prince of Wales-Hyder Census Area,2018,15,240,146,94
198,Prince of Wales-Hyder Census Area,2018,16,173,97,76
198,Prince of Wales-Hyder Census Area,2018,17,71,43,28
198,Prince of Wales-Hyder Census Area,2018,18,40,18,22
220,Sitka City and Borough,2018,0,8621,4313,4308
220,Sitka City and Borough,2018,1,446,236,210
220,Sitka City and Borough,2018,2,508,277,231
220,Sitka City and Borough,2018,3,570,310,260
220,Sitka City and Borough,2018,4,542,282,260
220,Sitka City and Borough,2018,5,426,210,216
220,Sitka City and Borough,2018,6,603,291,312
220,Sitka City and Borough,2018,7,630,275,355
220,Sitka City and Borough,2018,8,608,332,276
220,Sitka City and Borough,2018,9,558,289,269
220,Sitka City and Borough,2018,10,529,258,271
220,Sitka City and Borough,2018,11,524,263,261
220,Sitka City and Borough,2018,12,658,350,308
220,Sitka City and Borough,2018,13,661,325,336
220,Sitka City and Borough,2018,14,477,235,242
220,Sitka City and Borough,2018,15,334,165,169
220,Sitka City and Borough,2018,16,217,97,120
220,Sitka City and Borough,2018,17,182,71,111
220,Sitka City and Borough,2018,18,148,47,101
230,"Skagway Borough, Municipality",2018,0,1087,551,536
230,"Skagway Borough, Municipality",2018,1,62,27,35
230,"Skagway Borough, Municipality",2018,2,48,30,18
230,"Skagway Borough, Municipality",2018,3,53,27,26
230,"Skagway Borough, Municipality",2018,4,32,14,18
230,"Skagway Borough, Municipality",2018,5,38,27,11
230,"Skagway Borough, Municipality",2018,6,77,28,49
230,"Skagway Borough, Municipality",2018,7,99,49,50
230,"Skagway Borough, Municipality",2018,8,88,47,41
230,"Skagway Borough, Municipality",2018,9,115,60,55
230,"Skagway Borough, Municipality",2018,10,97,47,50
230,"Skagway Borough, Municipality",2018,11,71,38,33
230,"Skagway Borough, Municipality",2018,12,68,40,28
230,"Skagway Borough, Municipality",2018,13,85,50,35
230,"Skagway Borough, Municipality",2018,14,68,32,36
230,"Skagway Borough, Municipality",2018,15,41,23,18
230,"Skagway Borough, Municipality",2018,16,26,5,21
230,"Skagway Borough, Municipality",2018,17,14,5,9
230,"Skagway Borough, Municipality",2018,18,5,2,3
240,Southeast Fairbanks Census Area,2018,0,6967,3837,3130
240,Southeast Fairbanks Census Area,2018,1,445,224,221
240,Southeast Fairbanks Census Area,2018,2,507,264,243
240,Southeast Fairbanks Census Area,2018,3,507,266,241
240,Southeast Fairbanks Census Area,2018,4,440,239,201
240,Southeast Fairbanks Census Area,2018,5,292,151,141
240,Southeast Fairbanks Census Area,2018,6,450,251,199
240,Southeast Fairbanks Census Area,2018,7,538,299,239
240,Southeast Fairbanks Census Area,2018,8,480,266,214
240,Southeast Fairbanks Census Area,2018,9,413,233,180
240,Southeast Fairbanks Census Area,2018,10,455,274,181
240,Southeast Fairbanks Census Area,2018,11,432,242,190
240,Southeast Fairbanks Census Area,2018,12,503,273,230
240,Southeast Fairbanks Census Area,2018,13,498,281,217
240,Southeast Fairbanks Census Area,2018,14,386,249,137
240,Southeast Fairbanks Census Area,2018,15,275,147,128
240,Southeast Fairbanks Census Area,2018,16,171,91,80
240,Southeast Fairbanks Census Area,2018,17,94,57,37
240,Southeast Fairbanks Census Area,2018,18,81,30,51
275,Wrangell City and Borough,2018,0,2423,1227,1196
275,Wrangell City and Borough,2018,1,124,69,55
275,Wrangell City and Borough,2018,2,166,67,99
275,Wrangell City and Borough,2018,3,147,74,73
275,Wrangell City and Borough,2018,4,124,74,50
275,Wrangell City and Borough,2018,5,89,42,47
275,Wrangell City and Borough,2018,6,132,54,78
275,Wrangell City and Borough,2018,7,137,71,66
275,Wrangell City and Borough,2018,8,115,64,51
275,Wrangell City and Borough,2018,9,97,41,56
275,Wrangell City and Borough,2018,10,140,74,66
275,Wrangell City and Borough,2018,11,146,71,75
275,Wrangell City and Borough,2018,12,220,112,108
275,Wrangell City and Borough,2018,13,271,138,133
275,Wrangell City and Borough,2018,14,204,113,91
275,Wrangell City and Borough,2018,15,128,67,61
275,Wrangell City and Borough,2018,16,85,47,38
275,Wrangell City and Borough,2018,17,62,35,27
275,Wrangell City and Borough,2018,18,36,14,22
282,Yakutat City and Borough,2018,0,522,283,239
282,Yakutat City and Borough,2018,1,35,18,17
282,Yakutat City and Borough,2018,2,26,10,16
282,Yakutat City and Borough,2018,3,31,14,17
282,Yakutat City and Borough,2018,4,27,10,17
282,Yakutat City and Borough,2018,5,17,10,7
282,Yakutat City and Borough,2018,6,31,20,11
282,Yakutat City and Borough,2018,7,23,10,13
282,Yakutat City and Borough,2018,8,41,24,17
282,Yakutat City and Borough,2018,9,28,20,8
282,Yakutat City and Borough,2018,10,45,25,20
282,Yakutat City and Borough,2018,11,50,33,17
282,Yakutat City and Borough,2018,12,26,16,10
282,Yakutat City and Borough,2018,13,45,25,20
282,Yakutat City and Borough,2018,14,39,21,18
282,Yakutat City and Borough,2018,15,26,14,12
282,Yakutat City and Borough,2018,16,10,7,3
282,Yakutat City and Borough,2018,17,16,6,10
282,Yakutat City and Borough,2018,18,6,0,6
290,Yukon-Koyukuk Census Area,2018,0,5287,2792,2495
290,Yukon-Koyukuk Census Area,2018,1,379,191,188
290,Yukon-Koyukuk Census Area,2018,2,447,222,225
290,Yukon-Koyukuk Census Area,2018,3,410,215,195
290,Yukon-Koyukuk Census Area,2018,4,368,209,159
290,Yukon-Koyukuk Census Area,2018,5,231,122,109
290,Yukon-Koyukuk Census Area,2018,6,354,190,164
290,Yukon-Koyukuk Census Area,2018,7,360,189,171
290,Yukon-Koyukuk Census Area,2018,8,331,178,153
290,Yukon-Koyukuk Census Area,2018,9,284,147,137
290,Yukon-Koyukuk Census Area,2018,10,236,106,130
290,Yukon-Koyukuk Census Area,2018,11,298,169,129
290,Yukon-Koyukuk Census Area,2018,12,383,203,180
290,Yukon-Koyukuk Census Area,2018,13,423,235,188
290,Yukon-Koyukuk Census Area,2018,14,338,182,156
290,Yukon-Koyukuk Census Area,2018,15,209,113,96
290,Yukon-Koyukuk Census Area,2018,16,113,58,55
290,Yukon-Koyukuk Census Area,2018,17,65,39,26
290,Yukon-Koyukuk Census Area,2018,18,58,24,34
000,Alaska,2019,0,732734,377146,355588
000,Alaska,2019,1,49819,25447,24372
000,Alaska,2019,2,52633,26908,25725
000,Alaska,2019,3,52892,27414,25478
000,Alaska,2019,4,47072,24682,22390
000,Alaska,2019,5,46395,25286,21109
000,Alaska,2019,6,55160,28716,26444
000,Alaska,2019,7,57062,29076,27986
000,Alaska,2019,8,53411,27567,25844
000,Alaska,2019,9,43670,22590,21080
000,Alaska,2019,10,42002,21460,20542
000,Alaska,2019,11,43616,22513,21103
000,Alaska,2019,12,50105,25893,24212
000,Alaska,2019,13,47404,24023,23381
000,Alaska,2019,14,37365,19367,17998
000,Alaska,2019,15,24697,12602,12095
000,Alaska,2019,16,14487,7190,7297
000,Alaska,2019,17,8215,3841,4374
000,Alaska,2019,18,6729,2571,4158
013,Aleutians East Borough,2019,0,2941,1929,1012
013,Aleutians East Borough,2019,1,64,39,25
013,Aleutians East Borough,2019,2,93,35,58
013,Aleutians East Borough,2019,3,79,42,37
013,Aleutians East Borough,2019,4,88,52,36
013,Aleutians East Borough,2019,5,207,147,60
013,Aleutians East Borough,2019,6,139,98,41
013,Aleutians East Borough,2019,7,217,151,66
013,Aleutians East Borough,2019,8,353,231,122
013,Aleutians East Borough,2019,9,250,164,86
013,Aleutians East Borough,2019,10,258,203,55
013,Aleutians East Borough,2019,11,355,245,110
013,Aleutians East Borough,2019,12,391,249,142
013,Aleutians East Borough,2019,13,222,130,92
013,Aleutians East Borough,2019,14,99,68,31
013,Aleutians East Borough,2019,15,74,43,31
013,Aleutians East Borough,2019,16,25,16,9
013,Aleutians East Borough,2019,17,20,11,9
013,Aleutians East Borough,2019,18,7,5,2
016,Aleutians West Census Area,2019,0,5585,3659,1926
016,Aleutians West Census Area,2019,1,195,101,94
016,Aleutians West Census Area,2019,2,246,118,128
016,Aleutians West Census Area,2019,3,237,133,104
016,Aleutians West Census Area,2019,4,221,143,78
016,Aleutians West Census Area,2019,5,299,198,101
016,Aleutians West Census Area,2019,6,568,450,118
016,Aleutians West Census Area,2019,7,472,298,174
016,Aleutians West Census Area,2019,8,473,309,164
016,Aleutians West Census Area,2019,9,465,326,139
016,Aleutians West Census Area,2019,10,396,260,136
016,Aleutians West Census Area,2019,11,598,363,235
016,Aleutians West Census Area,2019,12,544,365,179
016,Aleutians West Census Area,2019,13,432,312,120
016,Aleutians West Census Area,2019,14,293,194,99
016,Aleutians West Census Area,2019,15,105,68,37
016,Aleutians West Census Area,2019,16,19,11,8
016,Aleutians West Census Area,2019,17,12,4,8
016,Aleutians West Census Area,2019,18,10,6,4
020,Anchorage Municipality,2019,0,292487,147126,145361
020,Anchorage Municipality,2019,1,19699,10055,9644
020,Anchorage Municipality,2019,2,20060,10267,9793
020,Anchorage Municipality,2019,3,20136,10487,9649
020,Anchorage Municipality,2019,4,18532,9533,8999
020,Anchorage Municipality,2019,5,20740,10967,9773
020,Anchorage Municipality,2019,6,24030,12376,11654
020,Anchorage Municipality,2019,7,24242,12174,12068
020,Anchorage Municipality,2019,8,21925,10953,10972
020,Anchorage Municipality,2019,9,17505,8763,8742
020,Anchorage Municipality,2019,10,17175,8483,8692
020,Anchorage Municipality,2019,11,17202,8525,8677
020,Anchorage Municipality,2019,12,19337,9681,9656
020,Anchorage Municipality,2019,13,17672,8639,9033
020,Anchorage Municipality,2019,14,13639,6822,6817
020,Anchorage Municipality,2019,15,9115,4454,4661
020,Anchorage Municipality,2019,16,5365,2487,2878
020,Anchorage Municipality,2019,17,3287,1424,1863
020,Anchorage Municipality,2019,18,2826,1036,1790
050,Bethel Census Area,2019,0,18176,9458,8718
050,Bethel Census Area,2019,1,1718,913,805
050,Bethel Census Area,2019,2,1848,940,908
050,Bethel Census Area,2019,3,1760,871,889
050,Bethel Census Area,2019,4,1583,848,735
050,Bethel Census Area,2019,5,1390,735,655
050,Bethel Census Area,2019,6,1524,761,763
050,Bethel Census Area,2019,7,1362,705,657
050,Bethel Census Area,2019,8,1062,548,514
050,Bethel Census Area,2019,9,860,441,419
050,Bethel Census Area,2019,10,858,442,416
050,Bethel Census Area,2019,11,911,514,397
050,Bethel Census Area,2019,12,1036,570,466
050,Bethel Census Area,2019,13,848,437,411
050,Bethel Census Area,2019,14,649,363,286
050,Bethel Census Area,2019,15,323,172,151
050,Bethel Census Area,2019,16,248,122,126
050,Bethel Census Area,2019,17,118,57,61
050,Bethel Census Area,2019,18,78,19,59
060,Bristol Bay Borough,2019,0,871,454,417
060,Bristol Bay Borough,2019,1,56,24,32
060,Bristol Bay Borough,2019,2,50,29,21
060,Bristol Bay Borough,2019,3,40,19,21
060,Bristol Bay Borough,2019,4,56,25,31
060,Bristol Bay Borough,2019,5,42,25,17
060,Bristol Bay Borough,2019,6,59,25,34
060,Bristol Bay Borough,2019,7,71,29,42
060,Bristol Bay Borough,2019,8,46,25,21
060,Bristol Bay Borough,2019,9,43,26,17
060,Bristol Bay Borough,2019,10,57,31,26
060,Bristol Bay Borough,2019,11,41,23,18
060,Bristol Bay Borough,2019,12,94,51,43
060,Bristol Bay Borough,2019,13,94,63,31
060,Bristol Bay Borough,2019,14,59,22,37
060,Bristol Bay Borough,2019,15,24,15,9
060,Bristol Bay Borough,2019,16,21,11,10
060,Bristol Bay Borough,2019,17,11,7,4
060,Bristol Bay Borough,2019,18,7,4,3
063,Chugach Census Area,2019,0,6750,3559,3191
063,Chugach Census Area,2019,1,486,247,239
063,Chugach Census Area,2019,2,448,229,219
063,Chugach Census Area,2019,3,448,230,218
063,Chugach Census Area,2019,4,393,214,179
063,Chugach Census Area,2019,5,290,165,125
063,Chugach Census Area,2019,6,518,273,245
063,Chugach Census Area,2019,7,570,315,255
063,Chugach Census Area,2019,8,502,255,247
063,Chugach Census Area,2019,9,423,230,193
063,Chugach Census Area,2019,10,389,197,192
063,Chugach Census Area,2019,11,422,239,183
063,Chugach Census Area,2019,12,532,287,245
063,Chugach Census Area,2019,13,522,270,252
063,Chugach Census Area,2019,14,371,197,174
063,Chugach Census Area,2019,15,216,110,106
063,Chugach Census Area,2019,16,125,63,62
063,Chugach Census Area,2019,17,52,24,28
063,Chugach Census Area,2019,18,43,14,29
066,Copper River Census Area,2019,0,2770,1468,1302
066,Copper River Census Area,2019,1,186,83,103
066,Copper River Census Area,2019,2,185,96,89
066,Copper River Census Area,2019,3,199,93,106
066,Copper River Census Area,2019,4,167,85,82
066,Copper River Census Area,2019,5,107,62,45
066,Copper River Census Area,2019,6,108,60,48
066,Copper River Census Area,2019,7,171,78,93
066,Copper River Census Area,2019,8,185,98,87
066,Copper River Census Area,2019,9,140,72,68
066,Copper River Census Area,2019,10,136,77,59
066,Copper River Census Area,2019,11,189,97,92
066,Copper River Census Area,2019,12,236,125,111
066,Copper River Census Area,2019,13,311,176,135
066,Copper River Census Area,2019,14,186,114,72
066,Copper River Census Area,2019,15,120,66,54
066,Copper River Census Area,2019,16,96,62,34
066,Copper River Census Area,2019,17,32,17,15
066,Copper River Census Area,2019,18,16,7,9
068,Denali Borough,2019,0,1863,1005,858
068,Denali Borough,2019,1,103,52,51
068,Denali Borough,2019,2,115,64,51
068,Denali Borough,2019,3,113,57,56
068,Denali Borough,2019,4,98,44,54
068,Denali Borough,2019,5,46,21,25
068,Denali Borough,2019,6,108,56,52
068,Denali Borough,2019,7,148,71,77
068,Denali Borough,2019,8,153,77,76
068,Denali Borough,2019,9,124,64,60
068,Denali Borough,2019,10,156,76,80
068,Denali Borough,2019,11,132,80,52
068,Denali Borough,2019,12,168,101,67
068,Denali Borough,2019,13,152,98,54
068,Denali Borough,2019,14,126,76,50
068,Denali Borough,2019,15,46,27,19
068,Denali Borough,2019,16,38,25,13
068,Denali Borough,2019,17,27,8,19
068,Denali Borough,2019,18,10,8,2
070,Dillingham Census Area,2019,0,4898,2540,2358
070,Dillingham Census Area,2019,1,446,215,231
070,Dillingham Census Area,2019,2,474,234,240
070,Dillingham Census Area,2019,3,417,223,194
070,Dillingham Census Area,2019,4,338,179,159
070,Dillingham Census Area,2019,5,335,174,161
070,Dillingham Census Area,2019,6,410,228,182
070,Dillingham Census Area,2019,7,325,157,168
070,Dillingham Census Area,2019,8,303,156,147
070,Dillingham Census Area,2019,9,197,97,100
070,Dillingham Census Area,2019,10,221,107,114
070,Dillingham Census Area,2019,11,286,151,135
070,Dillingham Census Area,2019,12,330,180,150
070,Dillingham Census Area,2019,13,330,192,138
070,Dillingham Census Area,2019,14,204,107,97
070,Dillingham Census Area,2019,15,110,50,60
070,Dillingham Census Area,2019,16,87,51,36
070,Dillingham Census Area,2019,17,55,27,28
070,Dillingham Census Area,2019,18,30,12,18
090,Fairbanks North Star Borough,2019,0,96095,50180,45915
090,Fairbanks North Star Borough,2019,1,6774,3459,3315
090,Fairbanks North Star Borough,2019,2,6708,3454,3254
090,Fairbanks North Star Borough,2019,3,6452,3335,3117
090,Fairbanks North Star Borough,2019,4,6070,3219,2851
090,Fairbanks North Star Borough,2019,5,7937,4639,3298
090,Fairbanks North Star Borough,2019,6,7762,4119,3643
090,Fairbanks North Star Borough,2019,7,7926,4131,3795
090,Fairbanks North Star Borough,2019,8,7161,3747,3414
090,Fairbanks North Star Borough,2019,9,5740,2987,2753
090,Fairbanks North Star Borough,2019,10,5163,2697,2466
090,Fairbanks North Star Borough,2019,11,5239,2665,2574
090,Fairbanks North Star Borough,2019,12,6192,3095,3097
090,Fairbanks North Star Borough,2019,13,5860,2981,2879
090,Fairbanks North Star Borough,2019,14,4635,2426,2209
090,Fairbanks North Star Borough,2019,15,3199,1666,1533
090,Fairbanks North Star Borough,2019,16,1682,863,819
090,Fairbanks North Star Borough,2019,17,858,411,447
090,Fairbanks North Star Borough,2019,18,737,286,451
100,Haines Borough,2019,0,2524,1250,1274
100,Haines Borough,2019,1,121,58,63
100,Haines Borough,2019,2,163,73,90
100,Haines Borough,2019,3,128,72,56
100,Haines Borough,2019,4,112,56,56
100,Haines Borough,2019,5,77,45,32
100,Haines Borough,2019,6,108,57,51
100,Haines Borough,2019,7,138,63,75
100,Haines Borough,2019,8,175,80,95
100,Haines Borough,2019,9,142,73,69
100,Haines Borough,2019,10,137,71,66
100,Haines Borough,2019,11,158,80,78
100,Haines Borough,2019,12,257,130,127
100,Haines Borough,2019,13,264,135,129
100,Haines Borough,2019,14,217,112,105
100,Haines Borough,2019,15,150,75,75
100,Haines Borough,2019,16,87,37,50
100,Haines Borough,2019,17,39,18,21
100,Haines Borough,2019,18,51,15,36
105,Hoonah-Angoon Census Area,2019,0,2155,1138,1017
105,Hoonah-Angoon Census Area,2019,1,114,49,65
105,Hoonah-Angoon Census Area,2019,2,127,66,61
105,Hoonah-Angoon Census Area,2019,3,140,65,75
105,Hoonah-Angoon Census Area,2019,4,100,44,56
105,Hoonah-Angoon Census Area,2019,5,69,33,36
105,Hoonah-Angoon Census Area,2019,6,112,69,43
105,Hoonah-Angoon Census Area,2019,7,110,62,48
105,Hoonah-Angoon Census Area,2019,8,126,62,64
105,Hoonah-Angoon Census Area,2019,9,114,54,60
105,Hoonah-Angoon Census Area,2019,10,119,64,55
105,Hoonah-Angoon Census Area,2019,11,135,75,60
105,Hoonah-Angoon Census Area,2019,12,187,97,90
105,Hoonah-Angoon Census Area,2019,13,207,108,99
105,Hoonah-Angoon Census Area,2019,14,225,119,106
105,Hoonah-Angoon Census Area,2019,15,114,70,44
105,Hoonah-Angoon Census Area,2019,16,83,54,29
105,Hoonah-Angoon Census Area,2019,17,54,37,17
105,Hoonah-Angoon Census Area,2019,18,19,10,9
110,Juneau City and Borough,2019,0,32059,16152,15907
110,Juneau City and Borough,2019,1,1757,872,885
110,Juneau City and Borough,2019,2,1985,1013,972
110,Juneau City and Borough,2019,3,2105,1066,1039
110,Juneau City and Borough,2019,4,1886,980,906
110,Juneau City and Borough,2019,5,1631,849,782
110,Juneau City and Borough,2019,6,2353,1183,1170
110,Juneau City and Borough,2019,7,2555,1283,1272
110,Juneau City and Borough,2019,8,2483,1248,1235
110,Juneau City and Borough,2019,9,2037,1016,1021
110,Juneau City and Borough,2019,10,1976,1018,958
110,Juneau City and Borough,2019,11,2190,1100,1090
110,Juneau City and Borough,2019,12,2398,1232,1166
110,Juneau City and Borough,2019,13,2245,1144,1101
110,Juneau City and Borough,2019,14,1851,902,949
110,Juneau City and Borough,2019,15,1265,679,586
110,Juneau City and Borough,2019,16,648,285,363
110,Juneau City and Borough,2019,17,407,179,228
110,Juneau City and Borough,2019,18,287,103,184
122,Kenai Peninsula Borough,2019,0,58499,30267,28232
122,Kenai Peninsula Borough,2019,1,3476,1751,1725
122,Kenai Peninsula Borough,2019,2,3731,1896,1835
122,Kenai Peninsula Borough,2019,3,3880,1997,1883
122,Kenai Peninsula Borough,2019,4,3433,1784,1649
122,Kenai Peninsula Borough,2019,5,2508,1411,1097
122,Kenai Peninsula Borough,2019,6,3418,1816,1602
122,Kenai Peninsula Borough,2019,7,3666,1865,1801
122,Kenai Peninsula Borough,2019,8,3930,2087,1843
122,Kenai Peninsula Borough,2019,9,3439,1856,1583
122,Kenai Peninsula Borough,2019,10,3367,1694,1673
122,Kenai Peninsula Borough,2019,11,3551,1849,1702
122,Kenai Peninsula Borough,2019,12,4453,2231,2222
122,Kenai Peninsula Borough,2019,13,4817,2411,2406
122,Kenai Peninsula Borough,2019,14,4249,2267,1982
122,Kenai Peninsula Borough,2019,15,2924,1551,1373
122,Kenai Peninsula Borough,2019,16,1946,1008,938
122,Kenai Peninsula Borough,2019,17,928,472,456
122,Kenai Peninsula Borough,2019,18,783,321,462
130,Ketchikan Gateway Borough,2019,0,13798,7015,6783
130,Ketchikan Gateway Borough,2019,1,736,380,356
130,Ketchikan Gateway Borough,2019,2,900,480,420
130,Ketchikan Gateway Borough,2019,3,898,446,452
130,Ketchikan Gateway Borough,2019,4,867,462,405
130,Ketchikan Gateway Borough,2019,5,755,414,341
130,Ketchikan Gateway Borough,2019,6,945,503,442
130,Ketchikan Gateway Borough,2019,7,931,447,484
130,Ketchikan Gateway Borough,2019,8,971,492,479
130,Ketchikan Gateway Borough,2019,9,813,414,399
130,Ketchikan Gateway Borough,2019,10,809,398,411
130,Ketchikan Gateway Borough,2019,11,864,419,445
130,Ketchikan Gateway Borough,2019,12,1050,550,500
130,Ketchikan Gateway Borough,2019,13,1030,503,527
130,Ketchikan Gateway Borough,2019,14,838,429,409
130,Ketchikan Gateway Borough,2019,15,606,284,322
130,Ketchikan Gateway Borough,2019,16,396,210,186
130,Ketchikan Gateway Borough,2019,17,217,112,105
130,Ketchikan Gateway Borough,2019,18,172,72,100
150,Kodiak Island Borough,2019,0,13029,6827,6202
150,Kodiak Island Borough,2019,1,938,491,447
150,Kodiak Island Borough,2019,2,950,495,455
150,Kodiak Island Borough,2019,3,984,510,474
150,Kodiak Island Borough,2019,4,837,464,373
150,Kodiak Island Borough,2019,5,813,451,362
150,Kodiak Island Borough,2019,6,1004,525,479
150,Kodiak Island Borough,2019,7,1018,561,457
150,Kodiak Island Borough,2019,8,920,478,442
150,Kodiak Island Borough,2019,9,771,386,385
150,Kodiak Island Borough,2019,10,709,358,351
150,Kodiak Island Borough,2019,11,759,383,376
150,Kodiak Island Borough,2019,12,913,506,407
150,Kodiak Island Borough,2019,13,877,492,385
150,Kodiak Island Borough,2019,14,623,301,322
150,Kodiak Island Borough,2019,15,444,212,232
150,Kodiak Island Borough,2019,16,242,123,119
150,Kodiak Island Borough,2019,17,124,58,66
150,Kodiak Island Borough,2019,18,103,33,70
158,Kusilvak Census Area,2019,0,8199,4278,3921
158,Kusilvak Census Area,2019,1,884,473,411
158,Kusilvak Census Area,2019,2,908,466,442
158,Kusilvak Census Area,2019,3,930,491,439
158,Kusilvak Census Area,2019,4,786,392,394
158,Kusilvak Census Area,2019,5,691,392,299
158,Kusilvak Census Area,2019,6,719,363,356
158,Kusilvak Census Area,2019,7,619,343,276
158,Kusilvak Census Area,2019,8,413,221,192
158,Kusilvak Census Area,2019,9,321,154,167
158,Kusilvak Census Area,2019,10,319,153,166
158,Kusilvak Census Area,2019,11,361,187,174
158,Kusilvak Census Area,2019,12,407,215,192
158,Kusilvak Census Area,2019,13,323,173,150
158,Kusilvak Census Area,2019,14,217,119,98
158,Kusilvak Census Area,2019,15,149,78,71
158,Kusilvak Census Area,2019,16,66,30,36
158,Kusilvak Census Area,2019,17,36,14,22
158,Kusilvak Census Area,2019,18,50,14,36
164,Lake and Peninsula Borough,2019,0,1625,843,782
164,Lake and Peninsula Borough,2019,1,155,77,78
164,Lake and Peninsula Borough,2019,2,133,70,63
164,Lake and Peninsula Borough,2019,3,127,61,66
164,Lake and Peninsula Borough,2019,4,104,49,55
164,Lake and Peninsula Borough,2019,5,93,44,49
164,Lake and Peninsula Borough,2019,6,120,61,59
164,Lake and Peninsula Borough,2019,7,135,74,61
164,Lake and Peninsula Borough,2019,8,123,52,71
164,Lake and Peninsula Borough,2019,9,86,54,32
164,Lake and Peninsula Borough,2019,10,59,33,26
164,Lake and Peninsula Borough,2019,11,89,46,43
164,Lake and Peninsula Borough,2019,12,125,77,48
164,Lake and Peninsula Borough,2019,13,108,53,55
164,Lake and Peninsula Borough,2019,14,82,46,36
164,Lake and Peninsula Borough,2019,15,35,22,13
164,Lake and Peninsula Borough,2019,16,22,11,11
164,Lake and Peninsula Borough,2019,17,18,11,7
164,Lake and Peninsula Borough,2019,18,11,2,9
170,Matanuska-Susitna Borough,2019,0,106782,54721,52061
170,Matanuska-Susitna Borough,2019,1,7665,3965,3700
170,Matanuska-Susitna Borough,2019,2,8657,4411,4246
170,Matanuska-Susitna Borough,2019,3,8819,4557,4262
170,Matanuska-Susitna Borough,2019,4,7443,3994,3449
170,Matanuska-Susitna Borough,2019,5,5128,2738,2390
170,Matanuska-Susitna Borough,2019,6,6745,3388,3357
170,Matanuska-Susitna Borough,2019,7,7589,3729,3860
170,Matanuska-Susitna Borough,2019,8,7828,4006,3822
170,Matanuska-Susitna Borough,2019,9,6660,3493,3167
170,Matanuska-Susitna Borough,2019,10,6333,3218,3115
170,Matanuska-Susitna Borough,2019,11,6332,3232,3100
170,Matanuska-Susitna Borough,2019,12,7167,3704,3463
170,Matanuska-Susitna Borough,2019,13,6893,3446,3447
170,Matanuska-Susitna Borough,2019,14,5671,2887,2784
170,Matanuska-Susitna Borough,2019,15,3652,1860,1792
170,Matanuska-Susitna Borough,2019,16,2135,1129,1006
170,Matanuska-Susitna Borough,2019,17,1135,562,573
170,Matanuska-Susitna Borough,2019,18,930,402,528
180,Nome Census Area,2019,0,9850,5180,4670
180,Nome Census Area,2019,1,852,397,455
180,Nome Census Area,2019,2,952,505,447
180,Nome Census Area,2019,3,990,536,454
180,Nome Census Area,2019,4,808,434,374
180,Nome Census Area,2019,5,652,354,298
180,Nome Census Area,2019,6,821,421,400
180,Nome Census Area,2019,7,780,394,386
180,Nome Census Area,2019,8,639,338,301
180,Nome Census Area,2019,9,563,302,261
180,Nome Census Area,2019,10,477,249,228
180,Nome Census Area,2019,11,491,291,200
180,Nome Census Area,2019,12,529,266,263
180,Nome Census Area,2019,13,510,265,245
180,Nome Census Area,2019,14,347,192,155
180,Nome Census Area,2019,15,216,137,79
180,Nome Census Area,2019,16,102,41,61
180,Nome Census Area,2019,17,81,38,43
180,Nome Census Area,2019,18,40,20,20
185,North Slope Borough,2019,0,9904,6051,3853
185,North Slope Borough,2019,1,656,334,322
185,North Slope Borough,2019,2,785,396,389
185,North Slope Borough,2019,3,774,401,373
185,North Slope Borough,2019,4,575,299,276
185,North Slope Borough,2019,5,557,335,222
185,North Slope Borough,2019,6,870,508,362
185,North Slope Borough,2019,7,1001,651,350
185,North Slope Borough,2019,8,864,603,261
185,North Slope Borough,2019,9,552,336,216
185,North Slope Borough,2019,10,559,383,176
185,North Slope Borough,2019,11,779,560,219
185,North Slope Borough,2019,12,795,540,255
185,North Slope Borough,2019,13,581,377,204
185,North Slope Borough,2019,14,318,203,115
185,North Slope Borough,2019,15,125,75,50
185,North Slope Borough,2019,16,47,24,23
185,North Slope Borough,2019,17,42,15,27
185,North Slope Borough,2019,18,24,11,13
188,Northwest Arctic Borough,2019,0,7730,4151,3579
188,Northwest Arctic Borough,2019,1,701,350,351
188,Northwest Arctic Borough,2019,2,804,415,389
188,Northwest Arctic Borough,2019,3,795,426,369
188,Northwest Arctic Borough,2019,4,621,331,290
188,Northwest Arctic Borough,2019,5,537,287,250
188,Northwest Arctic Borough,2019,6,599,319,280
188,Northwest Arctic Borough,2019,7,644,357,287
188,Northwest Arctic Borough,2019,8,493,264,229
188,Northwest Arctic Borough,2019,9,372,195,177
188,Northwest Arctic Borough,2019,10,343,185,158
188,Northwest Arctic Borough,2019,11,439,276,163
188,Northwest Arctic Borough,2019,12,435,248,187
188,Northwest Arctic Borough,2019,13,364,199,165
188,Northwest Arctic Borough,2019,14,216,129,87
188,Northwest Arctic Borough,2019,15,177,91,86
188,Northwest Arctic Borough,2019,16,69,33,36
188,Northwest Arctic Borough,2019,17,62,35,27
188,Northwest Arctic Borough,2019,18,59,11,48
195,Petersburg Borough,2019,0,3233,1628,1605
195,Petersburg Borough,2019,1,191,97,94
195,Petersburg Borough,2019,2,229,95,134
195,Petersburg Borough,2019,3,210,108,102
195,Petersburg Borough,2019,4,156,75,81
195,Petersburg Borough,2019,5,125,72,53
195,Petersburg Borough,2019,6,179,83,96
195,Petersburg Borough,2019,7,210,102,108
195,Petersburg Borough,2019,8,212,98,114
195,Petersburg Borough,2019,9,187,90,97
195,Petersburg Borough,2019,10,214,108,106
195,Petersburg Borough,2019,11,187,106,81
195,Petersburg Borough,2019,12,225,119,106
195,Petersburg Borough,2019,13,268,133,135
195,Petersburg Borough,2019,14,241,143,98
195,Petersburg Borough,2019,15,185,88,97
195,Petersburg Borough,2019,16,112,65,47
195,Petersburg Borough,2019,17,47,23,24
195,Petersburg Borough,2019,18,55,23,32
198,Prince of Wales-Hyder Census Area,2019,0,6203,3370,2833
198,Prince of Wales-Hyder Census Area,2019,1,377,214,163
198,Prince of Wales-Hyder Census Area,2019,2,441,210,231
198,Prince of Wales-Hyder Census Area,2019,3,481,258,223
198,Prince of Wales-Hyder Census Area,2019,4,357,213,144
198,Prince of Wales-Hyder Census Area,2019,5,265,148,117
198,Prince of Wales-Hyder Census Area,2019,6,305,156,149
198,Prince of Wales-Hyder Census Area,2019,7,425,195,230
198,Prince of Wales-Hyder Census Area,2019,8,390,212,178
198,Prince of Wales-Hyder Census Area,2019,9,346,189,157
198,Prince of Wales-Hyder Census Area,2019,10,346,192,154
198,Prince of Wales-Hyder Census Area,2019,11,419,229,190
198,Prince of Wales-Hyder Census Area,2019,12,533,315,218
198,Prince of Wales-Hyder Census Area,2019,13,515,251,264
198,Prince of Wales-Hyder Census Area,2019,14,457,273,184
198,Prince of Wales-Hyder Census Area,2019,15,242,147,95
198,Prince of Wales-Hyder Census Area,2019,16,182,103,79
198,Prince of Wales-Hyder Census Area,2019,17,81,43,38
198,Prince of Wales-Hyder Census Area,2019,18,41,22,19
220,Sitka City and Borough,2019,0,8552,4323,4229
220,Sitka City and Borough,2019,1,437,251,186
220,Sitka City and Borough,2019,2,470,257,213
220,Sitka City and Borough,2019,3,581,325,256
220,Sitka City and Borough,2019,4,500,245,255
220,Sitka City and Borough,2019,5,425,229,196
220,Sitka City and Borough,2019,6,600,282,318
220,Sitka City and Borough,2019,7,638,291,347
220,Sitka City and Borough,2019,8,610,325,285
220,Sitka City and Borough,2019,9,578,306,272
220,Sitka City and Borough,2019,10,499,258,241
220,Sitka City and Borough,2019,11,507,250,257
220,Sitka City and Borough,2019,12,632,329,303
220,Sitka City and Borough,2019,13,660,335,325
220,Sitka City and Borough,2019,14,495,236,259
220,Sitka City and Borough,2019,15,347,172,175
220,Sitka City and Borough,2019,16,236,110,126
220,Sitka City and Borough,2019,17,194,77,117
220,Sitka City and Borough,2019,18,143,45,98
230,"Skagway Borough, Municipality",2019,0,1099,545,554
230,"Skagway Borough, Municipality",2019,1,70,28,42
230,"Skagway Borough, Municipality",2019,2,60,42,18
230,"Skagway Borough, Municipality",2019,3,55,28,27
230,"Skagway Borough, Municipality",2019,4,28,15,13
230,"Skagway Borough, Municipality",2019,5,35,15,20
230,"Skagway Borough, Municipality",2019,6,91,38,53
230,"Skagway Borough, Municipality",2019,7,78,33,45
230,"Skagway Borough, Municipality",2019,8,96,51,45
230,"Skagway Borough, Municipality",2019,9,116,58,58
230,"Skagway Borough, Municipality",2019,10,87,42,45
230,"Skagway Borough, Municipality",2019,11,89,50,39
230,"Skagway Borough, Municipality",2019,12,62,37,25
230,"Skagway Borough, Municipality",2019,13,71,42,29
230,"Skagway Borough, Municipality",2019,14,69,32,37
230,"Skagway Borough, Municipality",2019,15,43,22,21
230,"Skagway Borough, Municipality",2019,16,32,6,26
230,"Skagway Borough, Municipality",2019,17,14,6,8
230,"Skagway Borough, Municipality",2019,18,3,0,3
240,Southeast Fairbanks Census Area,2019,0,6900,3779,3121
240,Southeast Fairbanks Census Area,2019,1,422,206,216
240,Southeast Fairbanks Census Area,2019,2,494,254,240
240,Southeast Fairbanks Census Area,2019,3,503,265,238
240,Southeast Fairbanks Census Area,2019,4,432,244,188
240,Southeast Fairbanks Census Area,2019,5,288,148,140
240,Southeast Fairbanks Census Area,2019,6,450,257,193
240,Southeast Fairbanks Census Area,2019,7,516,263,253
240,Southeast Fairbanks Census Area,2019,8,467,269,198
240,Southeast Fairbanks Census Area,2019,9,421,240,181
240,Southeast Fairbanks Census Area,2019,10,415,243,172
240,Southeast Fairbanks Census Area,2019,11,437,231,206
240,Southeast Fairbanks Census Area,2019,12,495,282,213
240,Southeast Fairbanks Census Area,2019,13,483,266,217
240,Southeast Fairbanks Census Area,2019,14,412,264,148
240,Southeast Fairbanks Census Area,2019,15,304,163,141
240,Southeast Fairbanks Census Area,2019,16,167,91,76
240,Southeast Fairbanks Census Area,2019,17,106,61,45
240,Southeast Fairbanks Census Area,2019,18,88,32,56
275,Wrangell City and Borough,2019,0,2406,1205,1201
275,Wrangell City and Borough,2019,1,126,62,64
275,Wrangell City and Borough,2019,2,183,76,107
275,Wrangell City and Borough,2019,3,148,77,71
275,Wrangell City and Borough,2019,4,107,56,51
275,Wrangell City and Borough,2019,5,82,38,44
275,Wrangell City and Borough,2019,6,130,50,80
275,Wrangell City and Borough,2019,7,120,60,60
275,Wrangell City and Borough,2019,8,142,86,56
275,Wrangell City and Borough,2019,9,98,36,62
275,Wrangell City and Borough,2019,10,134,67,67
275,Wrangell City and Borough,2019,11,131,64,67
275,Wrangell City and Borough,2019,12,208,108,100
275,Wrangell City and Borough,2019,13,268,134,134
275,Wrangell City and Borough,2019,14,202,118,84
275,Wrangell City and Borough,2019,15,141,79,62
275,Wrangell City and Borough,2019,16,86,46,40
275,Wrangell City and Borough,2019,17,56,34,22
275,Wrangell City and Borough,2019,18,44,14,30
282,Yakutat City and Borough,2019,0,542,296,246
282,Yakutat City and Borough,2019,1,36,19,17
282,Yakutat City and Borough,2019,2,32,15,17
282,Yakutat City and Borough,2019,3,29,11,18
282,Yakutat City and Borough,2019,4,30,13,17
282,Yakutat City and Borough,2019,5,21,12,9
282,Yakutat City and Borough,2019,6,32,18,14
282,Yakutat City and Borough,2019,7,30,12,18
282,Yakutat City and Borough,2019,8,41,26,15
282,Yakutat City and Borough,2019,9,28,18,10
282,Yakutat City and Borough,2019,10,35,22,13
282,Yakutat City and Borough,2019,11,48,32,16
282,Yakutat City and Borough,2019,12,30,18,12
282,Yakutat City and Borough,2019,13,43,27,16
282,Yakutat City and Borough,2019,14,46,24,22
282,Yakutat City and Borough,2019,15,29,16,13
282,Yakutat City and Borough,2019,16,8,6,2
282,Yakutat City and Borough,2019,17,20,6,14
282,Yakutat City and Borough,2019,18,4,1,3
290,Yukon-Koyukuk Census Area,2019,0,5209,2749,2460
290,Yukon-Koyukuk Census Area,2019,1,378,185,193
290,Yukon-Koyukuk Census Area,2019,2,402,207,195
290,Yukon-Koyukuk Census Area,2019,3,434,224,210
290,Yukon-Koyukuk Census Area,2019,4,344,190,154
290,Yukon-Koyukuk Census Area,2019,5,250,138,112
290,Yukon-Koyukuk Census Area,2019,6,333,173,160
290,Yukon-Koyukuk Census Area,2019,7,355,182,173
290,Yukon-Koyukuk Census Area,2019,8,325,170,155
290,Yukon-Koyukuk Census Area,2019,9,279,150,129
290,Yukon-Koyukuk Census Area,2019,10,256,131,125
290,Yukon-Koyukuk Census Area,2019,11,275,151,124
290,Yukon-Koyukuk Census Area,2019,12,344,185,159
290,Yukon-Koyukuk Census Area,2019,13,434,231,203
290,Yukon-Koyukuk Census Area,2019,14,328,182,146
290,Yukon-Koyukuk Census Area,2019,15,217,110,107
290,Yukon-Koyukuk Census Area,2019,16,115,67,48
290,Yukon-Koyukuk Census Area,2019,17,82,50,32
290,Yukon-Koyukuk Census Area,2019,18,58,23,35
000,Alaska,2020,0,728903,375017,353886
000,Alaska,2020,1,48323,24847,23476
000,Alaska,2020,2,51987,26546,25441
000,Alaska,2020,3,52815,27280,25535
000,Alaska,2020,4,46684,24435,22249
000,Alaska,2020,5,45738,25065,20673
000,Alaska,2020,6,52868,27566,25302
000,Alaska,2020,7,57116,29073,28043
000,Alaska,2020,8,54715,28264,26451
000,Alaska,2020,9,44877,23111,21766
000,Alaska,2020,10,40978,20937,20041
000,Alaska,2020,11,42648,21907,20741
000,Alaska,2020,12,48055,24755,23300
000,Alaska,2020,13,46854,23882,22972
000,Alaska,2020,14,38405,19689,18716
000,Alaska,2020,15,26079,13355,12724
000,Alaska,2020,16,15430,7667,7763
000,Alaska,2020,17,8399,3951,4448
000,Alaska,2020,18,6932,2687,4245
013,Aleutians East Borough,2020,0,2925,1887,1038
013,Aleutians East Borough,2020,1,70,43,27
013,Aleutians East Borough,2020,2,86,34,52
013,Aleutians East Borough,2020,3,91,43,48
013,Aleutians East Borough,2020,4,98,61,37
013,Aleutians East Borough,2020,5,202,149,53
013,Aleutians East Borough,2020,6,165,113,52
013,Aleutians East Borough,2020,7,211,143,68
013,Aleutians East Borough,2020,8,311,197,114
013,Aleutians East Borough,2020,9,253,162,91
013,Aleutians East Borough,2020,10,254,181,73
013,Aleutians East Borough,2020,11,324,225,99
013,Aleutians East Borough,2020,12,397,254,143
013,Aleutians East Borough,2020,13,217,130,87
013,Aleutians East Borough,2020,14,104,69,35
013,Aleutians East Borough,2020,15,82,49,33
013,Aleutians East Borough,2020,16,38,21,17
013,Aleutians East Borough,2020,17,15,10,5
013,Aleutians East Borough,2020,18,7,3,4
016,Aleutians West Census Area,2020,0,5544,3598,1946
016,Aleutians West Census Area,2020,1,214,112,102
016,Aleutians West Census Area,2020,2,249,110,139
016,Aleutians West Census Area,2020,3,238,141,97
016,Aleutians West Census Area,2020,4,232,143,89
016,Aleutians West Census Area,2020,5,274,173,101
016,Aleutians West Census Area,2020,6,480,360,120
016,Aleutians West Census Area,2020,7,492,321,171
016,Aleutians West Census Area,2020,8,510,334,176
016,Aleutians West Census Area,2020,9,473,335,138
016,Aleutians West Census Area,2020,10,394,259,135
016,Aleutians West Census Area,2020,11,605,364,241
016,Aleutians West Census Area,2020,12,517,347,170
016,Aleutians West Census Area,2020,13,427,299,128
016,Aleutians West Census Area,2020,14,293,213,80
016,Aleutians West Census Area,2020,15,106,67,39
016,Aleutians West Census Area,2020,16,21,11,10
016,Aleutians West Census Area,2020,17,10,5,5
016,Aleutians West Census Area,2020,18,9,4,5
020,Anchorage Municipality,2020,0,288970,145203,143767
020,Anchorage Municipality,2020,1,19146,9879,9267
020,Anchorage Municipality,2020,2,19718,10015,9703
020,Anchorage Municipality,2020,3,19791,10263,9528
020,Anchorage Municipality,2020,4,18225,9378,8847
020,Anchorage Municipality,2020,5,20410,10821,9589
020,Anchorage Municipality,2020,6,22950,11820,11130
020,Anchorage Municipality,2020,7,24138,12086,12052
020,Anchorage Municipality,2020,8,22248,11195,11053
020,Anchorage Municipality,2020,9,17902,8896,9006
020,Anchorage Municipality,2020,10,16553,8084,8469
020,Anchorage Municipality,2020,11,16791,8372,8419
020,Anchorage Municipality,2020,12,18343,9078,9265
020,Anchorage Municipality,2020,13,17300,8494,8806
020,Anchorage Municipality,2020,14,14034,6997,7037
020,Anchorage Municipality,2020,15,9511,4675,4836
020,Anchorage Municipality,2020,16,5725,2650,3075
020,Anchorage Municipality,2020,17,3302,1441,1861
020,Anchorage Municipality,2020,18,2883,1059,1824
050,Bethel Census Area,2020,0,17868,9301,8567
050,Bethel Census Area,2020,1,1719,929,790
050,Bethel Census Area,2020,2,1790,931,859
050,Bethel Census Area,2020,3,1716,844,872
050,Bethel Census Area,2020,4,1565,829,736
050,Bethel Census Area,2020,5,1355,716,639
050,Bethel Census Area,2020,6,1473,730,743
050,Bethel Census Area,2020,7,1363,701,662
050,Bethel Census Area,2020,8,1023,523,500
050,Bethel Census Area,2020,9,883,445,438
050,Bethel Census Area,2020,10,830,429,401
050,Bethel Census Area,2020,11,852,487,365
050,Bethel Census Area,2020,12,997,531,466
050,Bethel Census Area,2020,13,838,450,388
050,Bethel Census Area,2020,14,655,366,289
050,Bethel Census Area,2020,15,356,184,172
050,Bethel Census Area,2020,16,261,128,133
050,Bethel Census Area,2020,17,115,57,58
050,Bethel Census Area,2020,18,77,21,56
060,Bristol Bay Borough,2020,0,868,458,410
060,Bristol Bay Borough,2020,1,52,24,28
060,Bristol Bay Borough,2020,2,60,38,22
060,Bristol Bay Borough,2020,3,43,19,24
060,Bristol Bay Borough,2020,4,50,23,27
060,Bristol Bay Borough,2020,5,40,23,17
060,Bristol Bay Borough,2020,6,70,30,40
060,Bristol Bay Borough,2020,7,55,25,30
060,Bristol Bay Borough,2020,8,52,29,23
060,Bristol Bay Borough,2020,9,38,22,16
060,Bristol Bay Borough,2020,10,58,30,28
060,Bristol Bay Borough,2020,11,41,23,18
060,Bristol Bay Borough,2020,12,80,44,36
060,Bristol Bay Borough,2020,13,101,62,39
060,Bristol Bay Borough,2020,14,58,25,33
060,Bristol Bay Borough,2020,15,28,17,11
060,Bristol Bay Borough,2020,16,25,15,10
060,Bristol Bay Borough,2020,17,11,6,5
060,Bristol Bay Borough,2020,18,6,3,3
063,Chugach Census Area,2020,0,6751,3584,3167
063,Chugach Census Area,2020,1,452,230,222
063,Chugach Census Area,2020,2,501,264,237
063,Chugach Census Area,2020,3,452,233,219
063,Chugach Census Area,2020,4,378,218,160
063,Chugach Census Area,2020,5,291,161,130
063,Chugach Census Area,2020,6,501,280,221
063,Chugach Census Area,2020,7,562,304,258
063,Chugach Census Area,2020,8,517,271,246
063,Chugach Census Area,2020,9,440,230,210
063,Chugach Census Area,2020,10,381,201,180
063,Chugach Census Area,2020,11,426,231,195
063,Chugach Census Area,2020,12,497,274,223
063,Chugach Census Area,2020,13,521,269,252
063,Chugach Census Area,2020,14,396,202,194
063,Chugach Census Area,2020,15,215,108,107
063,Chugach Census Area,2020,16,125,71,54
063,Chugach Census Area,2020,17,54,22,32
063,Chugach Census Area,2020,18,42,15,27
066,Copper River Census Area,2020,0,2699,1428,1271
066,Copper River Census Area,2020,1,169,76,93
066,Copper River Census Area,2020,2,196,105,91
066,Copper River Census Area,2020,3,197,97,100
066,Copper River Census Area,2020,4,170,86,84
066,Copper River Census Area,2020,5,98,58,40
066,Copper River Census Area,2020,6,102,51,51
066,Copper River Census Area,2020,7,154,67,87
066,Copper River Census Area,2020,8,183,96,87
066,Copper River Census Area,2020,9,147,76,71
066,Copper River Census Area,2020,10,140,79,61
066,Copper River Census Area,2020,11,182,94,88
066,Copper River Census Area,2020,12,212,115,97
066,Copper River Census Area,2020,13,302,167,135
066,Copper River Census Area,2020,14,179,104,75
066,Copper River Census Area,2020,15,124,71,53
066,Copper River Census Area,2020,16,94,60,34
066,Copper River Census Area,2020,17,37,20,17
066,Copper River Census Area,2020,18,13,6,7
068,Denali Borough,2020,0,1806,966,840
068,Denali Borough,2020,1,87,40,47
068,Denali Borough,2020,2,110,58,52
068,Denali Borough,2020,3,111,59,52
068,Denali Borough,2020,4,79,34,45
068,Denali Borough,2020,5,42,20,22
068,Denali Borough,2020,6,110,57,53
068,Denali Borough,2020,7,145,64,81
068,Denali Borough,2020,8,150,78,72
068,Denali Borough,2020,9,134,66,68
068,Denali Borough,2020,10,134,68,66
068,Denali Borough,2020,11,123,74,49
068,Denali Borough,2020,12,158,86,72
068,Denali Borough,2020,13,167,111,56
068,Denali Borough,2020,14,119,71,48
068,Denali Borough,2020,15,49,32,17
068,Denali Borough,2020,16,41,23,18
068,Denali Borough,2020,17,38,17,21
068,Denali Borough,2020,18,9,8,1
070,Dillingham Census Area,2020,0,4773,2481,2292
070,Dillingham Census Area,2020,1,425,222,203
070,Dillingham Census Area,2020,2,438,210,228
070,Dillingham Census Area,2020,3,417,224,193
070,Dillingham Census Area,2020,4,340,169,171
070,Dillingham Census Area,2020,5,327,174,153
070,Dillingham Census Area,2020,6,380,205,175
070,Dillingham Census Area,2020,7,370,189,181
070,Dillingham Census Area,2020,8,284,143,141
070,Dillingham Census Area,2020,9,222,110,112
070,Dillingham Census Area,2020,10,188,90,98
070,Dillingham Census Area,2020,11,252,142,110
070,Dillingham Census Area,2020,12,335,174,161
070,Dillingham Census Area,2020,13,300,174,126
070,Dillingham Census Area,2020,14,211,106,105
070,Dillingham Census Area,2020,15,114,56,58
070,Dillingham Census Area,2020,16,92,52,40
070,Dillingham Census Area,2020,17,57,32,25
070,Dillingham Census Area,2020,18,21,9,12
090,Fairbanks North Star Borough,2020,0,97159,50570,46589
090,Fairbanks North Star Borough,2020,1,6641,3365,3276
090,Fairbanks North Star Borough,2020,2,6809,3482,3327
090,Fairbanks North Star Borough,2020,3,6631,3412,3219
090,Fairbanks North Star Borough,2020,4,6104,3183,2921
090,Fairbanks North Star Borough,2020,5,7841,4608,3233
090,Fairbanks North Star Borough,2020,6,7698,4122,3576
090,Fairbanks North Star Borough,2020,7,7923,4060,3863
090,Fairbanks North Star Borough,2020,8,7496,3924,3572
090,Fairbanks North Star Borough,2020,9,5920,3103,2817
090,Fairbanks North Star Borough,2020,10,5176,2665,2511
090,Fairbanks North Star Borough,2020,11,5205,2636,2569
090,Fairbanks North Star Borough,2020,12,6030,3035,2995
090,Fairbanks North Star Borough,2020,13,5860,2997,2863
090,Fairbanks North Star Borough,2020,14,4823,2470,2353
090,Fairbanks North Star Borough,2020,15,3444,1795,1649
090,Fairbanks North Star Borough,2020,16,1844,959,885
090,Fairbanks North Star Borough,2020,17,953,464,489
090,Fairbanks North Star Borough,2020,18,761,290,471
100,Haines Borough,2020,0,2520,1254,1266
100,Haines Borough,2020,1,113,57,56
100,Haines Borough,2020,2,162,73,89
100,Haines Borough,2020,3,125,73,52
100,Haines Borough,2020,4,108,51,57
100,Haines Borough,2020,5,75,38,37
100,Haines Borough,2020,6,111,61,50
100,Haines Borough,2020,7,127,57,70
100,Haines Borough,2020,8,184,88,96
100,Haines Borough,2020,9,153,71,82
100,Haines Borough,2020,10,143,74,69
100,Haines Borough,2020,11,166,90,76
100,Haines Borough,2020,12,238,120,118
100,Haines Borough,2020,13,251,136,115
100,Haines Borough,2020,14,223,119,104
100,Haines Borough,2020,15,155,71,84
100,Haines Borough,2020,16,92,44,48
100,Haines Borough,2020,17,46,15,31
100,Haines Borough,2020,18,48,16,32
105,Hoonah-Angoon Census Area,2020,0,2074,1094,980
105,Hoonah-Angoon Census Area,2020,1,99,47,52
105,Hoonah-Angoon Census Area,2020,2,117,61,56
105,Hoonah-Angoon Census Area,2020,3,134,68,66
105,Hoonah-Angoon Census Area,2020,4,103,43,60
105,Hoonah-Angoon Census Area,2020,5,69,30,39
105,Hoonah-Angoon Census Area,2020,6,99,61,38
105,Hoonah-Angoon Census Area,2020,7,116,62,54
105,Hoonah-Angoon Census Area,2020,8,120,59,61
105,Hoonah-Angoon Census Area,2020,9,105,49,56
105,Hoonah-Angoon Census Area,2020,10,104,53,51
105,Hoonah-Angoon Census Area,2020,11,129,76,53
105,Hoonah-Angoon Census Area,2020,12,157,72,85
105,Hoonah-Angoon Census Area,2020,13,206,108,98
105,Hoonah-Angoon Census Area,2020,14,212,113,99
105,Hoonah-Angoon Census Area,2020,15,139,82,57
105,Hoonah-Angoon Census Area,2020,16,87,57,30
105,Hoonah-Angoon Census Area,2020,17,58,43,15
105,Hoonah-Angoon Census Area,2020,18,20,10,10
110,Juneau City and Borough,2020,0,31773,16051,15722
110,Juneau City and Borough,2020,1,1707,853,854
110,Juneau City and Borough,2020,2,1952,1000,952
110,Juneau City and Borough,2020,3,2051,1013,1038
110,Juneau City and Borough,2020,4,1882,968,914
110,Juneau City and Borough,2020,5,1548,816,732
110,Juneau City and Borough,2020,6,2262,1202,1060
110,Juneau City and Borough,2020,7,2561,1279,1282
110,Juneau City and Borough,2020,8,2545,1267,1278
110,Juneau City and Borough,2020,9,2111,1072,1039
110,Juneau City and Borough,2020,10,1915,1009,906
110,Juneau City and Borough,2020,11,2101,1033,1068
110,Juneau City and Borough,2020,12,2350,1204,1146
110,Juneau City and Borough,2020,13,2215,1143,1072
110,Juneau City and Borough,2020,14,1858,869,989
110,Juneau City and Borough,2020,15,1333,718,615
110,Juneau City and Borough,2020,16,681,297,384
110,Juneau City and Borough,2020,17,418,194,224
110,Juneau City and Borough,2020,18,283,114,169
122,Kenai Peninsula Borough,2020,0,58934,30586,28348
122,Kenai Peninsula Borough,2020,1,3466,1744,1722
122,Kenai Peninsula Borough,2020,2,3693,1903,1790
122,Kenai Peninsula Borough,2020,3,3956,1997,1959
122,Kenai Peninsula Borough,2020,4,3418,1803,1615
122,Kenai Peninsula Borough,2020,5,2483,1402,1081
122,Kenai Peninsula Borough,2020,6,3353,1788,1565
122,Kenai Peninsula Borough,2020,7,3744,1903,1841
122,Kenai Peninsula Borough,2020,8,4108,2184,1924
122,Kenai Peninsula Borough,2020,9,3506,1890,1616
122,Kenai Peninsula Borough,2020,10,3296,1690,1606
122,Kenai Peninsula Borough,2020,11,3539,1836,1703
122,Kenai Peninsula Borough,2020,12,4262,2127,2135
122,Kenai Peninsula Borough,2020,13,4793,2445,2348
122,Kenai Peninsula Borough,2020,14,4335,2287,2048
122,Kenai Peninsula Borough,2020,15,3172,1669,1503
122,Kenai Peninsula Borough,2020,16,2043,1094,949
122,Kenai Peninsula Borough,2020,17,938,481,457
122,Kenai Peninsula Borough,2020,18,829,343,486
130,Ketchikan Gateway Borough,2020,0,13677,6942,6735
130,Ketchikan Gateway Borough,2020,1,685,354,331
130,Ketchikan Gateway Borough,2020,2,844,447,397
130,Ketchikan Gateway Borough,2020,3,894,450,444
130,Ketchikan Gateway Borough,2020,4,861,455,406
130,Ketchikan Gateway Borough,2020,5,762,426,336
130,Ketchikan Gateway Borough,2020,6,848,456,392
130,Ketchikan Gateway Borough,2020,7,938,434,504
130,Ketchikan Gateway Borough,2020,8,1011,505,506
130,Ketchikan Gateway Borough,2020,9,862,441,421
130,Ketchikan Gateway Borough,2020,10,792,384,408
130,Ketchikan Gateway Borough,2020,11,868,417,451
130,Ketchikan Gateway Borough,2020,12,998,539,459
130,Ketchikan Gateway Borough,2020,13,1009,500,509
130,Ketchikan Gateway Borough,2020,14,852,413,439
130,Ketchikan Gateway Borough,2020,15,638,307,331
130,Ketchikan Gateway Borough,2020,16,422,228,194
130,Ketchikan Gateway Borough,2020,17,218,113,105
130,Ketchikan Gateway Borough,2020,18,175,73,102
150,Kodiak Island Borough,2020,0,12611,6580,6031
150,Kodiak Island Borough,2020,1,805,420,385
150,Kodiak Island Borough,2020,2,930,499,431
150,Kodiak Island Borough,2020,3,971,500,471
150,Kodiak Island Borough,2020,4,788,426,362
150,Kodiak Island Borough,2020,5,791,448,343
150,Kodiak Island Borough,2020,6,891,458,433
150,Kodiak Island Borough,2020,7,998,562,436
150,Kodiak Island Borough,2020,8,935,494,441
150,Kodiak Island Borough,2020,9,762,367,395
150,Kodiak Island Borough,2020,10,691,341,350
150,Kodiak Island Borough,2020,11,743,369,374
150,Kodiak Island Borough,2020,12,855,455,400
150,Kodiak Island Borough,2020,13,842,490,352
150,Kodiak Island Borough,2020,14,663,304,359
150,Kodiak Island Borough,2020,15,452,225,227
150,Kodiak Island Borough,2020,16,253,131,122
150,Kodiak Island Borough,2020,17,126,52,74
150,Kodiak Island Borough,2020,18,115,39,76
158,Kusilvak Census Area,2020,0,8088,4248,3840
158,Kusilvak Census Area,2020,1,860,475,385
158,Kusilvak Census Area,2020,2,865,446,419
158,Kusilvak Census Area,2020,3,940,513,427
158,Kusilvak Census Area,2020,4,793,390,403
158,Kusilvak Census Area,2020,5,688,386,302
158,Kusilvak Census Area,2020,6,649,328,321
158,Kusilvak Census Area,2020,7,621,344,277
158,Kusilvak Census Area,2020,8,421,223,198
158,Kusilvak Census Area,2020,9,325,161,164
158,Kusilvak Census Area,2020,10,316,154,162
158,Kusilvak Census Area,2020,11,360,180,180
158,Kusilvak Census Area,2020,12,383,204,179
158,Kusilvak Census Area,2020,13,338,183,155
158,Kusilvak Census Area,2020,14,217,122,95
158,Kusilvak Census Area,2020,15,154,76,78
158,Kusilvak Census Area,2020,16,74,33,41
158,Kusilvak Census Area,2020,17,37,17,20
158,Kusilvak Census Area,2020,18,47,13,34
164,Lake and Peninsula Borough,2020,0,1552,800,752
164,Lake and Peninsula Borough,2020,1,138,69,69
164,Lake and Peninsula Borough,2020,2,121,61,60
164,Lake and Peninsula Borough,2020,3,124,62,62
164,Lake and Peninsula Borough,2020,4,108,50,58
164,Lake and Peninsula Borough,2020,5,80,34,46
164,Lake and Peninsula Borough,2020,6,110,53,57
164,Lake and Peninsula Borough,2020,7,119,70,49
164,Lake and Peninsula Borough,2020,8,124,51,73
164,Lake and Peninsula Borough,2020,9,93,58,35
164,Lake and Peninsula Borough,2020,10,60,30,30
164,Lake and Peninsula Borough,2020,11,81,40,41
164,Lake and Peninsula Borough,2020,12,115,70,45
164,Lake and Peninsula Borough,2020,13,113,58,55
164,Lake and Peninsula Borough,2020,14,76,42,34
164,Lake and Peninsula Borough,2020,15,42,26,16
164,Lake and Peninsula Borough,2020,16,21,12,9
164,Lake and Peninsula Borough,2020,17,18,11,7
164,Lake and Peninsula Borough,2020,18,9,3,6
170,Matanuska-Susitna Borough,2020,0,107305,55119,52186
170,Matanuska-Susitna Borough,2020,1,7371,3824,3547
170,Matanuska-Susitna Borough,2020,2,8588,4376,4212
170,Matanuska-Susitna Borough,2020,3,8967,4664,4303
170,Matanuska-Susitna Borough,2020,4,7459,3983,3476
170,Matanuska-Susitna Borough,2020,5,5155,2798,2357
170,Matanuska-Susitna Borough,2020,6,6547,3288,3259
170,Matanuska-Susitna Borough,2020,7,7578,3798,3780
170,Matanuska-Susitna Borough,2020,8,8148,4148,4000
170,Matanuska-Susitna Borough,2020,9,6903,3571,3332
170,Matanuska-Susitna Borough,2020,10,6267,3268,2999
170,Matanuska-Susitna Borough,2020,11,6262,3158,3104
170,Matanuska-Susitna Borough,2020,12,6962,3657,3305
170,Matanuska-Susitna Borough,2020,13,6944,3455,3489
170,Matanuska-Susitna Borough,2020,14,5843,2965,2878
170,Matanuska-Susitna Borough,2020,15,3899,1991,1908
170,Matanuska-Susitna Borough,2020,16,2243,1158,1085
170,Matanuska-Susitna Borough,2020,17,1193,576,617
170,Matanuska-Susitna Borough,2020,18,976,441,535
180,Nome Census Area,2020,0,9769,5154,4615
180,Nome Census Area,2020,1,796,390,406
180,Nome Census Area,2020,2,931,471,460
180,Nome Census Area,2020,3,966,527,439
180,Nome Census Area,2020,4,808,426,382
180,Nome Census Area,2020,5,672,379,293
180,Nome Census Area,2020,6,816,424,392
180,Nome Census Area,2020,7,786,396,390
180,Nome Census Area,2020,8,651,342,309
180,Nome Census Area,2020,9,585,341,244
180,Nome Census Area,2020,10,468,244,224
180,Nome Census Area,2020,11,452,260,192
180,Nome Census Area,2020,12,532,270,262
180,Nome Census Area,2020,13,504,245,259
180,Nome Census Area,2020,14,369,204,165
180,Nome Census Area,2020,15,206,130,76
180,Nome Census Area,2020,16,115,47,68
180,Nome Census Area,2020,17,70,39,31
180,Nome Census Area,2020,18,42,19,23
185,North Slope Borough,2020,0,9771,5922,3849
185,North Slope Borough,2020,1,639,310,329
185,North Slope Borough,2020,2,760,392,368
185,North Slope Borough,2020,3,779,391,388
185,North Slope Borough,2020,4,605,332,273
185,North Slope Borough,2020,5,581,339,242
185,North Slope Borough,2020,6,791,478,313
185,North Slope Borough,2020,7,992,631,361
185,North Slope Borough,2020,8,914,622,292
185,North Slope Borough,2020,9,558,342,216
185,North Slope Borough,2020,10,561,380,181
185,North Slope Borough,2020,11,658,464,194
185,North Slope Borough,2020,12,754,524,230
185,North Slope Borough,2020,13,633,409,224
185,North Slope Borough,2020,14,314,190,124
185,North Slope Borough,2020,15,123,70,53
185,North Slope Borough,2020,16,47,26,21
185,North Slope Borough,2020,17,40,14,26
185,North Slope Borough,2020,18,22,8,14
188,Northwest Arctic Borough,2020,0,7583,4072,3511
188,Northwest Arctic Borough,2020,1,691,358,333
188,Northwest Arctic Borough,2020,2,755,408,347
188,Northwest Arctic Borough,2020,3,797,400,397
188,Northwest Arctic Borough,2020,4,613,341,272
188,Northwest Arctic Borough,2020,5,510,272,238
188,Northwest Arctic Borough,2020,6,538,266,272
188,Northwest Arctic Borough,2020,7,665,378,287
188,Northwest Arctic Borough,2020,8,488,264,224
188,Northwest Arctic Borough,2020,9,383,187,196
188,Northwest Arctic Borough,2020,10,353,199,154
188,Northwest Arctic Borough,2020,11,394,243,151
188,Northwest Arctic Borough,2020,12,432,239,193
188,Northwest Arctic Borough,2020,13,362,204,158
188,Northwest Arctic Borough,2020,14,239,143,96
188,Northwest Arctic Borough,2020,15,158,80,78
188,Northwest Arctic Borough,2020,16,89,48,41
188,Northwest Arctic Borough,2020,17,58,29,29
188,Northwest Arctic Borough,2020,18,58,13,45
195,Petersburg Borough,2020,0,3189,1601,1588
195,Petersburg Borough,2020,1,177,88,89
195,Petersburg Borough,2020,2,218,90,128
195,Petersburg Borough,2020,3,224,118,106
195,Petersburg Borough,2020,4,146,75,71
195,Petersburg Borough,2020,5,117,66,51
195,Petersburg Borough,2020,6,176,82,94
195,Petersburg Borough,2020,7,212,110,102
195,Petersburg Borough,2020,8,213,100,113
195,Petersburg Borough,2020,9,184,82,102
195,Petersburg Borough,2020,10,198,98,100
195,Petersburg Borough,2020,11,192,112,80
195,Petersburg Borough,2020,12,215,112,103
195,Petersburg Borough,2020,13,244,118,126
195,Petersburg Borough,2020,14,248,146,102
195,Petersburg Borough,2020,15,193,88,105
195,Petersburg Borough,2020,16,128,72,56
195,Petersburg Borough,2020,17,51,21,30
195,Petersburg Borough,2020,18,53,23,30
198,Prince of Wales-Hyder Census Area,2020,0,6090,3323,2767
198,Prince of Wales-Hyder Census Area,2020,1,353,195,158
198,Prince of Wales-Hyder Census Area,2020,2,431,229,202
198,Prince of Wales-Hyder Census Area,2020,3,457,231,226
198,Prince of Wales-Hyder Census Area,2020,4,345,204,141
198,Prince of Wales-Hyder Census Area,2020,5,256,142,114
198,Prince of Wales-Hyder Census Area,2020,6,264,134,130
198,Prince of Wales-Hyder Census Area,2020,7,441,208,233
198,Prince of Wales-Hyder Census Area,2020,8,380,204,176
198,Prince of Wales-Hyder Census Area,2020,9,341,195,146
198,Prince of Wales-Hyder Census Area,2020,10,334,191,143
198,Prince of Wales-Hyder Census Area,2020,11,430,232,198
198,Prince of Wales-Hyder Census Area,2020,12,528,311,217
198,Prince of Wales-Hyder Census Area,2020,13,497,252,245
198,Prince of Wales-Hyder Census Area,2020,14,476,276,200
198,Prince of Wales-Hyder Census Area,2020,15,260,159,101
198,Prince of Wales-Hyder Census Area,2020,16,178,97,81
198,Prince of Wales-Hyder Census Area,2020,17,79,41,38
198,Prince of Wales-Hyder Census Area,2020,18,40,22,18
220,Sitka City and Borough,2020,0,8523,4246,4277
220,Sitka City and Borough,2020,1,459,240,219
220,Sitka City and Borough,2020,2,477,258,219
220,Sitka City and Borough,2020,3,537,298,239
220,Sitka City and Borough,2020,4,485,241,244
220,Sitka City and Borough,2020,5,439,245,194
220,Sitka City and Borough,2020,6,560,256,304
220,Sitka City and Borough,2020,7,629,283,346
220,Sitka City and Borough,2020,8,624,316,308
220,Sitka City and Borough,2020,9,605,319,286
220,Sitka City and Borough,2020,10,489,236,253
220,Sitka City and Borough,2020,11,504,253,251
220,Sitka City and Borough,2020,12,598,304,294
220,Sitka City and Borough,2020,13,639,325,314
220,Sitka City and Borough,2020,14,529,251,278
220,Sitka City and Borough,2020,15,359,186,173
220,Sitka City and Borough,2020,16,254,117,137
220,Sitka City and Borough,2020,17,183,73,110
220,Sitka City and Borough,2020,18,153,45,108
230,"Skagway Borough, Municipality",2020,0,1147,570,577
230,"Skagway Borough, Municipality",2020,1,62,25,37
230,"Skagway Borough, Municipality",2020,2,66,39,27
230,"Skagway Borough, Municipality",2020,3,64,40,24
230,"Skagway Borough, Municipality",2020,4,29,14,15
230,"Skagway Borough, Municipality",2020,5,31,14,17
230,"Skagway Borough, Municipality",2020,6,77,31,46
230,"Skagway Borough, Municipality",2020,7,99,43,56
230,"Skagway Borough, Municipality",2020,8,96,56,40
230,"Skagway Borough, Municipality",2020,9,129,58,71
230,"Skagway Borough, Municipality",2020,10,94,51,43
230,"Skagway Borough, Municipality",2020,11,91,47,44
230,"Skagway Borough, Municipality",2020,12,63,39,24
230,"Skagway Borough, Municipality",2020,13,70,38,32
230,"Skagway Borough, Municipality",2020,14,74,37,37
230,"Skagway Borough, Municipality",2020,15,43,22,21
230,"Skagway Borough, Municipality",2020,16,39,6,33
230,"Skagway Borough, Municipality",2020,17,16,9,7
230,"Skagway Borough, Municipality",2020,18,4,1,3
240,Southeast Fairbanks Census Area,2020,0,6937,3789,3148
240,Southeast Fairbanks Census Area,2020,1,404,200,204
240,Southeast Fairbanks Census Area,2020,2,529,264,265
240,Southeast Fairbanks Census Area,2020,3,519,284,235
240,Southeast Fairbanks Census Area,2020,4,427,242,185
240,Southeast Fairbanks Census Area,2020,5,283,153,130
240,Southeast Fairbanks Census Area,2020,6,387,211,176
240,Southeast Fairbanks Census Area,2020,7,578,312,266
240,Southeast Fairbanks Census Area,2020,8,483,279,204
240,Southeast Fairbanks Census Area,2020,9,423,231,192
240,Southeast Fairbanks Census Area,2020,10,391,234,157
240,Southeast Fairbanks Census Area,2020,11,434,228,206
240,Southeast Fairbanks Census Area,2020,12,476,269,207
240,Southeast Fairbanks Census Area,2020,13,474,263,211
240,Southeast Fairbanks Census Area,2020,14,429,261,168
240,Southeast Fairbanks Census Area,2020,15,317,175,142
240,Southeast Fairbanks Census Area,2020,16,170,87,83
240,Southeast Fairbanks Census Area,2020,17,102,57,45
240,Southeast Fairbanks Census Area,2020,18,111,39,72
275,Wrangell City and Borough,2020,0,2379,1193,1186
275,Wrangell City and Borough,2020,1,124,63,61
275,Wrangell City and Borough,2020,2,166,66,100
275,Wrangell City and Borough,2020,3,158,77,81
275,Wrangell City and Borough,2020,4,120,66,54
275,Wrangell City and Borough,2020,5,61,35,26
275,Wrangell City and Borough,2020,6,125,51,74
275,Wrangell City and Borough,2020,7,130,59,71
275,Wrangell City and Borough,2020,8,148,88,60
275,Wrangell City and Borough,2020,9,101,40,61
275,Wrangell City and Borough,2020,10,128,73,55
275,Wrangell City and Borough,2020,11,127,54,73
275,Wrangell City and Borough,2020,12,198,102,96
275,Wrangell City and Borough,2020,13,245,125,120
275,Wrangell City and Borough,2020,14,199,102,97
275,Wrangell City and Borough,2020,15,146,89,57
275,Wrangell City and Borough,2020,16,94,50,44
275,Wrangell City and Borough,2020,17,58,35,23
275,Wrangell City and Borough,2020,18,51,18,33
282,Yakutat City and Borough,2020,0,574,315,259
282,Yakutat City and Borough,2020,1,35,22,13
282,Yakutat City and Borough,2020,2,42,19,23
282,Yakutat City and Borough,2020,3,27,7,20
282,Yakutat City and Borough,2020,4,37,20,17
282,Yakutat City and Borough,2020,5,20,10,10
282,Yakutat City and Borough,2020,6,31,18,13
282,Yakutat City and Borough,2020,7,34,12,22
282,Yakutat City and Borough,2020,8,43,28,15
282,Yakutat City and Borough,2020,9,39,25,14
282,Yakutat City and Borough,2020,10,32,22,10
282,Yakutat City and Borough,2020,11,49,32,17
282,Yakutat City and Borough,2020,12,34,20,14
282,Yakutat City and Borough,2020,13,41,20,21
282,Yakutat City and Borough,2020,14,45,25,20
282,Yakutat City and Borough,2020,15,30,17,13
282,Yakutat City and Borough,2020,16,8,5,3
282,Yakutat City and Borough,2020,17,20,11,9
282,Yakutat City and Borough,2020,18,7,2,5
290,Yukon-Koyukuk Census Area,2020,0,5044,2682,2362
290,Yukon-Koyukuk Census Area,2020,1,364,193,171
290,Yukon-Koyukuk Census Area,2020,2,383,197,186
290,Yukon-Koyukuk Census Area,2020,3,438,232,206
290,Yukon-Koyukuk Census Area,2020,4,308,181,127
290,Yukon-Koyukuk Census Area,2020,5,237,129,108
290,Yukon-Koyukuk Census Area,2020,6,304,152,152
290,Yukon-Koyukuk Census Area,2020,7,335,172,163
290,Yukon-Koyukuk Census Area,2020,8,305,156,149
290,Yukon-Koyukuk Census Area,2020,9,297,166,131
290,Yukon-Koyukuk Census Area,2020,10,238,120,118
290,Yukon-Koyukuk Census Area,2020,11,267,135,132
290,Yukon-Koyukuk Census Area,2020,12,339,179,160
290,Yukon-Koyukuk Census Area,2020,13,401,212,189
290,Yukon-Koyukuk Census Area,2020,14,332,197,135
290,Yukon-Koyukuk Census Area,2020,15,231,120,111
290,Yukon-Koyukuk Census Area,2020,16,126,68,58
290,Yukon-Koyukuk Census Area,2020,17,78,46,32
290,Yukon-Koyukuk Census Area,2020,18,61,27,34
