SUMLEV,STATE,COUNTY,STNAME,CTYNAME,YEAR,AGEGRP,TOT_POP,TOT_MALE,TOT_FEMALE
50,12,1,Florida,Alachua County,1,0,247336,119786,127550
50,12,1,Florida,Alachua County,1,1,13068,6703,6365
50,12,1,Florida,Alachua County,1,2,11739,5913,5826
50,12,1,Florida,Alachua County,1,3,11669,5992,5677
50,12,1,Florida,Alachua County,1,4,23589,10942,12647
50,12,1,Florida,Alachua County,1,5,41515,19979,21536
50,12,1,Florida,Alachua County,1,6,21724,11365,10359
50,12,1,Florida,Alachua County,1,7,15256,7917,7339
50,12,1,Florida,Alachua County,1,8,13043,6566,6477
50,12,1,Florida,Alachua County,1,9,12465,6091,6374
50,12,1,Florida,Alachua County,1,10,14262,6829,7433
50,12,1,Florida,Alachua County,1,11,15208,7034,8174
50,12,1,Florida,Alachua County,1,12,14800,7036,7764
50,12,1,Florida,Alachua County,1,13,12371,5903,6468
50,12,1,Florida,Alachua County,1,14,8593,4156,4437
50,12,1,Florida,Alachua County,1,15,5987,2623,3364
50,12,1,Florida,Alachua County,1,16,4589,2016,2573
50,12,1,Florida,Alachua County,1,17,3786,1476,2310
50,12,1,Florida,Alachua County,1,18,3672,1245,2427
50,12,1,Florida,Alachua County,2,0,247337,119786,127551
50,12,1,Florida,Alachua County,2,1,13068,6703,6365
50,12,1,Florida,Alachua County,2,2,11739,5913,5826
50,12,1,Florida,Alachua County,2,3,11669,5992,5677
50,12,1,Florida,Alachua County,2,4,23589,10942,12647
50,12,1,Florida,Alachua County,2,5,41515,19979,21536
50,12,1,Florida,Alachua County,2,6,21724,11365,10359
50,12,1,Florida,Alachua County,2,7,15256,7917,7339
50,12,1,Florida,Alachua County,2,8,13043,6566,6477
50,12,1,Florida,Alachua County,2,9,12465,6091,6374
50,12,1,Florida,Alachua County,2,10,14261,6828,7433
50,12,1,Florida,Alachua County,2,11,15208,7034,8174
50,12,1,Florida,Alachua County,2,12,14800,7036,7764
50,12,1,Florida,Alachua County,2,13,12373,5904,6469
50,12,1,Florida,Alachua County,2,14,8593,4156,4437
50,12,1,Florida,Alachua County,2,15,5987,2623,3364
50,12,1,Florida,Alachua County,2,16,4589,2016,2573
50,12,1,Florida,Alachua County,2,17,3786,1476,2310
50,12,1,Florida,Alachua County,2,18,3672,1245,2427
50,12,1,Florida,Alachua County,3,0,247614,119953,127661
50,12,1,Florida,Alachua County,3,1,13119,6733,6386
50,12,1,Florida,Alachua County,3,2,11730,5914,5816
50,12,1,Florida,Alachua County,3,3,11708,5995,5713
50,12,1,Florida,Alachua County,3,4,23126,10809,12317
50,12,1,Florida,Alachua County,3,5,42004,20175,21829
50,12,1,Florida,Alachua County,3,6,21650,11337,10313
50,12,1,Florida,Alachua County,3,7,15353,7961,7392
50,12,1,Florida,Alachua County,3,8,13004,6542,6462
50,12,1,Florida,Alachua County,3,9,12493,6126,6367
50,12,1,Florida,Alachua County,3,10,14105,6746,7359
50,12,1,Florida,Alachua County,3,11,15160,7021,8139
50,12,1,Florida,Alachua County,3,12,14789,7009,7780
50,12,1,Florida,Alachua County,3,13,12514,5961,6553
50,12,1,Florida,Alachua County,3,14,8704,4208,4496
50,12,1,Florida,Alachua County,3,15,6040,2658,3382
50,12,1,Florida,Alachua County,3,16,4601,1996,2605
50,12,1,Florida,Alachua County,3,17,3794,1495,2299
50,12,1,Florida,Alachua County,3,18,3720,1267,2453
50,12,1,Florida,Alachua County,4,0,249834,120911,128923
50,12,1,Florida,Alachua County,4,1,13496,6994,6502
50,12,1,Florida,Alachua County,4,2,11832,5957,5875
50,12,1,Florida,Alachua County,4,3,11903,6057,5846
50,12,1,Florida,Alachua County,4,4,21564,10251,11313
50,12,1,Florida,Alachua County,4,5,43729,20822,22907
50,12,1,Florida,Alachua County,4,6,21412,11073,10339
50,12,1,Florida,Alachua County,4,7,15934,8210,7724
50,12,1,Florida,Alachua County,4,8,12997,6578,6419
50,12,1,Florida,Alachua County,4,9,12790,6326,6464
50,12,1,Florida,Alachua County,4,10,13651,6517,7134
50,12,1,Florida,Alachua County,4,11,15051,7046,8005
50,12,1,Florida,Alachua County,4,12,14749,6914,7835
50,12,1,Florida,Alachua County,4,13,13154,6195,6959
50,12,1,Florida,Alachua County,4,14,9071,4383,4688
50,12,1,Florida,Alachua County,4,15,6273,2799,3474
50,12,1,Florida,Alachua County,4,16,4678,1981,2697
50,12,1,Florida,Alachua County,4,17,3757,1507,2250
50,12,1,Florida,Alachua County,4,18,3793,1301,2492
50,12,1,Florida,Alachua County,5,0,251520,121651,129869
50,12,1,Florida,Alachua County,5,1,13847,7114,6733
50,12,1,Florida,Alachua County,5,2,12023,6107,5916
50,12,1,Florida,Alachua County,5,3,11794,5986,5808
50,12,1,Florida,Alachua County,5,4,20623,9909,10714
50,12,1,Florida,Alachua County,5,5,44185,21171,23014
50,12,1,Florida,Alachua County,5,6,20986,10704,10282
50,12,1,Florida,Alachua County,5,7,16695,8516,8179
50,12,1,Florida,Alachua County,5,8,13093,6651,6442
50,12,1,Florida,Alachua County,5,9,12854,6293,6561
50,12,1,Florida,Alachua County,5,10,13160,6248,6912
50,12,1,Florida,Alachua County,5,11,14829,6997,7832
50,12,1,Florida,Alachua County,5,12,14879,6927,7952
50,12,1,Florida,Alachua County,5,13,13480,6311,7169
50,12,1,Florida,Alachua County,5,14,9929,4781,5148
50,12,1,Florida,Alachua County,5,15,6625,3002,3623
50,12,1,Florida,Alachua County,5,16,4786,2022,2764
50,12,1,Florida,Alachua County,5,17,3767,1517,2250
50,12,1,Florida,Alachua County,5,18,3965,1395,2570
50,12,1,Florida,Alachua County,6,0,252475,122063,130412
50,12,1,Florida,Alachua County,6,1,13833,7100,6733
50,12,1,Florida,Alachua County,6,2,12439,6332,6107
50,12,1,Florida,Alachua County,6,3,11779,5943,5836
50,12,1,Florida,Alachua County,6,4,20370,9743,10627
50,12,1,Florida,Alachua County,6,5,43886,21305,22581
50,12,1,Florida,Alachua County,6,6,20839,10393,10446
50,12,1,Florida,Alachua County,6,7,17075,8740,8335
50,12,1,Florida,Alachua County,6,8,13287,6681,6606
50,12,1,Florida,Alachua County,6,9,12737,6256,6481
50,12,1,Florida,Alachua County,6,10,12758,6143,6615
50,12,1,Florida,Alachua County,6,11,14369,6754,7615
50,12,1,Florida,Alachua County,6,12,15049,6993,8056
50,12,1,Florida,Alachua County,6,13,13636,6294,7342
50,12,1,Florida,Alachua County,6,14,10505,4994,5511
50,12,1,Florida,Alachua County,6,15,7163,3339,3824
50,12,1,Florida,Alachua County,6,16,4849,2068,2781
50,12,1,Florida,Alachua County,6,17,3828,1561,2267
50,12,1,Florida,Alachua County,6,18,4073,1424,2649
50,12,1,Florida,Alachua County,7,0,255456,123596,131860
50,12,1,Florida,Alachua County,7,1,14045,7205,6840
50,12,1,Florida,Alachua County,7,2,12729,6502,6227
50,12,1,Florida,Alachua County,7,3,11813,5974,5839
50,12,1,Florida,Alachua County,7,4,20473,9735,10738
50,12,1,Florida,Alachua County,7,5,43680,21307,22373
50,12,1,Florida,Alachua County,7,6,21140,10541,10599
50,12,1,Florida,Alachua County,7,7,17360,8864,8496
50,12,1,Florida,Alachua County,7,8,13675,6853,6822
50,12,1,Florida,Alachua County,7,9,12845,6343,6502
50,12,1,Florida,Alachua County,7,10,12603,6120,6483
50,12,1,Florida,Alachua County,7,11,14328,6703,7625
50,12,1,Florida,Alachua County,7,12,14879,6930,7949
50,12,1,Florida,Alachua County,7,13,13973,6436,7537
50,12,1,Florida,Alachua County,7,14,11192,5255,5937
50,12,1,Florida,Alachua County,7,15,7616,3577,4039
50,12,1,Florida,Alachua County,7,16,5123,2169,2954
50,12,1,Florida,Alachua County,7,17,3803,1592,2211
50,12,1,Florida,Alachua County,7,18,4179,1490,2689
50,12,1,Florida,Alachua County,8,0,259052,125383,133669
50,12,1,Florida,Alachua County,8,1,14223,7271,6952
50,12,1,Florida,Alachua County,8,2,12988,6673,6315
50,12,1,Florida,Alachua County,8,3,11917,6100,5817
50,12,1,Florida,Alachua County,8,4,20772,9779,10993
50,12,1,Florida,Alachua County,8,5,43150,21137,22013
50,12,1,Florida,Alachua County,8,6,22166,11084,11082
50,12,1,Florida,Alachua County,8,7,17485,8818,8667
50,12,1,Florida,Alachua County,8,8,14174,7125,7049
50,12,1,Florida,Alachua County,8,9,12954,6421,6533
50,12,1,Florida,Alachua County,8,10,12623,6148,6475
50,12,1,Florida,Alachua County,8,11,14088,6643,7445
50,12,1,Florida,Alachua County,8,12,14876,6804,8072
50,12,1,Florida,Alachua County,8,13,14164,6588,7576
50,12,1,Florida,Alachua County,8,14,11834,5530,6304
50,12,1,Florida,Alachua County,8,15,8168,3837,4331
50,12,1,Florida,Alachua County,8,16,5350,2278,3072
50,12,1,Florida,Alachua County,8,17,3809,1568,2241
50,12,1,Florida,Alachua County,8,18,4311,1579,2732
50,12,1,Florida,Alachua County,9,0,263959,127745,136214
50,12,1,Florida,Alachua County,9,1,14247,7201,7046
50,12,1,Florida,Alachua County,9,2,13516,6944,6572
50,12,1,Florida,Alachua County,9,3,12222,6259,5963
50,12,1,Florida,Alachua County,9,4,21540,10121,11419
50,12,1,Florida,Alachua County,9,5,42556,20949,21607
50,12,1,Florida,Alachua County,9,6,23351,11605,11746
50,12,1,Florida,Alachua County,9,7,17661,8911,8750
50,12,1,Florida,Alachua County,9,8,15044,7554,7490
50,12,1,Florida,Alachua County,9,9,12942,6390,6552
50,12,1,Florida,Alachua County,9,10,12958,6387,6571
50,12,1,Florida,Alachua County,9,11,13725,6477,7248
50,12,1,Florida,Alachua County,9,12,14931,6920,8011
50,12,1,Florida,Alachua County,9,13,14280,6557,7723
50,12,1,Florida,Alachua County,9,14,12545,5845,6700
50,12,1,Florida,Alachua County,9,15,8538,3998,4540
50,12,1,Florida,Alachua County,9,16,5675,2467,3208
50,12,1,Florida,Alachua County,9,17,3842,1555,2287
50,12,1,Florida,Alachua County,9,18,4386,1605,2781
50,12,1,Florida,Alachua County,10,0,266309,128758,137551
50,12,1,Florida,Alachua County,10,1,14048,7076,6972
50,12,1,Florida,Alachua County,10,2,13747,7029,6718
50,12,1,Florida,Alachua County,10,3,12433,6311,6122
50,12,1,Florida,Alachua County,10,4,21448,10117,11331
50,12,1,Florida,Alachua County,10,5,42015,20653,21362
50,12,1,Florida,Alachua County,10,6,23933,11935,11998
50,12,1,Florida,Alachua County,10,7,17757,8964,8793
50,12,1,Florida,Alachua County,10,8,15610,7804,7806
50,12,1,Florida,Alachua County,10,9,13168,6509,6659
50,12,1,Florida,Alachua County,10,10,13184,6460,6724
50,12,1,Florida,Alachua County,10,11,13362,6314,7048
50,12,1,Florida,Alachua County,10,12,14765,6901,7864
50,12,1,Florida,Alachua County,10,13,14385,6610,7775
50,12,1,Florida,Alachua County,10,14,12696,5810,6886
50,12,1,Florida,Alachua County,10,15,9369,4364,5005
50,12,1,Florida,Alachua County,10,16,6012,2669,3343
50,12,1,Florida,Alachua County,10,17,3934,1601,2333
50,12,1,Florida,Alachua County,10,18,4443,1631,2812
50,12,1,Florida,Alachua County,11,0,268851,129748,139103
50,12,1,Florida,Alachua County,11,1,14041,7076,6965
50,12,1,Florida,Alachua County,11,2,13888,7060,6828
50,12,1,Florida,Alachua County,11,3,12998,6646,6352
50,12,1,Florida,Alachua County,11,4,21341,10021,11320
50,12,1,Florida,Alachua County,11,5,41741,20422,21319
50,12,1,Florida,Alachua County,11,6,23903,11957,11946
50,12,1,Florida,Alachua County,11,7,18112,9025,9087
50,12,1,Florida,Alachua County,11,8,16079,8050,8029
50,12,1,Florida,Alachua County,11,9,13489,6613,6876
50,12,1,Florida,Alachua County,11,10,13197,6492,6705
50,12,1,Florida,Alachua County,11,11,13080,6253,6827
50,12,1,Florida,Alachua County,11,12,14622,6828,7794
50,12,1,Florida,Alachua County,11,13,14553,6647,7906
50,12,1,Florida,Alachua County,11,14,12942,5877,7065
50,12,1,Florida,Alachua County,11,15,9830,4517,5313
50,12,1,Florida,Alachua County,11,16,6484,2958,3526
50,12,1,Florida,Alachua County,11,17,4016,1647,2369
50,12,1,Florida,Alachua County,11,18,4535,1659,2876
50,12,1,Florida,Alachua County,12,0,269043,129680,139363
50,12,1,Florida,Alachua County,12,1,13818,6959,6859
50,12,1,Florida,Alachua County,12,2,13879,7073,6806
50,12,1,Florida,Alachua County,12,3,13213,6670,6543
50,12,1,Florida,Alachua County,12,4,21383,10094,11289
50,12,1,Florida,Alachua County,12,5,40970,19950,21020
50,12,1,Florida,Alachua County,12,6,23193,11601,11592
50,12,1,Florida,Alachua County,12,7,18554,9241,9313
50,12,1,Florida,Alachua County,12,8,16310,8233,8077
50,12,1,Florida,Alachua County,12,9,13812,6744,7068
50,12,1,Florida,Alachua County,12,10,13110,6476,6634
50,12,1,Florida,Alachua County,12,11,12776,6123,6653
50,12,1,Florida,Alachua County,12,12,14353,6692,7661
50,12,1,Florida,Alachua County,12,13,14400,6548,7852
50,12,1,Florida,Alachua County,12,14,13283,6027,7256
50,12,1,Florida,Alachua County,12,15,10365,4714,5651
50,12,1,Florida,Alachua County,12,16,6854,3161,3693
50,12,1,Florida,Alachua County,12,17,4227,1705,2522
50,12,1,Florida,Alachua County,12,18,4543,1669,2874
50,12,3,Florida,Baker County,1,0,27115,14160,12955
50,12,3,Florida,Baker County,1,1,1933,1004,929
50,12,3,Florida,Baker County,1,2,1991,998,993
50,12,3,Florida,Baker County,1,3,1962,1006,956
50,12,3,Florida,Baker County,1,4,1877,1006,871
50,12,3,Florida,Baker County,1,5,1766,966,800
50,12,3,Florida,Baker County,1,6,1893,1037,856
50,12,3,Florida,Baker County,1,7,1782,998,784
50,12,3,Florida,Baker County,1,8,1853,1031,822
50,12,3,Florida,Baker County,1,9,1931,1062,869
50,12,3,Florida,Baker County,1,10,2088,1150,938
50,12,3,Florida,Baker County,1,11,1930,975,955
50,12,3,Florida,Baker County,1,12,1692,853,839
50,12,3,Florida,Baker County,1,13,1461,713,748
50,12,3,Florida,Baker County,1,14,1063,538,525
50,12,3,Florida,Baker County,1,15,766,384,382
50,12,3,Florida,Baker County,1,16,520,225,295
50,12,3,Florida,Baker County,1,17,368,145,223
50,12,3,Florida,Baker County,1,18,239,69,170
50,12,3,Florida,Baker County,2,0,27115,14160,12955
50,12,3,Florida,Baker County,2,1,1933,1004,929
50,12,3,Florida,Baker County,2,2,1991,998,993
50,12,3,Florida,Baker County,2,3,1962,1006,956
50,12,3,Florida,Baker County,2,4,1877,1006,871
50,12,3,Florida,Baker County,2,5,1766,966,800
50,12,3,Florida,Baker County,2,6,1893,1037,856
50,12,3,Florida,Baker County,2,7,1782,998,784
50,12,3,Florida,Baker County,2,8,1853,1031,822
50,12,3,Florida,Baker County,2,9,1931,1062,869
50,12,3,Florida,Baker County,2,10,2088,1150,938
50,12,3,Florida,Baker County,2,11,1930,975,955
50,12,3,Florida,Baker County,2,12,1692,853,839
50,12,3,Florida,Baker County,2,13,1461,713,748
50,12,3,Florida,Baker County,2,14,1063,538,525
50,12,3,Florida,Baker County,2,15,766,384,382
50,12,3,Florida,Baker County,2,16,520,225,295
50,12,3,Florida,Baker County,2,17,368,145,223
50,12,3,Florida,Baker County,2,18,239,69,170
50,12,3,Florida,Baker County,3,0,27066,14146,12920
50,12,3,Florida,Baker County,3,1,1913,994,919
50,12,3,Florida,Baker County,3,2,1986,1001,985
50,12,3,Florida,Baker County,3,3,1971,1008,963
50,12,3,Florida,Baker County,3,4,1849,994,855
50,12,3,Florida,Baker County,3,5,1775,972,803
50,12,3,Florida,Baker County,3,6,1887,1038,849
50,12,3,Florida,Baker County,3,7,1772,985,787
50,12,3,Florida,Baker County,3,8,1843,1025,818
50,12,3,Florida,Baker County,3,9,1929,1063,866
50,12,3,Florida,Baker County,3,10,2075,1145,930
50,12,3,Florida,Baker County,3,11,1937,986,951
50,12,3,Florida,Baker County,3,12,1695,858,837
50,12,3,Florida,Baker County,3,13,1463,713,750
50,12,3,Florida,Baker County,3,14,1069,540,529
50,12,3,Florida,Baker County,3,15,775,387,388
50,12,3,Florida,Baker County,3,16,522,227,295
50,12,3,Florida,Baker County,3,17,362,140,222
50,12,3,Florida,Baker County,3,18,243,70,173
50,12,3,Florida,Baker County,4,0,27049,14118,12931
50,12,3,Florida,Baker County,4,1,1867,980,887
50,12,3,Florida,Baker County,4,2,1993,1022,971
50,12,3,Florida,Baker County,4,3,2014,1034,980
50,12,3,Florida,Baker County,4,4,1765,958,807
50,12,3,Florida,Baker County,4,5,1829,987,842
50,12,3,Florida,Baker County,4,6,1876,1048,828
50,12,3,Florida,Baker County,4,7,1782,962,820
50,12,3,Florida,Baker County,4,8,1801,994,807
50,12,3,Florida,Baker County,4,9,1915,1071,844
50,12,3,Florida,Baker County,4,10,1982,1091,891
50,12,3,Florida,Baker County,4,11,1946,1006,940
50,12,3,Florida,Baker County,4,12,1716,856,860
50,12,3,Florida,Baker County,4,13,1498,717,781
50,12,3,Florida,Baker County,4,14,1102,542,560
50,12,3,Florida,Baker County,4,15,797,389,408
50,12,3,Florida,Baker County,4,16,552,241,311
50,12,3,Florida,Baker County,4,17,346,137,209
50,12,3,Florida,Baker County,4,18,268,83,185
50,12,3,Florida,Baker County,5,0,27053,14116,12937
50,12,3,Florida,Baker County,5,1,1801,928,873
50,12,3,Florida,Baker County,5,2,1985,1014,971
50,12,3,Florida,Baker County,5,3,2029,1049,980
50,12,3,Florida,Baker County,5,4,1679,912,767
50,12,3,Florida,Baker County,5,5,1861,1018,843
50,12,3,Florida,Baker County,5,6,1855,1042,813
50,12,3,Florida,Baker County,5,7,1801,983,818
50,12,3,Florida,Baker County,5,8,1789,980,809
50,12,3,Florida,Baker County,5,9,1883,1033,850
50,12,3,Florida,Baker County,5,10,1947,1101,846
50,12,3,Florida,Baker County,5,11,1942,1003,939
50,12,3,Florida,Baker County,5,12,1722,847,875
50,12,3,Florida,Baker County,5,13,1529,749,780
50,12,3,Florida,Baker County,5,14,1177,575,602
50,12,3,Florida,Baker County,5,15,833,406,427
50,12,3,Florida,Baker County,5,16,576,243,333
50,12,3,Florida,Baker County,5,17,336,137,199
50,12,3,Florida,Baker County,5,18,308,96,212
50,12,3,Florida,Baker County,6,0,27009,14081,12928
50,12,3,Florida,Baker County,6,1,1707,860,847
50,12,3,Florida,Baker County,6,2,1935,1017,918
50,12,3,Florida,Baker County,6,3,2022,1007,1015
50,12,3,Florida,Baker County,6,4,1662,884,778
50,12,3,Florida,Baker County,6,5,1836,1002,834
50,12,3,Florida,Baker County,6,6,1908,1092,816
50,12,3,Florida,Baker County,6,7,1816,1000,816
50,12,3,Florida,Baker County,6,8,1731,950,781
50,12,3,Florida,Baker County,6,9,1871,1007,864
50,12,3,Florida,Baker County,6,10,1930,1107,823
50,12,3,Florida,Baker County,6,11,1953,1025,928
50,12,3,Florida,Baker County,6,12,1719,838,881
50,12,3,Florida,Baker County,6,13,1549,779,770
50,12,3,Florida,Baker County,6,14,1200,573,627
50,12,3,Florida,Baker County,6,15,896,439,457
50,12,3,Florida,Baker County,6,16,592,260,332
50,12,3,Florida,Baker County,6,17,369,143,226
50,12,3,Florida,Baker County,6,18,313,98,215
50,12,3,Florida,Baker County,7,0,27122,14122,13000
50,12,3,Florida,Baker County,7,1,1733,873,860
50,12,3,Florida,Baker County,7,2,1884,996,888
50,12,3,Florida,Baker County,7,3,1983,985,998
50,12,3,Florida,Baker County,7,4,1701,891,810
50,12,3,Florida,Baker County,7,5,1776,1011,765
50,12,3,Florida,Baker County,7,6,1938,1090,848
50,12,3,Florida,Baker County,7,7,1849,1001,848
50,12,3,Florida,Baker County,7,8,1731,949,782
50,12,3,Florida,Baker County,7,9,1832,1010,822
50,12,3,Florida,Baker County,7,10,1906,1056,850
50,12,3,Florida,Baker County,7,11,1978,1039,939
50,12,3,Florida,Baker County,7,12,1766,875,891
50,12,3,Florida,Baker County,7,13,1553,768,785
50,12,3,Florida,Baker County,7,14,1227,586,641
50,12,3,Florida,Baker County,7,15,917,435,482
50,12,3,Florida,Baker County,7,16,620,292,328
50,12,3,Florida,Baker County,7,17,404,159,245
50,12,3,Florida,Baker County,7,18,324,106,218
50,12,3,Florida,Baker County,8,0,27355,14295,13060
50,12,3,Florida,Baker County,8,1,1705,866,839
50,12,3,Florida,Baker County,8,2,1851,956,895
50,12,3,Florida,Baker County,8,3,1952,980,972
50,12,3,Florida,Baker County,8,4,1785,935,850
50,12,3,Florida,Baker County,8,5,1714,980,734
50,12,3,Florida,Baker County,8,6,2016,1163,853
50,12,3,Florida,Baker County,8,7,1861,1003,858
50,12,3,Florida,Baker County,8,8,1773,975,798
50,12,3,Florida,Baker County,8,9,1790,980,810
50,12,3,Florida,Baker County,8,10,1947,1105,842
50,12,3,Florida,Baker County,8,11,1924,1030,894
50,12,3,Florida,Baker County,8,12,1858,909,949
50,12,3,Florida,Baker County,8,13,1556,780,776
50,12,3,Florida,Baker County,8,14,1290,608,682
50,12,3,Florida,Baker County,8,15,926,445,481
50,12,3,Florida,Baker County,8,16,653,304,349
50,12,3,Florida,Baker County,8,17,434,175,259
50,12,3,Florida,Baker County,8,18,320,101,219
50,12,3,Florida,Baker County,9,0,27884,14641,13243
50,12,3,Florida,Baker County,9,1,1743,845,898
50,12,3,Florida,Baker County,9,2,1863,972,891
50,12,3,Florida,Baker County,9,3,1973,1013,960
50,12,3,Florida,Baker County,9,4,1818,932,886
50,12,3,Florida,Baker County,9,5,1699,986,713
50,12,3,Florida,Baker County,9,6,2169,1253,916
50,12,3,Florida,Baker County,9,7,1956,1085,871
50,12,3,Florida,Baker County,9,8,1827,1011,816
50,12,3,Florida,Baker County,9,9,1783,978,805
50,12,3,Florida,Baker County,9,10,1963,1093,870
50,12,3,Florida,Baker County,9,11,1868,1022,846
50,12,3,Florida,Baker County,9,12,1884,958,926
50,12,3,Florida,Baker County,9,13,1596,795,801
50,12,3,Florida,Baker County,9,14,1322,632,690
50,12,3,Florida,Baker County,9,15,958,460,498
50,12,3,Florida,Baker County,9,16,666,307,359
50,12,3,Florida,Baker County,9,17,461,186,275
50,12,3,Florida,Baker County,9,18,335,113,222
50,12,3,Florida,Baker County,10,0,28254,14874,13380
50,12,3,Florida,Baker County,10,1,1813,900,913
50,12,3,Florida,Baker County,10,2,1833,947,886
50,12,3,Florida,Baker County,10,3,1993,1027,966
50,12,3,Florida,Baker County,10,4,1805,940,865
50,12,3,Florida,Baker County,10,5,1659,973,686
50,12,3,Florida,Baker County,10,6,2228,1298,930
50,12,3,Florida,Baker County,10,7,2003,1115,888
50,12,3,Florida,Baker County,10,8,1883,1029,854
50,12,3,Florida,Baker County,10,9,1791,975,816
50,12,3,Florida,Baker County,10,10,2002,1112,890
50,12,3,Florida,Baker County,10,11,1885,1038,847
50,12,3,Florida,Baker County,10,12,1862,959,903
50,12,3,Florida,Baker County,10,13,1598,781,817
50,12,3,Florida,Baker County,10,14,1370,667,703
50,12,3,Florida,Baker County,10,15,1016,491,525
50,12,3,Florida,Baker County,10,16,685,304,381
50,12,3,Florida,Baker County,10,17,480,195,285
50,12,3,Florida,Baker County,10,18,348,123,225
50,12,3,Florida,Baker County,11,0,28353,14922,13431
50,12,3,Florida,Baker County,11,1,1783,895,888
50,12,3,Florida,Baker County,11,2,1848,957,891
50,12,3,Florida,Baker County,11,3,1929,989,940
50,12,3,Florida,Baker County,11,4,1830,938,892
50,12,3,Florida,Baker County,11,5,1655,985,670
50,12,3,Florida,Baker County,11,6,2242,1309,933
50,12,3,Florida,Baker County,11,7,2024,1132,892
50,12,3,Florida,Baker County,11,8,1892,1033,859
50,12,3,Florida,Baker County,11,9,1769,954,815
50,12,3,Florida,Baker County,11,10,1970,1098,872
50,12,3,Florida,Baker County,11,11,1884,1034,850
50,12,3,Florida,Baker County,11,12,1877,970,907
50,12,3,Florida,Baker County,11,13,1638,788,850
50,12,3,Florida,Baker County,11,14,1381,689,692
50,12,3,Florida,Baker County,11,15,1039,483,556
50,12,3,Florida,Baker County,11,16,739,331,408
50,12,3,Florida,Baker County,11,17,477,197,280
50,12,3,Florida,Baker County,11,18,376,140,236
50,12,3,Florida,Baker County,12,0,29210,15365,13845
50,12,3,Florida,Baker County,12,1,1810,888,922
50,12,3,Florida,Baker County,12,2,1976,1031,945
50,12,3,Florida,Baker County,12,3,1988,1048,940
50,12,3,Florida,Baker County,12,4,1830,919,911
50,12,3,Florida,Baker County,12,5,1741,1018,723
50,12,3,Florida,Baker County,12,6,2240,1331,909
50,12,3,Florida,Baker County,12,7,2135,1186,949
50,12,3,Florida,Baker County,12,8,2009,1079,930
50,12,3,Florida,Baker County,12,9,1854,1007,847
50,12,3,Florida,Baker County,12,10,1977,1133,844
50,12,3,Florida,Baker County,12,11,1896,999,897
50,12,3,Florida,Baker County,12,12,1925,1015,910
50,12,3,Florida,Baker County,12,13,1712,851,861
50,12,3,Florida,Baker County,12,14,1378,653,725
50,12,3,Florida,Baker County,12,15,1078,499,579
50,12,3,Florida,Baker County,12,16,751,329,422
50,12,3,Florida,Baker County,12,17,503,224,279
50,12,3,Florida,Baker County,12,18,407,155,252
50,12,5,Florida,Bay County,1,0,168852,83656,85196
50,12,5,Florida,Bay County,1,1,10633,5451,5182
50,12,5,Florida,Bay County,1,2,10014,4971,5043
50,12,5,Florida,Bay County,1,3,9993,5121,4872
50,12,5,Florida,Bay County,1,4,10889,5604,5285
50,12,5,Florida,Bay County,1,5,11624,5957,5667
50,12,5,Florida,Bay County,1,6,11754,6093,5661
50,12,5,Florida,Bay County,1,7,10396,5371,5025
50,12,5,Florida,Bay County,1,8,10322,5158,5164
50,12,5,Florida,Bay County,1,9,11259,5760,5499
50,12,5,Florida,Bay County,1,10,13579,6809,6770
50,12,5,Florida,Bay County,1,11,12929,6227,6702
50,12,5,Florida,Bay County,1,12,10925,5265,5660
50,12,5,Florida,Bay County,1,13,9976,4919,5057
50,12,5,Florida,Bay County,1,14,7731,3694,4037
50,12,5,Florida,Bay County,1,15,5947,2715,3232
50,12,5,Florida,Bay County,1,16,4617,2067,2550
50,12,5,Florida,Bay County,1,17,3430,1403,2027
50,12,5,Florida,Bay County,1,18,2834,1071,1763
50,12,5,Florida,Bay County,2,0,168850,83656,85194
50,12,5,Florida,Bay County,2,1,10633,5451,5182
50,12,5,Florida,Bay County,2,2,10014,4971,5043
50,12,5,Florida,Bay County,2,3,9993,5121,4872
50,12,5,Florida,Bay County,2,4,10890,5604,5286
50,12,5,Florida,Bay County,2,5,11625,5958,5667
50,12,5,Florida,Bay County,2,6,11754,6093,5661
50,12,5,Florida,Bay County,2,7,10396,5371,5025
50,12,5,Florida,Bay County,2,8,10322,5158,5164
50,12,5,Florida,Bay County,2,9,11259,5760,5499
50,12,5,Florida,Bay County,2,10,13579,6809,6770
50,12,5,Florida,Bay County,2,11,12927,6226,6701
50,12,5,Florida,Bay County,2,12,10925,5265,5660
50,12,5,Florida,Bay County,2,13,9978,4921,5057
50,12,5,Florida,Bay County,2,14,7731,3694,4037
50,12,5,Florida,Bay County,2,15,5946,2715,3231
50,12,5,Florida,Bay County,2,16,4616,2066,2550
50,12,5,Florida,Bay County,2,17,3428,1402,2026
50,12,5,Florida,Bay County,2,18,2834,1071,1763
50,12,5,Florida,Bay County,3,0,169206,83897,85309
50,12,5,Florida,Bay County,3,1,10625,5447,5178
50,12,5,Florida,Bay County,3,2,10039,5000,5039
50,12,5,Florida,Bay County,3,3,10008,5118,4890
50,12,5,Florida,Bay County,3,4,10723,5548,5175
50,12,5,Florida,Bay County,3,5,11767,6023,5744
50,12,5,Florida,Bay County,3,6,11820,6146,5674
50,12,5,Florida,Bay County,3,7,10477,5418,5059
50,12,5,Florida,Bay County,3,8,10251,5116,5135
50,12,5,Florida,Bay County,3,9,11284,5781,5503
50,12,5,Florida,Bay County,3,10,13486,6768,6718
50,12,5,Florida,Bay County,3,11,12988,6269,6719
50,12,5,Florida,Bay County,3,12,11045,5330,5715
50,12,5,Florida,Bay County,3,13,10045,4931,5114
50,12,5,Florida,Bay County,3,14,7730,3704,4026
50,12,5,Florida,Bay County,3,15,5994,2744,3250
50,12,5,Florida,Bay County,3,16,4605,2055,2550
50,12,5,Florida,Bay County,3,17,3450,1414,2036
50,12,5,Florida,Bay County,3,18,2869,1085,1784
50,12,5,Florida,Bay County,4,0,169555,83916,85639
50,12,5,Florida,Bay County,4,1,10454,5340,5114
50,12,5,Florida,Bay County,4,2,10037,5065,4972
50,12,5,Florida,Bay County,4,3,9962,5076,4886
50,12,5,Florida,Bay County,4,4,10116,5289,4827
50,12,5,Florida,Bay County,4,5,12088,6143,5945
50,12,5,Florida,Bay County,4,6,11848,6109,5739
50,12,5,Florida,Bay County,4,7,10736,5513,5223
50,12,5,Florida,Bay County,4,8,9857,4872,4985
50,12,5,Florida,Bay County,4,9,11248,5718,5530
50,12,5,Florida,Bay County,4,10,12934,6462,6472
50,12,5,Florida,Bay County,4,11,13258,6458,6800
50,12,5,Florida,Bay County,4,12,11405,5510,5895
50,12,5,Florida,Bay County,4,13,10422,5035,5387
50,12,5,Florida,Bay County,4,14,7820,3765,4055
50,12,5,Florida,Bay County,4,15,6208,2867,3341
50,12,5,Florida,Bay County,4,16,4657,2085,2572
50,12,5,Florida,Bay County,4,17,3482,1434,2048
50,12,5,Florida,Bay County,4,18,3023,1175,1848
50,12,5,Florida,Bay County,5,0,171757,85127,86630
50,12,5,Florida,Bay County,5,1,10621,5395,5226
50,12,5,Florida,Bay County,5,2,10243,5222,5021
50,12,5,Florida,Bay County,5,3,10053,5080,4973
50,12,5,Florida,Bay County,5,4,9832,5173,4659
50,12,5,Florida,Bay County,5,5,12280,6287,5993
50,12,5,Florida,Bay County,5,6,12100,6223,5877
50,12,5,Florida,Bay County,5,7,11033,5720,5313
50,12,5,Florida,Bay County,5,8,9801,4866,4935
50,12,5,Florida,Bay County,5,9,11253,5663,5590
50,12,5,Florida,Bay County,5,10,12524,6261,6263
50,12,5,Florida,Bay County,5,11,13496,6638,6858
50,12,5,Florida,Bay County,5,12,11823,5660,6163
50,12,5,Florida,Bay County,5,13,10255,4940,5315
50,12,5,Florida,Bay County,5,14,8524,4144,4380
50,12,5,Florida,Bay County,5,15,6483,3005,3478
50,12,5,Florida,Bay County,5,16,4730,2114,2616
50,12,5,Florida,Bay County,5,17,3468,1459,2009
50,12,5,Florida,Bay County,5,18,3238,1277,1961
50,12,5,Florida,Bay County,6,0,174596,86632,87964
50,12,5,Florida,Bay County,6,1,10921,5543,5378
50,12,5,Florida,Bay County,6,2,10535,5370,5165
50,12,5,Florida,Bay County,6,3,10052,5065,4987
50,12,5,Florida,Bay County,6,4,9807,5169,4638
50,12,5,Florida,Bay County,6,5,12397,6451,5946
50,12,5,Florida,Bay County,6,6,12486,6387,6099
50,12,5,Florida,Bay County,6,7,11503,5976,5527
50,12,5,Florida,Bay County,6,8,10066,5073,4993
50,12,5,Florida,Bay County,6,9,11144,5546,5598
50,12,5,Florida,Bay County,6,10,12019,6015,6004
50,12,5,Florida,Bay County,6,11,13604,6745,6859
50,12,5,Florida,Bay County,6,12,12282,5820,6462
50,12,5,Florida,Bay County,6,13,10258,4921,5337
50,12,5,Florida,Bay County,6,14,8968,4359,4609
50,12,5,Florida,Bay County,6,15,6749,3140,3609
50,12,5,Florida,Bay County,6,16,4923,2242,2681
50,12,5,Florida,Bay County,6,17,3503,1453,2050
50,12,5,Florida,Bay County,6,18,3379,1357,2022
50,12,5,Florida,Bay County,7,0,178289,88600,89689
50,12,5,Florida,Bay County,7,1,11131,5671,5460
50,12,5,Florida,Bay County,7,2,10901,5604,5297
50,12,5,Florida,Bay County,7,3,10169,5051,5118
50,12,5,Florida,Bay County,7,4,9836,5207,4629
50,12,5,Florida,Bay County,7,5,12395,6550,5845
50,12,5,Florida,Bay County,7,6,13119,6706,6413
50,12,5,Florida,Bay County,7,7,12019,6258,5761
50,12,5,Florida,Bay County,7,8,10433,5315,5118
50,12,5,Florida,Bay County,7,9,11043,5468,5575
50,12,5,Florida,Bay County,7,10,11635,5824,5811
50,12,5,Florida,Bay County,7,11,13734,6847,6887
50,12,5,Florida,Bay County,7,12,12673,5972,6701
50,12,5,Florida,Bay County,7,13,10688,5103,5585
50,12,5,Florida,Bay County,7,14,9453,4570,4883
50,12,5,Florida,Bay County,7,15,6961,3255,3706
50,12,5,Florida,Bay County,7,16,5079,2301,2778
50,12,5,Florida,Bay County,7,17,3540,1486,2054
50,12,5,Florida,Bay County,7,18,3480,1412,2068
50,12,5,Florida,Bay County,8,0,181488,90377,91111
50,12,5,Florida,Bay County,8,1,11486,5850,5636
50,12,5,Florida,Bay County,8,2,11013,5648,5365
50,12,5,Florida,Bay County,8,3,10444,5217,5227
50,12,5,Florida,Bay County,8,4,9895,5205,4690
50,12,5,Florida,Bay County,8,5,12263,6637,5626
50,12,5,Florida,Bay County,8,6,13604,6963,6641
50,12,5,Florida,Bay County,8,7,12485,6507,5978
50,12,5,Florida,Bay County,8,8,10915,5644,5271
50,12,5,Florida,Bay County,8,9,10856,5355,5501
50,12,5,Florida,Bay County,8,10,11501,5729,5772
50,12,5,Florida,Bay County,8,11,13623,6814,6809
50,12,5,Florida,Bay County,8,12,12967,6131,6836
50,12,5,Florida,Bay County,8,13,11036,5264,5772
50,12,5,Florida,Bay County,8,14,9893,4728,5165
50,12,5,Florida,Bay County,8,15,7130,3348,3782
50,12,5,Florida,Bay County,8,16,5159,2314,2845
50,12,5,Florida,Bay County,8,17,3598,1533,2065
50,12,5,Florida,Bay County,8,18,3620,1490,2130
50,12,5,Florida,Bay County,9,0,183634,91445,92189
50,12,5,Florida,Bay County,9,1,11617,5958,5659
50,12,5,Florida,Bay County,9,2,11081,5617,5464
50,12,5,Florida,Bay County,9,3,10651,5337,5314
50,12,5,Florida,Bay County,9,4,9962,5227,4735
50,12,5,Florida,Bay County,9,5,11633,6271,5362
50,12,5,Florida,Bay County,9,6,14047,7188,6859
50,12,5,Florida,Bay County,9,7,12689,6545,6144
50,12,5,Florida,Bay County,9,8,11306,5825,5481
50,12,5,Florida,Bay County,9,9,10584,5241,5343
50,12,5,Florida,Bay County,9,10,11661,5786,5875
50,12,5,Florida,Bay County,9,11,13221,6624,6597
50,12,5,Florida,Bay County,9,12,13395,6479,6916
50,12,5,Florida,Bay County,9,13,11462,5433,6029
50,12,5,Florida,Bay County,9,14,10339,4916,5423
50,12,5,Florida,Bay County,9,15,7267,3463,3804
50,12,5,Florida,Bay County,9,16,5358,2413,2945
50,12,5,Florida,Bay County,9,17,3667,1580,2087
50,12,5,Florida,Bay County,9,18,3694,1542,2152
50,12,5,Florida,Bay County,10,0,184736,91977,92759
50,12,5,Florida,Bay County,10,1,11495,5973,5522
50,12,5,Florida,Bay County,10,2,11138,5660,5478
50,12,5,Florida,Bay County,10,3,10879,5425,5454
50,12,5,Florida,Bay County,10,4,9931,5197,4734
50,12,5,Florida,Bay County,10,5,11296,6152,5144
50,12,5,Florida,Bay County,10,6,14001,7123,6878
50,12,5,Florida,Bay County,10,7,12816,6626,6190
50,12,5,Florida,Bay County,10,8,11627,5991,5636
50,12,5,Florida,Bay County,10,9,10452,5171,5281
50,12,5,Florida,Bay County,10,10,11609,5804,5805
50,12,5,Florida,Bay County,10,11,12695,6267,6428
50,12,5,Florida,Bay County,10,12,13668,6677,6991
50,12,5,Florida,Bay County,10,13,11982,5623,6359
50,12,5,Florida,Bay County,10,14,10128,4786,5342
50,12,5,Florida,Bay County,10,15,7926,3775,4151
50,12,5,Florida,Bay County,10,16,5562,2534,3028
50,12,5,Florida,Bay County,10,17,3747,1601,2146
50,12,5,Florida,Bay County,10,18,3784,1592,2192
50,12,5,Florida,Bay County,11,0,186240,92404,93836
50,12,5,Florida,Bay County,11,1,11339,5878,5461
50,12,5,Florida,Bay County,11,2,11282,5717,5565
50,12,5,Florida,Bay County,11,3,10997,5525,5472
50,12,5,Florida,Bay County,11,4,9935,5124,4811
50,12,5,Florida,Bay County,11,5,11123,6034,5089
50,12,5,Florida,Bay County,11,6,13898,7037,6861
50,12,5,Florida,Bay County,11,7,12862,6614,6248
50,12,5,Florida,Bay County,11,8,11958,6104,5854
50,12,5,Florida,Bay County,11,9,10562,5278,5284
50,12,5,Florida,Bay County,11,10,11535,5699,5836
50,12,5,Florida,Bay County,11,11,12319,6037,6282
50,12,5,Florida,Bay County,11,12,13874,6774,7100
50,12,5,Florida,Bay County,11,13,12458,5877,6581
50,12,5,Florida,Bay County,11,14,10284,4834,5450
50,12,5,Florida,Bay County,11,15,8319,3936,4383
50,12,5,Florida,Bay County,11,16,5785,2663,3122
50,12,5,Florida,Bay County,11,17,3856,1659,2197
50,12,5,Florida,Bay County,11,18,3854,1614,2240
50,12,5,Florida,Bay County,12,0,174705,86622,88083
50,12,5,Florida,Bay County,12,1,9997,5099,4898
50,12,5,Florida,Bay County,12,2,10003,5056,4947
50,12,5,Florida,Bay County,12,3,10172,5136,5036
50,12,5,Florida,Bay County,12,4,9235,4700,4535
50,12,5,Florida,Bay County,12,5,9554,5209,4345
50,12,5,Florida,Bay County,12,6,11796,6145,5651
50,12,5,Florida,Bay County,12,7,11682,5958,5724
50,12,5,Florida,Bay County,12,8,11204,5702,5502
50,12,5,Florida,Bay County,12,9,10201,5180,5021
50,12,5,Florida,Bay County,12,10,10796,5324,5472
50,12,5,Florida,Bay County,12,11,11459,5704,5755
50,12,5,Florida,Bay County,12,12,13673,6740,6933
50,12,5,Florida,Bay County,12,13,12398,5776,6622
50,12,5,Florida,Bay County,12,14,10450,4911,5539
50,12,5,Florida,Bay County,12,15,8556,4023,4533
50,12,5,Florida,Bay County,12,16,5836,2687,3149
50,12,5,Florida,Bay County,12,17,3806,1634,2172
50,12,5,Florida,Bay County,12,18,3887,1638,2249
50,12,7,Florida,Bradford County,1,0,28520,16010,12510
50,12,7,Florida,Bradford County,1,1,1670,876,794
50,12,7,Florida,Bradford County,1,2,1571,786,785
50,12,7,Florida,Bradford County,1,3,1497,758,739
50,12,7,Florida,Bradford County,1,4,1571,845,726
50,12,7,Florida,Bradford County,1,5,1877,1171,706
50,12,7,Florida,Bradford County,1,6,2334,1548,786
50,12,7,Florida,Bradford County,1,7,2015,1347,668
50,12,7,Florida,Bradford County,1,8,1917,1225,692
50,12,7,Florida,Bradford County,1,9,1904,1205,699
50,12,7,Florida,Bradford County,1,10,2300,1390,910
50,12,7,Florida,Bradford County,1,11,2239,1240,999
50,12,7,Florida,Bradford County,1,12,1874,1011,863
50,12,7,Florida,Bradford County,1,13,1638,799,839
50,12,7,Florida,Bradford County,1,14,1362,665,697
50,12,7,Florida,Bradford County,1,15,961,467,494
50,12,7,Florida,Bradford County,1,16,780,315,465
50,12,7,Florida,Bradford County,1,17,523,216,307
50,12,7,Florida,Bradford County,1,18,487,146,341
50,12,7,Florida,Bradford County,2,0,28519,16010,12509
50,12,7,Florida,Bradford County,2,1,1670,876,794
50,12,7,Florida,Bradford County,2,2,1571,786,785
50,12,7,Florida,Bradford County,2,3,1497,758,739
50,12,7,Florida,Bradford County,2,4,1571,845,726
50,12,7,Florida,Bradford County,2,5,1877,1171,706
50,12,7,Florida,Bradford County,2,6,2334,1548,786
50,12,7,Florida,Bradford County,2,7,2015,1347,668
50,12,7,Florida,Bradford County,2,8,1917,1225,692
50,12,7,Florida,Bradford County,2,9,1904,1205,699
50,12,7,Florida,Bradford County,2,10,2300,1390,910
50,12,7,Florida,Bradford County,2,11,2239,1240,999
50,12,7,Florida,Bradford County,2,12,1874,1011,863
50,12,7,Florida,Bradford County,2,13,1638,799,839
50,12,7,Florida,Bradford County,2,14,1362,665,697
50,12,7,Florida,Bradford County,2,15,961,467,494
50,12,7,Florida,Bradford County,2,16,779,315,464
50,12,7,Florida,Bradford County,2,17,523,216,307
50,12,7,Florida,Bradford County,2,18,487,146,341
50,12,7,Florida,Bradford County,3,0,28536,16057,12479
50,12,7,Florida,Bradford County,3,1,1672,876,796
50,12,7,Florida,Bradford County,3,2,1567,784,783
50,12,7,Florida,Bradford County,3,3,1506,761,745
50,12,7,Florida,Bradford County,3,4,1529,821,708
50,12,7,Florida,Bradford County,3,5,1907,1193,714
50,12,7,Florida,Bradford County,3,6,2347,1565,782
50,12,7,Florida,Bradford County,3,7,2035,1364,671
50,12,7,Florida,Bradford County,3,8,1916,1227,689
50,12,7,Florida,Bradford County,3,9,1912,1213,699
50,12,7,Florida,Bradford County,3,10,2275,1386,889
50,12,7,Florida,Bradford County,3,11,2225,1235,990
50,12,7,Florida,Bradford County,3,12,1882,1020,862
50,12,7,Florida,Bradford County,3,13,1638,798,840
50,12,7,Florida,Bradford County,3,14,1357,664,693
50,12,7,Florida,Bradford County,3,15,968,467,501
50,12,7,Florida,Bradford County,3,16,775,315,460
50,12,7,Florida,Bradford County,3,17,532,222,310
50,12,7,Florida,Bradford County,3,18,493,146,347
50,12,7,Florida,Bradford County,4,0,28431,16080,12351
50,12,7,Florida,Bradford County,4,1,1652,865,787
50,12,7,Florida,Bradford County,4,2,1552,794,758
50,12,7,Florida,Bradford County,4,3,1526,779,747
50,12,7,Florida,Bradford County,4,4,1358,735,623
50,12,7,Florida,Bradford County,4,5,1979,1241,738
50,12,7,Florida,Bradford County,4,6,2295,1551,744
50,12,7,Florida,Bradford County,4,7,2099,1392,707
50,12,7,Florida,Bradford County,4,8,1861,1212,649
50,12,7,Florida,Bradford County,4,9,1938,1226,712
50,12,7,Florida,Bradford County,4,10,2161,1347,814
50,12,7,Florida,Bradford County,4,11,2213,1241,972
50,12,7,Florida,Bradford County,4,12,1919,1032,887
50,12,7,Florida,Bradford County,4,13,1658,821,837
50,12,7,Florida,Bradford County,4,14,1339,658,681
50,12,7,Florida,Bradford County,4,15,1028,476,552
50,12,7,Florida,Bradford County,4,16,776,332,444
50,12,7,Florida,Bradford County,4,17,560,227,333
50,12,7,Florida,Bradford County,4,18,517,151,366
50,12,7,Florida,Bradford County,5,0,27051,14740,12311
50,12,7,Florida,Bradford County,5,1,1630,861,769
50,12,7,Florida,Bradford County,5,2,1549,788,761
50,12,7,Florida,Bradford County,5,3,1526,791,735
50,12,7,Florida,Bradford County,5,4,1333,717,616
50,12,7,Florida,Bradford County,5,5,1781,1057,724
50,12,7,Florida,Bradford County,5,6,2000,1284,716
50,12,7,Florida,Bradford County,5,7,1920,1204,716
50,12,7,Florida,Bradford County,5,8,1646,1010,636
50,12,7,Florida,Bradford County,5,9,1727,1038,689
50,12,7,Florida,Bradford County,5,10,1915,1123,792
50,12,7,Florida,Bradford County,5,11,2081,1149,932
50,12,7,Florida,Bradford County,5,12,1933,997,936
50,12,7,Florida,Bradford County,5,13,1636,801,835
50,12,7,Florida,Bradford County,5,14,1400,686,714
50,12,7,Florida,Bradford County,5,15,1085,495,590
50,12,7,Florida,Bradford County,5,16,773,346,427
50,12,7,Florida,Bradford County,5,17,572,223,349
50,12,7,Florida,Bradford County,5,18,544,170,374
50,12,7,Florida,Bradford County,6,0,26802,14642,12160
50,12,7,Florida,Bradford County,6,1,1564,832,732
50,12,7,Florida,Bradford County,6,2,1551,781,770
50,12,7,Florida,Bradford County,6,3,1486,780,706
50,12,7,Florida,Bradford County,6,4,1348,724,624
50,12,7,Florida,Bradford County,6,5,1771,1067,704
50,12,7,Florida,Bradford County,6,6,1946,1245,701
50,12,7,Florida,Bradford County,6,7,1909,1199,710
50,12,7,Florida,Bradford County,6,8,1588,980,608
50,12,7,Florida,Bradford County,6,9,1694,1021,673
50,12,7,Florida,Bradford County,6,10,1863,1104,759
50,12,7,Florida,Bradford County,6,11,2020,1137,883
50,12,7,Florida,Bradford County,6,12,1935,990,945
50,12,7,Florida,Bradford County,6,13,1647,835,812
50,12,7,Florida,Bradford County,6,14,1393,666,727
50,12,7,Florida,Bradford County,6,15,1151,514,637
50,12,7,Florida,Bradford County,6,16,804,375,429
50,12,7,Florida,Bradford County,6,17,563,217,346
50,12,7,Florida,Bradford County,6,18,569,175,394
50,12,7,Florida,Bradford County,7,0,26552,14480,12072
50,12,7,Florida,Bradford County,7,1,1515,798,717
50,12,7,Florida,Bradford County,7,2,1529,778,751
50,12,7,Florida,Bradford County,7,3,1454,757,697
50,12,7,Florida,Bradford County,7,4,1327,708,619
50,12,7,Florida,Bradford County,7,5,1787,1091,696
50,12,7,Florida,Bradford County,7,6,1905,1213,692
50,12,7,Florida,Bradford County,7,7,1885,1176,709
50,12,7,Florida,Bradford County,7,8,1619,999,620
50,12,7,Florida,Bradford County,7,9,1676,1012,664
50,12,7,Florida,Bradford County,7,10,1725,1041,684
50,12,7,Florida,Bradford County,7,11,1968,1085,883
50,12,7,Florida,Bradford County,7,12,1918,988,930
50,12,7,Florida,Bradford County,7,13,1647,827,820
50,12,7,Florida,Bradford County,7,14,1432,674,758
50,12,7,Florida,Bradford County,7,15,1179,542,637
50,12,7,Florida,Bradford County,7,16,836,391,445
50,12,7,Florida,Bradford County,7,17,577,215,362
50,12,7,Florida,Bradford County,7,18,573,185,388
50,12,7,Florida,Bradford County,8,0,26748,14566,12182
50,12,7,Florida,Bradford County,8,1,1514,805,709
50,12,7,Florida,Bradford County,8,2,1516,789,727
50,12,7,Florida,Bradford County,8,3,1479,743,736
50,12,7,Florida,Bradford County,8,4,1378,708,670
50,12,7,Florida,Bradford County,8,5,1660,1030,630
50,12,7,Florida,Bradford County,8,6,2052,1289,763
50,12,7,Florida,Bradford County,8,7,1914,1197,717
50,12,7,Florida,Bradford County,8,8,1689,1041,648
50,12,7,Florida,Bradford County,8,9,1638,976,662
50,12,7,Florida,Bradford County,8,10,1696,1035,661
50,12,7,Florida,Bradford County,8,11,1925,1066,859
50,12,7,Florida,Bradford County,8,12,1938,988,950
50,12,7,Florida,Bradford County,8,13,1653,844,809
50,12,7,Florida,Bradford County,8,14,1459,681,778
50,12,7,Florida,Bradford County,8,15,1206,557,649
50,12,7,Florida,Bradford County,8,16,841,379,462
50,12,7,Florida,Bradford County,8,17,616,246,370
50,12,7,Florida,Bradford County,8,18,574,192,382
50,12,7,Florida,Bradford County,9,0,26740,14536,12204
50,12,7,Florida,Bradford County,9,1,1496,789,707
50,12,7,Florida,Bradford County,9,2,1526,807,719
50,12,7,Florida,Bradford County,9,3,1458,730,728
50,12,7,Florida,Bradford County,9,4,1393,717,676
50,12,7,Florida,Bradford County,9,5,1600,989,611
50,12,7,Florida,Bradford County,9,6,2067,1309,758
50,12,7,Florida,Bradford County,9,7,1882,1181,701
50,12,7,Florida,Bradford County,9,8,1731,1060,671
50,12,7,Florida,Bradford County,9,9,1649,977,672
50,12,7,Florida,Bradford County,9,10,1717,1033,684
50,12,7,Florida,Bradford County,9,11,1812,1031,781
50,12,7,Florida,Bradford County,9,12,1881,948,933
50,12,7,Florida,Bradford County,9,13,1738,881,857
50,12,7,Florida,Bradford County,9,14,1499,698,801
50,12,7,Florida,Bradford County,9,15,1184,551,633
50,12,7,Florida,Bradford County,9,16,886,387,499
50,12,7,Florida,Bradford County,9,17,602,255,347
50,12,7,Florida,Bradford County,9,18,619,193,426
50,12,7,Florida,Bradford County,10,0,27142,14744,12398
50,12,7,Florida,Bradford County,10,1,1554,812,742
50,12,7,Florida,Bradford County,10,2,1540,804,736
50,12,7,Florida,Bradford County,10,3,1506,757,749
50,12,7,Florida,Bradford County,10,4,1420,722,698
50,12,7,Florida,Bradford County,10,5,1599,982,617
50,12,7,Florida,Bradford County,10,6,2129,1346,783
50,12,7,Florida,Bradford County,10,7,1929,1200,729
50,12,7,Florida,Bradford County,10,8,1814,1123,691
50,12,7,Florida,Bradford County,10,9,1651,983,668
50,12,7,Florida,Bradford County,10,10,1740,1051,689
50,12,7,Florida,Bradford County,10,11,1769,995,774
50,12,7,Florida,Bradford County,10,12,1854,961,893
50,12,7,Florida,Bradford County,10,13,1783,874,909
50,12,7,Florida,Bradford County,10,14,1457,688,769
50,12,7,Florida,Bradford County,10,15,1259,588,671
50,12,7,Florida,Bradford County,10,16,944,415,529
50,12,7,Florida,Bradford County,10,17,558,243,315
50,12,7,Florida,Bradford County,10,18,636,200,436
50,12,7,Florida,Bradford County,11,0,27752,15327,12425
50,12,7,Florida,Bradford County,11,1,1486,771,715
50,12,7,Florida,Bradford County,11,2,1537,806,731
50,12,7,Florida,Bradford County,11,3,1513,756,757
50,12,7,Florida,Bradford County,11,4,1400,711,689
50,12,7,Florida,Bradford County,11,5,1677,1078,599
50,12,7,Florida,Bradford County,11,6,2289,1479,810
50,12,7,Florida,Bradford County,11,7,1960,1248,712
50,12,7,Florida,Bradford County,11,8,1975,1239,736
50,12,7,Florida,Bradford County,11,9,1678,1053,625
50,12,7,Florida,Bradford County,11,10,1822,1094,728
50,12,7,Florida,Bradford County,11,11,1774,1029,745
50,12,7,Florida,Bradford County,11,12,1898,1005,893
50,12,7,Florida,Bradford County,11,13,1792,869,923
50,12,7,Florida,Bradford County,11,14,1484,720,764
50,12,7,Florida,Bradford County,11,15,1261,570,691
50,12,7,Florida,Bradford County,11,16,1001,440,561
50,12,7,Florida,Bradford County,11,17,587,256,331
50,12,7,Florida,Bradford County,11,18,618,203,415
50,12,7,Florida,Bradford County,12,0,28201,15692,12509
50,12,7,Florida,Bradford County,12,1,1482,782,700
50,12,7,Florida,Bradford County,12,2,1539,822,717
50,12,7,Florida,Bradford County,12,3,1551,782,769
50,12,7,Florida,Bradford County,12,4,1413,716,697
50,12,7,Florida,Bradford County,12,5,1737,1112,625
50,12,7,Florida,Bradford County,12,6,2413,1584,829
50,12,7,Florida,Bradford County,12,7,2021,1288,733
50,12,7,Florida,Bradford County,12,8,2011,1277,734
50,12,7,Florida,Bradford County,12,9,1762,1098,664
50,12,7,Florida,Bradford County,12,10,1833,1122,711
50,12,7,Florida,Bradford County,12,11,1715,1011,704
50,12,7,Florida,Bradford County,12,12,1889,983,906
50,12,7,Florida,Bradford County,12,13,1771,864,907
50,12,7,Florida,Bradford County,12,14,1506,745,761
50,12,7,Florida,Bradford County,12,15,1320,579,741
50,12,7,Florida,Bradford County,12,16,1032,465,567
50,12,7,Florida,Bradford County,12,17,600,256,344
50,12,7,Florida,Bradford County,12,18,606,206,400
50,12,9,Florida,Brevard County,1,0,543376,266242,277134
50,12,9,Florida,Brevard County,1,1,26809,13914,12895
50,12,9,Florida,Brevard County,1,2,28563,14611,13952
50,12,9,Florida,Brevard County,1,3,31269,15986,15283
50,12,9,Florida,Brevard County,1,4,34491,18192,16299
50,12,9,Florida,Brevard County,1,5,29335,15685,13650
50,12,9,Florida,Brevard County,1,6,28624,14418,14206
50,12,9,Florida,Brevard County,1,7,26171,13057,13114
50,12,9,Florida,Brevard County,1,8,28521,13864,14657
50,12,9,Florida,Brevard County,1,9,33627,16372,17255
50,12,9,Florida,Brevard County,1,10,44882,21809,23073
50,12,9,Florida,Brevard County,1,11,45720,22411,23309
50,12,9,Florida,Brevard County,1,12,38668,18878,19790
50,12,9,Florida,Brevard County,1,13,35984,17137,18847
50,12,9,Florida,Brevard County,1,14,31238,14634,16604
50,12,9,Florida,Brevard County,1,15,26448,12328,14120
50,12,9,Florida,Brevard County,1,16,22238,10365,11873
50,12,9,Florida,Brevard County,1,17,16687,7273,9414
50,12,9,Florida,Brevard County,1,18,14101,5308,8793
50,12,9,Florida,Brevard County,2,0,543372,266241,277131
50,12,9,Florida,Brevard County,2,1,26809,13914,12895
50,12,9,Florida,Brevard County,2,2,28562,14611,13951
50,12,9,Florida,Brevard County,2,3,31268,15985,15283
50,12,9,Florida,Brevard County,2,4,34489,18191,16298
50,12,9,Florida,Brevard County,2,5,29335,15685,13650
50,12,9,Florida,Brevard County,2,6,28625,14419,14206
50,12,9,Florida,Brevard County,2,7,26171,13057,13114
50,12,9,Florida,Brevard County,2,8,28520,13864,14656
50,12,9,Florida,Brevard County,2,9,33627,16372,17255
50,12,9,Florida,Brevard County,2,10,44883,21809,23074
50,12,9,Florida,Brevard County,2,11,45720,22411,23309
50,12,9,Florida,Brevard County,2,12,38668,18878,19790
50,12,9,Florida,Brevard County,2,13,35983,17136,18847
50,12,9,Florida,Brevard County,2,14,31239,14635,16604
50,12,9,Florida,Brevard County,2,15,26448,12328,14120
50,12,9,Florida,Brevard County,2,16,22238,10365,11873
50,12,9,Florida,Brevard County,2,17,16686,7273,9413
50,12,9,Florida,Brevard County,2,18,14101,5308,8793
50,12,9,Florida,Brevard County,3,0,543965,266536,277429
50,12,9,Florida,Brevard County,3,1,26635,13830,12805
50,12,9,Florida,Brevard County,3,2,28481,14564,13917
50,12,9,Florida,Brevard County,3,3,31204,15974,15230
50,12,9,Florida,Brevard County,3,4,34237,18049,16188
50,12,9,Florida,Brevard County,3,5,29685,15886,13799
50,12,9,Florida,Brevard County,3,6,28759,14489,14270
50,12,9,Florida,Brevard County,3,7,26390,13171,13219
50,12,9,Florida,Brevard County,3,8,28188,13700,14488
50,12,9,Florida,Brevard County,3,9,33421,16250,17171
50,12,9,Florida,Brevard County,3,10,44486,21619,22867
50,12,9,Florida,Brevard County,3,11,45966,22532,23434
50,12,9,Florida,Brevard County,3,12,39119,19071,20048
50,12,9,Florida,Brevard County,3,13,36181,17255,18926
50,12,9,Florida,Brevard County,3,14,31364,14719,16645
50,12,9,Florida,Brevard County,3,15,26506,12347,14159
50,12,9,Florida,Brevard County,3,16,22254,10359,11895
50,12,9,Florida,Brevard County,3,17,16821,7364,9457
50,12,9,Florida,Brevard County,3,18,14268,5357,8911
50,12,9,Florida,Brevard County,4,0,544359,266435,277924
50,12,9,Florida,Brevard County,4,1,26167,13624,12543
50,12,9,Florida,Brevard County,4,2,28180,14372,13808
50,12,9,Florida,Brevard County,4,3,30852,15831,15021
50,12,9,Florida,Brevard County,4,4,33238,17514,15724
50,12,9,Florida,Brevard County,4,5,30698,16379,14319
50,12,9,Florida,Brevard County,4,6,28804,14514,14290
50,12,9,Florida,Brevard County,4,7,26968,13425,13543
50,12,9,Florida,Brevard County,4,8,26732,12923,13809
50,12,9,Florida,Brevard County,4,9,32589,15811,16778
50,12,9,Florida,Brevard County,4,10,42090,20401,21689
50,12,9,Florida,Brevard County,4,11,46693,22850,23843
50,12,9,Florida,Brevard County,4,12,40543,19656,20887
50,12,9,Florida,Brevard County,4,13,37491,17955,19536
50,12,9,Florida,Brevard County,4,14,31919,15062,16857
50,12,9,Florida,Brevard County,4,15,26961,12501,14460
50,12,9,Florida,Brevard County,4,16,22498,10433,12065
50,12,9,Florida,Brevard County,4,17,17095,7609,9486
50,12,9,Florida,Brevard County,4,18,14841,5575,9266
50,12,9,Florida,Brevard County,5,0,546966,267564,279402
50,12,9,Florida,Brevard County,5,1,26072,13536,12536
50,12,9,Florida,Brevard County,5,2,28335,14596,13739
50,12,9,Florida,Brevard County,5,3,30525,15583,14942
50,12,9,Florida,Brevard County,5,4,32044,16868,15176
50,12,9,Florida,Brevard County,5,5,31284,16584,14700
50,12,9,Florida,Brevard County,5,6,29072,14862,14210
50,12,9,Florida,Brevard County,5,7,27634,13631,14003
50,12,9,Florida,Brevard County,5,8,26358,12790,13568
50,12,9,Florida,Brevard County,5,9,31987,15483,16504
50,12,9,Florida,Brevard County,5,10,39708,19224,20484
50,12,9,Florida,Brevard County,5,11,46812,22816,23996
50,12,9,Florida,Brevard County,5,12,42480,20504,21976
50,12,9,Florida,Brevard County,5,13,36964,17737,19227
50,12,9,Florida,Brevard County,5,14,34211,16254,17957
50,12,9,Florida,Brevard County,5,15,27809,12924,14885
50,12,9,Florida,Brevard County,5,16,22843,10524,12319
50,12,9,Florida,Brevard County,5,17,17311,7774,9537
50,12,9,Florida,Brevard County,5,18,15517,5874,9643
50,12,9,Florida,Brevard County,6,0,550255,269112,281143
50,12,9,Florida,Brevard County,6,1,25842,13395,12447
50,12,9,Florida,Brevard County,6,2,28461,14662,13799
50,12,9,Florida,Brevard County,6,3,30277,15460,14817
50,12,9,Florida,Brevard County,6,4,31641,16687,14954
50,12,9,Florida,Brevard County,6,5,31872,16866,15006
50,12,9,Florida,Brevard County,6,6,29464,15158,14306
50,12,9,Florida,Brevard County,6,7,28392,13991,14401
50,12,9,Florida,Brevard County,6,8,26277,12837,13440
50,12,9,Florida,Brevard County,6,9,31299,15082,16217
50,12,9,Florida,Brevard County,6,10,37479,18078,19401
50,12,9,Florida,Brevard County,6,11,46509,22632,23877
50,12,9,Florida,Brevard County,6,12,44034,21156,22878
50,12,9,Florida,Brevard County,6,13,37617,18171,19446
50,12,9,Florida,Brevard County,6,14,34914,16560,18354
50,12,9,Florida,Brevard County,6,15,29339,13672,15667
50,12,9,Florida,Brevard County,6,16,23294,10654,12640
50,12,9,Florida,Brevard County,6,17,17528,7988,9540
50,12,9,Florida,Brevard County,6,18,16016,6063,9953
50,12,9,Florida,Brevard County,7,0,555548,271634,283914
50,12,9,Florida,Brevard County,7,1,26181,13677,12504
50,12,9,Florida,Brevard County,7,2,28378,14629,13749
50,12,9,Florida,Brevard County,7,3,30179,15408,14771
50,12,9,Florida,Brevard County,7,4,31220,16436,14784
50,12,9,Florida,Brevard County,7,5,31828,16870,14958
50,12,9,Florida,Brevard County,7,6,30239,15538,14701
50,12,9,Florida,Brevard County,7,7,29037,14288,14749
50,12,9,Florida,Brevard County,7,8,26645,13061,13584
50,12,9,Florida,Brevard County,7,9,30527,14688,15839
50,12,9,Florida,Brevard County,7,10,35685,17195,18490
50,12,9,Florida,Brevard County,7,11,46192,22365,23827
50,12,9,Florida,Brevard County,7,12,45324,21772,23552
50,12,9,Florida,Brevard County,7,13,39193,18899,20294
50,12,9,Florida,Brevard County,7,14,36411,17246,19165
50,12,9,Florida,Brevard County,7,15,30382,14216,16166
50,12,9,Florida,Brevard County,7,16,23860,10939,12921
50,12,9,Florida,Brevard County,7,17,17591,8032,9559
50,12,9,Florida,Brevard County,7,18,16676,6375,10301
50,12,9,Florida,Brevard County,8,0,565746,276546,289200
50,12,9,Florida,Brevard County,8,1,26836,13933,12903
50,12,9,Florida,Brevard County,8,2,28727,14885,13842
50,12,9,Florida,Brevard County,8,3,30404,15452,14952
50,12,9,Florida,Brevard County,8,4,31283,16486,14797
50,12,9,Florida,Brevard County,8,5,31526,16647,14879
50,12,9,Florida,Brevard County,8,6,31559,16303,15256
50,12,9,Florida,Brevard County,8,7,29803,14597,15206
50,12,9,Florida,Brevard County,8,8,27887,13770,14117
50,12,9,Florida,Brevard County,8,9,29931,14408,15523
50,12,9,Florida,Brevard County,8,10,35030,16849,18181
50,12,9,Florida,Brevard County,8,11,45495,21927,23568
50,12,9,Florida,Brevard County,8,12,47146,22680,24466
50,12,9,Florida,Brevard County,8,13,41243,19791,21452
50,12,9,Florida,Brevard County,8,14,38275,18160,20115
50,12,9,Florida,Brevard County,8,15,31023,14563,16460
50,12,9,Florida,Brevard County,8,16,24226,11100,13126
50,12,9,Florida,Brevard County,8,17,18148,8245,9903
50,12,9,Florida,Brevard County,8,18,17204,6750,10454
50,12,9,Florida,Brevard County,9,0,576874,281866,295008
50,12,9,Florida,Brevard County,9,1,27433,14176,13257
50,12,9,Florida,Brevard County,9,2,28918,15025,13893
50,12,9,Florida,Brevard County,9,3,30811,15633,15178
50,12,9,Florida,Brevard County,9,4,31570,16582,14988
50,12,9,Florida,Brevard County,9,5,31157,16466,14691
50,12,9,Florida,Brevard County,9,6,32945,17028,15917
50,12,9,Florida,Brevard County,9,7,30745,15196,15549
50,12,9,Florida,Brevard County,9,8,29263,14432,14831
50,12,9,Florida,Brevard County,9,9,29299,14133,15166
50,12,9,Florida,Brevard County,9,10,35191,17014,18177
50,12,9,Florida,Brevard County,9,11,44179,21255,22924
50,12,9,Florida,Brevard County,9,12,48838,23390,25448
50,12,9,Florida,Brevard County,9,13,43352,20697,22655
50,12,9,Florida,Brevard County,9,14,40200,19118,21082
50,12,9,Florida,Brevard County,9,15,31793,14984,16809
50,12,9,Florida,Brevard County,9,16,24890,11340,13550
50,12,9,Florida,Brevard County,9,17,18497,8305,10192
50,12,9,Florida,Brevard County,9,18,17793,7092,10701
50,12,9,Florida,Brevard County,10,0,587769,287247,300522
50,12,9,Florida,Brevard County,10,1,27823,14256,13567
50,12,9,Florida,Brevard County,10,2,29365,15164,14201
50,12,9,Florida,Brevard County,10,3,31422,16028,15394
50,12,9,Florida,Brevard County,10,4,31772,16698,15074
50,12,9,Florida,Brevard County,10,5,30986,16489,14497
50,12,9,Florida,Brevard County,10,6,34346,17788,16558
50,12,9,Florida,Brevard County,10,7,31773,15821,15952
50,12,9,Florida,Brevard County,10,8,30772,15103,15669
50,12,9,Florida,Brevard County,10,9,29565,14267,15298
50,12,9,Florida,Brevard County,10,10,34943,16909,18034
50,12,9,Florida,Brevard County,10,11,42631,20543,22088
50,12,9,Florida,Brevard County,10,12,49665,23787,25878
50,12,9,Florida,Brevard County,10,13,45844,21785,24059
50,12,9,Florida,Brevard County,10,14,39780,18988,20792
50,12,9,Florida,Brevard County,10,15,34277,16134,18143
50,12,9,Florida,Brevard County,10,16,25798,11821,13977
50,12,9,Florida,Brevard County,10,17,18720,8291,10429
50,12,9,Florida,Brevard County,10,18,18287,7375,10912
50,12,9,Florida,Brevard County,11,0,595203,291187,304016
50,12,9,Florida,Brevard County,11,1,27809,14223,13586
50,12,9,Florida,Brevard County,11,2,29432,15220,14212
50,12,9,Florida,Brevard County,11,3,31952,16250,15702
50,12,9,Florida,Brevard County,11,4,31557,16619,14938
50,12,9,Florida,Brevard County,11,5,30943,16535,14408
50,12,9,Florida,Brevard County,11,6,35039,18237,16802
50,12,9,Florida,Brevard County,11,7,32707,16377,16330
50,12,9,Florida,Brevard County,11,8,32042,15754,16288
50,12,9,Florida,Brevard County,11,9,29777,14500,15277
50,12,9,Florida,Brevard County,11,10,34719,16720,17999
50,12,9,Florida,Brevard County,11,11,40732,19612,21120
50,12,9,Florida,Brevard County,11,12,49996,23974,26022
50,12,9,Florida,Brevard County,11,13,47423,22526,24897
50,12,9,Florida,Brevard County,11,14,40901,19626,21275
50,12,9,Florida,Brevard County,11,15,35037,16459,18578
50,12,9,Florida,Brevard County,11,16,27278,12530,14748
50,12,9,Florida,Brevard County,11,17,19154,8446,10708
50,12,9,Florida,Brevard County,11,18,18705,7579,11126
50,12,9,Florida,Brevard County,12,0,601942,294384,307558
50,12,9,Florida,Brevard County,12,1,27397,13979,13418
50,12,9,Florida,Brevard County,12,2,29991,15386,14605
50,12,9,Florida,Brevard County,12,3,32093,16363,15730
50,12,9,Florida,Brevard County,12,4,31642,16616,15026
50,12,9,Florida,Brevard County,12,5,30547,16354,14193
50,12,9,Florida,Brevard County,12,6,35224,18356,16868
50,12,9,Florida,Brevard County,12,7,33677,16985,16692
50,12,9,Florida,Brevard County,12,8,32914,16066,16848
50,12,9,Florida,Brevard County,12,9,30305,14875,15430
50,12,9,Florida,Brevard County,12,10,34354,16511,17843
50,12,9,Florida,Brevard County,12,11,39126,18850,20276
50,12,9,Florida,Brevard County,12,12,49906,23847,26059
50,12,9,Florida,Brevard County,12,13,49014,23414,25600
50,12,9,Florida,Brevard County,12,14,42211,20218,21993
50,12,9,Florida,Brevard County,12,15,36569,17203,19366
50,12,9,Florida,Brevard County,12,16,28324,13057,15267
50,12,9,Florida,Brevard County,12,17,19663,8682,10981
50,12,9,Florida,Brevard County,12,18,18985,7622,11363
50,12,11,Florida,Broward County,1,0,1748066,846571,901495
50,12,11,Florida,Broward County,1,1,103256,52655,50601
50,12,11,Florida,Broward County,1,2,104071,52938,51133
50,12,11,Florida,Broward County,1,3,112207,57800,54407
50,12,11,Florida,Broward County,1,4,114200,58922,55278
50,12,11,Florida,Broward County,1,5,104783,52502,52281
50,12,11,Florida,Broward County,1,6,113599,55272,58327
50,12,11,Florida,Broward County,1,7,110880,53431,57449
50,12,11,Florida,Broward County,1,8,120146,58036,62110
50,12,11,Florida,Broward County,1,9,131279,63594,67685
50,12,11,Florida,Broward County,1,10,143737,70701,73036
50,12,11,Florida,Broward County,1,11,133303,65509,67794
50,12,11,Florida,Broward County,1,12,112695,54163,58532
50,12,11,Florida,Broward County,1,13,94486,45296,49190
50,12,11,Florida,Broward County,1,14,71669,33709,37960
50,12,11,Florida,Broward County,1,15,53684,24202,29482
50,12,11,Florida,Broward County,1,16,44374,18829,25545
50,12,11,Florida,Broward County,1,17,38171,14947,23224
50,12,11,Florida,Broward County,1,18,41526,14065,27461
50,12,11,Florida,Broward County,2,0,1748146,846652,901494
50,12,11,Florida,Broward County,2,1,103257,52656,50601
50,12,11,Florida,Broward County,2,2,104071,52938,51133
50,12,11,Florida,Broward County,2,3,112219,57812,54407
50,12,11,Florida,Broward County,2,4,114269,58991,55278
50,12,11,Florida,Broward County,2,5,104783,52502,52281
50,12,11,Florida,Broward County,2,6,113599,55272,58327
50,12,11,Florida,Broward County,2,7,110880,53431,57449
50,12,11,Florida,Broward County,2,8,120146,58036,62110
50,12,11,Florida,Broward County,2,9,131279,63594,67685
50,12,11,Florida,Broward County,2,10,143737,70701,73036
50,12,11,Florida,Broward County,2,11,133303,65509,67794
50,12,11,Florida,Broward County,2,12,112693,54162,58531
50,12,11,Florida,Broward County,2,13,94486,45296,49190
50,12,11,Florida,Broward County,2,14,71669,33709,37960
50,12,11,Florida,Broward County,2,15,53684,24202,29482
50,12,11,Florida,Broward County,2,16,44374,18829,25545
50,12,11,Florida,Broward County,2,17,38171,14947,23224
50,12,11,Florida,Broward County,2,18,41526,14065,27461
50,12,11,Florida,Broward County,3,0,1752803,849095,903708
50,12,11,Florida,Broward County,3,1,103412,52709,50703
50,12,11,Florida,Broward County,3,2,104109,52957,51152
50,12,11,Florida,Broward County,3,3,112213,57744,54469
50,12,11,Florida,Broward County,3,4,114298,59026,55272
50,12,11,Florida,Broward County,3,5,105674,52981,52693
50,12,11,Florida,Broward County,3,6,114122,55625,58497
50,12,11,Florida,Broward County,3,7,111623,53834,57789
50,12,11,Florida,Broward County,3,8,119593,57765,61828
50,12,11,Florida,Broward County,3,9,131002,63463,67539
50,12,11,Florida,Broward County,3,10,143562,70596,72966
50,12,11,Florida,Broward County,3,11,134050,65874,68176
50,12,11,Florida,Broward County,3,12,113542,54594,58948
50,12,11,Florida,Broward County,3,13,95340,45703,49637
50,12,11,Florida,Broward County,3,14,72288,33979,38309
50,12,11,Florida,Broward County,3,15,54091,24420,29671
50,12,11,Florida,Broward County,3,16,44208,18793,25415
50,12,11,Florida,Broward County,3,17,38106,14951,23155
50,12,11,Florida,Broward County,3,18,41570,14081,27489
50,12,11,Florida,Broward County,4,0,1786980,867265,919715
50,12,11,Florida,Broward County,4,1,105082,53499,51583
50,12,11,Florida,Broward County,4,2,105501,53786,51715
50,12,11,Florida,Broward County,4,3,112933,57895,55038
50,12,11,Florida,Broward County,4,4,114957,59406,55551
50,12,11,Florida,Broward County,4,5,110645,55733,54912
50,12,11,Florida,Broward County,4,6,117795,57903,59892
50,12,11,Florida,Broward County,4,7,116824,56645,60179
50,12,11,Florida,Broward County,4,8,117864,57105,60759
50,12,11,Florida,Broward County,4,9,131566,63680,67886
50,12,11,Florida,Broward County,4,10,142982,70151,72831
50,12,11,Florida,Broward County,4,11,137673,67709,69964
50,12,11,Florida,Broward County,4,12,117307,56535,60772
50,12,11,Florida,Broward County,4,13,100369,48148,52221
50,12,11,Florida,Broward County,4,14,75242,35347,39895
50,12,11,Florida,Broward County,4,15,56195,25505,30690
50,12,11,Florida,Broward County,4,16,44307,18987,25320
50,12,11,Florida,Broward County,4,17,37727,14959,22768
50,12,11,Florida,Broward County,4,18,42011,14272,27739
50,12,11,Florida,Broward County,5,0,1814253,881189,933064
50,12,11,Florida,Broward County,5,1,105734,53803,51931
50,12,11,Florida,Broward County,5,2,106911,54491,52420
50,12,11,Florida,Broward County,5,3,112713,57598,55115
50,12,11,Florida,Broward County,5,4,112857,58453,54404
50,12,11,Florida,Broward County,5,5,113883,57480,56403
50,12,11,Florida,Broward County,5,6,120369,59358,61011
50,12,11,Florida,Broward County,5,7,120645,58579,62066
50,12,11,Florida,Broward County,5,8,118535,57463,61072
50,12,11,Florida,Broward County,5,9,131925,63977,67948
50,12,11,Florida,Broward County,5,10,141373,69207,72166
50,12,11,Florida,Broward County,5,11,140303,69083,71220
50,12,11,Florida,Broward County,5,12,121816,58980,62836
50,12,11,Florida,Broward County,5,13,101535,48380,53155
50,12,11,Florida,Broward County,5,14,81748,38547,43201
50,12,11,Florida,Broward County,5,15,58958,26858,32100
50,12,11,Florida,Broward County,5,16,45082,19405,25677
50,12,11,Florida,Broward County,5,17,37337,14893,22444
50,12,11,Florida,Broward County,5,18,42529,14634,27895
50,12,11,Florida,Broward County,6,0,1836600,892950,943650
50,12,11,Florida,Broward County,6,1,106727,54313,52414
50,12,11,Florida,Broward County,6,2,109302,55595,53707
50,12,11,Florida,Broward County,6,3,112529,57445,55084
50,12,11,Florida,Broward County,6,4,114371,59073,55298
50,12,11,Florida,Broward County,6,5,115116,58351,56765
50,12,11,Florida,Broward County,6,6,121511,60076,61435
50,12,11,Florida,Broward County,6,7,123017,59944,63073
50,12,11,Florida,Broward County,6,8,118837,57542,61295
50,12,11,Florida,Broward County,6,9,131163,63552,67611
50,12,11,Florida,Broward County,6,10,138379,67515,70864
50,12,11,Florida,Broward County,6,11,142089,70261,71828
50,12,11,Florida,Broward County,6,12,125291,60746,64545
50,12,11,Florida,Broward County,6,13,103582,49263,54319
50,12,11,Florida,Broward County,6,14,85282,40305,44977
50,12,11,Florida,Broward County,6,15,62924,28837,34087
50,12,11,Florida,Broward County,6,16,46534,20210,26324
50,12,11,Florida,Broward County,6,17,37077,14926,22151
50,12,11,Florida,Broward County,6,18,42869,14996,27873
50,12,11,Florida,Broward County,7,0,1860933,905049,955884
50,12,11,Florida,Broward County,7,1,109358,55620,53738
50,12,11,Florida,Broward County,7,2,110475,56160,54315
50,12,11,Florida,Broward County,7,3,112588,57208,55380
50,12,11,Florida,Broward County,7,4,113360,58373,54987
50,12,11,Florida,Broward County,7,5,116335,58993,57342
50,12,11,Florida,Broward County,7,6,123882,61560,62322
50,12,11,Florida,Broward County,7,7,125862,61374,64488
50,12,11,Florida,Broward County,7,8,120499,58507,61992
50,12,11,Florida,Broward County,7,9,129884,63121,66763
50,12,11,Florida,Broward County,7,10,135432,65926,69506
50,12,11,Florida,Broward County,7,11,143763,70957,72806
50,12,11,Florida,Broward County,7,12,128951,62778,66173
50,12,11,Florida,Broward County,7,13,106723,50631,56092
50,12,11,Florida,Broward County,7,14,89015,42036,46979
50,12,11,Florida,Broward County,7,15,66074,30322,35752
50,12,11,Florida,Broward County,7,16,48214,21032,27182
50,12,11,Florida,Broward County,7,17,37031,15054,21977
50,12,11,Florida,Broward County,7,18,43487,15397,28090
50,12,11,Florida,Broward County,8,0,1885040,917471,967569
50,12,11,Florida,Broward County,8,1,110918,56557,54361
50,12,11,Florida,Broward County,8,2,111160,56394,54766
50,12,11,Florida,Broward County,8,3,112426,56982,55444
50,12,11,Florida,Broward County,8,4,113051,57983,55068
50,12,11,Florida,Broward County,8,5,115986,59050,56936
50,12,11,Florida,Broward County,8,6,126801,63209,63592
50,12,11,Florida,Broward County,8,7,127448,62360,65088
50,12,11,Florida,Broward County,8,8,123969,60411,63558
50,12,11,Florida,Broward County,8,9,127884,62078,65806
50,12,11,Florida,Broward County,8,10,134566,65450,69116
50,12,11,Florida,Broward County,8,11,144634,71298,73336
50,12,11,Florida,Broward County,8,12,132648,64883,67765
50,12,11,Florida,Broward County,8,13,110213,52363,57850
50,12,11,Florida,Broward County,8,14,93141,43925,49216
50,12,11,Florida,Broward County,8,15,69043,31764,37279
50,12,11,Florida,Broward County,8,16,49808,21818,27990
50,12,11,Florida,Broward County,8,17,37033,15092,21941
50,12,11,Florida,Broward County,8,18,44311,15854,28457
50,12,11,Florida,Broward County,9,0,1912583,931399,981184
50,12,11,Florida,Broward County,9,1,112079,57306,54773
50,12,11,Florida,Broward County,9,2,112004,56887,55117
50,12,11,Florida,Broward County,9,3,113382,57433,55949
50,12,11,Florida,Broward County,9,4,112985,57753,55232
50,12,11,Florida,Broward County,9,5,114288,58225,56063
50,12,11,Florida,Broward County,9,6,130721,65084,65637
50,12,11,Florida,Broward County,9,7,129730,63824,65906
50,12,11,Florida,Broward County,9,8,128000,62381,65619
50,12,11,Florida,Broward County,9,9,126176,61402,64774
50,12,11,Florida,Broward County,9,10,135326,65902,69424
50,12,11,Florida,Broward County,9,11,144196,70836,73360
50,12,11,Florida,Broward County,9,12,136102,66668,69434
50,12,11,Florida,Broward County,9,13,113681,54010,59671
50,12,11,Florida,Broward County,9,14,97288,46050,51238
50,12,11,Florida,Broward County,9,15,72008,32963,39045
50,12,11,Florida,Broward County,9,16,52053,22952,29101
50,12,11,Florida,Broward County,9,17,37447,15457,21990
50,12,11,Florida,Broward County,9,18,45117,16266,28851
50,12,11,Florida,Broward County,10,0,1934516,942414,992102
50,12,11,Florida,Broward County,10,1,113133,57750,55383
50,12,11,Florida,Broward County,10,2,112407,57254,55153
50,12,11,Florida,Broward County,10,3,115124,58147,56977
50,12,11,Florida,Broward County,10,4,112643,57391,55252
50,12,11,Florida,Broward County,10,5,112694,57582,55112
50,12,11,Florida,Broward County,10,6,132458,66211,66247
50,12,11,Florida,Broward County,10,7,130917,64619,66298
50,12,11,Florida,Broward County,10,8,130917,63928,66989
50,12,11,Florida,Broward County,10,9,126508,61503,65005
50,12,11,Florida,Broward County,10,10,135204,65752,69452
50,12,11,Florida,Broward County,10,11,142643,69969,72674
50,12,11,Florida,Broward County,10,12,138297,67940,70357
50,12,11,Florida,Broward County,10,13,117532,56115,61417
50,12,11,Florida,Broward County,10,14,97793,45968,51825
50,12,11,Florida,Broward County,10,15,77800,35624,42176
50,12,11,Florida,Broward County,10,16,54357,24067,30290
50,12,11,Florida,Broward County,10,17,38521,15999,22522
50,12,11,Florida,Broward County,10,18,45568,16595,28973
50,12,11,Florida,Broward County,11,0,1946107,947590,998517
50,12,11,Florida,Broward County,11,1,113216,57703,55513
50,12,11,Florida,Broward County,11,2,112455,57225,55230
50,12,11,Florida,Broward County,11,3,116694,58794,57900
50,12,11,Florida,Broward County,11,4,111298,56468,54830
50,12,11,Florida,Broward County,11,5,111068,56605,54463
50,12,11,Florida,Broward County,11,6,131341,65869,65472
50,12,11,Florida,Broward County,11,7,131824,65363,66461
50,12,11,Florida,Broward County,11,8,132699,64833,67866
50,12,11,Florida,Broward County,11,9,126884,61575,65309
50,12,11,Florida,Broward County,11,10,134184,65146,69038
50,12,11,Florida,Broward County,11,11,139642,68331,71311
50,12,11,Florida,Broward County,11,12,139754,68929,70825
50,12,11,Florida,Broward County,11,13,120882,57856,63026
50,12,11,Florida,Broward County,11,14,99627,46576,53051
50,12,11,Florida,Broward County,11,15,80979,37033,43946
50,12,11,Florida,Broward County,11,16,57693,25668,32025
50,12,11,Florida,Broward County,11,17,39775,16674,23101
50,12,11,Florida,Broward County,11,18,46092,16942,29150
50,12,11,Florida,Broward County,12,0,1952778,950870,1001908
50,12,11,Florida,Broward County,12,1,112052,57006,55046
50,12,11,Florida,Broward County,12,2,112981,57538,55443
50,12,11,Florida,Broward County,12,3,116386,58833,57553
50,12,11,Florida,Broward County,12,4,110221,55761,54460
50,12,11,Florida,Broward County,12,5,109266,55643,53623
50,12,11,Florida,Broward County,12,6,129728,65014,64714
50,12,11,Florida,Broward County,12,7,132665,66091,66574
50,12,11,Florida,Broward County,12,8,133609,65374,68235
50,12,11,Florida,Broward County,12,9,127579,62013,65566
50,12,11,Florida,Broward County,12,10,132452,64275,68177
50,12,11,Florida,Broward County,12,11,136223,66569,69654
50,12,11,Florida,Broward County,12,12,141265,69615,71650
50,12,11,Florida,Broward County,12,13,123755,59566,64189
50,12,11,Florida,Broward County,12,14,102342,47675,54667
50,12,11,Florida,Broward County,12,15,84208,38382,45826
50,12,11,Florida,Broward County,12,16,60266,26808,33458
50,12,11,Florida,Broward County,12,17,41248,17391,23857
50,12,11,Florida,Broward County,12,18,46532,17316,29216
50,12,13,Florida,Calhoun County,1,0,14625,7955,6670
50,12,13,Florida,Calhoun County,1,1,909,450,459
50,12,13,Florida,Calhoun County,1,2,814,415,399
50,12,13,Florida,Calhoun County,1,3,886,452,434
50,12,13,Florida,Calhoun County,1,4,869,442,427
50,12,13,Florida,Calhoun County,1,5,895,511,384
50,12,13,Florida,Calhoun County,1,6,1000,630,370
50,12,13,Florida,Calhoun County,1,7,992,615,377
50,12,13,Florida,Calhoun County,1,8,1004,636,368
50,12,13,Florida,Calhoun County,1,9,1025,618,407
50,12,13,Florida,Calhoun County,1,10,1089,629,460
50,12,13,Florida,Calhoun County,1,11,1107,609,498
50,12,13,Florida,Calhoun County,1,12,953,500,453
50,12,13,Florida,Calhoun County,1,13,824,405,419
50,12,13,Florida,Calhoun County,1,14,732,348,384
50,12,13,Florida,Calhoun County,1,15,588,313,275
50,12,13,Florida,Calhoun County,1,16,413,181,232
50,12,13,Florida,Calhoun County,1,17,280,131,149
50,12,13,Florida,Calhoun County,1,18,245,70,175
50,12,13,Florida,Calhoun County,2,0,14627,7955,6672
50,12,13,Florida,Calhoun County,2,1,909,450,459
50,12,13,Florida,Calhoun County,2,2,814,415,399
50,12,13,Florida,Calhoun County,2,3,886,452,434
50,12,13,Florida,Calhoun County,2,4,869,442,427
50,12,13,Florida,Calhoun County,2,5,895,511,384
50,12,13,Florida,Calhoun County,2,6,1000,630,370
50,12,13,Florida,Calhoun County,2,7,992,615,377
50,12,13,Florida,Calhoun County,2,8,1004,636,368
50,12,13,Florida,Calhoun County,2,9,1025,618,407
50,12,13,Florida,Calhoun County,2,10,1089,629,460
50,12,13,Florida,Calhoun County,2,11,1108,609,499
50,12,13,Florida,Calhoun County,2,12,953,500,453
50,12,13,Florida,Calhoun County,2,13,824,405,419
50,12,13,Florida,Calhoun County,2,14,732,348,384
50,12,13,Florida,Calhoun County,2,15,588,313,275
50,12,13,Florida,Calhoun County,2,16,413,181,232
50,12,13,Florida,Calhoun County,2,17,281,131,150
50,12,13,Florida,Calhoun County,2,18,245,70,175
50,12,13,Florida,Calhoun County,3,0,14647,7977,6670
50,12,13,Florida,Calhoun County,3,1,903,448,455
50,12,13,Florida,Calhoun County,3,2,818,420,398
50,12,13,Florida,Calhoun County,3,3,882,451,431
50,12,13,Florida,Calhoun County,3,4,845,429,416
50,12,13,Florida,Calhoun County,3,5,908,517,391
50,12,13,Florida,Calhoun County,3,6,1004,640,364
50,12,13,Florida,Calhoun County,3,7,984,610,374
50,12,13,Florida,Calhoun County,3,8,1000,631,369
50,12,13,Florida,Calhoun County,3,9,1020,619,401
50,12,13,Florida,Calhoun County,3,10,1095,631,464
50,12,13,Florida,Calhoun County,3,11,1110,611,499
50,12,13,Florida,Calhoun County,3,12,957,501,456
50,12,13,Florida,Calhoun County,3,13,833,412,421
50,12,13,Florida,Calhoun County,3,14,737,350,387
50,12,13,Florida,Calhoun County,3,15,587,311,276
50,12,13,Florida,Calhoun County,3,16,420,184,236
50,12,13,Florida,Calhoun County,3,17,293,139,154
50,12,13,Florida,Calhoun County,3,18,251,73,178
50,12,13,Florida,Calhoun County,4,0,14717,8017,6700
50,12,13,Florida,Calhoun County,4,1,858,422,436
50,12,13,Florida,Calhoun County,4,2,858,437,421
50,12,13,Florida,Calhoun County,4,3,910,447,463
50,12,13,Florida,Calhoun County,4,4,804,414,390
50,12,13,Florida,Calhoun County,4,5,958,554,404
50,12,13,Florida,Calhoun County,4,6,1024,670,354
50,12,13,Florida,Calhoun County,4,7,984,610,374
50,12,13,Florida,Calhoun County,4,8,978,616,362
50,12,13,Florida,Calhoun County,4,9,1046,639,407
50,12,13,Florida,Calhoun County,4,10,1091,621,470
50,12,13,Florida,Calhoun County,4,11,1068,596,472
50,12,13,Florida,Calhoun County,4,12,939,490,449
50,12,13,Florida,Calhoun County,4,13,870,438,432
50,12,13,Florida,Calhoun County,4,14,736,335,401
50,12,13,Florida,Calhoun County,4,15,571,298,273
50,12,13,Florida,Calhoun County,4,16,434,197,237
50,12,13,Florida,Calhoun County,4,17,317,151,166
50,12,13,Florida,Calhoun County,4,18,271,82,189
50,12,13,Florida,Calhoun County,5,0,14665,7999,6666
50,12,13,Florida,Calhoun County,5,1,846,424,422
50,12,13,Florida,Calhoun County,5,2,891,462,429
50,12,13,Florida,Calhoun County,5,3,885,448,437
50,12,13,Florida,Calhoun County,5,4,784,398,386
50,12,13,Florida,Calhoun County,5,5,943,550,393
50,12,13,Florida,Calhoun County,5,6,1019,641,378
50,12,13,Florida,Calhoun County,5,7,980,609,371
50,12,13,Florida,Calhoun County,5,8,942,593,349
50,12,13,Florida,Calhoun County,5,9,1035,643,392
50,12,13,Florida,Calhoun County,5,10,1089,624,465
50,12,13,Florida,Calhoun County,5,11,1042,570,472
50,12,13,Florida,Calhoun County,5,12,947,500,447
50,12,13,Florida,Calhoun County,5,13,884,444,440
50,12,13,Florida,Calhoun County,5,14,752,345,407
50,12,13,Florida,Calhoun County,5,15,580,302,278
50,12,13,Florida,Calhoun County,5,16,448,210,238
50,12,13,Florida,Calhoun County,5,17,320,146,174
50,12,13,Florida,Calhoun County,5,18,278,90,188
50,12,13,Florida,Calhoun County,6,0,14578,7958,6620
50,12,13,Florida,Calhoun County,6,1,791,403,388
50,12,13,Florida,Calhoun County,6,2,927,480,447
50,12,13,Florida,Calhoun County,6,3,839,442,397
50,12,13,Florida,Calhoun County,6,4,805,403,402
50,12,13,Florida,Calhoun County,6,5,872,511,361
50,12,13,Florida,Calhoun County,6,6,1032,638,394
50,12,13,Florida,Calhoun County,6,7,1005,607,398
50,12,13,Florida,Calhoun County,6,8,954,594,360
50,12,13,Florida,Calhoun County,6,9,1002,629,373
50,12,13,Florida,Calhoun County,6,10,1076,636,440
50,12,13,Florida,Calhoun County,6,11,1034,569,465
50,12,13,Florida,Calhoun County,6,12,970,509,461
50,12,13,Florida,Calhoun County,6,13,846,429,417
50,12,13,Florida,Calhoun County,6,14,757,356,401
50,12,13,Florida,Calhoun County,6,15,591,294,297
50,12,13,Florida,Calhoun County,6,16,457,220,237
50,12,13,Florida,Calhoun County,6,17,327,141,186
50,12,13,Florida,Calhoun County,6,18,293,97,196
50,12,13,Florida,Calhoun County,7,0,14450,7901,6549
50,12,13,Florida,Calhoun County,7,1,758,392,366
50,12,13,Florida,Calhoun County,7,2,906,457,449
50,12,13,Florida,Calhoun County,7,3,806,417,389
50,12,13,Florida,Calhoun County,7,4,813,420,393
50,12,13,Florida,Calhoun County,7,5,849,501,348
50,12,13,Florida,Calhoun County,7,6,1036,650,386
50,12,13,Florida,Calhoun County,7,7,998,600,398
50,12,13,Florida,Calhoun County,7,8,967,608,359
50,12,13,Florida,Calhoun County,7,9,980,606,374
50,12,13,Florida,Calhoun County,7,10,1033,623,410
50,12,13,Florida,Calhoun County,7,11,1020,558,462
50,12,13,Florida,Calhoun County,7,12,973,512,461
50,12,13,Florida,Calhoun County,7,13,855,431,424
50,12,13,Florida,Calhoun County,7,14,755,365,390
50,12,13,Florida,Calhoun County,7,15,628,297,331
50,12,13,Florida,Calhoun County,7,16,463,235,228
50,12,13,Florida,Calhoun County,7,17,309,127,182
50,12,13,Florida,Calhoun County,7,18,301,102,199
50,12,13,Florida,Calhoun County,8,0,14406,7840,6566
50,12,13,Florida,Calhoun County,8,1,752,378,374
50,12,13,Florida,Calhoun County,8,2,886,448,438
50,12,13,Florida,Calhoun County,8,3,826,433,393
50,12,13,Florida,Calhoun County,8,4,807,415,392
50,12,13,Florida,Calhoun County,8,5,812,473,339
50,12,13,Florida,Calhoun County,8,6,1058,666,392
50,12,13,Florida,Calhoun County,8,7,965,593,372
50,12,13,Florida,Calhoun County,8,8,953,569,384
50,12,13,Florida,Calhoun County,8,9,974,602,372
50,12,13,Florida,Calhoun County,8,10,1001,611,390
50,12,13,Florida,Calhoun County,8,11,1008,541,467
50,12,13,Florida,Calhoun County,8,12,992,530,462
50,12,13,Florida,Calhoun County,8,13,862,431,431
50,12,13,Florida,Calhoun County,8,14,760,370,390
50,12,13,Florida,Calhoun County,8,15,660,300,360
50,12,13,Florida,Calhoun County,8,16,470,244,226
50,12,13,Florida,Calhoun County,8,17,308,124,184
50,12,13,Florida,Calhoun County,8,18,312,112,200
50,12,13,Florida,Calhoun County,9,0,14330,7776,6554
50,12,13,Florida,Calhoun County,9,1,747,384,363
50,12,13,Florida,Calhoun County,9,2,859,422,437
50,12,13,Florida,Calhoun County,9,3,843,432,411
50,12,13,Florida,Calhoun County,9,4,797,412,385
50,12,13,Florida,Calhoun County,9,5,751,448,303
50,12,13,Florida,Calhoun County,9,6,1122,692,430
50,12,13,Florida,Calhoun County,9,7,974,603,371
50,12,13,Florida,Calhoun County,9,8,928,546,382
50,12,13,Florida,Calhoun County,9,9,927,573,354
50,12,13,Florida,Calhoun County,9,10,1003,613,390
50,12,13,Florida,Calhoun County,9,11,986,531,455
50,12,13,Florida,Calhoun County,9,12,987,528,459
50,12,13,Florida,Calhoun County,9,13,874,436,438
50,12,13,Florida,Calhoun County,9,14,774,376,398
50,12,13,Florida,Calhoun County,9,15,644,290,354
50,12,13,Florida,Calhoun County,9,16,472,238,234
50,12,13,Florida,Calhoun County,9,17,310,127,183
50,12,13,Florida,Calhoun County,9,18,332,125,207
50,12,13,Florida,Calhoun County,10,0,14428,7870,6558
50,12,13,Florida,Calhoun County,10,1,720,370,350
50,12,13,Florida,Calhoun County,10,2,837,418,419
50,12,13,Florida,Calhoun County,10,3,847,446,401
50,12,13,Florida,Calhoun County,10,4,802,410,392
50,12,13,Florida,Calhoun County,10,5,765,463,302
50,12,13,Florida,Calhoun County,10,6,1085,685,400
50,12,13,Florida,Calhoun County,10,7,982,602,380
50,12,13,Florida,Calhoun County,10,8,963,577,386
50,12,13,Florida,Calhoun County,10,9,923,567,356
50,12,13,Florida,Calhoun County,10,10,1056,649,407
50,12,13,Florida,Calhoun County,10,11,1001,545,456
50,12,13,Florida,Calhoun County,10,12,958,505,453
50,12,13,Florida,Calhoun County,10,13,909,453,456
50,12,13,Florida,Calhoun County,10,14,798,386,412
50,12,13,Florida,Calhoun County,10,15,645,290,355
50,12,13,Florida,Calhoun County,10,16,487,239,248
50,12,13,Florida,Calhoun County,10,17,318,145,173
50,12,13,Florida,Calhoun County,10,18,332,120,212
50,12,13,Florida,Calhoun County,11,0,14543,7932,6611
50,12,13,Florida,Calhoun County,11,1,718,376,342
50,12,13,Florida,Calhoun County,11,2,813,396,417
50,12,13,Florida,Calhoun County,11,3,912,475,437
50,12,13,Florida,Calhoun County,11,4,775,401,374
50,12,13,Florida,Calhoun County,11,5,788,474,314
50,12,13,Florida,Calhoun County,11,6,1089,677,412
50,12,13,Florida,Calhoun County,11,7,1013,624,389
50,12,13,Florida,Calhoun County,11,8,972,577,395
50,12,13,Florida,Calhoun County,11,9,950,584,366
50,12,13,Florida,Calhoun County,11,10,1022,624,398
50,12,13,Florida,Calhoun County,11,11,1001,564,437
50,12,13,Florida,Calhoun County,11,12,955,500,455
50,12,13,Florida,Calhoun County,11,13,932,458,474
50,12,13,Florida,Calhoun County,11,14,792,390,402
50,12,13,Florida,Calhoun County,11,15,658,297,361
50,12,13,Florida,Calhoun County,11,16,500,236,264
50,12,13,Florida,Calhoun County,11,17,326,158,168
50,12,13,Florida,Calhoun County,11,18,327,121,206
50,12,13,Florida,Calhoun County,12,0,14105,7613,6492
50,12,13,Florida,Calhoun County,12,1,678,342,336
50,12,13,Florida,Calhoun County,12,2,756,391,365
50,12,13,Florida,Calhoun County,12,3,894,446,448
50,12,13,Florida,Calhoun County,12,4,750,399,351
50,12,13,Florida,Calhoun County,12,5,755,450,305
50,12,13,Florida,Calhoun County,12,6,976,598,378
50,12,13,Florida,Calhoun County,12,7,949,586,363
50,12,13,Florida,Calhoun County,12,8,936,543,393
50,12,13,Florida,Calhoun County,12,9,904,536,368
50,12,13,Florida,Calhoun County,12,10,995,599,396
50,12,13,Florida,Calhoun County,12,11,931,527,404
50,12,13,Florida,Calhoun County,12,12,957,491,466
50,12,13,Florida,Calhoun County,12,13,954,468,486
50,12,13,Florida,Calhoun County,12,14,808,400,408
50,12,13,Florida,Calhoun County,12,15,696,318,378
50,12,13,Florida,Calhoun County,12,16,524,236,288
50,12,13,Florida,Calhoun County,12,17,341,170,171
50,12,13,Florida,Calhoun County,12,18,301,113,188
50,12,15,Florida,Charlotte County,1,0,159978,77762,82216
50,12,15,Florida,Charlotte County,1,1,5545,2853,2692
50,12,15,Florida,Charlotte County,1,2,6031,3061,2970
50,12,15,Florida,Charlotte County,1,3,6773,3529,3244
50,12,15,Florida,Charlotte County,1,4,7336,3807,3529
50,12,15,Florida,Charlotte County,1,5,5805,3106,2699
50,12,15,Florida,Charlotte County,1,6,5704,2952,2752
50,12,15,Florida,Charlotte County,1,7,5482,2900,2582
50,12,15,Florida,Charlotte County,1,8,6318,3162,3156
50,12,15,Florida,Charlotte County,1,9,7777,3898,3879
50,12,15,Florida,Charlotte County,1,10,10052,4881,5171
50,12,15,Florida,Charlotte County,1,11,11180,5180,6000
50,12,15,Florida,Charlotte County,1,12,12192,5441,6751
50,12,15,Florida,Charlotte County,1,13,15184,7019,8165
50,12,15,Florida,Charlotte County,1,14,15550,7487,8063
50,12,15,Florida,Charlotte County,1,15,13395,6551,6844
50,12,15,Florida,Charlotte County,1,16,10823,5471,5352
50,12,15,Florida,Charlotte County,1,17,8061,3724,4337
50,12,15,Florida,Charlotte County,1,18,6770,2740,4030
50,12,15,Florida,Charlotte County,2,0,159967,77762,82205
50,12,15,Florida,Charlotte County,2,1,5542,2853,2689
50,12,15,Florida,Charlotte County,2,2,6029,3061,2968
50,12,15,Florida,Charlotte County,2,3,6772,3528,3244
50,12,15,Florida,Charlotte County,2,4,7336,3808,3528
50,12,15,Florida,Charlotte County,2,5,5804,3105,2699
50,12,15,Florida,Charlotte County,2,6,5700,2951,2749
50,12,15,Florida,Charlotte County,2,7,5476,2898,2578
50,12,15,Florida,Charlotte County,2,8,6317,3161,3156
50,12,15,Florida,Charlotte County,2,9,7774,3897,3877
50,12,15,Florida,Charlotte County,2,10,10052,4881,5171
50,12,15,Florida,Charlotte County,2,11,11180,5180,6000
50,12,15,Florida,Charlotte County,2,12,12192,5442,6750
50,12,15,Florida,Charlotte County,2,13,15184,7019,8165
50,12,15,Florida,Charlotte County,2,14,15551,7487,8064
50,12,15,Florida,Charlotte County,2,15,13399,6553,6846
50,12,15,Florida,Charlotte County,2,16,10824,5472,5352
50,12,15,Florida,Charlotte County,2,17,8064,3726,4338
50,12,15,Florida,Charlotte County,2,18,6771,2740,4031
50,12,15,Florida,Charlotte County,3,0,159875,77590,82285
50,12,15,Florida,Charlotte County,3,1,5519,2824,2695
50,12,15,Florida,Charlotte County,3,2,5998,3052,2946
50,12,15,Florida,Charlotte County,3,3,6732,3496,3236
50,12,15,Florida,Charlotte County,3,4,7262,3768,3494
50,12,15,Florida,Charlotte County,3,5,5844,3114,2730
50,12,15,Florida,Charlotte County,3,6,5672,2912,2760
50,12,15,Florida,Charlotte County,3,7,5447,2870,2577
50,12,15,Florida,Charlotte County,3,8,6210,3097,3113
50,12,15,Florida,Charlotte County,3,9,7713,3852,3861
50,12,15,Florida,Charlotte County,3,10,9935,4818,5117
50,12,15,Florida,Charlotte County,3,11,11182,5174,6008
50,12,15,Florida,Charlotte County,3,12,12225,5454,6771
50,12,15,Florida,Charlotte County,3,13,15189,7007,8182
50,12,15,Florida,Charlotte County,3,14,15600,7522,8078
50,12,15,Florida,Charlotte County,3,15,13462,6569,6893
50,12,15,Florida,Charlotte County,3,16,10862,5485,5377
50,12,15,Florida,Charlotte County,3,17,8155,3797,4358
50,12,15,Florida,Charlotte County,3,18,6868,2779,4089
50,12,15,Florida,Charlotte County,4,0,159869,77548,82321
50,12,15,Florida,Charlotte County,4,1,5392,2779,2613
50,12,15,Florida,Charlotte County,4,2,5895,3073,2822
50,12,15,Florida,Charlotte County,4,3,6579,3398,3181
50,12,15,Florida,Charlotte County,4,4,7030,3672,3358
50,12,15,Florida,Charlotte County,4,5,6130,3293,2837
50,12,15,Florida,Charlotte County,4,6,5665,2871,2794
50,12,15,Florida,Charlotte County,4,7,5442,2798,2644
50,12,15,Florida,Charlotte County,4,8,5848,2944,2904
50,12,15,Florida,Charlotte County,4,9,7528,3713,3815
50,12,15,Florida,Charlotte County,4,10,9405,4561,4844
50,12,15,Florida,Charlotte County,4,11,11204,5182,6022
50,12,15,Florida,Charlotte County,4,12,12207,5423,6784
50,12,15,Florida,Charlotte County,4,13,15406,7107,8299
50,12,15,Florida,Charlotte County,4,14,15809,7660,8149
50,12,15,Florida,Charlotte County,4,15,13697,6650,7047
50,12,15,Florida,Charlotte County,4,16,11040,5524,5516
50,12,15,Florida,Charlotte County,4,17,8348,3949,4399
50,12,15,Florida,Charlotte County,4,18,7244,2951,4293
50,12,15,Florida,Charlotte County,5,0,162744,79237,83507
50,12,15,Florida,Charlotte County,5,1,5373,2719,2654
50,12,15,Florida,Charlotte County,5,2,5926,3109,2817
50,12,15,Florida,Charlotte County,5,3,6569,3381,3188
50,12,15,Florida,Charlotte County,5,4,6954,3672,3282
50,12,15,Florida,Charlotte County,5,5,6594,3531,3063
50,12,15,Florida,Charlotte County,5,6,5839,3039,2800
50,12,15,Florida,Charlotte County,5,7,5872,3004,2868
50,12,15,Florida,Charlotte County,5,8,5918,3060,2858
50,12,15,Florida,Charlotte County,5,9,7545,3722,3823
50,12,15,Florida,Charlotte County,5,10,9195,4512,4683
50,12,15,Florida,Charlotte County,5,11,11197,5226,5971
50,12,15,Florida,Charlotte County,5,12,12312,5524,6788
50,12,15,Florida,Charlotte County,5,13,14797,6801,7996
50,12,15,Florida,Charlotte County,5,14,16736,8025,8711
50,12,15,Florida,Charlotte County,5,15,14422,7035,7387
50,12,15,Florida,Charlotte County,5,16,11258,5601,5657
50,12,15,Florida,Charlotte County,5,17,8491,4070,4421
50,12,15,Florida,Charlotte County,5,18,7746,3206,4540
50,12,15,Florida,Charlotte County,6,0,164671,80243,84428
50,12,15,Florida,Charlotte County,6,1,5258,2748,2510
50,12,15,Florida,Charlotte County,6,2,5948,3088,2860
50,12,15,Florida,Charlotte County,6,3,6549,3325,3224
50,12,15,Florida,Charlotte County,6,4,6759,3621,3138
50,12,15,Florida,Charlotte County,6,5,6684,3588,3096
50,12,15,Florida,Charlotte County,6,6,6075,3170,2905
50,12,15,Florida,Charlotte County,6,7,5903,2959,2944
50,12,15,Florida,Charlotte County,6,8,5925,3069,2856
50,12,15,Florida,Charlotte County,6,9,7409,3670,3739
50,12,15,Florida,Charlotte County,6,10,8881,4319,4562
50,12,15,Florida,Charlotte County,6,11,11156,5234,5922
50,12,15,Florida,Charlotte County,6,12,12437,5625,6812
50,12,15,Florida,Charlotte County,6,13,14806,6675,8131
50,12,15,Florida,Charlotte County,6,14,17136,8204,8932
50,12,15,Florida,Charlotte County,6,15,15333,7543,7790
50,12,15,Florida,Charlotte County,6,16,11808,5854,5954
50,12,15,Florida,Charlotte County,6,17,8566,4205,4361
50,12,15,Florida,Charlotte County,6,18,8038,3346,4692
50,12,15,Florida,Charlotte County,7,0,168041,81928,86113
50,12,15,Florida,Charlotte County,7,1,5254,2747,2507
50,12,15,Florida,Charlotte County,7,2,5977,3101,2876
50,12,15,Florida,Charlotte County,7,3,6538,3329,3209
50,12,15,Florida,Charlotte County,7,4,6773,3610,3163
50,12,15,Florida,Charlotte County,7,5,6850,3673,3177
50,12,15,Florida,Charlotte County,7,6,6283,3341,2942
50,12,15,Florida,Charlotte County,7,7,5983,3035,2948
50,12,15,Florida,Charlotte County,7,8,5892,3033,2859
50,12,15,Florida,Charlotte County,7,9,7328,3667,3661
50,12,15,Florida,Charlotte County,7,10,8597,4162,4435
50,12,15,Florida,Charlotte County,7,11,11233,5260,5973
50,12,15,Florida,Charlotte County,7,12,12956,5868,7088
50,12,15,Florida,Charlotte County,7,13,14948,6762,8186
50,12,15,Florida,Charlotte County,7,14,17847,8458,9389
50,12,15,Florida,Charlotte County,7,15,16150,7896,8254
50,12,15,Florida,Charlotte County,7,16,12315,6093,6222
50,12,15,Florida,Charlotte County,7,17,8774,4380,4394
50,12,15,Florida,Charlotte County,7,18,8343,3513,4830
50,12,15,Florida,Charlotte County,8,0,172382,83879,88503
50,12,15,Florida,Charlotte County,8,1,5405,2858,2547
50,12,15,Florida,Charlotte County,8,2,5981,3090,2891
50,12,15,Florida,Charlotte County,8,3,6496,3346,3150
50,12,15,Florida,Charlotte County,8,4,6736,3543,3193
50,12,15,Florida,Charlotte County,8,5,6968,3715,3253
50,12,15,Florida,Charlotte County,8,6,6661,3531,3130
50,12,15,Florida,Charlotte County,8,7,6271,3161,3110
50,12,15,Florida,Charlotte County,8,8,6111,3154,2957
50,12,15,Florida,Charlotte County,8,9,7080,3495,3585
50,12,15,Florida,Charlotte County,8,10,8536,4109,4427
50,12,15,Florida,Charlotte County,8,11,11156,5215,5941
50,12,15,Florida,Charlotte County,8,12,13354,6038,7316
50,12,15,Florida,Charlotte County,8,13,15517,7004,8513
50,12,15,Florida,Charlotte County,8,14,18785,8856,9929
50,12,15,Florida,Charlotte County,8,15,16822,8211,8611
50,12,15,Florida,Charlotte County,8,16,12741,6300,6441
50,12,15,Florida,Charlotte County,8,17,8907,4449,4458
50,12,15,Florida,Charlotte County,8,18,8855,3804,5051
50,12,15,Florida,Charlotte County,9,0,177671,86657,91014
50,12,15,Florida,Charlotte County,9,1,5546,2881,2665
50,12,15,Florida,Charlotte County,9,2,5931,3022,2909
50,12,15,Florida,Charlotte County,9,3,6564,3408,3156
50,12,15,Florida,Charlotte County,9,4,6755,3573,3182
50,12,15,Florida,Charlotte County,9,5,6915,3672,3243
50,12,15,Florida,Charlotte County,9,6,7225,3908,3317
50,12,15,Florida,Charlotte County,9,7,6513,3301,3212
50,12,15,Florida,Charlotte County,9,8,6347,3268,3079
50,12,15,Florida,Charlotte County,9,9,6833,3384,3449
50,12,15,Florida,Charlotte County,9,10,8657,4165,4492
50,12,15,Florida,Charlotte County,9,11,11198,5273,5925
50,12,15,Florida,Charlotte County,9,12,13894,6287,7607
50,12,15,Florida,Charlotte County,9,13,16206,7320,8886
50,12,15,Florida,Charlotte County,9,14,19872,9423,10449
50,12,15,Florida,Charlotte County,9,15,17469,8566,8903
50,12,15,Florida,Charlotte County,9,16,13246,6516,6730
50,12,15,Florida,Charlotte County,9,17,9190,4601,4589
50,12,15,Florida,Charlotte County,9,18,9310,4089,5221
50,12,15,Florida,Charlotte County,10,0,181522,88453,93069
50,12,15,Florida,Charlotte County,10,1,5541,2815,2726
50,12,15,Florida,Charlotte County,10,2,5818,2988,2830
50,12,15,Florida,Charlotte County,10,3,6525,3409,3116
50,12,15,Florida,Charlotte County,10,4,6805,3567,3238
50,12,15,Florida,Charlotte County,10,5,6869,3658,3211
50,12,15,Florida,Charlotte County,10,6,7485,4047,3438
50,12,15,Florida,Charlotte County,10,7,6536,3373,3163
50,12,15,Florida,Charlotte County,10,8,6564,3349,3215
50,12,15,Florida,Charlotte County,10,9,6794,3385,3409
50,12,15,Florida,Charlotte County,10,10,8639,4143,4496
50,12,15,Florida,Charlotte County,10,11,11146,5221,5925
50,12,15,Florida,Charlotte County,10,12,14303,6466,7837
50,12,15,Florida,Charlotte County,10,13,16695,7556,9139
50,12,15,Florida,Charlotte County,10,14,19708,9316,10392
50,12,15,Florida,Charlotte County,10,15,18838,9158,9680
50,12,15,Florida,Charlotte County,10,16,14085,6928,7157
50,12,15,Florida,Charlotte County,10,17,9517,4755,4762
50,12,15,Florida,Charlotte County,10,18,9654,4319,5335
50,12,15,Florida,Charlotte County,11,0,184849,90134,94715
50,12,15,Florida,Charlotte County,11,1,5470,2764,2706
50,12,15,Florida,Charlotte County,11,2,5791,3017,2774
50,12,15,Florida,Charlotte County,11,3,6494,3403,3091
50,12,15,Florida,Charlotte County,11,4,6689,3487,3202
50,12,15,Florida,Charlotte County,11,5,6849,3687,3162
50,12,15,Florida,Charlotte County,11,6,7594,4097,3497
50,12,15,Florida,Charlotte County,11,7,6746,3534,3212
50,12,15,Florida,Charlotte County,11,8,6725,3388,3337
50,12,15,Florida,Charlotte County,11,9,6841,3458,3383
50,12,15,Florida,Charlotte County,11,10,8616,4094,4522
50,12,15,Florida,Charlotte County,11,11,10779,5045,5734
50,12,15,Florida,Charlotte County,11,12,14519,6608,7911
50,12,15,Florida,Charlotte County,11,13,17278,7852,9426
50,12,15,Florida,Charlotte County,11,14,19852,9259,10593
50,12,15,Florida,Charlotte County,11,15,19533,9481,10052
50,12,15,Florida,Charlotte County,11,16,15179,7513,7666
50,12,15,Florida,Charlotte County,11,17,10036,5016,5020
50,12,15,Florida,Charlotte County,11,18,9858,4431,5427
50,12,15,Florida,Charlotte County,12,0,188910,92036,96874
50,12,15,Florida,Charlotte County,12,1,5508,2773,2735
50,12,15,Florida,Charlotte County,12,2,6065,3167,2898
50,12,15,Florida,Charlotte County,12,3,6603,3465,3138
50,12,15,Florida,Charlotte County,12,4,6630,3445,3185
50,12,15,Florida,Charlotte County,12,5,6727,3642,3085
50,12,15,Florida,Charlotte County,12,6,7638,4062,3576
50,12,15,Florida,Charlotte County,12,7,7039,3704,3335
50,12,15,Florida,Charlotte County,12,8,7001,3556,3445
50,12,15,Florida,Charlotte County,12,9,6926,3501,3425
50,12,15,Florida,Charlotte County,12,10,8575,4065,4510
50,12,15,Florida,Charlotte County,12,11,10600,4909,5691
50,12,15,Florida,Charlotte County,12,12,14721,6734,7987
50,12,15,Florida,Charlotte County,12,13,17805,8087,9718
50,12,15,Florida,Charlotte County,12,14,20219,9414,10805
50,12,15,Florida,Charlotte County,12,15,20400,9893,10507
50,12,15,Florida,Charlotte County,12,16,15887,7784,8103
50,12,15,Florida,Charlotte County,12,17,10438,5250,5188
50,12,15,Florida,Charlotte County,12,18,10128,4585,5543
50,12,17,Florida,Citrus County,1,0,141236,68359,72877
50,12,17,Florida,Citrus County,1,1,5537,2783,2754
50,12,17,Florida,Citrus County,1,2,5724,2926,2798
50,12,17,Florida,Citrus County,1,3,6602,3361,3241
50,12,17,Florida,Citrus County,1,4,7195,3767,3428
50,12,17,Florida,Citrus County,1,5,5357,2801,2556
50,12,17,Florida,Citrus County,1,6,5007,2532,2475
50,12,17,Florida,Citrus County,1,7,4858,2407,2451
50,12,17,Florida,Citrus County,1,8,5945,2909,3036
50,12,17,Florida,Citrus County,1,9,7134,3388,3746
50,12,17,Florida,Citrus County,1,10,9188,4470,4718
50,12,17,Florida,Citrus County,1,11,10147,4718,5429
50,12,17,Florida,Citrus County,1,12,10666,4854,5812
50,12,17,Florida,Citrus County,1,13,12835,5841,6994
50,12,17,Florida,Citrus County,1,14,13265,6375,6890
50,12,17,Florida,Citrus County,1,15,11332,5720,5612
50,12,17,Florida,Citrus County,1,16,8866,4446,4420
50,12,17,Florida,Citrus County,1,17,6300,2991,3309
50,12,17,Florida,Citrus County,1,18,5278,2070,3208
50,12,17,Florida,Citrus County,2,0,141230,68356,72874
50,12,17,Florida,Citrus County,2,1,5537,2783,2754
50,12,17,Florida,Citrus County,2,2,5724,2926,2798
50,12,17,Florida,Citrus County,2,3,6599,3359,3240
50,12,17,Florida,Citrus County,2,4,7193,3766,3427
50,12,17,Florida,Citrus County,2,5,5359,2802,2557
50,12,17,Florida,Citrus County,2,6,5009,2534,2475
50,12,17,Florida,Citrus County,2,7,4858,2407,2451
50,12,17,Florida,Citrus County,2,8,5944,2909,3035
50,12,17,Florida,Citrus County,2,9,7134,3388,3746
50,12,17,Florida,Citrus County,2,10,9188,4470,4718
50,12,17,Florida,Citrus County,2,11,10148,4718,5430
50,12,17,Florida,Citrus County,2,12,10665,4853,5812
50,12,17,Florida,Citrus County,2,13,12833,5840,6993
50,12,17,Florida,Citrus County,2,14,13265,6375,6890
50,12,17,Florida,Citrus County,2,15,11332,5720,5612
50,12,17,Florida,Citrus County,2,16,8865,4446,4419
50,12,17,Florida,Citrus County,2,17,6299,2990,3309
50,12,17,Florida,Citrus County,2,18,5278,2070,3208
50,12,17,Florida,Citrus County,3,0,141173,68339,72834
50,12,17,Florida,Citrus County,3,1,5518,2777,2741
50,12,17,Florida,Citrus County,3,2,5691,2896,2795
50,12,17,Florida,Citrus County,3,3,6584,3359,3225
50,12,17,Florida,Citrus County,3,4,7128,3742,3386
50,12,17,Florida,Citrus County,3,5,5433,2834,2599
50,12,17,Florida,Citrus County,3,6,5058,2566,2492
50,12,17,Florida,Citrus County,3,7,4891,2422,2469
50,12,17,Florida,Citrus County,3,8,5859,2871,2988
50,12,17,Florida,Citrus County,3,9,7103,3375,3728
50,12,17,Florida,Citrus County,3,10,9153,4430,4723
50,12,17,Florida,Citrus County,3,11,10132,4728,5404
50,12,17,Florida,Citrus County,3,12,10683,4860,5823
50,12,17,Florida,Citrus County,3,13,12789,5817,6972
50,12,17,Florida,Citrus County,3,14,13243,6354,6889
50,12,17,Florida,Citrus County,3,15,11402,5740,5662
50,12,17,Florida,Citrus County,3,16,8871,4454,4417
50,12,17,Florida,Citrus County,3,17,6314,3010,3304
50,12,17,Florida,Citrus County,3,18,5321,2104,3217
50,12,17,Florida,Citrus County,4,0,139764,67643,72121
50,12,17,Florida,Citrus County,4,1,5397,2717,2680
50,12,17,Florida,Citrus County,4,2,5553,2835,2718
50,12,17,Florida,Citrus County,4,3,6335,3240,3095
50,12,17,Florida,Citrus County,4,4,6820,3587,3233
50,12,17,Florida,Citrus County,4,5,5654,2927,2727
50,12,17,Florida,Citrus County,4,6,5111,2610,2501
50,12,17,Florida,Citrus County,4,7,4938,2478,2460
50,12,17,Florida,Citrus County,4,8,5412,2668,2744
50,12,17,Florida,Citrus County,4,9,6871,3268,3603
50,12,17,Florida,Citrus County,4,10,8741,4201,4540
50,12,17,Florida,Citrus County,4,11,9885,4615,5270
50,12,17,Florida,Citrus County,4,12,10581,4828,5753
50,12,17,Florida,Citrus County,4,13,12744,5752,6992
50,12,17,Florida,Citrus County,4,14,13143,6245,6898
50,12,17,Florida,Citrus County,4,15,11709,5828,5881
50,12,17,Florida,Citrus County,4,16,8925,4556,4369
50,12,17,Florida,Citrus County,4,17,6449,3095,3354
50,12,17,Florida,Citrus County,4,18,5496,2193,3303
50,12,17,Florida,Citrus County,5,0,139180,67264,71916
50,12,17,Florida,Citrus County,5,1,5357,2711,2646
50,12,17,Florida,Citrus County,5,2,5550,2807,2743
50,12,17,Florida,Citrus County,5,3,6162,3150,3012
50,12,17,Florida,Citrus County,5,4,6647,3481,3166
50,12,17,Florida,Citrus County,5,5,5679,2932,2747
50,12,17,Florida,Citrus County,5,6,5239,2680,2559
50,12,17,Florida,Citrus County,5,7,4936,2459,2477
50,12,17,Florida,Citrus County,5,8,5092,2520,2572
50,12,17,Florida,Citrus County,5,9,6707,3157,3550
50,12,17,Florida,Citrus County,5,10,8249,3997,4252
50,12,17,Florida,Citrus County,5,11,9769,4592,5177
50,12,17,Florida,Citrus County,5,12,10582,4839,5743
50,12,17,Florida,Citrus County,5,13,12164,5465,6699
50,12,17,Florida,Citrus County,5,14,13634,6379,7255
50,12,17,Florida,Citrus County,5,15,12148,6038,6110
50,12,17,Florida,Citrus County,5,16,9039,4589,4450
50,12,17,Florida,Citrus County,5,17,6515,3160,3355
50,12,17,Florida,Citrus County,5,18,5711,2308,3403
50,12,17,Florida,Citrus County,6,0,138829,67250,71579
50,12,17,Florida,Citrus County,6,1,5384,2746,2638
50,12,17,Florida,Citrus County,6,2,5638,2873,2765
50,12,17,Florida,Citrus County,6,3,5970,3029,2941
50,12,17,Florida,Citrus County,6,4,6412,3361,3051
50,12,17,Florida,Citrus County,6,5,5734,3026,2708
50,12,17,Florida,Citrus County,6,6,5303,2743,2560
50,12,17,Florida,Citrus County,6,7,5046,2530,2516
50,12,17,Florida,Citrus County,6,8,4983,2459,2524
50,12,17,Florida,Citrus County,6,9,6548,3103,3445
50,12,17,Florida,Citrus County,6,10,7841,3769,4072
50,12,17,Florida,Citrus County,6,11,9584,4520,5064
50,12,17,Florida,Citrus County,6,12,10557,4804,5753
50,12,17,Florida,Citrus County,6,13,11924,5357,6567
50,12,17,Florida,Citrus County,6,14,13479,6321,7158
50,12,17,Florida,Citrus County,6,15,12637,6219,6418
50,12,17,Florida,Citrus County,6,16,9410,4756,4654
50,12,17,Florida,Citrus County,6,17,6521,3211,3310
50,12,17,Florida,Citrus County,6,18,5858,2423,3435
50,12,17,Florida,Citrus County,7,0,138828,67149,71679
50,12,17,Florida,Citrus County,7,1,5387,2729,2658
50,12,17,Florida,Citrus County,7,2,5664,2863,2801
50,12,17,Florida,Citrus County,7,3,5945,3026,2919
50,12,17,Florida,Citrus County,7,4,6220,3260,2960
50,12,17,Florida,Citrus County,7,5,5726,3027,2699
50,12,17,Florida,Citrus County,7,6,5446,2784,2662
50,12,17,Florida,Citrus County,7,7,5141,2574,2567
50,12,17,Florida,Citrus County,7,8,4991,2468,2523
50,12,17,Florida,Citrus County,7,9,6290,2965,3325
50,12,17,Florida,Citrus County,7,10,7437,3565,3872
50,12,17,Florida,Citrus County,7,11,9492,4518,4974
50,12,17,Florida,Citrus County,7,12,10520,4801,5719
50,12,17,Florida,Citrus County,7,13,11768,5306,6462
50,12,17,Florida,Citrus County,7,14,13772,6373,7399
50,12,17,Florida,Citrus County,7,15,12816,6237,6579
50,12,17,Florida,Citrus County,7,16,9742,4951,4791
50,12,17,Florida,Citrus County,7,17,6562,3244,3318
50,12,17,Florida,Citrus County,7,18,5909,2458,3451
50,12,17,Florida,Citrus County,8,0,140287,67880,72407
50,12,17,Florida,Citrus County,8,1,5314,2653,2661
50,12,17,Florida,Citrus County,8,2,5716,2906,2810
50,12,17,Florida,Citrus County,8,3,5943,3027,2916
50,12,17,Florida,Citrus County,8,4,6182,3235,2947
50,12,17,Florida,Citrus County,8,5,5749,3023,2726
50,12,17,Florida,Citrus County,8,6,5713,2951,2762
50,12,17,Florida,Citrus County,8,7,5224,2626,2598
50,12,17,Florida,Citrus County,8,8,5102,2554,2548
50,12,17,Florida,Citrus County,8,9,6067,2880,3187
50,12,17,Florida,Citrus County,8,10,7324,3477,3847
50,12,17,Florida,Citrus County,8,11,9437,4512,4925
50,12,17,Florida,Citrus County,8,12,10743,4871,5872
50,12,17,Florida,Citrus County,8,13,11967,5402,6565
50,12,17,Florida,Citrus County,8,14,14175,6580,7595
50,12,17,Florida,Citrus County,8,15,12969,6314,6655
50,12,17,Florida,Citrus County,8,16,9984,5003,4981
50,12,17,Florida,Citrus County,8,17,6747,3374,3373
50,12,17,Florida,Citrus County,8,18,5931,2492,3439
50,12,17,Florida,Citrus County,9,0,142804,68930,73874
50,12,17,Florida,Citrus County,9,1,5412,2723,2689
50,12,17,Florida,Citrus County,9,2,5716,2901,2815
50,12,17,Florida,Citrus County,9,3,5999,3002,2997
50,12,17,Florida,Citrus County,9,4,6157,3233,2924
50,12,17,Florida,Citrus County,9,5,5762,3008,2754
50,12,17,Florida,Citrus County,9,6,6115,3150,2965
50,12,17,Florida,Citrus County,9,7,5480,2785,2695
50,12,17,Florida,Citrus County,9,8,5268,2557,2711
50,12,17,Florida,Citrus County,9,9,5795,2799,2996
50,12,17,Florida,Citrus County,9,10,7327,3420,3907
50,12,17,Florida,Citrus County,9,11,9287,4379,4908
50,12,17,Florida,Citrus County,9,12,10908,4969,5939
50,12,17,Florida,Citrus County,9,13,12343,5577,6766
50,12,17,Florida,Citrus County,9,14,14804,6838,7966
50,12,17,Florida,Citrus County,9,15,13216,6395,6821
50,12,17,Florida,Citrus County,9,16,10329,5171,5158
50,12,17,Florida,Citrus County,9,17,6741,3382,3359
50,12,17,Florida,Citrus County,9,18,6145,2641,3504
50,12,17,Florida,Citrus County,10,0,145415,70393,75022
50,12,17,Florida,Citrus County,10,1,5453,2806,2647
50,12,17,Florida,Citrus County,10,2,5850,2954,2896
50,12,17,Florida,Citrus County,10,3,6279,3175,3104
50,12,17,Florida,Citrus County,10,4,6187,3283,2904
50,12,17,Florida,Citrus County,10,5,5625,2945,2680
50,12,17,Florida,Citrus County,10,6,6407,3339,3068
50,12,17,Florida,Citrus County,10,7,5733,2926,2807
50,12,17,Florida,Citrus County,10,8,5541,2697,2844
50,12,17,Florida,Citrus County,10,9,5700,2784,2916
50,12,17,Florida,Citrus County,10,10,7363,3426,3937
50,12,17,Florida,Citrus County,10,11,9032,4288,4744
50,12,17,Florida,Citrus County,10,12,11025,5039,5986
50,12,17,Florida,Citrus County,10,13,12667,5681,6986
50,12,17,Florida,Citrus County,10,14,14434,6705,7729
50,12,17,Florida,Citrus County,10,15,14125,6778,7347
50,12,17,Florida,Citrus County,10,16,10789,5382,5407
50,12,17,Florida,Citrus County,10,17,6859,3417,3442
50,12,17,Florida,Citrus County,10,18,6346,2768,3578
50,12,17,Florida,Citrus County,11,0,147682,71590,76092
50,12,17,Florida,Citrus County,11,1,5549,2867,2682
50,12,17,Florida,Citrus County,11,2,5925,2978,2947
50,12,17,Florida,Citrus County,11,3,6484,3307,3177
50,12,17,Florida,Citrus County,11,4,6140,3233,2907
50,12,17,Florida,Citrus County,11,5,5595,2970,2625
50,12,17,Florida,Citrus County,11,6,6661,3476,3185
50,12,17,Florida,Citrus County,11,7,5995,3072,2923
50,12,17,Florida,Citrus County,11,8,5729,2796,2933
50,12,17,Florida,Citrus County,11,9,5679,2773,2906
50,12,17,Florida,Citrus County,11,10,7441,3486,3955
50,12,17,Florida,Citrus County,11,11,8790,4156,4634
50,12,17,Florida,Citrus County,11,12,11059,5105,5954
50,12,17,Florida,Citrus County,11,13,12903,5742,7161
50,12,17,Florida,Citrus County,11,14,14439,6677,7762
50,12,17,Florida,Citrus County,11,15,14391,6901,7490
50,12,17,Florida,Citrus County,11,16,11489,5695,5794
50,12,17,Florida,Citrus County,11,17,7053,3533,3520
50,12,17,Florida,Citrus County,11,18,6360,2823,3537
50,12,17,Florida,Citrus County,12,0,149657,72571,77086
50,12,17,Florida,Citrus County,12,1,5510,2848,2662
50,12,17,Florida,Citrus County,12,2,6048,3055,2993
50,12,17,Florida,Citrus County,12,3,6415,3243,3172
50,12,17,Florida,Citrus County,12,4,6183,3231,2952
50,12,17,Florida,Citrus County,12,5,5539,2943,2596
50,12,17,Florida,Citrus County,12,6,6727,3506,3221
50,12,17,Florida,Citrus County,12,7,6254,3231,3023
50,12,17,Florida,Citrus County,12,8,5868,2884,2984
50,12,17,Florida,Citrus County,12,9,5820,2851,2969
50,12,17,Florida,Citrus County,12,10,7341,3401,3940
50,12,17,Florida,Citrus County,12,11,8624,4038,4586
50,12,17,Florida,Citrus County,12,12,11164,5197,5967
50,12,17,Florida,Citrus County,12,13,13226,6008,7218
50,12,17,Florida,Citrus County,12,14,14596,6727,7869
50,12,17,Florida,Citrus County,12,15,14860,7022,7838
50,12,17,Florida,Citrus County,12,16,11859,5844,6015
50,12,17,Florida,Citrus County,12,17,7298,3691,3607
50,12,17,Florida,Citrus County,12,18,6325,2851,3474
50,12,19,Florida,Clay County,1,0,190865,93491,97374
50,12,19,Florida,Clay County,1,1,11869,6079,5790
50,12,19,Florida,Clay County,1,2,13625,7025,6600
50,12,19,Florida,Clay County,1,3,15002,7643,7359
50,12,19,Florida,Clay County,1,4,15061,7809,7252
50,12,19,Florida,Clay County,1,5,10835,5518,5317
50,12,19,Florida,Clay County,1,6,10732,5283,5449
50,12,19,Florida,Clay County,1,7,10961,5197,5764
50,12,19,Florida,Clay County,1,8,13122,6210,6912
50,12,19,Florida,Clay County,1,9,14253,6894,7359
50,12,19,Florida,Clay County,1,10,15954,7840,8114
50,12,19,Florida,Clay County,1,11,14135,6861,7274
50,12,19,Florida,Clay County,1,12,12118,5809,6309
50,12,19,Florida,Clay County,1,13,10906,5249,5657
50,12,19,Florida,Clay County,1,14,7941,3775,4166
50,12,19,Florida,Clay County,1,15,5563,2642,2921
50,12,19,Florida,Clay County,1,16,3873,1774,2099
50,12,19,Florida,Clay County,1,17,2672,1128,1544
50,12,19,Florida,Clay County,1,18,2243,755,1488
50,12,19,Florida,Clay County,2,0,190878,93496,97382
50,12,19,Florida,Clay County,2,1,11869,6079,5790
50,12,19,Florida,Clay County,2,2,13627,7026,6601
50,12,19,Florida,Clay County,2,3,15003,7643,7360
50,12,19,Florida,Clay County,2,4,15063,7809,7254
50,12,19,Florida,Clay County,2,5,10836,5519,5317
50,12,19,Florida,Clay County,2,6,10732,5283,5449
50,12,19,Florida,Clay County,2,7,10963,5198,5765
50,12,19,Florida,Clay County,2,8,13122,6210,6912
50,12,19,Florida,Clay County,2,9,14254,6895,7359
50,12,19,Florida,Clay County,2,10,15954,7840,8114
50,12,19,Florida,Clay County,2,11,14136,6861,7275
50,12,19,Florida,Clay County,2,12,12118,5809,6309
50,12,19,Florida,Clay County,2,13,10906,5249,5657
50,12,19,Florida,Clay County,2,14,7941,3775,4166
50,12,19,Florida,Clay County,2,15,5564,2642,2922
50,12,19,Florida,Clay County,2,16,3875,1775,2100
50,12,19,Florida,Clay County,2,17,2672,1128,1544
50,12,19,Florida,Clay County,2,18,2243,755,1488
50,12,19,Florida,Clay County,3,0,191451,93793,97658
50,12,19,Florida,Clay County,3,1,11846,6050,5796
50,12,19,Florida,Clay County,3,2,13602,7007,6595
50,12,19,Florida,Clay County,3,3,15030,7667,7363
50,12,19,Florida,Clay County,3,4,14944,7715,7229
50,12,19,Florida,Clay County,3,5,11073,5674,5399
50,12,19,Florida,Clay County,3,6,10775,5309,5466
50,12,19,Florida,Clay County,3,7,11028,5240,5788
50,12,19,Florida,Clay County,3,8,13005,6164,6841
50,12,19,Florida,Clay County,3,9,14264,6904,7360
50,12,19,Florida,Clay County,3,10,15902,7806,8096
50,12,19,Florida,Clay County,3,11,14238,6923,7315
50,12,19,Florida,Clay County,3,12,12187,5832,6355
50,12,19,Florida,Clay County,3,13,10994,5288,5706
50,12,19,Florida,Clay County,3,14,8044,3839,4205
50,12,19,Florida,Clay County,3,15,5624,2664,2960
50,12,19,Florida,Clay County,3,16,3910,1794,2116
50,12,19,Florida,Clay County,3,17,2694,1139,1555
50,12,19,Florida,Clay County,3,18,2291,778,1513
50,12,19,Florida,Clay County,4,0,192314,94234,98080
50,12,19,Florida,Clay County,4,1,11467,5837,5630
50,12,19,Florida,Clay County,4,2,13330,6838,6492
50,12,19,Florida,Clay County,4,3,15103,7694,7409
50,12,19,Florida,Clay County,4,4,14579,7492,7087
50,12,19,Florida,Clay County,4,5,11647,6049,5598
50,12,19,Florida,Clay County,4,6,10935,5437,5498
50,12,19,Florida,Clay County,4,7,11122,5355,5767
50,12,19,Florida,Clay County,4,8,12428,5864,6564
50,12,19,Florida,Clay County,4,9,14190,6850,7340
50,12,19,Florida,Clay County,4,10,15511,7608,7903
50,12,19,Florida,Clay County,4,11,14576,7128,7448
50,12,19,Florida,Clay County,4,12,12546,5968,6578
50,12,19,Florida,Clay County,4,13,11453,5495,5958
50,12,19,Florida,Clay County,4,14,8379,4042,4337
50,12,19,Florida,Clay County,4,15,5836,2701,3135
50,12,19,Florida,Clay County,4,16,4009,1861,2148
50,12,19,Florida,Clay County,4,17,2781,1185,1596
50,12,19,Florida,Clay County,4,18,2422,830,1592
50,12,19,Florida,Clay County,5,0,193861,95129,98732
50,12,19,Florida,Clay County,5,1,11200,5803,5397
50,12,19,Florida,Clay County,5,2,13247,6748,6499
50,12,19,Florida,Clay County,5,3,14934,7589,7345
50,12,19,Florida,Clay County,5,4,14440,7425,7015
50,12,19,Florida,Clay County,5,5,11963,6299,5664
50,12,19,Florida,Clay County,5,6,11192,5579,5613
50,12,19,Florida,Clay County,5,7,11452,5509,5943
50,12,19,Florida,Clay County,5,8,12003,5690,6313
50,12,19,Florida,Clay County,5,9,14117,6729,7388
50,12,19,Florida,Clay County,5,10,15107,7452,7655
50,12,19,Florida,Clay County,5,11,14865,7271,7594
50,12,19,Florida,Clay County,5,12,12947,6163,6784
50,12,19,Florida,Clay County,5,13,11325,5453,5872
50,12,19,Florida,Clay County,5,14,9284,4517,4767
50,12,19,Florida,Clay County,5,15,6245,2880,3365
50,12,19,Florida,Clay County,5,16,4152,1932,2220
50,12,19,Florida,Clay County,5,17,2880,1236,1644
50,12,19,Florida,Clay County,5,18,2508,854,1654
50,12,19,Florida,Clay County,6,0,195657,96271,99386
50,12,19,Florida,Clay County,6,1,11044,5705,5339
50,12,19,Florida,Clay County,6,2,13203,6786,6417
50,12,19,Florida,Clay County,6,3,14670,7544,7126
50,12,19,Florida,Clay County,6,4,14279,7338,6941
50,12,19,Florida,Clay County,6,5,12324,6423,5901
50,12,19,Florida,Clay County,6,6,11301,5721,5580
50,12,19,Florida,Clay County,6,7,11697,5690,6007
50,12,19,Florida,Clay County,6,8,11972,5736,6236
50,12,19,Florida,Clay County,6,9,14010,6681,7329
50,12,19,Florida,Clay County,6,10,14637,7186,7451
50,12,19,Florida,Clay County,6,11,15240,7497,7743
50,12,19,Florida,Clay County,6,12,13341,6377,6964
50,12,19,Florida,Clay County,6,13,11418,5479,5939
50,12,19,Florida,Clay County,6,14,9860,4803,5057
50,12,19,Florida,Clay County,6,15,6730,3111,3619
50,12,19,Florida,Clay County,6,16,4341,2002,2339
50,12,19,Florida,Clay County,6,17,2976,1308,1668
50,12,19,Florida,Clay County,6,18,2614,884,1730
50,12,19,Florida,Clay County,7,0,198570,97788,100782
50,12,19,Florida,Clay County,7,1,11220,5833,5387
50,12,19,Florida,Clay County,7,2,13057,6682,6375
50,12,19,Florida,Clay County,7,3,14617,7520,7097
50,12,19,Florida,Clay County,7,4,14259,7346,6913
50,12,19,Florida,Clay County,7,5,12438,6465,5973
50,12,19,Florida,Clay County,7,6,11843,6085,5758
50,12,19,Florida,Clay County,7,7,11969,5901,6068
50,12,19,Florida,Clay County,7,8,12107,5748,6359
50,12,19,Florida,Clay County,7,9,13902,6642,7260
50,12,19,Florida,Clay County,7,10,14270,6980,7290
50,12,19,Florida,Clay County,7,11,15537,7676,7861
50,12,19,Florida,Clay County,7,12,13687,6617,7070
50,12,19,Florida,Clay County,7,13,11856,5632,6224
50,12,19,Florida,Clay County,7,14,10355,5001,5354
50,12,19,Florida,Clay County,7,15,7106,3297,3809
50,12,19,Florida,Clay County,7,16,4656,2114,2542
50,12,19,Florida,Clay County,7,17,3054,1348,1706
50,12,19,Florida,Clay County,7,18,2637,901,1736
50,12,19,Florida,Clay County,8,0,202392,99735,102657
50,12,19,Florida,Clay County,8,1,11343,5945,5398
50,12,19,Florida,Clay County,8,2,13157,6754,6403
50,12,19,Florida,Clay County,8,3,14562,7501,7061
50,12,19,Florida,Clay County,8,4,14532,7474,7058
50,12,19,Florida,Clay County,8,5,12285,6399,5886
50,12,19,Florida,Clay County,8,6,12311,6392,5919
50,12,19,Florida,Clay County,8,7,12503,6162,6341
50,12,19,Florida,Clay County,8,8,12370,5862,6508
50,12,19,Florida,Clay County,8,9,13608,6463,7145
50,12,19,Florida,Clay County,8,10,14239,6978,7261
50,12,19,Florida,Clay County,8,11,15721,7749,7972
50,12,19,Florida,Clay County,8,12,14188,6924,7264
50,12,19,Florida,Clay County,8,13,12393,5817,6576
50,12,19,Florida,Clay County,8,14,10945,5241,5704
50,12,19,Florida,Clay County,8,15,7515,3574,3941
50,12,19,Florida,Clay County,8,16,4962,2218,2744
50,12,19,Florida,Clay County,8,17,3055,1330,1725
50,12,19,Florida,Clay County,8,18,2703,952,1751
50,12,19,Florida,Clay County,9,0,207246,102020,105226
50,12,19,Florida,Clay County,9,1,11693,6063,5630
50,12,19,Florida,Clay County,9,2,13286,6824,6462
50,12,19,Florida,Clay County,9,3,14759,7572,7187
50,12,19,Florida,Clay County,9,4,14780,7578,7202
50,12,19,Florida,Clay County,9,5,11922,6078,5844
50,12,19,Florida,Clay County,9,6,13042,6839,6203
50,12,19,Florida,Clay County,9,7,12935,6371,6564
50,12,19,Florida,Clay County,9,8,13034,6248,6786
50,12,19,Florida,Clay County,9,9,13384,6355,7029
50,12,19,Florida,Clay County,9,10,14586,7140,7446
50,12,19,Florida,Clay County,9,11,15467,7633,7834
50,12,19,Florida,Clay County,9,12,14737,7176,7561
50,12,19,Florida,Clay County,9,13,12892,6064,6828
50,12,19,Florida,Clay County,9,14,11584,5537,6047
50,12,19,Florida,Clay County,9,15,7917,3804,4113
50,12,19,Florida,Clay County,9,16,5192,2314,2878
50,12,19,Florida,Clay County,9,17,3179,1400,1779
50,12,19,Florida,Clay County,9,18,2857,1024,1833
50,12,19,Florida,Clay County,10,0,212228,104587,107641
50,12,19,Florida,Clay County,10,1,11913,6052,5861
50,12,19,Florida,Clay County,10,2,13462,7004,6458
50,12,19,Florida,Clay County,10,3,15053,7712,7341
50,12,19,Florida,Clay County,10,4,14634,7542,7092
50,12,19,Florida,Clay County,10,5,11909,6115,5794
50,12,19,Florida,Clay County,10,6,13534,7059,6475
50,12,19,Florida,Clay County,10,7,13288,6522,6766
50,12,19,Florida,Clay County,10,8,13753,6652,7101
50,12,19,Florida,Clay County,10,9,13486,6455,7031
50,12,19,Florida,Clay County,10,10,14753,7134,7619
50,12,19,Florida,Clay County,10,11,15219,7531,7688
50,12,19,Florida,Clay County,10,12,15252,7469,7783
50,12,19,Florida,Clay County,10,13,13584,6394,7190
50,12,19,Florida,Clay County,10,14,11679,5605,6074
50,12,19,Florida,Clay County,10,15,8829,4271,4558
50,12,19,Florida,Clay County,10,16,5585,2507,3078
50,12,19,Florida,Clay County,10,17,3320,1472,1848
50,12,19,Florida,Clay County,10,18,2975,1091,1884
50,12,19,Florida,Clay County,11,0,215908,106537,109371
50,12,19,Florida,Clay County,11,1,11942,6061,5881
50,12,19,Florida,Clay County,11,2,13545,6989,6556
50,12,19,Florida,Clay County,11,3,15262,7840,7422
50,12,19,Florida,Clay County,11,4,14517,7575,6942
50,12,19,Florida,Clay County,11,5,11893,6040,5853
50,12,19,Florida,Clay County,11,6,13624,7086,6538
50,12,19,Florida,Clay County,11,7,13549,6761,6788
50,12,19,Florida,Clay County,11,8,14259,6925,7334
50,12,19,Florida,Clay County,11,9,13608,6529,7079
50,12,19,Florida,Clay County,11,10,14886,7191,7695
50,12,19,Florida,Clay County,11,11,15025,7381,7644
50,12,19,Florida,Clay County,11,12,15644,7735,7909
50,12,19,Florida,Clay County,11,13,14096,6668,7428
50,12,19,Florida,Clay County,11,14,11984,5736,6248
50,12,19,Florida,Clay County,11,15,9501,4598,4903
50,12,19,Florida,Clay County,11,16,6018,2743,3275
50,12,19,Florida,Clay County,11,17,3493,1552,1941
50,12,19,Florida,Clay County,11,18,3062,1127,1935
50,12,19,Florida,Clay County,12,0,219252,108161,111091
50,12,19,Florida,Clay County,12,1,11884,6027,5857
50,12,19,Florida,Clay County,12,2,13788,7116,6672
50,12,19,Florida,Clay County,12,3,15308,7841,7467
50,12,19,Florida,Clay County,12,4,14495,7526,6969
50,12,19,Florida,Clay County,12,5,12039,6144,5895
50,12,19,Florida,Clay County,12,6,13432,6951,6481
50,12,19,Florida,Clay County,12,7,14046,7025,7021
50,12,19,Florida,Clay County,12,8,14580,7030,7550
50,12,19,Florida,Clay County,12,9,13839,6696,7143
50,12,19,Florida,Clay County,12,10,14615,6980,7635
50,12,19,Florida,Clay County,12,11,14755,7284,7471
50,12,19,Florida,Clay County,12,12,16012,7954,8058
50,12,19,Florida,Clay County,12,13,14615,7007,7608
50,12,19,Florida,Clay County,12,14,12485,5922,6563
50,12,19,Florida,Clay County,12,15,10037,4865,5172
50,12,19,Florida,Clay County,12,16,6420,2960,3460
50,12,19,Florida,Clay County,12,17,3791,1679,2112
50,12,19,Florida,Clay County,12,18,3111,1154,1957
50,12,21,Florida,Collier County,1,0,321520,158494,163026
50,12,21,Florida,Collier County,1,1,16836,8491,8345
50,12,21,Florida,Collier County,1,2,17277,8871,8406
50,12,21,Florida,Collier County,1,3,17451,9003,8448
50,12,21,Florida,Collier County,1,4,17613,9218,8395
50,12,21,Florida,Collier County,1,5,15516,8380,7136
50,12,21,Florida,Collier County,1,6,16504,8626,7878
50,12,21,Florida,Collier County,1,7,16046,8308,7738
50,12,21,Florida,Collier County,1,8,16892,8440,8452
50,12,21,Florida,Collier County,1,9,18665,9345,9320
50,12,21,Florida,Collier County,1,10,20763,10249,10514
50,12,21,Florida,Collier County,1,11,20066,9564,10502
50,12,21,Florida,Collier County,1,12,19857,9042,10815
50,12,21,Florida,Collier County,1,13,23083,10369,12714
50,12,21,Florida,Collier County,1,14,24701,11495,13206
50,12,21,Florida,Collier County,1,15,21453,10500,10953
50,12,21,Florida,Collier County,1,16,16857,8405,8452
50,12,21,Florida,Collier County,1,17,12433,6085,6348
50,12,21,Florida,Collier County,1,18,9507,4103,5404
50,12,21,Florida,Collier County,2,0,321522,158496,163026
50,12,21,Florida,Collier County,2,1,16836,8491,8345
50,12,21,Florida,Collier County,2,2,17277,8871,8406
50,12,21,Florida,Collier County,2,3,17451,9003,8448
50,12,21,Florida,Collier County,2,4,17613,9218,8395
50,12,21,Florida,Collier County,2,5,15516,8380,7136
50,12,21,Florida,Collier County,2,6,16504,8626,7878
50,12,21,Florida,Collier County,2,7,16046,8308,7738
50,12,21,Florida,Collier County,2,8,16893,8440,8453
50,12,21,Florida,Collier County,2,9,18665,9345,9320
50,12,21,Florida,Collier County,2,10,20763,10249,10514
50,12,21,Florida,Collier County,2,11,20067,9565,10502
50,12,21,Florida,Collier County,2,12,19857,9042,10815
50,12,21,Florida,Collier County,2,13,23083,10369,12714
50,12,21,Florida,Collier County,2,14,24701,11495,13206
50,12,21,Florida,Collier County,2,15,21453,10500,10953
50,12,21,Florida,Collier County,2,16,16857,8405,8452
50,12,21,Florida,Collier County,2,17,12433,6086,6347
50,12,21,Florida,Collier County,2,18,9507,4103,5404
50,12,21,Florida,Collier County,3,0,322581,158984,163597
50,12,21,Florida,Collier County,3,1,16816,8485,8331
50,12,21,Florida,Collier County,3,2,17300,8890,8410
50,12,21,Florida,Collier County,3,3,17467,8995,8472
50,12,21,Florida,Collier County,3,4,17610,9222,8388
50,12,21,Florida,Collier County,3,5,15578,8388,7190
50,12,21,Florida,Collier County,3,6,16528,8651,7877
50,12,21,Florida,Collier County,3,7,16090,8299,7791
50,12,21,Florida,Collier County,3,8,16813,8418,8395
50,12,21,Florida,Collier County,3,9,18690,9336,9354
50,12,21,Florida,Collier County,3,10,20731,10249,10482
50,12,21,Florida,Collier County,3,11,20200,9640,10560
50,12,21,Florida,Collier County,3,12,19941,9093,10848
50,12,21,Florida,Collier County,3,13,23105,10383,12722
50,12,21,Florida,Collier County,3,14,24789,11522,13267
50,12,21,Florida,Collier County,3,15,21643,10586,11057
50,12,21,Florida,Collier County,3,16,16963,8453,8510
50,12,21,Florida,Collier County,3,17,12615,6172,6443
50,12,21,Florida,Collier County,3,18,9702,4202,5500
50,12,21,Florida,Collier County,4,0,327629,161479,166150
50,12,21,Florida,Collier County,4,1,16804,8505,8299
50,12,21,Florida,Collier County,4,2,17471,9013,8458
50,12,21,Florida,Collier County,4,3,17438,8949,8489
50,12,21,Florida,Collier County,4,4,17587,9244,8343
50,12,21,Florida,Collier County,4,5,16072,8628,7444
50,12,21,Florida,Collier County,4,6,16665,8720,7945
50,12,21,Florida,Collier County,4,7,16311,8355,7956
50,12,21,Florida,Collier County,4,8,16413,8303,8110
50,12,21,Florida,Collier County,4,9,18908,9328,9580
50,12,21,Florida,Collier County,4,10,20600,10245,10355
50,12,21,Florida,Collier County,4,11,20678,9934,10744
50,12,21,Florida,Collier County,4,12,20105,9248,10857
50,12,21,Florida,Collier County,4,13,23427,10487,12940
50,12,21,Florida,Collier County,4,14,25111,11589,13522
50,12,21,Florida,Collier County,4,15,22478,10961,11517
50,12,21,Florida,Collier County,4,16,17697,8766,8931
50,12,21,Florida,Collier County,4,17,13339,6565,6774
50,12,21,Florida,Collier County,4,18,10525,4639,5886
50,12,21,Florida,Collier County,5,0,332233,163657,168576
50,12,21,Florida,Collier County,5,1,16631,8465,8166
50,12,21,Florida,Collier County,5,2,17599,9052,8547
50,12,21,Florida,Collier County,5,3,17663,9047,8616
50,12,21,Florida,Collier County,5,4,17429,9188,8241
50,12,21,Florida,Collier County,5,5,16410,8752,7658
50,12,21,Florida,Collier County,5,6,16763,8849,7914
50,12,21,Florida,Collier County,5,7,16469,8444,8025
50,12,21,Florida,Collier County,5,8,16339,8239,8100
50,12,21,Florida,Collier County,5,9,18774,9235,9539
50,12,21,Florida,Collier County,5,10,20544,10231,10313
50,12,21,Florida,Collier County,5,11,20889,10061,10828
50,12,21,Florida,Collier County,5,12,20618,9437,11181
50,12,21,Florida,Collier County,5,13,22441,10088,12353
50,12,21,Florida,Collier County,5,14,26336,12024,14312
50,12,21,Florida,Collier County,5,15,23526,11436,12090
50,12,21,Florida,Collier County,5,16,18476,9043,9433
50,12,21,Florida,Collier County,5,17,13937,6940,6997
50,12,21,Florida,Collier County,5,18,11389,5126,6263
50,12,21,Florida,Collier County,6,0,338987,166814,172173
50,12,21,Florida,Collier County,6,1,16474,8436,8038
50,12,21,Florida,Collier County,6,2,17751,9126,8625
50,12,21,Florida,Collier County,6,3,17745,9083,8662
50,12,21,Florida,Collier County,6,4,17520,9188,8332
50,12,21,Florida,Collier County,6,5,16847,8912,7935
50,12,21,Florida,Collier County,6,6,16864,8923,7941
50,12,21,Florida,Collier County,6,7,16793,8632,8161
50,12,21,Florida,Collier County,6,8,16496,8257,8239
50,12,21,Florida,Collier County,6,9,18772,9208,9564
50,12,21,Florida,Collier County,6,10,20502,10241,10261
50,12,21,Florida,Collier County,6,11,21507,10378,11129
50,12,21,Florida,Collier County,6,12,21345,9865,11480
50,12,21,Florida,Collier County,6,13,22570,10139,12431
50,12,21,Florida,Collier County,6,14,26285,12032,14253
50,12,21,Florida,Collier County,6,15,25262,12040,13222
50,12,21,Florida,Collier County,6,16,19652,9644,10008
50,12,21,Florida,Collier County,6,17,14320,7093,7227
50,12,21,Florida,Collier County,6,18,12282,5617,6665
50,12,21,Florida,Collier County,7,0,347211,171099,176112
50,12,21,Florida,Collier County,7,1,16684,8561,8123
50,12,21,Florida,Collier County,7,2,17793,9151,8642
50,12,21,Florida,Collier County,7,3,18049,9308,8741
50,12,21,Florida,Collier County,7,4,17614,9215,8399
50,12,21,Florida,Collier County,7,5,17468,9251,8217
50,12,21,Florida,Collier County,7,6,17215,9119,8096
50,12,21,Florida,Collier County,7,7,17113,8783,8330
50,12,21,Florida,Collier County,7,8,16854,8530,8324
50,12,21,Florida,Collier County,7,9,18583,9123,9460
50,12,21,Florida,Collier County,7,10,20313,10126,10187
50,12,21,Florida,Collier County,7,11,22091,10733,11358
50,12,21,Florida,Collier County,7,12,22014,10224,11790
50,12,21,Florida,Collier County,7,13,23203,10523,12680
50,12,21,Florida,Collier County,7,14,26917,12307,14610
50,12,21,Florida,Collier County,7,15,26354,12454,13900
50,12,21,Florida,Collier County,7,16,20889,10255,10634
50,12,21,Florida,Collier County,7,17,14747,7248,7499
50,12,21,Florida,Collier County,7,18,13310,6188,7122
50,12,21,Florida,Collier County,8,0,356041,175596,180445
50,12,21,Florida,Collier County,8,1,16678,8560,8118
50,12,21,Florida,Collier County,8,2,17870,9149,8721
50,12,21,Florida,Collier County,8,3,18354,9490,8864
50,12,21,Florida,Collier County,8,4,17727,9321,8406
50,12,21,Florida,Collier County,8,5,17745,9405,8340
50,12,21,Florida,Collier County,8,6,17476,9271,8205
50,12,21,Florida,Collier County,8,7,17297,8983,8314
50,12,21,Florida,Collier County,8,8,17254,8753,8501
50,12,21,Florida,Collier County,8,9,18450,9078,9372
50,12,21,Florida,Collier County,8,10,20467,10179,10288
50,12,21,Florida,Collier County,8,11,22659,11010,11649
50,12,21,Florida,Collier County,8,12,22839,10654,12185
50,12,21,Florida,Collier County,8,13,24028,10924,13104
50,12,21,Florida,Collier County,8,14,27978,12792,15186
50,12,21,Florida,Collier County,8,15,27540,12955,14585
50,12,21,Florida,Collier County,8,16,21936,10755,11181
50,12,21,Florida,Collier County,8,17,15396,7621,7775
50,12,21,Florida,Collier County,8,18,14347,6696,7651
50,12,21,Florida,Collier County,9,0,365445,179960,185485
50,12,21,Florida,Collier County,9,1,16591,8488,8103
50,12,21,Florida,Collier County,9,2,17883,9079,8804
50,12,21,Florida,Collier County,9,3,18735,9658,9077
50,12,21,Florida,Collier County,9,4,17987,9393,8594
50,12,21,Florida,Collier County,9,5,17882,9417,8465
50,12,21,Florida,Collier County,9,6,17851,9367,8484
50,12,21,Florida,Collier County,9,7,17680,9301,8379
50,12,21,Florida,Collier County,9,8,17682,8997,8685
50,12,21,Florida,Collier County,9,9,18172,8953,9219
50,12,21,Florida,Collier County,9,10,21047,10402,10645
50,12,21,Florida,Collier County,9,11,22915,11184,11731
50,12,21,Florida,Collier County,9,12,23767,11143,12624
50,12,21,Florida,Collier County,9,13,24715,11237,13478
50,12,21,Florida,Collier County,9,14,29168,13313,15855
50,12,21,Florida,Collier County,9,15,28461,13387,15074
50,12,21,Florida,Collier County,9,16,23179,11308,11871
50,12,21,Florida,Collier County,9,17,16205,8063,8142
50,12,21,Florida,Collier County,9,18,15525,7270,8255
50,12,21,Florida,Collier County,10,0,372678,183561,189117
50,12,21,Florida,Collier County,10,1,16688,8529,8159
50,12,21,Florida,Collier County,10,2,17665,9017,8648
50,12,21,Florida,Collier County,10,3,18944,9717,9227
50,12,21,Florida,Collier County,10,4,18263,9464,8799
50,12,21,Florida,Collier County,10,5,17857,9457,8400
50,12,21,Florida,Collier County,10,6,18096,9473,8623
50,12,21,Florida,Collier County,10,7,17867,9421,8446
50,12,21,Florida,Collier County,10,8,18205,9381,8824
50,12,21,Florida,Collier County,10,9,17956,8915,9041
50,12,21,Florida,Collier County,10,10,21083,10366,10717
50,12,21,Florida,Collier County,10,11,23152,11319,11833
50,12,21,Florida,Collier County,10,12,24237,11374,12863
50,12,21,Florida,Collier County,10,13,25322,11582,13740
50,12,21,Florida,Collier County,10,14,28648,13084,15564
50,12,21,Florida,Collier County,10,15,30264,14128,16136
50,12,21,Florida,Collier County,10,16,24635,12004,12631
50,12,21,Florida,Collier County,10,17,17271,8465,8806
50,12,21,Florida,Collier County,10,18,16525,7865,8660
50,12,21,Florida,Collier County,11,0,378201,186291,191910
50,12,21,Florida,Collier County,11,1,16661,8544,8117
50,12,21,Florida,Collier County,11,2,17357,8864,8493
50,12,21,Florida,Collier County,11,3,19076,9716,9360
50,12,21,Florida,Collier County,11,4,18258,9473,8785
50,12,21,Florida,Collier County,11,5,17759,9387,8372
50,12,21,Florida,Collier County,11,6,18258,9568,8690
50,12,21,Florida,Collier County,11,7,17751,9411,8340
50,12,21,Florida,Collier County,11,8,18497,9585,8912
50,12,21,Florida,Collier County,11,9,18162,8970,9192
50,12,21,Florida,Collier County,11,10,20802,10184,10618
50,12,21,Florida,Collier County,11,11,22918,11222,11696
50,12,21,Florida,Collier County,11,12,24679,11657,13022
50,12,21,Florida,Collier County,11,13,25919,11897,14022
50,12,21,Florida,Collier County,11,14,28706,13157,15549
50,12,21,Florida,Collier County,11,15,30888,14499,16389
50,12,21,Florida,Collier County,11,16,26612,12748,13864
50,12,21,Florida,Collier County,11,17,18397,9062,9335
50,12,21,Florida,Collier County,11,18,17501,8347,9154
50,12,21,Florida,Collier County,12,0,384902,189649,195253
50,12,21,Florida,Collier County,12,1,16664,8492,8172
50,12,21,Florida,Collier County,12,2,17433,8943,8490
50,12,21,Florida,Collier County,12,3,18938,9637,9301
50,12,21,Florida,Collier County,12,4,18524,9636,8888
50,12,21,Florida,Collier County,12,5,17730,9315,8415
50,12,21,Florida,Collier County,12,6,18451,9675,8776
50,12,21,Florida,Collier County,12,7,18021,9533,8488
50,12,21,Florida,Collier County,12,8,18743,9722,9021
50,12,21,Florida,Collier County,12,9,18300,9115,9185
50,12,21,Florida,Collier County,12,10,20554,10033,10521
50,12,21,Florida,Collier County,12,11,22703,11099,11604
50,12,21,Florida,Collier County,12,12,25272,11986,13286
50,12,21,Florida,Collier County,12,13,26862,12403,14459
50,12,21,Florida,Collier County,12,14,28976,13426,15550
50,12,21,Florida,Collier County,12,15,31851,14893,16958
50,12,21,Florida,Collier County,12,16,27915,13282,14633
50,12,21,Florida,Collier County,12,17,19622,9647,9975
50,12,21,Florida,Collier County,12,18,18343,8812,9531
50,12,23,Florida,Columbia County,1,0,67531,34951,32580
50,12,23,Florida,Columbia County,1,1,4232,2157,2075
50,12,23,Florida,Columbia County,1,2,4156,2149,2007
50,12,23,Florida,Columbia County,1,3,4205,2190,2015
50,12,23,Florida,Columbia County,1,4,4514,2469,2045
50,12,23,Florida,Columbia County,1,5,4725,2792,1933
50,12,23,Florida,Columbia County,1,6,4271,2310,1961
50,12,23,Florida,Columbia County,1,7,3929,2173,1756
50,12,23,Florida,Columbia County,1,8,3833,2088,1745
50,12,23,Florida,Columbia County,1,9,4242,2271,1971
50,12,23,Florida,Columbia County,1,10,4935,2557,2378
50,12,23,Florida,Columbia County,1,11,5275,2621,2654
50,12,23,Florida,Columbia County,1,12,4547,2301,2246
50,12,23,Florida,Columbia County,1,13,4277,2061,2216
50,12,23,Florida,Columbia County,1,14,3480,1700,1780
50,12,23,Florida,Columbia County,1,15,2563,1232,1331
50,12,23,Florida,Columbia County,1,16,1937,914,1023
50,12,23,Florida,Columbia County,1,17,1316,571,745
50,12,23,Florida,Columbia County,1,18,1094,395,699
50,12,23,Florida,Columbia County,2,0,67526,34950,32576
50,12,23,Florida,Columbia County,2,1,4231,2157,2074
50,12,23,Florida,Columbia County,2,2,4155,2149,2006
50,12,23,Florida,Columbia County,2,3,4205,2190,2015
50,12,23,Florida,Columbia County,2,4,4514,2469,2045
50,12,23,Florida,Columbia County,2,5,4725,2792,1933
50,12,23,Florida,Columbia County,2,6,4270,2310,1960
50,12,23,Florida,Columbia County,2,7,3928,2172,1756
50,12,23,Florida,Columbia County,2,8,3833,2088,1745
50,12,23,Florida,Columbia County,2,9,4242,2271,1971
50,12,23,Florida,Columbia County,2,10,4935,2557,2378
50,12,23,Florida,Columbia County,2,11,5275,2621,2654
50,12,23,Florida,Columbia County,2,12,4547,2301,2246
50,12,23,Florida,Columbia County,2,13,4275,2060,2215
50,12,23,Florida,Columbia County,2,14,3481,1701,1780
50,12,23,Florida,Columbia County,2,15,2563,1232,1331
50,12,23,Florida,Columbia County,2,16,1937,914,1023
50,12,23,Florida,Columbia County,2,17,1316,571,745
50,12,23,Florida,Columbia County,2,18,1094,395,699
50,12,23,Florida,Columbia County,3,0,67553,34943,32610
50,12,23,Florida,Columbia County,3,1,4210,2147,2063
50,12,23,Florida,Columbia County,3,2,4162,2155,2007
50,12,23,Florida,Columbia County,3,3,4219,2193,2026
50,12,23,Florida,Columbia County,3,4,4447,2444,2003
50,12,23,Florida,Columbia County,3,5,4755,2798,1957
50,12,23,Florida,Columbia County,3,6,4297,2321,1976
50,12,23,Florida,Columbia County,3,7,3968,2187,1781
50,12,23,Florida,Columbia County,3,8,3800,2067,1733
50,12,23,Florida,Columbia County,3,9,4228,2263,1965
50,12,23,Florida,Columbia County,3,10,4927,2550,2377
50,12,23,Florida,Columbia County,3,11,5241,2603,2638
50,12,23,Florida,Columbia County,3,12,4584,2314,2270
50,12,23,Florida,Columbia County,3,13,4275,2063,2212
50,12,23,Florida,Columbia County,3,14,3481,1701,1780
50,12,23,Florida,Columbia County,3,15,2596,1250,1346
50,12,23,Florida,Columbia County,3,16,1940,910,1030
50,12,23,Florida,Columbia County,3,17,1322,580,742
50,12,23,Florida,Columbia County,3,18,1101,397,704
50,12,23,Florida,Columbia County,4,0,67317,34760,32557
50,12,23,Florida,Columbia County,4,1,4089,2042,2047
50,12,23,Florida,Columbia County,4,2,4131,2150,1981
50,12,23,Florida,Columbia County,4,3,4195,2144,2051
50,12,23,Florida,Columbia County,4,4,4183,2318,1865
50,12,23,Florida,Columbia County,4,5,4885,2884,2001
50,12,23,Florida,Columbia County,4,6,4303,2330,1973
50,12,23,Florida,Columbia County,4,7,4020,2199,1821
50,12,23,Florida,Columbia County,4,8,3704,1999,1705
50,12,23,Florida,Columbia County,4,9,4225,2251,1974
50,12,23,Florida,Columbia County,4,10,4795,2499,2296
50,12,23,Florida,Columbia County,4,11,5092,2540,2552
50,12,23,Florida,Columbia County,4,12,4717,2333,2384
50,12,23,Florida,Columbia County,4,13,4355,2127,2228
50,12,23,Florida,Columbia County,4,14,3495,1694,1801
50,12,23,Florida,Columbia County,4,15,2668,1306,1362
50,12,23,Florida,Columbia County,4,16,1976,916,1060
50,12,23,Florida,Columbia County,4,17,1364,610,754
50,12,23,Florida,Columbia County,4,18,1120,418,702
50,12,23,Florida,Columbia County,5,0,67884,35264,32620
50,12,23,Florida,Columbia County,5,1,4051,2063,1988
50,12,23,Florida,Columbia County,5,2,4160,2160,2000
50,12,23,Florida,Columbia County,5,3,4262,2196,2066
50,12,23,Florida,Columbia County,5,4,3989,2214,1775
50,12,23,Florida,Columbia County,5,5,5058,3028,2030
50,12,23,Florida,Columbia County,5,6,4387,2402,1985
50,12,23,Florida,Columbia County,5,7,4130,2257,1873
50,12,23,Florida,Columbia County,5,8,3770,2059,1711
50,12,23,Florida,Columbia County,5,9,4213,2259,1954
50,12,23,Florida,Columbia County,5,10,4620,2454,2166
50,12,23,Florida,Columbia County,5,11,5009,2532,2477
50,12,23,Florida,Columbia County,5,12,4971,2428,2543
50,12,23,Florida,Columbia County,5,13,4210,2068,2142
50,12,23,Florida,Columbia County,5,14,3749,1808,1941
50,12,23,Florida,Columbia County,5,15,2731,1330,1401
50,12,23,Florida,Columbia County,5,16,2014,931,1083
50,12,23,Florida,Columbia County,5,17,1367,618,749
50,12,23,Florida,Columbia County,5,18,1193,457,736
50,12,23,Florida,Columbia County,6,0,67417,34944,32473
50,12,23,Florida,Columbia County,6,1,3918,1995,1923
50,12,23,Florida,Columbia County,6,2,4156,2104,2052
50,12,23,Florida,Columbia County,6,3,4187,2191,1996
50,12,23,Florida,Columbia County,6,4,3903,2138,1765
50,12,23,Florida,Columbia County,6,5,4897,2945,1952
50,12,23,Florida,Columbia County,6,6,4346,2388,1958
50,12,23,Florida,Columbia County,6,7,4186,2249,1937
50,12,23,Florida,Columbia County,6,8,3772,2081,1691
50,12,23,Florida,Columbia County,6,9,4138,2225,1913
50,12,23,Florida,Columbia County,6,10,4374,2316,2058
50,12,23,Florida,Columbia County,6,11,4886,2501,2385
50,12,23,Florida,Columbia County,6,12,5054,2447,2607
50,12,23,Florida,Columbia County,6,13,4235,2091,2144
50,12,23,Florida,Columbia County,6,14,3842,1857,1985
50,12,23,Florida,Columbia County,6,15,2870,1380,1490
50,12,23,Florida,Columbia County,6,16,2038,942,1096
50,12,23,Florida,Columbia County,6,17,1391,632,759
50,12,23,Florida,Columbia County,6,18,1224,462,762
50,12,23,Florida,Columbia County,7,0,67779,35135,32644
50,12,23,Florida,Columbia County,7,1,3996,2004,1992
50,12,23,Florida,Columbia County,7,2,4263,2173,2090
50,12,23,Florida,Columbia County,7,3,4109,2153,1956
50,12,23,Florida,Columbia County,7,4,3983,2181,1802
50,12,23,Florida,Columbia County,7,5,4803,2918,1885
50,12,23,Florida,Columbia County,7,6,4368,2379,1989
50,12,23,Florida,Columbia County,7,7,4226,2268,1958
50,12,23,Florida,Columbia County,7,8,3866,2104,1762
50,12,23,Florida,Columbia County,7,9,4120,2238,1882
50,12,23,Florida,Columbia County,7,10,4209,2224,1985
50,12,23,Florida,Columbia County,7,11,4807,2523,2284
50,12,23,Florida,Columbia County,7,12,5070,2439,2631
50,12,23,Florida,Columbia County,7,13,4300,2107,2193
50,12,23,Florida,Columbia County,7,14,3926,1881,2045
50,12,23,Florida,Columbia County,7,15,2984,1436,1548
50,12,23,Florida,Columbia County,7,16,2072,963,1109
50,12,23,Florida,Columbia County,7,17,1404,650,754
50,12,23,Florida,Columbia County,7,18,1273,494,779
50,12,23,Florida,Columbia County,8,0,68222,35390,32832
50,12,23,Florida,Columbia County,8,1,4074,2077,1997
50,12,23,Florida,Columbia County,8,2,4198,2119,2079
50,12,23,Florida,Columbia County,8,3,4101,2123,1978
50,12,23,Florida,Columbia County,8,4,4013,2195,1818
50,12,23,Florida,Columbia County,8,5,4724,2913,1811
50,12,23,Florida,Columbia County,8,6,4483,2434,2049
50,12,23,Florida,Columbia County,8,7,4280,2320,1960
50,12,23,Florida,Columbia County,8,8,3942,2113,1829
50,12,23,Florida,Columbia County,8,9,4001,2181,1820
50,12,23,Florida,Columbia County,8,10,4214,2277,1937
50,12,23,Florida,Columbia County,8,11,4704,2426,2278
50,12,23,Florida,Columbia County,8,12,5044,2449,2595
50,12,23,Florida,Columbia County,8,13,4453,2190,2263
50,12,23,Florida,Columbia County,8,14,4013,1892,2121
50,12,23,Florida,Columbia County,8,15,3082,1491,1591
50,12,23,Florida,Columbia County,8,16,2120,996,1124
50,12,23,Florida,Columbia County,8,17,1449,661,788
50,12,23,Florida,Columbia County,8,18,1327,533,794
50,12,23,Florida,Columbia County,9,0,69265,35896,33369
50,12,23,Florida,Columbia County,9,1,4249,2185,2064
50,12,23,Florida,Columbia County,9,2,4189,2112,2077
50,12,23,Florida,Columbia County,9,3,4219,2165,2054
50,12,23,Florida,Columbia County,9,4,4134,2276,1858
50,12,23,Florida,Columbia County,9,5,4528,2838,1690
50,12,23,Florida,Columbia County,9,6,4638,2526,2112
50,12,23,Florida,Columbia County,9,7,4417,2379,2038
50,12,23,Florida,Columbia County,9,8,4111,2182,1929
50,12,23,Florida,Columbia County,9,9,3898,2114,1784
50,12,23,Florida,Columbia County,9,10,4188,2234,1954
50,12,23,Florida,Columbia County,9,11,4712,2415,2297
50,12,23,Florida,Columbia County,9,12,4895,2419,2476
50,12,23,Florida,Columbia County,9,13,4665,2245,2420
50,12,23,Florida,Columbia County,9,14,4156,2006,2150
50,12,23,Florida,Columbia County,9,15,3146,1502,1644
50,12,23,Florida,Columbia County,9,16,2227,1052,1175
50,12,23,Florida,Columbia County,9,17,1513,689,824
50,12,23,Florida,Columbia County,9,18,1380,557,823
50,12,23,Florida,Columbia County,10,0,69999,36175,33824
50,12,23,Florida,Columbia County,10,1,4255,2148,2107
50,12,23,Florida,Columbia County,10,2,4199,2160,2039
50,12,23,Florida,Columbia County,10,3,4299,2176,2123
50,12,23,Florida,Columbia County,10,4,4191,2310,1881
50,12,23,Florida,Columbia County,10,5,4401,2777,1624
50,12,23,Florida,Columbia County,10,6,4756,2573,2183
50,12,23,Florida,Columbia County,10,7,4388,2370,2018
50,12,23,Florida,Columbia County,10,8,4200,2204,1996
50,12,23,Florida,Columbia County,10,9,3984,2166,1818
50,12,23,Florida,Columbia County,10,10,4141,2171,1970
50,12,23,Florida,Columbia County,10,11,4573,2343,2230
50,12,23,Florida,Columbia County,10,12,4863,2411,2452
50,12,23,Florida,Columbia County,10,13,4870,2326,2544
50,12,23,Florida,Columbia County,10,14,4095,1989,2106
50,12,23,Florida,Columbia County,10,15,3418,1628,1790
50,12,23,Florida,Columbia County,10,16,2350,1125,1225
50,12,23,Florida,Columbia County,10,17,1565,704,861
50,12,23,Florida,Columbia County,10,18,1451,594,857
50,12,23,Florida,Columbia County,11,0,70668,36462,34206
50,12,23,Florida,Columbia County,11,1,4227,2088,2139
50,12,23,Florida,Columbia County,11,2,4246,2194,2052
50,12,23,Florida,Columbia County,11,3,4397,2181,2216
50,12,23,Florida,Columbia County,11,4,4188,2340,1848
50,12,23,Florida,Columbia County,11,5,4479,2794,1685
50,12,23,Florida,Columbia County,11,6,4820,2653,2167
50,12,23,Florida,Columbia County,11,7,4460,2405,2055
50,12,23,Florida,Columbia County,11,8,4281,2220,2061
50,12,23,Florida,Columbia County,11,9,3997,2194,1803
50,12,23,Florida,Columbia County,11,10,4133,2142,1991
50,12,23,Florida,Columbia County,11,11,4371,2263,2108
50,12,23,Florida,Columbia County,11,12,4798,2422,2376
50,12,23,Florida,Columbia County,11,13,4979,2347,2632
50,12,23,Florida,Columbia County,11,14,4123,2001,2122
50,12,23,Florida,Columbia County,11,15,3575,1704,1871
50,12,23,Florida,Columbia County,11,16,2530,1198,1332
50,12,23,Florida,Columbia County,11,17,1583,712,871
50,12,23,Florida,Columbia County,11,18,1481,604,877
50,12,23,Florida,Columbia County,12,0,71686,37103,34583
50,12,23,Florida,Columbia County,12,1,4139,2051,2088
50,12,23,Florida,Columbia County,12,2,4348,2229,2119
50,12,23,Florida,Columbia County,12,3,4430,2244,2186
50,12,23,Florida,Columbia County,12,4,4167,2293,1874
50,12,23,Florida,Columbia County,12,5,4567,2902,1665
50,12,23,Florida,Columbia County,12,6,4776,2659,2117
50,12,23,Florida,Columbia County,12,7,4638,2522,2116
50,12,23,Florida,Columbia County,12,8,4355,2304,2051
50,12,23,Florida,Columbia County,12,9,4125,2248,1877
50,12,23,Florida,Columbia County,12,10,4210,2223,1987
50,12,23,Florida,Columbia County,12,11,4256,2176,2080
50,12,23,Florida,Columbia County,12,12,4824,2450,2374
50,12,23,Florida,Columbia County,12,13,5042,2390,2652
50,12,23,Florida,Columbia County,12,14,4274,2056,2218
50,12,23,Florida,Columbia County,12,15,3712,1736,1976
50,12,23,Florida,Columbia County,12,16,2660,1265,1395
50,12,23,Florida,Columbia County,12,17,1646,737,909
50,12,23,Florida,Columbia County,12,18,1517,618,899
50,12,27,Florida,DeSoto County,1,0,34862,19718,15144
50,12,27,Florida,DeSoto County,1,1,2278,1165,1113
50,12,27,Florida,DeSoto County,1,2,2103,1119,984
50,12,27,Florida,DeSoto County,1,3,2027,1052,975
50,12,27,Florida,DeSoto County,1,4,2456,1475,981
50,12,27,Florida,DeSoto County,1,5,2678,1813,865
50,12,27,Florida,DeSoto County,1,6,2407,1577,830
50,12,27,Florida,DeSoto County,1,7,2200,1376,824
50,12,27,Florida,DeSoto County,1,8,2120,1300,820
50,12,27,Florida,DeSoto County,1,9,2053,1265,788
50,12,27,Florida,DeSoto County,1,10,2175,1251,924
50,12,27,Florida,DeSoto County,1,11,2173,1220,953
50,12,27,Florida,DeSoto County,1,12,2002,1099,903
50,12,27,Florida,DeSoto County,1,13,1962,1002,960
50,12,27,Florida,DeSoto County,1,14,1934,926,1008
50,12,27,Florida,DeSoto County,1,15,1633,824,809
50,12,27,Florida,DeSoto County,1,16,1224,611,613
50,12,27,Florida,DeSoto County,1,17,831,402,429
50,12,27,Florida,DeSoto County,1,18,606,241,365
50,12,27,Florida,DeSoto County,2,0,34862,19718,15144
50,12,27,Florida,DeSoto County,2,1,2278,1165,1113
50,12,27,Florida,DeSoto County,2,2,2103,1119,984
50,12,27,Florida,DeSoto County,2,3,2027,1052,975
50,12,27,Florida,DeSoto County,2,4,2456,1475,981
50,12,27,Florida,DeSoto County,2,5,2678,1813,865
50,12,27,Florida,DeSoto County,2,6,2407,1577,830
50,12,27,Florida,DeSoto County,2,7,2200,1376,824
50,12,27,Florida,DeSoto County,2,8,2120,1300,820
50,12,27,Florida,DeSoto County,2,9,2053,1265,788
50,12,27,Florida,DeSoto County,2,10,2175,1251,924
50,12,27,Florida,DeSoto County,2,11,2173,1220,953
50,12,27,Florida,DeSoto County,2,12,2002,1099,903
50,12,27,Florida,DeSoto County,2,13,1962,1002,960
50,12,27,Florida,DeSoto County,2,14,1934,926,1008
50,12,27,Florida,DeSoto County,2,15,1633,824,809
50,12,27,Florida,DeSoto County,2,16,1224,611,613
50,12,27,Florida,DeSoto County,2,17,831,402,429
50,12,27,Florida,DeSoto County,2,18,606,241,365
50,12,27,Florida,DeSoto County,3,0,34934,19756,15178
50,12,27,Florida,DeSoto County,3,1,2264,1165,1099
50,12,27,Florida,DeSoto County,3,2,2118,1121,997
50,12,27,Florida,DeSoto County,3,3,2032,1060,972
50,12,27,Florida,DeSoto County,3,4,2424,1451,973
50,12,27,Florida,DeSoto County,3,5,2691,1811,880
50,12,27,Florida,DeSoto County,3,6,2426,1585,841
50,12,27,Florida,DeSoto County,3,7,2229,1395,834
50,12,27,Florida,DeSoto County,3,8,2096,1279,817
50,12,27,Florida,DeSoto County,3,9,2054,1263,791
50,12,27,Florida,DeSoto County,3,10,2182,1258,924
50,12,27,Florida,DeSoto County,3,11,2169,1220,949
50,12,27,Florida,DeSoto County,3,12,2015,1105,910
50,12,27,Florida,DeSoto County,3,13,1951,1000,951
50,12,27,Florida,DeSoto County,3,14,1938,926,1012
50,12,27,Florida,DeSoto County,3,15,1648,837,811
50,12,27,Florida,DeSoto County,3,16,1229,614,615
50,12,27,Florida,DeSoto County,3,17,853,416,437
50,12,27,Florida,DeSoto County,3,18,615,250,365
50,12,27,Florida,DeSoto County,4,0,34845,19776,15069
50,12,27,Florida,DeSoto County,4,1,2177,1114,1063
50,12,27,Florida,DeSoto County,4,2,2084,1102,982
50,12,27,Florida,DeSoto County,4,3,2031,1080,951
50,12,27,Florida,DeSoto County,4,4,2273,1341,932
50,12,27,Florida,DeSoto County,4,5,2707,1813,894
50,12,27,Florida,DeSoto County,4,6,2409,1589,820
50,12,27,Florida,DeSoto County,4,7,2331,1484,847
50,12,27,Florida,DeSoto County,4,8,1978,1219,759
50,12,27,Florida,DeSoto County,4,9,2070,1268,802
50,12,27,Florida,DeSoto County,4,10,2167,1281,886
50,12,27,Florida,DeSoto County,4,11,2144,1216,928
50,12,27,Florida,DeSoto County,4,12,2070,1120,950
50,12,27,Florida,DeSoto County,4,13,1959,1018,941
50,12,27,Florida,DeSoto County,4,14,1922,914,1008
50,12,27,Florida,DeSoto County,4,15,1751,906,845
50,12,27,Florida,DeSoto County,4,16,1240,606,634
50,12,27,Florida,DeSoto County,4,17,887,434,453
50,12,27,Florida,DeSoto County,4,18,645,271,374
50,12,27,Florida,DeSoto County,5,0,35005,19846,15159
50,12,27,Florida,DeSoto County,5,1,2093,1066,1027
50,12,27,Florida,DeSoto County,5,2,2051,1108,943
50,12,27,Florida,DeSoto County,5,3,2035,1110,925
50,12,27,Florida,DeSoto County,5,4,2197,1269,928
50,12,27,Florida,DeSoto County,5,5,2672,1786,886
50,12,27,Florida,DeSoto County,5,6,2418,1583,835
50,12,27,Florida,DeSoto County,5,7,2345,1496,849
50,12,27,Florida,DeSoto County,5,8,2008,1273,735
50,12,27,Florida,DeSoto County,5,9,2099,1268,831
50,12,27,Florida,DeSoto County,5,10,2108,1236,872
50,12,27,Florida,DeSoto County,5,11,2212,1255,957
50,12,27,Florida,DeSoto County,5,12,2084,1110,974
50,12,27,Florida,DeSoto County,5,13,1938,1012,926
50,12,27,Florida,DeSoto County,5,14,1978,942,1036
50,12,27,Florida,DeSoto County,5,15,1832,934,898
50,12,27,Florida,DeSoto County,5,16,1285,613,672
50,12,27,Florida,DeSoto County,5,17,935,470,465
50,12,27,Florida,DeSoto County,5,18,715,315,400
50,12,27,Florida,DeSoto County,6,0,34905,19771,15134
50,12,27,Florida,DeSoto County,6,1,2052,1035,1017
50,12,27,Florida,DeSoto County,6,2,1998,1063,935
50,12,27,Florida,DeSoto County,6,3,1943,1053,890
50,12,27,Florida,DeSoto County,6,4,2110,1218,892
50,12,27,Florida,DeSoto County,6,5,2622,1752,870
50,12,27,Florida,DeSoto County,6,6,2481,1619,862
50,12,27,Florida,DeSoto County,6,7,2338,1507,831
50,12,27,Florida,DeSoto County,6,8,2012,1283,729
50,12,27,Florida,DeSoto County,6,9,2119,1299,820
50,12,27,Florida,DeSoto County,6,10,2091,1245,846
50,12,27,Florida,DeSoto County,6,11,2216,1244,972
50,12,27,Florida,DeSoto County,6,12,2068,1108,960
50,12,27,Florida,DeSoto County,6,13,1930,985,945
50,12,27,Florida,DeSoto County,6,14,1965,962,1003
50,12,27,Florida,DeSoto County,6,15,1897,910,987
50,12,27,Florida,DeSoto County,6,16,1350,676,674
50,12,27,Florida,DeSoto County,6,17,957,468,489
50,12,27,Florida,DeSoto County,6,18,756,344,412
50,12,27,Florida,DeSoto County,7,0,35338,20006,15332
50,12,27,Florida,DeSoto County,7,1,1999,1023,976
50,12,27,Florida,DeSoto County,7,2,1976,1051,925
50,12,27,Florida,DeSoto County,7,3,1960,1045,915
50,12,27,Florida,DeSoto County,7,4,2107,1222,885
50,12,27,Florida,DeSoto County,7,5,2655,1805,850
50,12,27,Florida,DeSoto County,7,6,2551,1623,928
50,12,27,Florida,DeSoto County,7,7,2333,1478,855
50,12,27,Florida,DeSoto County,7,8,2020,1319,701
50,12,27,Florida,DeSoto County,7,9,2163,1306,857
50,12,27,Florida,DeSoto County,7,10,2066,1241,825
50,12,27,Florida,DeSoto County,7,11,2240,1270,970
50,12,27,Florida,DeSoto County,7,12,2124,1128,996
50,12,27,Florida,DeSoto County,7,13,1947,975,972
50,12,27,Florida,DeSoto County,7,14,1997,1003,994
50,12,27,Florida,DeSoto County,7,15,1917,930,987
50,12,27,Florida,DeSoto County,7,16,1490,736,754
50,12,27,Florida,DeSoto County,7,17,991,486,505
50,12,27,Florida,DeSoto County,7,18,802,365,437
50,12,27,Florida,DeSoto County,8,0,35648,20274,15374
50,12,27,Florida,DeSoto County,8,1,1886,1011,875
50,12,27,Florida,DeSoto County,8,2,2019,1015,1004
50,12,27,Florida,DeSoto County,8,3,1928,1039,889
50,12,27,Florida,DeSoto County,8,4,2092,1219,873
50,12,27,Florida,DeSoto County,8,5,2546,1741,805
50,12,27,Florida,DeSoto County,8,6,2561,1626,935
50,12,27,Florida,DeSoto County,8,7,2354,1506,848
50,12,27,Florida,DeSoto County,8,8,2225,1432,793
50,12,27,Florida,DeSoto County,8,9,2106,1287,819
50,12,27,Florida,DeSoto County,8,10,2078,1260,818
50,12,27,Florida,DeSoto County,8,11,2307,1303,1004
50,12,27,Florida,DeSoto County,8,12,2125,1145,980
50,12,27,Florida,DeSoto County,8,13,2001,1019,982
50,12,27,Florida,DeSoto County,8,14,2066,1030,1036
50,12,27,Florida,DeSoto County,8,15,1941,941,1000
50,12,27,Florida,DeSoto County,8,16,1534,784,750
50,12,27,Florida,DeSoto County,8,17,993,505,488
50,12,27,Florida,DeSoto County,8,18,886,411,475
50,12,27,Florida,DeSoto County,9,0,36255,20622,15633
50,12,27,Florida,DeSoto County,9,1,1816,970,846
50,12,27,Florida,DeSoto County,9,2,2096,1055,1041
50,12,27,Florida,DeSoto County,9,3,1888,1008,880
50,12,27,Florida,DeSoto County,9,4,2109,1248,861
50,12,27,Florida,DeSoto County,9,5,2459,1652,807
50,12,27,Florida,DeSoto County,9,6,2652,1728,924
50,12,27,Florida,DeSoto County,9,7,2416,1563,853
50,12,27,Florida,DeSoto County,9,8,2358,1498,860
50,12,27,Florida,DeSoto County,9,9,1988,1228,760
50,12,27,Florida,DeSoto County,9,10,2126,1289,837
50,12,27,Florida,DeSoto County,9,11,2311,1311,1000
50,12,27,Florida,DeSoto County,9,12,2195,1183,1012
50,12,27,Florida,DeSoto County,9,13,2128,1071,1057
50,12,27,Florida,DeSoto County,9,14,2118,1060,1058
50,12,27,Florida,DeSoto County,9,15,1975,943,1032
50,12,27,Florida,DeSoto County,9,16,1628,847,781
50,12,27,Florida,DeSoto County,9,17,1032,515,517
50,12,27,Florida,DeSoto County,9,18,960,453,507
50,12,27,Florida,DeSoto County,10,0,37241,21160,16081
50,12,27,Florida,DeSoto County,10,1,1885,984,901
50,12,27,Florida,DeSoto County,10,2,2071,1031,1040
50,12,27,Florida,DeSoto County,10,3,1936,1023,913
50,12,27,Florida,DeSoto County,10,4,2187,1299,888
50,12,27,Florida,DeSoto County,10,5,2484,1664,820
50,12,27,Florida,DeSoto County,10,6,2755,1791,964
50,12,27,Florida,DeSoto County,10,7,2499,1623,876
50,12,27,Florida,DeSoto County,10,8,2514,1615,899
50,12,27,Florida,DeSoto County,10,9,2013,1279,734
50,12,27,Florida,DeSoto County,10,10,2216,1316,900
50,12,27,Florida,DeSoto County,10,11,2222,1257,965
50,12,27,Florida,DeSoto County,10,12,2301,1242,1059
50,12,27,Florida,DeSoto County,10,13,2162,1084,1078
50,12,27,Florida,DeSoto County,10,14,2096,1064,1032
50,12,27,Florida,DeSoto County,10,15,2069,993,1076
50,12,27,Florida,DeSoto County,10,16,1742,885,857
50,12,27,Florida,DeSoto County,10,17,1062,517,545
50,12,27,Florida,DeSoto County,10,18,1027,493,534
50,12,27,Florida,DeSoto County,11,0,37368,21098,16270
50,12,27,Florida,DeSoto County,11,1,1892,972,920
50,12,27,Florida,DeSoto County,11,2,1988,981,1007
50,12,27,Florida,DeSoto County,11,3,1984,1028,956
50,12,27,Florida,DeSoto County,11,4,2139,1255,884
50,12,27,Florida,DeSoto County,11,5,2429,1626,803
50,12,27,Florida,DeSoto County,11,6,2796,1812,984
50,12,27,Florida,DeSoto County,11,7,2524,1619,905
50,12,27,Florida,DeSoto County,11,8,2535,1630,905
50,12,27,Florida,DeSoto County,11,9,2040,1286,754
50,12,27,Florida,DeSoto County,11,10,2192,1303,889
50,12,27,Florida,DeSoto County,11,11,2153,1225,928
50,12,27,Florida,DeSoto County,11,12,2279,1212,1067
50,12,27,Florida,DeSoto County,11,13,2146,1079,1067
50,12,27,Florida,DeSoto County,11,14,2124,1057,1067
50,12,27,Florida,DeSoto County,11,15,2113,1045,1068
50,12,27,Florida,DeSoto County,11,16,1834,889,945
50,12,27,Florida,DeSoto County,11,17,1131,579,552
50,12,27,Florida,DeSoto County,11,18,1069,500,569
50,12,27,Florida,DeSoto County,12,0,38001,21395,16606
50,12,27,Florida,DeSoto County,12,1,1875,927,948
50,12,27,Florida,DeSoto County,12,2,1961,999,962
50,12,27,Florida,DeSoto County,12,3,1984,1014,970
50,12,27,Florida,DeSoto County,12,4,2181,1254,927
50,12,27,Florida,DeSoto County,12,5,2419,1612,807
50,12,27,Florida,DeSoto County,12,6,2796,1809,987
50,12,27,Florida,DeSoto County,12,7,2603,1663,940
50,12,27,Florida,DeSoto County,12,8,2630,1673,957
50,12,27,Florida,DeSoto County,12,9,2071,1324,747
50,12,27,Florida,DeSoto County,12,10,2219,1315,904
50,12,27,Florida,DeSoto County,12,11,2158,1239,919
50,12,27,Florida,DeSoto County,12,12,2311,1235,1076
50,12,27,Florida,DeSoto County,12,13,2235,1114,1121
50,12,27,Florida,DeSoto County,12,14,2148,1069,1079
50,12,27,Florida,DeSoto County,12,15,2187,1092,1095
50,12,27,Florida,DeSoto County,12,16,1863,905,958
50,12,27,Florida,DeSoto County,12,17,1241,614,627
50,12,27,Florida,DeSoto County,12,18,1119,537,582
50,12,29,Florida,Dixie County,1,0,16422,8842,7580
50,12,29,Florida,Dixie County,1,1,865,439,426
50,12,29,Florida,Dixie County,1,2,885,459,426
50,12,29,Florida,Dixie County,1,3,859,430,429
50,12,29,Florida,Dixie County,1,4,880,469,411
50,12,29,Florida,Dixie County,1,5,872,490,382
50,12,29,Florida,Dixie County,1,6,929,544,385
50,12,29,Florida,Dixie County,1,7,923,565,358
50,12,29,Florida,Dixie County,1,8,856,520,336
50,12,29,Florida,Dixie County,1,9,1058,604,454
50,12,29,Florida,Dixie County,1,10,1253,706,547
50,12,29,Florida,Dixie County,1,11,1321,723,598
50,12,29,Florida,Dixie County,1,12,1243,638,605
50,12,29,Florida,Dixie County,1,13,1308,649,659
50,12,29,Florida,Dixie County,1,14,1132,579,553
50,12,29,Florida,Dixie County,1,15,865,463,402
50,12,29,Florida,Dixie County,1,16,576,312,264
50,12,29,Florida,Dixie County,1,17,347,148,199
50,12,29,Florida,Dixie County,1,18,250,104,146
50,12,29,Florida,Dixie County,2,0,16422,8842,7580
50,12,29,Florida,Dixie County,2,1,865,439,426
50,12,29,Florida,Dixie County,2,2,885,459,426
50,12,29,Florida,Dixie County,2,3,859,430,429
50,12,29,Florida,Dixie County,2,4,880,469,411
50,12,29,Florida,Dixie County,2,5,872,490,382
50,12,29,Florida,Dixie County,2,6,929,544,385
50,12,29,Florida,Dixie County,2,7,923,565,358
50,12,29,Florida,Dixie County,2,8,856,520,336
50,12,29,Florida,Dixie County,2,9,1058,604,454
50,12,29,Florida,Dixie County,2,10,1253,706,547
50,12,29,Florida,Dixie County,2,11,1321,723,598
50,12,29,Florida,Dixie County,2,12,1243,638,605
50,12,29,Florida,Dixie County,2,13,1308,649,659
50,12,29,Florida,Dixie County,2,14,1132,579,553
50,12,29,Florida,Dixie County,2,15,865,463,402
50,12,29,Florida,Dixie County,2,16,576,312,264
50,12,29,Florida,Dixie County,2,17,347,148,199
50,12,29,Florida,Dixie County,2,18,250,104,146
50,12,29,Florida,Dixie County,3,0,16400,8843,7557
50,12,29,Florida,Dixie County,3,1,851,429,422
50,12,29,Florida,Dixie County,3,2,877,460,417
50,12,29,Florida,Dixie County,3,3,866,438,428
50,12,29,Florida,Dixie County,3,4,859,462,397
50,12,29,Florida,Dixie County,3,5,877,492,385
50,12,29,Florida,Dixie County,3,6,923,543,380
50,12,29,Florida,Dixie County,3,7,924,563,361
50,12,29,Florida,Dixie County,3,8,861,524,337
50,12,29,Florida,Dixie County,3,9,1041,598,443
50,12,29,Florida,Dixie County,3,10,1243,693,550
50,12,29,Florida,Dixie County,3,11,1320,726,594
50,12,29,Florida,Dixie County,3,12,1250,642,608
50,12,29,Florida,Dixie County,3,13,1303,649,654
50,12,29,Florida,Dixie County,3,14,1142,585,557
50,12,29,Florida,Dixie County,3,15,873,464,409
50,12,29,Florida,Dixie County,3,16,586,319,267
50,12,29,Florida,Dixie County,3,17,355,153,202
50,12,29,Florida,Dixie County,3,18,249,103,146
50,12,29,Florida,Dixie County,4,0,16406,8831,7575
50,12,29,Florida,Dixie County,4,1,878,428,450
50,12,29,Florida,Dixie County,4,2,879,466,413
50,12,29,Florida,Dixie County,4,3,887,447,440
50,12,29,Florida,Dixie County,4,4,823,455,368
50,12,29,Florida,Dixie County,4,5,872,478,394
50,12,29,Florida,Dixie County,4,6,922,543,379
50,12,29,Florida,Dixie County,4,7,939,562,377
50,12,29,Florida,Dixie County,4,8,877,534,343
50,12,29,Florida,Dixie County,4,9,963,562,401
50,12,29,Florida,Dixie County,4,10,1202,668,534
50,12,29,Florida,Dixie County,4,11,1331,726,605
50,12,29,Florida,Dixie County,4,12,1214,613,601
50,12,29,Florida,Dixie County,4,13,1326,674,652
50,12,29,Florida,Dixie County,4,14,1158,599,559
50,12,29,Florida,Dixie County,4,15,909,482,427
50,12,29,Florida,Dixie County,4,16,613,328,285
50,12,29,Florida,Dixie County,4,17,362,164,198
50,12,29,Florida,Dixie County,4,18,251,102,149
50,12,29,Florida,Dixie County,5,0,16153,8699,7454
50,12,29,Florida,Dixie County,5,1,835,395,440
50,12,29,Florida,Dixie County,5,2,847,448,399
50,12,29,Florida,Dixie County,5,3,923,475,448
50,12,29,Florida,Dixie County,5,4,764,427,337
50,12,29,Florida,Dixie County,5,5,856,479,377
50,12,29,Florida,Dixie County,5,6,904,542,362
50,12,29,Florida,Dixie County,5,7,923,550,373
50,12,29,Florida,Dixie County,5,8,868,544,324
50,12,29,Florida,Dixie County,5,9,924,536,388
50,12,29,Florida,Dixie County,5,10,1125,641,484
50,12,29,Florida,Dixie County,5,11,1301,704,597
50,12,29,Florida,Dixie County,5,12,1205,599,606
50,12,29,Florida,Dixie County,5,13,1253,613,640
50,12,29,Florida,Dixie County,5,14,1216,620,596
50,12,29,Florida,Dixie County,5,15,923,498,425
50,12,29,Florida,Dixie County,5,16,638,336,302
50,12,29,Florida,Dixie County,5,17,376,181,195
50,12,29,Florida,Dixie County,5,18,272,111,161
50,12,29,Florida,Dixie County,6,0,16084,8662,7422
50,12,29,Florida,Dixie County,6,1,835,394,441
50,12,29,Florida,Dixie County,6,2,867,472,395
50,12,29,Florida,Dixie County,6,3,870,442,428
50,12,29,Florida,Dixie County,6,4,750,403,347
50,12,29,Florida,Dixie County,6,5,870,507,363
50,12,29,Florida,Dixie County,6,6,885,525,360
50,12,29,Florida,Dixie County,6,7,924,536,388
50,12,29,Florida,Dixie County,6,8,841,542,299
50,12,29,Florida,Dixie County,6,9,897,513,384
50,12,29,Florida,Dixie County,6,10,1091,619,472
50,12,29,Florida,Dixie County,6,11,1280,691,589
50,12,29,Florida,Dixie County,6,12,1224,609,615
50,12,29,Florida,Dixie County,6,13,1207,586,621
50,12,29,Florida,Dixie County,6,14,1217,628,589
50,12,29,Florida,Dixie County,6,15,976,532,444
50,12,29,Florida,Dixie County,6,16,676,351,325
50,12,29,Florida,Dixie County,6,17,377,194,183
50,12,29,Florida,Dixie County,6,18,297,118,179
50,12,29,Florida,Dixie County,7,0,16041,8699,7342
50,12,29,Florida,Dixie County,7,1,810,419,391
50,12,29,Florida,Dixie County,7,2,862,461,401
50,12,29,Florida,Dixie County,7,3,868,438,430
50,12,29,Florida,Dixie County,7,4,754,387,367
50,12,29,Florida,Dixie County,7,5,847,527,320
50,12,29,Florida,Dixie County,7,6,908,545,363
50,12,29,Florida,Dixie County,7,7,886,505,381
50,12,29,Florida,Dixie County,7,8,891,568,323
50,12,29,Florida,Dixie County,7,9,871,513,358
50,12,29,Florida,Dixie County,7,10,1042,600,442
50,12,29,Florida,Dixie County,7,11,1245,678,567
50,12,29,Florida,Dixie County,7,12,1244,616,628
50,12,29,Florida,Dixie County,7,13,1159,571,588
50,12,29,Florida,Dixie County,7,14,1218,614,604
50,12,29,Florida,Dixie County,7,15,994,526,468
50,12,29,Florida,Dixie County,7,16,727,386,341
50,12,29,Florida,Dixie County,7,17,413,222,191
50,12,29,Florida,Dixie County,7,18,302,123,179
50,12,29,Florida,Dixie County,8,0,16353,8968,7385
50,12,29,Florida,Dixie County,8,1,769,411,358
50,12,29,Florida,Dixie County,8,2,874,441,433
50,12,29,Florida,Dixie County,8,3,871,450,421
50,12,29,Florida,Dixie County,8,4,778,405,373
50,12,29,Florida,Dixie County,8,5,826,533,293
50,12,29,Florida,Dixie County,8,6,975,599,376
50,12,29,Florida,Dixie County,8,7,941,553,388
50,12,29,Florida,Dixie County,8,8,971,618,353
50,12,29,Florida,Dixie County,8,9,874,537,337
50,12,29,Florida,Dixie County,8,10,1006,591,415
50,12,29,Florida,Dixie County,8,11,1276,704,572
50,12,29,Florida,Dixie County,8,12,1288,664,624
50,12,29,Florida,Dixie County,8,13,1144,547,597
50,12,29,Florida,Dixie County,8,14,1226,609,617
50,12,29,Florida,Dixie County,8,15,1001,529,472
50,12,29,Florida,Dixie County,8,16,761,405,356
50,12,29,Florida,Dixie County,8,17,449,239,210
50,12,29,Florida,Dixie County,8,18,323,133,190
50,12,29,Florida,Dixie County,9,0,16465,9074,7391
50,12,29,Florida,Dixie County,9,1,764,419,345
50,12,29,Florida,Dixie County,9,2,879,430,449
50,12,29,Florida,Dixie County,9,3,845,454,391
50,12,29,Florida,Dixie County,9,4,813,428,385
50,12,29,Florida,Dixie County,9,5,794,518,276
50,12,29,Florida,Dixie County,9,6,1016,620,396
50,12,29,Florida,Dixie County,9,7,946,560,386
50,12,29,Florida,Dixie County,9,8,986,625,361
50,12,29,Florida,Dixie County,9,9,912,566,346
50,12,29,Florida,Dixie County,9,10,973,574,399
50,12,29,Florida,Dixie County,9,11,1224,681,543
50,12,29,Florida,Dixie County,9,12,1297,677,620
50,12,29,Florida,Dixie County,9,13,1166,570,596
50,12,29,Florida,Dixie County,9,14,1235,612,623
50,12,29,Florida,Dixie County,9,15,1039,544,495
50,12,29,Florida,Dixie County,9,16,758,398,360
50,12,29,Florida,Dixie County,9,17,473,254,219
50,12,29,Florida,Dixie County,9,18,345,144,201
50,12,29,Florida,Dixie County,10,0,16615,9138,7477
50,12,29,Florida,Dixie County,10,1,801,432,369
50,12,29,Florida,Dixie County,10,2,855,426,429
50,12,29,Florida,Dixie County,10,3,868,465,403
50,12,29,Florida,Dixie County,10,4,825,428,397
50,12,29,Florida,Dixie County,10,5,799,526,273
50,12,29,Florida,Dixie County,10,6,1032,635,397
50,12,29,Florida,Dixie County,10,7,922,530,392
50,12,29,Florida,Dixie County,10,8,1029,647,382
50,12,29,Florida,Dixie County,10,9,920,589,331
50,12,29,Florida,Dixie County,10,10,950,555,395
50,12,29,Florida,Dixie County,10,11,1181,663,518
50,12,29,Florida,Dixie County,10,12,1329,684,645
50,12,29,Florida,Dixie County,10,13,1212,596,616
50,12,29,Florida,Dixie County,10,14,1180,580,600
50,12,29,Florida,Dixie County,10,15,1102,566,536
50,12,29,Florida,Dixie County,10,16,765,407,358
50,12,29,Florida,Dixie County,10,17,483,246,237
50,12,29,Florida,Dixie County,10,18,362,163,199
50,12,29,Florida,Dixie County,11,0,16685,9198,7487
50,12,29,Florida,Dixie County,11,1,770,404,366
50,12,29,Florida,Dixie County,11,2,860,436,424
50,12,29,Florida,Dixie County,11,3,873,467,406
50,12,29,Florida,Dixie County,11,4,815,429,386
50,12,29,Florida,Dixie County,11,5,817,522,295
50,12,29,Florida,Dixie County,11,6,1046,659,387
50,12,29,Florida,Dixie County,11,7,934,558,376
50,12,29,Florida,Dixie County,11,8,1047,630,417
50,12,29,Florida,Dixie County,11,9,944,626,318
50,12,29,Florida,Dixie County,11,10,920,524,396
50,12,29,Florida,Dixie County,11,11,1167,662,505
50,12,29,Florida,Dixie County,11,12,1307,669,638
50,12,29,Florida,Dixie County,11,13,1243,611,632
50,12,29,Florida,Dixie County,11,14,1166,581,585
50,12,29,Florida,Dixie County,11,15,1110,568,542
50,12,29,Florida,Dixie County,11,16,798,439,359
50,12,29,Florida,Dixie County,11,17,492,240,252
50,12,29,Florida,Dixie County,11,18,376,173,203
50,12,29,Florida,Dixie County,12,0,16826,9278,7548
50,12,29,Florida,Dixie County,12,1,771,381,390
50,12,29,Florida,Dixie County,12,2,859,462,397
50,12,29,Florida,Dixie County,12,3,939,483,456
50,12,29,Florida,Dixie County,12,4,799,424,375
50,12,29,Florida,Dixie County,12,5,828,536,292
50,12,29,Florida,Dixie County,12,6,996,625,371
50,12,29,Florida,Dixie County,12,7,966,580,386
50,12,29,Florida,Dixie County,12,8,1061,625,436
50,12,29,Florida,Dixie County,12,9,969,638,331
50,12,29,Florida,Dixie County,12,10,939,544,395
50,12,29,Florida,Dixie County,12,11,1125,648,477
50,12,29,Florida,Dixie County,12,12,1288,660,628
50,12,29,Florida,Dixie County,12,13,1302,646,656
50,12,29,Florida,Dixie County,12,14,1168,575,593
50,12,29,Florida,Dixie County,12,15,1102,567,535
50,12,29,Florida,Dixie County,12,16,799,432,367
50,12,29,Florida,Dixie County,12,17,508,258,250
50,12,29,Florida,Dixie County,12,18,407,194,213
50,12,31,Florida,Duval County,1,0,864263,419425,444838
50,12,31,Florida,Duval County,1,1,59501,30386,29115
50,12,31,Florida,Duval County,1,2,55355,28186,27169
50,12,31,Florida,Duval County,1,3,55072,27808,27264
50,12,31,Florida,Duval County,1,4,58187,29480,28707
50,12,31,Florida,Duval County,1,5,66043,33486,32557
50,12,31,Florida,Duval County,1,6,68856,34142,34714
50,12,31,Florida,Duval County,1,7,59999,29539,30460
50,12,31,Florida,Duval County,1,8,58323,28788,29535
50,12,31,Florida,Duval County,1,9,58625,28868,29757
50,12,31,Florida,Duval County,1,10,65294,31740,33554
50,12,31,Florida,Duval County,1,11,63074,30290,32784
50,12,31,Florida,Duval County,1,12,54525,25696,28829
50,12,31,Florida,Duval County,1,13,45240,21271,23969
50,12,31,Florida,Duval County,1,14,31081,14018,17063
50,12,31,Florida,Duval County,1,15,22182,9807,12375
50,12,31,Florida,Duval County,1,16,16877,7043,9834
50,12,31,Florida,Duval County,1,17,13259,4982,8277
50,12,31,Florida,Duval County,1,18,12770,3895,8875
50,12,31,Florida,Duval County,2,0,864253,419422,444831
50,12,31,Florida,Duval County,2,1,59501,30386,29115
50,12,31,Florida,Duval County,2,2,55353,28185,27168
50,12,31,Florida,Duval County,2,3,55071,27808,27263
50,12,31,Florida,Duval County,2,4,58185,29480,28705
50,12,31,Florida,Duval County,2,5,66043,33486,32557
50,12,31,Florida,Duval County,2,6,68856,34142,34714
50,12,31,Florida,Duval County,2,7,59997,29538,30459
50,12,31,Florida,Duval County,2,8,58323,28788,29535
50,12,31,Florida,Duval County,2,9,58624,28867,29757
50,12,31,Florida,Duval County,2,10,65294,31740,33554
50,12,31,Florida,Duval County,2,11,63073,30290,32783
50,12,31,Florida,Duval County,2,12,54525,25696,28829
50,12,31,Florida,Duval County,2,13,45240,21271,23969
50,12,31,Florida,Duval County,2,14,31081,14018,17063
50,12,31,Florida,Duval County,2,15,22182,9807,12375
50,12,31,Florida,Duval County,2,16,16877,7043,9834
50,12,31,Florida,Duval County,2,17,13258,4982,8276
50,12,31,Florida,Duval County,2,18,12770,3895,8875
50,12,31,Florida,Duval County,3,0,865628,420165,445463
50,12,31,Florida,Duval County,3,1,59451,30349,29102
50,12,31,Florida,Duval County,3,2,55381,28260,27121
50,12,31,Florida,Duval County,3,3,55009,27772,27237
50,12,31,Florida,Duval County,3,4,57725,29291,28434
50,12,31,Florida,Duval County,3,5,66372,33590,32782
50,12,31,Florida,Duval County,3,6,69053,34286,34767
50,12,31,Florida,Duval County,3,7,60477,29820,30657
50,12,31,Florida,Duval County,3,8,58043,28627,29416
50,12,31,Florida,Duval County,3,9,58594,28817,29777
50,12,31,Florida,Duval County,3,10,64890,31542,33348
50,12,31,Florida,Duval County,3,11,63257,30417,32840
50,12,31,Florida,Duval County,3,12,54875,25861,29014
50,12,31,Florida,Duval County,3,13,45768,21482,24286
50,12,31,Florida,Duval County,3,14,31390,14185,17205
50,12,31,Florida,Duval County,3,15,22362,9873,12489
50,12,31,Florida,Duval County,3,16,16858,7049,9809
50,12,31,Florida,Duval County,3,17,13255,5021,8234
50,12,31,Florida,Duval County,3,18,12868,3923,8945
50,12,31,Florida,Duval County,4,0,872355,423088,449267
50,12,31,Florida,Duval County,4,1,59895,30557,29338
50,12,31,Florida,Duval County,4,2,55701,28562,27139
50,12,31,Florida,Duval County,4,3,54740,27615,27125
50,12,31,Florida,Duval County,4,4,55243,28090,27153
50,12,31,Florida,Duval County,4,5,67869,34142,33727
50,12,31,Florida,Duval County,4,6,70305,34982,35323
50,12,31,Florida,Duval County,4,7,62614,30798,31816
50,12,31,Florida,Duval County,4,8,56276,27618,28658
50,12,31,Florida,Duval County,4,9,58932,28805,30127
50,12,31,Florida,Duval County,4,10,62832,30457,32375
50,12,31,Florida,Duval County,4,11,64095,30923,33172
50,12,31,Florida,Duval County,4,12,56254,26504,29750
50,12,31,Florida,Duval County,4,13,48319,22612,25707
50,12,31,Florida,Duval County,4,14,32705,14900,17805
50,12,31,Florida,Duval County,4,15,23170,10226,12944
50,12,31,Florida,Duval County,4,16,17026,7154,9872
50,12,31,Florida,Duval County,4,17,13229,5107,8122
50,12,31,Florida,Duval County,4,18,13150,4036,9114
50,12,31,Florida,Duval County,5,0,880108,426452,453656
50,12,31,Florida,Duval County,5,1,60002,30457,29545
50,12,31,Florida,Duval County,5,2,56565,29051,27514
50,12,31,Florida,Duval County,5,3,54441,27516,26925
50,12,31,Florida,Duval County,5,4,54239,27553,26686
50,12,31,Florida,Duval County,5,5,68034,34119,33915
50,12,31,Florida,Duval County,5,6,71345,35764,35581
50,12,31,Florida,Duval County,5,7,64398,31552,32846
50,12,31,Florida,Duval County,5,8,55514,27220,28294
50,12,31,Florida,Duval County,5,9,59267,28997,30270
50,12,31,Florida,Duval County,5,10,61052,29524,31528
50,12,31,Florida,Duval County,5,11,64219,30871,33348
50,12,31,Florida,Duval County,5,12,58199,27399,30800
50,12,31,Florida,Duval County,5,13,48257,22402,25855
50,12,31,Florida,Duval County,5,14,36084,16642,19442
50,12,31,Florida,Duval County,5,15,24318,10712,13606
50,12,31,Florida,Duval County,5,16,17420,7299,10121
50,12,31,Florida,Duval County,5,17,13236,5161,8075
50,12,31,Florida,Duval County,5,18,13518,4213,9305
50,12,31,Florida,Duval County,6,0,885943,429512,456431
50,12,31,Florida,Duval County,6,1,59837,30506,29331
50,12,31,Florida,Duval County,6,2,57561,29541,28020
50,12,31,Florida,Duval County,6,3,53999,27366,26633
50,12,31,Florida,Duval County,6,4,53407,27093,26314
50,12,31,Florida,Duval County,6,5,67008,33948,33060
50,12,31,Florida,Duval County,6,6,73265,36550,36715
50,12,31,Florida,Duval County,6,7,65987,32429,33558
50,12,31,Florida,Duval County,6,8,55483,27083,28400
50,12,31,Florida,Duval County,6,9,58578,28660,29918
50,12,31,Florida,Duval County,6,10,59288,28626,30662
50,12,31,Florida,Duval County,6,11,64218,30865,33353
50,12,31,Florida,Duval County,6,12,59355,27968,31387
50,12,31,Florida,Duval County,6,13,48855,22657,26198
50,12,31,Florida,Duval County,6,14,38247,17702,20545
50,12,31,Florida,Duval County,6,15,25987,11406,14581
50,12,31,Florida,Duval County,6,16,17963,7639,10324
50,12,31,Florida,Duval County,6,17,13189,5135,8054
50,12,31,Florida,Duval County,6,18,13716,4338,9378
50,12,31,Florida,Duval County,7,0,896668,434497,462171
50,12,31,Florida,Duval County,7,1,60576,30820,29756
50,12,31,Florida,Duval County,7,2,58040,29655,28385
50,12,31,Florida,Duval County,7,3,54220,27539,26681
50,12,31,Florida,Duval County,7,4,53465,27124,26341
50,12,31,Florida,Duval County,7,5,66660,33902,32758
50,12,31,Florida,Duval County,7,6,75466,37525,37941
50,12,31,Florida,Duval County,7,7,67572,33248,34324
50,12,31,Florida,Duval County,7,8,56522,27617,28905
50,12,31,Florida,Duval County,7,9,57568,28056,29512
50,12,31,Florida,Duval County,7,10,57802,27991,29811
50,12,31,Florida,Duval County,7,11,64364,30876,33488
50,12,31,Florida,Duval County,7,12,60422,28474,31948
50,12,31,Florida,Duval County,7,13,50397,23436,26961
50,12,31,Florida,Duval County,7,14,40470,18705,21765
50,12,31,Florida,Duval County,7,15,27256,11947,15309
50,12,31,Florida,Duval County,7,16,18676,7983,10693
50,12,31,Florida,Duval County,7,17,13264,5206,8058
50,12,31,Florida,Duval County,7,18,13928,4393,9535
50,12,31,Florida,Duval County,8,0,910578,441851,468727
50,12,31,Florida,Duval County,8,1,61764,31619,30145
50,12,31,Florida,Duval County,8,2,58492,29692,28800
50,12,31,Florida,Duval County,8,3,54294,27659,26635
50,12,31,Florida,Duval County,8,4,53764,27285,26479
50,12,31,Florida,Duval County,8,5,65515,33522,31993
50,12,31,Florida,Duval County,8,6,78018,38824,39194
50,12,31,Florida,Duval County,8,7,69704,34387,35317
50,12,31,Florida,Duval County,8,8,58518,28646,29872
50,12,31,Florida,Duval County,8,9,56552,27566,28986
50,12,31,Florida,Duval County,8,10,57931,28180,29751
50,12,31,Florida,Duval County,8,11,63971,30647,33324
50,12,31,Florida,Duval County,8,12,61569,29181,32388
50,12,31,Florida,Duval County,8,13,52068,24081,27987
50,12,31,Florida,Duval County,8,14,42783,19726,23057
50,12,31,Florida,Duval County,8,15,28693,12714,15979
50,12,31,Florida,Duval County,8,16,19414,8277,11137
50,12,31,Florida,Duval County,8,17,13408,5305,8103
50,12,31,Florida,Duval County,8,18,14120,4540,9580
50,12,31,Florida,Duval County,9,0,926010,449505,476505
50,12,31,Florida,Duval County,9,1,62757,32226,30531
50,12,31,Florida,Duval County,9,2,59408,30181,29227
50,12,31,Florida,Duval County,9,3,55074,28097,26977
50,12,31,Florida,Duval County,9,4,54259,27547,26712
50,12,31,Florida,Duval County,9,5,63958,32937,31021
50,12,31,Florida,Duval County,9,6,80715,40035,40680
50,12,31,Florida,Duval County,9,7,71526,35390,36136
50,12,31,Florida,Duval County,9,8,61200,30051,31149
50,12,31,Florida,Duval County,9,9,55198,26869,28329
50,12,31,Florida,Duval County,9,10,58680,28459,30221
50,12,31,Florida,Duval County,9,11,62828,30067,32761
50,12,31,Florida,Duval County,9,12,63038,29927,33111
50,12,31,Florida,Duval County,9,13,53824,24845,28979
50,12,31,Florida,Duval County,9,14,45299,20694,24605
50,12,31,Florida,Duval County,9,15,29977,13461,16516
50,12,31,Florida,Duval County,9,16,20173,8615,11558
50,12,31,Florida,Duval County,9,17,13661,5376,8285
50,12,31,Florida,Duval County,9,18,14435,4728,9707
50,12,31,Florida,Duval County,10,0,937933,454866,483067
50,12,31,Florida,Duval County,10,1,63632,32654,30978
50,12,31,Florida,Duval County,10,2,59688,30147,29541
50,12,31,Florida,Duval County,10,3,56226,28753,27473
50,12,31,Florida,Duval County,10,4,54087,27453,26634
50,12,31,Florida,Duval County,10,5,62726,32055,30671
50,12,31,Florida,Duval County,10,6,82367,40927,41440
50,12,31,Florida,Duval County,10,7,73093,36328,36765
50,12,31,Florida,Duval County,10,8,63074,30889,32185
50,12,31,Florida,Duval County,10,9,54802,26609,28193
50,12,31,Florida,Duval County,10,10,59069,28721,30348
50,12,31,Florida,Duval County,10,11,61322,29323,31999
50,12,31,Florida,Duval County,10,12,63603,30150,33453
50,12,31,Florida,Duval County,10,13,55965,25830,30135
50,12,31,Florida,Duval County,10,14,45190,20577,24613
50,12,31,Florida,Duval County,10,15,33278,15104,18174
50,12,31,Florida,Duval County,10,16,21197,9033,12164
50,12,31,Florida,Duval County,10,17,13909,5500,8409
50,12,31,Florida,Duval County,10,18,14705,4813,9892
50,12,31,Florida,Duval County,11,0,948652,459755,488897
50,12,31,Florida,Duval County,11,1,64443,32939,31504
50,12,31,Florida,Duval County,11,2,60195,30525,29670
50,12,31,Florida,Duval County,11,3,57632,29469,28163
50,12,31,Florida,Duval County,11,4,53644,27260,26384
50,12,31,Florida,Duval County,11,5,61827,31616,30211
50,12,31,Florida,Duval County,11,6,82351,41058,41293
50,12,31,Florida,Duval County,11,7,75089,37106,37983
50,12,31,Florida,Duval County,11,8,65193,31934,33259
50,12,31,Florida,Duval County,11,9,55102,26711,28391
50,12,31,Florida,Duval County,11,10,58757,28484,30273
50,12,31,Florida,Duval County,11,11,59933,28643,31290
50,12,31,Florida,Duval County,11,12,63733,30210,33523
50,12,31,Florida,Duval County,11,13,57456,26490,30966
50,12,31,Florida,Duval County,11,14,46232,21013,25219
50,12,31,Florida,Duval County,11,15,35276,16076,19200
50,12,31,Florida,Duval County,11,16,22590,9604,12986
50,12,31,Florida,Duval County,11,17,14350,5793,8557
50,12,31,Florida,Duval County,11,18,14849,4824,10025
50,12,31,Florida,Duval County,12,0,957755,464225,493530
50,12,31,Florida,Duval County,12,1,64571,33002,31569
50,12,31,Florida,Duval County,12,2,60744,30946,29798
50,12,31,Florida,Duval County,12,3,57980,29526,28454
50,12,31,Florida,Duval County,12,4,53967,27436,26531
50,12,31,Florida,Duval County,12,5,61291,31438,29853
50,12,31,Florida,Duval County,12,6,81972,40962,41010
50,12,31,Florida,Duval County,12,7,76909,37996,38913
50,12,31,Florida,Duval County,12,8,66644,32783,33861
50,12,31,Florida,Duval County,12,9,55954,27117,28837
50,12,31,Florida,Duval County,12,10,58070,28015,30055
50,12,31,Florida,Duval County,12,11,58637,28098,30539
50,12,31,Florida,Duval County,12,12,63930,30267,33663
50,12,31,Florida,Duval County,12,13,58492,26992,31500
50,12,31,Florida,Duval County,12,14,47521,21629,25892
50,12,31,Florida,Duval County,12,15,37335,16937,20398
50,12,31,Florida,Duval County,12,16,23833,10180,13653
50,12,31,Florida,Duval County,12,17,14900,6022,8878
50,12,31,Florida,Duval County,12,18,15005,4879,10126
50,12,33,Florida,Escambia County,1,0,297619,147119,150500
50,12,33,Florida,Escambia County,1,1,18787,9476,9311
50,12,33,Florida,Escambia County,1,2,17210,8793,8417
50,12,33,Florida,Escambia County,1,3,17092,8664,8428
50,12,33,Florida,Escambia County,1,4,23216,12492,10724
50,12,33,Florida,Escambia County,1,5,26402,13838,12564
50,12,33,Florida,Escambia County,1,6,20975,10896,10079
50,12,33,Florida,Escambia County,1,7,17141,8736,8405
50,12,33,Florida,Escambia County,1,8,16632,8443,8189
50,12,33,Florida,Escambia County,1,9,17380,8650,8730
50,12,33,Florida,Escambia County,1,10,21194,10554,10640
50,12,33,Florida,Escambia County,1,11,22000,10779,11221
50,12,33,Florida,Escambia County,1,12,19379,9224,10155
50,12,33,Florida,Escambia County,1,13,17282,8136,9146
50,12,33,Florida,Escambia County,1,14,13276,6099,7177
50,12,33,Florida,Escambia County,1,15,10208,4673,5535
50,12,33,Florida,Escambia County,1,16,8097,3483,4614
50,12,33,Florida,Escambia County,1,17,6019,2377,3642
50,12,33,Florida,Escambia County,1,18,5329,1806,3523
50,12,33,Florida,Escambia County,2,0,297620,147119,150501
50,12,33,Florida,Escambia County,2,1,18787,9476,9311
50,12,33,Florida,Escambia County,2,2,17210,8793,8417
50,12,33,Florida,Escambia County,2,3,17092,8664,8428
50,12,33,Florida,Escambia County,2,4,23216,12492,10724
50,12,33,Florida,Escambia County,2,5,26402,13838,12564
50,12,33,Florida,Escambia County,2,6,20975,10896,10079
50,12,33,Florida,Escambia County,2,7,17142,8737,8405
50,12,33,Florida,Escambia County,2,8,16632,8443,8189
50,12,33,Florida,Escambia County,2,9,17379,8649,8730
50,12,33,Florida,Escambia County,2,10,21194,10554,10640
50,12,33,Florida,Escambia County,2,11,22000,10779,11221
50,12,33,Florida,Escambia County,2,12,19379,9224,10155
50,12,33,Florida,Escambia County,2,13,17282,8136,9146
50,12,33,Florida,Escambia County,2,14,13276,6099,7177
50,12,33,Florida,Escambia County,2,15,10208,4673,5535
50,12,33,Florida,Escambia County,2,16,8098,3483,4615
50,12,33,Florida,Escambia County,2,17,6019,2377,3642
50,12,33,Florida,Escambia County,2,18,5329,1806,3523
50,12,33,Florida,Escambia County,3,0,298038,147388,150650
50,12,33,Florida,Escambia County,3,1,18795,9491,9304
50,12,33,Florida,Escambia County,3,2,17243,8810,8433
50,12,33,Florida,Escambia County,3,3,17047,8652,8395
50,12,33,Florida,Escambia County,3,4,23067,12457,10610
50,12,33,Florida,Escambia County,3,5,26513,13859,12654
50,12,33,Florida,Escambia County,3,6,21114,10998,10116
50,12,33,Florida,Escambia County,3,7,17324,8840,8484
50,12,33,Florida,Escambia County,3,8,16505,8378,8127
50,12,33,Florida,Escambia County,3,9,17366,8648,8718
50,12,33,Florida,Escambia County,3,10,21053,10477,10576
50,12,33,Florida,Escambia County,3,11,22009,10786,11223
50,12,33,Florida,Escambia County,3,12,19514,9278,10236
50,12,33,Florida,Escambia County,3,13,17453,8204,9249
50,12,33,Florida,Escambia County,3,14,13318,6133,7185
50,12,33,Florida,Escambia County,3,15,10231,4680,5551
50,12,33,Florida,Escambia County,3,16,8102,3483,4619
50,12,33,Florida,Escambia County,3,17,6015,2400,3615
50,12,33,Florida,Escambia County,3,18,5369,1814,3555
50,12,33,Florida,Escambia County,4,0,299401,148262,151139
50,12,33,Florida,Escambia County,4,1,18670,9462,9208
50,12,33,Florida,Escambia County,4,2,17535,8980,8555
50,12,33,Florida,Escambia County,4,3,16986,8676,8310
50,12,33,Florida,Escambia County,4,4,22527,12341,10186
50,12,33,Florida,Escambia County,4,5,26980,14026,12954
50,12,33,Florida,Escambia County,4,6,21501,11109,10392
50,12,33,Florida,Escambia County,4,7,17735,9075,8660
50,12,33,Florida,Escambia County,4,8,15941,8087,7854
50,12,33,Florida,Escambia County,4,9,17326,8646,8680
50,12,33,Florida,Escambia County,4,10,20280,10085,10195
50,12,33,Florida,Escambia County,4,11,22092,10819,11273
50,12,33,Florida,Escambia County,4,12,19994,9506,10488
50,12,33,Florida,Escambia County,4,13,18307,8576,9731
50,12,33,Florida,Escambia County,4,14,13570,6326,7244
50,12,33,Florida,Escambia County,4,15,10351,4734,5617
50,12,33,Florida,Escambia County,4,16,8134,3519,4615
50,12,33,Florida,Escambia County,4,17,6012,2435,3577
50,12,33,Florida,Escambia County,4,18,5460,1860,3600
50,12,33,Florida,Escambia County,5,0,303423,150720,152703
50,12,33,Florida,Escambia County,5,1,18581,9385,9196
50,12,33,Florida,Escambia County,5,2,17967,9189,8778
50,12,33,Florida,Escambia County,5,3,17053,8695,8358
50,12,33,Florida,Escambia County,5,4,22684,12606,10078
50,12,33,Florida,Escambia County,5,5,27982,14842,13140
50,12,33,Florida,Escambia County,5,6,21997,11399,10598
50,12,33,Florida,Escambia County,5,7,18379,9411,8968
50,12,33,Florida,Escambia County,5,8,15923,8086,7837
50,12,33,Florida,Escambia County,5,9,17397,8672,8725
50,12,33,Florida,Escambia County,5,10,19479,9670,9809
50,12,33,Florida,Escambia County,5,11,22005,10755,11250
50,12,33,Florida,Escambia County,5,12,20543,9797,10746
50,12,33,Florida,Escambia County,5,13,18153,8450,9703
50,12,33,Florida,Escambia County,5,14,14808,6965,7843
50,12,33,Florida,Escambia County,5,15,10676,4846,5830
50,12,33,Florida,Escambia County,5,16,8142,3550,4592
50,12,33,Florida,Escambia County,5,17,6025,2472,3553
50,12,33,Florida,Escambia County,5,18,5629,1930,3699
50,12,33,Florida,Escambia County,6,0,306694,153015,153679
50,12,33,Florida,Escambia County,6,1,18573,9420,9153
50,12,33,Florida,Escambia County,6,2,18477,9416,9061
50,12,33,Florida,Escambia County,6,3,17014,8737,8277
50,12,33,Florida,Escambia County,6,4,23026,12978,10048
50,12,33,Florida,Escambia County,6,5,28578,15548,13030
50,12,33,Florida,Escambia County,6,6,22756,11840,10916
50,12,33,Florida,Escambia County,6,7,18969,9738,9231
50,12,33,Florida,Escambia County,6,8,16020,8093,7927
50,12,33,Florida,Escambia County,6,9,17305,8717,8588
50,12,33,Florida,Escambia County,6,10,18570,9156,9414
50,12,33,Florida,Escambia County,6,11,21689,10596,11093
50,12,33,Florida,Escambia County,6,12,21042,9993,11049
50,12,33,Florida,Escambia County,6,13,18131,8437,9694
50,12,33,Florida,Escambia County,6,14,15427,7215,8212
50,12,33,Florida,Escambia County,6,15,11099,5024,6075
50,12,33,Florida,Escambia County,6,16,8306,3629,4677
50,12,33,Florida,Escambia County,6,17,5987,2491,3496
50,12,33,Florida,Escambia County,6,18,5725,1987,3738
50,12,33,Florida,Escambia County,7,0,307960,153274,154686
50,12,33,Florida,Escambia County,7,1,18636,9469,9167
50,12,33,Florida,Escambia County,7,2,18501,9465,9036
50,12,33,Florida,Escambia County,7,3,17051,8758,8293
50,12,33,Florida,Escambia County,7,4,22303,12374,9929
50,12,33,Florida,Escambia County,7,5,27877,15172,12705
50,12,33,Florida,Escambia County,7,6,23598,12248,11350
50,12,33,Florida,Escambia County,7,7,19515,9961,9554
50,12,33,Florida,Escambia County,7,8,16376,8288,8088
50,12,33,Florida,Escambia County,7,9,16883,8461,8422
50,12,33,Florida,Escambia County,7,10,18066,8958,9108
50,12,33,Florida,Escambia County,7,11,21434,10413,11021
50,12,33,Florida,Escambia County,7,12,21437,10281,11156
50,12,33,Florida,Escambia County,7,13,18425,8531,9894
50,12,33,Florida,Escambia County,7,14,15980,7450,8530
50,12,33,Florida,Escambia County,7,15,11589,5275,6314
50,12,33,Florida,Escambia County,7,16,8502,3711,4791
50,12,33,Florida,Escambia County,7,17,5926,2431,3495
50,12,33,Florida,Escambia County,7,18,5861,2028,3833
50,12,33,Florida,Escambia County,8,0,309311,153822,155489
50,12,33,Florida,Escambia County,8,1,18628,9457,9171
50,12,33,Florida,Escambia County,8,2,18563,9490,9073
50,12,33,Florida,Escambia County,8,3,17097,8792,8305
50,12,33,Florida,Escambia County,8,4,21989,12191,9798
50,12,33,Florida,Escambia County,8,5,27165,14885,12280
50,12,33,Florida,Escambia County,8,6,23938,12287,11651
50,12,33,Florida,Escambia County,8,7,20075,10301,9774
50,12,33,Florida,Escambia County,8,8,16916,8549,8367
50,12,33,Florida,Escambia County,8,9,16505,8257,8248
50,12,33,Florida,Escambia County,8,10,17715,8803,8912
50,12,33,Florida,Escambia County,8,11,20832,10070,10762
50,12,33,Florida,Escambia County,8,12,21870,10524,11346
50,12,33,Florida,Escambia County,8,13,18933,8782,10151
50,12,33,Florida,Escambia County,8,14,16627,7690,8937
50,12,33,Florida,Escambia County,8,15,11962,5437,6525
50,12,33,Florida,Escambia County,8,16,8566,3773,4793
50,12,33,Florida,Escambia County,8,17,6012,2433,3579
50,12,33,Florida,Escambia County,8,18,5918,2101,3817
50,12,33,Florida,Escambia County,9,0,311473,154356,157117
50,12,33,Florida,Escambia County,9,1,19041,9729,9312
50,12,33,Florida,Escambia County,9,2,18443,9358,9085
50,12,33,Florida,Escambia County,9,3,17585,8980,8605
50,12,33,Florida,Escambia County,9,4,21389,11762,9627
50,12,33,Florida,Escambia County,9,5,26086,14231,11855
50,12,33,Florida,Escambia County,9,6,24740,12671,12069
50,12,33,Florida,Escambia County,9,7,20555,10459,10096
50,12,33,Florida,Escambia County,9,8,17579,8915,8664
50,12,33,Florida,Escambia County,9,9,16107,8045,8062
50,12,33,Florida,Escambia County,9,10,17722,8777,8945
50,12,33,Florida,Escambia County,9,11,20251,9769,10482
50,12,33,Florida,Escambia County,9,12,21985,10541,11444
50,12,33,Florida,Escambia County,9,13,19588,9031,10557
50,12,33,Florida,Escambia County,9,14,17306,7977,9329
50,12,33,Florida,Escambia County,9,15,12299,5666,6633
50,12,33,Florida,Escambia County,9,16,8629,3780,4849
50,12,33,Florida,Escambia County,9,17,6177,2514,3663
50,12,33,Florida,Escambia County,9,18,5991,2151,3840
50,12,33,Florida,Escambia County,10,0,313249,155087,158162
50,12,33,Florida,Escambia County,10,1,19094,9797,9297
50,12,33,Florida,Escambia County,10,2,18277,9288,8989
50,12,33,Florida,Escambia County,10,3,17935,9151,8784
50,12,33,Florida,Escambia County,10,4,21210,11661,9549
50,12,33,Florida,Escambia County,10,5,25282,13731,11551
50,12,33,Florida,Escambia County,10,6,25258,12977,12281
50,12,33,Florida,Escambia County,10,7,20894,10567,10327
50,12,33,Florida,Escambia County,10,8,18023,9129,8894
50,12,33,Florida,Escambia County,10,9,15912,7950,7962
50,12,33,Florida,Escambia County,10,10,17772,8800,8972
50,12,33,Florida,Escambia County,10,11,19492,9322,10170
50,12,33,Florida,Escambia County,10,12,22151,10630,11521
50,12,33,Florida,Escambia County,10,13,20007,9257,10750
50,12,33,Florida,Escambia County,10,14,17179,7869,9310
50,12,33,Florida,Escambia County,10,15,13416,6245,7171
50,12,33,Florida,Escambia County,10,16,8993,3917,5076
50,12,33,Florida,Escambia County,10,17,6241,2576,3665
50,12,33,Florida,Escambia County,10,18,6113,2220,3893
50,12,33,Florida,Escambia County,11,0,315104,155911,159193
50,12,33,Florida,Escambia County,11,1,19011,9781,9230
50,12,33,Florida,Escambia County,11,2,18198,9245,8953
50,12,33,Florida,Escambia County,11,3,18201,9298,8903
50,12,33,Florida,Escambia County,11,4,21207,11738,9469
50,12,33,Florida,Escambia County,11,5,25102,13462,11640
50,12,33,Florida,Escambia County,11,6,25238,13062,12176
50,12,33,Florida,Escambia County,11,7,21096,10713,10383
50,12,33,Florida,Escambia County,11,8,18534,9395,9139
50,12,33,Florida,Escambia County,11,9,16005,7884,8121
50,12,33,Florida,Escambia County,11,10,17814,8893,8921
50,12,33,Florida,Escambia County,11,11,18729,8913,9816
50,12,33,Florida,Escambia County,11,12,22062,10546,11516
50,12,33,Florida,Escambia County,11,13,20727,9616,11111
50,12,33,Florida,Escambia County,11,14,17295,7920,9375
50,12,33,Florida,Escambia County,11,15,14051,6447,7604
50,12,33,Florida,Escambia County,11,16,9427,4155,5272
50,12,33,Florida,Escambia County,11,17,6321,2648,3673
50,12,33,Florida,Escambia County,11,18,6086,2195,3891
50,12,33,Florida,Escambia County,12,0,318316,157221,161095
50,12,33,Florida,Escambia County,12,1,19012,9762,9250
50,12,33,Florida,Escambia County,12,2,18512,9460,9052
50,12,33,Florida,Escambia County,12,3,18309,9397,8912
50,12,33,Florida,Escambia County,12,4,21372,11782,9590
50,12,33,Florida,Escambia County,12,5,24956,13368,11588
50,12,33,Florida,Escambia County,12,6,25381,13145,12236
50,12,33,Florida,Escambia County,12,7,21853,11053,10800
50,12,33,Florida,Escambia County,12,8,19111,9574,9537
50,12,33,Florida,Escambia County,12,9,16400,8050,8350
50,12,33,Florida,Escambia County,12,10,17459,8660,8799
50,12,33,Florida,Escambia County,12,11,18174,8631,9543
50,12,33,Florida,Escambia County,12,12,21957,10426,11531
50,12,33,Florida,Escambia County,12,13,21249,9997,11252
50,12,33,Florida,Escambia County,12,14,17612,7994,9618
50,12,33,Florida,Escambia County,12,15,14567,6597,7970
50,12,33,Florida,Escambia County,12,16,9832,4381,5451
50,12,33,Florida,Escambia County,12,17,6492,2756,3736
50,12,33,Florida,Escambia County,12,18,6068,2188,3880
50,12,35,Florida,Flagler County,1,0,95696,46016,49680
50,12,35,Florida,Flagler County,1,1,4766,2434,2332
50,12,35,Florida,Flagler County,1,2,5153,2598,2555
50,12,35,Florida,Flagler County,1,3,5571,2918,2653
50,12,35,Florida,Flagler County,1,4,5572,2868,2704
50,12,35,Florida,Flagler County,1,5,3959,1983,1976
50,12,35,Florida,Flagler County,1,6,4300,2059,2241
50,12,35,Florida,Flagler County,1,7,4711,2297,2414
50,12,35,Florida,Flagler County,1,8,5143,2458,2685
50,12,35,Florida,Flagler County,1,9,5620,2688,2932
50,12,35,Florida,Flagler County,1,10,6142,2864,3278
50,12,35,Florida,Flagler County,1,11,6529,2957,3572
50,12,35,Florida,Flagler County,1,12,6864,3058,3806
50,12,35,Florida,Flagler County,1,13,7961,3651,4310
50,12,35,Florida,Flagler County,1,14,7528,3660,3868
50,12,35,Florida,Flagler County,1,15,6065,3041,3024
50,12,35,Florida,Flagler County,1,16,4327,2105,2222
50,12,35,Florida,Flagler County,1,17,3078,1431,1647
50,12,35,Florida,Flagler County,1,18,2407,946,1461
50,12,35,Florida,Flagler County,2,0,95692,46013,49679
50,12,35,Florida,Flagler County,2,1,4765,2433,2332
50,12,35,Florida,Flagler County,2,2,5153,2598,2555
50,12,35,Florida,Flagler County,2,3,5570,2918,2652
50,12,35,Florida,Flagler County,2,4,5570,2867,2703
50,12,35,Florida,Flagler County,2,5,3958,1983,1975
50,12,35,Florida,Flagler County,2,6,4300,2059,2241
50,12,35,Florida,Flagler County,2,7,4709,2296,2413
50,12,35,Florida,Flagler County,2,8,5143,2458,2685
50,12,35,Florida,Flagler County,2,9,5618,2687,2931
50,12,35,Florida,Flagler County,2,10,6145,2865,3280
50,12,35,Florida,Flagler County,2,11,6531,2957,3574
50,12,35,Florida,Flagler County,2,12,6864,3058,3806
50,12,35,Florida,Flagler County,2,13,7961,3651,4310
50,12,35,Florida,Flagler County,2,14,7528,3660,3868
50,12,35,Florida,Flagler County,2,15,6065,3041,3024
50,12,35,Florida,Flagler County,2,16,4327,2105,2222
50,12,35,Florida,Flagler County,2,17,3078,1431,1647
50,12,35,Florida,Flagler County,2,18,2407,946,1461
50,12,35,Florida,Flagler County,3,0,96066,46196,49870
50,12,35,Florida,Flagler County,3,1,4771,2442,2329
50,12,35,Florida,Flagler County,3,2,5143,2595,2548
50,12,35,Florida,Flagler County,3,3,5589,2923,2666
50,12,35,Florida,Flagler County,3,4,5541,2854,2687
50,12,35,Florida,Flagler County,3,5,4047,2033,2014
50,12,35,Florida,Flagler County,3,6,4306,2068,2238
50,12,35,Florida,Flagler County,3,7,4694,2282,2412
50,12,35,Florida,Flagler County,3,8,5105,2434,2671
50,12,35,Florida,Flagler County,3,9,5646,2703,2943
50,12,35,Florida,Flagler County,3,10,6133,2859,3274
50,12,35,Florida,Flagler County,3,11,6563,2973,3590
50,12,35,Florida,Flagler County,3,12,6891,3067,3824
50,12,35,Florida,Flagler County,3,13,8001,3664,4337
50,12,35,Florida,Flagler County,3,14,7575,3692,3883
50,12,35,Florida,Flagler County,3,15,6132,3067,3065
50,12,35,Florida,Flagler County,3,16,4370,2134,2236
50,12,35,Florida,Flagler County,3,17,3099,1445,1654
50,12,35,Florida,Flagler County,3,18,2460,961,1499
50,12,35,Florida,Flagler County,4,0,97462,46798,50664
50,12,35,Florida,Flagler County,4,1,4626,2353,2273
50,12,35,Florida,Flagler County,4,2,5168,2604,2564
50,12,35,Florida,Flagler County,4,3,5647,2925,2722
50,12,35,Florida,Flagler County,4,4,5432,2847,2585
50,12,35,Florida,Flagler County,4,5,4349,2184,2165
50,12,35,Florida,Flagler County,4,6,4251,2051,2200
50,12,35,Florida,Flagler County,4,7,4698,2253,2445
50,12,35,Florida,Flagler County,4,8,4989,2373,2616
50,12,35,Florida,Flagler County,4,9,5687,2721,2966
50,12,35,Florida,Flagler County,4,10,6055,2832,3223
50,12,35,Florida,Flagler County,4,11,6723,3068,3655
50,12,35,Florida,Flagler County,4,12,6963,3091,3872
50,12,35,Florida,Flagler County,4,13,8262,3753,4509
50,12,35,Florida,Flagler County,4,14,7765,3788,3977
50,12,35,Florida,Flagler County,4,15,6417,3154,3263
50,12,35,Florida,Flagler County,4,16,4616,2281,2335
50,12,35,Florida,Flagler County,4,17,3180,1482,1698
50,12,35,Florida,Flagler County,4,18,2634,1038,1596
50,12,35,Florida,Flagler County,5,0,98434,47301,51133
50,12,35,Florida,Flagler County,5,1,4466,2310,2156
50,12,35,Florida,Flagler County,5,2,5136,2620,2516
50,12,35,Florida,Flagler County,5,3,5638,2883,2755
50,12,35,Florida,Flagler County,5,4,5411,2825,2586
50,12,35,Florida,Flagler County,5,5,4571,2338,2233
50,12,35,Florida,Flagler County,5,6,4232,2024,2208
50,12,35,Florida,Flagler County,5,7,4533,2176,2357
50,12,35,Florida,Flagler County,5,8,4933,2347,2586
50,12,35,Florida,Flagler County,5,9,5592,2669,2923
50,12,35,Florida,Flagler County,5,10,6121,2850,3271
50,12,35,Florida,Flagler County,5,11,6668,3061,3607
50,12,35,Florida,Flagler County,5,12,7065,3164,3901
50,12,35,Florida,Flagler County,5,13,7987,3544,4443
50,12,35,Florida,Flagler County,5,14,8422,4117,4305
50,12,35,Florida,Flagler County,5,15,6763,3327,3436
50,12,35,Florida,Flagler County,5,16,4805,2375,2430
50,12,35,Florida,Flagler County,5,17,3335,1580,1755
50,12,35,Florida,Flagler County,5,18,2756,1091,1665
50,12,35,Florida,Flagler County,6,0,99798,47976,51822
50,12,35,Florida,Flagler County,6,1,4363,2256,2107
50,12,35,Florida,Flagler County,6,2,5089,2583,2506
50,12,35,Florida,Flagler County,6,3,5659,2878,2781
50,12,35,Florida,Flagler County,6,4,5447,2833,2614
50,12,35,Florida,Flagler County,6,5,4741,2473,2268
50,12,35,Florida,Flagler County,6,6,4194,1997,2197
50,12,35,Florida,Flagler County,6,7,4679,2282,2397
50,12,35,Florida,Flagler County,6,8,4852,2298,2554
50,12,35,Florida,Flagler County,6,9,5636,2697,2939
50,12,35,Florida,Flagler County,6,10,5992,2778,3214
50,12,35,Florida,Flagler County,6,11,6666,3068,3598
50,12,35,Florida,Flagler County,6,12,7199,3250,3949
50,12,35,Florida,Flagler County,6,13,8048,3577,4471
50,12,35,Florida,Flagler County,6,14,8713,4173,4540
50,12,35,Florida,Flagler County,6,15,7234,3569,3665
50,12,35,Florida,Flagler County,6,16,5035,2499,2536
50,12,35,Florida,Flagler County,6,17,3402,1635,1767
50,12,35,Florida,Flagler County,6,18,2849,1130,1719
50,12,35,Florida,Flagler County,7,0,101889,49035,52854
50,12,35,Florida,Flagler County,7,1,4318,2276,2042
50,12,35,Florida,Flagler County,7,2,5110,2585,2525
50,12,35,Florida,Flagler County,7,3,5591,2817,2774
50,12,35,Florida,Flagler County,7,4,5432,2859,2573
50,12,35,Florida,Flagler County,7,5,4843,2519,2324
50,12,35,Florida,Flagler County,7,6,4343,2131,2212
50,12,35,Florida,Flagler County,7,7,4745,2255,2490
50,12,35,Florida,Flagler County,7,8,4911,2391,2520
50,12,35,Florida,Flagler County,7,9,5605,2629,2976
50,12,35,Florida,Flagler County,7,10,5958,2820,3138
50,12,35,Florida,Flagler County,7,11,6775,3138,3637
50,12,35,Florida,Flagler County,7,12,7373,3292,4081
50,12,35,Florida,Flagler County,7,13,8230,3638,4592
50,12,35,Florida,Flagler County,7,14,9224,4384,4840
50,12,35,Florida,Flagler County,7,15,7623,3755,3868
50,12,35,Florida,Flagler County,7,16,5314,2672,2642
50,12,35,Florida,Flagler County,7,17,3457,1646,1811
50,12,35,Florida,Flagler County,7,18,3037,1228,1809
50,12,35,Florida,Flagler County,8,0,104436,50277,54159
50,12,35,Florida,Flagler County,8,1,4300,2215,2085
50,12,35,Florida,Flagler County,8,2,5105,2597,2508
50,12,35,Florida,Flagler County,8,3,5637,2903,2734
50,12,35,Florida,Flagler County,8,4,5461,2862,2599
50,12,35,Florida,Flagler County,8,5,4877,2516,2361
50,12,35,Florida,Flagler County,8,6,4588,2292,2296
50,12,35,Florida,Flagler County,8,7,4783,2250,2533
50,12,35,Florida,Flagler County,8,8,5033,2437,2596
50,12,35,Florida,Flagler County,8,9,5555,2646,2909
50,12,35,Florida,Flagler County,8,10,6001,2868,3133
50,12,35,Florida,Flagler County,8,11,6824,3171,3653
50,12,35,Florida,Flagler County,8,12,7525,3335,4190
50,12,35,Florida,Flagler County,8,13,8590,3771,4819
50,12,35,Florida,Flagler County,8,14,9805,4647,5158
50,12,35,Florida,Flagler County,8,15,7914,3896,4018
50,12,35,Florida,Flagler County,8,16,5693,2879,2814
50,12,35,Florida,Flagler County,8,17,3583,1716,1867
50,12,35,Florida,Flagler County,8,18,3162,1276,1886
50,12,35,Florida,Flagler County,9,0,107406,51690,55716
50,12,35,Florida,Flagler County,9,1,4329,2219,2110
50,12,35,Florida,Flagler County,9,2,5187,2634,2553
50,12,35,Florida,Flagler County,9,3,5631,2927,2704
50,12,35,Florida,Flagler County,9,4,5548,2886,2662
50,12,35,Florida,Flagler County,9,5,4860,2552,2308
50,12,35,Florida,Flagler County,9,6,4867,2427,2440
50,12,35,Florida,Flagler County,9,7,4828,2318,2510
50,12,35,Florida,Flagler County,9,8,5133,2403,2730
50,12,35,Florida,Flagler County,9,9,5492,2643,2849
50,12,35,Florida,Flagler County,9,10,6278,2984,3294
50,12,35,Florida,Flagler County,9,11,6874,3220,3654
50,12,35,Florida,Flagler County,9,12,7830,3479,4351
50,12,35,Florida,Flagler County,9,13,8886,3866,5020
50,12,35,Florida,Flagler County,9,14,10321,4846,5475
50,12,35,Florida,Flagler County,9,15,8315,4126,4189
50,12,35,Florida,Flagler County,9,16,5976,2965,3011
50,12,35,Florida,Flagler County,9,17,3755,1826,1929
50,12,35,Florida,Flagler County,9,18,3296,1369,1927
50,12,35,Florida,Flagler County,10,0,109999,52891,57108
50,12,35,Florida,Flagler County,10,1,4324,2177,2147
50,12,35,Florida,Flagler County,10,2,5151,2641,2510
50,12,35,Florida,Flagler County,10,3,5750,2967,2783
50,12,35,Florida,Flagler County,10,4,5705,2929,2776
50,12,35,Florida,Flagler County,10,5,4798,2510,2288
50,12,35,Florida,Flagler County,10,6,5013,2551,2462
50,12,35,Florida,Flagler County,10,7,4917,2312,2605
50,12,35,Florida,Flagler County,10,8,5170,2470,2700
50,12,35,Florida,Flagler County,10,9,5550,2666,2884
50,12,35,Florida,Flagler County,10,10,6328,2973,3355
50,12,35,Florida,Flagler County,10,11,7054,3296,3758
50,12,35,Florida,Flagler County,10,12,8000,3613,4387
50,12,35,Florida,Flagler County,10,13,9177,4033,5144
50,12,35,Florida,Flagler County,10,14,10320,4749,5571
50,12,35,Florida,Flagler County,10,15,9088,4503,4585
50,12,35,Florida,Flagler County,10,16,6284,3130,3154
50,12,35,Florida,Flagler County,10,17,3855,1867,1988
50,12,35,Florida,Flagler County,10,18,3515,1504,2011
50,12,35,Florida,Flagler County,11,0,112085,53980,58105
50,12,35,Florida,Flagler County,11,1,4389,2206,2183
50,12,35,Florida,Flagler County,11,2,5006,2614,2392
50,12,35,Florida,Flagler County,11,3,5827,3001,2826
50,12,35,Florida,Flagler County,11,4,5796,2994,2802
50,12,35,Florida,Flagler County,11,5,4821,2542,2279
50,12,35,Florida,Flagler County,11,6,5181,2650,2531
50,12,35,Florida,Flagler County,11,7,4886,2303,2583
50,12,35,Florida,Flagler County,11,8,5266,2492,2774
50,12,35,Florida,Flagler County,11,9,5514,2641,2873
50,12,35,Florida,Flagler County,11,10,6397,3028,3369
50,12,35,Florida,Flagler County,11,11,6967,3249,3718
50,12,35,Florida,Flagler County,11,12,8153,3628,4525
50,12,35,Florida,Flagler County,11,13,9446,4230,5216
50,12,35,Florida,Flagler County,11,14,10404,4766,5638
50,12,35,Florida,Flagler County,11,15,9540,4688,4852
50,12,35,Florida,Flagler County,11,16,6745,3336,3409
50,12,35,Florida,Flagler County,11,17,4060,2003,2057
50,12,35,Florida,Flagler County,11,18,3687,1609,2078
50,12,35,Florida,Flagler County,12,0,115081,55374,59707
50,12,35,Florida,Flagler County,12,1,4419,2239,2180
50,12,35,Florida,Flagler County,12,2,5097,2638,2459
50,12,35,Florida,Flagler County,12,3,5872,2995,2877
50,12,35,Florida,Flagler County,12,4,5850,3032,2818
50,12,35,Florida,Flagler County,12,5,4928,2557,2371
50,12,35,Florida,Flagler County,12,6,5369,2706,2663
50,12,35,Florida,Flagler County,12,7,4959,2399,2560
50,12,35,Florida,Flagler County,12,8,5434,2581,2853
50,12,35,Florida,Flagler County,12,9,5598,2684,2914
50,12,35,Florida,Flagler County,12,10,6497,3025,3472
50,12,35,Florida,Flagler County,12,11,7067,3327,3740
50,12,35,Florida,Flagler County,12,12,8331,3758,4573
50,12,35,Florida,Flagler County,12,13,9764,4353,5411
50,12,35,Florida,Flagler County,12,14,10629,4825,5804
50,12,35,Florida,Flagler County,12,15,10109,4975,5134
50,12,35,Florida,Flagler County,12,16,7031,3463,3568
50,12,35,Florida,Flagler County,12,17,4269,2112,2157
50,12,35,Florida,Flagler County,12,18,3858,1705,2153
50,12,37,Florida,Franklin County,1,0,11549,6656,4893
50,12,37,Florida,Franklin County,1,1,593,299,294
50,12,37,Florida,Franklin County,1,2,525,280,245
50,12,37,Florida,Franklin County,1,3,539,281,258
50,12,37,Florida,Franklin County,1,4,514,265,249
50,12,37,Florida,Franklin County,1,5,692,455,237
50,12,37,Florida,Franklin County,1,6,952,696,256
50,12,37,Florida,Franklin County,1,7,847,584,263
50,12,37,Florida,Franklin County,1,8,749,502,247
50,12,37,Florida,Franklin County,1,9,737,461,276
50,12,37,Florida,Franklin County,1,10,880,520,360
50,12,37,Florida,Franklin County,1,11,836,440,396
50,12,37,Florida,Franklin County,1,12,844,431,413
50,12,37,Florida,Franklin County,1,13,826,419,407
50,12,37,Florida,Franklin County,1,14,728,392,336
50,12,37,Florida,Franklin County,1,15,553,281,272
50,12,37,Florida,Franklin County,1,16,330,177,153
50,12,37,Florida,Franklin County,1,17,214,105,109
50,12,37,Florida,Franklin County,1,18,190,68,122
50,12,37,Florida,Franklin County,2,0,11549,6656,4893
50,12,37,Florida,Franklin County,2,1,593,299,294
50,12,37,Florida,Franklin County,2,2,525,280,245
50,12,37,Florida,Franklin County,2,3,539,281,258
50,12,37,Florida,Franklin County,2,4,514,265,249
50,12,37,Florida,Franklin County,2,5,692,455,237
50,12,37,Florida,Franklin County,2,6,952,696,256
50,12,37,Florida,Franklin County,2,7,847,584,263
50,12,37,Florida,Franklin County,2,8,749,502,247
50,12,37,Florida,Franklin County,2,9,737,461,276
50,12,37,Florida,Franklin County,2,10,880,520,360
50,12,37,Florida,Franklin County,2,11,836,440,396
50,12,37,Florida,Franklin County,2,12,844,431,413
50,12,37,Florida,Franklin County,2,13,826,419,407
50,12,37,Florida,Franklin County,2,14,728,392,336
50,12,37,Florida,Franklin County,2,15,553,281,272
50,12,37,Florida,Franklin County,2,16,330,177,153
50,12,37,Florida,Franklin County,2,17,214,105,109
50,12,37,Florida,Franklin County,2,18,190,68,122
50,12,37,Florida,Franklin County,3,0,11522,6626,4896
50,12,37,Florida,Franklin County,3,1,598,298,300
50,12,37,Florida,Franklin County,3,2,529,283,246
50,12,37,Florida,Franklin County,3,3,545,284,261
50,12,37,Florida,Franklin County,3,4,507,262,245
50,12,37,Florida,Franklin County,3,5,690,455,235
50,12,37,Florida,Franklin County,3,6,946,688,258
50,12,37,Florida,Franklin County,3,7,851,583,268
50,12,37,Florida,Franklin County,3,8,745,498,247
50,12,37,Florida,Franklin County,3,9,729,455,274
50,12,37,Florida,Franklin County,3,10,873,520,353
50,12,37,Florida,Franklin County,3,11,838,440,398
50,12,37,Florida,Franklin County,3,12,827,418,409
50,12,37,Florida,Franklin County,3,13,829,421,408
50,12,37,Florida,Franklin County,3,14,726,388,338
50,12,37,Florida,Franklin County,3,15,554,280,274
50,12,37,Florida,Franklin County,3,16,340,181,159
50,12,37,Florida,Franklin County,3,17,210,105,105
50,12,37,Florida,Franklin County,3,18,185,67,118
50,12,37,Florida,Franklin County,4,0,11472,6599,4873
50,12,37,Florida,Franklin County,4,1,554,275,279
50,12,37,Florida,Franklin County,4,2,549,292,257
50,12,37,Florida,Franklin County,4,3,539,290,249
50,12,37,Florida,Franklin County,4,4,470,246,224
50,12,37,Florida,Franklin County,4,5,690,464,226
50,12,37,Florida,Franklin County,4,6,940,671,269
50,12,37,Florida,Franklin County,4,7,846,574,272
50,12,37,Florida,Franklin County,4,8,730,485,245
50,12,37,Florida,Franklin County,4,9,717,446,271
50,12,37,Florida,Franklin County,4,10,853,519,334
50,12,37,Florida,Franklin County,4,11,843,447,396
50,12,37,Florida,Franklin County,4,12,792,397,395
50,12,37,Florida,Franklin County,4,13,885,454,431
50,12,37,Florida,Franklin County,4,14,733,381,352
50,12,37,Florida,Franklin County,4,15,565,288,277
50,12,37,Florida,Franklin County,4,16,373,198,175
50,12,37,Florida,Franklin County,4,17,208,105,103
50,12,37,Florida,Franklin County,4,18,185,67,118
50,12,37,Florida,Franklin County,5,0,11612,6669,4943
50,12,37,Florida,Franklin County,5,1,544,271,273
50,12,37,Florida,Franklin County,5,2,559,293,266
50,12,37,Florida,Franklin County,5,3,559,297,262
50,12,37,Florida,Franklin County,5,4,458,251,207
50,12,37,Florida,Franklin County,5,5,714,466,248
50,12,37,Florida,Franklin County,5,6,962,695,267
50,12,37,Florida,Franklin County,5,7,867,596,271
50,12,37,Florida,Franklin County,5,8,725,485,240
50,12,37,Florida,Franklin County,5,9,735,448,287
50,12,37,Florida,Franklin County,5,10,828,509,319
50,12,37,Florida,Franklin County,5,11,822,422,400
50,12,37,Florida,Franklin County,5,12,790,397,393
50,12,37,Florida,Franklin County,5,13,872,435,437
50,12,37,Florida,Franklin County,5,14,784,401,383
50,12,37,Florida,Franklin County,5,15,603,319,284
50,12,37,Florida,Franklin County,5,16,392,204,188
50,12,37,Florida,Franklin County,5,17,219,112,107
50,12,37,Florida,Franklin County,5,18,179,68,111
50,12,37,Florida,Franklin County,6,0,11521,6589,4932
50,12,37,Florida,Franklin County,6,1,543,273,270
50,12,37,Florida,Franklin County,6,2,576,294,282
50,12,37,Florida,Franklin County,6,3,509,266,243
50,12,37,Florida,Franklin County,6,4,458,249,209
50,12,37,Florida,Franklin County,6,5,728,461,267
50,12,37,Florida,Franklin County,6,6,944,669,275
50,12,37,Florida,Franklin County,6,7,858,586,272
50,12,37,Florida,Franklin County,6,8,699,484,215
50,12,37,Florida,Franklin County,6,9,720,445,275
50,12,37,Florida,Franklin County,6,10,774,468,306
50,12,37,Florida,Franklin County,6,11,811,432,379
50,12,37,Florida,Franklin County,6,12,778,393,385
50,12,37,Florida,Franklin County,6,13,867,430,437
50,12,37,Florida,Franklin County,6,14,790,389,401
50,12,37,Florida,Franklin County,6,15,661,364,297
50,12,37,Florida,Franklin County,6,16,400,204,196
50,12,37,Florida,Franklin County,6,17,226,113,113
50,12,37,Florida,Franklin County,6,18,179,69,110
50,12,37,Florida,Franklin County,7,0,11661,6750,4911
50,12,37,Florida,Franklin County,7,1,529,254,275
50,12,37,Florida,Franklin County,7,2,571,294,277
50,12,37,Florida,Franklin County,7,3,514,261,253
50,12,37,Florida,Franklin County,7,4,483,267,216
50,12,37,Florida,Franklin County,7,5,716,479,237
50,12,37,Florida,Franklin County,7,6,1004,727,277
50,12,37,Florida,Franklin County,7,7,864,592,272
50,12,37,Florida,Franklin County,7,8,730,502,228
50,12,37,Florida,Franklin County,7,9,717,457,260
50,12,37,Florida,Franklin County,7,10,747,467,280
50,12,37,Florida,Franklin County,7,11,784,423,361
50,12,37,Florida,Franklin County,7,12,800,414,386
50,12,37,Florida,Franklin County,7,13,843,415,428
50,12,37,Florida,Franklin County,7,14,841,406,435
50,12,37,Florida,Franklin County,7,15,665,370,295
50,12,37,Florida,Franklin County,7,16,442,224,218
50,12,37,Florida,Franklin County,7,17,221,113,108
50,12,37,Florida,Franklin County,7,18,190,85,105
50,12,37,Florida,Franklin County,8,0,11707,6735,4972
50,12,37,Florida,Franklin County,8,1,535,279,256
50,12,37,Florida,Franklin County,8,2,571,288,283
50,12,37,Florida,Franklin County,8,3,503,257,246
50,12,37,Florida,Franklin County,8,4,476,263,213
50,12,37,Florida,Franklin County,8,5,687,457,230
50,12,37,Florida,Franklin County,8,6,991,720,271
50,12,37,Florida,Franklin County,8,7,873,595,278
50,12,37,Florida,Franklin County,8,8,715,471,244
50,12,37,Florida,Franklin County,8,9,678,435,243
50,12,37,Florida,Franklin County,8,10,737,453,284
50,12,37,Florida,Franklin County,8,11,778,427,351
50,12,37,Florida,Franklin County,8,12,817,401,416
50,12,37,Florida,Franklin County,8,13,870,431,439
50,12,37,Florida,Franklin County,8,14,872,426,446
50,12,37,Florida,Franklin County,8,15,680,358,322
50,12,37,Florida,Franklin County,8,16,479,247,232
50,12,37,Florida,Franklin County,8,17,254,139,115
50,12,37,Florida,Franklin County,8,18,191,88,103
50,12,37,Florida,Franklin County,9,0,11823,6766,5057
50,12,37,Florida,Franklin County,9,1,536,285,251
50,12,37,Florida,Franklin County,9,2,549,278,271
50,12,37,Florida,Franklin County,9,3,538,278,260
50,12,37,Florida,Franklin County,9,4,477,273,204
50,12,37,Florida,Franklin County,9,5,689,459,230
50,12,37,Florida,Franklin County,9,6,981,706,275
50,12,37,Florida,Franklin County,9,7,851,580,271
50,12,37,Florida,Franklin County,9,8,736,468,268
50,12,37,Florida,Franklin County,9,9,660,420,240
50,12,37,Florida,Franklin County,9,10,739,451,288
50,12,37,Florida,Franklin County,9,11,783,431,352
50,12,37,Florida,Franklin County,9,12,818,405,413
50,12,37,Florida,Franklin County,9,13,864,417,447
50,12,37,Florida,Franklin County,9,14,932,465,467
50,12,37,Florida,Franklin County,9,15,701,347,354
50,12,37,Florida,Franklin County,9,16,499,261,238
50,12,37,Florida,Franklin County,9,17,286,157,129
50,12,37,Florida,Franklin County,9,18,184,85,99
50,12,37,Florida,Franklin County,10,0,11724,6659,5065
50,12,37,Florida,Franklin County,10,1,512,279,233
50,12,37,Florida,Franklin County,10,2,540,274,266
50,12,37,Florida,Franklin County,10,3,539,278,261
50,12,37,Florida,Franklin County,10,4,464,256,208
50,12,37,Florida,Franklin County,10,5,648,436,212
50,12,37,Florida,Franklin County,10,6,945,668,277
50,12,37,Florida,Franklin County,10,7,832,553,279
50,12,37,Florida,Franklin County,10,8,724,467,257
50,12,37,Florida,Franklin County,10,9,637,410,227
50,12,37,Florida,Franklin County,10,10,730,432,298
50,12,37,Florida,Franklin County,10,11,777,430,347
50,12,37,Florida,Franklin County,10,12,799,388,411
50,12,37,Florida,Franklin County,10,13,874,416,458
50,12,37,Florida,Franklin County,10,14,939,461,478
50,12,37,Florida,Franklin County,10,15,761,380,381
50,12,37,Florida,Franklin County,10,16,521,280,241
50,12,37,Florida,Franklin County,10,17,284,157,127
50,12,37,Florida,Franklin County,10,18,198,94,104
50,12,37,Florida,Franklin County,11,0,11676,6508,5168
50,12,37,Florida,Franklin County,11,1,523,287,236
50,12,37,Florida,Franklin County,11,2,522,268,254
50,12,37,Florida,Franklin County,11,3,549,284,265
50,12,37,Florida,Franklin County,11,4,462,245,217
50,12,37,Florida,Franklin County,11,5,583,384,199
50,12,37,Florida,Franklin County,11,6,914,631,283
50,12,37,Florida,Franklin County,11,7,778,500,278
50,12,37,Florida,Franklin County,11,8,717,444,273
50,12,37,Florida,Franklin County,11,9,601,378,223
50,12,37,Florida,Franklin County,11,10,723,413,310
50,12,37,Florida,Franklin County,11,11,759,409,350
50,12,37,Florida,Franklin County,11,12,840,416,424
50,12,37,Florida,Franklin County,11,13,894,429,465
50,12,37,Florida,Franklin County,11,14,965,470,495
50,12,37,Florida,Franklin County,11,15,774,381,393
50,12,37,Florida,Franklin County,11,16,566,312,254
50,12,37,Florida,Franklin County,11,17,295,154,141
50,12,37,Florida,Franklin County,11,18,211,103,108
50,12,37,Florida,Franklin County,12,0,12125,6902,5223
50,12,37,Florida,Franklin County,12,1,512,283,229
50,12,37,Florida,Franklin County,12,2,497,264,233
50,12,37,Florida,Franklin County,12,3,551,289,262
50,12,37,Florida,Franklin County,12,4,472,244,228
50,12,37,Florida,Franklin County,12,5,641,431,210
50,12,37,Florida,Franklin County,12,6,958,698,260
50,12,37,Florida,Franklin County,12,7,852,577,275
50,12,37,Florida,Franklin County,12,8,750,471,279
50,12,37,Florida,Franklin County,12,9,652,420,232
50,12,37,Florida,Franklin County,12,10,739,449,290
50,12,37,Florida,Franklin County,12,11,752,414,338
50,12,37,Florida,Franklin County,12,12,891,442,449
50,12,37,Florida,Franklin County,12,13,932,453,479
50,12,37,Florida,Franklin County,12,14,968,462,506
50,12,37,Florida,Franklin County,12,15,845,417,428
50,12,37,Florida,Franklin County,12,16,583,324,259
50,12,37,Florida,Franklin County,12,17,325,166,159
50,12,37,Florida,Franklin County,12,18,205,98,107
50,12,39,Florida,Gadsden County,1,0,46389,22647,23742
50,12,39,Florida,Gadsden County,1,1,3213,1608,1605
50,12,39,Florida,Gadsden County,1,2,3109,1569,1540
50,12,39,Florida,Gadsden County,1,3,2969,1510,1459
50,12,39,Florida,Gadsden County,1,4,3168,1586,1582
50,12,39,Florida,Gadsden County,1,5,2691,1404,1287
50,12,39,Florida,Gadsden County,1,6,2995,1493,1502
50,12,39,Florida,Gadsden County,1,7,2805,1415,1390
50,12,39,Florida,Gadsden County,1,8,2906,1392,1514
50,12,39,Florida,Gadsden County,1,9,2950,1467,1483
50,12,39,Florida,Gadsden County,1,10,3324,1605,1719
50,12,39,Florida,Gadsden County,1,11,3642,1839,1803
50,12,39,Florida,Gadsden County,1,12,3502,1716,1786
50,12,39,Florida,Gadsden County,1,13,2792,1342,1450
50,12,39,Florida,Gadsden County,1,14,2094,950,1144
50,12,39,Florida,Gadsden County,1,15,1608,743,865
50,12,39,Florida,Gadsden County,1,16,1184,506,678
50,12,39,Florida,Gadsden County,1,17,764,299,465
50,12,39,Florida,Gadsden County,1,18,673,203,470
50,12,39,Florida,Gadsden County,2,0,47744,22646,25098
50,12,39,Florida,Gadsden County,2,1,3213,1608,1605
50,12,39,Florida,Gadsden County,2,2,3109,1569,1540
50,12,39,Florida,Gadsden County,2,3,2969,1510,1459
50,12,39,Florida,Gadsden County,2,4,3206,1586,1620
50,12,39,Florida,Gadsden County,2,5,2921,1404,1517
50,12,39,Florida,Gadsden County,2,6,3215,1493,1722
50,12,39,Florida,Gadsden County,2,7,2995,1415,1580
50,12,39,Florida,Gadsden County,2,8,3098,1392,1706
50,12,39,Florida,Gadsden County,2,9,3129,1467,1662
50,12,39,Florida,Gadsden County,2,10,3485,1605,1880
50,12,39,Florida,Gadsden County,2,11,3747,1839,1908
50,12,39,Florida,Gadsden County,2,12,3524,1716,1808
50,12,39,Florida,Gadsden County,2,13,2806,1342,1464
50,12,39,Florida,Gadsden County,2,14,2100,950,1150
50,12,39,Florida,Gadsden County,2,15,1606,742,864
50,12,39,Florida,Gadsden County,2,16,1184,506,678
50,12,39,Florida,Gadsden County,2,17,764,299,465
50,12,39,Florida,Gadsden County,2,18,673,203,470
50,12,39,Florida,Gadsden County,3,0,47794,22679,25115
50,12,39,Florida,Gadsden County,3,1,3228,1615,1613
50,12,39,Florida,Gadsden County,3,2,3102,1570,1532
50,12,39,Florida,Gadsden County,3,3,2979,1512,1467
50,12,39,Florida,Gadsden County,3,4,3159,1554,1605
50,12,39,Florida,Gadsden County,3,5,2932,1409,1523
50,12,39,Florida,Gadsden County,3,6,3198,1495,1703
50,12,39,Florida,Gadsden County,3,7,3004,1415,1589
50,12,39,Florida,Gadsden County,3,8,3098,1403,1695
50,12,39,Florida,Gadsden County,3,9,3131,1470,1661
50,12,39,Florida,Gadsden County,3,10,3478,1599,1879
50,12,39,Florida,Gadsden County,3,11,3736,1825,1911
50,12,39,Florida,Gadsden County,3,12,3539,1726,1813
50,12,39,Florida,Gadsden County,3,13,2833,1360,1473
50,12,39,Florida,Gadsden County,3,14,2114,958,1156
50,12,39,Florida,Gadsden County,3,15,1608,738,870
50,12,39,Florida,Gadsden County,3,16,1197,517,680
50,12,39,Florida,Gadsden County,3,17,772,304,468
50,12,39,Florida,Gadsden County,3,18,686,209,477
50,12,39,Florida,Gadsden County,4,0,47373,22504,24869
50,12,39,Florida,Gadsden County,4,1,3118,1556,1562
50,12,39,Florida,Gadsden County,4,2,3031,1558,1473
50,12,39,Florida,Gadsden County,4,3,2992,1526,1466
50,12,39,Florida,Gadsden County,4,4,2920,1419,1501
50,12,39,Florida,Gadsden County,4,5,3039,1480,1559
50,12,39,Florida,Gadsden County,4,6,3106,1460,1646
50,12,39,Florida,Gadsden County,4,7,3039,1416,1623
50,12,39,Florida,Gadsden County,4,8,3029,1391,1638
50,12,39,Florida,Gadsden County,4,9,3135,1457,1678
50,12,39,Florida,Gadsden County,4,10,3336,1529,1807
50,12,39,Florida,Gadsden County,4,11,3648,1771,1877
50,12,39,Florida,Gadsden County,4,12,3565,1739,1826
50,12,39,Florida,Gadsden County,4,13,2949,1428,1521
50,12,39,Florida,Gadsden County,4,14,2141,973,1168
50,12,39,Florida,Gadsden County,4,15,1604,720,884
50,12,39,Florida,Gadsden County,4,16,1223,543,680
50,12,39,Florida,Gadsden County,4,17,795,319,476
50,12,39,Florida,Gadsden County,4,18,703,219,484
50,12,39,Florida,Gadsden County,5,0,46574,22179,24395
50,12,39,Florida,Gadsden County,5,1,3044,1535,1509
50,12,39,Florida,Gadsden County,5,2,3063,1545,1518
50,12,39,Florida,Gadsden County,5,3,2920,1470,1450
50,12,39,Florida,Gadsden County,5,4,2697,1343,1354
50,12,39,Florida,Gadsden County,5,5,3038,1504,1534
50,12,39,Florida,Gadsden County,5,6,2891,1376,1515
50,12,39,Florida,Gadsden County,5,7,3042,1439,1603
50,12,39,Florida,Gadsden County,5,8,2895,1327,1568
50,12,39,Florida,Gadsden County,5,9,3115,1448,1667
50,12,39,Florida,Gadsden County,5,10,3112,1441,1671
50,12,39,Florida,Gadsden County,5,11,3566,1720,1846
50,12,39,Florida,Gadsden County,5,12,3531,1721,1810
50,12,39,Florida,Gadsden County,5,13,2977,1434,1543
50,12,39,Florida,Gadsden County,5,14,2270,1029,1241
50,12,39,Florida,Gadsden County,5,15,1610,724,886
50,12,39,Florida,Gadsden County,5,16,1250,540,710
50,12,39,Florida,Gadsden County,5,17,844,357,487
50,12,39,Florida,Gadsden County,5,18,709,226,483
50,12,39,Florida,Gadsden County,6,0,46087,21944,24143
50,12,39,Florida,Gadsden County,6,1,2856,1417,1439
50,12,39,Florida,Gadsden County,6,2,3008,1526,1482
50,12,39,Florida,Gadsden County,6,3,2922,1476,1446
50,12,39,Florida,Gadsden County,6,4,2668,1305,1363
50,12,39,Florida,Gadsden County,6,5,3083,1545,1538
50,12,39,Florida,Gadsden County,6,6,2707,1297,1410
50,12,39,Florida,Gadsden County,6,7,3012,1419,1593
50,12,39,Florida,Gadsden County,6,8,2860,1331,1529
50,12,39,Florida,Gadsden County,6,9,3052,1425,1627
50,12,39,Florida,Gadsden County,6,10,2983,1383,1600
50,12,39,Florida,Gadsden County,6,11,3546,1711,1835
50,12,39,Florida,Gadsden County,6,12,3482,1697,1785
50,12,39,Florida,Gadsden County,6,13,3038,1434,1604
50,12,39,Florida,Gadsden County,6,14,2372,1091,1281
50,12,39,Florida,Gadsden County,6,15,1685,766,919
50,12,39,Florida,Gadsden County,6,16,1257,538,719
50,12,39,Florida,Gadsden County,6,17,850,352,498
50,12,39,Florida,Gadsden County,6,18,706,231,475
50,12,39,Florida,Gadsden County,7,0,46114,21921,24193
50,12,39,Florida,Gadsden County,7,1,2746,1351,1395
50,12,39,Florida,Gadsden County,7,2,3009,1511,1498
50,12,39,Florida,Gadsden County,7,3,2864,1425,1439
50,12,39,Florida,Gadsden County,7,4,2545,1272,1273
50,12,39,Florida,Gadsden County,7,5,3068,1521,1547
50,12,39,Florida,Gadsden County,7,6,2745,1339,1406
50,12,39,Florida,Gadsden County,7,7,3011,1400,1611
50,12,39,Florida,Gadsden County,7,8,2889,1339,1550
50,12,39,Florida,Gadsden County,7,9,3000,1403,1597
50,12,39,Florida,Gadsden County,7,10,2948,1364,1584
50,12,39,Florida,Gadsden County,7,11,3545,1725,1820
50,12,39,Florida,Gadsden County,7,12,3471,1713,1758
50,12,39,Florida,Gadsden County,7,13,3151,1451,1700
50,12,39,Florida,Gadsden County,7,14,2465,1163,1302
50,12,39,Florida,Gadsden County,7,15,1777,790,987
50,12,39,Florida,Gadsden County,7,16,1286,556,730
50,12,39,Florida,Gadsden County,7,17,858,341,517
50,12,39,Florida,Gadsden County,7,18,736,257,479
50,12,39,Florida,Gadsden County,8,0,46060,21857,24203
50,12,39,Florida,Gadsden County,8,1,2677,1330,1347
50,12,39,Florida,Gadsden County,8,2,2977,1477,1500
50,12,39,Florida,Gadsden County,8,3,2815,1422,1393
50,12,39,Florida,Gadsden County,8,4,2673,1339,1334
50,12,39,Florida,Gadsden County,8,5,3018,1476,1542
50,12,39,Florida,Gadsden County,8,6,2775,1354,1421
50,12,39,Florida,Gadsden County,8,7,2872,1322,1550
50,12,39,Florida,Gadsden County,8,8,2837,1313,1524
50,12,39,Florida,Gadsden County,8,9,2991,1394,1597
50,12,39,Florida,Gadsden County,8,10,2973,1384,1589
50,12,39,Florida,Gadsden County,8,11,3476,1695,1781
50,12,39,Florida,Gadsden County,8,12,3425,1663,1762
50,12,39,Florida,Gadsden County,8,13,3192,1497,1695
50,12,39,Florida,Gadsden County,8,14,2526,1174,1352
50,12,39,Florida,Gadsden County,8,15,1847,795,1052
50,12,39,Florida,Gadsden County,8,16,1328,590,738
50,12,39,Florida,Gadsden County,8,17,905,372,533
50,12,39,Florida,Gadsden County,8,18,753,260,493
50,12,39,Florida,Gadsden County,9,0,46086,21935,24151
50,12,39,Florida,Gadsden County,9,1,2696,1340,1356
50,12,39,Florida,Gadsden County,9,2,2896,1450,1446
50,12,39,Florida,Gadsden County,9,3,2831,1445,1386
50,12,39,Florida,Gadsden County,9,4,2672,1317,1355
50,12,39,Florida,Gadsden County,9,5,2876,1427,1449
50,12,39,Florida,Gadsden County,9,6,2850,1407,1443
50,12,39,Florida,Gadsden County,9,7,2800,1275,1525
50,12,39,Florida,Gadsden County,9,8,2891,1343,1548
50,12,39,Florida,Gadsden County,9,9,2946,1383,1563
50,12,39,Florida,Gadsden County,9,10,2985,1424,1561
50,12,39,Florida,Gadsden County,9,11,3380,1632,1748
50,12,39,Florida,Gadsden County,9,12,3318,1578,1740
50,12,39,Florida,Gadsden County,9,13,3278,1563,1715
50,12,39,Florida,Gadsden County,9,14,2694,1269,1425
50,12,39,Florida,Gadsden County,9,15,1900,826,1074
50,12,39,Florida,Gadsden County,9,16,1330,579,751
50,12,39,Florida,Gadsden County,9,17,948,395,553
50,12,39,Florida,Gadsden County,9,18,795,282,513
50,12,39,Florida,Gadsden County,10,0,45993,21903,24090
50,12,39,Florida,Gadsden County,10,1,2680,1337,1343
50,12,39,Florida,Gadsden County,10,2,2834,1451,1383
50,12,39,Florida,Gadsden County,10,3,2848,1432,1416
50,12,39,Florida,Gadsden County,10,4,2689,1309,1380
50,12,39,Florida,Gadsden County,10,5,2786,1353,1433
50,12,39,Florida,Gadsden County,10,6,2917,1506,1411
50,12,39,Florida,Gadsden County,10,7,2666,1217,1449
50,12,39,Florida,Gadsden County,10,8,2872,1335,1537
50,12,39,Florida,Gadsden County,10,9,2894,1342,1552
50,12,39,Florida,Gadsden County,10,10,2988,1414,1574
50,12,39,Florida,Gadsden County,10,11,3238,1588,1650
50,12,39,Florida,Gadsden County,10,12,3358,1580,1778
50,12,39,Florida,Gadsden County,10,13,3281,1580,1701
50,12,39,Florida,Gadsden County,10,14,2720,1275,1445
50,12,39,Florida,Gadsden County,10,15,2045,882,1163
50,12,39,Florida,Gadsden County,10,16,1331,581,750
50,12,39,Florida,Gadsden County,10,17,977,389,588
50,12,39,Florida,Gadsden County,10,18,869,332,537
50,12,39,Florida,Gadsden County,11,0,45927,21806,24121
50,12,39,Florida,Gadsden County,11,1,2737,1346,1391
50,12,39,Florida,Gadsden County,11,2,2756,1382,1374
50,12,39,Florida,Gadsden County,11,3,2940,1467,1473
50,12,39,Florida,Gadsden County,11,4,2674,1332,1342
50,12,39,Florida,Gadsden County,11,5,2733,1314,1419
50,12,39,Florida,Gadsden County,11,6,2917,1484,1433
50,12,39,Florida,Gadsden County,11,7,2578,1208,1370
50,12,39,Florida,Gadsden County,11,8,2902,1334,1568
50,12,39,Florida,Gadsden County,11,9,2857,1333,1524
50,12,39,Florida,Gadsden County,11,10,2956,1398,1558
50,12,39,Florida,Gadsden County,11,11,3044,1492,1552
50,12,39,Florida,Gadsden County,11,12,3353,1581,1772
50,12,39,Florida,Gadsden County,11,13,3237,1555,1682
50,12,39,Florida,Gadsden County,11,14,2801,1279,1522
50,12,39,Florida,Gadsden County,11,15,2140,940,1200
50,12,39,Florida,Gadsden County,11,16,1412,628,784
50,12,39,Florida,Gadsden County,11,17,973,378,595
50,12,39,Florida,Gadsden County,11,18,917,355,562
50,12,39,Florida,Gadsden County,12,0,45660,21675,23985
50,12,39,Florida,Gadsden County,12,1,2731,1367,1364
50,12,39,Florida,Gadsden County,12,2,2666,1328,1338
50,12,39,Florida,Gadsden County,12,3,2886,1449,1437
50,12,39,Florida,Gadsden County,12,4,2587,1269,1318
50,12,39,Florida,Gadsden County,12,5,2687,1302,1385
50,12,39,Florida,Gadsden County,12,6,2982,1522,1460
50,12,39,Florida,Gadsden County,12,7,2515,1167,1348
50,12,39,Florida,Gadsden County,12,8,2822,1282,1540
50,12,39,Florida,Gadsden County,12,9,2854,1335,1519
50,12,39,Florida,Gadsden County,12,10,2907,1362,1545
50,12,39,Florida,Gadsden County,12,11,3009,1492,1517
50,12,39,Florida,Gadsden County,12,12,3296,1582,1714
50,12,39,Florida,Gadsden County,12,13,3178,1507,1671
50,12,39,Florida,Gadsden County,12,14,2877,1290,1587
50,12,39,Florida,Gadsden County,12,15,2236,1006,1230
50,12,39,Florida,Gadsden County,12,16,1457,633,824
50,12,39,Florida,Gadsden County,12,17,1021,421,600
50,12,39,Florida,Gadsden County,12,18,949,361,588
50,12,41,Florida,Gilchrist County,1,0,16939,8836,8103
50,12,41,Florida,Gilchrist County,1,1,909,449,460
50,12,41,Florida,Gilchrist County,1,2,955,480,475
50,12,41,Florida,Gilchrist County,1,3,1085,549,536
50,12,41,Florida,Gilchrist County,1,4,1381,861,520
50,12,41,Florida,Gilchrist County,1,5,1480,1067,413
50,12,41,Florida,Gilchrist County,1,6,832,434,398
50,12,41,Florida,Gilchrist County,1,7,781,382,399
50,12,41,Florida,Gilchrist County,1,8,900,431,469
50,12,41,Florida,Gilchrist County,1,9,1044,533,511
50,12,41,Florida,Gilchrist County,1,10,1183,598,585
50,12,41,Florida,Gilchrist County,1,11,1257,636,621
50,12,41,Florida,Gilchrist County,1,12,1157,559,598
50,12,41,Florida,Gilchrist County,1,13,1119,541,578
50,12,41,Florida,Gilchrist County,1,14,996,508,488
50,12,41,Florida,Gilchrist County,1,15,674,334,340
50,12,41,Florida,Gilchrist County,1,16,495,229,266
50,12,41,Florida,Gilchrist County,1,17,343,146,197
50,12,41,Florida,Gilchrist County,1,18,348,99,249
50,12,41,Florida,Gilchrist County,2,0,16941,8836,8105
50,12,41,Florida,Gilchrist County,2,1,910,449,461
50,12,41,Florida,Gilchrist County,2,2,955,480,475
50,12,41,Florida,Gilchrist County,2,3,1085,549,536
50,12,41,Florida,Gilchrist County,2,4,1381,861,520
50,12,41,Florida,Gilchrist County,2,5,1481,1067,414
50,12,41,Florida,Gilchrist County,2,6,832,434,398
50,12,41,Florida,Gilchrist County,2,7,781,382,399
50,12,41,Florida,Gilchrist County,2,8,900,431,469
50,12,41,Florida,Gilchrist County,2,9,1044,533,511
50,12,41,Florida,Gilchrist County,2,10,1183,598,585
50,12,41,Florida,Gilchrist County,2,11,1257,636,621
50,12,41,Florida,Gilchrist County,2,12,1157,559,598
50,12,41,Florida,Gilchrist County,2,13,1119,541,578
50,12,41,Florida,Gilchrist County,2,14,996,508,488
50,12,41,Florida,Gilchrist County,2,15,674,334,340
50,12,41,Florida,Gilchrist County,2,16,495,229,266
50,12,41,Florida,Gilchrist County,2,17,343,146,197
50,12,41,Florida,Gilchrist County,2,18,348,99,249
50,12,41,Florida,Gilchrist County,3,0,17000,8859,8141
50,12,41,Florida,Gilchrist County,3,1,928,457,471
50,12,41,Florida,Gilchrist County,3,2,951,477,474
50,12,41,Florida,Gilchrist County,3,3,1078,547,531
50,12,41,Florida,Gilchrist County,3,4,1369,850,519
50,12,41,Florida,Gilchrist County,3,5,1486,1072,414
50,12,41,Florida,Gilchrist County,3,6,847,438,409
50,12,41,Florida,Gilchrist County,3,7,781,383,398
50,12,41,Florida,Gilchrist County,3,8,884,425,459
50,12,41,Florida,Gilchrist County,3,9,1030,521,509
50,12,41,Florida,Gilchrist County,3,10,1193,609,584
50,12,41,Florida,Gilchrist County,3,11,1253,634,619
50,12,41,Florida,Gilchrist County,3,12,1175,567,608
50,12,41,Florida,Gilchrist County,3,13,1136,545,591
50,12,41,Florida,Gilchrist County,3,14,989,504,485
50,12,41,Florida,Gilchrist County,3,15,692,344,348
50,12,41,Florida,Gilchrist County,3,16,497,231,266
50,12,41,Florida,Gilchrist County,3,17,355,153,202
50,12,41,Florida,Gilchrist County,3,18,356,102,254
50,12,41,Florida,Gilchrist County,4,0,16994,8866,8128
50,12,41,Florida,Gilchrist County,4,1,917,471,446
50,12,41,Florida,Gilchrist County,4,2,928,470,458
50,12,41,Florida,Gilchrist County,4,3,1090,535,555
50,12,41,Florida,Gilchrist County,4,4,1327,828,499
50,12,41,Florida,Gilchrist County,4,5,1497,1090,407
50,12,41,Florida,Gilchrist County,4,6,878,429,449
50,12,41,Florida,Gilchrist County,4,7,788,400,388
50,12,41,Florida,Gilchrist County,4,8,826,406,420
50,12,41,Florida,Gilchrist County,4,9,1017,505,512
50,12,41,Florida,Gilchrist County,4,10,1160,603,557
50,12,41,Florida,Gilchrist County,4,11,1213,604,609
50,12,41,Florida,Gilchrist County,4,12,1221,600,621
50,12,41,Florida,Gilchrist County,4,13,1151,558,593
50,12,41,Florida,Gilchrist County,4,14,972,486,486
50,12,41,Florida,Gilchrist County,4,15,735,360,375
50,12,41,Florida,Gilchrist County,4,16,517,237,280
50,12,41,Florida,Gilchrist County,4,17,379,173,206
50,12,41,Florida,Gilchrist County,4,18,378,111,267
50,12,41,Florida,Gilchrist County,5,0,16897,8826,8071
50,12,41,Florida,Gilchrist County,5,1,902,469,433
50,12,41,Florida,Gilchrist County,5,2,908,455,453
50,12,41,Florida,Gilchrist County,5,3,1056,535,521
50,12,41,Florida,Gilchrist County,5,4,1295,811,484
50,12,41,Florida,Gilchrist County,5,5,1463,1066,397
50,12,41,Florida,Gilchrist County,5,6,853,420,433
50,12,41,Florida,Gilchrist County,5,7,817,422,395
50,12,41,Florida,Gilchrist County,5,8,782,386,396
50,12,41,Florida,Gilchrist County,5,9,1056,515,541
50,12,41,Florida,Gilchrist County,5,10,1111,566,545
50,12,41,Florida,Gilchrist County,5,11,1227,627,600
50,12,41,Florida,Gilchrist County,5,12,1223,595,628
50,12,41,Florida,Gilchrist County,5,13,1110,542,568
50,12,41,Florida,Gilchrist County,5,14,1029,511,518
50,12,41,Florida,Gilchrist County,5,15,761,376,385
50,12,41,Florida,Gilchrist County,5,16,548,244,304
50,12,41,Florida,Gilchrist County,5,17,381,177,204
50,12,41,Florida,Gilchrist County,5,18,375,109,266
50,12,41,Florida,Gilchrist County,6,0,16957,8895,8062
50,12,41,Florida,Gilchrist County,6,1,924,485,439
50,12,41,Florida,Gilchrist County,6,2,883,445,438
50,12,41,Florida,Gilchrist County,6,3,998,505,493
50,12,41,Florida,Gilchrist County,6,4,1317,842,475
50,12,41,Florida,Gilchrist County,6,5,1467,1051,416
50,12,41,Florida,Gilchrist County,6,6,839,436,403
50,12,41,Florida,Gilchrist County,6,7,848,452,396
50,12,41,Florida,Gilchrist County,6,8,786,388,398
50,12,41,Florida,Gilchrist County,6,9,1026,487,539
50,12,41,Florida,Gilchrist County,6,10,1089,563,526
50,12,41,Florida,Gilchrist County,6,11,1203,616,587
50,12,41,Florida,Gilchrist County,6,12,1271,619,652
50,12,41,Florida,Gilchrist County,6,13,1109,544,565
50,12,41,Florida,Gilchrist County,6,14,1032,509,523
50,12,41,Florida,Gilchrist County,6,15,833,410,423
50,12,41,Florida,Gilchrist County,6,16,558,247,311
50,12,41,Florida,Gilchrist County,6,17,394,184,210
50,12,41,Florida,Gilchrist County,6,18,380,112,268
50,12,41,Florida,Gilchrist County,7,0,16991,8866,8125
50,12,41,Florida,Gilchrist County,7,1,944,492,452
50,12,41,Florida,Gilchrist County,7,2,891,440,451
50,12,41,Florida,Gilchrist County,7,3,950,495,455
50,12,41,Florida,Gilchrist County,7,4,1291,802,489
50,12,41,Florida,Gilchrist County,7,5,1489,1059,430
50,12,41,Florida,Gilchrist County,7,6,839,445,394
50,12,41,Florida,Gilchrist County,7,7,856,448,408
50,12,41,Florida,Gilchrist County,7,8,799,389,410
50,12,41,Florida,Gilchrist County,7,9,1003,460,543
50,12,41,Florida,Gilchrist County,7,10,1060,539,521
50,12,41,Florida,Gilchrist County,7,11,1210,627,583
50,12,41,Florida,Gilchrist County,7,12,1244,606,638
50,12,41,Florida,Gilchrist County,7,13,1137,562,575
50,12,41,Florida,Gilchrist County,7,14,1026,493,533
50,12,41,Florida,Gilchrist County,7,15,882,442,440
50,12,41,Florida,Gilchrist County,7,16,576,264,312
50,12,41,Florida,Gilchrist County,7,17,385,171,214
50,12,41,Florida,Gilchrist County,7,18,409,132,277
50,12,41,Florida,Gilchrist County,8,0,17378,9038,8340
50,12,41,Florida,Gilchrist County,8,1,969,516,453
50,12,41,Florida,Gilchrist County,8,2,956,479,477
50,12,41,Florida,Gilchrist County,8,3,997,485,512
50,12,41,Florida,Gilchrist County,8,4,1280,806,474
50,12,41,Florida,Gilchrist County,8,5,1518,1071,447
50,12,41,Florida,Gilchrist County,8,6,900,480,420
50,12,41,Florida,Gilchrist County,8,7,868,434,434
50,12,41,Florida,Gilchrist County,8,8,803,405,398
50,12,41,Florida,Gilchrist County,8,9,974,450,524
50,12,41,Florida,Gilchrist County,8,10,1084,553,531
50,12,41,Florida,Gilchrist County,8,11,1185,615,570
50,12,41,Florida,Gilchrist County,8,12,1271,616,655
50,12,41,Florida,Gilchrist County,8,13,1183,575,608
50,12,41,Florida,Gilchrist County,8,14,1098,526,572
50,12,41,Florida,Gilchrist County,8,15,870,428,442
50,12,41,Florida,Gilchrist County,8,16,614,290,324
50,12,41,Florida,Gilchrist County,8,17,378,166,212
50,12,41,Florida,Gilchrist County,8,18,430,143,287
50,12,41,Florida,Gilchrist County,9,0,17622,9149,8473
50,12,41,Florida,Gilchrist County,9,1,1009,535,474
50,12,41,Florida,Gilchrist County,9,2,921,471,450
50,12,41,Florida,Gilchrist County,9,3,974,484,490
50,12,41,Florida,Gilchrist County,9,4,1324,808,516
50,12,41,Florida,Gilchrist County,9,5,1480,1062,418
50,12,41,Florida,Gilchrist County,9,6,934,496,438
50,12,41,Florida,Gilchrist County,9,7,899,437,462
50,12,41,Florida,Gilchrist County,9,8,852,431,421
50,12,41,Florida,Gilchrist County,9,9,942,436,506
50,12,41,Florida,Gilchrist County,9,10,1044,533,511
50,12,41,Florida,Gilchrist County,9,11,1235,641,594
50,12,41,Florida,Gilchrist County,9,12,1278,626,652
50,12,41,Florida,Gilchrist County,9,13,1239,592,647
50,12,41,Florida,Gilchrist County,9,14,1133,549,584
50,12,41,Florida,Gilchrist County,9,15,876,425,451
50,12,41,Florida,Gilchrist County,9,16,635,297,338
50,12,41,Florida,Gilchrist County,9,17,393,176,217
50,12,41,Florida,Gilchrist County,9,18,454,150,304
50,12,41,Florida,Gilchrist County,10,0,17900,9254,8646
50,12,41,Florida,Gilchrist County,10,1,1034,549,485
50,12,41,Florida,Gilchrist County,10,2,963,491,472
50,12,41,Florida,Gilchrist County,10,3,960,455,505
50,12,41,Florida,Gilchrist County,10,4,1337,820,517
50,12,41,Florida,Gilchrist County,10,5,1458,1065,393
50,12,41,Florida,Gilchrist County,10,6,949,478,471
50,12,41,Florida,Gilchrist County,10,7,924,454,470
50,12,41,Florida,Gilchrist County,10,8,953,483,470
50,12,41,Florida,Gilchrist County,10,9,865,415,450
50,12,41,Florida,Gilchrist County,10,10,1071,524,547
50,12,41,Florida,Gilchrist County,10,11,1196,622,574
50,12,41,Florida,Gilchrist County,10,12,1328,650,678
50,12,41,Florida,Gilchrist County,10,13,1278,619,659
50,12,41,Florida,Gilchrist County,10,14,1115,541,574
50,12,41,Florida,Gilchrist County,10,15,928,450,478
50,12,41,Florida,Gilchrist County,10,16,655,302,353
50,12,41,Florida,Gilchrist County,10,17,417,178,239
50,12,41,Florida,Gilchrist County,10,18,469,158,311
50,12,41,Florida,Gilchrist County,11,0,18284,9451,8833
50,12,41,Florida,Gilchrist County,11,1,1034,563,471
50,12,41,Florida,Gilchrist County,11,2,1010,515,495
50,12,41,Florida,Gilchrist County,11,3,997,476,521
50,12,41,Florida,Gilchrist County,11,4,1325,817,508
50,12,41,Florida,Gilchrist County,11,5,1499,1092,407
50,12,41,Florida,Gilchrist County,11,6,944,482,462
50,12,41,Florida,Gilchrist County,11,7,957,477,480
50,12,41,Florida,Gilchrist County,11,8,996,514,482
50,12,41,Florida,Gilchrist County,11,9,888,444,444
50,12,41,Florida,Gilchrist County,11,10,1088,511,577
50,12,41,Florida,Gilchrist County,11,11,1197,615,582
50,12,41,Florida,Gilchrist County,11,12,1326,658,668
50,12,41,Florida,Gilchrist County,11,13,1328,632,696
50,12,41,Florida,Gilchrist County,11,14,1126,536,590
50,12,41,Florida,Gilchrist County,11,15,917,443,474
50,12,41,Florida,Gilchrist County,11,16,734,337,397
50,12,41,Florida,Gilchrist County,11,17,439,181,258
50,12,41,Florida,Gilchrist County,11,18,479,158,321
50,12,41,Florida,Gilchrist County,12,0,18582,9588,8994
50,12,41,Florida,Gilchrist County,12,1,989,531,458
50,12,41,Florida,Gilchrist County,12,2,1046,544,502
50,12,41,Florida,Gilchrist County,12,3,1013,481,532
50,12,41,Florida,Gilchrist County,12,4,1304,812,492
50,12,41,Florida,Gilchrist County,12,5,1548,1128,420
50,12,41,Florida,Gilchrist County,12,6,934,479,455
50,12,41,Florida,Gilchrist County,12,7,982,490,492
50,12,41,Florida,Gilchrist County,12,8,999,501,498
50,12,41,Florida,Gilchrist County,12,9,938,473,465
50,12,41,Florida,Gilchrist County,12,10,1108,518,590
50,12,41,Florida,Gilchrist County,12,11,1144,592,552
50,12,41,Florida,Gilchrist County,12,12,1378,691,687
50,12,41,Florida,Gilchrist County,12,13,1361,641,720
50,12,41,Florida,Gilchrist County,12,14,1151,547,604
50,12,41,Florida,Gilchrist County,12,15,952,450,502
50,12,41,Florida,Gilchrist County,12,16,788,364,424
50,12,41,Florida,Gilchrist County,12,17,464,193,271
50,12,41,Florida,Gilchrist County,12,18,483,153,330
50,12,43,Florida,Glades County,1,0,12884,7443,5441
50,12,43,Florida,Glades County,1,1,718,357,361
50,12,43,Florida,Glades County,1,2,645,330,315
50,12,43,Florida,Glades County,1,3,661,354,307
50,12,43,Florida,Glades County,1,4,687,397,290
50,12,43,Florida,Glades County,1,5,718,454,264
50,12,43,Florida,Glades County,1,6,896,599,297
50,12,43,Florida,Glades County,1,7,778,525,253
50,12,43,Florida,Glades County,1,8,806,555,251
50,12,43,Florida,Glades County,1,9,856,525,331
50,12,43,Florida,Glades County,1,10,859,540,319
50,12,43,Florida,Glades County,1,11,810,482,328
50,12,43,Florida,Glades County,1,12,854,449,405
50,12,43,Florida,Glades County,1,13,829,436,393
50,12,43,Florida,Glades County,1,14,907,458,449
50,12,43,Florida,Glades County,1,15,821,433,388
50,12,43,Florida,Glades County,1,16,520,286,234
50,12,43,Florida,Glades County,1,17,333,180,153
50,12,43,Florida,Glades County,1,18,186,83,103
50,12,43,Florida,Glades County,2,0,12881,7441,5440
50,12,43,Florida,Glades County,2,1,718,357,361
50,12,43,Florida,Glades County,2,2,645,330,315
50,12,43,Florida,Glades County,2,3,661,354,307
50,12,43,Florida,Glades County,2,4,687,397,290
50,12,43,Florida,Glades County,2,5,718,454,264
50,12,43,Florida,Glades County,2,6,896,599,297
50,12,43,Florida,Glades County,2,7,778,525,253
50,12,43,Florida,Glades County,2,8,806,555,251
50,12,43,Florida,Glades County,2,9,856,525,331
50,12,43,Florida,Glades County,2,10,858,539,319
50,12,43,Florida,Glades County,2,11,810,482,328
50,12,43,Florida,Glades County,2,12,854,449,405
50,12,43,Florida,Glades County,2,13,829,436,393
50,12,43,Florida,Glades County,2,14,907,458,449
50,12,43,Florida,Glades County,2,15,820,433,387
50,12,43,Florida,Glades County,2,16,519,285,234
50,12,43,Florida,Glades County,2,17,333,180,153
50,12,43,Florida,Glades County,2,18,186,83,103
50,12,43,Florida,Glades County,3,0,12869,7430,5439
50,12,43,Florida,Glades County,3,1,693,337,356
50,12,43,Florida,Glades County,3,2,654,342,312
50,12,43,Florida,Glades County,3,3,659,352,307
50,12,43,Florida,Glades County,3,4,675,389,286
50,12,43,Florida,Glades County,3,5,721,454,267
50,12,43,Florida,Glades County,3,6,895,598,297
50,12,43,Florida,Glades County,3,7,783,525,258
50,12,43,Florida,Glades County,3,8,797,551,246
50,12,43,Florida,Glades County,3,9,854,525,329
50,12,43,Florida,Glades County,3,10,846,532,314
50,12,43,Florida,Glades County,3,11,824,492,332
50,12,43,Florida,Glades County,3,12,850,450,400
50,12,43,Florida,Glades County,3,13,833,435,398
50,12,43,Florida,Glades County,3,14,905,457,448
50,12,43,Florida,Glades County,3,15,820,433,387
50,12,43,Florida,Glades County,3,16,529,287,242
50,12,43,Florida,Glades County,3,17,342,187,155
50,12,43,Florida,Glades County,3,18,189,84,105
50,12,43,Florida,Glades County,4,0,12837,7343,5494
50,12,43,Florida,Glades County,4,1,652,298,354
50,12,43,Florida,Glades County,4,2,664,339,325
50,12,43,Florida,Glades County,4,3,670,351,319
50,12,43,Florida,Glades County,4,4,646,376,270
50,12,43,Florida,Glades County,4,5,737,458,279
50,12,43,Florida,Glades County,4,6,880,580,300
50,12,43,Florida,Glades County,4,7,788,491,297
50,12,43,Florida,Glades County,4,8,801,564,237
50,12,43,Florida,Glades County,4,9,831,510,321
50,12,43,Florida,Glades County,4,10,826,528,298
50,12,43,Florida,Glades County,4,11,832,498,334
50,12,43,Florida,Glades County,4,12,816,445,371
50,12,43,Florida,Glades County,4,13,837,419,418
50,12,43,Florida,Glades County,4,14,894,456,438
50,12,43,Florida,Glades County,4,15,831,441,390
50,12,43,Florida,Glades County,4,16,578,298,280
50,12,43,Florida,Glades County,4,17,352,198,154
50,12,43,Florida,Glades County,4,18,202,93,109
50,12,43,Florida,Glades County,5,0,12669,7242,5427
50,12,43,Florida,Glades County,5,1,541,260,281
50,12,43,Florida,Glades County,5,2,661,320,341
50,12,43,Florida,Glades County,5,3,680,348,332
50,12,43,Florida,Glades County,5,4,606,330,276
50,12,43,Florida,Glades County,5,5,700,445,255
50,12,43,Florida,Glades County,5,6,871,594,277
50,12,43,Florida,Glades County,5,7,780,467,313
50,12,43,Florida,Glades County,5,8,790,558,232
50,12,43,Florida,Glades County,5,9,843,525,318
50,12,43,Florida,Glades County,5,10,829,517,312
50,12,43,Florida,Glades County,5,11,822,508,314
50,12,43,Florida,Glades County,5,12,819,432,387
50,12,43,Florida,Glades County,5,13,817,419,398
50,12,43,Florida,Glades County,5,14,881,452,429
50,12,43,Florida,Glades County,5,15,842,447,395
50,12,43,Florida,Glades County,5,16,589,301,288
50,12,43,Florida,Glades County,5,17,362,207,155
50,12,43,Florida,Glades County,5,18,236,112,124
50,12,43,Florida,Glades County,6,0,12670,7217,5453
50,12,43,Florida,Glades County,6,1,518,245,273
50,12,43,Florida,Glades County,6,2,651,319,332
50,12,43,Florida,Glades County,6,3,627,321,306
50,12,43,Florida,Glades County,6,4,617,342,275
50,12,43,Florida,Glades County,6,5,700,419,281
50,12,43,Florida,Glades County,6,6,863,592,271
50,12,43,Florida,Glades County,6,7,802,469,333
50,12,43,Florida,Glades County,6,8,759,539,220
50,12,43,Florida,Glades County,6,9,842,534,308
50,12,43,Florida,Glades County,6,10,800,497,303
50,12,43,Florida,Glades County,6,11,817,498,319
50,12,43,Florida,Glades County,6,12,845,452,393
50,12,43,Florida,Glades County,6,13,823,420,403
50,12,43,Florida,Glades County,6,14,877,451,426
50,12,43,Florida,Glades County,6,15,838,446,392
50,12,43,Florida,Glades County,6,16,628,319,309
50,12,43,Florida,Glades County,6,17,395,223,172
50,12,43,Florida,Glades County,6,18,268,131,137
50,12,43,Florida,Glades County,7,0,12943,7345,5598
50,12,43,Florida,Glades County,7,1,474,239,235
50,12,43,Florida,Glades County,7,2,679,329,350
50,12,43,Florida,Glades County,7,3,636,321,315
50,12,43,Florida,Glades County,7,4,623,345,278
50,12,43,Florida,Glades County,7,5,686,404,282
50,12,43,Florida,Glades County,7,6,858,583,275
50,12,43,Florida,Glades County,7,7,842,499,343
50,12,43,Florida,Glades County,7,8,775,542,233
50,12,43,Florida,Glades County,7,9,848,558,290
50,12,43,Florida,Glades County,7,10,803,487,316
50,12,43,Florida,Glades County,7,11,855,520,335
50,12,43,Florida,Glades County,7,12,809,436,373
50,12,43,Florida,Glades County,7,13,836,409,427
50,12,43,Florida,Glades County,7,14,896,465,431
50,12,43,Florida,Glades County,7,15,913,485,428
50,12,43,Florida,Glades County,7,16,695,352,343
50,12,43,Florida,Glades County,7,17,420,223,197
50,12,43,Florida,Glades County,7,18,295,148,147
50,12,43,Florida,Glades County,8,0,13099,7400,5699
50,12,43,Florida,Glades County,8,1,420,200,220
50,12,43,Florida,Glades County,8,2,683,334,349
50,12,43,Florida,Glades County,8,3,657,339,318
50,12,43,Florida,Glades County,8,4,633,342,291
50,12,43,Florida,Glades County,8,5,678,407,271
50,12,43,Florida,Glades County,8,6,868,592,276
50,12,43,Florida,Glades County,8,7,832,512,320
50,12,43,Florida,Glades County,8,8,792,542,250
50,12,43,Florida,Glades County,8,9,848,563,285
50,12,43,Florida,Glades County,8,10,823,481,342
50,12,43,Florida,Glades County,8,11,843,496,347
50,12,43,Florida,Glades County,8,12,817,456,361
50,12,43,Florida,Glades County,8,13,834,412,422
50,12,43,Florida,Glades County,8,14,911,463,448
50,12,43,Florida,Glades County,8,15,939,461,478
50,12,43,Florida,Glades County,8,16,758,403,355
50,12,43,Florida,Glades County,8,17,428,224,204
50,12,43,Florida,Glades County,8,18,335,173,162
50,12,43,Florida,Glades County,9,0,13406,7516,5890
50,12,43,Florida,Glades County,9,1,420,199,221
50,12,43,Florida,Glades County,9,2,670,315,355
50,12,43,Florida,Glades County,9,3,646,338,308
50,12,43,Florida,Glades County,9,4,667,361,306
50,12,43,Florida,Glades County,9,5,638,381,257
50,12,43,Florida,Glades County,9,6,934,629,305
50,12,43,Florida,Glades County,9,7,816,518,298
50,12,43,Florida,Glades County,9,8,859,559,300
50,12,43,Florida,Glades County,9,9,806,538,268
50,12,43,Florida,Glades County,9,10,830,482,348
50,12,43,Florida,Glades County,9,11,898,502,396
50,12,43,Florida,Glades County,9,12,839,480,359
50,12,43,Florida,Glades County,9,13,837,414,423
50,12,43,Florida,Glades County,9,14,963,480,483
50,12,43,Florida,Glades County,9,15,974,483,491
50,12,43,Florida,Glades County,9,16,778,412,366
50,12,43,Florida,Glades County,9,17,475,239,236
50,12,43,Florida,Glades County,9,18,356,186,170
50,12,43,Florida,Glades County,10,0,13580,7572,6008
50,12,43,Florida,Glades County,10,1,395,180,215
50,12,43,Florida,Glades County,10,2,621,302,319
50,12,43,Florida,Glades County,10,3,651,330,321
50,12,43,Florida,Glades County,10,4,680,366,314
50,12,43,Florida,Glades County,10,5,634,388,246
50,12,43,Florida,Glades County,10,6,951,615,336
50,12,43,Florida,Glades County,10,7,853,551,302
50,12,43,Florida,Glades County,10,8,833,534,299
50,12,43,Florida,Glades County,10,9,835,552,283
50,12,43,Florida,Glades County,10,10,842,486,356
50,12,43,Florida,Glades County,10,11,894,497,397
50,12,43,Florida,Glades County,10,12,862,480,382
50,12,43,Florida,Glades County,10,13,887,434,453
50,12,43,Florida,Glades County,10,14,921,452,469
50,12,43,Florida,Glades County,10,15,994,492,502
50,12,43,Florida,Glades County,10,16,835,445,390
50,12,43,Florida,Glades County,10,17,510,258,252
50,12,43,Florida,Glades County,10,18,382,210,172
50,12,43,Florida,Glades County,11,0,13686,7679,6007
50,12,43,Florida,Glades County,11,1,419,213,206
50,12,43,Florida,Glades County,11,2,565,284,281
50,12,43,Florida,Glades County,11,3,670,330,340
50,12,43,Florida,Glades County,11,4,638,363,275
50,12,43,Florida,Glades County,11,5,656,389,267
50,12,43,Florida,Glades County,11,6,922,594,328
50,12,43,Florida,Glades County,11,7,859,567,292
50,12,43,Florida,Glades County,11,8,856,546,310
50,12,43,Florida,Glades County,11,9,824,538,286
50,12,43,Florida,Glades County,11,10,881,521,360
50,12,43,Florida,Glades County,11,11,863,474,389
50,12,43,Florida,Glades County,11,12,872,486,386
50,12,43,Florida,Glades County,11,13,925,474,451
50,12,43,Florida,Glades County,11,14,918,431,487
50,12,43,Florida,Glades County,11,15,995,506,489
50,12,43,Florida,Glades County,11,16,873,466,407
50,12,43,Florida,Glades County,11,17,550,276,274
50,12,43,Florida,Glades County,11,18,400,221,179
50,12,43,Florida,Glades County,12,0,13811,7700,6111
50,12,43,Florida,Glades County,12,1,404,209,195
50,12,43,Florida,Glades County,12,2,533,264,269
50,12,43,Florida,Glades County,12,3,670,332,338
50,12,43,Florida,Glades County,12,4,635,346,289
50,12,43,Florida,Glades County,12,5,656,374,282
50,12,43,Florida,Glades County,12,6,916,589,327
50,12,43,Florida,Glades County,12,7,836,537,299
50,12,43,Florida,Glades County,12,8,942,590,352
50,12,43,Florida,Glades County,12,9,816,542,274
50,12,43,Florida,Glades County,12,10,873,525,348
50,12,43,Florida,Glades County,12,11,859,455,404
50,12,43,Florida,Glades County,12,12,922,511,411
50,12,43,Florida,Glades County,12,13,941,471,470
50,12,43,Florida,Glades County,12,14,909,428,481
50,12,43,Florida,Glades County,12,15,977,505,472
50,12,43,Florida,Glades County,12,16,943,498,445
50,12,43,Florida,Glades County,12,17,595,313,282
50,12,43,Florida,Glades County,12,18,384,211,173
50,12,45,Florida,Gulf County,1,0,15863,9484,6379
50,12,45,Florida,Gulf County,1,1,649,312,337
50,12,45,Florida,Gulf County,1,2,649,324,325
50,12,45,Florida,Gulf County,1,3,808,426,382
50,12,45,Florida,Gulf County,1,4,752,403,349
50,12,45,Florida,Gulf County,1,5,926,652,274
50,12,45,Florida,Gulf County,1,6,1206,932,274
50,12,45,Florida,Gulf County,1,7,1154,831,323
50,12,45,Florida,Gulf County,1,8,1125,785,340
50,12,45,Florida,Gulf County,1,9,1241,828,413
50,12,45,Florida,Gulf County,1,10,1358,886,472
50,12,45,Florida,Gulf County,1,11,1215,715,500
50,12,45,Florida,Gulf County,1,12,1139,619,520
50,12,45,Florida,Gulf County,1,13,1054,552,502
50,12,45,Florida,Gulf County,1,14,854,444,410
50,12,45,Florida,Gulf County,1,15,652,299,353
50,12,45,Florida,Gulf County,1,16,488,244,244
50,12,45,Florida,Gulf County,1,17,349,149,200
50,12,45,Florida,Gulf County,1,18,244,83,161
50,12,45,Florida,Gulf County,2,0,15863,9484,6379
50,12,45,Florida,Gulf County,2,1,648,312,336
50,12,45,Florida,Gulf County,2,2,649,324,325
50,12,45,Florida,Gulf County,2,3,808,426,382
50,12,45,Florida,Gulf County,2,4,751,403,348
50,12,45,Florida,Gulf County,2,5,924,651,273
50,12,45,Florida,Gulf County,2,6,1206,932,274
50,12,45,Florida,Gulf County,2,7,1154,831,323
50,12,45,Florida,Gulf County,2,8,1125,785,340
50,12,45,Florida,Gulf County,2,9,1241,828,413
50,12,45,Florida,Gulf County,2,10,1358,886,472
50,12,45,Florida,Gulf County,2,11,1217,716,501
50,12,45,Florida,Gulf County,2,12,1139,619,520
50,12,45,Florida,Gulf County,2,13,1052,550,502
50,12,45,Florida,Gulf County,2,14,854,444,410
50,12,45,Florida,Gulf County,2,15,653,299,354
50,12,45,Florida,Gulf County,2,16,489,245,244
50,12,45,Florida,Gulf County,2,17,351,150,201
50,12,45,Florida,Gulf County,2,18,244,83,161
50,12,45,Florida,Gulf County,3,0,15825,9436,6389
50,12,45,Florida,Gulf County,3,1,640,307,333
50,12,45,Florida,Gulf County,3,2,644,322,322
50,12,45,Florida,Gulf County,3,3,808,423,385
50,12,45,Florida,Gulf County,3,4,737,395,342
50,12,45,Florida,Gulf County,3,5,928,651,277
50,12,45,Florida,Gulf County,3,6,1194,921,273
50,12,45,Florida,Gulf County,3,7,1146,823,323
50,12,45,Florida,Gulf County,3,8,1118,778,340
50,12,45,Florida,Gulf County,3,9,1222,806,416
50,12,45,Florida,Gulf County,3,10,1342,875,467
50,12,45,Florida,Gulf County,3,11,1221,725,496
50,12,45,Florida,Gulf County,3,12,1141,618,523
50,12,45,Florida,Gulf County,3,13,1068,556,512
50,12,45,Florida,Gulf County,3,14,856,446,410
50,12,45,Florida,Gulf County,3,15,658,301,357
50,12,45,Florida,Gulf County,3,16,492,250,242
50,12,45,Florida,Gulf County,3,17,358,152,206
50,12,45,Florida,Gulf County,3,18,252,87,165
50,12,45,Florida,Gulf County,4,0,15764,9396,6368
50,12,45,Florida,Gulf County,4,1,660,323,337
50,12,45,Florida,Gulf County,4,2,621,308,313
50,12,45,Florida,Gulf County,4,3,786,401,385
50,12,45,Florida,Gulf County,4,4,702,376,326
50,12,45,Florida,Gulf County,4,5,980,667,313
50,12,45,Florida,Gulf County,4,6,1185,932,253
50,12,45,Florida,Gulf County,4,7,1130,817,313
50,12,45,Florida,Gulf County,4,8,1110,768,342
50,12,45,Florida,Gulf County,4,9,1182,772,410
50,12,45,Florida,Gulf County,4,10,1279,851,428
50,12,45,Florida,Gulf County,4,11,1240,749,491
50,12,45,Florida,Gulf County,4,12,1097,594,503
50,12,45,Florida,Gulf County,4,13,1110,571,539
50,12,45,Florida,Gulf County,4,14,863,454,409
50,12,45,Florida,Gulf County,4,15,683,311,372
50,12,45,Florida,Gulf County,4,16,498,257,241
50,12,45,Florida,Gulf County,4,17,353,141,212
50,12,45,Florida,Gulf County,4,18,285,104,181
50,12,45,Florida,Gulf County,5,0,15770,9433,6337
50,12,45,Florida,Gulf County,5,1,644,318,326
50,12,45,Florida,Gulf County,5,2,629,298,331
50,12,45,Florida,Gulf County,5,3,748,377,371
50,12,45,Florida,Gulf County,5,4,698,394,304
50,12,45,Florida,Gulf County,5,5,987,672,315
50,12,45,Florida,Gulf County,5,6,1204,945,259
50,12,45,Florida,Gulf County,5,7,1157,853,304
50,12,45,Florida,Gulf County,5,8,1094,772,322
50,12,45,Florida,Gulf County,5,9,1168,779,389
50,12,45,Florida,Gulf County,5,10,1267,837,430
50,12,45,Florida,Gulf County,5,11,1217,741,476
50,12,45,Florida,Gulf County,5,12,1087,590,497
50,12,45,Florida,Gulf County,5,13,1079,546,533
50,12,45,Florida,Gulf County,5,14,937,479,458
50,12,45,Florida,Gulf County,5,15,696,332,364
50,12,45,Florida,Gulf County,5,16,496,248,248
50,12,45,Florida,Gulf County,5,17,366,149,217
50,12,45,Florida,Gulf County,5,18,296,103,193
50,12,45,Florida,Gulf County,6,0,15884,9521,6363
50,12,45,Florida,Gulf County,6,1,655,334,321
50,12,45,Florida,Gulf County,6,2,650,312,338
50,12,45,Florida,Gulf County,6,3,715,362,353
50,12,45,Florida,Gulf County,6,4,668,363,305
50,12,45,Florida,Gulf County,6,5,1016,701,315
50,12,45,Florida,Gulf County,6,6,1223,961,262
50,12,45,Florida,Gulf County,6,7,1168,849,319
50,12,45,Florida,Gulf County,6,8,1083,767,316
50,12,45,Florida,Gulf County,6,9,1168,793,375
50,12,45,Florida,Gulf County,6,10,1282,850,432
50,12,45,Florida,Gulf County,6,11,1226,743,483
50,12,45,Florida,Gulf County,6,12,1107,602,505
50,12,45,Florida,Gulf County,6,13,1072,532,540
50,12,45,Florida,Gulf County,6,14,972,502,470
50,12,45,Florida,Gulf County,6,15,722,346,376
50,12,45,Florida,Gulf County,6,16,516,239,277
50,12,45,Florida,Gulf County,6,17,350,155,195
50,12,45,Florida,Gulf County,6,18,291,110,181
50,12,45,Florida,Gulf County,7,0,16002,9639,6363
50,12,45,Florida,Gulf County,7,1,673,334,339
50,12,45,Florida,Gulf County,7,2,685,322,363
50,12,45,Florida,Gulf County,7,3,652,343,309
50,12,45,Florida,Gulf County,7,4,681,359,322
50,12,45,Florida,Gulf County,7,5,986,692,294
50,12,45,Florida,Gulf County,7,6,1258,980,278
50,12,45,Florida,Gulf County,7,7,1161,873,288
50,12,45,Florida,Gulf County,7,8,1109,781,328
50,12,45,Florida,Gulf County,7,9,1138,793,345
50,12,45,Florida,Gulf County,7,10,1258,836,422
50,12,45,Florida,Gulf County,7,11,1246,751,495
50,12,45,Florida,Gulf County,7,12,1102,597,505
50,12,45,Florida,Gulf County,7,13,1092,555,537
50,12,45,Florida,Gulf County,7,14,1005,508,497
50,12,45,Florida,Gulf County,7,15,767,380,387
50,12,45,Florida,Gulf County,7,16,530,247,283
50,12,45,Florida,Gulf County,7,17,363,169,194
50,12,45,Florida,Gulf County,7,18,296,119,177
50,12,45,Florida,Gulf County,8,0,15929,9510,6419
50,12,45,Florida,Gulf County,8,1,664,344,320
50,12,45,Florida,Gulf County,8,2,685,327,358
50,12,45,Florida,Gulf County,8,3,645,351,294
50,12,45,Florida,Gulf County,8,4,739,376,363
50,12,45,Florida,Gulf County,8,5,932,658,274
50,12,45,Florida,Gulf County,8,6,1272,959,313
50,12,45,Florida,Gulf County,8,7,1091,828,263
50,12,45,Florida,Gulf County,8,8,1070,742,328
50,12,45,Florida,Gulf County,8,9,1088,749,339
50,12,45,Florida,Gulf County,8,10,1178,775,403
50,12,45,Florida,Gulf County,8,11,1230,748,482
50,12,45,Florida,Gulf County,8,12,1150,619,531
50,12,45,Florida,Gulf County,8,13,1118,581,537
50,12,45,Florida,Gulf County,8,14,1026,501,525
50,12,45,Florida,Gulf County,8,15,816,418,398
50,12,45,Florida,Gulf County,8,16,557,238,319
50,12,45,Florida,Gulf County,8,17,359,180,179
50,12,45,Florida,Gulf County,8,18,309,116,193
50,12,45,Florida,Gulf County,9,0,16062,9526,6536
50,12,45,Florida,Gulf County,9,1,645,345,300
50,12,45,Florida,Gulf County,9,2,710,347,363
50,12,45,Florida,Gulf County,9,3,635,331,304
50,12,45,Florida,Gulf County,9,4,741,377,364
50,12,45,Florida,Gulf County,9,5,912,647,265
50,12,45,Florida,Gulf County,9,6,1322,964,358
50,12,45,Florida,Gulf County,9,7,1059,813,246
50,12,45,Florida,Gulf County,9,8,1072,743,329
50,12,45,Florida,Gulf County,9,9,1077,740,337
50,12,45,Florida,Gulf County,9,10,1146,743,403
50,12,45,Florida,Gulf County,9,11,1220,752,468
50,12,45,Florida,Gulf County,9,12,1202,643,559
50,12,45,Florida,Gulf County,9,13,1123,577,546
50,12,45,Florida,Gulf County,9,14,1091,527,564
50,12,45,Florida,Gulf County,9,15,837,424,413
50,12,45,Florida,Gulf County,9,16,576,249,327
50,12,45,Florida,Gulf County,9,17,355,178,177
50,12,45,Florida,Gulf County,9,18,339,126,213
50,12,45,Florida,Gulf County,10,0,16105,9447,6658
50,12,45,Florida,Gulf County,10,1,642,334,308
50,12,45,Florida,Gulf County,10,2,742,372,370
50,12,45,Florida,Gulf County,10,3,674,344,330
50,12,45,Florida,Gulf County,10,4,716,370,346
50,12,45,Florida,Gulf County,10,5,897,630,267
50,12,45,Florida,Gulf County,10,6,1273,917,356
50,12,45,Florida,Gulf County,10,7,1074,800,274
50,12,45,Florida,Gulf County,10,8,1008,701,307
50,12,45,Florida,Gulf County,10,9,1045,706,339
50,12,45,Florida,Gulf County,10,10,1156,735,421
50,12,45,Florida,Gulf County,10,11,1205,736,469
50,12,45,Florida,Gulf County,10,12,1179,612,567
50,12,45,Florida,Gulf County,10,13,1153,601,552
50,12,45,Florida,Gulf County,10,14,1099,543,556
50,12,45,Florida,Gulf County,10,15,921,461,460
50,12,45,Florida,Gulf County,10,16,613,285,328
50,12,45,Florida,Gulf County,10,17,368,166,202
50,12,45,Florida,Gulf County,10,18,340,134,206
50,12,45,Florida,Gulf County,11,0,16146,9460,6686
50,12,45,Florida,Gulf County,11,1,642,342,300
50,12,45,Florida,Gulf County,11,2,718,367,351
50,12,45,Florida,Gulf County,11,3,719,356,363
50,12,45,Florida,Gulf County,11,4,700,370,330
50,12,45,Florida,Gulf County,11,5,899,629,270
50,12,45,Florida,Gulf County,11,6,1220,884,336
50,12,45,Florida,Gulf County,11,7,1089,793,296
50,12,45,Florida,Gulf County,11,8,998,689,309
50,12,45,Florida,Gulf County,11,9,1028,684,344
50,12,45,Florida,Gulf County,11,10,1111,724,387
50,12,45,Florida,Gulf County,11,11,1176,699,477
50,12,45,Florida,Gulf County,11,12,1185,641,544
50,12,45,Florida,Gulf County,11,13,1167,599,568
50,12,45,Florida,Gulf County,11,14,1151,575,576
50,12,45,Florida,Gulf County,11,15,962,487,475
50,12,45,Florida,Gulf County,11,16,655,309,346
50,12,45,Florida,Gulf County,11,17,384,166,218
50,12,45,Florida,Gulf County,11,18,342,146,196
50,12,45,Florida,Gulf County,12,0,13639,6890,6749
50,12,45,Florida,Gulf County,12,1,645,337,308
50,12,45,Florida,Gulf County,12,2,723,367,356
50,12,45,Florida,Gulf County,12,3,734,364,370
50,12,45,Florida,Gulf County,12,4,626,318,308
50,12,45,Florida,Gulf County,12,5,627,339,288
50,12,45,Florida,Gulf County,12,6,724,397,327
50,12,45,Florida,Gulf County,12,7,707,395,312
50,12,45,Florida,Gulf County,12,8,622,333,289
50,12,45,Florida,Gulf County,12,9,693,342,351
50,12,45,Florida,Gulf County,12,10,755,401,354
50,12,45,Florida,Gulf County,12,11,962,485,477
50,12,45,Florida,Gulf County,12,12,1090,544,546
50,12,45,Florida,Gulf County,12,13,1117,529,588
50,12,45,Florida,Gulf County,12,14,1188,601,587
50,12,45,Florida,Gulf County,12,15,970,469,501
50,12,45,Florida,Gulf County,12,16,695,333,362
50,12,45,Florida,Gulf County,12,17,408,173,235
50,12,45,Florida,Gulf County,12,18,353,163,190
50,12,47,Florida,Hamilton County,1,0,14799,8721,6078
50,12,47,Florida,Hamilton County,1,1,776,378,398
50,12,47,Florida,Hamilton County,1,2,781,419,362
50,12,47,Florida,Hamilton County,1,3,822,432,390
50,12,47,Florida,Hamilton County,1,4,971,578,393
50,12,47,Florida,Hamilton County,1,5,1519,1162,357
50,12,47,Florida,Hamilton County,1,6,1051,752,299
50,12,47,Florida,Hamilton County,1,7,911,614,297
50,12,47,Florida,Hamilton County,1,8,952,596,356
50,12,47,Florida,Hamilton County,1,9,962,590,372
50,12,47,Florida,Hamilton County,1,10,1050,644,406
50,12,47,Florida,Hamilton County,1,11,1128,668,460
50,12,47,Florida,Hamilton County,1,12,1009,530,479
50,12,47,Florida,Hamilton County,1,13,921,454,467
50,12,47,Florida,Hamilton County,1,14,705,367,338
50,12,47,Florida,Hamilton County,1,15,476,214,262
50,12,47,Florida,Hamilton County,1,16,361,179,182
50,12,47,Florida,Hamilton County,1,17,218,95,123
50,12,47,Florida,Hamilton County,1,18,186,49,137
50,12,47,Florida,Hamilton County,2,0,14799,8721,6078
50,12,47,Florida,Hamilton County,2,1,776,378,398
50,12,47,Florida,Hamilton County,2,2,781,419,362
50,12,47,Florida,Hamilton County,2,3,822,432,390
50,12,47,Florida,Hamilton County,2,4,971,578,393
50,12,47,Florida,Hamilton County,2,5,1519,1162,357
50,12,47,Florida,Hamilton County,2,6,1051,752,299
50,12,47,Florida,Hamilton County,2,7,911,614,297
50,12,47,Florida,Hamilton County,2,8,952,596,356
50,12,47,Florida,Hamilton County,2,9,962,590,372
50,12,47,Florida,Hamilton County,2,10,1050,644,406
50,12,47,Florida,Hamilton County,2,11,1128,668,460
50,12,47,Florida,Hamilton County,2,12,1009,530,479
50,12,47,Florida,Hamilton County,2,13,921,454,467
50,12,47,Florida,Hamilton County,2,14,705,367,338
50,12,47,Florida,Hamilton County,2,15,476,214,262
50,12,47,Florida,Hamilton County,2,16,361,179,182
50,12,47,Florida,Hamilton County,2,17,218,95,123
50,12,47,Florida,Hamilton County,2,18,186,49,137
50,12,47,Florida,Hamilton County,3,0,14683,8622,6061
50,12,47,Florida,Hamilton County,3,1,769,372,397
50,12,47,Florida,Hamilton County,3,2,765,406,359
50,12,47,Florida,Hamilton County,3,3,807,423,384
50,12,47,Florida,Hamilton County,3,4,958,570,388
50,12,47,Florida,Hamilton County,3,5,1509,1153,356
50,12,47,Florida,Hamilton County,3,6,1030,733,297
50,12,47,Florida,Hamilton County,3,7,904,603,301
50,12,47,Florida,Hamilton County,3,8,934,587,347
50,12,47,Florida,Hamilton County,3,9,947,579,368
50,12,47,Florida,Hamilton County,3,10,1040,635,405
50,12,47,Florida,Hamilton County,3,11,1114,662,452
50,12,47,Florida,Hamilton County,3,12,1014,530,484
50,12,47,Florida,Hamilton County,3,13,929,459,470
50,12,47,Florida,Hamilton County,3,14,707,365,342
50,12,47,Florida,Hamilton County,3,15,488,221,267
50,12,47,Florida,Hamilton County,3,16,359,177,182
50,12,47,Florida,Hamilton County,3,17,220,96,124
50,12,47,Florida,Hamilton County,3,18,189,51,138
50,12,47,Florida,Hamilton County,4,0,14595,8541,6054
50,12,47,Florida,Hamilton County,4,1,789,395,394
50,12,47,Florida,Hamilton County,4,2,756,383,373
50,12,47,Florida,Hamilton County,4,3,786,427,359
50,12,47,Florida,Hamilton County,4,4,923,543,380
50,12,47,Florida,Hamilton County,4,5,1506,1145,361
50,12,47,Florida,Hamilton County,4,6,1023,717,306
50,12,47,Florida,Hamilton County,4,7,889,580,309
50,12,47,Florida,Hamilton County,4,8,886,578,308
50,12,47,Florida,Hamilton County,4,9,935,570,365
50,12,47,Florida,Hamilton County,4,10,1021,618,403
50,12,47,Florida,Hamilton County,4,11,1075,639,436
50,12,47,Florida,Hamilton County,4,12,1025,533,492
50,12,47,Florida,Hamilton County,4,13,953,476,477
50,12,47,Florida,Hamilton County,4,14,713,355,358
50,12,47,Florida,Hamilton County,4,15,523,240,283
50,12,47,Florida,Hamilton County,4,16,368,187,181
50,12,47,Florida,Hamilton County,4,17,224,103,121
50,12,47,Florida,Hamilton County,4,18,200,52,148
50,12,47,Florida,Hamilton County,5,0,14721,8642,6079
50,12,47,Florida,Hamilton County,5,1,762,376,386
50,12,47,Florida,Hamilton County,5,2,739,363,376
50,12,47,Florida,Hamilton County,5,3,779,413,366
50,12,47,Florida,Hamilton County,5,4,895,545,350
50,12,47,Florida,Hamilton County,5,5,1546,1173,373
50,12,47,Florida,Hamilton County,5,6,1080,749,331
50,12,47,Florida,Hamilton County,5,7,902,625,277
50,12,47,Florida,Hamilton County,5,8,873,556,317
50,12,47,Florida,Hamilton County,5,9,951,573,378
50,12,47,Florida,Hamilton County,5,10,1010,629,381
50,12,47,Florida,Hamilton County,5,11,1060,627,433
50,12,47,Florida,Hamilton County,5,12,1045,550,495
50,12,47,Florida,Hamilton County,5,13,937,485,452
50,12,47,Florida,Hamilton County,5,14,786,382,404
50,12,47,Florida,Hamilton County,5,15,543,254,289
50,12,47,Florida,Hamilton County,5,16,358,174,184
50,12,47,Florida,Hamilton County,5,17,242,113,129
50,12,47,Florida,Hamilton County,5,18,213,55,158
50,12,47,Florida,Hamilton County,6,0,14342,8308,6034
50,12,47,Florida,Hamilton County,6,1,734,369,365
50,12,47,Florida,Hamilton County,6,2,727,365,362
50,12,47,Florida,Hamilton County,6,3,766,417,349
50,12,47,Florida,Hamilton County,6,4,822,487,335
50,12,47,Florida,Hamilton County,6,5,1459,1081,378
50,12,47,Florida,Hamilton County,6,6,1053,722,331
50,12,47,Florida,Hamilton County,6,7,848,573,275
50,12,47,Florida,Hamilton County,6,8,862,522,340
50,12,47,Florida,Hamilton County,6,9,914,554,360
50,12,47,Florida,Hamilton County,6,10,944,586,358
50,12,47,Florida,Hamilton County,6,11,1013,580,433
50,12,47,Florida,Hamilton County,6,12,1068,554,514
50,12,47,Florida,Hamilton County,6,13,913,486,427
50,12,47,Florida,Hamilton County,6,14,816,383,433
50,12,47,Florida,Hamilton County,6,15,561,278,283
50,12,47,Florida,Hamilton County,6,16,370,172,198
50,12,47,Florida,Hamilton County,6,17,255,127,128
50,12,47,Florida,Hamilton County,6,18,217,52,165
50,12,47,Florida,Hamilton County,7,0,14071,8057,6014
50,12,47,Florida,Hamilton County,7,1,741,394,347
50,12,47,Florida,Hamilton County,7,2,725,355,370
50,12,47,Florida,Hamilton County,7,3,782,419,363
50,12,47,Florida,Hamilton County,7,4,799,478,321
50,12,47,Florida,Hamilton County,7,5,1375,995,380
50,12,47,Florida,Hamilton County,7,6,1012,682,330
50,12,47,Florida,Hamilton County,7,7,811,542,269
50,12,47,Florida,Hamilton County,7,8,834,510,324
50,12,47,Florida,Hamilton County,7,9,886,517,369
50,12,47,Florida,Hamilton County,7,10,889,546,343
50,12,47,Florida,Hamilton County,7,11,955,542,413
50,12,47,Florida,Hamilton County,7,12,1064,551,513
50,12,47,Florida,Hamilton County,7,13,931,476,455
50,12,47,Florida,Hamilton County,7,14,843,404,439
50,12,47,Florida,Hamilton County,7,15,573,297,276
50,12,47,Florida,Hamilton County,7,16,361,155,206
50,12,47,Florida,Hamilton County,7,17,264,125,139
50,12,47,Florida,Hamilton County,7,18,226,69,157
50,12,47,Florida,Hamilton County,8,0,14272,8229,6043
50,12,47,Florida,Hamilton County,8,1,753,383,370
50,12,47,Florida,Hamilton County,8,2,744,373,371
50,12,47,Florida,Hamilton County,8,3,755,399,356
50,12,47,Florida,Hamilton County,8,4,848,495,353
50,12,47,Florida,Hamilton County,8,5,1375,1036,339
50,12,47,Florida,Hamilton County,8,6,1076,723,353
50,12,47,Florida,Hamilton County,8,7,838,569,269
50,12,47,Florida,Hamilton County,8,8,849,527,322
50,12,47,Florida,Hamilton County,8,9,874,517,357
50,12,47,Florida,Hamilton County,8,10,907,553,354
50,12,47,Florida,Hamilton County,8,11,949,546,403
50,12,47,Florida,Hamilton County,8,12,1045,563,482
50,12,47,Florida,Hamilton County,8,13,931,460,471
50,12,47,Florida,Hamilton County,8,14,858,420,438
50,12,47,Florida,Hamilton County,8,15,592,298,294
50,12,47,Florida,Hamilton County,8,16,375,163,212
50,12,47,Florida,Hamilton County,8,17,265,117,148
50,12,47,Florida,Hamilton County,8,18,238,87,151
50,12,47,Florida,Hamilton County,9,0,14303,8281,6022
50,12,47,Florida,Hamilton County,9,1,725,373,352
50,12,47,Florida,Hamilton County,9,2,786,396,390
50,12,47,Florida,Hamilton County,9,3,751,387,364
50,12,47,Florida,Hamilton County,9,4,807,486,321
50,12,47,Florida,Hamilton County,9,5,1361,1045,316
50,12,47,Florida,Hamilton County,9,6,1075,718,357
50,12,47,Florida,Hamilton County,9,7,872,586,286
50,12,47,Florida,Hamilton County,9,8,841,537,304
50,12,47,Florida,Hamilton County,9,9,855,513,342
50,12,47,Florida,Hamilton County,9,10,916,560,356
50,12,47,Florida,Hamilton County,9,11,962,551,411
50,12,47,Florida,Hamilton County,9,12,1014,556,458
50,12,47,Florida,Hamilton County,9,13,953,464,489
50,12,47,Florida,Hamilton County,9,14,860,418,442
50,12,47,Florida,Hamilton County,9,15,593,291,302
50,12,47,Florida,Hamilton County,9,16,421,188,233
50,12,47,Florida,Hamilton County,9,17,268,125,143
50,12,47,Florida,Hamilton County,9,18,243,87,156
50,12,47,Florida,Hamilton County,10,0,14364,8358,6006
50,12,47,Florida,Hamilton County,10,1,768,410,358
50,12,47,Florida,Hamilton County,10,2,758,382,376
50,12,47,Florida,Hamilton County,10,3,766,387,379
50,12,47,Florida,Hamilton County,10,4,814,491,323
50,12,47,Florida,Hamilton County,10,5,1296,1026,270
50,12,47,Florida,Hamilton County,10,6,1156,784,372
50,12,47,Florida,Hamilton County,10,7,895,581,314
50,12,47,Florida,Hamilton County,10,8,805,532,273
50,12,47,Florida,Hamilton County,10,9,820,501,319
50,12,47,Florida,Hamilton County,10,10,922,551,371
50,12,47,Florida,Hamilton County,10,11,968,570,398
50,12,47,Florida,Hamilton County,10,12,950,523,427
50,12,47,Florida,Hamilton County,10,13,951,457,494
50,12,47,Florida,Hamilton County,10,14,838,421,417
50,12,47,Florida,Hamilton County,10,15,688,330,358
50,12,47,Florida,Hamilton County,10,16,420,195,225
50,12,47,Florida,Hamilton County,10,17,281,121,160
50,12,47,Florida,Hamilton County,10,18,268,96,172
50,12,47,Florida,Hamilton County,11,0,14262,8259,6003
50,12,47,Florida,Hamilton County,11,1,785,414,371
50,12,47,Florida,Hamilton County,11,2,702,344,358
50,12,47,Florida,Hamilton County,11,3,755,391,364
50,12,47,Florida,Hamilton County,11,4,795,478,317
50,12,47,Florida,Hamilton County,11,5,1274,1001,273
50,12,47,Florida,Hamilton County,11,6,1119,756,363
50,12,47,Florida,Hamilton County,11,7,880,576,304
50,12,47,Florida,Hamilton County,11,8,803,526,277
50,12,47,Florida,Hamilton County,11,9,840,500,340
50,12,47,Florida,Hamilton County,11,10,891,535,356
50,12,47,Florida,Hamilton County,11,11,935,555,380
50,12,47,Florida,Hamilton County,11,12,938,520,418
50,12,47,Florida,Hamilton County,11,13,969,475,494
50,12,47,Florida,Hamilton County,11,14,830,420,410
50,12,47,Florida,Hamilton County,11,15,743,342,401
50,12,47,Florida,Hamilton County,11,16,445,211,234
50,12,47,Florida,Hamilton County,11,17,272,106,166
50,12,47,Florida,Hamilton County,11,18,286,109,177
50,12,47,Florida,Hamilton County,12,0,14428,8347,6081
50,12,47,Florida,Hamilton County,12,1,786,404,382
50,12,47,Florida,Hamilton County,12,2,715,350,365
50,12,47,Florida,Hamilton County,12,3,772,389,383
50,12,47,Florida,Hamilton County,12,4,796,484,312
50,12,47,Florida,Hamilton County,12,5,1289,1023,266
50,12,47,Florida,Hamilton County,12,6,1112,749,363
50,12,47,Florida,Hamilton County,12,7,905,591,314
50,12,47,Florida,Hamilton County,12,8,809,516,293
50,12,47,Florida,Hamilton County,12,9,827,506,321
50,12,47,Florida,Hamilton County,12,10,903,542,361
50,12,47,Florida,Hamilton County,12,11,938,566,372
50,12,47,Florida,Hamilton County,12,12,931,521,410
50,12,47,Florida,Hamilton County,12,13,981,489,492
50,12,47,Florida,Hamilton County,12,14,847,421,426
50,12,47,Florida,Hamilton County,12,15,767,351,416
50,12,47,Florida,Hamilton County,12,16,450,224,226
50,12,47,Florida,Hamilton County,12,17,295,111,184
50,12,47,Florida,Hamilton County,12,18,305,110,195
50,12,49,Florida,Hardee County,1,0,27731,14868,12863
50,12,49,Florida,Hardee County,1,1,2227,1152,1075
50,12,49,Florida,Hardee County,1,2,2173,1076,1097
50,12,49,Florida,Hardee County,1,3,2041,1059,982
50,12,49,Florida,Hardee County,1,4,2178,1256,922
50,12,49,Florida,Hardee County,1,5,2202,1343,859
50,12,49,Florida,Hardee County,1,6,2106,1262,844
50,12,49,Florida,Hardee County,1,7,1664,880,784
50,12,49,Florida,Hardee County,1,8,1775,985,790
50,12,49,Florida,Hardee County,1,9,1687,948,739
50,12,49,Florida,Hardee County,1,10,1757,894,863
50,12,49,Florida,Hardee County,1,11,1597,870,727
50,12,49,Florida,Hardee County,1,12,1462,781,681
50,12,49,Florida,Hardee County,1,13,1287,660,627
50,12,49,Florida,Hardee County,1,14,1152,570,582
50,12,49,Florida,Hardee County,1,15,919,457,462
50,12,49,Florida,Hardee County,1,16,639,303,336
50,12,49,Florida,Hardee County,1,17,479,232,247
50,12,49,Florida,Hardee County,1,18,386,140,246
50,12,49,Florida,Hardee County,2,0,27737,14873,12864
50,12,49,Florida,Hardee County,2,1,2228,1153,1075
50,12,49,Florida,Hardee County,2,2,2173,1076,1097
50,12,49,Florida,Hardee County,2,3,2044,1062,982
50,12,49,Florida,Hardee County,2,4,2178,1256,922
50,12,49,Florida,Hardee County,2,5,2202,1343,859
50,12,49,Florida,Hardee County,2,6,2107,1262,845
50,12,49,Florida,Hardee County,2,7,1664,880,784
50,12,49,Florida,Hardee County,2,8,1776,986,790
50,12,49,Florida,Hardee County,2,9,1687,948,739
50,12,49,Florida,Hardee County,2,10,1757,894,863
50,12,49,Florida,Hardee County,2,11,1597,870,727
50,12,49,Florida,Hardee County,2,12,1462,781,681
50,12,49,Florida,Hardee County,2,13,1287,660,627
50,12,49,Florida,Hardee County,2,14,1152,570,582
50,12,49,Florida,Hardee County,2,15,919,457,462
50,12,49,Florida,Hardee County,2,16,639,303,336
50,12,49,Florida,Hardee County,2,17,479,232,247
50,12,49,Florida,Hardee County,2,18,386,140,246
50,12,49,Florida,Hardee County,3,0,27730,14882,12848
50,12,49,Florida,Hardee County,3,1,2212,1148,1064
50,12,49,Florida,Hardee County,3,2,2161,1071,1090
50,12,49,Florida,Hardee County,3,3,2063,1069,994
50,12,49,Florida,Hardee County,3,4,2149,1240,909
50,12,49,Florida,Hardee County,3,5,2202,1338,864
50,12,49,Florida,Hardee County,3,6,2118,1271,847
50,12,49,Florida,Hardee County,3,7,1668,883,785
50,12,49,Florida,Hardee County,3,8,1776,985,791
50,12,49,Florida,Hardee County,3,9,1673,945,728
50,12,49,Florida,Hardee County,3,10,1760,899,861
50,12,49,Florida,Hardee County,3,11,1605,877,728
50,12,49,Florida,Hardee County,3,12,1471,785,686
50,12,49,Florida,Hardee County,3,13,1291,659,632
50,12,49,Florida,Hardee County,3,14,1151,572,579
50,12,49,Florida,Hardee County,3,15,915,455,460
50,12,49,Florida,Hardee County,3,16,647,313,334
50,12,49,Florida,Hardee County,3,17,478,227,251
50,12,49,Florida,Hardee County,3,18,390,145,245
50,12,49,Florida,Hardee County,4,0,27684,14839,12845
50,12,49,Florida,Hardee County,4,1,2149,1128,1021
50,12,49,Florida,Hardee County,4,2,2115,1063,1052
50,12,49,Florida,Hardee County,4,3,2118,1089,1029
50,12,49,Florida,Hardee County,4,4,2060,1190,870
50,12,49,Florida,Hardee County,4,5,2213,1312,901
50,12,49,Florida,Hardee County,4,6,2145,1287,858
50,12,49,Florida,Hardee County,4,7,1637,864,773
50,12,49,Florida,Hardee County,4,8,1745,970,775
50,12,49,Florida,Hardee County,4,9,1645,942,703
50,12,49,Florida,Hardee County,4,10,1747,886,861
50,12,49,Florida,Hardee County,4,11,1646,896,750
50,12,49,Florida,Hardee County,4,12,1491,796,695
50,12,49,Florida,Hardee County,4,13,1302,659,643
50,12,49,Florida,Hardee County,4,14,1169,581,588
50,12,49,Florida,Hardee County,4,15,918,457,461
50,12,49,Florida,Hardee County,4,16,692,336,356
50,12,49,Florida,Hardee County,4,17,472,216,256
50,12,49,Florida,Hardee County,4,18,420,167,253
50,12,49,Florida,Hardee County,5,0,27439,14691,12748
50,12,49,Florida,Hardee County,5,1,2040,1072,968
50,12,49,Florida,Hardee County,5,2,2148,1086,1062
50,12,49,Florida,Hardee County,5,3,2094,1088,1006
50,12,49,Florida,Hardee County,5,4,2032,1165,867
50,12,49,Florida,Hardee County,5,5,2188,1283,905
50,12,49,Florida,Hardee County,5,6,2118,1280,838
50,12,49,Florida,Hardee County,5,7,1610,851,759
50,12,49,Florida,Hardee County,5,8,1683,934,749
50,12,49,Florida,Hardee County,5,9,1655,943,712
50,12,49,Florida,Hardee County,5,10,1680,865,815
50,12,49,Florida,Hardee County,5,11,1644,902,742
50,12,49,Florida,Hardee County,5,12,1495,788,707
50,12,49,Florida,Hardee County,5,13,1286,657,629
50,12,49,Florida,Hardee County,5,14,1187,576,611
50,12,49,Florida,Hardee County,5,15,941,479,462
50,12,49,Florida,Hardee County,5,16,715,335,380
50,12,49,Florida,Hardee County,5,17,480,208,272
50,12,49,Florida,Hardee County,5,18,443,179,264
50,12,49,Florida,Hardee County,6,0,27311,14567,12744
50,12,49,Florida,Hardee County,6,1,2024,1051,973
50,12,49,Florida,Hardee County,6,2,2100,1070,1030
50,12,49,Florida,Hardee County,6,3,2044,1058,986
50,12,49,Florida,Hardee County,6,4,2038,1149,889
50,12,49,Florida,Hardee County,6,5,2147,1253,894
50,12,49,Florida,Hardee County,6,6,2070,1270,800
50,12,49,Florida,Hardee County,6,7,1619,856,763
50,12,49,Florida,Hardee County,6,8,1626,891,735
50,12,49,Florida,Hardee County,6,9,1659,932,727
50,12,49,Florida,Hardee County,6,10,1674,873,801
50,12,49,Florida,Hardee County,6,11,1637,893,744
50,12,49,Florida,Hardee County,6,12,1469,757,712
50,12,49,Florida,Hardee County,6,13,1298,667,631
50,12,49,Florida,Hardee County,6,14,1221,602,619
50,12,49,Florida,Hardee County,6,15,962,480,482
50,12,49,Florida,Hardee County,6,16,766,361,405
50,12,49,Florida,Hardee County,6,17,469,199,270
50,12,49,Florida,Hardee County,6,18,488,205,283
50,12,49,Florida,Hardee County,7,0,27266,14579,12687
50,12,49,Florida,Hardee County,7,1,2004,1049,955
50,12,49,Florida,Hardee County,7,2,2076,1088,988
50,12,49,Florida,Hardee County,7,3,2001,1018,983
50,12,49,Florida,Hardee County,7,4,2008,1117,891
50,12,49,Florida,Hardee County,7,5,2143,1266,877
50,12,49,Florida,Hardee County,7,6,2059,1254,805
50,12,49,Florida,Hardee County,7,7,1622,880,742
50,12,49,Florida,Hardee County,7,8,1585,865,720
50,12,49,Florida,Hardee County,7,9,1701,933,768
50,12,49,Florida,Hardee County,7,10,1632,864,768
50,12,49,Florida,Hardee County,7,11,1660,910,750
50,12,49,Florida,Hardee County,7,12,1479,758,721
50,12,49,Florida,Hardee County,7,13,1283,655,628
50,12,49,Florida,Hardee County,7,14,1250,625,625
50,12,49,Florida,Hardee County,7,15,987,480,507
50,12,49,Florida,Hardee County,7,16,777,386,391
50,12,49,Florida,Hardee County,7,17,484,215,269
50,12,49,Florida,Hardee County,7,18,515,216,299
50,12,49,Florida,Hardee County,8,0,27177,14444,12733
50,12,49,Florida,Hardee County,8,1,1982,1030,952
50,12,49,Florida,Hardee County,8,2,2029,1048,981
50,12,49,Florida,Hardee County,8,3,2000,1028,972
50,12,49,Florida,Hardee County,8,4,1991,1085,906
50,12,49,Florida,Hardee County,8,5,2098,1246,852
50,12,49,Florida,Hardee County,8,6,2037,1230,807
50,12,49,Florida,Hardee County,8,7,1629,898,731
50,12,49,Florida,Hardee County,8,8,1541,829,712
50,12,49,Florida,Hardee County,8,9,1665,890,775
50,12,49,Florida,Hardee County,8,10,1630,870,760
50,12,49,Florida,Hardee County,8,11,1641,884,757
50,12,49,Florida,Hardee County,8,12,1509,772,737
50,12,49,Florida,Hardee County,8,13,1315,663,652
50,12,49,Florida,Hardee County,8,14,1280,648,632
50,12,49,Florida,Hardee County,8,15,1035,499,536
50,12,49,Florida,Hardee County,8,16,780,382,398
50,12,49,Florida,Hardee County,8,17,514,233,281
50,12,49,Florida,Hardee County,8,18,501,209,292
50,12,49,Florida,Hardee County,9,0,27219,14485,12734
50,12,49,Florida,Hardee County,9,1,1964,1042,922
50,12,49,Florida,Hardee County,9,2,2020,1045,975
50,12,49,Florida,Hardee County,9,3,1963,1017,946
50,12,49,Florida,Hardee County,9,4,2001,1069,932
50,12,49,Florida,Hardee County,9,5,2035,1215,820
50,12,49,Florida,Hardee County,9,6,2049,1232,817
50,12,49,Florida,Hardee County,9,7,1637,902,735
50,12,49,Florida,Hardee County,9,8,1502,823,679
50,12,49,Florida,Hardee County,9,9,1664,899,765
50,12,49,Florida,Hardee County,9,10,1667,892,775
50,12,49,Florida,Hardee County,9,11,1635,866,769
50,12,49,Florida,Hardee County,9,12,1533,790,743
50,12,49,Florida,Hardee County,9,13,1345,671,674
50,12,49,Florida,Hardee County,9,14,1298,659,639
50,12,49,Florida,Hardee County,9,15,1028,490,538
50,12,49,Florida,Hardee County,9,16,806,403,403
50,12,49,Florida,Hardee County,9,17,569,261,308
50,12,49,Florida,Hardee County,9,18,503,209,294
50,12,49,Florida,Hardee County,10,0,27154,14366,12788
50,12,49,Florida,Hardee County,10,1,1908,1023,885
50,12,49,Florida,Hardee County,10,2,2019,1039,980
50,12,49,Florida,Hardee County,10,3,2059,1058,1001
50,12,49,Florida,Hardee County,10,4,1973,1061,912
50,12,49,Florida,Hardee County,10,5,1920,1138,782
50,12,49,Florida,Hardee County,10,6,2051,1203,848
50,12,49,Florida,Hardee County,10,7,1636,917,719
50,12,49,Florida,Hardee County,10,8,1509,815,694
50,12,49,Florida,Hardee County,10,9,1587,835,752
50,12,49,Florida,Hardee County,10,10,1632,871,761
50,12,49,Florida,Hardee County,10,11,1625,856,769
50,12,49,Florida,Hardee County,10,12,1525,794,731
50,12,49,Florida,Hardee County,10,13,1353,661,692
50,12,49,Florida,Hardee County,10,14,1311,669,642
50,12,49,Florida,Hardee County,10,15,1068,500,568
50,12,49,Florida,Hardee County,10,16,860,432,428
50,12,49,Florida,Hardee County,10,17,604,275,329
50,12,49,Florida,Hardee County,10,18,514,219,295
50,12,49,Florida,Hardee County,11,0,27168,14355,12813
50,12,49,Florida,Hardee County,11,1,1862,960,902
50,12,49,Florida,Hardee County,11,2,1980,1043,937
50,12,49,Florida,Hardee County,11,3,2069,1058,1011
50,12,49,Florida,Hardee County,11,4,1935,1052,883
50,12,49,Florida,Hardee County,11,5,1935,1156,779
50,12,49,Florida,Hardee County,11,6,2034,1160,874
50,12,49,Florida,Hardee County,11,7,1649,938,711
50,12,49,Florida,Hardee County,11,8,1510,822,688
50,12,49,Florida,Hardee County,11,9,1547,789,758
50,12,49,Florida,Hardee County,11,10,1665,890,775
50,12,49,Florida,Hardee County,11,11,1603,877,726
50,12,49,Florida,Hardee County,11,12,1513,791,722
50,12,49,Florida,Hardee County,11,13,1333,629,704
50,12,49,Florida,Hardee County,11,14,1365,696,669
50,12,49,Florida,Hardee County,11,15,1135,536,599
50,12,49,Florida,Hardee County,11,16,854,421,433
50,12,49,Florida,Hardee County,11,17,641,302,339
50,12,49,Florida,Hardee County,11,18,538,235,303
50,12,49,Florida,Hardee County,12,0,26937,14232,12705
50,12,49,Florida,Hardee County,12,1,1813,943,870
50,12,49,Florida,Hardee County,12,2,1942,1009,933
50,12,49,Florida,Hardee County,12,3,1988,1044,944
50,12,49,Florida,Hardee County,12,4,1891,1005,886
50,12,49,Florida,Hardee County,12,5,1909,1122,787
50,12,49,Florida,Hardee County,12,6,1998,1156,842
50,12,49,Florida,Hardee County,12,7,1611,899,712
50,12,49,Florida,Hardee County,12,8,1516,850,666
50,12,49,Florida,Hardee County,12,9,1474,763,711
50,12,49,Florida,Hardee County,12,10,1679,859,820
50,12,49,Florida,Hardee County,12,11,1559,881,678
50,12,49,Florida,Hardee County,12,12,1551,798,753
50,12,49,Florida,Hardee County,12,13,1311,623,688
50,12,49,Florida,Hardee County,12,14,1366,694,672
50,12,49,Florida,Hardee County,12,15,1189,574,615
50,12,49,Florida,Hardee County,12,16,905,432,473
50,12,49,Florida,Hardee County,12,17,646,313,333
50,12,49,Florida,Hardee County,12,18,589,267,322
50,12,51,Florida,Hendry County,1,0,39140,21198,17942
50,12,51,Florida,Hendry County,1,1,3131,1618,1513
50,12,51,Florida,Hendry County,1,2,2965,1522,1443
50,12,51,Florida,Hendry County,1,3,2863,1480,1383
50,12,51,Florida,Hendry County,1,4,3188,1672,1516
50,12,51,Florida,Hendry County,1,5,3004,1770,1234
50,12,51,Florida,Hendry County,1,6,2913,1770,1143
50,12,51,Florida,Hendry County,1,7,2663,1580,1083
50,12,51,Florida,Hendry County,1,8,2695,1481,1214
50,12,51,Florida,Hendry County,1,9,2571,1413,1158
50,12,51,Florida,Hendry County,1,10,2610,1429,1181
50,12,51,Florida,Hendry County,1,11,2398,1309,1089
50,12,51,Florida,Hendry County,1,12,1902,988,914
50,12,51,Florida,Hendry County,1,13,1746,877,869
50,12,51,Florida,Hendry County,1,14,1459,757,702
50,12,51,Florida,Hendry County,1,15,1149,612,537
50,12,51,Florida,Hendry County,1,16,832,428,404
50,12,51,Florida,Hendry County,1,17,577,291,286
50,12,51,Florida,Hendry County,1,18,474,201,273
50,12,51,Florida,Hendry County,2,0,39143,21200,17943
50,12,51,Florida,Hendry County,2,1,3131,1618,1513
50,12,51,Florida,Hendry County,2,2,2965,1522,1443
50,12,51,Florida,Hendry County,2,3,2863,1480,1383
50,12,51,Florida,Hendry County,2,4,3188,1672,1516
50,12,51,Florida,Hendry County,2,5,3004,1770,1234
50,12,51,Florida,Hendry County,2,6,2913,1770,1143
50,12,51,Florida,Hendry County,2,7,2663,1580,1083
50,12,51,Florida,Hendry County,2,8,2695,1481,1214
50,12,51,Florida,Hendry County,2,9,2571,1413,1158
50,12,51,Florida,Hendry County,2,10,2611,1430,1181
50,12,51,Florida,Hendry County,2,11,2398,1309,1089
50,12,51,Florida,Hendry County,2,12,1902,988,914
50,12,51,Florida,Hendry County,2,13,1746,877,869
50,12,51,Florida,Hendry County,2,14,1459,757,702
50,12,51,Florida,Hendry County,2,15,1150,612,538
50,12,51,Florida,Hendry County,2,16,833,429,404
50,12,51,Florida,Hendry County,2,17,577,291,286
50,12,51,Florida,Hendry County,2,18,474,201,273
50,12,51,Florida,Hendry County,3,0,39009,21059,17950
50,12,51,Florida,Hendry County,3,1,3112,1602,1510
50,12,51,Florida,Hendry County,3,2,2972,1529,1443
50,12,51,Florida,Hendry County,3,3,2888,1488,1400
50,12,51,Florida,Hendry County,3,4,3116,1629,1487
50,12,51,Florida,Hendry County,3,5,3007,1759,1248
50,12,51,Florida,Hendry County,3,6,2896,1761,1135
50,12,51,Florida,Hendry County,3,7,2649,1560,1089
50,12,51,Florida,Hendry County,3,8,2656,1461,1195
50,12,51,Florida,Hendry County,3,9,2559,1402,1157
50,12,51,Florida,Hendry County,3,10,2606,1414,1192
50,12,51,Florida,Hendry County,3,11,2377,1289,1088
50,12,51,Florida,Hendry County,3,12,1931,1005,926
50,12,51,Florida,Hendry County,3,13,1741,872,869
50,12,51,Florida,Hendry County,3,14,1464,760,704
50,12,51,Florida,Hendry County,3,15,1150,610,540
50,12,51,Florida,Hendry County,3,16,829,425,404
50,12,51,Florida,Hendry County,3,17,575,286,289
50,12,51,Florida,Hendry County,3,18,481,207,274
50,12,51,Florida,Hendry County,4,0,38972,20948,18024
50,12,51,Florida,Hendry County,4,1,3072,1586,1486
50,12,51,Florida,Hendry County,4,2,2971,1528,1443
50,12,51,Florida,Hendry County,4,3,2940,1499,1441
50,12,51,Florida,Hendry County,4,4,2921,1524,1397
50,12,51,Florida,Hendry County,4,5,3114,1801,1313
50,12,51,Florida,Hendry County,4,6,2891,1757,1134
50,12,51,Florida,Hendry County,4,7,2628,1543,1085
50,12,51,Florida,Hendry County,4,8,2569,1443,1126
50,12,51,Florida,Hendry County,4,9,2542,1381,1161
50,12,51,Florida,Hendry County,4,10,2633,1396,1237
50,12,51,Florida,Hendry County,4,11,2345,1261,1084
50,12,51,Florida,Hendry County,4,12,2044,1065,979
50,12,51,Florida,Hendry County,4,13,1737,869,868
50,12,51,Florida,Hendry County,4,14,1487,762,725
50,12,51,Florida,Hendry County,4,15,1176,611,565
50,12,51,Florida,Hendry County,4,16,842,436,406
50,12,51,Florida,Hendry County,4,17,584,288,296
50,12,51,Florida,Hendry County,4,18,476,198,278
50,12,51,Florida,Hendry County,5,0,37870,20040,17830
50,12,51,Florida,Hendry County,5,1,3077,1595,1482
50,12,51,Florida,Hendry County,5,2,2960,1517,1443
50,12,51,Florida,Hendry County,5,3,2926,1522,1404
50,12,51,Florida,Hendry County,5,4,2686,1428,1258
50,12,51,Florida,Hendry County,5,5,2871,1621,1250
50,12,51,Florida,Hendry County,5,6,2689,1562,1127
50,12,51,Florida,Hendry County,5,7,2482,1378,1104
50,12,51,Florida,Hendry County,5,8,2380,1276,1104
50,12,51,Florida,Hendry County,5,9,2526,1363,1163
50,12,51,Florida,Hendry County,5,10,2515,1312,1203
50,12,51,Florida,Hendry County,5,11,2277,1195,1082
50,12,51,Florida,Hendry County,5,12,2092,1080,1012
50,12,51,Florida,Hendry County,5,13,1673,836,837
50,12,51,Florida,Hendry County,5,14,1540,768,772
50,12,51,Florida,Hendry County,5,15,1202,630,572
50,12,51,Florida,Hendry County,5,16,849,448,401
50,12,51,Florida,Hendry County,5,17,617,291,326
50,12,51,Florida,Hendry County,5,18,508,218,290
50,12,51,Florida,Hendry County,6,0,37809,19856,17953
50,12,51,Florida,Hendry County,6,1,2998,1589,1409
50,12,51,Florida,Hendry County,6,2,3008,1543,1465
50,12,51,Florida,Hendry County,6,3,2866,1500,1366
50,12,51,Florida,Hendry County,6,4,2693,1428,1265
50,12,51,Florida,Hendry County,6,5,2816,1540,1276
50,12,51,Florida,Hendry County,6,6,2713,1545,1168
50,12,51,Florida,Hendry County,6,7,2501,1353,1148
50,12,51,Florida,Hendry County,6,8,2283,1203,1080
50,12,51,Florida,Hendry County,6,9,2458,1313,1145
50,12,51,Florida,Hendry County,6,10,2491,1258,1233
50,12,51,Florida,Hendry County,6,11,2284,1204,1080
50,12,51,Florida,Hendry County,6,12,2163,1099,1064
50,12,51,Florida,Hendry County,6,13,1676,848,828
50,12,51,Florida,Hendry County,6,14,1569,790,779
50,12,51,Florida,Hendry County,6,15,1224,625,599
50,12,51,Florida,Hendry County,6,16,882,478,404
50,12,51,Florida,Hendry County,6,17,637,298,339
50,12,51,Florida,Hendry County,6,18,547,242,305
50,12,51,Florida,Hendry County,7,0,38474,20140,18334
50,12,51,Florida,Hendry County,7,1,2984,1587,1397
50,12,51,Florida,Hendry County,7,2,3089,1599,1490
50,12,51,Florida,Hendry County,7,3,2879,1493,1386
50,12,51,Florida,Hendry County,7,4,2686,1440,1246
50,12,51,Florida,Hendry County,7,5,2782,1508,1274
50,12,51,Florida,Hendry County,7,6,2803,1521,1282
50,12,51,Florida,Hendry County,7,7,2627,1438,1189
50,12,51,Florida,Hendry County,7,8,2347,1251,1096
50,12,51,Florida,Hendry County,7,9,2505,1335,1170
50,12,51,Florida,Hendry County,7,10,2409,1206,1203
50,12,51,Florida,Hendry County,7,11,2414,1274,1140
50,12,51,Florida,Hendry County,7,12,2258,1135,1123
50,12,51,Florida,Hendry County,7,13,1714,860,854
50,12,51,Florida,Hendry County,7,14,1569,782,787
50,12,51,Florida,Hendry County,7,15,1284,656,628
50,12,51,Florida,Hendry County,7,16,927,497,430
50,12,51,Florida,Hendry County,7,17,614,295,319
50,12,51,Florida,Hendry County,7,18,583,263,320
50,12,51,Florida,Hendry County,8,0,39248,20609,18639
50,12,51,Florida,Hendry County,8,1,2972,1586,1386
50,12,51,Florida,Hendry County,8,2,3095,1575,1520
50,12,51,Florida,Hendry County,8,3,2898,1512,1386
50,12,51,Florida,Hendry County,8,4,2760,1466,1294
50,12,51,Florida,Hendry County,8,5,2799,1542,1257
50,12,51,Florida,Hendry County,8,6,2871,1548,1323
50,12,51,Florida,Hendry County,8,7,2692,1499,1193
50,12,51,Florida,Hendry County,8,8,2430,1325,1105
50,12,51,Florida,Hendry County,8,9,2522,1317,1205
50,12,51,Florida,Hendry County,8,10,2423,1219,1204
50,12,51,Florida,Hendry County,8,11,2526,1349,1177
50,12,51,Florida,Hendry County,8,12,2287,1159,1128
50,12,51,Florida,Hendry County,8,13,1836,924,912
50,12,51,Florida,Hendry County,8,14,1604,813,791
50,12,51,Florida,Hendry County,8,15,1338,689,649
50,12,51,Florida,Hendry County,8,16,935,486,449
50,12,51,Florida,Hendry County,8,17,651,318,333
50,12,51,Florida,Hendry County,8,18,609,282,327
50,12,51,Florida,Hendry County,9,0,40037,21085,18952
50,12,51,Florida,Hendry County,9,1,3019,1606,1413
50,12,51,Florida,Hendry County,9,2,3081,1601,1480
50,12,51,Florida,Hendry County,9,3,2917,1490,1427
50,12,51,Florida,Hendry County,9,4,2827,1498,1329
50,12,51,Florida,Hendry County,9,5,2697,1517,1180
50,12,51,Florida,Hendry County,9,6,3064,1660,1404
50,12,51,Florida,Hendry County,9,7,2712,1540,1172
50,12,51,Florida,Hendry County,9,8,2489,1341,1148
50,12,51,Florida,Hendry County,9,9,2494,1311,1183
50,12,51,Florida,Hendry County,9,10,2519,1325,1194
50,12,51,Florida,Hendry County,9,11,2632,1392,1240
50,12,51,Florida,Hendry County,9,12,2307,1168,1139
50,12,51,Florida,Hendry County,9,13,1999,996,1003
50,12,51,Florida,Hendry County,9,14,1605,831,774
50,12,51,Florida,Hendry County,9,15,1390,702,688
50,12,51,Florida,Hendry County,9,16,972,481,491
50,12,51,Florida,Hendry County,9,17,675,338,337
50,12,51,Florida,Hendry County,9,18,638,288,350
50,12,51,Florida,Hendry County,10,0,41018,21619,19399
50,12,51,Florida,Hendry County,10,1,3104,1672,1432
50,12,51,Florida,Hendry County,10,2,3077,1598,1479
50,12,51,Florida,Hendry County,10,3,3091,1545,1546
50,12,51,Florida,Hendry County,10,4,2869,1535,1334
50,12,51,Florida,Hendry County,10,5,2698,1530,1168
50,12,51,Florida,Hendry County,10,6,3091,1658,1433
50,12,51,Florida,Hendry County,10,7,2785,1605,1180
50,12,51,Florida,Hendry County,10,8,2623,1393,1230
50,12,51,Florida,Hendry County,10,9,2490,1319,1171
50,12,51,Florida,Hendry County,10,10,2580,1369,1211
50,12,51,Florida,Hendry County,10,11,2707,1454,1253
50,12,51,Florida,Hendry County,10,12,2371,1186,1185
50,12,51,Florida,Hendry County,10,13,2075,1038,1037
50,12,51,Florida,Hendry County,10,14,1598,816,782
50,12,51,Florida,Hendry County,10,15,1483,756,727
50,12,51,Florida,Hendry County,10,16,1036,505,531
50,12,51,Florida,Hendry County,10,17,657,341,316
50,12,51,Florida,Hendry County,10,18,683,299,384
50,12,51,Florida,Hendry County,11,0,41336,21852,19484
50,12,51,Florida,Hendry County,11,1,3046,1610,1436
50,12,51,Florida,Hendry County,11,2,3124,1683,1441
50,12,51,Florida,Hendry County,11,3,3191,1614,1577
50,12,51,Florida,Hendry County,11,4,2806,1500,1306
50,12,51,Florida,Hendry County,11,5,2714,1552,1162
50,12,51,Florida,Hendry County,11,6,3075,1681,1394
50,12,51,Florida,Hendry County,11,7,2798,1551,1247
50,12,51,Florida,Hendry County,11,8,2633,1403,1230
50,12,51,Florida,Hendry County,11,9,2493,1363,1130
50,12,51,Florida,Hendry County,11,10,2559,1331,1228
50,12,51,Florida,Hendry County,11,11,2729,1464,1265
50,12,51,Florida,Hendry County,11,12,2399,1223,1176
50,12,51,Florida,Hendry County,11,13,2151,1065,1086
50,12,51,Florida,Hendry County,11,14,1616,827,789
50,12,51,Florida,Hendry County,11,15,1524,798,726
50,12,51,Florida,Hendry County,11,16,1104,522,582
50,12,51,Florida,Hendry County,11,17,660,349,311
50,12,51,Florida,Hendry County,11,18,714,316,398
50,12,51,Florida,Hendry County,12,0,42022,22255,19767
50,12,51,Florida,Hendry County,12,1,3053,1633,1420
50,12,51,Florida,Hendry County,12,2,3135,1682,1453
50,12,51,Florida,Hendry County,12,3,3269,1620,1649
50,12,51,Florida,Hendry County,12,4,2867,1518,1349
50,12,51,Florida,Hendry County,12,5,2699,1553,1146
50,12,51,Florida,Hendry County,12,6,3072,1727,1345
50,12,51,Florida,Hendry County,12,7,2857,1561,1296
50,12,51,Florida,Hendry County,12,8,2773,1512,1261
50,12,51,Florida,Hendry County,12,9,2516,1371,1145
50,12,51,Florida,Hendry County,12,10,2570,1344,1226
50,12,51,Florida,Hendry County,12,11,2700,1450,1250
50,12,51,Florida,Hendry County,12,12,2544,1325,1219
50,12,51,Florida,Hendry County,12,13,2188,1063,1125
50,12,51,Florida,Hendry County,12,14,1668,849,819
50,12,51,Florida,Hendry County,12,15,1543,802,741
50,12,51,Florida,Hendry County,12,16,1155,564,591
50,12,51,Florida,Hendry County,12,17,687,353,334
50,12,51,Florida,Hendry County,12,18,726,328,398
50,12,53,Florida,Hernando County,1,0,172778,82534,90244
50,12,53,Florida,Hernando County,1,1,8504,4317,4187
50,12,53,Florida,Hernando County,1,2,9240,4530,4710
50,12,53,Florida,Hernando County,1,3,10095,5142,4953
50,12,53,Florida,Hernando County,1,4,9957,5060,4897
50,12,53,Florida,Hernando County,1,5,7823,3877,3946
50,12,53,Florida,Hernando County,1,6,7581,3707,3874
50,12,53,Florida,Hernando County,1,7,7778,3707,4071
50,12,53,Florida,Hernando County,1,8,8914,4199,4715
50,12,53,Florida,Hernando County,1,9,10179,4896,5283
50,12,53,Florida,Hernando County,1,10,11772,5641,6131
50,12,53,Florida,Hernando County,1,11,11941,5638,6303
50,12,53,Florida,Hernando County,1,12,11520,5261,6259
50,12,53,Florida,Hernando County,1,13,12951,5985,6966
50,12,53,Florida,Hernando County,1,14,12680,5977,6703
50,12,53,Florida,Hernando County,1,15,10553,5082,5471
50,12,53,Florida,Hernando County,1,16,8836,4217,4619
50,12,53,Florida,Hernando County,1,17,6944,3089,3855
50,12,53,Florida,Hernando County,1,18,5510,2209,3301
50,12,53,Florida,Hernando County,2,0,172778,82535,90243
50,12,53,Florida,Hernando County,2,1,8504,4317,4187
50,12,53,Florida,Hernando County,2,2,9240,4530,4710
50,12,53,Florida,Hernando County,2,3,10095,5142,4953
50,12,53,Florida,Hernando County,2,4,9957,5060,4897
50,12,53,Florida,Hernando County,2,5,7823,3877,3946
50,12,53,Florida,Hernando County,2,6,7581,3707,3874
50,12,53,Florida,Hernando County,2,7,7778,3707,4071
50,12,53,Florida,Hernando County,2,8,8914,4199,4715
50,12,53,Florida,Hernando County,2,9,10179,4896,5283
50,12,53,Florida,Hernando County,2,10,11772,5641,6131
50,12,53,Florida,Hernando County,2,11,11941,5638,6303
50,12,53,Florida,Hernando County,2,12,11519,5261,6258
50,12,53,Florida,Hernando County,2,13,12951,5985,6966
50,12,53,Florida,Hernando County,2,14,12679,5977,6702
50,12,53,Florida,Hernando County,2,15,10555,5083,5472
50,12,53,Florida,Hernando County,2,16,8836,4216,4620
50,12,53,Florida,Hernando County,2,17,6944,3090,3854
50,12,53,Florida,Hernando County,2,18,5510,2209,3301
50,12,53,Florida,Hernando County,3,0,172969,82652,90317
50,12,53,Florida,Hernando County,3,1,8437,4288,4149
50,12,53,Florida,Hernando County,3,2,9216,4519,4697
50,12,53,Florida,Hernando County,3,3,10098,5134,4964
50,12,53,Florida,Hernando County,3,4,9903,5058,4845
50,12,53,Florida,Hernando County,3,5,7955,3948,4007
50,12,53,Florida,Hernando County,3,6,7625,3740,3885
50,12,53,Florida,Hernando County,3,7,7811,3714,4097
50,12,53,Florida,Hernando County,3,8,8820,4152,4668
50,12,53,Florida,Hernando County,3,9,10174,4894,5280
50,12,53,Florida,Hernando County,3,10,11746,5631,6115
50,12,53,Florida,Hernando County,3,11,11974,5652,6322
50,12,53,Florida,Hernando County,3,12,11587,5292,6295
50,12,53,Florida,Hernando County,3,13,12952,5991,6961
50,12,53,Florida,Hernando County,3,14,12706,5973,6733
50,12,53,Florida,Hernando County,3,15,10617,5118,5499
50,12,53,Florida,Hernando County,3,16,8836,4218,4618
50,12,53,Florida,Hernando County,3,17,6950,3104,3846
50,12,53,Florida,Hernando County,3,18,5562,2226,3336
50,12,53,Florida,Hernando County,4,0,172847,82636,90211
50,12,53,Florida,Hernando County,4,1,8229,4231,3998
50,12,53,Florida,Hernando County,4,2,9173,4540,4633
50,12,53,Florida,Hernando County,4,3,10124,5102,5022
50,12,53,Florida,Hernando County,4,4,9762,5036,4726
50,12,53,Florida,Hernando County,4,5,8284,4092,4192
50,12,53,Florida,Hernando County,4,6,7585,3713,3872
50,12,53,Florida,Hernando County,4,7,7853,3749,4104
50,12,53,Florida,Hernando County,4,8,8426,3951,4475
50,12,53,Florida,Hernando County,4,9,10157,4911,5246
50,12,53,Florida,Hernando County,4,10,11319,5391,5928
50,12,53,Florida,Hernando County,4,11,12033,5685,6348
50,12,53,Florida,Hernando County,4,12,11740,5323,6417
50,12,53,Florida,Hernando County,4,13,13048,6053,6995
50,12,53,Florida,Hernando County,4,14,12802,6000,6802
50,12,53,Florida,Hernando County,4,15,10848,5238,5610
50,12,53,Florida,Hernando County,4,16,8834,4231,4603
50,12,53,Florida,Hernando County,4,17,6956,3122,3834
50,12,53,Florida,Hernando County,4,18,5674,2268,3406
50,12,53,Florida,Hernando County,5,0,172718,82666,90052
50,12,53,Florida,Hernando County,5,1,7851,3966,3885
50,12,53,Florida,Hernando County,5,2,9098,4554,4544
50,12,53,Florida,Hernando County,5,3,10000,5071,4929
50,12,53,Florida,Hernando County,5,4,9696,4992,4704
50,12,53,Florida,Hernando County,5,5,8540,4251,4289
50,12,53,Florida,Hernando County,5,6,7649,3784,3865
50,12,53,Florida,Hernando County,5,7,8004,3843,4161
50,12,53,Florida,Hernando County,5,8,8103,3856,4247
50,12,53,Florida,Hernando County,5,9,10090,4799,5291
50,12,53,Florida,Hernando County,5,10,10967,5256,5711
50,12,53,Florida,Hernando County,5,11,11985,5665,6320
50,12,53,Florida,Hernando County,5,12,11976,5491,6485
50,12,53,Florida,Hernando County,5,13,12639,5843,6796
50,12,53,Florida,Hernando County,5,14,13337,6214,7123
50,12,53,Florida,Hernando County,5,15,11187,5362,5825
50,12,53,Florida,Hernando County,5,16,8855,4248,4607
50,12,53,Florida,Hernando County,5,17,6841,3125,3716
50,12,53,Florida,Hernando County,5,18,5900,2346,3554
50,12,53,Florida,Hernando County,6,0,173639,83207,90432
50,12,53,Florida,Hernando County,6,1,7763,3938,3825
50,12,53,Florida,Hernando County,6,2,9064,4533,4531
50,12,53,Florida,Hernando County,6,3,9842,4960,4882
50,12,53,Florida,Hernando County,6,4,9679,5032,4647
50,12,53,Florida,Hernando County,6,5,8863,4396,4467
50,12,53,Florida,Hernando County,6,6,7847,3887,3960
50,12,53,Florida,Hernando County,6,7,8066,3908,4158
50,12,53,Florida,Hernando County,6,8,8080,3856,4224
50,12,53,Florida,Hernando County,6,9,9909,4702,5207
50,12,53,Florida,Hernando County,6,10,10705,5065,5640
50,12,53,Florida,Hernando County,6,11,11992,5746,6246
50,12,53,Florida,Hernando County,6,12,12324,5697,6627
50,12,53,Florida,Hernando County,6,13,12420,5690,6730
50,12,53,Florida,Hernando County,6,14,13387,6227,7160
50,12,53,Florida,Hernando County,6,15,11920,5718,6202
50,12,53,Florida,Hernando County,6,16,8979,4309,4670
50,12,53,Florida,Hernando County,6,17,6761,3135,3626
50,12,53,Florida,Hernando County,6,18,6038,2408,3630
50,12,53,Florida,Hernando County,7,0,175298,83982,91316
50,12,53,Florida,Hernando County,7,1,7847,3999,3848
50,12,53,Florida,Hernando County,7,2,8969,4500,4469
50,12,53,Florida,Hernando County,7,3,9663,4814,4849
50,12,53,Florida,Hernando County,7,4,9756,5079,4677
50,12,53,Florida,Hernando County,7,5,8877,4401,4476
50,12,53,Florida,Hernando County,7,6,8266,4125,4141
50,12,53,Florida,Hernando County,7,7,8144,3995,4149
50,12,53,Florida,Hernando County,7,8,8290,3922,4368
50,12,53,Florida,Hernando County,7,9,9661,4563,5098
50,12,53,Florida,Hernando County,7,10,10596,5020,5576
50,12,53,Florida,Hernando County,7,11,12143,5868,6275
50,12,53,Florida,Hernando County,7,12,12538,5825,6713
50,12,53,Florida,Hernando County,7,13,12442,5620,6822
50,12,53,Florida,Hernando County,7,14,13746,6424,7322
50,12,53,Florida,Hernando County,7,15,12244,5811,6433
50,12,53,Florida,Hernando County,7,16,9259,4451,4808
50,12,53,Florida,Hernando County,7,17,6626,3070,3556
50,12,53,Florida,Hernando County,7,18,6231,2495,3736
50,12,53,Florida,Hernando County,8,0,177900,85234,92666
50,12,53,Florida,Hernando County,8,1,7922,3949,3973
50,12,53,Florida,Hernando County,8,2,9050,4616,4434
50,12,53,Florida,Hernando County,8,3,9745,4816,4929
50,12,53,Florida,Hernando County,8,4,9806,5066,4740
50,12,53,Florida,Hernando County,8,5,8674,4381,4293
50,12,53,Florida,Hernando County,8,6,8864,4450,4414
50,12,53,Florida,Hernando County,8,7,8271,4008,4263
50,12,53,Florida,Hernando County,8,8,8583,4111,4472
50,12,53,Florida,Hernando County,8,9,9471,4461,5010
50,12,53,Florida,Hernando County,8,10,10716,5126,5590
50,12,53,Florida,Hernando County,8,11,12206,5807,6399
50,12,53,Florida,Hernando County,8,12,12703,5958,6745
50,12,53,Florida,Hernando County,8,13,12661,5663,6998
50,12,53,Florida,Hernando County,8,14,14073,6604,7469
50,12,53,Florida,Hernando County,8,15,12648,5981,6667
50,12,53,Florida,Hernando County,8,16,9444,4525,4919
50,12,53,Florida,Hernando County,8,17,6718,3160,3558
50,12,53,Florida,Hernando County,8,18,6345,2552,3793
50,12,53,Florida,Hernando County,9,0,182459,87575,94884
50,12,53,Florida,Hernando County,9,1,8292,4137,4155
50,12,53,Florida,Hernando County,9,2,9227,4808,4419
50,12,53,Florida,Hernando County,9,3,9979,4919,5060
50,12,53,Florida,Hernando County,9,4,9886,5055,4831
50,12,53,Florida,Hernando County,9,5,8832,4468,4364
50,12,53,Florida,Hernando County,9,6,9454,4714,4740
50,12,53,Florida,Hernando County,9,7,8685,4215,4470
50,12,53,Florida,Hernando County,9,8,8955,4341,4614
50,12,53,Florida,Hernando County,9,9,9287,4455,4832
50,12,53,Florida,Hernando County,9,10,10963,5228,5735
50,12,53,Florida,Hernando County,9,11,12195,5769,6426
50,12,53,Florida,Hernando County,9,12,13137,6167,6970
50,12,53,Florida,Hernando County,9,13,13096,5869,7227
50,12,53,Florida,Hernando County,9,14,14650,6848,7802
50,12,53,Florida,Hernando County,9,15,12770,6007,6763
50,12,53,Florida,Hernando County,9,16,9790,4737,5053
50,12,53,Florida,Hernando County,9,17,6738,3157,3581
50,12,53,Florida,Hernando County,9,18,6523,2681,3842
50,12,53,Florida,Hernando County,10,0,186704,89778,96926
50,12,53,Florida,Hernando County,10,1,8560,4369,4191
50,12,53,Florida,Hernando County,10,2,9276,4765,4511
50,12,53,Florida,Hernando County,10,3,10252,5130,5122
50,12,53,Florida,Hernando County,10,4,9926,5005,4921
50,12,53,Florida,Hernando County,10,5,9002,4566,4436
50,12,53,Florida,Hernando County,10,6,10062,5085,4977
50,12,53,Florida,Hernando County,10,7,9182,4402,4780
50,12,53,Florida,Hernando County,10,8,9365,4571,4794
50,12,53,Florida,Hernando County,10,9,9257,4495,4762
50,12,53,Florida,Hernando County,10,10,11281,5345,5936
50,12,53,Florida,Hernando County,10,11,12180,5774,6406
50,12,53,Florida,Hernando County,10,12,13265,6211,7054
50,12,53,Florida,Hernando County,10,13,13608,6126,7482
50,12,53,Florida,Hernando County,10,14,14275,6624,7651
50,12,53,Florida,Hernando County,10,15,13674,6481,7193
50,12,53,Florida,Hernando County,10,16,10210,4863,5347
50,12,53,Florida,Hernando County,10,17,6833,3261,3572
50,12,53,Florida,Hernando County,10,18,6496,2705,3791
50,12,53,Florida,Hernando County,11,0,190582,91856,98726
50,12,53,Florida,Hernando County,11,1,8727,4411,4316
50,12,53,Florida,Hernando County,11,2,9446,4876,4570
50,12,53,Florida,Hernando County,11,3,10428,5211,5217
50,12,53,Florida,Hernando County,11,4,9938,5004,4934
50,12,53,Florida,Hernando County,11,5,9055,4586,4469
50,12,53,Florida,Hernando County,11,6,10363,5229,5134
50,12,53,Florida,Hernando County,11,7,9715,4736,4979
50,12,53,Florida,Hernando County,11,8,9783,4794,4989
50,12,53,Florida,Hernando County,11,9,9486,4656,4830
50,12,53,Florida,Hernando County,11,10,11380,5413,5967
50,12,53,Florida,Hernando County,11,11,12082,5675,6407
50,12,53,Florida,Hernando County,11,12,13609,6452,7157
50,12,53,Florida,Hernando County,11,13,14193,6460,7733
50,12,53,Florida,Hernando County,11,14,14223,6581,7642
50,12,53,Florida,Hernando County,11,15,13836,6515,7321
50,12,53,Florida,Hernando County,11,16,10824,5169,5655
50,12,53,Florida,Hernando County,11,17,7009,3328,3681
50,12,53,Florida,Hernando County,11,18,6485,2760,3725
50,12,53,Florida,Hernando County,12,0,193920,93470,100450
50,12,53,Florida,Hernando County,12,1,8778,4479,4299
50,12,53,Florida,Hernando County,12,2,9675,4980,4695
50,12,53,Florida,Hernando County,12,3,10611,5296,5315
50,12,53,Florida,Hernando County,12,4,9880,4951,4929
50,12,53,Florida,Hernando County,12,5,9199,4628,4571
50,12,53,Florida,Hernando County,12,6,10470,5325,5145
50,12,53,Florida,Hernando County,12,7,10168,5000,5168
50,12,53,Florida,Hernando County,12,8,9923,4830,5093
50,12,53,Florida,Hernando County,12,9,10090,4913,5177
50,12,53,Florida,Hernando County,12,10,11367,5442,5925
50,12,53,Florida,Hernando County,12,11,12074,5678,6396
50,12,53,Florida,Hernando County,12,12,13828,6560,7268
50,12,53,Florida,Hernando County,12,13,14509,6622,7887
50,12,53,Florida,Hernando County,12,14,14407,6584,7823
50,12,53,Florida,Hernando County,12,15,14110,6669,7441
50,12,53,Florida,Hernando County,12,16,11204,5307,5897
50,12,53,Florida,Hernando County,12,17,7253,3450,3803
50,12,53,Florida,Hernando County,12,18,6374,2756,3618
50,12,55,Florida,Highlands County,1,0,98786,48273,50513
50,12,55,Florida,Highlands County,1,1,4988,2583,2405
50,12,55,Florida,Highlands County,1,2,4858,2463,2395
50,12,55,Florida,Highlands County,1,3,4957,2558,2399
50,12,55,Florida,Highlands County,1,4,5211,2741,2470
50,12,55,Florida,Highlands County,1,5,4451,2393,2058
50,12,55,Florida,Highlands County,1,6,4415,2290,2125
50,12,55,Florida,Highlands County,1,7,4197,2125,2072
50,12,55,Florida,Highlands County,1,8,4210,2086,2124
50,12,55,Florida,Highlands County,1,9,4646,2377,2269
50,12,55,Florida,Highlands County,1,10,5641,2709,2932
50,12,55,Florida,Highlands County,1,11,6068,2961,3107
50,12,55,Florida,Highlands County,1,12,6083,2817,3266
50,12,55,Florida,Highlands County,1,13,7239,3227,4012
50,12,55,Florida,Highlands County,1,14,8487,3976,4511
50,12,55,Florida,Highlands County,1,15,7880,3862,4018
50,12,55,Florida,Highlands County,1,16,6393,3077,3316
50,12,55,Florida,Highlands County,1,17,4901,2362,2539
50,12,55,Florida,Highlands County,1,18,4161,1666,2495
50,12,55,Florida,Highlands County,2,0,98784,48272,50512
50,12,55,Florida,Highlands County,2,1,4988,2583,2405
50,12,55,Florida,Highlands County,2,2,4858,2463,2395
50,12,55,Florida,Highlands County,2,3,4957,2558,2399
50,12,55,Florida,Highlands County,2,4,5211,2741,2470
50,12,55,Florida,Highlands County,2,5,4451,2393,2058
50,12,55,Florida,Highlands County,2,6,4415,2290,2125
50,12,55,Florida,Highlands County,2,7,4197,2125,2072
50,12,55,Florida,Highlands County,2,8,4210,2086,2124
50,12,55,Florida,Highlands County,2,9,4646,2377,2269
50,12,55,Florida,Highlands County,2,10,5641,2709,2932
50,12,55,Florida,Highlands County,2,11,6068,2961,3107
50,12,55,Florida,Highlands County,2,12,6083,2817,3266
50,12,55,Florida,Highlands County,2,13,7238,3227,4011
50,12,55,Florida,Highlands County,2,14,8486,3975,4511
50,12,55,Florida,Highlands County,2,15,7880,3862,4018
50,12,55,Florida,Highlands County,2,16,6393,3077,3316
50,12,55,Florida,Highlands County,2,17,4901,2362,2539
50,12,55,Florida,Highlands County,2,18,4161,1666,2495
50,12,55,Florida,Highlands County,3,0,98635,48180,50455
50,12,55,Florida,Highlands County,3,1,4954,2563,2391
50,12,55,Florida,Highlands County,3,2,4849,2471,2378
50,12,55,Florida,Highlands County,3,3,4958,2553,2405
50,12,55,Florida,Highlands County,3,4,5152,2709,2443
50,12,55,Florida,Highlands County,3,5,4472,2400,2072
50,12,55,Florida,Highlands County,3,6,4420,2291,2129
50,12,55,Florida,Highlands County,3,7,4192,2113,2079
50,12,55,Florida,Highlands County,3,8,4187,2071,2116
50,12,55,Florida,Highlands County,3,9,4618,2361,2257
50,12,55,Florida,Highlands County,3,10,5604,2695,2909
50,12,55,Florida,Highlands County,3,11,6069,2960,3109
50,12,55,Florida,Highlands County,3,12,6093,2829,3264
50,12,55,Florida,Highlands County,3,13,7223,3222,4001
50,12,55,Florida,Highlands County,3,14,8417,3941,4476
50,12,55,Florida,Highlands County,3,15,7918,3867,4051
50,12,55,Florida,Highlands County,3,16,6389,3079,3310
50,12,55,Florida,Highlands County,3,17,4895,2354,2541
50,12,55,Florida,Highlands County,3,18,4225,1701,2524
50,12,55,Florida,Highlands County,4,0,98477,48066,50411
50,12,55,Florida,Highlands County,4,1,4907,2496,2411
50,12,55,Florida,Highlands County,4,2,4847,2493,2354
50,12,55,Florida,Highlands County,4,3,4979,2551,2428
50,12,55,Florida,Highlands County,4,4,5006,2659,2347
50,12,55,Florida,Highlands County,4,5,4609,2450,2159
50,12,55,Florida,Highlands County,4,6,4419,2283,2136
50,12,55,Florida,Highlands County,4,7,4222,2106,2116
50,12,55,Florida,Highlands County,4,8,4162,2080,2082
50,12,55,Florida,Highlands County,4,9,4608,2321,2287
50,12,55,Florida,Highlands County,4,10,5327,2613,2714
50,12,55,Florida,Highlands County,4,11,5999,2880,3119
50,12,55,Florida,Highlands County,4,12,6122,2879,3243
50,12,55,Florida,Highlands County,4,13,7281,3253,4028
50,12,55,Florida,Highlands County,4,14,8128,3803,4325
50,12,55,Florida,Highlands County,4,15,8083,3919,4164
50,12,55,Florida,Highlands County,4,16,6510,3137,3373
50,12,55,Florida,Highlands County,4,17,4883,2330,2553
50,12,55,Florida,Highlands County,4,18,4385,1813,2572
50,12,55,Florida,Highlands County,5,0,98222,47794,50428
50,12,55,Florida,Highlands County,5,1,4754,2399,2355
50,12,55,Florida,Highlands County,5,2,4921,2517,2404
50,12,55,Florida,Highlands County,5,3,4938,2521,2417
50,12,55,Florida,Highlands County,5,4,4921,2611,2310
50,12,55,Florida,Highlands County,5,5,4732,2509,2223
50,12,55,Florida,Highlands County,5,6,4458,2298,2160
50,12,55,Florida,Highlands County,5,7,4297,2160,2137
50,12,55,Florida,Highlands County,5,8,4093,2013,2080
50,12,55,Florida,Highlands County,5,9,4547,2268,2279
50,12,55,Florida,Highlands County,5,10,5110,2527,2583
50,12,55,Florida,Highlands County,5,11,5853,2777,3076
50,12,55,Florida,Highlands County,5,12,6221,2907,3314
50,12,55,Florida,Highlands County,5,13,6821,3054,3767
50,12,55,Florida,Highlands County,5,14,8279,3843,4436
50,12,55,Florida,Highlands County,5,15,8138,3910,4228
50,12,55,Florida,Highlands County,5,16,6717,3226,3491
50,12,55,Florida,Highlands County,5,17,4909,2365,2544
50,12,55,Florida,Highlands County,5,18,4513,1889,2624
50,12,55,Florida,Highlands County,6,0,98077,47720,50357
50,12,55,Florida,Highlands County,6,1,4568,2302,2266
50,12,55,Florida,Highlands County,6,2,5103,2647,2456
50,12,55,Florida,Highlands County,6,3,4835,2419,2416
50,12,55,Florida,Highlands County,6,4,4749,2489,2260
50,12,55,Florida,Highlands County,6,5,4767,2517,2250
50,12,55,Florida,Highlands County,6,6,4445,2295,2150
50,12,55,Florida,Highlands County,6,7,4390,2205,2185
50,12,55,Florida,Highlands County,6,8,4099,2052,2047
50,12,55,Florida,Highlands County,6,9,4481,2187,2294
50,12,55,Florida,Highlands County,6,10,4976,2516,2460
50,12,55,Florida,Highlands County,6,11,5775,2749,3026
50,12,55,Florida,Highlands County,6,12,6222,2927,3295
50,12,55,Florida,Highlands County,6,13,6686,2981,3705
50,12,55,Florida,Highlands County,6,14,8107,3726,4381
50,12,55,Florida,Highlands County,6,15,8381,4013,4368
50,12,55,Florida,Highlands County,6,16,6861,3343,3518
50,12,55,Florida,Highlands County,6,17,5023,2401,2622
50,12,55,Florida,Highlands County,6,18,4609,1951,2658
50,12,55,Florida,Highlands County,7,0,98584,47911,50673
50,12,55,Florida,Highlands County,7,1,4602,2316,2286
50,12,55,Florida,Highlands County,7,2,5032,2570,2462
50,12,55,Florida,Highlands County,7,3,4817,2406,2411
50,12,55,Florida,Highlands County,7,4,4670,2444,2226
50,12,55,Florida,Highlands County,7,5,4688,2477,2211
50,12,55,Florida,Highlands County,7,6,4503,2302,2201
50,12,55,Florida,Highlands County,7,7,4550,2302,2248
50,12,55,Florida,Highlands County,7,8,4098,2046,2052
50,12,55,Florida,Highlands County,7,9,4409,2144,2265
50,12,55,Florida,Highlands County,7,10,4773,2449,2324
50,12,55,Florida,Highlands County,7,11,5729,2735,2994
50,12,55,Florida,Highlands County,7,12,6311,3025,3286
50,12,55,Florida,Highlands County,7,13,6707,2975,3732
50,12,55,Florida,Highlands County,7,14,8155,3728,4427
50,12,55,Florida,Highlands County,7,15,8585,4056,4529
50,12,55,Florida,Highlands County,7,16,7122,3469,3653
50,12,55,Florida,Highlands County,7,17,5040,2380,2660
50,12,55,Florida,Highlands County,7,18,4793,2087,2706
50,12,55,Florida,Highlands County,8,0,100137,48752,51385
50,12,55,Florida,Highlands County,8,1,4641,2345,2296
50,12,55,Florida,Highlands County,8,2,5071,2567,2504
50,12,55,Florida,Highlands County,8,3,4842,2446,2396
50,12,55,Florida,Highlands County,8,4,4711,2436,2275
50,12,55,Florida,Highlands County,8,5,4653,2507,2146
50,12,55,Florida,Highlands County,8,6,4793,2504,2289
50,12,55,Florida,Highlands County,8,7,4544,2287,2257
50,12,55,Florida,Highlands County,8,8,4277,2146,2131
50,12,55,Florida,Highlands County,8,9,4227,2043,2184
50,12,55,Florida,Highlands County,8,10,4799,2450,2349
50,12,55,Florida,Highlands County,8,11,5747,2743,3004
50,12,55,Florida,Highlands County,8,12,6427,3065,3362
50,12,55,Florida,Highlands County,8,13,6893,3085,3808
50,12,55,Florida,Highlands County,8,14,8298,3774,4524
50,12,55,Florida,Highlands County,8,15,8706,4132,4574
50,12,55,Florida,Highlands County,8,16,7380,3589,3791
50,12,55,Florida,Highlands County,8,17,5149,2440,2709
50,12,55,Florida,Highlands County,8,18,4979,2193,2786
50,12,55,Florida,Highlands County,9,0,102041,49856,52185
50,12,55,Florida,Highlands County,9,1,4658,2320,2338
50,12,55,Florida,Highlands County,9,2,5100,2595,2505
50,12,55,Florida,Highlands County,9,3,4911,2499,2412
50,12,55,Florida,Highlands County,9,4,4748,2457,2291
50,12,55,Florida,Highlands County,9,5,4662,2527,2135
50,12,55,Florida,Highlands County,9,6,5050,2663,2387
50,12,55,Florida,Highlands County,9,7,4699,2374,2325
50,12,55,Florida,Highlands County,9,8,4407,2192,2215
50,12,55,Florida,Highlands County,9,9,4199,2093,2106
50,12,55,Florida,Highlands County,9,10,4789,2398,2391
50,12,55,Florida,Highlands County,9,11,5687,2769,2918
50,12,55,Florida,Highlands County,9,12,6528,3077,3451
50,12,55,Florida,Highlands County,9,13,7018,3191,3827
50,12,55,Florida,Highlands County,9,14,8679,3927,4752
50,12,55,Florida,Highlands County,9,15,8722,4134,4588
50,12,55,Florida,Highlands County,9,16,7620,3705,3915
50,12,55,Florida,Highlands County,9,17,5431,2657,2774
50,12,55,Florida,Highlands County,9,18,5133,2278,2855
50,12,55,Florida,Highlands County,10,0,103852,50740,53112
50,12,55,Florida,Highlands County,10,1,4738,2370,2368
50,12,55,Florida,Highlands County,10,2,5002,2536,2466
50,12,55,Florida,Highlands County,10,3,5112,2586,2526
50,12,55,Florida,Highlands County,10,4,4739,2448,2291
50,12,55,Florida,Highlands County,10,5,4739,2583,2156
50,12,55,Florida,Highlands County,10,6,5192,2745,2447
50,12,55,Florida,Highlands County,10,7,4782,2421,2361
50,12,55,Florida,Highlands County,10,8,4597,2329,2268
50,12,55,Florida,Highlands County,10,9,4223,2076,2147
50,12,55,Florida,Highlands County,10,10,4876,2401,2475
50,12,55,Florida,Highlands County,10,11,5540,2703,2837
50,12,55,Florida,Highlands County,10,12,6551,3083,3468
50,12,55,Florida,Highlands County,10,13,7272,3334,3938
50,12,55,Florida,Highlands County,10,14,8405,3773,4632
50,12,55,Florida,Highlands County,10,15,9158,4327,4831
50,12,55,Florida,Highlands County,10,16,7959,3866,4093
50,12,55,Florida,Highlands County,10,17,5614,2749,2865
50,12,55,Florida,Highlands County,10,18,5353,2410,2943
50,12,55,Florida,Highlands County,11,0,104933,51218,53715
50,12,55,Florida,Highlands County,11,1,4724,2399,2325
50,12,55,Florida,Highlands County,11,2,4914,2469,2445
50,12,55,Florida,Highlands County,11,3,5269,2685,2584
50,12,55,Florida,Highlands County,11,4,4667,2399,2268
50,12,55,Florida,Highlands County,11,5,4699,2516,2183
50,12,55,Florida,Highlands County,11,6,5232,2770,2462
50,12,55,Florida,Highlands County,11,7,4837,2449,2388
50,12,55,Florida,Highlands County,11,8,4711,2363,2348
50,12,55,Florida,Highlands County,11,9,4360,2168,2192
50,12,55,Florida,Highlands County,11,10,4842,2346,2496
50,12,55,Florida,Highlands County,11,11,5406,2698,2708
50,12,55,Florida,Highlands County,11,12,6500,3048,3452
50,12,55,Florida,Highlands County,11,13,7443,3385,4058
50,12,55,Florida,Highlands County,11,14,8338,3736,4602
50,12,55,Florida,Highlands County,11,15,9228,4362,4866
50,12,55,Florida,Highlands County,11,16,8374,4042,4332
50,12,55,Florida,Highlands County,11,17,5828,2863,2965
50,12,55,Florida,Highlands County,11,18,5561,2520,3041
50,12,55,Florida,Highlands County,12,0,106221,51882,54339
50,12,55,Florida,Highlands County,12,1,4610,2296,2314
50,12,55,Florida,Highlands County,12,2,4974,2525,2449
50,12,55,Florida,Highlands County,12,3,5281,2682,2599
50,12,55,Florida,Highlands County,12,4,4806,2480,2326
50,12,55,Florida,Highlands County,12,5,4651,2472,2179
50,12,55,Florida,Highlands County,12,6,5199,2741,2458
50,12,55,Florida,Highlands County,12,7,4963,2526,2437
50,12,55,Florida,Highlands County,12,8,4874,2456,2418
50,12,55,Florida,Highlands County,12,9,4386,2203,2183
50,12,55,Florida,Highlands County,12,10,4786,2320,2466
50,12,55,Florida,Highlands County,12,11,5362,2689,2673
50,12,55,Florida,Highlands County,12,12,6578,3092,3486
50,12,55,Florida,Highlands County,12,13,7462,3432,4030
50,12,55,Florida,Highlands County,12,14,8432,3771,4661
50,12,55,Florida,Highlands County,12,15,9434,4465,4969
50,12,55,Florida,Highlands County,12,16,8641,4118,4523
50,12,55,Florida,Highlands County,12,17,6089,2975,3114
50,12,55,Florida,Highlands County,12,18,5693,2639,3054
50,12,57,Florida,Hillsborough County,1,0,1229226,599084,630142
50,12,57,Florida,Hillsborough County,1,1,80459,41220,39239
50,12,57,Florida,Hillsborough County,1,2,79737,40719,39018
50,12,57,Florida,Hillsborough County,1,3,82835,42407,40428
50,12,57,Florida,Hillsborough County,1,4,88167,44848,43319
50,12,57,Florida,Hillsborough County,1,5,91853,44505,47348
50,12,57,Florida,Hillsborough County,1,6,90023,44008,46015
50,12,57,Florida,Hillsborough County,1,7,83854,41339,42515
50,12,57,Florida,Hillsborough County,1,8,86098,42426,43672
50,12,57,Florida,Hillsborough County,1,9,88244,43700,44544
50,12,57,Florida,Hillsborough County,1,10,93099,45817,47282
50,12,57,Florida,Hillsborough County,1,11,84959,41463,43496
50,12,57,Florida,Hillsborough County,1,12,72285,34443,37842
50,12,57,Florida,Hillsborough County,1,13,62376,29665,32711
50,12,57,Florida,Hillsborough County,1,14,45801,21342,24459
50,12,57,Florida,Hillsborough County,1,15,33971,15292,18679
50,12,57,Florida,Hillsborough County,1,16,26553,11607,14946
50,12,57,Florida,Hillsborough County,1,17,20347,8101,12246
50,12,57,Florida,Hillsborough County,1,18,18565,6182,12383
50,12,57,Florida,Hillsborough County,2,0,1229202,599066,630136
50,12,57,Florida,Hillsborough County,2,1,80448,41216,39232
50,12,57,Florida,Hillsborough County,2,2,79733,40716,39017
50,12,57,Florida,Hillsborough County,2,3,82834,42406,40428
50,12,57,Florida,Hillsborough County,2,4,88173,44851,43322
50,12,57,Florida,Hillsborough County,2,5,91846,44499,47347
50,12,57,Florida,Hillsborough County,2,6,90020,44006,46014
50,12,57,Florida,Hillsborough County,2,7,83852,41337,42515
50,12,57,Florida,Hillsborough County,2,8,86097,42423,43674
50,12,57,Florida,Hillsborough County,2,9,88243,43700,44543
50,12,57,Florida,Hillsborough County,2,10,93100,45819,47281
50,12,57,Florida,Hillsborough County,2,11,84958,41463,43495
50,12,57,Florida,Hillsborough County,2,12,72282,34440,37842
50,12,57,Florida,Hillsborough County,2,13,62376,29665,32711
50,12,57,Florida,Hillsborough County,2,14,45804,21343,24461
50,12,57,Florida,Hillsborough County,2,15,33971,15292,18679
50,12,57,Florida,Hillsborough County,2,16,26553,11607,14946
50,12,57,Florida,Hillsborough County,2,17,20347,8101,12246
50,12,57,Florida,Hillsborough County,2,18,18565,6182,12383
50,12,57,Florida,Hillsborough County,3,0,1233498,601301,632197
50,12,57,Florida,Hillsborough County,3,1,80332,41182,39150
50,12,57,Florida,Hillsborough County,3,2,79650,40679,38971
50,12,57,Florida,Hillsborough County,3,3,82835,42386,40449
50,12,57,Florida,Hillsborough County,3,4,87675,44696,42979
50,12,57,Florida,Hillsborough County,3,5,92471,44801,47670
50,12,57,Florida,Hillsborough County,3,6,90636,44345,46291
50,12,57,Florida,Hillsborough County,3,7,84438,41606,42832
50,12,57,Florida,Hillsborough County,3,8,85901,42348,43553
50,12,57,Florida,Hillsborough County,3,9,88464,43823,44641
50,12,57,Florida,Hillsborough County,3,10,93217,45878,47339
50,12,57,Florida,Hillsborough County,3,11,85556,41759,43797
50,12,57,Florida,Hillsborough County,3,12,73002,34783,38219
50,12,57,Florida,Hillsborough County,3,13,63105,30002,33103
50,12,57,Florida,Hillsborough County,3,14,46235,21543,24692
50,12,57,Florida,Hillsborough County,3,15,34201,15427,18774
50,12,57,Florida,Hillsborough County,3,16,26605,11642,14963
50,12,57,Florida,Hillsborough County,3,17,20433,8162,12271
50,12,57,Florida,Hillsborough County,3,18,18742,6239,12503
50,12,57,Florida,Hillsborough County,4,0,1255503,614597,640906
50,12,57,Florida,Hillsborough County,4,1,81556,41855,39701
50,12,57,Florida,Hillsborough County,4,2,80317,41059,39258
50,12,57,Florida,Hillsborough County,4,3,83156,42523,40633
50,12,57,Florida,Hillsborough County,4,4,85796,44024,41772
50,12,57,Florida,Hillsborough County,4,5,93897,45809,48088
50,12,57,Florida,Hillsborough County,4,6,92975,46162,46813
50,12,57,Florida,Hillsborough County,4,7,86989,42998,43991
50,12,57,Florida,Hillsborough County,4,8,83792,41496,42296
50,12,57,Florida,Hillsborough County,4,9,89666,44583,45083
50,12,57,Florida,Hillsborough County,4,10,92839,45899,46940
50,12,57,Florida,Hillsborough County,4,11,88444,43441,45003
50,12,57,Florida,Hillsborough County,4,12,77011,36967,40044
50,12,57,Florida,Hillsborough County,4,13,68494,32576,35918
50,12,57,Florida,Hillsborough County,4,14,48679,22746,25933
50,12,57,Florida,Hillsborough County,4,15,35109,15867,19242
50,12,57,Florida,Hillsborough County,4,16,26821,11800,15021
50,12,57,Florida,Hillsborough County,4,17,20618,8324,12294
50,12,57,Florida,Hillsborough County,4,18,19344,6468,12876
50,12,57,Florida,Hillsborough County,5,0,1279639,624847,654792
50,12,57,Florida,Hillsborough County,5,1,82073,42144,39929
50,12,57,Florida,Hillsborough County,5,2,82020,42008,40012
50,12,57,Florida,Hillsborough County,5,3,83767,42854,40913
50,12,57,Florida,Hillsborough County,5,4,85332,43644,41688
50,12,57,Florida,Hillsborough County,5,5,94930,46211,48719
50,12,57,Florida,Hillsborough County,5,6,95655,47482,48173
50,12,57,Florida,Hillsborough County,5,7,90371,44346,46025
50,12,57,Florida,Hillsborough County,5,8,84215,41439,42776
50,12,57,Florida,Hillsborough County,5,9,91540,45286,46254
50,12,57,Florida,Hillsborough County,5,10,92170,45499,46671
50,12,57,Florida,Hillsborough County,5,11,90137,44133,46004
50,12,57,Florida,Hillsborough County,5,12,79661,38056,41605
50,12,57,Florida,Hillsborough County,5,13,68758,32429,36329
50,12,57,Florida,Hillsborough County,5,14,53909,25310,28599
50,12,57,Florida,Hillsborough County,5,15,36690,16567,20123
50,12,57,Florida,Hillsborough County,5,16,27498,12086,15412
50,12,57,Florida,Hillsborough County,5,17,20897,8564,12333
50,12,57,Florida,Hillsborough County,5,18,20016,6789,13227
50,12,57,Florida,Hillsborough County,6,0,1304131,635832,668299
50,12,57,Florida,Hillsborough County,6,1,82712,42593,40119
50,12,57,Florida,Hillsborough County,6,2,83863,43024,40839
50,12,57,Florida,Hillsborough County,6,3,84114,42838,41276
50,12,57,Florida,Hillsborough County,6,4,85967,44025,41942
50,12,57,Florida,Hillsborough County,6,5,95102,46435,48667
50,12,57,Florida,Hillsborough County,6,6,98646,48751,49895
50,12,57,Florida,Hillsborough County,6,7,93321,45545,47776
50,12,57,Florida,Hillsborough County,6,8,85815,41911,43904
50,12,57,Florida,Hillsborough County,6,9,93246,46084,47162
50,12,57,Florida,Hillsborough County,6,10,91416,44931,46485
50,12,57,Florida,Hillsborough County,6,11,92137,45107,47030
50,12,57,Florida,Hillsborough County,6,12,81681,39083,42598
50,12,57,Florida,Hillsborough County,6,13,70159,32912,37247
50,12,57,Florida,Hillsborough County,6,14,56795,26647,30148
50,12,57,Florida,Hillsborough County,6,15,39211,17847,21364
50,12,57,Florida,Hillsborough County,6,16,28330,12375,15955
50,12,57,Florida,Hillsborough County,6,17,20944,8698,12246
50,12,57,Florida,Hillsborough County,6,18,20672,7026,13646
50,12,57,Florida,Hillsborough County,7,0,1332298,649545,682753
50,12,57,Florida,Hillsborough County,7,1,83897,43090,40807
50,12,57,Florida,Hillsborough County,7,2,85230,43646,41584
50,12,57,Florida,Hillsborough County,7,3,84744,43270,41474
50,12,57,Florida,Hillsborough County,7,4,86431,44277,42154
50,12,57,Florida,Hillsborough County,7,5,95297,46891,48406
50,12,57,Florida,Hillsborough County,7,6,102537,50565,51972
50,12,57,Florida,Hillsborough County,7,7,96067,46847,49220
50,12,57,Florida,Hillsborough County,7,8,88623,43372,45251
50,12,57,Florida,Hillsborough County,7,9,93509,45932,47577
50,12,57,Florida,Hillsborough County,7,10,91204,44954,46250
50,12,57,Florida,Hillsborough County,7,11,94484,46159,48325
50,12,57,Florida,Hillsborough County,7,12,84431,40655,43776
50,12,57,Florida,Hillsborough County,7,13,72167,33742,38425
50,12,57,Florida,Hillsborough County,7,14,60389,28324,32065
50,12,57,Florida,Hillsborough County,7,15,41430,18798,22632
50,12,57,Florida,Hillsborough County,7,16,29381,12817,16564
50,12,57,Florida,Hillsborough County,7,17,21176,8840,12336
50,12,57,Florida,Hillsborough County,7,18,21301,7366,13935
50,12,57,Florida,Hillsborough County,8,0,1364073,665697,698376
50,12,57,Florida,Hillsborough County,8,1,86133,44198,41935
50,12,57,Florida,Hillsborough County,8,2,86676,44479,42197
50,12,57,Florida,Hillsborough County,8,3,85386,43636,41750
50,12,57,Florida,Hillsborough County,8,4,87569,44800,42769
50,12,57,Florida,Hillsborough County,8,5,94071,46744,47327
50,12,57,Florida,Hillsborough County,8,6,107441,52910,54531
50,12,57,Florida,Hillsborough County,8,7,98883,48267,50616
50,12,57,Florida,Hillsborough County,8,8,92265,45203,47062
50,12,57,Florida,Hillsborough County,8,9,93321,45737,47584
50,12,57,Florida,Hillsborough County,8,10,92790,45813,46977
50,12,57,Florida,Hillsborough County,8,11,95912,46938,48974
50,12,57,Florida,Hillsborough County,8,12,87033,41945,45088
50,12,57,Florida,Hillsborough County,8,13,74759,35039,39720
50,12,57,Florida,Hillsborough County,8,14,64139,30017,34122
50,12,57,Florida,Hillsborough County,8,15,43625,19862,23763
50,12,57,Florida,Hillsborough County,8,16,30689,13387,17302
50,12,57,Florida,Hillsborough County,8,17,21473,9001,12472
50,12,57,Florida,Hillsborough County,8,18,21908,7721,14187
50,12,57,Florida,Hillsborough County,9,0,1396693,681997,714696
50,12,57,Florida,Hillsborough County,9,1,87637,45117,42520
50,12,57,Florida,Hillsborough County,9,2,88585,45335,43250
50,12,57,Florida,Hillsborough County,9,3,86961,44500,42461
50,12,57,Florida,Hillsborough County,9,4,88703,45444,43259
50,12,57,Florida,Hillsborough County,9,5,92760,46167,46593
50,12,57,Florida,Hillsborough County,9,6,111293,54687,56606
50,12,57,Florida,Hillsborough County,9,7,102454,50353,52101
50,12,57,Florida,Hillsborough County,9,8,96225,47160,49065
50,12,57,Florida,Hillsborough County,9,9,92969,45618,47351
50,12,57,Florida,Hillsborough County,9,10,95751,47164,48587
50,12,57,Florida,Hillsborough County,9,11,96212,47175,49037
50,12,57,Florida,Hillsborough County,9,12,89503,43217,46286
50,12,57,Florida,Hillsborough County,9,13,77352,36149,41203
50,12,57,Florida,Hillsborough County,9,14,67193,31318,35875
50,12,57,Florida,Hillsborough County,9,15,46513,21278,25235
50,12,57,Florida,Hillsborough County,9,16,31827,13900,17927
50,12,57,Florida,Hillsborough County,9,17,22153,9339,12814
50,12,57,Florida,Hillsborough County,9,18,22602,8076,14526
50,12,57,Florida,Hillsborough County,10,0,1426736,697571,729165
50,12,57,Florida,Hillsborough County,10,1,88696,45621,43075
50,12,57,Florida,Hillsborough County,10,2,89601,45868,43733
50,12,57,Florida,Hillsborough County,10,3,88818,45598,43220
50,12,57,Florida,Hillsborough County,10,4,90015,46040,43975
50,12,57,Florida,Hillsborough County,10,5,92741,46188,46553
50,12,57,Florida,Hillsborough County,10,6,113759,55983,57776
50,12,57,Florida,Hillsborough County,10,7,105304,52115,53189
50,12,57,Florida,Hillsborough County,10,8,100416,49298,51118
50,12,57,Florida,Hillsborough County,10,9,93606,45968,47638
50,12,57,Florida,Hillsborough County,10,10,98290,48373,49917
50,12,57,Florida,Hillsborough County,10,11,95871,47209,48662
50,12,57,Florida,Hillsborough County,10,12,91193,44121,47072
50,12,57,Florida,Hillsborough County,10,13,80052,37493,42559
50,12,57,Florida,Hillsborough County,10,14,67534,31435,36099
50,12,57,Florida,Hillsborough County,10,15,51497,23605,27892
50,12,57,Florida,Hillsborough County,10,16,33383,14585,18798
50,12,57,Florida,Hillsborough County,10,17,22784,9657,13127
50,12,57,Florida,Hillsborough County,10,18,23176,8414,14762
50,12,57,Florida,Hillsborough County,11,0,1451919,710366,741553
50,12,57,Florida,Hillsborough County,11,1,88875,45595,43280
50,12,57,Florida,Hillsborough County,11,2,90208,46392,43816
50,12,57,Florida,Hillsborough County,11,3,90797,46635,44162
50,12,57,Florida,Hillsborough County,11,4,90628,46165,44463
50,12,57,Florida,Hillsborough County,11,5,92896,46366,46530
50,12,57,Florida,Hillsborough County,11,6,113806,56462,57344
50,12,57,Florida,Hillsborough County,11,7,108469,53811,54658
50,12,57,Florida,Hillsborough County,11,8,104181,51042,53139
50,12,57,Florida,Hillsborough County,11,9,94940,46458,48482
50,12,57,Florida,Hillsborough County,11,10,99674,49240,50434
50,12,57,Florida,Hillsborough County,11,11,95295,46681,48614
50,12,57,Florida,Hillsborough County,11,12,93723,45662,48061
50,12,57,Florida,Hillsborough County,11,13,82225,38650,43575
50,12,57,Florida,Hillsborough County,11,14,68909,31902,37007
50,12,57,Florida,Hillsborough County,11,15,54298,24892,29406
50,12,57,Florida,Hillsborough County,11,16,35787,15774,20013
50,12,57,Florida,Hillsborough County,11,17,23669,9982,13687
50,12,57,Florida,Hillsborough County,11,18,23539,8657,14882
50,12,57,Florida,Hillsborough County,12,0,1471968,720329,751639
50,12,57,Florida,Hillsborough County,12,1,88951,45629,43322
50,12,57,Florida,Hillsborough County,12,2,91259,46929,44330
50,12,57,Florida,Hillsborough County,12,3,91478,46933,44545
50,12,57,Florida,Hillsborough County,12,4,90454,46273,44181
50,12,57,Florida,Hillsborough County,12,5,92982,46310,46672
50,12,57,Florida,Hillsborough County,12,6,113783,56634,57149
50,12,57,Florida,Hillsborough County,12,7,111590,55307,56283
50,12,57,Florida,Hillsborough County,12,8,106342,52208,54134
50,12,57,Florida,Hillsborough County,12,9,97191,47545,49646
50,12,57,Florida,Hillsborough County,12,10,99649,49052,50597
50,12,57,Florida,Hillsborough County,12,11,94795,46624,48171
50,12,57,Florida,Hillsborough County,12,12,95398,46341,49057
50,12,57,Florida,Hillsborough County,12,13,84061,39927,44134
50,12,57,Florida,Hillsborough County,12,14,70428,32459,37969
50,12,57,Florida,Hillsborough County,12,15,57395,26344,31051
50,12,57,Florida,Hillsborough County,12,16,37833,16648,21185
50,12,57,Florida,Hillsborough County,12,17,24523,10314,14209
50,12,57,Florida,Hillsborough County,12,18,23856,8852,15004
50,12,59,Florida,Holmes County,1,0,19927,10594,9333
50,12,59,Florida,Holmes County,1,1,1136,595,541
50,12,59,Florida,Holmes County,1,2,1130,588,542
50,12,59,Florida,Holmes County,1,3,1186,629,557
50,12,59,Florida,Holmes County,1,4,1310,722,588
50,12,59,Florida,Holmes County,1,5,1280,804,476
50,12,59,Florida,Holmes County,1,6,1255,759,496
50,12,59,Florida,Holmes County,1,7,1091,634,457
50,12,59,Florida,Holmes County,1,8,1220,675,545
50,12,59,Florida,Holmes County,1,9,1367,756,611
50,12,59,Florida,Holmes County,1,10,1430,798,632
50,12,59,Florida,Holmes County,1,11,1466,736,730
50,12,59,Florida,Holmes County,1,12,1343,678,665
50,12,59,Florida,Holmes County,1,13,1288,641,647
50,12,59,Florida,Holmes County,1,14,1102,529,573
50,12,59,Florida,Holmes County,1,15,919,440,479
50,12,59,Florida,Holmes County,1,16,638,317,321
50,12,59,Florida,Holmes County,1,17,425,178,247
50,12,59,Florida,Holmes County,1,18,341,115,226
50,12,59,Florida,Holmes County,2,0,19923,10590,9333
50,12,59,Florida,Holmes County,2,1,1136,595,541
50,12,59,Florida,Holmes County,2,2,1130,588,542
50,12,59,Florida,Holmes County,2,3,1186,629,557
50,12,59,Florida,Holmes County,2,4,1310,722,588
50,12,59,Florida,Holmes County,2,5,1279,803,476
50,12,59,Florida,Holmes County,2,6,1255,759,496
50,12,59,Florida,Holmes County,2,7,1091,634,457
50,12,59,Florida,Holmes County,2,8,1220,675,545
50,12,59,Florida,Holmes County,2,9,1364,754,610
50,12,59,Florida,Holmes County,2,10,1430,798,632
50,12,59,Florida,Holmes County,2,11,1465,735,730
50,12,59,Florida,Holmes County,2,12,1343,678,665
50,12,59,Florida,Holmes County,2,13,1288,641,647
50,12,59,Florida,Holmes County,2,14,1102,529,573
50,12,59,Florida,Holmes County,2,15,919,440,479
50,12,59,Florida,Holmes County,2,16,638,317,321
50,12,59,Florida,Holmes County,2,17,426,178,248
50,12,59,Florida,Holmes County,2,18,341,115,226
50,12,59,Florida,Holmes County,3,0,19843,10560,9283
50,12,59,Florida,Holmes County,3,1,1135,594,541
50,12,59,Florida,Holmes County,3,2,1116,581,535
50,12,59,Florida,Holmes County,3,3,1172,622,550
50,12,59,Florida,Holmes County,3,4,1284,708,576
50,12,59,Florida,Holmes County,3,5,1299,817,482
50,12,59,Florida,Holmes County,3,6,1253,759,494
50,12,59,Florida,Holmes County,3,7,1090,632,458
50,12,59,Florida,Holmes County,3,8,1216,678,538
50,12,59,Florida,Holmes County,3,9,1345,746,599
50,12,59,Florida,Holmes County,3,10,1421,784,637
50,12,59,Florida,Holmes County,3,11,1465,738,727
50,12,59,Florida,Holmes County,3,12,1330,673,657
50,12,59,Florida,Holmes County,3,13,1289,644,645
50,12,59,Florida,Holmes County,3,14,1102,531,571
50,12,59,Florida,Holmes County,3,15,913,438,475
50,12,59,Florida,Holmes County,3,16,650,320,330
50,12,59,Florida,Holmes County,3,17,425,179,246
50,12,59,Florida,Holmes County,3,18,338,116,222
50,12,59,Florida,Holmes County,4,0,19838,10542,9296
50,12,59,Florida,Holmes County,4,1,1131,605,526
50,12,59,Florida,Holmes County,4,2,1151,591,560
50,12,59,Florida,Holmes County,4,3,1151,591,560
50,12,59,Florida,Holmes County,4,4,1223,672,551
50,12,59,Florida,Holmes County,4,5,1370,844,526
50,12,59,Florida,Holmes County,4,6,1243,755,488
50,12,59,Florida,Holmes County,4,7,1151,648,503
50,12,59,Florida,Holmes County,4,8,1184,671,513
50,12,59,Florida,Holmes County,4,9,1294,734,560
50,12,59,Florida,Holmes County,4,10,1384,757,627
50,12,59,Florida,Holmes County,4,11,1505,761,744
50,12,59,Florida,Holmes County,4,12,1292,654,638
50,12,59,Florida,Holmes County,4,13,1304,660,644
50,12,59,Florida,Holmes County,4,14,1102,530,572
50,12,59,Florida,Holmes County,4,15,894,432,462
50,12,59,Florida,Holmes County,4,16,697,330,367
50,12,59,Florida,Holmes County,4,17,428,185,243
50,12,59,Florida,Holmes County,4,18,334,122,212
50,12,59,Florida,Holmes County,5,0,19697,10495,9202
50,12,59,Florida,Holmes County,5,1,1053,549,504
50,12,59,Florida,Holmes County,5,2,1126,590,536
50,12,59,Florida,Holmes County,5,3,1120,578,542
50,12,59,Florida,Holmes County,5,4,1187,657,530
50,12,59,Florida,Holmes County,5,5,1390,856,534
50,12,59,Florida,Holmes County,5,6,1219,754,465
50,12,59,Florida,Holmes County,5,7,1150,671,479
50,12,59,Florida,Holmes County,5,8,1158,667,491
50,12,59,Florida,Holmes County,5,9,1288,728,560
50,12,59,Florida,Holmes County,5,10,1383,756,627
50,12,59,Florida,Holmes County,5,11,1470,767,703
50,12,59,Florida,Holmes County,5,12,1349,667,682
50,12,59,Florida,Holmes County,5,13,1262,633,629
50,12,59,Florida,Holmes County,5,14,1104,521,583
50,12,59,Florida,Holmes County,5,15,917,446,471
50,12,59,Florida,Holmes County,5,16,730,338,392
50,12,59,Florida,Holmes County,5,17,452,192,260
50,12,59,Florida,Holmes County,5,18,339,125,214
50,12,59,Florida,Holmes County,6,0,19594,10426,9168
50,12,59,Florida,Holmes County,6,1,993,501,492
50,12,59,Florida,Holmes County,6,2,1150,608,542
50,12,59,Florida,Holmes County,6,3,1132,581,551
50,12,59,Florida,Holmes County,6,4,1128,624,504
50,12,59,Florida,Holmes County,6,5,1418,865,553
50,12,59,Florida,Holmes County,6,6,1183,730,453
50,12,59,Florida,Holmes County,6,7,1172,685,487
50,12,59,Florida,Holmes County,6,8,1128,653,475
50,12,59,Florida,Holmes County,6,9,1277,740,537
50,12,59,Florida,Holmes County,6,10,1356,734,622
50,12,59,Florida,Holmes County,6,11,1429,745,684
50,12,59,Florida,Holmes County,6,12,1339,685,654
50,12,59,Florida,Holmes County,6,13,1273,611,662
50,12,59,Florida,Holmes County,6,14,1096,522,574
50,12,59,Florida,Holmes County,6,15,971,461,510
50,12,59,Florida,Holmes County,6,16,724,340,384
50,12,59,Florida,Holmes County,6,17,468,210,258
50,12,59,Florida,Holmes County,6,18,357,131,226
50,12,59,Florida,Holmes County,7,0,19564,10420,9144
50,12,59,Florida,Holmes County,7,1,964,484,480
50,12,59,Florida,Holmes County,7,2,1177,616,561
50,12,59,Florida,Holmes County,7,3,1116,571,545
50,12,59,Florida,Holmes County,7,4,1118,618,500
50,12,59,Florida,Holmes County,7,5,1346,857,489
50,12,59,Florida,Holmes County,7,6,1240,758,482
50,12,59,Florida,Holmes County,7,7,1211,687,524
50,12,59,Florida,Holmes County,7,8,1082,639,443
50,12,59,Florida,Holmes County,7,9,1305,743,562
50,12,59,Florida,Holmes County,7,10,1337,746,591
50,12,59,Florida,Holmes County,7,11,1383,707,676
50,12,59,Florida,Holmes County,7,12,1334,674,660
50,12,59,Florida,Holmes County,7,13,1277,628,649
50,12,59,Florida,Holmes County,7,14,1108,519,589
50,12,59,Florida,Holmes County,7,15,977,474,503
50,12,59,Florida,Holmes County,7,16,745,347,398
50,12,59,Florida,Holmes County,7,17,470,210,260
50,12,59,Florida,Holmes County,7,18,374,142,232
50,12,59,Florida,Holmes County,8,0,19273,10247,9026
50,12,59,Florida,Holmes County,8,1,929,469,460
50,12,59,Florida,Holmes County,8,2,1109,587,522
50,12,59,Florida,Holmes County,8,3,1115,555,560
50,12,59,Florida,Holmes County,8,4,1084,606,478
50,12,59,Florida,Holmes County,8,5,1313,836,477
50,12,59,Florida,Holmes County,8,6,1232,749,483
50,12,59,Florida,Holmes County,8,7,1125,646,479
50,12,59,Florida,Holmes County,8,8,1082,617,465
50,12,59,Florida,Holmes County,8,9,1241,709,532
50,12,59,Florida,Holmes County,8,10,1334,754,580
50,12,59,Florida,Holmes County,8,11,1355,707,648
50,12,59,Florida,Holmes County,8,12,1382,679,703
50,12,59,Florida,Holmes County,8,13,1226,607,619
50,12,59,Florida,Holmes County,8,14,1151,547,604
50,12,59,Florida,Holmes County,8,15,962,461,501
50,12,59,Florida,Holmes County,8,16,750,344,406
50,12,59,Florida,Holmes County,8,17,484,219,265
50,12,59,Florida,Holmes County,8,18,399,155,244
50,12,59,Florida,Holmes County,9,0,19398,10316,9082
50,12,59,Florida,Holmes County,9,1,999,494,505
50,12,59,Florida,Holmes County,9,2,1079,567,512
50,12,59,Florida,Holmes County,9,3,1134,576,558
50,12,59,Florida,Holmes County,9,4,1059,598,461
50,12,59,Florida,Holmes County,9,5,1274,830,444
50,12,59,Florida,Holmes County,9,6,1310,793,517
50,12,59,Florida,Holmes County,9,7,1158,670,488
50,12,59,Florida,Holmes County,9,8,1122,629,493
50,12,59,Florida,Holmes County,9,9,1194,688,506
50,12,59,Florida,Holmes County,9,10,1320,748,572
50,12,59,Florida,Holmes County,9,11,1294,663,631
50,12,59,Florida,Holmes County,9,12,1433,705,728
50,12,59,Florida,Holmes County,9,13,1248,624,624
50,12,59,Florida,Holmes County,9,14,1165,552,613
50,12,59,Florida,Holmes County,9,15,964,461,503
50,12,59,Florida,Holmes County,9,16,734,342,392
50,12,59,Florida,Holmes County,9,17,523,227,296
50,12,59,Florida,Holmes County,9,18,388,149,239
50,12,59,Florida,Holmes County,10,0,19427,10341,9086
50,12,59,Florida,Holmes County,10,1,1008,519,489
50,12,59,Florida,Holmes County,10,2,1053,541,512
50,12,59,Florida,Holmes County,10,3,1141,581,560
50,12,59,Florida,Holmes County,10,4,1048,589,459
50,12,59,Florida,Holmes County,10,5,1293,828,465
50,12,59,Florida,Holmes County,10,6,1314,793,521
50,12,59,Florida,Holmes County,10,7,1143,662,481
50,12,59,Florida,Holmes County,10,8,1126,635,491
50,12,59,Florida,Holmes County,10,9,1173,681,492
50,12,59,Florida,Holmes County,10,10,1344,763,581
50,12,59,Florida,Holmes County,10,11,1286,672,614
50,12,59,Florida,Holmes County,10,12,1415,710,705
50,12,59,Florida,Holmes County,10,13,1300,641,659
50,12,59,Florida,Holmes County,10,14,1138,539,599
50,12,59,Florida,Holmes County,10,15,963,453,510
50,12,59,Florida,Holmes County,10,16,734,343,391
50,12,59,Florida,Holmes County,10,17,542,232,310
50,12,59,Florida,Holmes County,10,18,406,159,247
50,12,59,Florida,Holmes County,11,0,19443,10327,9116
50,12,59,Florida,Holmes County,11,1,1070,546,524
50,12,59,Florida,Holmes County,11,2,1027,518,509
50,12,59,Florida,Holmes County,11,3,1159,617,542
50,12,59,Florida,Holmes County,11,4,1061,579,482
50,12,59,Florida,Holmes County,11,5,1246,792,454
50,12,59,Florida,Holmes County,11,6,1323,799,524
50,12,59,Florida,Holmes County,11,7,1141,666,475
50,12,59,Florida,Holmes County,11,8,1146,640,506
50,12,59,Florida,Holmes County,11,9,1153,654,499
50,12,59,Florida,Holmes County,11,10,1317,770,547
50,12,59,Florida,Holmes County,11,11,1284,655,629
50,12,59,Florida,Holmes County,11,12,1363,686,677
50,12,59,Florida,Holmes County,11,13,1294,647,647
50,12,59,Florida,Holmes County,11,14,1178,542,636
50,12,59,Florida,Holmes County,11,15,954,451,503
50,12,59,Florida,Holmes County,11,16,762,358,404
50,12,59,Florida,Holmes County,11,17,545,238,307
50,12,59,Florida,Holmes County,11,18,420,169,251
50,12,59,Florida,Holmes County,12,0,19617,10425,9192
50,12,59,Florida,Holmes County,12,1,1093,552,541
50,12,59,Florida,Holmes County,12,2,1023,536,487
50,12,59,Florida,Holmes County,12,3,1172,611,561
50,12,59,Florida,Holmes County,12,4,1046,580,466
50,12,59,Florida,Holmes County,12,5,1229,789,440
50,12,59,Florida,Holmes County,12,6,1331,830,501
50,12,59,Florida,Holmes County,12,7,1190,686,504
50,12,59,Florida,Holmes County,12,8,1195,664,531
50,12,59,Florida,Holmes County,12,9,1109,627,482
50,12,59,Florida,Holmes County,12,10,1306,743,563
50,12,59,Florida,Holmes County,12,11,1288,665,623
50,12,59,Florida,Holmes County,12,12,1366,676,690
50,12,59,Florida,Holmes County,12,13,1348,663,685
50,12,59,Florida,Holmes County,12,14,1200,567,633
50,12,59,Florida,Holmes County,12,15,959,439,520
50,12,59,Florida,Holmes County,12,16,775,375,400
50,12,59,Florida,Holmes County,12,17,558,242,316
50,12,59,Florida,Holmes County,12,18,429,180,249
50,12,61,Florida,Indian River County,1,0,138028,66748,71280
50,12,61,Florida,Indian River County,1,1,6508,3254,3254
50,12,61,Florida,Indian River County,1,2,7024,3610,3414
50,12,61,Florida,Indian River County,1,3,7463,3813,3650
50,12,61,Florida,Indian River County,1,4,8012,4383,3629
50,12,61,Florida,Indian River County,1,5,6037,3156,2881
50,12,61,Florida,Indian River County,1,6,6421,3345,3076
50,12,61,Florida,Indian River County,1,7,6034,2996,3038
50,12,61,Florida,Indian River County,1,8,6551,3245,3306
50,12,61,Florida,Indian River County,1,9,7664,3691,3973
50,12,61,Florida,Indian River County,1,10,9168,4414,4754
50,12,61,Florida,Indian River County,1,11,9809,4644,5165
50,12,61,Florida,Indian River County,1,12,9581,4465,5116
50,12,61,Florida,Indian River County,1,13,10252,4635,5617
50,12,61,Florida,Indian River County,1,14,9651,4469,5182
50,12,61,Florida,Indian River County,1,15,8385,3937,4448
50,12,61,Florida,Indian River County,1,16,7535,3535,4000
50,12,61,Florida,Indian River County,1,17,6255,2797,3458
50,12,61,Florida,Indian River County,1,18,5678,2359,3319
50,12,61,Florida,Indian River County,2,0,138028,66748,71280
50,12,61,Florida,Indian River County,2,1,6508,3254,3254
50,12,61,Florida,Indian River County,2,2,7024,3610,3414
50,12,61,Florida,Indian River County,2,3,7463,3813,3650
50,12,61,Florida,Indian River County,2,4,8012,4383,3629
50,12,61,Florida,Indian River County,2,5,6037,3156,2881
50,12,61,Florida,Indian River County,2,6,6421,3345,3076
50,12,61,Florida,Indian River County,2,7,6034,2996,3038
50,12,61,Florida,Indian River County,2,8,6551,3245,3306
50,12,61,Florida,Indian River County,2,9,7664,3691,3973
50,12,61,Florida,Indian River County,2,10,9168,4414,4754
50,12,61,Florida,Indian River County,2,11,9809,4644,5165
50,12,61,Florida,Indian River County,2,12,9581,4465,5116
50,12,61,Florida,Indian River County,2,13,10252,4635,5617
50,12,61,Florida,Indian River County,2,14,9651,4469,5182
50,12,61,Florida,Indian River County,2,15,8385,3937,4448
50,12,61,Florida,Indian River County,2,16,7535,3535,4000
50,12,61,Florida,Indian River County,2,17,6255,2797,3458
50,12,61,Florida,Indian River County,2,18,5678,2359,3319
50,12,61,Florida,Indian River County,3,0,138270,66829,71441
50,12,61,Florida,Indian River County,3,1,6480,3231,3249
50,12,61,Florida,Indian River County,3,2,7019,3597,3422
50,12,61,Florida,Indian River County,3,3,7440,3811,3629
50,12,61,Florida,Indian River County,3,4,7971,4358,3613
50,12,61,Florida,Indian River County,3,5,6097,3185,2912
50,12,61,Florida,Indian River County,3,6,6413,3330,3083
50,12,61,Florida,Indian River County,3,7,6078,3020,3058
50,12,61,Florida,Indian River County,3,8,6488,3206,3282
50,12,61,Florida,Indian River County,3,9,7649,3690,3959
50,12,61,Florida,Indian River County,3,10,9115,4390,4725
50,12,61,Florida,Indian River County,3,11,9845,4661,5184
50,12,61,Florida,Indian River County,3,12,9633,4493,5140
50,12,61,Florida,Indian River County,3,13,10358,4682,5676
50,12,61,Florida,Indian River County,3,14,9707,4499,5208
50,12,61,Florida,Indian River County,3,15,8435,3948,4487
50,12,61,Florida,Indian River County,3,16,7503,3523,3980
50,12,61,Florida,Indian River County,3,17,6294,2815,3479
50,12,61,Florida,Indian River County,3,18,5745,2390,3355
50,12,61,Florida,Indian River County,4,0,139103,67042,72061
50,12,61,Florida,Indian River County,4,1,6413,3209,3204
50,12,61,Florida,Indian River County,4,2,6969,3538,3431
50,12,61,Florida,Indian River County,4,3,7429,3806,3623
50,12,61,Florida,Indian River County,4,4,7896,4297,3599
50,12,61,Florida,Indian River County,4,5,6364,3298,3066
50,12,61,Florida,Indian River County,4,6,6361,3271,3090
50,12,61,Florida,Indian River County,4,7,6187,3088,3099
50,12,61,Florida,Indian River County,4,8,6179,3012,3167
50,12,61,Florida,Indian River County,4,9,7597,3671,3926
50,12,61,Florida,Indian River County,4,10,8818,4260,4558
50,12,61,Florida,Indian River County,4,11,9880,4656,5224
50,12,61,Florida,Indian River County,4,12,9714,4539,5175
50,12,61,Florida,Indian River County,4,13,10777,4905,5872
50,12,61,Florida,Indian River County,4,14,9952,4596,5356
50,12,61,Florida,Indian River County,4,15,8730,4054,4676
50,12,61,Florida,Indian River County,4,16,7448,3500,3948
50,12,61,Florida,Indian River County,4,17,6398,2894,3504
50,12,61,Florida,Indian River County,4,18,5991,2448,3543
50,12,61,Florida,Indian River County,5,0,140473,67621,72852
50,12,61,Florida,Indian River County,5,1,6378,3153,3225
50,12,61,Florida,Indian River County,5,2,6978,3509,3469
50,12,61,Florida,Indian River County,5,3,7322,3780,3542
50,12,61,Florida,Indian River County,5,4,7855,4308,3547
50,12,61,Florida,Indian River County,5,5,6459,3329,3130
50,12,61,Florida,Indian River County,5,6,6449,3307,3142
50,12,61,Florida,Indian River County,5,7,6325,3167,3158
50,12,61,Florida,Indian River County,5,8,6031,2927,3104
50,12,61,Florida,Indian River County,5,9,7616,3674,3942
50,12,61,Florida,Indian River County,5,10,8584,4148,4436
50,12,61,Florida,Indian River County,5,11,9858,4664,5194
50,12,61,Florida,Indian River County,5,12,9999,4650,5349
50,12,61,Florida,Indian River County,5,13,10587,4833,5754
50,12,61,Florida,Indian River County,5,14,10714,4905,5809
50,12,61,Florida,Indian River County,5,15,9101,4253,4848
50,12,61,Florida,Indian River County,5,16,7537,3520,4017
50,12,61,Florida,Indian River County,5,17,6435,2956,3479
50,12,61,Florida,Indian River County,5,18,6245,2538,3707
50,12,61,Florida,Indian River County,6,0,141895,68144,73751
50,12,61,Florida,Indian River County,6,1,6442,3241,3201
50,12,61,Florida,Indian River County,6,2,6955,3506,3449
50,12,61,Florida,Indian River County,6,3,7248,3696,3552
50,12,61,Florida,Indian River County,6,4,7867,4274,3593
50,12,61,Florida,Indian River County,6,5,6604,3413,3191
50,12,61,Florida,Indian River County,6,6,6471,3268,3203
50,12,61,Florida,Indian River County,6,7,6403,3158,3245
50,12,61,Florida,Indian River County,6,8,6016,2917,3099
50,12,61,Florida,Indian River County,6,9,7379,3531,3848
50,12,61,Florida,Indian River County,6,10,8359,4024,4335
50,12,61,Florida,Indian River County,6,11,9855,4687,5168
50,12,61,Florida,Indian River County,6,12,10163,4684,5479
50,12,61,Florida,Indian River County,6,13,10589,4800,5789
50,12,61,Florida,Indian River County,6,14,11173,5124,6049
50,12,61,Florida,Indian River County,6,15,9695,4565,5130
50,12,61,Florida,Indian River County,6,16,7786,3636,4150
50,12,61,Florida,Indian River County,6,17,6386,2936,3450
50,12,61,Florida,Indian River County,6,18,6504,2684,3820
50,12,61,Florida,Indian River County,7,0,144445,69409,75036
50,12,61,Florida,Indian River County,7,1,6423,3291,3132
50,12,61,Florida,Indian River County,7,2,6916,3463,3453
50,12,61,Florida,Indian River County,7,3,7277,3722,3555
50,12,61,Florida,Indian River County,7,4,7744,4240,3504
50,12,61,Florida,Indian River County,7,5,6778,3520,3258
50,12,61,Florida,Indian River County,7,6,6678,3378,3300
50,12,61,Florida,Indian River County,7,7,6433,3205,3228
50,12,61,Florida,Indian River County,7,8,6094,2943,3151
50,12,61,Florida,Indian River County,7,9,7235,3455,3780
50,12,61,Florida,Indian River County,7,10,8197,3925,4272
50,12,61,Florida,Indian River County,7,11,9848,4661,5187
50,12,61,Florida,Indian River County,7,12,10511,4819,5692
50,12,61,Florida,Indian River County,7,13,10902,4925,5977
50,12,61,Florida,Indian River County,7,14,11866,5469,6397
50,12,61,Florida,Indian River County,7,15,10249,4846,5403
50,12,61,Florida,Indian River County,7,16,8112,3754,4358
50,12,61,Florida,Indian River County,7,17,6427,3030,3397
50,12,61,Florida,Indian River County,7,18,6755,2763,3992
50,12,61,Florida,Indian River County,8,0,147434,70735,76699
50,12,61,Florida,Indian River County,8,1,6496,3355,3141
50,12,61,Florida,Indian River County,8,2,6838,3449,3389
50,12,61,Florida,Indian River County,8,3,7302,3703,3599
50,12,61,Florida,Indian River County,8,4,7674,4224,3450
50,12,61,Florida,Indian River County,8,5,6930,3520,3410
50,12,61,Florida,Indian River County,8,6,6935,3525,3410
50,12,61,Florida,Indian River County,8,7,6499,3248,3251
50,12,61,Florida,Indian River County,8,8,6376,3068,3308
50,12,61,Florida,Indian River County,8,9,7004,3362,3642
50,12,61,Florida,Indian River County,8,10,8148,3864,4284
50,12,61,Florida,Indian River County,8,11,9722,4573,5149
50,12,61,Florida,Indian River County,8,12,10880,4968,5912
50,12,61,Florida,Indian River County,8,13,11074,5017,6057
50,12,61,Florida,Indian River County,8,14,12703,5813,6890
50,12,61,Florida,Indian River County,8,15,10929,5130,5799
50,12,61,Florida,Indian River County,8,16,8476,3966,4510
50,12,61,Florida,Indian River County,8,17,6424,3030,3394
50,12,61,Florida,Indian River County,8,18,7024,2920,4104
50,12,61,Florida,Indian River County,9,0,151159,72514,78645
50,12,61,Florida,Indian River County,9,1,6361,3267,3094
50,12,61,Florida,Indian River County,9,2,6846,3421,3425
50,12,61,Florida,Indian River County,9,3,7434,3758,3676
50,12,61,Florida,Indian River County,9,4,7699,4236,3463
50,12,61,Florida,Indian River County,9,5,6952,3555,3397
50,12,61,Florida,Indian River County,9,6,7155,3660,3495
50,12,61,Florida,Indian River County,9,7,6738,3350,3388
50,12,61,Florida,Indian River County,9,8,6628,3176,3452
50,12,61,Florida,Indian River County,9,9,6844,3310,3534
50,12,61,Florida,Indian River County,9,10,8249,3915,4334
50,12,61,Florida,Indian River County,9,11,9606,4590,5016
50,12,61,Florida,Indian River County,9,12,11284,5155,6129
50,12,61,Florida,Indian River County,9,13,11632,5275,6357
50,12,61,Florida,Indian River County,9,14,13538,6168,7370
50,12,61,Florida,Indian River County,9,15,11430,5328,6102
50,12,61,Florida,Indian River County,9,16,8972,4215,4757
50,12,61,Florida,Indian River County,9,17,6472,3031,3441
50,12,61,Florida,Indian River County,9,18,7319,3104,4215
50,12,61,Florida,Indian River County,10,0,154241,74067,80174
50,12,61,Florida,Indian River County,10,1,6401,3302,3099
50,12,61,Florida,Indian River County,10,2,6791,3391,3400
50,12,61,Florida,Indian River County,10,3,7280,3676,3604
50,12,61,Florida,Indian River County,10,4,7681,4234,3447
50,12,61,Florida,Indian River County,10,5,6929,3582,3347
50,12,61,Florida,Indian River County,10,6,7378,3767,3611
50,12,61,Florida,Indian River County,10,7,6840,3415,3425
50,12,61,Florida,Indian River County,10,8,6814,3266,3548
50,12,61,Florida,Indian River County,10,9,6747,3259,3488
50,12,61,Florida,Indian River County,10,10,8391,3989,4402
50,12,61,Florida,Indian River County,10,11,9432,4530,4902
50,12,61,Florida,Indian River County,10,12,11662,5347,6315
50,12,61,Florida,Indian River County,10,13,12070,5404,6666
50,12,61,Florida,Indian River County,10,14,13450,6131,7319
50,12,61,Florida,Indian River County,10,15,12720,5906,6814
50,12,61,Florida,Indian River County,10,16,9476,4484,4992
50,12,61,Florida,Indian River County,10,17,6652,3114,3538
50,12,61,Florida,Indian River County,10,18,7527,3270,4257
50,12,61,Florida,Indian River County,11,0,157187,75498,81689
50,12,61,Florida,Indian River County,11,1,6444,3349,3095
50,12,61,Florida,Indian River County,11,2,6768,3386,3382
50,12,61,Florida,Indian River County,11,3,7214,3643,3571
50,12,61,Florida,Indian River County,11,4,7656,4256,3400
50,12,61,Florida,Indian River County,11,5,6887,3487,3400
50,12,61,Florida,Indian River County,11,6,7541,3885,3656
50,12,61,Florida,Indian River County,11,7,6917,3486,3431
50,12,61,Florida,Indian River County,11,8,7061,3407,3654
50,12,61,Florida,Indian River County,11,9,6780,3320,3460
50,12,61,Florida,Indian River County,11,10,8216,3893,4323
50,12,61,Florida,Indian River County,11,11,9321,4477,4844
50,12,61,Florida,Indian River County,11,12,11812,5444,6368
50,12,61,Florida,Indian River County,11,13,12680,5624,7056
50,12,61,Florida,Indian River County,11,14,13652,6188,7464
50,12,61,Florida,Indian River County,11,15,13432,6179,7253
50,12,61,Florida,Indian River County,11,16,10234,4914,5320
50,12,61,Florida,Indian River County,11,17,6962,3236,3726
50,12,61,Florida,Indian River County,11,18,7610,3324,4286
50,12,61,Florida,Indian River County,12,0,159923,76759,83164
50,12,61,Florida,Indian River County,12,1,6451,3313,3138
50,12,61,Florida,Indian River County,12,2,6756,3479,3277
50,12,61,Florida,Indian River County,12,3,7133,3597,3536
50,12,61,Florida,Indian River County,12,4,7553,4193,3360
50,12,61,Florida,Indian River County,12,5,6846,3509,3337
50,12,61,Florida,Indian River County,12,6,7543,3899,3644
50,12,61,Florida,Indian River County,12,7,7220,3606,3614
50,12,61,Florida,Indian River County,12,8,7205,3532,3673
50,12,61,Florida,Indian River County,12,9,6836,3315,3521
50,12,61,Florida,Indian River County,12,10,8072,3816,4256
50,12,61,Florida,Indian River County,12,11,9255,4433,4822
50,12,61,Florida,Indian River County,12,12,11803,5414,6389
50,12,61,Florida,Indian River County,12,13,13117,5772,7345
50,12,61,Florida,Indian River County,12,14,14067,6332,7735
50,12,61,Florida,Indian River County,12,15,14237,6574,7663
50,12,61,Florida,Indian River County,12,16,10879,5222,5657
50,12,61,Florida,Indian River County,12,17,7298,3395,3903
50,12,61,Florida,Indian River County,12,18,7652,3358,4294
50,12,63,Florida,Jackson County,1,0,49746,27252,22494
50,12,63,Florida,Jackson County,1,1,2610,1337,1273
50,12,63,Florida,Jackson County,1,2,2769,1454,1315
50,12,63,Florida,Jackson County,1,3,2697,1375,1322
50,12,63,Florida,Jackson County,1,4,3170,1650,1520
50,12,63,Florida,Jackson County,1,5,3237,1993,1244
50,12,63,Florida,Jackson County,1,6,3148,1912,1236
50,12,63,Florida,Jackson County,1,7,3196,1988,1208
50,12,63,Florida,Jackson County,1,8,3636,2322,1314
50,12,63,Florida,Jackson County,1,9,3451,2113,1338
50,12,63,Florida,Jackson County,1,10,3783,2217,1566
50,12,63,Florida,Jackson County,1,11,3754,2073,1681
50,12,63,Florida,Jackson County,1,12,3461,1845,1616
50,12,63,Florida,Jackson County,1,13,3033,1584,1449
50,12,63,Florida,Jackson County,1,14,2478,1177,1301
50,12,63,Florida,Jackson County,1,15,1877,863,1014
50,12,63,Florida,Jackson County,1,16,1428,613,815
50,12,63,Florida,Jackson County,1,17,1049,431,618
50,12,63,Florida,Jackson County,1,18,969,305,664
50,12,63,Florida,Jackson County,2,0,49764,27264,22500
50,12,63,Florida,Jackson County,2,1,2610,1337,1273
50,12,63,Florida,Jackson County,2,2,2769,1454,1315
50,12,63,Florida,Jackson County,2,3,2699,1376,1323
50,12,63,Florida,Jackson County,2,4,3174,1653,1521
50,12,63,Florida,Jackson County,2,5,3237,1993,1244
50,12,63,Florida,Jackson County,2,6,3148,1912,1236
50,12,63,Florida,Jackson County,2,7,3196,1988,1208
50,12,63,Florida,Jackson County,2,8,3638,2323,1315
50,12,63,Florida,Jackson County,2,9,3452,2114,1338
50,12,63,Florida,Jackson County,2,10,3784,2218,1566
50,12,63,Florida,Jackson County,2,11,3753,2073,1680
50,12,63,Florida,Jackson County,2,12,3461,1845,1616
50,12,63,Florida,Jackson County,2,13,3036,1587,1449
50,12,63,Florida,Jackson County,2,14,2480,1178,1302
50,12,63,Florida,Jackson County,2,15,1878,864,1014
50,12,63,Florida,Jackson County,2,16,1428,613,815
50,12,63,Florida,Jackson County,2,17,1051,431,620
50,12,63,Florida,Jackson County,2,18,970,305,665
50,12,63,Florida,Jackson County,3,0,49648,27158,22490
50,12,63,Florida,Jackson County,3,1,2584,1324,1260
50,12,63,Florida,Jackson County,3,2,2739,1436,1303
50,12,63,Florida,Jackson County,3,3,2715,1380,1335
50,12,63,Florida,Jackson County,3,4,3114,1633,1481
50,12,63,Florida,Jackson County,3,5,3255,1997,1258
50,12,63,Florida,Jackson County,3,6,3138,1903,1235
50,12,63,Florida,Jackson County,3,7,3200,1985,1215
50,12,63,Florida,Jackson County,3,8,3613,2300,1313
50,12,63,Florida,Jackson County,3,9,3441,2107,1334
50,12,63,Florida,Jackson County,3,10,3746,2194,1552
50,12,63,Florida,Jackson County,3,11,3726,2054,1672
50,12,63,Florida,Jackson County,3,12,3462,1844,1618
50,12,63,Florida,Jackson County,3,13,3058,1593,1465
50,12,63,Florida,Jackson County,3,14,2497,1188,1309
50,12,63,Florida,Jackson County,3,15,1889,864,1025
50,12,63,Florida,Jackson County,3,16,1433,616,817
50,12,63,Florida,Jackson County,3,17,1056,429,627
50,12,63,Florida,Jackson County,3,18,982,311,671
50,12,63,Florida,Jackson County,4,0,49197,26865,22332
50,12,63,Florida,Jackson County,4,1,2490,1287,1203
50,12,63,Florida,Jackson County,4,2,2667,1401,1266
50,12,63,Florida,Jackson County,4,3,2725,1379,1346
50,12,63,Florida,Jackson County,4,4,2923,1558,1365
50,12,63,Florida,Jackson County,4,5,3347,2029,1318
50,12,63,Florida,Jackson County,4,6,3089,1891,1198
50,12,63,Florida,Jackson County,4,7,3186,1966,1220
50,12,63,Florida,Jackson County,4,8,3521,2242,1279
50,12,63,Florida,Jackson County,4,9,3396,2078,1318
50,12,63,Florida,Jackson County,4,10,3586,2085,1501
50,12,63,Florida,Jackson County,4,11,3633,2005,1628
50,12,63,Florida,Jackson County,4,12,3474,1843,1631
50,12,63,Florida,Jackson County,4,13,3146,1622,1524
50,12,63,Florida,Jackson County,4,14,2564,1224,1340
50,12,63,Florida,Jackson County,4,15,1915,860,1055
50,12,63,Florida,Jackson County,4,16,1450,629,821
50,12,63,Florida,Jackson County,4,17,1062,433,629
50,12,63,Florida,Jackson County,4,18,1023,333,690
50,12,63,Florida,Jackson County,5,0,49109,27099,22010
50,12,63,Florida,Jackson County,5,1,2363,1226,1137
50,12,63,Florida,Jackson County,5,2,2612,1364,1248
50,12,63,Florida,Jackson County,5,3,2695,1366,1329
50,12,63,Florida,Jackson County,5,4,2773,1484,1289
50,12,63,Florida,Jackson County,5,5,3404,2094,1310
50,12,63,Florida,Jackson County,5,6,3086,1935,1151
50,12,63,Florida,Jackson County,5,7,3240,2029,1211
50,12,63,Florida,Jackson County,5,8,3578,2300,1278
50,12,63,Florida,Jackson County,5,9,3442,2141,1301
50,12,63,Florida,Jackson County,5,10,3513,2071,1442
50,12,63,Florida,Jackson County,5,11,3576,2015,1561
50,12,63,Florida,Jackson County,5,12,3466,1854,1612
50,12,63,Florida,Jackson County,5,13,3095,1615,1480
50,12,63,Florida,Jackson County,5,14,2711,1287,1424
50,12,63,Florida,Jackson County,5,15,1965,890,1075
50,12,63,Florida,Jackson County,5,16,1446,623,823
50,12,63,Florida,Jackson County,5,17,1087,440,647
50,12,63,Florida,Jackson County,5,18,1057,365,692
50,12,63,Florida,Jackson County,6,0,48880,26956,21924
50,12,63,Florida,Jackson County,6,1,2422,1281,1141
50,12,63,Florida,Jackson County,6,2,2553,1327,1226
50,12,63,Florida,Jackson County,6,3,2629,1347,1282
50,12,63,Florida,Jackson County,6,4,2678,1435,1243
50,12,63,Florida,Jackson County,6,5,3406,2088,1318
50,12,63,Florida,Jackson County,6,6,3103,1955,1148
50,12,63,Florida,Jackson County,6,7,3243,2015,1228
50,12,63,Florida,Jackson County,6,8,3448,2224,1224
50,12,63,Florida,Jackson County,6,9,3390,2110,1280
50,12,63,Florida,Jackson County,6,10,3404,2021,1383
50,12,63,Florida,Jackson County,6,11,3523,1950,1573
50,12,63,Florida,Jackson County,6,12,3440,1838,1602
50,12,63,Florida,Jackson County,6,13,3135,1637,1498
50,12,63,Florida,Jackson County,6,14,2745,1313,1432
50,12,63,Florida,Jackson County,6,15,2080,942,1138
50,12,63,Florida,Jackson County,6,16,1528,672,856
50,12,63,Florida,Jackson County,6,17,1106,452,654
50,12,63,Florida,Jackson County,6,18,1047,349,698
50,12,63,Florida,Jackson County,7,0,48730,26937,21793
50,12,63,Florida,Jackson County,7,1,2368,1248,1120
50,12,63,Florida,Jackson County,7,2,2547,1335,1212
50,12,63,Florida,Jackson County,7,3,2621,1365,1256
50,12,63,Florida,Jackson County,7,4,2609,1384,1225
50,12,63,Florida,Jackson County,7,5,3342,2070,1272
50,12,63,Florida,Jackson County,7,6,3138,1948,1190
50,12,63,Florida,Jackson County,7,7,3247,2037,1210
50,12,63,Florida,Jackson County,7,8,3462,2249,1213
50,12,63,Florida,Jackson County,7,9,3369,2097,1272
50,12,63,Florida,Jackson County,7,10,3297,1988,1309
50,12,63,Florida,Jackson County,7,11,3488,1932,1556
50,12,63,Florida,Jackson County,7,12,3451,1845,1606
50,12,63,Florida,Jackson County,7,13,3115,1599,1516
50,12,63,Florida,Jackson County,7,14,2725,1328,1397
50,12,63,Florida,Jackson County,7,15,2184,986,1198
50,12,63,Florida,Jackson County,7,16,1572,692,880
50,12,63,Florida,Jackson County,7,17,1125,465,660
50,12,63,Florida,Jackson County,7,18,1070,369,701
50,12,63,Florida,Jackson County,8,0,48609,26859,21750
50,12,63,Florida,Jackson County,8,1,2387,1241,1146
50,12,63,Florida,Jackson County,8,2,2457,1298,1159
50,12,63,Florida,Jackson County,8,3,2573,1357,1216
50,12,63,Florida,Jackson County,8,4,2675,1423,1252
50,12,63,Florida,Jackson County,8,5,3231,2003,1228
50,12,63,Florida,Jackson County,8,6,3222,1989,1233
50,12,63,Florida,Jackson County,8,7,3227,2002,1225
50,12,63,Florida,Jackson County,8,8,3414,2229,1185
50,12,63,Florida,Jackson County,8,9,3348,2079,1269
50,12,63,Florida,Jackson County,8,10,3277,1964,1313
50,12,63,Florida,Jackson County,8,11,3393,1894,1499
50,12,63,Florida,Jackson County,8,12,3398,1804,1594
50,12,63,Florida,Jackson County,8,13,3158,1626,1532
50,12,63,Florida,Jackson County,8,14,2753,1361,1392
50,12,63,Florida,Jackson County,8,15,2233,1015,1218
50,12,63,Florida,Jackson County,8,16,1612,706,906
50,12,63,Florida,Jackson County,8,17,1128,471,657
50,12,63,Florida,Jackson County,8,18,1123,397,726
50,12,63,Florida,Jackson County,9,0,48299,26671,21628
50,12,63,Florida,Jackson County,9,1,2449,1269,1180
50,12,63,Florida,Jackson County,9,2,2380,1262,1118
50,12,63,Florida,Jackson County,9,3,2510,1323,1187
50,12,63,Florida,Jackson County,9,4,2719,1438,1281
50,12,63,Florida,Jackson County,9,5,3071,1946,1125
50,12,63,Florida,Jackson County,9,6,3348,2045,1303
50,12,63,Florida,Jackson County,9,7,3164,1995,1169
50,12,63,Florida,Jackson County,9,8,3374,2172,1202
50,12,63,Florida,Jackson County,9,9,3290,2036,1254
50,12,63,Florida,Jackson County,9,10,3202,1935,1267
50,12,63,Florida,Jackson County,9,11,3271,1824,1447
50,12,63,Florida,Jackson County,9,12,3303,1746,1557
50,12,63,Florida,Jackson County,9,13,3194,1644,1550
50,12,63,Florida,Jackson County,9,14,2829,1391,1438
50,12,63,Florida,Jackson County,9,15,2285,1051,1234
50,12,63,Florida,Jackson County,9,16,1622,699,923
50,12,63,Florida,Jackson County,9,17,1179,482,697
50,12,63,Florida,Jackson County,9,18,1109,413,696
50,12,63,Florida,Jackson County,10,0,48289,26607,21682
50,12,63,Florida,Jackson County,10,1,2447,1273,1174
50,12,63,Florida,Jackson County,10,2,2369,1257,1112
50,12,63,Florida,Jackson County,10,3,2557,1332,1225
50,12,63,Florida,Jackson County,10,4,2765,1466,1299
50,12,63,Florida,Jackson County,10,5,2993,1912,1081
50,12,63,Florida,Jackson County,10,6,3314,1985,1329
50,12,63,Florida,Jackson County,10,7,3196,2007,1189
50,12,63,Florida,Jackson County,10,8,3407,2198,1209
50,12,63,Florida,Jackson County,10,9,3280,2031,1249
50,12,63,Florida,Jackson County,10,10,3160,1905,1255
50,12,63,Florida,Jackson County,10,11,3163,1778,1385
50,12,63,Florida,Jackson County,10,12,3234,1725,1509
50,12,63,Florida,Jackson County,10,13,3185,1634,1551
50,12,63,Florida,Jackson County,10,14,2788,1373,1415
50,12,63,Florida,Jackson County,10,15,2409,1097,1312
50,12,63,Florida,Jackson County,10,16,1687,728,959
50,12,63,Florida,Jackson County,10,17,1181,487,694
50,12,63,Florida,Jackson County,10,18,1154,419,735
50,12,63,Florida,Jackson County,11,0,48112,26505,21607
50,12,63,Florida,Jackson County,11,1,2442,1278,1164
50,12,63,Florida,Jackson County,11,2,2349,1247,1102
50,12,63,Florida,Jackson County,11,3,2535,1334,1201
50,12,63,Florida,Jackson County,11,4,2660,1422,1238
50,12,63,Florida,Jackson County,11,5,2913,1824,1089
50,12,63,Florida,Jackson County,11,6,3347,2034,1313
50,12,63,Florida,Jackson County,11,7,3158,1998,1160
50,12,63,Florida,Jackson County,11,8,3430,2222,1208
50,12,63,Florida,Jackson County,11,9,3227,2004,1223
50,12,63,Florida,Jackson County,11,10,3194,1925,1269
50,12,63,Florida,Jackson County,11,11,3048,1714,1334
50,12,63,Florida,Jackson County,11,12,3224,1697,1527
50,12,63,Florida,Jackson County,11,13,3186,1614,1572
50,12,63,Florida,Jackson County,11,14,2786,1396,1390
50,12,63,Florida,Jackson County,11,15,2444,1113,1331
50,12,63,Florida,Jackson County,11,16,1765,748,1017
50,12,63,Florida,Jackson County,11,17,1244,527,717
50,12,63,Florida,Jackson County,11,18,1160,408,752
50,12,63,Florida,Jackson County,12,0,46414,25020,21394
50,12,63,Florida,Jackson County,12,1,2427,1285,1142
50,12,63,Florida,Jackson County,12,2,2289,1179,1110
50,12,63,Florida,Jackson County,12,3,2483,1311,1172
50,12,63,Florida,Jackson County,12,4,2598,1399,1199
50,12,63,Florida,Jackson County,12,5,2727,1654,1073
50,12,63,Florida,Jackson County,12,6,3133,1862,1271
50,12,63,Florida,Jackson County,12,7,2925,1765,1160
50,12,63,Florida,Jackson County,12,8,3165,1984,1181
50,12,63,Florida,Jackson County,12,9,3006,1802,1204
50,12,63,Florida,Jackson County,12,10,3026,1764,1262
50,12,63,Florida,Jackson County,12,11,2813,1541,1272
50,12,63,Florida,Jackson County,12,12,3120,1625,1495
50,12,63,Florida,Jackson County,12,13,3132,1592,1540
50,12,63,Florida,Jackson County,12,14,2809,1385,1424
50,12,63,Florida,Jackson County,12,15,2444,1126,1318
50,12,63,Florida,Jackson County,12,16,1863,794,1069
50,12,63,Florida,Jackson County,12,17,1282,539,743
50,12,63,Florida,Jackson County,12,18,1172,413,759
50,12,65,Florida,Jefferson County,1,0,14761,7727,7034
50,12,65,Florida,Jefferson County,1,1,777,406,371
50,12,65,Florida,Jefferson County,1,2,766,392,374
50,12,65,Florida,Jefferson County,1,3,756,391,365
50,12,65,Florida,Jefferson County,1,4,765,387,378
50,12,65,Florida,Jefferson County,1,5,810,433,377
50,12,65,Florida,Jefferson County,1,6,827,509,318
50,12,65,Florida,Jefferson County,1,7,942,570,372
50,12,65,Florida,Jefferson County,1,8,905,525,380
50,12,65,Florida,Jefferson County,1,9,1015,566,449
50,12,65,Florida,Jefferson County,1,10,1152,645,507
50,12,65,Florida,Jefferson County,1,11,1275,659,616
50,12,65,Florida,Jefferson County,1,12,1233,579,654
50,12,65,Florida,Jefferson County,1,13,1106,577,529
50,12,65,Florida,Jefferson County,1,14,849,416,433
50,12,65,Florida,Jefferson County,1,15,564,275,289
50,12,65,Florida,Jefferson County,1,16,387,163,224
50,12,65,Florida,Jefferson County,1,17,337,138,199
50,12,65,Florida,Jefferson County,1,18,295,96,199
50,12,65,Florida,Jefferson County,2,0,14761,7726,7035
50,12,65,Florida,Jefferson County,2,1,777,406,371
50,12,65,Florida,Jefferson County,2,2,766,392,374
50,12,65,Florida,Jefferson County,2,3,756,391,365
50,12,65,Florida,Jefferson County,2,4,765,387,378
50,12,65,Florida,Jefferson County,2,5,810,433,377
50,12,65,Florida,Jefferson County,2,6,827,509,318
50,12,65,Florida,Jefferson County,2,7,942,570,372
50,12,65,Florida,Jefferson County,2,8,905,525,380
50,12,65,Florida,Jefferson County,2,9,1015,566,449
50,12,65,Florida,Jefferson County,2,10,1152,645,507
50,12,65,Florida,Jefferson County,2,11,1275,659,616
50,12,65,Florida,Jefferson County,2,12,1233,579,654
50,12,65,Florida,Jefferson County,2,13,1106,576,530
50,12,65,Florida,Jefferson County,2,14,848,416,432
50,12,65,Florida,Jefferson County,2,15,565,275,290
50,12,65,Florida,Jefferson County,2,16,387,163,224
50,12,65,Florida,Jefferson County,2,17,337,138,199
50,12,65,Florida,Jefferson County,2,18,295,96,199
50,12,65,Florida,Jefferson County,3,0,14755,7712,7043
50,12,65,Florida,Jefferson County,3,1,774,401,373
50,12,65,Florida,Jefferson County,3,2,759,392,367
50,12,65,Florida,Jefferson County,3,3,757,391,366
50,12,65,Florida,Jefferson County,3,4,753,378,375
50,12,65,Florida,Jefferson County,3,5,817,434,383
50,12,65,Florida,Jefferson County,3,6,824,509,315
50,12,65,Florida,Jefferson County,3,7,942,568,374
50,12,65,Florida,Jefferson County,3,8,891,516,375
50,12,65,Florida,Jefferson County,3,9,1013,563,450
50,12,65,Florida,Jefferson County,3,10,1139,642,497
50,12,65,Florida,Jefferson County,3,11,1276,658,618
50,12,65,Florida,Jefferson County,3,12,1232,574,658
50,12,65,Florida,Jefferson County,3,13,1113,579,534
50,12,65,Florida,Jefferson County,3,14,862,425,437
50,12,65,Florida,Jefferson County,3,15,573,278,295
50,12,65,Florida,Jefferson County,3,16,386,167,219
50,12,65,Florida,Jefferson County,3,17,347,140,207
50,12,65,Florida,Jefferson County,3,18,297,97,200
50,12,65,Florida,Jefferson County,4,0,14529,7539,6990
50,12,65,Florida,Jefferson County,4,1,764,383,381
50,12,65,Florida,Jefferson County,4,2,741,387,354
50,12,65,Florida,Jefferson County,4,3,753,381,372
50,12,65,Florida,Jefferson County,4,4,698,352,346
50,12,65,Florida,Jefferson County,4,5,818,426,392
50,12,65,Florida,Jefferson County,4,6,788,495,293
50,12,65,Florida,Jefferson County,4,7,905,532,373
50,12,65,Florida,Jefferson County,4,8,849,504,345
50,12,65,Florida,Jefferson County,4,9,999,548,451
50,12,65,Florida,Jefferson County,4,10,1097,615,482
50,12,65,Florida,Jefferson County,4,11,1241,637,604
50,12,65,Florida,Jefferson County,4,12,1206,550,656
50,12,65,Florida,Jefferson County,4,13,1139,583,556
50,12,65,Florida,Jefferson County,4,14,911,454,457
50,12,65,Florida,Jefferson County,4,15,589,285,304
50,12,65,Florida,Jefferson County,4,16,385,177,208
50,12,65,Florida,Jefferson County,4,17,350,139,211
50,12,65,Florida,Jefferson County,4,18,296,91,205
50,12,65,Florida,Jefferson County,5,0,14219,7359,6860
50,12,65,Florida,Jefferson County,5,1,698,356,342
50,12,65,Florida,Jefferson County,5,2,707,357,350
50,12,65,Florida,Jefferson County,5,3,744,372,372
50,12,65,Florida,Jefferson County,5,4,664,347,317
50,12,65,Florida,Jefferson County,5,5,781,416,365
50,12,65,Florida,Jefferson County,5,6,766,459,307
50,12,65,Florida,Jefferson County,5,7,865,506,359
50,12,65,Florida,Jefferson County,5,8,816,491,325
50,12,65,Florida,Jefferson County,5,9,960,523,437
50,12,65,Florida,Jefferson County,5,10,1057,579,478
50,12,65,Florida,Jefferson County,5,11,1153,614,539
50,12,65,Florida,Jefferson County,5,12,1198,551,647
50,12,65,Florida,Jefferson County,5,13,1122,561,561
50,12,65,Florida,Jefferson County,5,14,1011,503,508
50,12,65,Florida,Jefferson County,5,15,611,301,310
50,12,65,Florida,Jefferson County,5,16,413,191,222
50,12,65,Florida,Jefferson County,5,17,354,137,217
50,12,65,Florida,Jefferson County,5,18,299,95,204
50,12,65,Florida,Jefferson County,6,0,14209,7410,6799
50,12,65,Florida,Jefferson County,6,1,686,368,318
50,12,65,Florida,Jefferson County,6,2,722,370,352
50,12,65,Florida,Jefferson County,6,3,730,363,367
50,12,65,Florida,Jefferson County,6,4,603,316,287
50,12,65,Florida,Jefferson County,6,5,807,430,377
50,12,65,Florida,Jefferson County,6,6,768,461,307
50,12,65,Florida,Jefferson County,6,7,848,507,341
50,12,65,Florida,Jefferson County,6,8,815,502,313
50,12,65,Florida,Jefferson County,6,9,954,538,416
50,12,65,Florida,Jefferson County,6,10,1041,557,484
50,12,65,Florida,Jefferson County,6,11,1129,603,526
50,12,65,Florida,Jefferson County,6,12,1197,574,623
50,12,65,Florida,Jefferson County,6,13,1123,547,576
50,12,65,Florida,Jefferson County,6,14,1008,493,515
50,12,65,Florida,Jefferson County,6,15,677,339,338
50,12,65,Florida,Jefferson County,6,16,436,198,238
50,12,65,Florida,Jefferson County,6,17,336,124,212
50,12,65,Florida,Jefferson County,6,18,329,120,209
50,12,65,Florida,Jefferson County,7,0,14056,7349,6707
50,12,65,Florida,Jefferson County,7,1,657,338,319
50,12,65,Florida,Jefferson County,7,2,717,364,353
50,12,65,Florida,Jefferson County,7,3,707,357,350
50,12,65,Florida,Jefferson County,7,4,587,307,280
50,12,65,Florida,Jefferson County,7,5,744,419,325
50,12,65,Florida,Jefferson County,7,6,802,464,338
50,12,65,Florida,Jefferson County,7,7,822,513,309
50,12,65,Florida,Jefferson County,7,8,790,480,310
50,12,65,Florida,Jefferson County,7,9,945,542,403
50,12,65,Florida,Jefferson County,7,10,997,538,459
50,12,65,Florida,Jefferson County,7,11,1142,612,530
50,12,65,Florida,Jefferson County,7,12,1145,560,585
50,12,65,Florida,Jefferson County,7,13,1144,540,604
50,12,65,Florida,Jefferson County,7,14,1005,495,510
50,12,65,Florida,Jefferson County,7,15,733,369,364
50,12,65,Florida,Jefferson County,7,16,454,215,239
50,12,65,Florida,Jefferson County,7,17,306,98,208
50,12,65,Florida,Jefferson County,7,18,359,138,221
50,12,65,Florida,Jefferson County,8,0,14115,7425,6690
50,12,65,Florida,Jefferson County,8,1,646,340,306
50,12,65,Florida,Jefferson County,8,2,727,377,350
50,12,65,Florida,Jefferson County,8,3,673,354,319
50,12,65,Florida,Jefferson County,8,4,648,334,314
50,12,65,Florida,Jefferson County,8,5,709,409,300
50,12,65,Florida,Jefferson County,8,6,846,499,347
50,12,65,Florida,Jefferson County,8,7,816,511,305
50,12,65,Florida,Jefferson County,8,8,795,475,320
50,12,65,Florida,Jefferson County,8,9,892,518,374
50,12,65,Florida,Jefferson County,8,10,992,526,466
50,12,65,Florida,Jefferson County,8,11,1079,592,487
50,12,65,Florida,Jefferson County,8,12,1161,578,583
50,12,65,Florida,Jefferson County,8,13,1150,517,633
50,12,65,Florida,Jefferson County,8,14,1048,538,510
50,12,65,Florida,Jefferson County,8,15,780,387,393
50,12,65,Florida,Jefferson County,8,16,482,229,253
50,12,65,Florida,Jefferson County,8,17,282,105,177
50,12,65,Florida,Jefferson County,8,18,389,136,253
50,12,65,Florida,Jefferson County,9,0,13960,7296,6664
50,12,65,Florida,Jefferson County,9,1,651,349,302
50,12,65,Florida,Jefferson County,9,2,728,378,350
50,12,65,Florida,Jefferson County,9,3,664,352,312
50,12,65,Florida,Jefferson County,9,4,650,336,314
50,12,65,Florida,Jefferson County,9,5,654,366,288
50,12,65,Florida,Jefferson County,9,6,850,481,369
50,12,65,Florida,Jefferson County,9,7,776,497,279
50,12,65,Florida,Jefferson County,9,8,797,470,327
50,12,65,Florida,Jefferson County,9,9,810,479,331
50,12,65,Florida,Jefferson County,9,10,987,512,475
50,12,65,Florida,Jefferson County,9,11,1050,581,469
50,12,65,Florida,Jefferson County,9,12,1125,548,577
50,12,65,Florida,Jefferson County,9,13,1136,512,624
50,12,65,Florida,Jefferson County,9,14,1084,551,533
50,12,65,Florida,Jefferson County,9,15,813,399,414
50,12,65,Florida,Jefferson County,9,16,495,232,263
50,12,65,Florida,Jefferson County,9,17,295,114,181
50,12,65,Florida,Jefferson County,9,18,395,139,256
50,12,65,Florida,Jefferson County,10,0,14165,7408,6757
50,12,65,Florida,Jefferson County,10,1,667,352,315
50,12,65,Florida,Jefferson County,10,2,731,389,342
50,12,65,Florida,Jefferson County,10,3,674,335,339
50,12,65,Florida,Jefferson County,10,4,650,331,319
50,12,65,Florida,Jefferson County,10,5,656,368,288
50,12,65,Florida,Jefferson County,10,6,849,494,355
50,12,65,Florida,Jefferson County,10,7,805,512,293
50,12,65,Florida,Jefferson County,10,8,811,473,338
50,12,65,Florida,Jefferson County,10,9,801,498,303
50,12,65,Florida,Jefferson County,10,10,991,515,476
50,12,65,Florida,Jefferson County,10,11,1057,579,478
50,12,65,Florida,Jefferson County,10,12,1113,551,562
50,12,65,Florida,Jefferson County,10,13,1145,523,622
50,12,65,Florida,Jefferson County,10,14,1080,544,536
50,12,65,Florida,Jefferson County,10,15,906,430,476
50,12,65,Florida,Jefferson County,10,16,516,247,269
50,12,65,Florida,Jefferson County,10,17,320,130,190
50,12,65,Florida,Jefferson County,10,18,393,137,256
50,12,65,Florida,Jefferson County,11,0,14321,7500,6821
50,12,65,Florida,Jefferson County,11,1,641,354,287
50,12,65,Florida,Jefferson County,11,2,692,352,340
50,12,65,Florida,Jefferson County,11,3,720,367,353
50,12,65,Florida,Jefferson County,11,4,638,322,316
50,12,65,Florida,Jefferson County,11,5,650,374,276
50,12,65,Florida,Jefferson County,11,6,856,518,338
50,12,65,Florida,Jefferson County,11,7,812,498,314
50,12,65,Florida,Jefferson County,11,8,798,471,327
50,12,65,Florida,Jefferson County,11,9,841,518,323
50,12,65,Florida,Jefferson County,11,10,970,503,467
50,12,65,Florida,Jefferson County,11,11,1086,587,499
50,12,65,Florida,Jefferson County,11,12,1111,548,563
50,12,65,Florida,Jefferson County,11,13,1140,538,602
50,12,65,Florida,Jefferson County,11,14,1098,541,557
50,12,65,Florida,Jefferson County,11,15,943,442,501
50,12,65,Florida,Jefferson County,11,16,576,284,292
50,12,65,Florida,Jefferson County,11,17,362,152,210
50,12,65,Florida,Jefferson County,11,18,387,131,256
50,12,65,Florida,Jefferson County,12,0,14246,7485,6761
50,12,65,Florida,Jefferson County,12,1,605,341,264
50,12,65,Florida,Jefferson County,12,2,657,329,328
50,12,65,Florida,Jefferson County,12,3,712,366,346
50,12,65,Florida,Jefferson County,12,4,632,329,303
50,12,65,Florida,Jefferson County,12,5,619,360,259
50,12,65,Florida,Jefferson County,12,6,831,519,312
50,12,65,Florida,Jefferson County,12,7,814,489,325
50,12,65,Florida,Jefferson County,12,8,796,472,324
50,12,65,Florida,Jefferson County,12,9,821,515,306
50,12,65,Florida,Jefferson County,12,10,955,508,447
50,12,65,Florida,Jefferson County,12,11,1029,554,475
50,12,65,Florida,Jefferson County,12,12,1123,544,579
50,12,65,Florida,Jefferson County,12,13,1141,538,603
50,12,65,Florida,Jefferson County,12,14,1124,531,593
50,12,65,Florida,Jefferson County,12,15,950,462,488
50,12,65,Florida,Jefferson County,12,16,652,327,325
50,12,65,Florida,Jefferson County,12,17,405,179,226
50,12,65,Florida,Jefferson County,12,18,380,122,258
50,12,67,Florida,Lafayette County,1,0,8870,5481,3389
50,12,67,Florida,Lafayette County,1,1,487,249,238
50,12,67,Florida,Lafayette County,1,2,541,268,273
50,12,67,Florida,Lafayette County,1,3,466,232,234
50,12,67,Florida,Lafayette County,1,4,541,321,220
50,12,67,Florida,Lafayette County,1,5,813,636,177
50,12,67,Florida,Lafayette County,1,6,732,536,196
50,12,67,Florida,Lafayette County,1,7,692,504,188
50,12,67,Florida,Lafayette County,1,8,733,508,225
50,12,67,Florida,Lafayette County,1,9,630,439,191
50,12,67,Florida,Lafayette County,1,10,665,435,230
50,12,67,Florida,Lafayette County,1,11,560,340,220
50,12,67,Florida,Lafayette County,1,12,497,273,224
50,12,67,Florida,Lafayette County,1,13,429,231,198
50,12,67,Florida,Lafayette County,1,14,357,179,178
50,12,67,Florida,Lafayette County,1,15,284,135,149
50,12,67,Florida,Lafayette County,1,16,208,108,100
50,12,67,Florida,Lafayette County,1,17,123,51,72
50,12,67,Florida,Lafayette County,1,18,112,36,76
50,12,67,Florida,Lafayette County,2,0,8868,5480,3388
50,12,67,Florida,Lafayette County,2,1,487,249,238
50,12,67,Florida,Lafayette County,2,2,541,268,273
50,12,67,Florida,Lafayette County,2,3,466,232,234
50,12,67,Florida,Lafayette County,2,4,541,321,220
50,12,67,Florida,Lafayette County,2,5,813,636,177
50,12,67,Florida,Lafayette County,2,6,732,536,196
50,12,67,Florida,Lafayette County,2,7,692,504,188
50,12,67,Florida,Lafayette County,2,8,733,508,225
50,12,67,Florida,Lafayette County,2,9,630,439,191
50,12,67,Florida,Lafayette County,2,10,665,435,230
50,12,67,Florida,Lafayette County,2,11,558,339,219
50,12,67,Florida,Lafayette County,2,12,497,273,224
50,12,67,Florida,Lafayette County,2,13,429,231,198
50,12,67,Florida,Lafayette County,2,14,357,179,178
50,12,67,Florida,Lafayette County,2,15,284,135,149
50,12,67,Florida,Lafayette County,2,16,208,108,100
50,12,67,Florida,Lafayette County,2,17,123,51,72
50,12,67,Florida,Lafayette County,2,18,112,36,76
50,12,67,Florida,Lafayette County,3,0,8808,5408,3400
50,12,67,Florida,Lafayette County,3,1,480,243,237
50,12,67,Florida,Lafayette County,3,2,544,272,272
50,12,67,Florida,Lafayette County,3,3,470,233,237
50,12,67,Florida,Lafayette County,3,4,530,314,216
50,12,67,Florida,Lafayette County,3,5,805,623,182
50,12,67,Florida,Lafayette County,3,6,712,516,196
50,12,67,Florida,Lafayette County,3,7,684,496,188
50,12,67,Florida,Lafayette County,3,8,724,500,224
50,12,67,Florida,Lafayette County,3,9,618,430,188
50,12,67,Florida,Lafayette County,3,10,663,429,234
50,12,67,Florida,Lafayette County,3,11,557,338,219
50,12,67,Florida,Lafayette County,3,12,499,274,225
50,12,67,Florida,Lafayette County,3,13,432,234,198
50,12,67,Florida,Lafayette County,3,14,356,176,180
50,12,67,Florida,Lafayette County,3,15,287,134,153
50,12,67,Florida,Lafayette County,3,16,202,105,97
50,12,67,Florida,Lafayette County,3,17,130,54,76
50,12,67,Florida,Lafayette County,3,18,115,37,78
50,12,67,Florida,Lafayette County,4,0,8798,5355,3443
50,12,67,Florida,Lafayette County,4,1,460,218,242
50,12,67,Florida,Lafayette County,4,2,543,282,261
50,12,67,Florida,Lafayette County,4,3,491,236,255
50,12,67,Florida,Lafayette County,4,4,509,298,211
50,12,67,Florida,Lafayette County,4,5,805,621,184
50,12,67,Florida,Lafayette County,4,6,711,513,198
50,12,67,Florida,Lafayette County,4,7,684,488,196
50,12,67,Florida,Lafayette County,4,8,702,498,204
50,12,67,Florida,Lafayette County,4,9,628,428,200
50,12,67,Florida,Lafayette County,4,10,651,419,232
50,12,67,Florida,Lafayette County,4,11,550,336,214
50,12,67,Florida,Lafayette County,4,12,488,269,219
50,12,67,Florida,Lafayette County,4,13,450,240,210
50,12,67,Florida,Lafayette County,4,14,357,164,193
50,12,67,Florida,Lafayette County,4,15,308,148,160
50,12,67,Florida,Lafayette County,4,16,196,100,96
50,12,67,Florida,Lafayette County,4,17,143,62,81
50,12,67,Florida,Lafayette County,4,18,122,35,87
50,12,67,Florida,Lafayette County,5,0,8791,5276,3515
50,12,67,Florida,Lafayette County,5,1,474,206,268
50,12,67,Florida,Lafayette County,5,2,541,289,252
50,12,67,Florida,Lafayette County,5,3,488,228,260
50,12,67,Florida,Lafayette County,5,4,523,305,218
50,12,67,Florida,Lafayette County,5,5,814,619,195
50,12,67,Florida,Lafayette County,5,6,650,477,173
50,12,67,Florida,Lafayette County,5,7,676,466,210
50,12,67,Florida,Lafayette County,5,8,659,464,195
50,12,67,Florida,Lafayette County,5,9,671,455,216
50,12,67,Florida,Lafayette County,5,10,637,399,238
50,12,67,Florida,Lafayette County,5,11,544,322,222
50,12,67,Florida,Lafayette County,5,12,476,261,215
50,12,67,Florida,Lafayette County,5,13,454,242,212
50,12,67,Florida,Lafayette County,5,14,389,190,199
50,12,67,Florida,Lafayette County,5,15,304,139,165
50,12,67,Florida,Lafayette County,5,16,224,115,109
50,12,67,Florida,Lafayette County,5,17,138,60,78
50,12,67,Florida,Lafayette County,5,18,129,39,90
50,12,67,Florida,Lafayette County,6,0,8819,5268,3551
50,12,67,Florida,Lafayette County,6,1,466,202,264
50,12,67,Florida,Lafayette County,6,2,546,296,250
50,12,67,Florida,Lafayette County,6,3,524,237,287
50,12,67,Florida,Lafayette County,6,4,507,294,213
50,12,67,Florida,Lafayette County,6,5,792,602,190
50,12,67,Florida,Lafayette County,6,6,639,469,170
50,12,67,Florida,Lafayette County,6,7,669,451,218
50,12,67,Florida,Lafayette County,6,8,651,450,201
50,12,67,Florida,Lafayette County,6,9,702,477,225
50,12,67,Florida,Lafayette County,6,10,611,379,232
50,12,67,Florida,Lafayette County,6,11,564,344,220
50,12,67,Florida,Lafayette County,6,12,477,264,213
50,12,67,Florida,Lafayette County,6,13,469,258,211
50,12,67,Florida,Lafayette County,6,14,381,184,197
50,12,67,Florida,Lafayette County,6,15,307,138,169
50,12,67,Florida,Lafayette County,6,16,233,118,115
50,12,67,Florida,Lafayette County,6,17,141,57,84
50,12,67,Florida,Lafayette County,6,18,140,48,92
50,12,67,Florida,Lafayette County,7,0,8862,5290,3572
50,12,67,Florida,Lafayette County,7,1,431,191,240
50,12,67,Florida,Lafayette County,7,2,549,279,270
50,12,67,Florida,Lafayette County,7,3,541,263,278
50,12,67,Florida,Lafayette County,7,4,524,304,220
50,12,67,Florida,Lafayette County,7,5,801,603,198
50,12,67,Florida,Lafayette County,7,6,642,479,163
50,12,67,Florida,Lafayette County,7,7,671,461,210
50,12,67,Florida,Lafayette County,7,8,647,437,210
50,12,67,Florida,Lafayette County,7,9,695,465,230
50,12,67,Florida,Lafayette County,7,10,593,386,207
50,12,67,Florida,Lafayette County,7,11,580,339,241
50,12,67,Florida,Lafayette County,7,12,483,274,209
50,12,67,Florida,Lafayette County,7,13,468,244,224
50,12,67,Florida,Lafayette County,7,14,393,191,202
50,12,67,Florida,Lafayette County,7,15,314,141,173
50,12,67,Florida,Lafayette County,7,16,244,117,127
50,12,67,Florida,Lafayette County,7,17,150,66,84
50,12,67,Florida,Lafayette County,7,18,136,50,86
50,12,67,Florida,Lafayette County,8,0,8724,5140,3584
50,12,67,Florida,Lafayette County,8,1,397,176,221
50,12,67,Florida,Lafayette County,8,2,501,239,262
50,12,67,Florida,Lafayette County,8,3,557,272,285
50,12,67,Florida,Lafayette County,8,4,518,290,228
50,12,67,Florida,Lafayette County,8,5,753,566,187
50,12,67,Florida,Lafayette County,8,6,644,461,183
50,12,67,Florida,Lafayette County,8,7,639,445,194
50,12,67,Florida,Lafayette County,8,8,623,420,203
50,12,67,Florida,Lafayette County,8,9,691,450,241
50,12,67,Florida,Lafayette County,8,10,580,379,201
50,12,67,Florida,Lafayette County,8,11,601,348,253
50,12,67,Florida,Lafayette County,8,12,476,267,209
50,12,67,Florida,Lafayette County,8,13,483,248,235
50,12,67,Florida,Lafayette County,8,14,388,190,198
50,12,67,Florida,Lafayette County,8,15,337,152,185
50,12,67,Florida,Lafayette County,8,16,243,116,127
50,12,67,Florida,Lafayette County,8,17,150,67,83
50,12,67,Florida,Lafayette County,8,18,143,54,89
50,12,67,Florida,Lafayette County,9,0,8747,5150,3597
50,12,67,Florida,Lafayette County,9,1,372,171,201
50,12,67,Florida,Lafayette County,9,2,503,233,270
50,12,67,Florida,Lafayette County,9,3,558,281,277
50,12,67,Florida,Lafayette County,9,4,550,308,242
50,12,67,Florida,Lafayette County,9,5,714,546,168
50,12,67,Florida,Lafayette County,9,6,695,474,221
50,12,67,Florida,Lafayette County,9,7,620,431,189
50,12,67,Florida,Lafayette County,9,8,629,418,211
50,12,67,Florida,Lafayette County,9,9,699,451,248
50,12,67,Florida,Lafayette County,9,10,596,385,211
50,12,67,Florida,Lafayette County,9,11,572,332,240
50,12,67,Florida,Lafayette County,9,12,472,269,203
50,12,67,Florida,Lafayette County,9,13,485,256,229
50,12,67,Florida,Lafayette County,9,14,408,204,204
50,12,67,Florida,Lafayette County,9,15,331,146,185
50,12,67,Florida,Lafayette County,9,16,252,122,130
50,12,67,Florida,Lafayette County,9,17,143,65,78
50,12,67,Florida,Lafayette County,9,18,148,58,90
50,12,67,Florida,Lafayette County,10,0,8602,4931,3671
50,12,67,Florida,Lafayette County,10,1,385,176,209
50,12,67,Florida,Lafayette County,10,2,493,215,278
50,12,67,Florida,Lafayette County,10,3,543,275,268
50,12,67,Florida,Lafayette County,10,4,559,301,258
50,12,67,Florida,Lafayette County,10,5,684,505,179
50,12,67,Florida,Lafayette County,10,6,669,436,233
50,12,67,Florida,Lafayette County,10,7,555,396,159
50,12,67,Florida,Lafayette County,10,8,605,372,233
50,12,67,Florida,Lafayette County,10,9,653,410,243
50,12,67,Florida,Lafayette County,10,10,620,400,220
50,12,67,Florida,Lafayette County,10,11,533,293,240
50,12,67,Florida,Lafayette County,10,12,480,271,209
50,12,67,Florida,Lafayette County,10,13,465,241,224
50,12,67,Florida,Lafayette County,10,14,423,219,204
50,12,67,Florida,Lafayette County,10,15,355,167,188
50,12,67,Florida,Lafayette County,10,16,261,118,143
50,12,67,Florida,Lafayette County,10,17,168,79,89
50,12,67,Florida,Lafayette County,10,18,151,57,94
50,12,67,Florida,Lafayette County,11,0,8691,4952,3739
50,12,67,Florida,Lafayette County,11,1,379,172,207
50,12,67,Florida,Lafayette County,11,2,472,196,276
50,12,67,Florida,Lafayette County,11,3,545,279,266
50,12,67,Florida,Lafayette County,11,4,576,321,255
50,12,67,Florida,Lafayette County,11,5,673,511,162
50,12,67,Florida,Lafayette County,11,6,701,440,261
50,12,67,Florida,Lafayette County,11,7,546,384,162
50,12,67,Florida,Lafayette County,11,8,603,367,236
50,12,67,Florida,Lafayette County,11,9,667,394,273
50,12,67,Florida,Lafayette County,11,10,647,422,225
50,12,67,Florida,Lafayette County,11,11,520,282,238
50,12,67,Florida,Lafayette County,11,12,509,293,216
50,12,67,Florida,Lafayette County,11,13,465,237,228
50,12,67,Florida,Lafayette County,11,14,442,234,208
50,12,67,Florida,Lafayette County,11,15,346,162,184
50,12,67,Florida,Lafayette County,11,16,261,116,145
50,12,67,Florida,Lafayette County,11,17,183,83,100
50,12,67,Florida,Lafayette County,11,18,156,59,97
50,12,67,Florida,Lafayette County,12,0,8422,4720,3702
50,12,67,Florida,Lafayette County,12,1,337,160,177
50,12,67,Florida,Lafayette County,12,2,452,200,252
50,12,67,Florida,Lafayette County,12,3,557,276,281
50,12,67,Florida,Lafayette County,12,4,553,292,261
50,12,67,Florida,Lafayette County,12,5,638,474,164
50,12,67,Florida,Lafayette County,12,6,626,382,244
50,12,67,Florida,Lafayette County,12,7,531,368,163
50,12,67,Florida,Lafayette County,12,8,539,336,203
50,12,67,Florida,Lafayette County,12,9,634,358,276
50,12,67,Florida,Lafayette County,12,10,618,390,228
50,12,67,Florida,Lafayette County,12,11,484,273,211
50,12,67,Florida,Lafayette County,12,12,520,279,241
50,12,67,Florida,Lafayette County,12,13,478,253,225
50,12,67,Florida,Lafayette County,12,14,451,224,227
50,12,67,Florida,Lafayette County,12,15,381,188,193
50,12,67,Florida,Lafayette County,12,16,267,118,149
50,12,67,Florida,Lafayette County,12,17,199,89,110
50,12,67,Florida,Lafayette County,12,18,157,60,97
50,12,69,Florida,Lake County,1,0,297052,143937,153115
50,12,69,Florida,Lake County,1,1,16233,8304,7929
50,12,69,Florida,Lake County,1,2,17115,8701,8414
50,12,69,Florida,Lake County,1,3,17575,9077,8498
50,12,69,Florida,Lake County,1,4,17224,8832,8392
50,12,69,Florida,Lake County,1,5,13499,6850,6649
50,12,69,Florida,Lake County,1,6,14268,6937,7331
50,12,69,Florida,Lake County,1,7,14644,7140,7504
50,12,69,Florida,Lake County,1,8,16841,8114,8727
50,12,69,Florida,Lake County,1,9,18465,9172,9293
50,12,69,Florida,Lake County,1,10,20321,10126,10195
50,12,69,Florida,Lake County,1,11,19430,9359,10071
50,12,69,Florida,Lake County,1,12,18640,8658,9982
50,12,69,Florida,Lake County,1,13,20972,9472,11500
50,12,69,Florida,Lake County,1,14,21120,9813,11307
50,12,69,Florida,Lake County,1,15,17992,8684,9308
50,12,69,Florida,Lake County,1,16,14102,6879,7223
50,12,69,Florida,Lake County,1,17,10228,4613,5615
50,12,69,Florida,Lake County,1,18,8383,3206,5177
50,12,69,Florida,Lake County,2,0,297047,143934,153113
50,12,69,Florida,Lake County,2,1,16233,8304,7929
50,12,69,Florida,Lake County,2,2,17114,8700,8414
50,12,69,Florida,Lake County,2,3,17574,9077,8497
50,12,69,Florida,Lake County,2,4,17223,8833,8390
50,12,69,Florida,Lake County,2,5,13498,6849,6649
50,12,69,Florida,Lake County,2,6,14268,6937,7331
50,12,69,Florida,Lake County,2,7,14644,7140,7504
50,12,69,Florida,Lake County,2,8,16838,8113,8725
50,12,69,Florida,Lake County,2,9,18465,9171,9294
50,12,69,Florida,Lake County,2,10,20321,10126,10195
50,12,69,Florida,Lake County,2,11,19428,9359,10069
50,12,69,Florida,Lake County,2,12,18640,8658,9982
50,12,69,Florida,Lake County,2,13,20973,9472,11501
50,12,69,Florida,Lake County,2,14,21121,9813,11308
50,12,69,Florida,Lake County,2,15,17993,8684,9309
50,12,69,Florida,Lake County,2,16,14102,6879,7223
50,12,69,Florida,Lake County,2,17,10228,4613,5615
50,12,69,Florida,Lake County,2,18,8384,3206,5178
50,12,69,Florida,Lake County,3,0,297709,144225,153484
50,12,69,Florida,Lake County,3,1,16155,8275,7880
50,12,69,Florida,Lake County,3,2,17111,8691,8420
50,12,69,Florida,Lake County,3,3,17619,9110,8509
50,12,69,Florida,Lake County,3,4,17128,8785,8343
50,12,69,Florida,Lake County,3,5,13722,6953,6769
50,12,69,Florida,Lake County,3,6,14352,6979,7373
50,12,69,Florida,Lake County,3,7,14675,7152,7523
50,12,69,Florida,Lake County,3,8,16688,8032,8656
50,12,69,Florida,Lake County,3,9,18518,9176,9342
50,12,69,Florida,Lake County,3,10,20285,10092,10193
50,12,69,Florida,Lake County,3,11,19559,9453,10106
50,12,69,Florida,Lake County,3,12,18715,8683,10032
50,12,69,Florida,Lake County,3,13,20999,9499,11500
50,12,69,Florida,Lake County,3,14,21115,9797,11318
50,12,69,Florida,Lake County,3,15,18122,8723,9399
50,12,69,Florida,Lake County,3,16,14189,6933,7256
50,12,69,Florida,Lake County,3,17,10284,4655,5629
50,12,69,Florida,Lake County,3,18,8473,3237,5236
50,12,69,Florida,Lake County,4,0,300505,145384,155121
50,12,69,Florida,Lake County,4,1,16035,8240,7795
50,12,69,Florida,Lake County,4,2,17137,8682,8455
50,12,69,Florida,Lake County,4,3,17791,9181,8610
50,12,69,Florida,Lake County,4,4,16840,8634,8206
50,12,69,Florida,Lake County,4,5,14506,7285,7221
50,12,69,Florida,Lake County,4,6,14510,7070,7440
50,12,69,Florida,Lake County,4,7,14897,7198,7699
50,12,69,Florida,Lake County,4,8,16142,7774,8368
50,12,69,Florida,Lake County,4,9,18699,9235,9464
50,12,69,Florida,Lake County,4,10,19919,9905,10014
50,12,69,Florida,Lake County,4,11,20020,9723,10297
50,12,69,Florida,Lake County,4,12,18915,8697,10218
50,12,69,Florida,Lake County,4,13,21243,9664,11579
50,12,69,Florida,Lake County,4,14,21243,9776,11467
50,12,69,Florida,Lake County,4,15,18696,8884,9812
50,12,69,Florida,Lake County,4,16,14645,7177,7468
50,12,69,Florida,Lake County,4,17,10394,4794,5600
50,12,69,Florida,Lake County,4,18,8873,3465,5408
50,12,69,Florida,Lake County,5,0,303725,146934,156791
50,12,69,Florida,Lake County,5,1,15703,8000,7703
50,12,69,Florida,Lake County,5,2,17116,8687,8429
50,12,69,Florida,Lake County,5,3,17963,9281,8682
50,12,69,Florida,Lake County,5,4,16656,8565,8091
50,12,69,Florida,Lake County,5,5,15254,7660,7594
50,12,69,Florida,Lake County,5,6,14628,7150,7478
50,12,69,Florida,Lake County,5,7,15198,7417,7781
50,12,69,Florida,Lake County,5,8,15707,7560,8147
50,12,69,Florida,Lake County,5,9,18768,9213,9555
50,12,69,Florida,Lake County,5,10,19670,9706,9964
50,12,69,Florida,Lake County,5,11,20262,9899,10363
50,12,69,Florida,Lake County,5,12,19348,8914,10434
50,12,69,Florida,Lake County,5,13,20457,9287,11170
50,12,69,Florida,Lake County,5,14,22644,10479,12165
50,12,69,Florida,Lake County,5,15,19323,9062,10261
50,12,69,Florida,Lake County,5,16,15159,7367,7792
50,12,69,Florida,Lake County,5,17,10588,4989,5599
50,12,69,Florida,Lake County,5,18,9281,3698,5583
50,12,69,Florida,Lake County,6,0,307973,149024,158949
50,12,69,Florida,Lake County,6,1,15651,8009,7642
50,12,69,Florida,Lake County,6,2,17375,8814,8561
50,12,69,Florida,Lake County,6,3,17950,9141,8809
50,12,69,Florida,Lake County,6,4,16689,8565,8124
50,12,69,Florida,Lake County,6,5,15721,7923,7798
50,12,69,Florida,Lake County,6,6,15017,7437,7580
50,12,69,Florida,Lake County,6,7,15629,7695,7934
50,12,69,Florida,Lake County,6,8,15740,7504,8236
50,12,69,Florida,Lake County,6,9,18734,9207,9527
50,12,69,Florida,Lake County,6,10,19435,9519,9916
50,12,69,Florida,Lake County,6,11,20538,10097,10441
50,12,69,Florida,Lake County,6,12,19974,9283,10691
50,12,69,Florida,Lake County,6,13,20261,9157,11104
50,12,69,Florida,Lake County,6,14,22891,10646,12245
50,12,69,Florida,Lake County,6,15,20331,9497,10834
50,12,69,Florida,Lake County,6,16,15656,7512,8144
50,12,69,Florida,Lake County,6,17,10745,5168,5577
50,12,69,Florida,Lake County,6,18,9636,3850,5786
50,12,69,Florida,Lake County,7,0,315340,152530,162810
50,12,69,Florida,Lake County,7,1,15931,8141,7790
50,12,69,Florida,Lake County,7,2,17463,8888,8575
50,12,69,Florida,Lake County,7,3,18172,9224,8948
50,12,69,Florida,Lake County,7,4,16873,8716,8157
50,12,69,Florida,Lake County,7,5,16107,8083,8024
50,12,69,Florida,Lake County,7,6,15957,7971,7986
50,12,69,Florida,Lake County,7,7,16168,7940,8228
50,12,69,Florida,Lake County,7,8,16178,7742,8436
50,12,69,Florida,Lake County,7,9,18573,9002,9571
50,12,69,Florida,Lake County,7,10,19389,9505,9884
50,12,69,Florida,Lake County,7,11,21092,10397,10695
50,12,69,Florida,Lake County,7,12,20678,9663,11015
50,12,69,Florida,Lake County,7,13,20651,9397,11254
50,12,69,Florida,Lake County,7,14,23543,10809,12734
50,12,69,Florida,Lake County,7,15,21252,9865,11387
50,12,69,Florida,Lake County,7,16,16352,7844,8508
50,12,69,Florida,Lake County,7,17,10979,5296,5683
50,12,69,Florida,Lake County,7,18,9982,4047,5935
50,12,69,Florida,Lake County,8,0,325154,157443,167711
50,12,69,Florida,Lake County,8,1,16308,8330,7978
50,12,69,Florida,Lake County,8,2,18015,9234,8781
50,12,69,Florida,Lake County,8,3,18563,9425,9138
50,12,69,Florida,Lake County,8,4,17445,9037,8408
50,12,69,Florida,Lake County,8,5,16281,8175,8106
50,12,69,Florida,Lake County,8,6,17115,8532,8583
50,12,69,Florida,Lake County,8,7,16872,8233,8639
50,12,69,Florida,Lake County,8,8,16906,8181,8725
50,12,69,Florida,Lake County,8,9,18473,8901,9572
50,12,69,Florida,Lake County,8,10,19697,9692,10005
50,12,69,Florida,Lake County,8,11,21593,10614,10979
50,12,69,Florida,Lake County,8,12,21447,10098,11349
50,12,69,Florida,Lake County,8,13,21475,9783,11692
50,12,69,Florida,Lake County,8,14,24283,11098,13185
50,12,69,Florida,Lake County,8,15,21951,10254,11697
50,12,69,Florida,Lake County,8,16,16779,8012,8767
50,12,69,Florida,Lake County,8,17,11589,5531,6058
50,12,69,Florida,Lake County,8,18,10362,4313,6049
50,12,69,Florida,Lake County,9,0,334913,162009,172904
50,12,69,Florida,Lake County,9,1,16716,8498,8218
50,12,69,Florida,Lake County,9,2,18244,9341,8903
50,12,69,Florida,Lake County,9,3,18997,9585,9412
50,12,69,Florida,Lake County,9,4,17913,9323,8590
50,12,69,Florida,Lake County,9,5,16364,8190,8174
50,12,69,Florida,Lake County,9,6,18039,8925,9114
50,12,69,Florida,Lake County,9,7,17757,8722,9035
50,12,69,Florida,Lake County,9,8,17826,8621,9205
50,12,69,Florida,Lake County,9,9,18399,8827,9572
50,12,69,Florida,Lake County,9,10,20260,9926,10334
50,12,69,Florida,Lake County,9,11,21542,10557,10985
50,12,69,Florida,Lake County,9,12,22421,10687,11734
50,12,69,Florida,Lake County,9,13,22337,10206,12131
50,12,69,Florida,Lake County,9,14,25227,11511,13716
50,12,69,Florida,Lake County,9,15,22613,10556,12057
50,12,69,Florida,Lake County,9,16,17481,8242,9239
50,12,69,Florida,Lake County,9,17,11996,5778,6218
50,12,69,Florida,Lake County,9,18,10781,4514,6267
50,12,69,Florida,Lake County,10,0,345432,167074,178358
50,12,69,Florida,Lake County,10,1,17081,8800,8281
50,12,69,Florida,Lake County,10,2,18399,9354,9045
50,12,69,Florida,Lake County,10,3,19404,9852,9552
50,12,69,Florida,Lake County,10,4,18216,9432,8784
50,12,69,Florida,Lake County,10,5,16666,8386,8280
50,12,69,Florida,Lake County,10,6,19073,9400,9673
50,12,69,Florida,Lake County,10,7,18187,8898,9289
50,12,69,Florida,Lake County,10,8,18785,9179,9606
50,12,69,Florida,Lake County,10,9,18510,8840,9670
50,12,69,Florida,Lake County,10,10,20842,10188,10654
50,12,69,Florida,Lake County,10,11,21914,10682,11232
50,12,69,Florida,Lake County,10,12,23150,11117,12033
50,12,69,Florida,Lake County,10,13,23551,10746,12805
50,12,69,Florida,Lake County,10,14,25054,11386,13668
50,12,69,Florida,Lake County,10,15,24785,11552,13233
50,12,69,Florida,Lake County,10,16,18267,8624,9643
50,12,69,Florida,Lake County,10,17,12505,5959,6546
50,12,69,Florida,Lake County,10,18,11043,4679,6364
50,12,69,Florida,Lake County,11,0,356720,172687,184033
50,12,69,Florida,Lake County,11,1,17491,8959,8532
50,12,69,Florida,Lake County,11,2,18717,9608,9109
50,12,69,Florida,Lake County,11,3,20248,10282,9966
50,12,69,Florida,Lake County,11,4,18383,9450,8933
50,12,69,Florida,Lake County,11,5,16974,8469,8505
50,12,69,Florida,Lake County,11,6,19987,9845,10142
50,12,69,Florida,Lake County,11,7,19212,9536,9676
50,12,69,Florida,Lake County,11,8,19537,9522,10015
50,12,69,Florida,Lake County,11,9,19048,9235,9813
50,12,69,Florida,Lake County,11,10,21215,10350,10865
50,12,69,Florida,Lake County,11,11,21910,10612,11298
50,12,69,Florida,Lake County,11,12,23872,11493,12379
50,12,69,Florida,Lake County,11,13,24748,11440,13308
50,12,69,Florida,Lake County,11,14,25717,11585,14132
50,12,69,Florida,Lake County,11,15,25681,11991,13690
50,12,69,Florida,Lake County,11,16,19720,9330,10390
50,12,69,Florida,Lake County,11,17,12952,6150,6802
50,12,69,Florida,Lake County,11,18,11308,4830,6478
50,12,69,Florida,Lake County,12,0,367118,177787,189331
50,12,69,Florida,Lake County,12,1,17779,9052,8727
50,12,69,Florida,Lake County,12,2,19064,9805,9259
50,12,69,Florida,Lake County,12,3,20597,10569,10028
50,12,69,Florida,Lake County,12,4,18701,9550,9151
50,12,69,Florida,Lake County,12,5,17283,8721,8562
50,12,69,Florida,Lake County,12,6,20540,10136,10404
50,12,69,Florida,Lake County,12,7,20171,10049,10122
50,12,69,Florida,Lake County,12,8,20260,9945,10315
50,12,69,Florida,Lake County,12,9,19690,9473,10217
50,12,69,Florida,Lake County,12,10,21291,10306,10985
50,12,69,Florida,Lake County,12,11,22042,10718,11324
50,12,69,Florida,Lake County,12,12,24689,11848,12841
50,12,69,Florida,Lake County,12,13,25625,11889,13736
50,12,69,Florida,Lake County,12,14,26647,12100,14547
50,12,69,Florida,Lake County,12,15,26842,12384,14458
50,12,69,Florida,Lake County,12,16,20700,9811,10889
50,12,69,Florida,Lake County,12,17,13512,6436,7076
50,12,69,Florida,Lake County,12,18,11685,4995,6690
50,12,71,Florida,Lee County,1,0,618754,303600,315154
50,12,71,Florida,Lee County,1,1,32866,16790,16076
50,12,71,Florida,Lee County,1,2,33330,17156,16174
50,12,71,Florida,Lee County,1,3,33995,17256,16739
50,12,71,Florida,Lee County,1,4,35161,17987,17174
50,12,71,Florida,Lee County,1,5,32993,16707,16286
50,12,71,Florida,Lee County,1,6,33570,17116,16454
50,12,71,Florida,Lee County,1,7,32308,16412,15896
50,12,71,Florida,Lee County,1,8,34235,17179,17056
50,12,71,Florida,Lee County,1,9,36241,18198,18043
50,12,71,Florida,Lee County,1,10,40732,20010,20722
50,12,71,Florida,Lee County,1,11,41025,19593,21432
50,12,71,Florida,Lee County,1,12,40665,18788,21877
50,12,71,Florida,Lee County,1,13,46527,21540,24987
50,12,71,Florida,Lee County,1,14,45024,21778,23246
50,12,71,Florida,Lee County,1,15,35886,17737,18149
50,12,71,Florida,Lee County,1,16,27131,13234,13897
50,12,71,Florida,Lee County,1,17,20464,9470,10994
50,12,71,Florida,Lee County,1,18,16601,6649,9952
50,12,71,Florida,Lee County,2,0,618755,303598,315157
50,12,71,Florida,Lee County,2,1,32866,16790,16076
50,12,71,Florida,Lee County,2,2,33330,17156,16174
50,12,71,Florida,Lee County,2,3,33995,17256,16739
50,12,71,Florida,Lee County,2,4,35160,17986,17174
50,12,71,Florida,Lee County,2,5,32993,16707,16286
50,12,71,Florida,Lee County,2,6,33569,17115,16454
50,12,71,Florida,Lee County,2,7,32308,16412,15896
50,12,71,Florida,Lee County,2,8,34235,17179,17056
50,12,71,Florida,Lee County,2,9,36242,18198,18044
50,12,71,Florida,Lee County,2,10,40732,20010,20722
50,12,71,Florida,Lee County,2,11,41025,19593,21432
50,12,71,Florida,Lee County,2,12,40665,18788,21877
50,12,71,Florida,Lee County,2,13,46527,21540,24987
50,12,71,Florida,Lee County,2,14,45024,21778,23246
50,12,71,Florida,Lee County,2,15,35887,17737,18150
50,12,71,Florida,Lee County,2,16,27131,13234,13897
50,12,71,Florida,Lee County,2,17,20465,9470,10995
50,12,71,Florida,Lee County,2,18,16601,6649,9952
50,12,71,Florida,Lee County,3,0,620449,304388,316061
50,12,71,Florida,Lee County,3,1,32698,16735,15963
50,12,71,Florida,Lee County,3,2,33284,17147,16137
50,12,71,Florida,Lee County,3,3,34077,17298,16779
50,12,71,Florida,Lee County,3,4,34871,17845,17026
50,12,71,Florida,Lee County,3,5,33259,16832,16427
50,12,71,Florida,Lee County,3,6,33545,17093,16452
50,12,71,Florida,Lee County,3,7,32378,16441,15937
50,12,71,Florida,Lee County,3,8,33951,16987,16964
50,12,71,Florida,Lee County,3,9,36294,18213,18081
50,12,71,Florida,Lee County,3,10,40662,19969,20693
50,12,71,Florida,Lee County,3,11,41203,19687,21516
50,12,71,Florida,Lee County,3,12,40944,18933,22011
50,12,71,Florida,Lee County,3,13,46786,21661,25125
50,12,71,Florida,Lee County,3,14,45334,21885,23449
50,12,71,Florida,Lee County,3,15,36300,17943,18357
50,12,71,Florida,Lee County,3,16,27329,13365,13964
50,12,71,Florida,Lee County,3,17,20637,9572,11065
50,12,71,Florida,Lee County,3,18,16897,6782,10115
50,12,71,Florida,Lee County,4,0,631053,309537,321516
50,12,71,Florida,Lee County,4,1,32475,16669,15806
50,12,71,Florida,Lee County,4,2,33641,17330,16311
50,12,71,Florida,Lee County,4,3,34867,17698,17169
50,12,71,Florida,Lee County,4,4,34348,17560,16788
50,12,71,Florida,Lee County,4,5,34140,17198,16942
50,12,71,Florida,Lee County,4,6,33630,17081,16549
50,12,71,Florida,Lee County,4,7,33039,16768,16271
50,12,71,Florida,Lee County,4,8,33160,16472,16688
50,12,71,Florida,Lee County,4,9,36896,18545,18351
50,12,71,Florida,Lee County,4,10,40183,19674,20509
50,12,71,Florida,Lee County,4,11,42060,20234,21826
50,12,71,Florida,Lee County,4,12,41800,19365,22435
50,12,71,Florida,Lee County,4,13,48268,22281,25987
50,12,71,Florida,Lee County,4,14,46552,22354,24198
50,12,71,Florida,Lee County,4,15,38273,18918,19355
50,12,71,Florida,Lee County,4,16,28567,14098,14469
50,12,71,Florida,Lee County,4,17,21163,9905,11258
50,12,71,Florida,Lee County,4,18,17991,7387,10604
50,12,71,Florida,Lee County,5,0,644197,315785,328412
50,12,71,Florida,Lee County,5,1,32539,16710,15829
50,12,71,Florida,Lee County,5,2,34054,17546,16508
50,12,71,Florida,Lee County,5,3,35257,17987,17270
50,12,71,Florida,Lee County,5,4,34463,17623,16840
50,12,71,Florida,Lee County,5,5,34951,17598,17353
50,12,71,Florida,Lee County,5,6,34217,17181,17036
50,12,71,Florida,Lee County,5,7,33948,17292,16656
50,12,71,Florida,Lee County,5,8,33305,16522,16783
50,12,71,Florida,Lee County,5,9,37576,18794,18782
50,12,71,Florida,Lee County,5,10,39595,19392,20203
50,12,71,Florida,Lee County,5,11,42866,20591,22275
50,12,71,Florida,Lee County,5,12,42991,19954,23037
50,12,71,Florida,Lee County,5,13,46863,21504,25359
50,12,71,Florida,Lee County,5,14,50042,23989,26053
50,12,71,Florida,Lee County,5,15,40770,20029,20741
50,12,71,Florida,Lee County,5,16,29937,14805,15132
50,12,71,Florida,Lee County,5,17,21573,10221,11352
50,12,71,Florida,Lee County,5,18,19250,8047,11203
50,12,71,Florida,Lee County,6,0,659834,322986,336848
50,12,71,Florida,Lee County,6,1,32787,16798,15989
50,12,71,Florida,Lee County,6,2,34711,17840,16871
50,12,71,Florida,Lee County,6,3,35533,18203,17330
50,12,71,Florida,Lee County,6,4,34829,17704,17125
50,12,71,Florida,Lee County,6,5,35270,17747,17523
50,12,71,Florida,Lee County,6,6,35289,17644,17645
50,12,71,Florida,Lee County,6,7,34859,17758,17101
50,12,71,Florida,Lee County,6,8,33666,16689,16977
50,12,71,Florida,Lee County,6,9,37762,18800,18962
50,12,71,Florida,Lee County,6,10,39515,19342,20173
50,12,71,Florida,Lee County,6,11,43654,20903,22751
50,12,71,Florida,Lee County,6,12,44286,20679,23607
50,12,71,Florida,Lee County,6,13,47685,21845,25840
50,12,71,Florida,Lee County,6,14,51684,24580,27104
50,12,71,Florida,Lee County,6,15,44368,21574,22794
50,12,71,Florida,Lee County,6,16,31615,15789,15826
50,12,71,Florida,Lee County,6,17,21936,10445,11491
50,12,71,Florida,Lee County,6,18,20385,8646,11739
50,12,71,Florida,Lee County,7,0,677232,331542,345690
50,12,71,Florida,Lee County,7,1,33100,16987,16113
50,12,71,Florida,Lee County,7,2,35136,17917,17219
50,12,71,Florida,Lee County,7,3,35935,18531,17404
50,12,71,Florida,Lee County,7,4,35392,17974,17418
50,12,71,Florida,Lee County,7,5,35833,18063,17770
50,12,71,Florida,Lee County,7,6,36726,18444,18282
50,12,71,Florida,Lee County,7,7,35834,18180,17654
50,12,71,Florida,Lee County,7,8,34393,17036,17357
50,12,71,Florida,Lee County,7,9,37617,18668,18949
50,12,71,Florida,Lee County,7,10,39402,19376,20026
50,12,71,Florida,Lee County,7,11,44407,21226,23181
50,12,71,Florida,Lee County,7,12,45833,21502,24331
50,12,71,Florida,Lee County,7,13,48417,22229,26188
50,12,71,Florida,Lee County,7,14,53992,25466,28526
50,12,71,Florida,Lee County,7,15,47235,22968,24267
50,12,71,Florida,Lee County,7,16,33791,16861,16930
50,12,71,Florida,Lee County,7,17,22605,10855,11750
50,12,71,Florida,Lee County,7,18,21584,9259,12325
50,12,71,Florida,Lee County,8,0,699644,342608,357036
50,12,71,Florida,Lee County,8,1,33780,17402,16378
50,12,71,Florida,Lee County,8,2,35751,18252,17499
50,12,71,Florida,Lee County,8,3,36630,18860,17770
50,12,71,Florida,Lee County,8,4,36131,18325,17806
50,12,71,Florida,Lee County,8,5,35986,18215,17771
50,12,71,Florida,Lee County,8,6,38529,19302,19227
50,12,71,Florida,Lee County,8,7,37255,18808,18447
50,12,71,Florida,Lee County,8,8,35685,17798,17887
50,12,71,Florida,Lee County,8,9,37595,18578,19017
50,12,71,Florida,Lee County,8,10,40451,19902,20549
50,12,71,Florida,Lee County,8,11,45373,21753,23620
50,12,71,Florida,Lee County,8,12,47468,22213,25255
50,12,71,Florida,Lee County,8,13,49664,22906,26758
50,12,71,Florida,Lee County,8,14,56943,26757,30186
50,12,71,Florida,Lee County,8,15,49829,24272,25557
50,12,71,Florida,Lee County,8,16,35797,17749,18048
50,12,71,Florida,Lee County,8,17,23835,11651,12184
50,12,71,Florida,Lee County,8,18,22942,9865,13077
50,12,71,Florida,Lee County,9,0,722649,353929,368720
50,12,71,Florida,Lee County,9,1,34456,17842,16614
50,12,71,Florida,Lee County,9,2,36333,18550,17783
50,12,71,Florida,Lee County,9,3,37385,19229,18156
50,12,71,Florida,Lee County,9,4,37232,18872,18360
50,12,71,Florida,Lee County,9,5,36050,18216,17834
50,12,71,Florida,Lee County,9,6,40536,20274,20262
50,12,71,Florida,Lee County,9,7,38457,19408,19049
50,12,71,Florida,Lee County,9,8,37277,18693,18584
50,12,71,Florida,Lee County,9,9,37571,18535,19036
50,12,71,Florida,Lee County,9,10,41780,20544,21236
50,12,71,Florida,Lee County,9,11,45852,21917,23935
50,12,71,Florida,Lee County,9,12,49730,23357,26373
50,12,71,Florida,Lee County,9,13,51503,23706,27797
50,12,71,Florida,Lee County,9,14,59618,27980,31638
50,12,71,Florida,Lee County,9,15,51591,25039,26552
50,12,71,Florida,Lee County,9,16,38072,18924,19148
50,12,71,Florida,Lee County,9,17,25028,12301,12727
50,12,71,Florida,Lee County,9,18,24178,10542,13636
50,12,71,Florida,Lee County,10,0,740000,362589,377411
50,12,71,Florida,Lee County,10,1,34361,17704,16657
50,12,71,Florida,Lee County,10,2,36579,18756,17823
50,12,71,Florida,Lee County,10,3,37870,19526,18344
50,12,71,Florida,Lee County,10,4,37651,19103,18548
50,12,71,Florida,Lee County,10,5,36528,18388,18140
50,12,71,Florida,Lee County,10,6,41648,21011,20637
50,12,71,Florida,Lee County,10,7,39381,19798,19583
50,12,71,Florida,Lee County,10,8,38553,19415,19138
50,12,71,Florida,Lee County,10,9,37696,18679,19017
50,12,71,Florida,Lee County,10,10,42623,20979,21644
50,12,71,Florida,Lee County,10,11,45648,21825,23823
50,12,71,Florida,Lee County,10,12,50925,23972,26953
50,12,71,Florida,Lee County,10,13,53151,24405,28746
50,12,71,Florida,Lee County,10,14,58468,27264,31204
50,12,71,Florida,Lee County,10,15,56139,27231,28908
50,12,71,Florida,Lee County,10,16,41030,20303,20727
50,12,71,Florida,Lee County,10,17,26389,12989,13400
50,12,71,Florida,Lee County,10,18,25360,11241,14119
50,12,71,Florida,Lee County,11,0,754470,369594,384876
50,12,71,Florida,Lee County,11,1,34663,17751,16912
50,12,71,Florida,Lee County,11,2,36342,18600,17742
50,12,71,Florida,Lee County,11,3,38406,19782,18624
50,12,71,Florida,Lee County,11,4,37830,19249,18581
50,12,71,Florida,Lee County,11,5,36838,18500,18338
50,12,71,Florida,Lee County,11,6,42062,21267,20795
50,12,71,Florida,Lee County,11,7,40397,20302,20095
50,12,71,Florida,Lee County,11,8,39744,20100,19644
50,12,71,Florida,Lee County,11,9,37868,18764,19104
50,12,71,Florida,Lee County,11,10,42793,21109,21684
50,12,71,Florida,Lee County,11,11,45284,21706,23578
50,12,71,Florida,Lee County,11,12,51844,24307,27537
50,12,71,Florida,Lee County,11,13,54222,25055,29167
50,12,71,Florida,Lee County,11,14,58817,27283,31534
50,12,71,Florida,Lee County,11,15,58376,28195,30181
50,12,71,Florida,Lee County,11,16,44653,21950,22703
50,12,71,Florida,Lee County,11,17,27937,13833,14104
50,12,71,Florida,Lee County,11,18,26394,11841,14553
50,12,71,Florida,Lee County,12,0,770577,377301,393276
50,12,71,Florida,Lee County,12,1,35113,17929,17184
50,12,71,Florida,Lee County,12,2,36508,18686,17822
50,12,71,Florida,Lee County,12,3,38605,19783,18822
50,12,71,Florida,Lee County,12,4,38264,19522,18742
50,12,71,Florida,Lee County,12,5,37222,18690,18532
50,12,71,Florida,Lee County,12,6,42481,21521,20960
50,12,71,Florida,Lee County,12,7,41647,21005,20642
50,12,71,Florida,Lee County,12,8,40785,20527,20258
50,12,71,Florida,Lee County,12,9,38722,19212,19510
50,12,71,Florida,Lee County,12,10,42471,20898,21573
50,12,71,Florida,Lee County,12,11,45242,21824,23418
50,12,71,Florida,Lee County,12,12,52962,24804,28158
50,12,71,Florida,Lee County,12,13,55923,25929,29994
50,12,71,Florida,Lee County,12,14,59564,27579,31985
50,12,71,Florida,Lee County,12,15,60911,29169,31742
50,12,71,Florida,Lee County,12,16,47340,23316,24024
50,12,71,Florida,Lee County,12,17,29482,14543,14939
50,12,71,Florida,Lee County,12,18,27335,12364,14971
50,12,73,Florida,Leon County,1,0,275487,131134,144353
50,12,73,Florida,Leon County,1,1,15350,7849,7501
50,12,73,Florida,Leon County,1,2,14877,7496,7381
50,12,73,Florida,Leon County,1,3,14690,7558,7132
50,12,73,Florida,Leon County,1,4,27231,12509,14722
50,12,73,Florida,Leon County,1,5,43722,21010,22712
50,12,73,Florida,Leon County,1,6,23281,11587,11694
50,12,73,Florida,Leon County,1,7,16673,8008,8665
50,12,73,Florida,Leon County,1,8,15350,7314,8036
50,12,73,Florida,Leon County,1,9,15010,7244,7766
50,12,73,Florida,Leon County,1,10,16437,7650,8787
50,12,73,Florida,Leon County,1,11,17156,7945,9211
50,12,73,Florida,Leon County,1,12,16092,7475,8617
50,12,73,Florida,Leon County,1,13,13638,6548,7090
50,12,73,Florida,Leon County,1,14,8787,4132,4655
50,12,73,Florida,Leon County,1,15,5846,2583,3263
50,12,73,Florida,Leon County,1,16,4329,1823,2506
50,12,73,Florida,Leon County,1,17,3601,1381,2220
50,12,73,Florida,Leon County,1,18,3417,1022,2395
50,12,73,Florida,Leon County,2,0,275483,131132,144351
50,12,73,Florida,Leon County,2,1,15350,7849,7501
50,12,73,Florida,Leon County,2,2,14875,7495,7380
50,12,73,Florida,Leon County,2,3,14689,7557,7132
50,12,73,Florida,Leon County,2,4,27231,12509,14722
50,12,73,Florida,Leon County,2,5,43722,21010,22712
50,12,73,Florida,Leon County,2,6,23281,11587,11694
50,12,73,Florida,Leon County,2,7,16671,8007,8664
50,12,73,Florida,Leon County,2,8,15350,7314,8036
50,12,73,Florida,Leon County,2,9,15010,7244,7766
50,12,73,Florida,Leon County,2,10,16437,7650,8787
50,12,73,Florida,Leon County,2,11,17154,7944,9210
50,12,73,Florida,Leon County,2,12,16092,7475,8617
50,12,73,Florida,Leon County,2,13,13639,6549,7090
50,12,73,Florida,Leon County,2,14,8788,4132,4656
50,12,73,Florida,Leon County,2,15,5847,2584,3263
50,12,73,Florida,Leon County,2,16,4329,1823,2506
50,12,73,Florida,Leon County,2,17,3601,1381,2220
50,12,73,Florida,Leon County,2,18,3417,1022,2395
50,12,73,Florida,Leon County,3,0,275971,131284,144687
50,12,73,Florida,Leon County,3,1,15318,7846,7472
50,12,73,Florida,Leon County,3,2,14850,7494,7356
50,12,73,Florida,Leon County,3,3,14745,7560,7185
50,12,73,Florida,Leon County,3,4,27111,12451,14660
50,12,73,Florida,Leon County,3,5,44285,21221,23064
50,12,73,Florida,Leon County,3,6,23096,11499,11597
50,12,73,Florida,Leon County,3,7,16803,8064,8739
50,12,73,Florida,Leon County,3,8,15228,7251,7977
50,12,73,Florida,Leon County,3,9,15044,7249,7795
50,12,73,Florida,Leon County,3,10,16274,7590,8684
50,12,73,Florida,Leon County,3,11,17098,7922,9176
50,12,73,Florida,Leon County,3,12,16072,7465,8607
50,12,73,Florida,Leon County,3,13,13793,6594,7199
50,12,73,Florida,Leon County,3,14,8914,4201,4713
50,12,73,Florida,Leon County,3,15,5927,2624,3303
50,12,73,Florida,Leon County,3,16,4362,1828,2534
50,12,73,Florida,Leon County,3,17,3592,1384,2208
50,12,73,Florida,Leon County,3,18,3459,1041,2418
50,12,73,Florida,Leon County,4,0,278371,132383,145988
50,12,73,Florida,Leon County,4,1,15133,7680,7453
50,12,73,Florida,Leon County,4,2,14902,7529,7373
50,12,73,Florida,Leon County,4,3,14926,7588,7338
50,12,73,Florida,Leon County,4,4,26196,12046,14150
50,12,73,Florida,Leon County,4,5,47055,22422,24633
50,12,73,Florida,Leon County,4,6,22426,11220,11206
50,12,73,Florida,Leon County,4,7,17237,8350,8887
50,12,73,Florida,Leon County,4,8,14640,6955,7685
50,12,73,Florida,Leon County,4,9,15239,7327,7912
50,12,73,Florida,Leon County,4,10,15688,7363,8325
50,12,73,Florida,Leon County,4,11,17034,7911,9123
50,12,73,Florida,Leon County,4,12,16070,7485,8585
50,12,73,Florida,Leon County,4,13,14571,6907,7664
50,12,73,Florida,Leon County,4,14,9408,4457,4951
50,12,73,Florida,Leon County,4,15,6210,2774,3436
50,12,73,Florida,Leon County,4,16,4503,1882,2621
50,12,73,Florida,Leon County,4,17,3490,1356,2134
50,12,73,Florida,Leon County,4,18,3643,1131,2512
50,12,73,Florida,Leon County,5,0,283620,135112,148508
50,12,73,Florida,Leon County,5,1,14919,7644,7275
50,12,73,Florida,Leon County,5,2,14963,7617,7346
50,12,73,Florida,Leon County,5,3,14894,7527,7367
50,12,73,Florida,Leon County,5,4,25437,11754,13683
50,12,73,Florida,Leon County,5,5,49476,23512,25964
50,12,73,Florida,Leon County,5,6,22364,11237,11127
50,12,73,Florida,Leon County,5,7,18136,8875,9261
50,12,73,Florida,Leon County,5,8,15011,7080,7931
50,12,73,Florida,Leon County,5,9,15550,7540,8010
50,12,73,Florida,Leon County,5,10,15590,7395,8195
50,12,73,Florida,Leon County,5,11,17043,7953,9090
50,12,73,Florida,Leon County,5,12,16400,7605,8795
50,12,73,Florida,Leon County,5,13,14742,6867,7875
50,12,73,Florida,Leon County,5,14,10650,5052,5598
50,12,73,Florida,Leon County,5,15,6627,2986,3641
50,12,73,Florida,Leon County,5,16,4567,1912,2655
50,12,73,Florida,Leon County,5,17,3506,1381,2125
50,12,73,Florida,Leon County,5,18,3745,1175,2570
50,12,73,Florida,Leon County,6,0,281887,134087,147800
50,12,73,Florida,Leon County,6,1,14779,7568,7211
50,12,73,Florida,Leon County,6,2,14912,7584,7328
50,12,73,Florida,Leon County,6,3,14916,7508,7408
50,12,73,Florida,Leon County,6,4,25295,11658,13637
50,12,73,Florida,Leon County,6,5,49518,23463,26055
50,12,73,Florida,Leon County,6,6,21586,10822,10764
50,12,73,Florida,Leon County,6,7,18241,8917,9324
50,12,73,Florida,Leon County,6,8,14892,7024,7868
50,12,73,Florida,Leon County,6,9,15104,7310,7794
50,12,73,Florida,Leon County,6,10,14718,6958,7760
50,12,73,Florida,Leon County,6,11,16532,7733,8799
50,12,73,Florida,Leon County,6,12,16045,7400,8645
50,12,73,Florida,Leon County,6,13,14720,6843,7877
50,12,73,Florida,Leon County,6,14,11317,5398,5919
50,12,73,Florida,Leon County,6,15,7249,3254,3995
50,12,73,Florida,Leon County,6,16,4722,2001,2721
50,12,73,Florida,Leon County,6,17,3482,1390,2092
50,12,73,Florida,Leon County,6,18,3859,1256,2603
50,12,73,Florida,Leon County,7,0,283770,135084,148686
50,12,73,Florida,Leon County,7,1,14707,7582,7125
50,12,73,Florida,Leon County,7,2,14906,7573,7333
50,12,73,Florida,Leon County,7,3,14933,7578,7355
50,12,73,Florida,Leon County,7,4,25231,11675,13556
50,12,73,Florida,Leon County,7,5,49460,23439,26021
50,12,73,Florida,Leon County,7,6,21790,11051,10739
50,12,73,Florida,Leon County,7,7,18532,8991,9541
50,12,73,Florida,Leon County,7,8,15073,7115,7958
50,12,73,Florida,Leon County,7,9,14963,7121,7842
50,12,73,Florida,Leon County,7,10,14486,6943,7543
50,12,73,Florida,Leon County,7,11,16405,7658,8747
50,12,73,Florida,Leon County,7,12,16020,7365,8655
50,12,73,Florida,Leon County,7,13,14962,6888,8074
50,12,73,Florida,Leon County,7,14,12181,5778,6403
50,12,73,Florida,Leon County,7,15,7672,3486,4186
50,12,73,Florida,Leon County,7,16,4988,2137,2851
50,12,73,Florida,Leon County,7,17,3464,1379,2085
50,12,73,Florida,Leon County,7,18,3997,1325,2672
50,12,73,Florida,Leon County,8,0,285904,135954,149950
50,12,73,Florida,Leon County,8,1,14862,7708,7154
50,12,73,Florida,Leon County,8,2,14942,7561,7381
50,12,73,Florida,Leon County,8,3,14875,7547,7328
50,12,73,Florida,Leon County,8,4,25226,11693,13533
50,12,73,Florida,Leon County,8,5,48915,23051,25864
50,12,73,Florida,Leon County,8,6,22539,11433,11106
50,12,73,Florida,Leon County,8,7,18490,9003,9487
50,12,73,Florida,Leon County,8,8,15545,7339,8206
50,12,73,Florida,Leon County,8,9,14709,6962,7747
50,12,73,Florida,Leon County,8,10,14632,7030,7602
50,12,73,Florida,Leon County,8,11,15829,7400,8429
50,12,73,Florida,Leon County,8,12,16245,7439,8806
50,12,73,Florida,Leon County,8,13,15042,6886,8156
50,12,73,Florida,Leon County,8,14,13021,6122,6899
50,12,73,Florida,Leon County,8,15,8203,3776,4427
50,12,73,Florida,Leon County,8,16,5243,2263,2980
50,12,73,Florida,Leon County,8,17,3581,1401,2180
50,12,73,Florida,Leon County,8,18,4005,1340,2665
50,12,73,Florida,Leon County,9,0,286744,136331,150413
50,12,73,Florida,Leon County,9,1,14850,7700,7150
50,12,73,Florida,Leon County,9,2,14775,7482,7293
50,12,73,Florida,Leon County,9,3,14823,7551,7272
50,12,73,Florida,Leon County,9,4,25056,11605,13451
50,12,73,Florida,Leon County,9,5,47507,22413,25094
50,12,73,Florida,Leon County,9,6,23298,11672,11626
50,12,73,Florida,Leon County,9,7,18206,8903,9303
50,12,73,Florida,Leon County,9,8,16070,7676,8394
50,12,73,Florida,Leon County,9,9,14487,6785,7702
50,12,73,Florida,Leon County,9,10,15039,7228,7811
50,12,73,Florida,Leon County,9,11,15277,7145,8132
50,12,73,Florida,Leon County,9,12,16284,7481,8803
50,12,73,Florida,Leon County,9,13,15199,6957,8242
50,12,73,Florida,Leon County,9,14,13822,6441,7381
50,12,73,Florida,Leon County,9,15,8666,3995,4671
50,12,73,Florida,Leon County,9,16,5595,2440,3155
50,12,73,Florida,Leon County,9,17,3721,1470,2251
50,12,73,Florida,Leon County,9,18,4069,1387,2682
50,12,73,Florida,Leon County,10,0,290965,138155,152810
50,12,73,Florida,Leon County,10,1,14994,7741,7253
50,12,73,Florida,Leon County,10,2,14912,7622,7290
50,12,73,Florida,Leon County,10,3,15086,7689,7397
50,12,73,Florida,Leon County,10,4,25839,11896,13943
50,12,73,Florida,Leon County,10,5,47042,22167,24875
50,12,73,Florida,Leon County,10,6,24271,12014,12257
50,12,73,Florida,Leon County,10,7,18082,8849,9233
50,12,73,Florida,Leon County,10,8,16876,8117,8759
50,12,73,Florida,Leon County,10,9,14514,6747,7767
50,12,73,Florida,Leon County,10,10,15221,7354,7867
50,12,73,Florida,Leon County,10,11,14983,7024,7959
50,12,73,Florida,Leon County,10,12,16224,7500,8724
50,12,73,Florida,Leon County,10,13,15423,7013,8410
50,12,73,Florida,Leon County,10,14,13623,6267,7356
50,12,73,Florida,Leon County,10,15,9927,4615,5312
50,12,73,Florida,Leon County,10,16,5989,2631,3358
50,12,73,Florida,Leon County,10,17,3815,1489,2326
50,12,73,Florida,Leon County,10,18,4144,1420,2724
50,12,73,Florida,Leon County,11,0,291657,138207,153450
50,12,73,Florida,Leon County,11,1,15128,7711,7417
50,12,73,Florida,Leon County,11,2,14844,7576,7268
50,12,73,Florida,Leon County,11,3,15199,7763,7436
50,12,73,Florida,Leon County,11,4,25719,11851,13868
50,12,73,Florida,Leon County,11,5,45989,21605,24384
50,12,73,Florida,Leon County,11,6,24402,12041,12361
50,12,73,Florida,Leon County,11,7,17888,8733,9155
50,12,73,Florida,Leon County,11,8,17338,8297,9041
50,12,73,Florida,Leon County,11,9,14746,6919,7827
50,12,73,Florida,Leon County,11,10,15129,7285,7844
50,12,73,Florida,Leon County,11,11,14600,6845,7755
50,12,73,Florida,Leon County,11,12,16176,7528,8648
50,12,73,Florida,Leon County,11,13,15428,6982,8446
50,12,73,Florida,Leon County,11,14,13812,6290,7522
50,12,73,Florida,Leon County,11,15,10548,4915,5633
50,12,73,Florida,Leon County,11,16,6522,2843,3679
50,12,73,Florida,Leon County,11,17,3968,1563,2405
50,12,73,Florida,Leon County,11,18,4221,1460,2761
50,12,73,Florida,Leon County,12,0,293582,138806,154776
50,12,73,Florida,Leon County,12,1,15251,7805,7446
50,12,73,Florida,Leon County,12,2,14942,7652,7290
50,12,73,Florida,Leon County,12,3,15344,7753,7591
50,12,73,Florida,Leon County,12,4,25736,11915,13821
50,12,73,Florida,Leon County,12,5,45628,21301,24327
50,12,73,Florida,Leon County,12,6,24101,11855,12246
50,12,73,Florida,Leon County,12,7,18122,8861,9261
50,12,73,Florida,Leon County,12,8,17731,8447,9284
50,12,73,Florida,Leon County,12,9,15030,7096,7934
50,12,73,Florida,Leon County,12,10,15034,7134,7900
50,12,73,Florida,Leon County,12,11,14495,6859,7636
50,12,73,Florida,Leon County,12,12,15897,7334,8563
50,12,73,Florida,Leon County,12,13,15485,6990,8495
50,12,73,Florida,Leon County,12,14,14135,6407,7728
50,12,73,Florida,Leon County,12,15,11220,5200,6020
50,12,73,Florida,Leon County,12,16,6930,3035,3895
50,12,73,Florida,Leon County,12,17,4171,1671,2500
50,12,73,Florida,Leon County,12,18,4330,1491,2839
50,12,75,Florida,Levy County,1,0,40801,20078,20723
50,12,75,Florida,Levy County,1,1,2299,1201,1098
50,12,75,Florida,Levy County,1,2,2300,1196,1104
50,12,75,Florida,Levy County,1,3,2426,1273,1153
50,12,75,Florida,Levy County,1,4,2591,1335,1256
50,12,75,Florida,Levy County,1,5,2086,1044,1042
50,12,75,Florida,Levy County,1,6,2066,985,1081
50,12,75,Florida,Levy County,1,7,2031,987,1044
50,12,75,Florida,Levy County,1,8,2223,1072,1151
50,12,75,Florida,Levy County,1,9,2371,1112,1259
50,12,75,Florida,Levy County,1,10,3055,1449,1606
50,12,75,Florida,Levy County,1,11,3135,1487,1648
50,12,75,Florida,Levy County,1,12,3151,1496,1655
50,12,75,Florida,Levy County,1,13,3153,1499,1654
50,12,75,Florida,Levy County,1,14,2717,1383,1334
50,12,75,Florida,Levy County,1,15,2093,1092,1001
50,12,75,Florida,Levy County,1,16,1413,734,679
50,12,75,Florida,Levy County,1,17,1018,467,551
50,12,75,Florida,Levy County,1,18,673,266,407
50,12,75,Florida,Levy County,2,0,40798,20075,20723
50,12,75,Florida,Levy County,2,1,2299,1201,1098
50,12,75,Florida,Levy County,2,2,2300,1196,1104
50,12,75,Florida,Levy County,2,3,2426,1273,1153
50,12,75,Florida,Levy County,2,4,2591,1335,1256
50,12,75,Florida,Levy County,2,5,2085,1043,1042
50,12,75,Florida,Levy County,2,6,2064,983,1081
50,12,75,Florida,Levy County,2,7,2031,987,1044
50,12,75,Florida,Levy County,2,8,2223,1072,1151
50,12,75,Florida,Levy County,2,9,2371,1112,1259
50,12,75,Florida,Levy County,2,10,3055,1449,1606
50,12,75,Florida,Levy County,2,11,3135,1487,1648
50,12,75,Florida,Levy County,2,12,3151,1496,1655
50,12,75,Florida,Levy County,2,13,3153,1499,1654
50,12,75,Florida,Levy County,2,14,2717,1383,1334
50,12,75,Florida,Levy County,2,15,2093,1092,1001
50,12,75,Florida,Levy County,2,16,1413,734,679
50,12,75,Florida,Levy County,2,17,1018,467,551
50,12,75,Florida,Levy County,2,18,673,266,407
50,12,75,Florida,Levy County,3,0,40720,20059,20661
50,12,75,Florida,Levy County,3,1,2293,1197,1096
50,12,75,Florida,Levy County,3,2,2293,1199,1094
50,12,75,Florida,Levy County,3,3,2422,1268,1154
50,12,75,Florida,Levy County,3,4,2561,1325,1236
50,12,75,Florida,Levy County,3,5,2092,1045,1047
50,12,75,Florida,Levy County,3,6,2049,972,1077
50,12,75,Florida,Levy County,3,7,2036,996,1040
50,12,75,Florida,Levy County,3,8,2201,1067,1134
50,12,75,Florida,Levy County,3,9,2362,1114,1248
50,12,75,Florida,Levy County,3,10,3017,1431,1586
50,12,75,Florida,Levy County,3,11,3125,1483,1642
50,12,75,Florida,Levy County,3,12,3162,1496,1666
50,12,75,Florida,Levy County,3,13,3165,1506,1659
50,12,75,Florida,Levy County,3,14,2718,1379,1339
50,12,75,Florida,Levy County,3,15,2107,1100,1007
50,12,75,Florida,Levy County,3,16,1419,739,680
50,12,75,Florida,Levy County,3,17,1015,474,541
50,12,75,Florida,Levy County,3,18,683,268,415
50,12,75,Florida,Levy County,4,0,40151,19779,20372
50,12,75,Florida,Levy County,4,1,2184,1134,1050
50,12,75,Florida,Levy County,4,2,2238,1184,1054
50,12,75,Florida,Levy County,4,3,2363,1226,1137
50,12,75,Florida,Levy County,4,4,2366,1242,1124
50,12,75,Florida,Levy County,4,5,2133,1079,1054
50,12,75,Florida,Levy County,4,6,2007,940,1067
50,12,75,Florida,Levy County,4,7,2029,986,1043
50,12,75,Florida,Levy County,4,8,2031,991,1040
50,12,75,Florida,Levy County,4,9,2349,1132,1217
50,12,75,Florida,Levy County,4,10,2841,1344,1497
50,12,75,Florida,Levy County,4,11,3115,1462,1653
50,12,75,Florida,Levy County,4,12,3141,1501,1640
50,12,75,Florida,Levy County,4,13,3243,1547,1696
50,12,75,Florida,Levy County,4,14,2720,1349,1371
50,12,75,Florida,Levy County,4,15,2151,1117,1034
50,12,75,Florida,Levy County,4,16,1499,768,731
50,12,75,Florida,Levy County,4,17,1007,492,515
50,12,75,Florida,Levy County,4,18,734,285,449
50,12,75,Florida,Levy County,5,0,39823,19607,20216
50,12,75,Florida,Levy County,5,1,2120,1121,999
50,12,75,Florida,Levy County,5,2,2298,1194,1104
50,12,75,Florida,Levy County,5,3,2335,1199,1136
50,12,75,Florida,Levy County,5,4,2216,1161,1055
50,12,75,Florida,Levy County,5,5,2129,1078,1051
50,12,75,Florida,Levy County,5,6,1965,940,1025
50,12,75,Florida,Levy County,5,7,2056,996,1060
50,12,75,Florida,Levy County,5,8,1949,970,979
50,12,75,Florida,Levy County,5,9,2281,1093,1188
50,12,75,Florida,Levy County,5,10,2720,1325,1395
50,12,75,Florida,Levy County,5,11,3076,1432,1644
50,12,75,Florida,Levy County,5,12,3081,1477,1604
50,12,75,Florida,Levy County,5,13,3146,1483,1663
50,12,75,Florida,Levy County,5,14,2872,1384,1488
50,12,75,Florida,Levy County,5,15,2231,1154,1077
50,12,75,Florida,Levy County,5,16,1547,794,753
50,12,75,Florida,Levy County,5,17,993,472,521
50,12,75,Florida,Levy County,5,18,808,334,474
50,12,75,Florida,Levy County,6,0,39433,19324,20109
50,12,75,Florida,Levy County,6,1,2059,1063,996
50,12,75,Florida,Levy County,6,2,2190,1136,1054
50,12,75,Florida,Levy County,6,3,2301,1175,1126
50,12,75,Florida,Levy County,6,4,2160,1139,1021
50,12,75,Florida,Levy County,6,5,2114,1074,1040
50,12,75,Florida,Levy County,6,6,2005,965,1040
50,12,75,Florida,Levy County,6,7,2010,953,1057
50,12,75,Florida,Levy County,6,8,1882,917,965
50,12,75,Florida,Levy County,6,9,2264,1086,1178
50,12,75,Florida,Levy County,6,10,2511,1218,1293
50,12,75,Florida,Levy County,6,11,3111,1437,1674
50,12,75,Florida,Levy County,6,12,3050,1468,1582
50,12,75,Florida,Levy County,6,13,3090,1420,1670
50,12,75,Florida,Levy County,6,14,2925,1416,1509
50,12,75,Florida,Levy County,6,15,2339,1201,1138
50,12,75,Florida,Levy County,6,16,1619,829,790
50,12,75,Florida,Levy County,6,17,966,472,494
50,12,75,Florida,Levy County,6,18,837,355,482
50,12,75,Florida,Levy County,7,0,39296,19281,20015
50,12,75,Florida,Levy County,7,1,2041,1054,987
50,12,75,Florida,Levy County,7,2,2169,1131,1038
50,12,75,Florida,Levy County,7,3,2282,1153,1129
50,12,75,Florida,Levy County,7,4,2134,1143,991
50,12,75,Florida,Levy County,7,5,2118,1070,1048
50,12,75,Florida,Levy County,7,6,2034,994,1040
50,12,75,Florida,Levy County,7,7,1947,919,1028
50,12,75,Florida,Levy County,7,8,1842,897,945
50,12,75,Florida,Levy County,7,9,2224,1094,1130
50,12,75,Florida,Levy County,7,10,2363,1105,1258
50,12,75,Florida,Levy County,7,11,3059,1443,1616
50,12,75,Florida,Levy County,7,12,3038,1420,1618
50,12,75,Florida,Levy County,7,13,3080,1439,1641
50,12,75,Florida,Levy County,7,14,3048,1494,1554
50,12,75,Florida,Levy County,7,15,2401,1211,1190
50,12,75,Florida,Levy County,7,16,1689,861,828
50,12,75,Florida,Levy County,7,17,980,491,489
50,12,75,Florida,Levy County,7,18,847,362,485
50,12,75,Florida,Levy County,8,0,39601,19447,20154
50,12,75,Florida,Levy County,8,1,2046,1048,998
50,12,75,Florida,Levy County,8,2,2227,1158,1069
50,12,75,Florida,Levy County,8,3,2203,1122,1081
50,12,75,Florida,Levy County,8,4,2084,1104,980
50,12,75,Florida,Levy County,8,5,2038,1037,1001
50,12,75,Florida,Levy County,8,6,2199,1088,1111
50,12,75,Florida,Levy County,8,7,1987,939,1048
50,12,75,Florida,Levy County,8,8,1904,942,962
50,12,75,Florida,Levy County,8,9,2120,1046,1074
50,12,75,Florida,Levy County,8,10,2302,1076,1226
50,12,75,Florida,Levy County,8,11,3021,1443,1578
50,12,75,Florida,Levy County,8,12,3126,1474,1652
50,12,75,Florida,Levy County,8,13,3078,1452,1626
50,12,75,Florida,Levy County,8,14,3078,1467,1611
50,12,75,Florida,Levy County,8,15,2499,1255,1244
50,12,75,Florida,Levy County,8,16,1761,891,870
50,12,75,Florida,Levy County,8,17,1065,529,536
50,12,75,Florida,Levy County,8,18,863,376,487
50,12,75,Florida,Levy County,9,0,39837,19553,20284
50,12,75,Florida,Levy County,9,1,2039,1047,992
50,12,75,Florida,Levy County,9,2,2267,1178,1089
50,12,75,Florida,Levy County,9,3,2198,1142,1056
50,12,75,Florida,Levy County,9,4,2075,1063,1012
50,12,75,Florida,Levy County,9,5,1995,1013,982
50,12,75,Florida,Levy County,9,6,2265,1118,1147
50,12,75,Florida,Levy County,9,7,2007,943,1064
50,12,75,Florida,Levy County,9,8,1957,987,970
50,12,75,Florida,Levy County,9,9,2004,972,1032
50,12,75,Florida,Levy County,9,10,2366,1162,1204
50,12,75,Florida,Levy County,9,11,2877,1337,1540
50,12,75,Florida,Levy County,9,12,3153,1465,1688
50,12,75,Florida,Levy County,9,13,3140,1487,1653
50,12,75,Florida,Levy County,9,14,3155,1522,1633
50,12,75,Florida,Levy County,9,15,2526,1255,1271
50,12,75,Florida,Levy County,9,16,1782,908,874
50,12,75,Florida,Levy County,9,17,1136,559,577
50,12,75,Florida,Levy County,9,18,895,395,500
50,12,75,Florida,Levy County,10,0,40276,19711,20565
50,12,75,Florida,Levy County,10,1,1995,1028,967
50,12,75,Florida,Levy County,10,2,2274,1189,1085
50,12,75,Florida,Levy County,10,3,2217,1140,1077
50,12,75,Florida,Levy County,10,4,2076,1078,998
50,12,75,Florida,Levy County,10,5,1950,982,968
50,12,75,Florida,Levy County,10,6,2425,1198,1227
50,12,75,Florida,Levy County,10,7,2059,976,1083
50,12,75,Florida,Levy County,10,8,2023,979,1044
50,12,75,Florida,Levy County,10,9,1945,941,1004
50,12,75,Florida,Levy County,10,10,2354,1145,1209
50,12,75,Florida,Levy County,10,11,2756,1320,1436
50,12,75,Florida,Levy County,10,12,3202,1475,1727
50,12,75,Florida,Levy County,10,13,3187,1489,1698
50,12,75,Florida,Levy County,10,14,3148,1502,1646
50,12,75,Florida,Levy County,10,15,2696,1324,1372
50,12,75,Florida,Levy County,10,16,1859,936,923
50,12,75,Florida,Levy County,10,17,1193,607,586
50,12,75,Florida,Levy County,10,18,917,402,515
50,12,75,Florida,Levy County,11,0,40798,19961,20837
50,12,75,Florida,Levy County,11,1,2082,1082,1000
50,12,75,Florida,Levy County,11,2,2233,1178,1055
50,12,75,Florida,Levy County,11,3,2283,1177,1106
50,12,75,Florida,Levy County,11,4,2101,1079,1022
50,12,75,Florida,Levy County,11,5,1856,942,914
50,12,75,Florida,Levy County,11,6,2478,1238,1240
50,12,75,Florida,Levy County,11,7,2103,988,1115
50,12,75,Florida,Levy County,11,8,2068,982,1086
50,12,75,Florida,Levy County,11,9,1960,946,1014
50,12,75,Florida,Levy County,11,10,2381,1152,1229
50,12,75,Florida,Levy County,11,11,2638,1291,1347
50,12,75,Florida,Levy County,11,12,3259,1486,1773
50,12,75,Florida,Levy County,11,13,3225,1526,1699
50,12,75,Florida,Levy County,11,14,3177,1462,1715
50,12,75,Florida,Levy County,11,15,2794,1374,1420
50,12,75,Florida,Levy County,11,16,1996,1013,983
50,12,75,Florida,Levy County,11,17,1227,616,611
50,12,75,Florida,Levy County,11,18,937,429,508
50,12,75,Florida,Levy County,12,0,41503,20296,21207
50,12,75,Florida,Levy County,12,1,2130,1113,1017
50,12,75,Florida,Levy County,12,2,2295,1212,1083
50,12,75,Florida,Levy County,12,3,2347,1229,1118
50,12,75,Florida,Levy County,12,4,2069,1051,1018
50,12,75,Florida,Levy County,12,5,1872,957,915
50,12,75,Florida,Levy County,12,6,2438,1193,1245
50,12,75,Florida,Levy County,12,7,2250,1076,1174
50,12,75,Florida,Levy County,12,8,2103,991,1112
50,12,75,Florida,Levy County,12,9,2011,960,1051
50,12,75,Florida,Levy County,12,10,2418,1197,1221
50,12,75,Florida,Levy County,12,11,2537,1224,1313
50,12,75,Florida,Levy County,12,12,3293,1533,1760
50,12,75,Florida,Levy County,12,13,3304,1520,1784
50,12,75,Florida,Levy County,12,14,3258,1514,1744
50,12,75,Florida,Levy County,12,15,2908,1424,1484
50,12,75,Florida,Levy County,12,16,2076,1048,1028
50,12,75,Florida,Levy County,12,17,1256,615,641
50,12,75,Florida,Levy County,12,18,938,439,499
50,12,77,Florida,Liberty County,1,0,8365,5092,3273
50,12,77,Florida,Liberty County,1,1,462,240,222
50,12,77,Florida,Liberty County,1,2,493,259,234
50,12,77,Florida,Liberty County,1,3,517,296,221
50,12,77,Florida,Liberty County,1,4,493,290,203
50,12,77,Florida,Liberty County,1,5,548,355,193
50,12,77,Florida,Liberty County,1,6,715,510,205
50,12,77,Florida,Liberty County,1,7,672,464,208
50,12,77,Florida,Liberty County,1,8,676,454,222
50,12,77,Florida,Liberty County,1,9,635,427,208
50,12,77,Florida,Liberty County,1,10,721,461,260
50,12,77,Florida,Liberty County,1,11,647,398,249
50,12,77,Florida,Liberty County,1,12,503,290,213
50,12,77,Florida,Liberty County,1,13,395,224,171
50,12,77,Florida,Liberty County,1,14,303,151,152
50,12,77,Florida,Liberty County,1,15,236,129,107
50,12,77,Florida,Liberty County,1,16,175,81,94
50,12,77,Florida,Liberty County,1,17,109,40,69
50,12,77,Florida,Liberty County,1,18,65,23,42
50,12,77,Florida,Liberty County,2,0,8365,5092,3273
50,12,77,Florida,Liberty County,2,1,462,240,222
50,12,77,Florida,Liberty County,2,2,493,259,234
50,12,77,Florida,Liberty County,2,3,517,296,221
50,12,77,Florida,Liberty County,2,4,493,290,203
50,12,77,Florida,Liberty County,2,5,548,355,193
50,12,77,Florida,Liberty County,2,6,715,510,205
50,12,77,Florida,Liberty County,2,7,672,464,208
50,12,77,Florida,Liberty County,2,8,676,454,222
50,12,77,Florida,Liberty County,2,9,635,427,208
50,12,77,Florida,Liberty County,2,10,721,461,260
50,12,77,Florida,Liberty County,2,11,647,398,249
50,12,77,Florida,Liberty County,2,12,503,290,213
50,12,77,Florida,Liberty County,2,13,395,224,171
50,12,77,Florida,Liberty County,2,14,303,151,152
50,12,77,Florida,Liberty County,2,15,236,129,107
50,12,77,Florida,Liberty County,2,16,175,81,94
50,12,77,Florida,Liberty County,2,17,109,40,69
50,12,77,Florida,Liberty County,2,18,65,23,42
50,12,77,Florida,Liberty County,3,0,8349,5082,3267
50,12,77,Florida,Liberty County,3,1,454,235,219
50,12,77,Florida,Liberty County,3,2,485,256,229
50,12,77,Florida,Liberty County,3,3,518,294,224
50,12,77,Florida,Liberty County,3,4,483,287,196
50,12,77,Florida,Liberty County,3,5,546,355,191
50,12,77,Florida,Liberty County,3,6,714,506,208
50,12,77,Florida,Liberty County,3,7,667,459,208
50,12,77,Florida,Liberty County,3,8,671,454,217
50,12,77,Florida,Liberty County,3,9,638,426,212
50,12,77,Florida,Liberty County,3,10,717,457,260
50,12,77,Florida,Liberty County,3,11,646,399,247
50,12,77,Florida,Liberty County,3,12,507,292,215
50,12,77,Florida,Liberty County,3,13,401,228,173
50,12,77,Florida,Liberty County,3,14,306,153,153
50,12,77,Florida,Liberty County,3,15,241,132,109
50,12,77,Florida,Liberty County,3,16,179,85,94
50,12,77,Florida,Liberty County,3,17,110,41,69
50,12,77,Florida,Liberty County,3,18,66,23,43
50,12,77,Florida,Liberty County,4,0,8264,5027,3237
50,12,77,Florida,Liberty County,4,1,422,225,197
50,12,77,Florida,Liberty County,4,2,472,248,224
50,12,77,Florida,Liberty County,4,3,541,291,250
50,12,77,Florida,Liberty County,4,4,470,281,189
50,12,77,Florida,Liberty County,4,5,528,349,179
50,12,77,Florida,Liberty County,4,6,718,498,220
50,12,77,Florida,Liberty County,4,7,641,434,207
50,12,77,Florida,Liberty County,4,8,654,459,195
50,12,77,Florida,Liberty County,4,9,637,422,215
50,12,77,Florida,Liberty County,4,10,683,441,242
50,12,77,Florida,Liberty County,4,11,633,391,242
50,12,77,Florida,Liberty County,4,12,518,297,221
50,12,77,Florida,Liberty County,4,13,420,240,180
50,12,77,Florida,Liberty County,4,14,319,166,153
50,12,77,Florida,Liberty County,4,15,248,135,113
50,12,77,Florida,Liberty County,4,16,183,84,99
50,12,77,Florida,Liberty County,4,17,115,45,70
50,12,77,Florida,Liberty County,4,18,62,21,41
50,12,77,Florida,Liberty County,5,0,8301,5114,3187
50,12,77,Florida,Liberty County,5,1,397,209,188
50,12,77,Florida,Liberty County,5,2,456,231,225
50,12,77,Florida,Liberty County,5,3,520,279,241
50,12,77,Florida,Liberty County,5,4,459,280,179
50,12,77,Florida,Liberty County,5,5,566,374,192
50,12,77,Florida,Liberty County,5,6,702,501,201
50,12,77,Florida,Liberty County,5,7,656,464,192
50,12,77,Florida,Liberty County,5,8,662,471,191
50,12,77,Florida,Liberty County,5,9,655,430,225
50,12,77,Florida,Liberty County,5,10,655,452,203
50,12,77,Florida,Liberty County,5,11,649,399,250
50,12,77,Florida,Liberty County,5,12,534,309,225
50,12,77,Florida,Liberty County,5,13,417,237,180
50,12,77,Florida,Liberty County,5,14,353,195,158
50,12,77,Florida,Liberty County,5,15,253,126,127
50,12,77,Florida,Liberty County,5,16,184,88,96
50,12,77,Florida,Liberty County,5,17,116,51,65
50,12,77,Florida,Liberty County,5,18,67,18,49
50,12,77,Florida,Liberty County,6,0,8357,5148,3209
50,12,77,Florida,Liberty County,6,1,397,210,187
50,12,77,Florida,Liberty County,6,2,437,220,217
50,12,77,Florida,Liberty County,6,3,508,268,240
50,12,77,Florida,Liberty County,6,4,458,278,180
50,12,77,Florida,Liberty County,6,5,601,403,198
50,12,77,Florida,Liberty County,6,6,701,507,194
50,12,77,Florida,Liberty County,6,7,678,474,204
50,12,77,Florida,Liberty County,6,8,651,453,198
50,12,77,Florida,Liberty County,6,9,671,441,230
50,12,77,Florida,Liberty County,6,10,653,452,201
50,12,77,Florida,Liberty County,6,11,630,391,239
50,12,77,Florida,Liberty County,6,12,532,313,219
50,12,77,Florida,Liberty County,6,13,429,245,184
50,12,77,Florida,Liberty County,6,14,366,204,162
50,12,77,Florida,Liberty County,6,15,244,112,132
50,12,77,Florida,Liberty County,6,16,200,99,101
50,12,77,Florida,Liberty County,6,17,119,54,65
50,12,77,Florida,Liberty County,6,18,82,24,58
50,12,77,Florida,Liberty County,7,0,8418,5224,3194
50,12,77,Florida,Liberty County,7,1,395,206,189
50,12,77,Florida,Liberty County,7,2,421,213,208
50,12,77,Florida,Liberty County,7,3,469,250,219
50,12,77,Florida,Liberty County,7,4,455,266,189
50,12,77,Florida,Liberty County,7,5,578,403,175
50,12,77,Florida,Liberty County,7,6,723,517,206
50,12,77,Florida,Liberty County,7,7,702,497,205
50,12,77,Florida,Liberty County,7,8,668,473,195
50,12,77,Florida,Liberty County,7,9,678,459,219
50,12,77,Florida,Liberty County,7,10,663,464,199
50,12,77,Florida,Liberty County,7,11,622,392,230
50,12,77,Florida,Liberty County,7,12,539,313,226
50,12,77,Florida,Liberty County,7,13,442,246,196
50,12,77,Florida,Liberty County,7,14,373,210,163
50,12,77,Florida,Liberty County,7,15,273,133,140
50,12,77,Florida,Liberty County,7,16,211,101,110
50,12,77,Florida,Liberty County,7,17,118,57,61
50,12,77,Florida,Liberty County,7,18,88,24,64
50,12,77,Florida,Liberty County,8,0,8409,5178,3231
50,12,77,Florida,Liberty County,8,1,393,214,179
50,12,77,Florida,Liberty County,8,2,433,216,217
50,12,77,Florida,Liberty County,8,3,463,244,219
50,12,77,Florida,Liberty County,8,4,472,272,200
50,12,77,Florida,Liberty County,8,5,557,384,173
50,12,77,Florida,Liberty County,8,6,731,530,201
50,12,77,Florida,Liberty County,8,7,689,487,202
50,12,77,Florida,Liberty County,8,8,657,451,206
50,12,77,Florida,Liberty County,8,9,663,448,215
50,12,77,Florida,Liberty County,8,10,677,468,209
50,12,77,Florida,Liberty County,8,11,593,363,230
50,12,77,Florida,Liberty County,8,12,539,318,221
50,12,77,Florida,Liberty County,8,13,445,250,195
50,12,77,Florida,Liberty County,8,14,378,201,177
50,12,77,Florida,Liberty County,8,15,282,134,148
50,12,77,Florida,Liberty County,8,16,211,108,103
50,12,77,Florida,Liberty County,8,17,132,59,73
50,12,77,Florida,Liberty County,8,18,94,31,63
50,12,77,Florida,Liberty County,9,0,8300,5131,3169
50,12,77,Florida,Liberty County,9,1,376,206,170
50,12,77,Florida,Liberty County,9,2,379,204,175
50,12,77,Florida,Liberty County,9,3,462,240,222
50,12,77,Florida,Liberty County,9,4,469,270,199
50,12,77,Florida,Liberty County,9,5,551,378,173
50,12,77,Florida,Liberty County,9,6,717,527,190
50,12,77,Florida,Liberty County,9,7,675,469,206
50,12,77,Florida,Liberty County,9,8,659,452,207
50,12,77,Florida,Liberty County,9,9,644,448,196
50,12,77,Florida,Liberty County,9,10,663,446,217
50,12,77,Florida,Liberty County,9,11,578,365,213
50,12,77,Florida,Liberty County,9,12,542,313,229
50,12,77,Florida,Liberty County,9,13,452,246,206
50,12,77,Florida,Liberty County,9,14,394,215,179
50,12,77,Florida,Liberty County,9,15,288,143,145
50,12,77,Florida,Liberty County,9,16,221,115,106
50,12,77,Florida,Liberty County,9,17,134,62,72
50,12,77,Florida,Liberty County,9,18,96,32,64
50,12,77,Florida,Liberty County,10,0,8236,5045,3191
50,12,77,Florida,Liberty County,10,1,397,204,193
50,12,77,Florida,Liberty County,10,2,374,195,179
50,12,77,Florida,Liberty County,10,3,433,220,213
50,12,77,Florida,Liberty County,10,4,458,263,195
50,12,77,Florida,Liberty County,10,5,520,351,169
50,12,77,Florida,Liberty County,10,6,736,537,199
50,12,77,Florida,Liberty County,10,7,637,443,194
50,12,77,Florida,Liberty County,10,8,647,449,198
50,12,77,Florida,Liberty County,10,9,621,441,180
50,12,77,Florida,Liberty County,10,10,645,433,212
50,12,77,Florida,Liberty County,10,11,552,353,199
50,12,77,Florida,Liberty County,10,12,565,305,260
50,12,77,Florida,Liberty County,10,13,464,257,207
50,12,77,Florida,Liberty County,10,14,402,218,184
50,12,77,Florida,Liberty County,10,15,318,163,155
50,12,77,Florida,Liberty County,10,16,226,108,118
50,12,77,Florida,Liberty County,10,17,142,72,70
50,12,77,Florida,Liberty County,10,18,99,33,66
50,12,77,Florida,Liberty County,11,0,8427,5213,3214
50,12,77,Florida,Liberty County,11,1,383,197,186
50,12,77,Florida,Liberty County,11,2,376,192,184
50,12,77,Florida,Liberty County,11,3,440,230,210
50,12,77,Florida,Liberty County,11,4,459,267,192
50,12,77,Florida,Liberty County,11,5,539,379,160
50,12,77,Florida,Liberty County,11,6,799,586,213
50,12,77,Florida,Liberty County,11,7,636,450,186
50,12,77,Florida,Liberty County,11,8,672,481,191
50,12,77,Florida,Liberty County,11,9,639,442,197
50,12,77,Florida,Liberty County,11,10,661,451,210
50,12,77,Florida,Liberty County,11,11,567,357,210
50,12,77,Florida,Liberty County,11,12,553,311,242
50,12,77,Florida,Liberty County,11,13,486,266,220
50,12,77,Florida,Liberty County,11,14,413,224,189
50,12,77,Florida,Liberty County,11,15,321,170,151
50,12,77,Florida,Liberty County,11,16,221,94,127
50,12,77,Florida,Liberty County,11,17,160,76,84
50,12,77,Florida,Liberty County,11,18,102,40,62
50,12,77,Florida,Liberty County,12,0,8354,5169,3185
50,12,77,Florida,Liberty County,12,1,366,194,172
50,12,77,Florida,Liberty County,12,2,382,204,178
50,12,77,Florida,Liberty County,12,3,421,215,206
50,12,77,Florida,Liberty County,12,4,438,250,188
50,12,77,Florida,Liberty County,12,5,526,372,154
50,12,77,Florida,Liberty County,12,6,795,589,206
50,12,77,Florida,Liberty County,12,7,641,452,189
50,12,77,Florida,Liberty County,12,8,674,474,200
50,12,77,Florida,Liberty County,12,9,632,437,195
50,12,77,Florida,Liberty County,12,10,669,459,210
50,12,77,Florida,Liberty County,12,11,531,343,188
50,12,77,Florida,Liberty County,12,12,538,301,237
50,12,77,Florida,Liberty County,12,13,485,257,228
50,12,77,Florida,Liberty County,12,14,418,224,194
50,12,77,Florida,Liberty County,12,15,316,169,147
50,12,77,Florida,Liberty County,12,16,252,116,136
50,12,77,Florida,Liberty County,12,17,167,74,93
50,12,77,Florida,Liberty County,12,18,103,39,64
50,12,79,Florida,Madison County,1,0,19224,10035,9189
50,12,79,Florida,Madison County,1,1,1215,608,607
50,12,79,Florida,Madison County,1,2,1075,544,531
50,12,79,Florida,Madison County,1,3,1100,562,538
50,12,79,Florida,Madison County,1,4,1346,737,609
50,12,79,Florida,Madison County,1,5,1279,693,586
50,12,79,Florida,Madison County,1,6,1285,768,517
50,12,79,Florida,Madison County,1,7,1108,632,476
50,12,79,Florida,Madison County,1,8,1145,652,493
50,12,79,Florida,Madison County,1,9,1209,656,553
50,12,79,Florida,Madison County,1,10,1429,793,636
50,12,79,Florida,Madison County,1,11,1358,711,647
50,12,79,Florida,Madison County,1,12,1354,660,694
50,12,79,Florida,Madison County,1,13,1276,683,593
50,12,79,Florida,Madison County,1,14,976,470,506
50,12,79,Florida,Madison County,1,15,760,362,398
50,12,79,Florida,Madison County,1,16,524,232,292
50,12,79,Florida,Madison County,1,17,397,172,225
50,12,79,Florida,Madison County,1,18,388,100,288
50,12,79,Florida,Madison County,2,0,19226,10037,9189
50,12,79,Florida,Madison County,2,1,1218,611,607
50,12,79,Florida,Madison County,2,2,1075,544,531
50,12,79,Florida,Madison County,2,3,1100,562,538
50,12,79,Florida,Madison County,2,4,1346,737,609
50,12,79,Florida,Madison County,2,5,1278,692,586
50,12,79,Florida,Madison County,2,6,1287,768,519
50,12,79,Florida,Madison County,2,7,1108,632,476
50,12,79,Florida,Madison County,2,8,1145,652,493
50,12,79,Florida,Madison County,2,9,1209,656,553
50,12,79,Florida,Madison County,2,10,1428,793,635
50,12,79,Florida,Madison County,2,11,1358,711,647
50,12,79,Florida,Madison County,2,12,1354,660,694
50,12,79,Florida,Madison County,2,13,1276,683,593
50,12,79,Florida,Madison County,2,14,976,470,506
50,12,79,Florida,Madison County,2,15,759,362,397
50,12,79,Florida,Madison County,2,16,524,232,292
50,12,79,Florida,Madison County,2,17,397,172,225
50,12,79,Florida,Madison County,2,18,388,100,288
50,12,79,Florida,Madison County,3,0,19248,10061,9187
50,12,79,Florida,Madison County,3,1,1186,591,595
50,12,79,Florida,Madison County,3,2,1083,549,534
50,12,79,Florida,Madison County,3,3,1108,564,544
50,12,79,Florida,Madison County,3,4,1303,716,587
50,12,79,Florida,Madison County,3,5,1291,702,589
50,12,79,Florida,Madison County,3,6,1289,773,516
50,12,79,Florida,Madison County,3,7,1126,646,480
50,12,79,Florida,Madison County,3,8,1132,643,489
50,12,79,Florida,Madison County,3,9,1214,665,549
50,12,79,Florida,Madison County,3,10,1422,786,636
50,12,79,Florida,Madison County,3,11,1369,715,654
50,12,79,Florida,Madison County,3,12,1365,668,697
50,12,79,Florida,Madison County,3,13,1284,687,597
50,12,79,Florida,Madison County,3,14,982,476,506
50,12,79,Florida,Madison County,3,15,770,366,404
50,12,79,Florida,Madison County,3,16,531,238,293
50,12,79,Florida,Madison County,3,17,404,176,228
50,12,79,Florida,Madison County,3,18,389,100,289
50,12,79,Florida,Madison County,4,0,19130,10074,9056
50,12,79,Florida,Madison County,4,1,1136,589,547
50,12,79,Florida,Madison County,4,2,1089,560,529
50,12,79,Florida,Madison County,4,3,1094,556,538
50,12,79,Florida,Madison County,4,4,1158,646,512
50,12,79,Florida,Madison County,4,5,1361,758,603
50,12,79,Florida,Madison County,4,6,1279,749,530
50,12,79,Florida,Madison County,4,7,1156,677,479
50,12,79,Florida,Madison County,4,8,1104,631,473
50,12,79,Florida,Madison County,4,9,1221,690,531
50,12,79,Florida,Madison County,4,10,1367,751,616
50,12,79,Florida,Madison County,4,11,1364,707,657
50,12,79,Florida,Madison County,4,12,1359,669,690
50,12,79,Florida,Madison County,4,13,1328,694,634
50,12,79,Florida,Madison County,4,14,980,496,484
50,12,79,Florida,Madison County,4,15,801,369,432
50,12,79,Florida,Madison County,4,16,548,257,291
50,12,79,Florida,Madison County,4,17,389,171,218
50,12,79,Florida,Madison County,4,18,396,104,292
50,12,79,Florida,Madison County,5,0,18972,9990,8982
50,12,79,Florida,Madison County,5,1,1080,559,521
50,12,79,Florida,Madison County,5,2,1071,551,520
50,12,79,Florida,Madison County,5,3,1030,525,505
50,12,79,Florida,Madison County,5,4,1075,604,471
50,12,79,Florida,Madison County,5,5,1357,743,614
50,12,79,Florida,Madison County,5,6,1289,759,530
50,12,79,Florida,Madison County,5,7,1130,674,456
50,12,79,Florida,Madison County,5,8,1129,657,472
50,12,79,Florida,Madison County,5,9,1196,663,533
50,12,79,Florida,Madison County,5,10,1325,729,596
50,12,79,Florida,Madison County,5,11,1354,712,642
50,12,79,Florida,Madison County,5,12,1344,646,698
50,12,79,Florida,Madison County,5,13,1347,686,661
50,12,79,Florida,Madison County,5,14,1057,557,500
50,12,79,Florida,Madison County,5,15,819,368,451
50,12,79,Florida,Madison County,5,16,567,276,291
50,12,79,Florida,Madison County,5,17,386,164,222
50,12,79,Florida,Madison County,5,18,416,117,299
50,12,79,Florida,Madison County,6,0,18753,9867,8886
50,12,79,Florida,Madison County,6,1,1036,534,502
50,12,79,Florida,Madison County,6,2,1084,558,526
50,12,79,Florida,Madison County,6,3,995,491,504
50,12,79,Florida,Madison County,6,4,1055,599,456
50,12,79,Florida,Madison County,6,5,1351,739,612
50,12,79,Florida,Madison County,6,6,1238,713,525
50,12,79,Florida,Madison County,6,7,1144,681,463
50,12,79,Florida,Madison County,6,8,1094,650,444
50,12,79,Florida,Madison County,6,9,1182,649,533
50,12,79,Florida,Madison County,6,10,1276,717,559
50,12,79,Florida,Madison County,6,11,1304,688,616
50,12,79,Florida,Madison County,6,12,1332,646,686
50,12,79,Florida,Madison County,6,13,1362,672,690
50,12,79,Florida,Madison County,6,14,1090,583,507
50,12,79,Florida,Madison County,6,15,828,382,446
50,12,79,Florida,Madison County,6,16,592,286,306
50,12,79,Florida,Madison County,6,17,401,160,241
50,12,79,Florida,Madison County,6,18,389,119,270
50,12,79,Florida,Madison County,7,0,18601,9827,8774
50,12,79,Florida,Madison County,7,1,986,509,477
50,12,79,Florida,Madison County,7,2,1071,550,521
50,12,79,Florida,Madison County,7,3,948,466,482
50,12,79,Florida,Madison County,7,4,1018,586,432
50,12,79,Florida,Madison County,7,5,1291,742,549
50,12,79,Florida,Madison County,7,6,1233,724,509
50,12,79,Florida,Madison County,7,7,1204,685,519
50,12,79,Florida,Madison County,7,8,1059,614,445
50,12,79,Florida,Madison County,7,9,1157,662,495
50,12,79,Florida,Madison County,7,10,1262,709,553
50,12,79,Florida,Madison County,7,11,1327,696,631
50,12,79,Florida,Madison County,7,12,1293,638,655
50,12,79,Florida,Madison County,7,13,1364,658,706
50,12,79,Florida,Madison County,7,14,1162,623,539
50,12,79,Florida,Madison County,7,15,848,399,449
50,12,79,Florida,Madison County,7,16,597,282,315
50,12,79,Florida,Madison County,7,17,389,158,231
50,12,79,Florida,Madison County,7,18,392,126,266
50,12,79,Florida,Madison County,8,0,18478,9761,8717
50,12,79,Florida,Madison County,8,1,994,534,460
50,12,79,Florida,Madison County,8,2,1023,512,511
50,12,79,Florida,Madison County,8,3,934,486,448
50,12,79,Florida,Madison County,8,4,1031,585,446
50,12,79,Florida,Madison County,8,5,1176,686,490
50,12,79,Florida,Madison County,8,6,1300,748,552
50,12,79,Florida,Madison County,8,7,1173,684,489
50,12,79,Florida,Madison County,8,8,1064,616,448
50,12,79,Florida,Madison County,8,9,1127,642,485
50,12,79,Florida,Madison County,8,10,1220,683,537
50,12,79,Florida,Madison County,8,11,1322,693,629
50,12,79,Florida,Madison County,8,12,1294,626,668
50,12,79,Florida,Madison County,8,13,1310,626,684
50,12,79,Florida,Madison County,8,14,1225,653,572
50,12,79,Florida,Madison County,8,15,873,417,456
50,12,79,Florida,Madison County,8,16,631,284,347
50,12,79,Florida,Madison County,8,17,394,158,236
50,12,79,Florida,Madison County,8,18,387,128,259
50,12,79,Florida,Madison County,9,0,18316,9685,8631
50,12,79,Florida,Madison County,9,1,1004,537,467
50,12,79,Florida,Madison County,9,2,972,506,466
50,12,79,Florida,Madison County,9,3,934,480,454
50,12,79,Florida,Madison County,9,4,1016,573,443
50,12,79,Florida,Madison County,9,5,1059,641,418
50,12,79,Florida,Madison County,9,6,1331,763,568
50,12,79,Florida,Madison County,9,7,1178,675,503
50,12,79,Florida,Madison County,9,8,1060,606,454
50,12,79,Florida,Madison County,9,9,1104,624,480
50,12,79,Florida,Madison County,9,10,1204,692,512
50,12,79,Florida,Madison County,9,11,1269,657,612
50,12,79,Florida,Madison County,9,12,1310,645,665
50,12,79,Florida,Madison County,9,13,1294,605,689
50,12,79,Florida,Madison County,9,14,1260,673,587
50,12,79,Florida,Madison County,9,15,889,432,457
50,12,79,Florida,Madison County,9,16,659,288,371
50,12,79,Florida,Madison County,9,17,402,164,238
50,12,79,Florida,Madison County,9,18,371,124,247
50,12,79,Florida,Madison County,10,0,18474,9847,8627
50,12,79,Florida,Madison County,10,1,974,517,457
50,12,79,Florida,Madison County,10,2,972,506,466
50,12,79,Florida,Madison County,10,3,972,498,474
50,12,79,Florida,Madison County,10,4,966,548,418
50,12,79,Florida,Madison County,10,5,1061,662,399
50,12,79,Florida,Madison County,10,6,1387,806,581
50,12,79,Florida,Madison County,10,7,1189,682,507
50,12,79,Florida,Madison County,10,8,1069,623,446
50,12,79,Florida,Madison County,10,9,1117,647,470
50,12,79,Florida,Madison County,10,10,1227,717,510
50,12,79,Florida,Madison County,10,11,1236,641,595
50,12,79,Florida,Madison County,10,12,1305,665,640
50,12,79,Florida,Madison County,10,13,1304,603,701
50,12,79,Florida,Madison County,10,14,1257,639,618
50,12,79,Florida,Madison County,10,15,967,499,468
50,12,79,Florida,Madison County,10,16,665,285,380
50,12,79,Florida,Madison County,10,17,425,188,237
50,12,79,Florida,Madison County,10,18,381,121,260
50,12,79,Florida,Madison County,11,0,18540,9842,8698
50,12,79,Florida,Madison County,11,1,942,505,437
50,12,79,Florida,Madison County,11,2,961,493,468
50,12,79,Florida,Madison County,11,3,970,488,482
50,12,79,Florida,Madison County,11,4,968,551,417
50,12,79,Florida,Madison County,11,5,1032,619,413
50,12,79,Florida,Madison County,11,6,1390,802,588
50,12,79,Florida,Madison County,11,7,1205,680,525
50,12,79,Florida,Madison County,11,8,1120,644,476
50,12,79,Florida,Madison County,11,9,1101,654,447
50,12,79,Florida,Madison County,11,10,1241,716,525
50,12,79,Florida,Madison County,11,11,1210,644,566
50,12,79,Florida,Madison County,11,12,1280,657,623
50,12,79,Florida,Madison County,11,13,1321,606,715
50,12,79,Florida,Madison County,11,14,1274,627,647
50,12,79,Florida,Madison County,11,15,985,519,466
50,12,79,Florida,Madison County,11,16,692,311,381
50,12,79,Florida,Madison County,11,17,439,193,246
50,12,79,Florida,Madison County,11,18,409,133,276
50,12,79,Florida,Madison County,12,0,18493,9821,8672
50,12,79,Florida,Madison County,12,1,880,457,423
50,12,79,Florida,Madison County,12,2,959,498,461
50,12,79,Florida,Madison County,12,3,976,494,482
50,12,79,Florida,Madison County,12,4,940,527,413
50,12,79,Florida,Madison County,12,5,1038,636,402
50,12,79,Florida,Madison County,12,6,1362,804,558
50,12,79,Florida,Madison County,12,7,1211,681,530
50,12,79,Florida,Madison County,12,8,1149,657,492
50,12,79,Florida,Madison County,12,9,1074,615,459
50,12,79,Florida,Madison County,12,10,1217,725,492
50,12,79,Florida,Madison County,12,11,1173,620,553
50,12,79,Florida,Madison County,12,12,1300,660,640
50,12,79,Florida,Madison County,12,13,1312,624,688
50,12,79,Florida,Madison County,12,14,1264,605,659
50,12,79,Florida,Madison County,12,15,1062,563,499
50,12,79,Florida,Madison County,12,16,706,325,381
50,12,79,Florida,Madison County,12,17,466,201,265
50,12,79,Florida,Madison County,12,18,404,129,275
50,12,81,Florida,Manatee County,1,0,322833,156115,166718
50,12,81,Florida,Manatee County,1,1,18322,9223,9099
50,12,81,Florida,Manatee County,1,2,18136,9281,8855
50,12,81,Florida,Manatee County,1,3,18527,9414,9113
50,12,81,Florida,Manatee County,1,4,18100,9239,8861
50,12,81,Florida,Manatee County,1,5,16031,8160,7871
50,12,81,Florida,Manatee County,1,6,16627,8250,8377
50,12,81,Florida,Manatee County,1,7,16126,8143,7983
50,12,81,Florida,Manatee County,1,8,17484,8568,8916
50,12,81,Florida,Manatee County,1,9,19243,9362,9881
50,12,81,Florida,Manatee County,1,10,21723,10562,11161
50,12,81,Florida,Manatee County,1,11,22325,10713,11612
50,12,81,Florida,Manatee County,1,12,21713,9979,11734
50,12,81,Florida,Manatee County,1,13,23367,10811,12556
50,12,81,Florida,Manatee County,1,14,21602,10176,11426
50,12,81,Florida,Manatee County,1,15,17383,8277,9106
50,12,81,Florida,Manatee County,1,16,14633,6953,7680
50,12,81,Florida,Manatee County,1,17,11563,5171,6392
50,12,81,Florida,Manatee County,1,18,9928,3833,6095
50,12,81,Florida,Manatee County,2,0,322879,156142,166737
50,12,81,Florida,Manatee County,2,1,18331,9226,9105
50,12,81,Florida,Manatee County,2,2,18141,9285,8856
50,12,81,Florida,Manatee County,2,3,18529,9416,9113
50,12,81,Florida,Manatee County,2,4,18101,9240,8861
50,12,81,Florida,Manatee County,2,5,16038,8165,7873
50,12,81,Florida,Manatee County,2,6,16632,8253,8379
50,12,81,Florida,Manatee County,2,7,16128,8145,7983
50,12,81,Florida,Manatee County,2,8,17486,8569,8917
50,12,81,Florida,Manatee County,2,9,19246,9363,9883
50,12,81,Florida,Manatee County,2,10,21724,10562,11162
50,12,81,Florida,Manatee County,2,11,22328,10715,11613
50,12,81,Florida,Manatee County,2,12,21717,9982,11735
50,12,81,Florida,Manatee County,2,13,23368,10811,12557
50,12,81,Florida,Manatee County,2,14,21602,10176,11426
50,12,81,Florida,Manatee County,2,15,17383,8277,9106
50,12,81,Florida,Manatee County,2,16,14633,6953,7680
50,12,81,Florida,Manatee County,2,17,11563,5171,6392
50,12,81,Florida,Manatee County,2,18,9929,3833,6096
50,12,81,Florida,Manatee County,3,0,323424,156392,167032
50,12,81,Florida,Manatee County,3,1,18209,9176,9033
50,12,81,Florida,Manatee County,3,2,18101,9257,8844
50,12,81,Florida,Manatee County,3,3,18519,9425,9094
50,12,81,Florida,Manatee County,3,4,18034,9219,8815
50,12,81,Florida,Manatee County,3,5,16156,8232,7924
50,12,81,Florida,Manatee County,3,6,16665,8273,8392
50,12,81,Florida,Manatee County,3,7,16186,8128,8058
50,12,81,Florida,Manatee County,3,8,17316,8499,8817
50,12,81,Florida,Manatee County,3,9,19280,9371,9909
50,12,81,Florida,Manatee County,3,10,21631,10501,11130
50,12,81,Florida,Manatee County,3,11,22411,10754,11657
50,12,81,Florida,Manatee County,3,12,21850,10065,11785
50,12,81,Florida,Manatee County,3,13,23489,10858,12631
50,12,81,Florida,Manatee County,3,14,21734,10232,11502
50,12,81,Florida,Manatee County,3,15,17506,8315,9191
50,12,81,Florida,Manatee County,3,16,14673,6991,7682
50,12,81,Florida,Manatee County,3,17,11621,5195,6426
50,12,81,Florida,Manatee County,3,18,10043,3901,6142
50,12,81,Florida,Manatee County,4,0,327549,158275,169274
50,12,81,Florida,Manatee County,4,1,17939,9075,8864
50,12,81,Florida,Manatee County,4,2,18345,9365,8980
50,12,81,Florida,Manatee County,4,3,18695,9513,9182
50,12,81,Florida,Manatee County,4,4,17898,9169,8729
50,12,81,Florida,Manatee County,4,5,16716,8515,8201
50,12,81,Florida,Manatee County,4,6,16862,8304,8558
50,12,81,Florida,Manatee County,4,7,16668,8277,8391
50,12,81,Florida,Manatee County,4,8,16777,8269,8508
50,12,81,Florida,Manatee County,4,9,19570,9502,10068
50,12,81,Florida,Manatee County,4,10,21149,10308,10841
50,12,81,Florida,Manatee County,4,11,22655,10777,11878
50,12,81,Florida,Manatee County,4,12,22149,10253,11896
50,12,81,Florida,Manatee County,4,13,24264,11173,13091
50,12,81,Florida,Manatee County,4,14,22407,10501,11906
50,12,81,Florida,Manatee County,4,15,18149,8565,9584
50,12,81,Florida,Manatee County,4,16,14940,7169,7771
50,12,81,Florida,Manatee County,4,17,11825,5332,6493
50,12,81,Florida,Manatee County,4,18,10541,4208,6333
50,12,81,Florida,Manatee County,5,0,333844,161360,172484
50,12,81,Florida,Manatee County,5,1,17764,8989,8775
50,12,81,Florida,Manatee County,5,2,18630,9536,9094
50,12,81,Florida,Manatee County,5,3,19025,9660,9365
50,12,81,Florida,Manatee County,5,4,18015,9328,8687
50,12,81,Florida,Manatee County,5,5,17296,8814,8482
50,12,81,Florida,Manatee County,5,6,17150,8480,8670
50,12,81,Florida,Manatee County,5,7,17095,8361,8734
50,12,81,Florida,Manatee County,5,8,16835,8381,8454
50,12,81,Florida,Manatee County,5,9,19657,9526,10131
50,12,81,Florida,Manatee County,5,10,20999,10246,10753
50,12,81,Florida,Manatee County,5,11,23055,10897,12158
50,12,81,Florida,Manatee County,5,12,22836,10636,12200
50,12,81,Florida,Manatee County,5,13,23702,10816,12886
50,12,81,Florida,Manatee County,5,14,24283,11429,12854
50,12,81,Florida,Manatee County,5,15,19146,9005,10141
50,12,81,Florida,Manatee County,5,16,15245,7292,7953
50,12,81,Florida,Manatee County,5,17,12005,5469,6536
50,12,81,Florida,Manatee County,5,18,11106,4495,6611
50,12,81,Florida,Manatee County,6,0,341855,165153,176702
50,12,81,Florida,Manatee County,6,1,17703,9060,8643
50,12,81,Florida,Manatee County,6,2,19071,9619,9452
50,12,81,Florida,Manatee County,6,3,19265,9844,9421
50,12,81,Florida,Manatee County,6,4,18283,9547,8736
50,12,81,Florida,Manatee County,6,5,17852,9012,8840
50,12,81,Florida,Manatee County,6,6,17472,8664,8808
50,12,81,Florida,Manatee County,6,7,17554,8523,9031
50,12,81,Florida,Manatee County,6,8,17085,8517,8568
50,12,81,Florida,Manatee County,6,9,19578,9474,10104
50,12,81,Florida,Manatee County,6,10,21206,10285,10921
50,12,81,Florida,Manatee County,6,11,23554,11206,12348
50,12,81,Florida,Manatee County,6,12,23763,10999,12764
50,12,81,Florida,Manatee County,6,13,23975,10953,13022
50,12,81,Florida,Manatee County,6,14,25050,11769,13281
50,12,81,Florida,Manatee County,6,15,20803,9777,11026
50,12,81,Florida,Manatee County,6,16,15745,7509,8236
50,12,81,Florida,Manatee County,6,17,12109,5586,6523
50,12,81,Florida,Manatee County,6,18,11787,4809,6978
50,12,81,Florida,Manatee County,7,0,350865,169593,181272
50,12,81,Florida,Manatee County,7,1,17714,9044,8670
50,12,81,Florida,Manatee County,7,2,19300,9740,9560
50,12,81,Florida,Manatee County,7,3,19400,10016,9384
50,12,81,Florida,Manatee County,7,4,18534,9579,8955
50,12,81,Florida,Manatee County,7,5,18130,9273,8857
50,12,81,Florida,Manatee County,7,6,18149,8990,9159
50,12,81,Florida,Manatee County,7,7,17949,8722,9227
50,12,81,Florida,Manatee County,7,8,17584,8706,8878
50,12,81,Florida,Manatee County,7,9,19521,9535,9986
50,12,81,Florida,Manatee County,7,10,21183,10143,11040
50,12,81,Florida,Manatee County,7,11,24085,11461,12624
50,12,81,Florida,Manatee County,7,12,24709,11479,13230
50,12,81,Florida,Manatee County,7,13,24994,11409,13585
50,12,81,Florida,Manatee County,7,14,26502,12452,14050
50,12,81,Florida,Manatee County,7,15,22141,10424,11717
50,12,81,Florida,Manatee County,7,16,16374,7761,8613
50,12,81,Florida,Manatee County,7,17,12356,5782,6574
50,12,81,Florida,Manatee County,7,18,12240,5077,7163
50,12,81,Florida,Manatee County,8,0,362548,175301,187247
50,12,81,Florida,Manatee County,8,1,18181,9342,8839
50,12,81,Florida,Manatee County,8,2,19563,9755,9808
50,12,81,Florida,Manatee County,8,3,19712,10149,9563
50,12,81,Florida,Manatee County,8,4,18924,9764,9160
50,12,81,Florida,Manatee County,8,5,18252,9306,8946
50,12,81,Florida,Manatee County,8,6,19146,9554,9592
50,12,81,Florida,Manatee County,8,7,18678,9149,9529
50,12,81,Florida,Manatee County,8,8,18271,9038,9233
50,12,81,Florida,Manatee County,8,9,19327,9360,9967
50,12,81,Florida,Manatee County,8,10,21781,10485,11296
50,12,81,Florida,Manatee County,8,11,24470,11729,12741
50,12,81,Florida,Manatee County,8,12,25988,12211,13777
50,12,81,Florida,Manatee County,8,13,25922,11743,14179
50,12,81,Florida,Manatee County,8,14,28109,13120,14989
50,12,81,Florida,Manatee County,8,15,23517,11112,12405
50,12,81,Florida,Manatee County,8,16,17064,8078,8986
50,12,81,Florida,Manatee County,8,17,12721,6007,6714
50,12,81,Florida,Manatee County,8,18,12922,5399,7523
50,12,81,Florida,Manatee County,9,0,375373,181370,194003
50,12,81,Florida,Manatee County,9,1,18602,9474,9128
50,12,81,Florida,Manatee County,9,2,19830,9912,9918
50,12,81,Florida,Manatee County,9,3,20235,10345,9890
50,12,81,Florida,Manatee County,9,4,19348,10067,9281
50,12,81,Florida,Manatee County,9,5,18448,9442,9006
50,12,81,Florida,Manatee County,9,6,20462,10143,10319
50,12,81,Florida,Manatee County,9,7,19337,9462,9875
50,12,81,Florida,Manatee County,9,8,19267,9530,9737
50,12,81,Florida,Manatee County,9,9,19224,9381,9843
50,12,81,Florida,Manatee County,9,10,22569,10876,11693
50,12,81,Florida,Manatee County,9,11,24622,11714,12908
50,12,81,Florida,Manatee County,9,12,27303,12741,14562
50,12,81,Florida,Manatee County,9,13,27245,12423,14822
50,12,81,Florida,Manatee County,9,14,29742,13764,15978
50,12,81,Florida,Manatee County,9,15,24620,11634,12986
50,12,81,Florida,Manatee County,9,16,17954,8488,9466
50,12,81,Florida,Manatee County,9,17,13053,6236,6817
50,12,81,Florida,Manatee County,9,18,13512,5738,7774
50,12,81,Florida,Manatee County,10,0,385506,186419,199087
50,12,81,Florida,Manatee County,10,1,18627,9498,9129
50,12,81,Florida,Manatee County,10,2,19785,9949,9836
50,12,81,Florida,Manatee County,10,3,20656,10467,10189
50,12,81,Florida,Manatee County,10,4,19671,10262,9409
50,12,81,Florida,Manatee County,10,5,18581,9593,8988
50,12,81,Florida,Manatee County,10,6,21290,10601,10689
50,12,81,Florida,Manatee County,10,7,19716,9781,9935
50,12,81,Florida,Manatee County,10,8,19891,9692,10199
50,12,81,Florida,Manatee County,10,9,19589,9616,9973
50,12,81,Florida,Manatee County,10,10,22967,11028,11939
50,12,81,Florida,Manatee County,10,11,24654,11815,12839
50,12,81,Florida,Manatee County,10,12,28007,12975,15032
50,12,81,Florida,Manatee County,10,13,28486,13027,15459
50,12,81,Florida,Manatee County,10,14,29518,13548,15970
50,12,81,Florida,Manatee County,10,15,27268,12917,14351
50,12,81,Florida,Manatee County,10,16,19171,9092,10079
50,12,81,Florida,Manatee County,10,17,13416,6401,7015
50,12,81,Florida,Manatee County,10,18,14213,6157,8056
50,12,81,Florida,Manatee County,11,0,394387,190618,203769
50,12,81,Florida,Manatee County,11,1,18525,9494,9031
50,12,81,Florida,Manatee County,11,2,19813,10045,9768
50,12,81,Florida,Manatee County,11,3,21217,10589,10628
50,12,81,Florida,Manatee County,11,4,19770,10372,9398
50,12,81,Florida,Manatee County,11,5,18572,9550,9022
50,12,81,Florida,Manatee County,11,6,21567,10732,10835
50,12,81,Florida,Manatee County,11,7,20258,10006,10252
50,12,81,Florida,Manatee County,11,8,20600,10047,10553
50,12,81,Florida,Manatee County,11,9,19886,9773,10113
50,12,81,Florida,Manatee County,11,10,23030,11079,11951
50,12,81,Florida,Manatee County,11,11,24882,11849,13033
50,12,81,Florida,Manatee County,11,12,28463,13264,15199
50,12,81,Florida,Manatee County,11,13,29637,13612,16025
50,12,81,Florida,Manatee County,11,14,29831,13627,16204
50,12,81,Florida,Manatee County,11,15,28637,13514,15123
50,12,81,Florida,Manatee County,11,16,21059,9966,11093
50,12,81,Florida,Manatee County,11,17,13899,6667,7232
50,12,81,Florida,Manatee County,11,18,14741,6432,8309
50,12,81,Florida,Manatee County,12,0,403253,194807,208446
50,12,81,Florida,Manatee County,12,1,18375,9391,8984
50,12,81,Florida,Manatee County,12,2,19900,10066,9834
50,12,81,Florida,Manatee County,12,3,21428,10734,10694
50,12,81,Florida,Manatee County,12,4,19951,10462,9489
50,12,81,Florida,Manatee County,12,5,18997,9743,9254
50,12,81,Florida,Manatee County,12,6,21596,10756,10840
50,12,81,Florida,Manatee County,12,7,20829,10340,10489
50,12,81,Florida,Manatee County,12,8,21018,10220,10798
50,12,81,Florida,Manatee County,12,9,20443,10002,10441
50,12,81,Florida,Manatee County,12,10,22742,11013,11729
50,12,81,Florida,Manatee County,12,11,24985,11790,13195
50,12,81,Florida,Manatee County,12,12,29054,13613,15441
50,12,81,Florida,Manatee County,12,13,30778,14171,16607
50,12,81,Florida,Manatee County,12,14,30891,14044,16847
50,12,81,Florida,Manatee County,12,15,30112,14200,15912
50,12,81,Florida,Manatee County,12,16,22465,10658,11807
50,12,81,Florida,Manatee County,12,17,14504,6918,7586
50,12,81,Florida,Manatee County,12,18,15185,6686,8499
50,12,83,Florida,Marion County,1,0,331298,158993,172305
50,12,83,Florida,Marion County,1,1,17112,8752,8360
50,12,83,Florida,Marion County,1,2,17413,8942,8471
50,12,83,Florida,Marion County,1,3,18029,9260,8769
50,12,83,Florida,Marion County,1,4,19033,9819,9214
50,12,83,Florida,Marion County,1,5,16336,8164,8172
50,12,83,Florida,Marion County,1,6,16473,7965,8508
50,12,83,Florida,Marion County,1,7,15337,7444,7893
50,12,83,Florida,Marion County,1,8,16921,8083,8838
50,12,83,Florida,Marion County,1,9,18934,9095,9839
50,12,83,Florida,Marion County,1,10,21877,10509,11368
50,12,83,Florida,Marion County,1,11,22514,10402,12112
50,12,83,Florida,Marion County,1,12,21283,9608,11675
50,12,83,Florida,Marion County,1,13,24718,11256,13462
50,12,83,Florida,Marion County,1,14,25466,11804,13662
50,12,83,Florida,Marion County,1,15,21628,10345,11283
50,12,83,Florida,Marion County,1,16,16762,8151,8611
50,12,83,Florida,Marion County,1,17,12060,5679,6381
50,12,83,Florida,Marion County,1,18,9402,3715,5687
50,12,83,Florida,Marion County,2,0,331299,158994,172305
50,12,83,Florida,Marion County,2,1,17112,8752,8360
50,12,83,Florida,Marion County,2,2,17413,8942,8471
50,12,83,Florida,Marion County,2,3,18029,9260,8769
50,12,83,Florida,Marion County,2,4,19034,9819,9215
50,12,83,Florida,Marion County,2,5,16336,8165,8171
50,12,83,Florida,Marion County,2,6,16473,7965,8508
50,12,83,Florida,Marion County,2,7,15337,7444,7893
50,12,83,Florida,Marion County,2,8,16922,8084,8838
50,12,83,Florida,Marion County,2,9,18934,9095,9839
50,12,83,Florida,Marion County,2,10,21877,10509,11368
50,12,83,Florida,Marion County,2,11,22515,10402,12113
50,12,83,Florida,Marion County,2,12,21283,9608,11675
50,12,83,Florida,Marion County,2,13,24718,11256,13462
50,12,83,Florida,Marion County,2,14,25466,11804,13662
50,12,83,Florida,Marion County,2,15,21628,10345,11283
50,12,83,Florida,Marion County,2,16,16762,8151,8611
50,12,83,Florida,Marion County,2,17,12059,5678,6381
50,12,83,Florida,Marion County,2,18,9401,3715,5686
50,12,83,Florida,Marion County,3,0,331331,158988,172343
50,12,83,Florida,Marion County,3,1,16946,8671,8275
50,12,83,Florida,Marion County,3,2,17411,8938,8473
50,12,83,Florida,Marion County,3,3,17996,9241,8755
50,12,83,Florida,Marion County,3,4,18846,9707,9139
50,12,83,Florida,Marion County,3,5,16548,8292,8256
50,12,83,Florida,Marion County,3,6,16459,7976,8483
50,12,83,Florida,Marion County,3,7,15397,7476,7921
50,12,83,Florida,Marion County,3,8,16758,8007,8751
50,12,83,Florida,Marion County,3,9,18889,9063,9826
50,12,83,Florida,Marion County,3,10,21774,10446,11328
50,12,83,Florida,Marion County,3,11,22527,10430,12097
50,12,83,Florida,Marion County,3,12,21385,9665,11720
50,12,83,Florida,Marion County,3,13,24731,11251,13480
50,12,83,Florida,Marion County,3,14,25474,11771,13703
50,12,83,Florida,Marion County,3,15,21724,10368,11356
50,12,83,Florida,Marion County,3,16,16808,8190,8618
50,12,83,Florida,Marion County,3,17,12136,5714,6422
50,12,83,Florida,Marion County,3,18,9522,3782,5740
50,12,83,Florida,Marion County,4,0,332286,159390,172896
50,12,83,Florida,Marion County,4,1,16801,8606,8195
50,12,83,Florida,Marion County,4,2,17285,8816,8469
50,12,83,Florida,Marion County,4,3,17847,9171,8676
50,12,83,Florida,Marion County,4,4,18259,9467,8792
50,12,83,Florida,Marion County,4,5,17514,8818,8696
50,12,83,Florida,Marion County,4,6,16750,8115,8635
50,12,83,Florida,Marion County,4,7,15709,7616,8093
50,12,83,Florida,Marion County,4,8,16085,7641,8444
50,12,83,Florida,Marion County,4,9,18716,8984,9732
50,12,83,Florida,Marion County,4,10,21118,10088,11030
50,12,83,Florida,Marion County,4,11,22516,10488,12028
50,12,83,Florida,Marion County,4,12,21558,9785,11773
50,12,83,Florida,Marion County,4,13,25084,11380,13704
50,12,83,Florida,Marion County,4,14,25452,11670,13782
50,12,83,Florida,Marion County,4,15,22228,10524,11704
50,12,83,Florida,Marion County,4,16,17135,8371,8764
50,12,83,Florida,Marion County,4,17,12361,5847,6514
50,12,83,Florida,Marion County,4,18,9868,4003,5865
50,12,83,Florida,Marion County,5,0,333873,160443,173430
50,12,83,Florida,Marion County,5,1,16715,8645,8070
50,12,83,Florida,Marion County,5,2,17486,8884,8602
50,12,83,Florida,Marion County,5,3,17823,9111,8712
50,12,83,Florida,Marion County,5,4,17882,9296,8586
50,12,83,Florida,Marion County,5,5,18235,9261,8974
50,12,83,Florida,Marion County,5,6,16829,8254,8575
50,12,83,Florida,Marion County,5,7,16110,7721,8389
50,12,83,Florida,Marion County,5,8,15729,7491,8238
50,12,83,Florida,Marion County,5,9,18550,9003,9547
50,12,83,Florida,Marion County,5,10,20555,9821,10734
50,12,83,Florida,Marion County,5,11,22420,10565,11855
50,12,83,Florida,Marion County,5,12,21963,9995,11968
50,12,83,Florida,Marion County,5,13,23924,10736,13188
50,12,83,Florida,Marion County,5,14,26433,12105,14328
50,12,83,Florida,Marion County,5,15,23009,10936,12073
50,12,83,Florida,Marion County,5,16,17511,8464,9047
50,12,83,Florida,Marion County,5,17,12498,6000,6498
50,12,83,Florida,Marion County,5,18,10201,4155,6046
50,12,83,Florida,Marion County,6,0,335083,161019,174064
50,12,83,Florida,Marion County,6,1,16573,8534,8039
50,12,83,Florida,Marion County,6,2,17661,9038,8623
50,12,83,Florida,Marion County,6,3,17793,9080,8713
50,12,83,Florida,Marion County,6,4,17592,9188,8404
50,12,83,Florida,Marion County,6,5,18304,9276,9028
50,12,83,Florida,Marion County,6,6,16988,8332,8656
50,12,83,Florida,Marion County,6,7,16404,7861,8543
50,12,83,Florida,Marion County,6,8,15618,7479,8139
50,12,83,Florida,Marion County,6,9,18189,8732,9457
50,12,83,Florida,Marion County,6,10,20013,9555,10458
50,12,83,Florida,Marion County,6,11,22315,10573,11742
50,12,83,Florida,Marion County,6,12,22457,10220,12237
50,12,83,Florida,Marion County,6,13,23462,10488,12974
50,12,83,Florida,Marion County,6,14,26554,12088,14466
50,12,83,Florida,Marion County,6,15,24196,11555,12641
50,12,83,Florida,Marion County,6,16,18062,8676,9386
50,12,83,Florida,Marion County,6,17,12389,5995,6394
50,12,83,Florida,Marion County,6,18,10513,4349,6164
50,12,83,Florida,Marion County,7,0,338005,162308,175697
50,12,83,Florida,Marion County,7,1,16794,8592,8202
50,12,83,Florida,Marion County,7,2,17751,9068,8683
50,12,83,Florida,Marion County,7,3,17875,9090,8785
50,12,83,Florida,Marion County,7,4,17362,9037,8325
50,12,83,Florida,Marion County,7,5,18106,9154,8952
50,12,83,Florida,Marion County,7,6,17644,8644,9000
50,12,83,Florida,Marion County,7,7,16830,8103,8727
50,12,83,Florida,Marion County,7,8,15911,7725,8186
50,12,83,Florida,Marion County,7,9,17762,8468,9294
50,12,83,Florida,Marion County,7,10,19625,9443,10182
50,12,83,Florida,Marion County,7,11,22185,10527,11658
50,12,83,Florida,Marion County,7,12,22907,10408,12499
50,12,83,Florida,Marion County,7,13,23289,10356,12933
50,12,83,Florida,Marion County,7,14,27155,12399,14756
50,12,83,Florida,Marion County,7,15,24957,11777,13180
50,12,83,Florida,Marion County,7,16,18703,8975,9728
50,12,83,Florida,Marion County,7,17,12492,6055,6437
50,12,83,Florida,Marion County,7,18,10657,4487,6170
50,12,83,Florida,Marion County,8,0,342182,164262,177920
50,12,83,Florida,Marion County,8,1,17160,8824,8336
50,12,83,Florida,Marion County,8,2,17808,9115,8693
50,12,83,Florida,Marion County,8,3,18102,9221,8881
50,12,83,Florida,Marion County,8,4,17453,9071,8382
50,12,83,Florida,Marion County,8,5,17858,9028,8830
50,12,83,Florida,Marion County,8,6,18500,9082,9418
50,12,83,Florida,Marion County,8,7,17263,8298,8965
50,12,83,Florida,Marion County,8,8,16281,7807,8474
50,12,83,Florida,Marion County,8,9,17408,8305,9103
50,12,83,Florida,Marion County,8,10,19594,9416,10178
50,12,83,Florida,Marion County,8,11,21891,10416,11475
50,12,83,Florida,Marion County,8,12,23243,10604,12639
50,12,83,Florida,Marion County,8,13,23449,10329,13120
50,12,83,Florida,Marion County,8,14,27731,12758,14973
50,12,83,Florida,Marion County,8,15,25466,11908,13558
50,12,83,Florida,Marion County,8,16,19253,9223,10030
50,12,83,Florida,Marion County,8,17,12800,6212,6588
50,12,83,Florida,Marion County,8,18,10922,4645,6277
50,12,83,Florida,Marion County,9,0,347469,166953,180516
50,12,83,Florida,Marion County,9,1,17566,9010,8556
50,12,83,Florida,Marion County,9,2,17921,9172,8749
50,12,83,Florida,Marion County,9,3,18423,9356,9067
50,12,83,Florida,Marion County,9,4,17602,9122,8480
50,12,83,Florida,Marion County,9,5,17517,8937,8580
50,12,83,Florida,Marion County,9,6,19512,9670,9842
50,12,83,Florida,Marion County,9,7,17632,8516,9116
50,12,83,Florida,Marion County,9,8,16817,8057,8760
50,12,83,Florida,Marion County,9,9,16924,8041,8883
50,12,83,Florida,Marion County,9,10,19760,9523,10237
50,12,83,Florida,Marion County,9,11,21558,10260,11298
50,12,83,Florida,Marion County,9,12,23608,10795,12813
50,12,83,Florida,Marion County,9,13,24017,10709,13308
50,12,83,Florida,Marion County,9,14,28586,13120,15466
50,12,83,Florida,Marion County,9,15,25812,12017,13795
50,12,83,Florida,Marion County,9,16,19870,9415,10455
50,12,83,Florida,Marion County,9,17,13134,6415,6719
50,12,83,Florida,Marion County,9,18,11210,4818,6392
50,12,83,Florida,Marion County,10,0,353339,169645,183694
50,12,83,Florida,Marion County,10,1,17750,9123,8627
50,12,83,Florida,Marion County,10,2,18235,9336,8899
50,12,83,Florida,Marion County,10,3,18676,9478,9198
50,12,83,Florida,Marion County,10,4,17797,9173,8624
50,12,83,Florida,Marion County,10,5,17325,8912,8413
50,12,83,Florida,Marion County,10,6,20205,9981,10224
50,12,83,Florida,Marion County,10,7,17971,8750,9221
50,12,83,Florida,Marion County,10,8,17660,8400,9260
50,12,83,Florida,Marion County,10,9,16789,7973,8816
50,12,83,Florida,Marion County,10,10,19876,9626,10250
50,12,83,Florida,Marion County,10,11,21377,10121,11256
50,12,83,Florida,Marion County,10,12,23695,10875,12820
50,12,83,Florida,Marion County,10,13,24666,11008,13658
50,12,83,Florida,Marion County,10,14,27750,12545,15205
50,12,83,Florida,Marion County,10,15,27593,12822,14771
50,12,83,Florida,Marion County,10,16,20845,9948,10897
50,12,83,Florida,Marion County,10,17,13541,6519,7022
50,12,83,Florida,Marion County,10,18,11588,5055,6533
50,12,83,Florida,Marion County,11,0,359062,172251,186811
50,12,83,Florida,Marion County,11,1,17841,9114,8727
50,12,83,Florida,Marion County,11,2,18370,9418,8952
50,12,83,Florida,Marion County,11,3,19115,9756,9359
50,12,83,Florida,Marion County,11,4,17865,9136,8729
50,12,83,Florida,Marion County,11,5,17453,8925,8528
50,12,83,Florida,Marion County,11,6,20558,10161,10397
50,12,83,Florida,Marion County,11,7,18651,9132,9519
50,12,83,Florida,Marion County,11,8,18244,8738,9506
50,12,83,Florida,Marion County,11,9,16974,8077,8897
50,12,83,Florida,Marion County,11,10,19695,9485,10210
50,12,83,Florida,Marion County,11,11,21134,9987,11147
50,12,83,Florida,Marion County,11,12,23709,10909,12800
50,12,83,Florida,Marion County,11,13,25570,11499,14071
50,12,83,Florida,Marion County,11,14,27675,12356,15319
50,12,83,Florida,Marion County,11,15,28109,13058,15051
50,12,83,Florida,Marion County,11,16,22212,10603,11609
50,12,83,Florida,Marion County,11,17,14123,6748,7375
50,12,83,Florida,Marion County,11,18,11764,5149,6615
50,12,83,Florida,Marion County,12,0,365579,175184,190395
50,12,83,Florida,Marion County,12,1,17973,9210,8763
50,12,83,Florida,Marion County,12,2,18713,9499,9214
50,12,83,Florida,Marion County,12,3,19414,9926,9488
50,12,83,Florida,Marion County,12,4,18090,9244,8846
50,12,83,Florida,Marion County,12,5,17467,8885,8582
50,12,83,Florida,Marion County,12,6,20780,10345,10435
50,12,83,Florida,Marion County,12,7,19354,9439,9915
50,12,83,Florida,Marion County,12,8,18843,9022,9821
50,12,83,Florida,Marion County,12,9,17473,8384,9089
50,12,83,Florida,Marion County,12,10,19488,9327,10161
50,12,83,Florida,Marion County,12,11,20932,9888,11044
50,12,83,Florida,Marion County,12,12,24073,11112,12961
50,12,83,Florida,Marion County,12,13,26304,11807,14497
50,12,83,Florida,Marion County,12,14,27822,12344,15478
50,12,83,Florida,Marion County,12,15,29176,13629,15547
50,12,83,Florida,Marion County,12,16,23079,10895,12184
50,12,83,Florida,Marion County,12,17,14661,7024,7637
50,12,83,Florida,Marion County,12,18,11937,5204,6733
50,12,85,Florida,Martin County,1,0,146318,72423,73895
50,12,85,Florida,Martin County,1,1,6201,3128,3073
50,12,85,Florida,Martin County,1,2,6896,3497,3399
50,12,85,Florida,Martin County,1,3,7751,3976,3775
50,12,85,Florida,Martin County,1,4,7805,4096,3709
50,12,85,Florida,Martin County,1,5,6422,3529,2893
50,12,85,Florida,Martin County,1,6,6394,3629,2765
50,12,85,Florida,Martin County,1,7,6042,3280,2762
50,12,85,Florida,Martin County,1,8,6755,3490,3265
50,12,85,Florida,Martin County,1,9,8674,4388,4286
50,12,85,Florida,Martin County,1,10,10775,5360,5415
50,12,85,Florida,Martin County,1,11,11406,5647,5759
50,12,85,Florida,Martin County,1,12,10444,4951,5493
50,12,85,Florida,Martin County,1,13,10781,5106,5675
50,12,85,Florida,Martin County,1,14,10517,4892,5625
50,12,85,Florida,Martin County,1,15,8958,4302,4656
50,12,85,Florida,Martin County,1,16,7950,3734,4216
50,12,85,Florida,Martin County,1,17,6538,2978,3560
50,12,85,Florida,Martin County,1,18,6009,2440,3569
50,12,85,Florida,Martin County,2,0,146852,72697,74155
50,12,85,Florida,Martin County,2,1,6217,3136,3081
50,12,85,Florida,Martin County,2,2,6913,3505,3408
50,12,85,Florida,Martin County,2,3,7790,4001,3789
50,12,85,Florida,Martin County,2,4,7845,4121,3724
50,12,85,Florida,Martin County,2,5,6443,3541,2902
50,12,85,Florida,Martin County,2,6,6407,3636,2771
50,12,85,Florida,Martin County,2,7,6052,3285,2767
50,12,85,Florida,Martin County,2,8,6771,3497,3274
50,12,85,Florida,Martin County,2,9,8720,4408,4312
50,12,85,Florida,Martin County,2,10,10824,5383,5441
50,12,85,Florida,Martin County,2,11,11453,5670,5783
50,12,85,Florida,Martin County,2,12,10501,4978,5523
50,12,85,Florida,Martin County,2,13,10831,5135,5696
50,12,85,Florida,Martin County,2,14,10554,4911,5643
50,12,85,Florida,Martin County,2,15,8989,4321,4668
50,12,85,Florida,Martin County,2,16,7969,3741,4228
50,12,85,Florida,Martin County,2,17,6555,2985,3570
50,12,85,Florida,Martin County,2,18,6018,2443,3575
50,12,85,Florida,Martin County,3,0,146909,72688,74221
50,12,85,Florida,Martin County,3,1,6196,3115,3081
50,12,85,Florida,Martin County,3,2,6885,3488,3397
50,12,85,Florida,Martin County,3,3,7781,3982,3799
50,12,85,Florida,Martin County,3,4,7807,4101,3706
50,12,85,Florida,Martin County,3,5,6466,3552,2914
50,12,85,Florida,Martin County,3,6,6424,3641,2783
50,12,85,Florida,Martin County,3,7,6101,3315,2786
50,12,85,Florida,Martin County,3,8,6708,3466,3242
50,12,85,Florida,Martin County,3,9,8658,4379,4279
50,12,85,Florida,Martin County,3,10,10782,5359,5423
50,12,85,Florida,Martin County,3,11,11479,5668,5811
50,12,85,Florida,Martin County,3,12,10529,5004,5525
50,12,85,Florida,Martin County,3,13,10881,5160,5721
50,12,85,Florida,Martin County,3,14,10568,4929,5639
50,12,85,Florida,Martin County,3,15,9025,4328,4697
50,12,85,Florida,Martin County,3,16,7945,3719,4226
50,12,85,Florida,Martin County,3,17,6605,3023,3582
50,12,85,Florida,Martin County,3,18,6069,2459,3610
50,12,85,Florida,Martin County,4,0,147871,73196,74675
50,12,85,Florida,Martin County,4,1,6167,3150,3017
50,12,85,Florida,Martin County,4,2,6865,3519,3346
50,12,85,Florida,Martin County,4,3,7792,3947,3845
50,12,85,Florida,Martin County,4,4,7745,4093,3652
50,12,85,Florida,Martin County,4,5,6704,3640,3064
50,12,85,Florida,Martin County,4,6,6573,3678,2895
50,12,85,Florida,Martin County,4,7,6295,3396,2899
50,12,85,Florida,Martin County,4,8,6399,3354,3045
50,12,85,Florida,Martin County,4,9,8498,4286,4212
50,12,85,Florida,Martin County,4,10,10459,5218,5241
50,12,85,Florida,Martin County,4,11,11432,5596,5836
50,12,85,Florida,Martin County,4,12,10735,5165,5570
50,12,85,Florida,Martin County,4,13,11218,5331,5887
50,12,85,Florida,Martin County,4,14,10624,4977,5647
50,12,85,Florida,Martin County,4,15,9243,4396,4847
50,12,85,Florida,Martin County,4,16,7992,3743,4249
50,12,85,Florida,Martin County,4,17,6811,3177,3634
50,12,85,Florida,Martin County,4,18,6319,2530,3789
50,12,85,Florida,Martin County,5,0,148981,73662,75319
50,12,85,Florida,Martin County,5,1,6106,3115,2991
50,12,85,Florida,Martin County,5,2,6918,3503,3415
50,12,85,Florida,Martin County,5,3,7758,3869,3889
50,12,85,Florida,Martin County,5,4,7727,4130,3597
50,12,85,Florida,Martin County,5,5,6950,3772,3178
50,12,85,Florida,Martin County,5,6,6577,3671,2906
50,12,85,Florida,Martin County,5,7,6420,3462,2958
50,12,85,Florida,Martin County,5,8,6404,3350,3054
50,12,85,Florida,Martin County,5,9,8290,4226,4064
50,12,85,Florida,Martin County,5,10,10121,5048,5073
50,12,85,Florida,Martin County,5,11,11367,5556,5811
50,12,85,Florida,Martin County,5,12,11041,5317,5724
50,12,85,Florida,Martin County,5,13,10850,5167,5683
50,12,85,Florida,Martin County,5,14,11229,5185,6044
50,12,85,Florida,Martin County,5,15,9629,4581,5048
50,12,85,Florida,Martin County,5,16,8027,3775,4252
50,12,85,Florida,Martin County,5,17,6866,3211,3655
50,12,85,Florida,Martin County,5,18,6701,2724,3977
50,12,85,Florida,Martin County,6,0,151126,74847,76279
50,12,85,Florida,Martin County,6,1,6147,3122,3025
50,12,85,Florida,Martin County,6,2,6977,3553,3424
50,12,85,Florida,Martin County,6,3,7664,3827,3837
50,12,85,Florida,Martin County,6,4,7915,4200,3715
50,12,85,Florida,Martin County,6,5,7350,4042,3308
50,12,85,Florida,Martin County,6,6,6682,3762,2920
50,12,85,Florida,Martin County,6,7,6620,3583,3037
50,12,85,Florida,Martin County,6,8,6489,3382,3107
50,12,85,Florida,Martin County,6,9,8123,4143,3980
50,12,85,Florida,Martin County,6,10,9901,4939,4962
50,12,85,Florida,Martin County,6,11,11333,5558,5775
50,12,85,Florida,Martin County,6,12,11432,5544,5888
50,12,85,Florida,Martin County,6,13,10804,5146,5658
50,12,85,Florida,Martin County,6,14,11367,5252,6115
50,12,85,Florida,Martin County,6,15,10289,4805,5484
50,12,85,Florida,Martin County,6,16,8229,3935,4294
50,12,85,Florida,Martin County,6,17,6818,3181,3637
50,12,85,Florida,Martin County,6,18,6986,2873,4113
50,12,85,Florida,Martin County,7,0,153119,75777,77342
50,12,85,Florida,Martin County,7,1,6298,3218,3080
50,12,85,Florida,Martin County,7,2,6957,3528,3429
50,12,85,Florida,Martin County,7,3,7524,3771,3753
50,12,85,Florida,Martin County,7,4,7814,4091,3723
50,12,85,Florida,Martin County,7,5,7415,4042,3373
50,12,85,Florida,Martin County,7,6,6983,3900,3083
50,12,85,Florida,Martin County,7,7,6728,3670,3058
50,12,85,Florida,Martin County,7,8,6447,3379,3068
50,12,85,Florida,Martin County,7,9,8064,4105,3959
50,12,85,Florida,Martin County,7,10,9600,4820,4780
50,12,85,Florida,Martin County,7,11,11395,5627,5768
50,12,85,Florida,Martin County,7,12,11914,5780,6134
50,12,85,Florida,Martin County,7,13,11015,5181,5834
50,12,85,Florida,Martin County,7,14,11689,5450,6239
50,12,85,Florida,Martin County,7,15,10707,4981,5726
50,12,85,Florida,Martin County,7,16,8512,4078,4434
50,12,85,Florida,Martin County,7,17,6796,3162,3634
50,12,85,Florida,Martin County,7,18,7261,2994,4267
50,12,85,Florida,Martin County,8,0,155559,76975,78584
50,12,85,Florida,Martin County,8,1,6354,3235,3119
50,12,85,Florida,Martin County,8,2,7069,3625,3444
50,12,85,Florida,Martin County,8,3,7626,3884,3742
50,12,85,Florida,Martin County,8,4,7886,4084,3802
50,12,85,Florida,Martin County,8,5,7380,3998,3382
50,12,85,Florida,Martin County,8,6,7056,3904,3152
50,12,85,Florida,Martin County,8,7,6886,3745,3141
50,12,85,Florida,Martin County,8,8,6763,3535,3228
50,12,85,Florida,Martin County,8,9,7730,3942,3788
50,12,85,Florida,Martin County,8,10,9575,4786,4789
50,12,85,Florida,Martin County,8,11,11343,5632,5711
50,12,85,Florida,Martin County,8,12,12221,5917,6304
50,12,85,Florida,Martin County,8,13,11479,5366,6113
50,12,85,Florida,Martin County,8,14,12025,5648,6377
50,12,85,Florida,Martin County,8,15,11149,5212,5937
50,12,85,Florida,Martin County,8,16,8637,4144,4493
50,12,85,Florida,Martin County,8,17,6881,3174,3707
50,12,85,Florida,Martin County,8,18,7499,3144,4355
50,12,85,Florida,Martin County,9,0,158325,78253,80072
50,12,85,Florida,Martin County,9,1,6518,3335,3183
50,12,85,Florida,Martin County,9,2,7091,3598,3493
50,12,85,Florida,Martin County,9,3,7736,3947,3789
50,12,85,Florida,Martin County,9,4,7847,4050,3797
50,12,85,Florida,Martin County,9,5,7237,3909,3328
50,12,85,Florida,Martin County,9,6,7387,4007,3380
50,12,85,Florida,Martin County,9,7,7068,3818,3250
50,12,85,Florida,Martin County,9,8,7122,3759,3363
50,12,85,Florida,Martin County,9,9,7470,3847,3623
50,12,85,Florida,Martin County,9,10,9535,4770,4765
50,12,85,Florida,Martin County,9,11,11212,5563,5649
50,12,85,Florida,Martin County,9,12,12509,5974,6535
50,12,85,Florida,Martin County,9,13,11929,5652,6277
50,12,85,Florida,Martin County,9,14,12583,5902,6681
50,12,85,Florida,Martin County,9,15,11353,5326,6027
50,12,85,Florida,Martin County,9,16,9005,4286,4719
50,12,85,Florida,Martin County,9,17,6918,3189,3729
50,12,85,Florida,Martin County,9,18,7805,3321,4484
50,12,85,Florida,Martin County,10,0,159701,78883,80818
50,12,85,Florida,Martin County,10,1,6580,3390,3190
50,12,85,Florida,Martin County,10,2,7018,3559,3459
50,12,85,Florida,Martin County,10,3,7760,3941,3819
50,12,85,Florida,Martin County,10,4,7772,3977,3795
50,12,85,Florida,Martin County,10,5,7136,3905,3231
50,12,85,Florida,Martin County,10,6,7540,4126,3414
50,12,85,Florida,Martin County,10,7,7226,3893,3333
50,12,85,Florida,Martin County,10,8,7237,3829,3408
50,12,85,Florida,Martin County,10,9,7440,3835,3605
50,12,85,Florida,Martin County,10,10,9424,4748,4676
50,12,85,Florida,Martin County,10,11,10891,5328,5563
50,12,85,Florida,Martin County,10,12,12530,5983,6547
50,12,85,Florida,Martin County,10,13,12446,5886,6560
50,12,85,Florida,Martin County,10,14,12240,5784,6456
50,12,85,Florida,Martin County,10,15,11995,5561,6434
50,12,85,Florida,Martin County,10,16,9528,4534,4994
50,12,85,Florida,Martin County,10,17,6865,3124,3741
50,12,85,Florida,Martin County,10,18,8073,3480,4593
50,12,85,Florida,Martin County,11,0,160742,79358,81384
50,12,85,Florida,Martin County,11,1,6628,3438,3190
50,12,85,Florida,Martin County,11,2,7017,3531,3486
50,12,85,Florida,Martin County,11,3,7835,3973,3862
50,12,85,Florida,Martin County,11,4,7646,3902,3744
50,12,85,Florida,Martin County,11,5,6993,3750,3243
50,12,85,Florida,Martin County,11,6,7626,4254,3372
50,12,85,Florida,Martin County,11,7,7400,3971,3429
50,12,85,Florida,Martin County,11,8,7398,3933,3465
50,12,85,Florida,Martin County,11,9,7464,3839,3625
50,12,85,Florida,Martin County,11,10,9192,4649,4543
50,12,85,Florida,Martin County,11,11,10527,5118,5409
50,12,85,Florida,Martin County,11,12,12482,5963,6519
50,12,85,Florida,Martin County,11,13,12793,6089,6704
50,12,85,Florida,Martin County,11,14,12179,5730,6449
50,12,85,Florida,Martin County,11,15,12156,5674,6482
50,12,85,Florida,Martin County,11,16,10223,4785,5438
50,12,85,Florida,Martin County,11,17,7019,3244,3775
50,12,85,Florida,Martin County,11,18,8164,3515,4649
50,12,85,Florida,Martin County,12,0,161000,79574,81426
50,12,85,Florida,Martin County,12,1,6606,3383,3223
50,12,85,Florida,Martin County,12,2,6994,3541,3453
50,12,85,Florida,Martin County,12,3,7649,3906,3743
50,12,85,Florida,Martin County,12,4,7509,3896,3613
50,12,85,Florida,Martin County,12,5,6912,3660,3252
50,12,85,Florida,Martin County,12,6,7599,4187,3412
50,12,85,Florida,Martin County,12,7,7515,4033,3482
50,12,85,Florida,Martin County,12,8,7553,4061,3492
50,12,85,Florida,Martin County,12,9,7352,3857,3495
50,12,85,Florida,Martin County,12,10,8859,4458,4401
50,12,85,Florida,Martin County,12,11,10126,4941,5185
50,12,85,Florida,Martin County,12,12,12428,5976,6452
50,12,85,Florida,Martin County,12,13,13138,6250,6888
50,12,85,Florida,Martin County,12,14,12297,5743,6554
50,12,85,Florida,Martin County,12,15,12421,5848,6573
50,12,85,Florida,Martin County,12,16,10619,4927,5692
50,12,85,Florida,Martin County,12,17,7217,3374,3843
50,12,85,Florida,Martin County,12,18,8206,3533,4673
50,12,86,Florida,Miami-Dade County,1,0,2496435,1208364,1288071
50,12,86,Florida,Miami-Dade County,1,1,149937,76444,73493
50,12,86,Florida,Miami-Dade County,1,2,145253,74318,70935
50,12,86,Florida,Miami-Dade County,1,3,152541,77881,74660
50,12,86,Florida,Miami-Dade County,1,4,168514,86094,82420
50,12,86,Florida,Miami-Dade County,1,5,176823,89112,87711
50,12,86,Florida,Miami-Dade County,1,6,172129,85029,87100
50,12,86,Florida,Miami-Dade County,1,7,168338,82917,85421
50,12,86,Florida,Miami-Dade County,1,8,184733,91993,92740
50,12,86,Florida,Miami-Dade County,1,9,187664,94001,93663
50,12,86,Florida,Miami-Dade County,1,10,198253,97586,100667
50,12,86,Florida,Miami-Dade County,1,11,168364,80358,88006
50,12,86,Florida,Miami-Dade County,1,12,147653,68881,78772
50,12,86,Florida,Miami-Dade County,1,13,124220,57326,66894
50,12,86,Florida,Miami-Dade County,1,14,100980,45532,55448
50,12,86,Florida,Miami-Dade County,1,15,85996,37255,48741
50,12,86,Florida,Miami-Dade County,1,16,67140,28169,38971
50,12,86,Florida,Miami-Dade County,1,17,52031,20462,31569
50,12,86,Florida,Miami-Dade County,1,18,45866,15006,30860
50,12,86,Florida,Miami-Dade County,2,0,2497993,1209922,1288071
50,12,86,Florida,Miami-Dade County,2,1,149936,76444,73492
50,12,86,Florida,Miami-Dade County,2,2,145251,74317,70934
50,12,86,Florida,Miami-Dade County,2,3,152542,77882,74660
50,12,86,Florida,Miami-Dade County,2,4,168573,86153,82420
50,12,86,Florida,Miami-Dade County,2,5,176886,89175,87711
50,12,86,Florida,Miami-Dade County,2,6,172297,85196,87101
50,12,86,Florida,Miami-Dade County,2,7,168542,83122,85420
50,12,86,Florida,Miami-Dade County,2,8,184935,92196,92739
50,12,86,Florida,Miami-Dade County,2,9,187905,94241,93664
50,12,86,Florida,Miami-Dade County,2,10,198519,97852,100667
50,12,86,Florida,Miami-Dade County,2,11,168538,80531,88007
50,12,86,Florida,Miami-Dade County,2,12,147756,68984,78772
50,12,86,Florida,Miami-Dade County,2,13,124266,57373,66893
50,12,86,Florida,Miami-Dade County,2,14,101005,45556,55449
50,12,86,Florida,Miami-Dade County,2,15,86001,37260,48741
50,12,86,Florida,Miami-Dade County,2,16,67143,28171,38972
50,12,86,Florida,Miami-Dade County,2,17,52032,20463,31569
50,12,86,Florida,Miami-Dade County,2,18,45866,15006,30860
50,12,86,Florida,Miami-Dade County,3,0,2506972,1214760,1292212
50,12,86,Florida,Miami-Dade County,3,1,150158,76553,73605
50,12,86,Florida,Miami-Dade County,3,2,145411,74395,71016
50,12,86,Florida,Miami-Dade County,3,3,152527,77921,74606
50,12,86,Florida,Miami-Dade County,3,4,168026,85963,82063
50,12,86,Florida,Miami-Dade County,3,5,178104,89817,88287
50,12,86,Florida,Miami-Dade County,3,6,173718,86054,87664
50,12,86,Florida,Miami-Dade County,3,7,169095,83443,85652
50,12,86,Florida,Miami-Dade County,3,8,184802,92137,92665
50,12,86,Florida,Miami-Dade County,3,9,187787,94232,93555
50,12,86,Florida,Miami-Dade County,3,10,199310,98381,100929
50,12,86,Florida,Miami-Dade County,3,11,169939,81244,88695
50,12,86,Florida,Miami-Dade County,3,12,148605,69474,79131
50,12,86,Florida,Miami-Dade County,3,13,125284,57793,67491
50,12,86,Florida,Miami-Dade County,3,14,101494,45773,55721
50,12,86,Florida,Miami-Dade County,3,15,86522,37492,49030
50,12,86,Florida,Miami-Dade County,3,16,67274,28193,39081
50,12,86,Florida,Miami-Dade County,3,17,52549,20713,31836
50,12,86,Florida,Miami-Dade County,3,18,46367,15182,31185
50,12,86,Florida,Miami-Dade County,4,0,2544531,1236078,1308453
50,12,86,Florida,Miami-Dade County,4,1,152125,77755,74370
50,12,86,Florida,Miami-Dade County,4,2,146512,74779,71733
50,12,86,Florida,Miami-Dade County,4,3,152710,78256,74454
50,12,86,Florida,Miami-Dade County,4,4,164143,84276,79867
50,12,86,Florida,Miami-Dade County,4,5,183805,92866,90939
50,12,86,Florida,Miami-Dade County,4,6,179165,89844,89321
50,12,86,Florida,Miami-Dade County,4,7,171058,84850,86208
50,12,86,Florida,Miami-Dade County,4,8,182427,90901,91526
50,12,86,Florida,Miami-Dade County,4,9,188765,94921,93844
50,12,86,Florida,Miami-Dade County,4,10,202303,100560,101743
50,12,86,Florida,Miami-Dade County,4,11,175578,84396,91182
50,12,86,Florida,Miami-Dade County,4,12,152548,71424,81124
50,12,86,Florida,Miami-Dade County,4,13,130578,60219,70359
50,12,86,Florida,Miami-Dade County,4,14,104385,47038,57347
50,12,86,Florida,Miami-Dade County,4,15,88192,38234,49958
50,12,86,Florida,Miami-Dade County,4,16,68377,28472,39905
50,12,86,Florida,Miami-Dade County,4,17,53821,21401,32420
50,12,86,Florida,Miami-Dade County,4,18,48039,15886,32153
50,12,86,Florida,Miami-Dade County,5,0,2576554,1250175,1326379
50,12,86,Florida,Miami-Dade County,5,1,152844,77983,74861
50,12,86,Florida,Miami-Dade County,5,2,148709,75937,72772
50,12,86,Florida,Miami-Dade County,5,3,151651,77571,74080
50,12,86,Florida,Miami-Dade County,5,4,159062,81405,77657
50,12,86,Florida,Miami-Dade County,5,5,185352,93348,92004
50,12,86,Florida,Miami-Dade County,5,6,184257,92862,91395
50,12,86,Florida,Miami-Dade County,5,7,174540,86727,87813
50,12,86,Florida,Miami-Dade County,5,8,180344,89442,90902
50,12,86,Florida,Miami-Dade County,5,9,191128,95829,95299
50,12,86,Florida,Miami-Dade County,5,10,201967,100304,101663
50,12,86,Florida,Miami-Dade County,5,11,181301,87575,93726
50,12,86,Florida,Miami-Dade County,5,12,157304,73662,83642
50,12,86,Florida,Miami-Dade County,5,13,133341,61285,72056
50,12,86,Florida,Miami-Dade County,5,14,109859,49580,60279
50,12,86,Florida,Miami-Dade County,5,15,89828,38997,50831
50,12,86,Florida,Miami-Dade County,5,16,70306,29193,41113
50,12,86,Florida,Miami-Dade County,5,17,54537,21758,32779
50,12,86,Florida,Miami-Dade County,5,18,50224,16717,33507
50,12,86,Florida,Miami-Dade County,6,0,2609692,1267020,1342672
50,12,86,Florida,Miami-Dade County,6,1,152023,77322,74701
50,12,86,Florida,Miami-Dade County,6,2,150099,76607,73492
50,12,86,Florida,Miami-Dade County,6,3,150451,76886,73565
50,12,86,Florida,Miami-Dade County,6,4,158576,81225,77351
50,12,86,Florida,Miami-Dade County,6,5,186033,93922,92111
50,12,86,Florida,Miami-Dade County,6,6,187760,95121,92639
50,12,86,Florida,Miami-Dade County,6,7,178335,89275,89060
50,12,86,Florida,Miami-Dade County,6,8,180075,89312,90763
50,12,86,Florida,Miami-Dade County,6,9,194614,97481,97133
50,12,86,Florida,Miami-Dade County,6,10,199431,99287,100144
50,12,86,Florida,Miami-Dade County,6,11,188730,91511,97219
50,12,86,Florida,Miami-Dade County,6,12,160199,75340,84859
50,12,86,Florida,Miami-Dade County,6,13,136726,62428,74298
50,12,86,Florida,Miami-Dade County,6,14,113121,50991,62130
50,12,86,Florida,Miami-Dade County,6,15,92787,40399,52388
50,12,86,Florida,Miami-Dade County,6,16,73005,30353,42652
50,12,86,Florida,Miami-Dade County,6,17,55211,21929,33282
50,12,86,Florida,Miami-Dade County,6,18,52516,17631,34885
50,12,86,Florida,Miami-Dade County,7,0,2634269,1279190,1355079
50,12,86,Florida,Miami-Dade County,7,1,153754,78220,75534
50,12,86,Florida,Miami-Dade County,7,2,150231,76842,73389
50,12,86,Florida,Miami-Dade County,7,3,149501,76382,73119
50,12,86,Florida,Miami-Dade County,7,4,156715,80020,76695
50,12,86,Florida,Miami-Dade County,7,5,183277,92570,90707
50,12,86,Florida,Miami-Dade County,7,6,190482,96912,93570
50,12,86,Florida,Miami-Dade County,7,7,181958,91306,90652
50,12,86,Florida,Miami-Dade County,7,8,179056,89208,89848
50,12,86,Florida,Miami-Dade County,7,9,195514,97684,97830
50,12,86,Florida,Miami-Dade County,7,10,196085,97701,98384
50,12,86,Florida,Miami-Dade County,7,11,196183,95439,100744
50,12,86,Florida,Miami-Dade County,7,12,163076,76849,86227
50,12,86,Florida,Miami-Dade County,7,13,141387,64445,76942
50,12,86,Florida,Miami-Dade County,7,14,116548,52504,64044
50,12,86,Florida,Miami-Dade County,7,15,94533,41190,53343
50,12,86,Florida,Miami-Dade County,7,16,75846,31484,44362
50,12,86,Florida,Miami-Dade County,7,17,55116,21779,33337
50,12,86,Florida,Miami-Dade County,7,18,55007,18655,36352
50,12,86,Florida,Miami-Dade County,8,0,2659839,1292164,1367675
50,12,86,Florida,Miami-Dade County,8,1,156342,79854,76488
50,12,86,Florida,Miami-Dade County,8,2,150412,76647,73765
50,12,86,Florida,Miami-Dade County,8,3,149341,76375,72966
50,12,86,Florida,Miami-Dade County,8,4,156629,79953,76676
50,12,86,Florida,Miami-Dade County,8,5,177481,89901,87580
50,12,86,Florida,Miami-Dade County,8,6,193952,98696,95256
50,12,86,Florida,Miami-Dade County,8,7,185080,93236,91844
50,12,86,Florida,Miami-Dade County,8,8,180548,89976,90572
50,12,86,Florida,Miami-Dade County,8,9,194176,96994,97182
50,12,86,Florida,Miami-Dade County,8,10,194040,96643,97397
50,12,86,Florida,Miami-Dade County,8,11,200886,98258,102628
50,12,86,Florida,Miami-Dade County,8,12,167146,78981,88165
50,12,86,Florida,Miami-Dade County,8,13,145183,66201,78982
50,12,86,Florida,Miami-Dade County,8,14,120739,54032,66707
50,12,86,Florida,Miami-Dade County,8,15,96679,42286,54393
50,12,86,Florida,Miami-Dade County,8,16,78002,32438,45564
50,12,86,Florida,Miami-Dade County,8,17,55752,21930,33822
50,12,86,Florida,Miami-Dade County,8,18,57451,19763,37688
50,12,86,Florida,Miami-Dade County,9,0,2692213,1308460,1383753
50,12,86,Florida,Miami-Dade County,9,1,158201,80705,77496
50,12,86,Florida,Miami-Dade County,9,2,151994,77638,74356
50,12,86,Florida,Miami-Dade County,9,3,150420,76451,73969
50,12,86,Florida,Miami-Dade County,9,4,157520,80586,76934
50,12,86,Florida,Miami-Dade County,9,5,172718,87846,84872
50,12,86,Florida,Miami-Dade County,9,6,197127,100099,97028
50,12,86,Florida,Miami-Dade County,9,7,189659,96257,93402
50,12,86,Florida,Miami-Dade County,9,8,181706,90689,91017
50,12,86,Florida,Miami-Dade County,9,9,192806,96134,96672
50,12,86,Florida,Miami-Dade County,9,10,194918,97118,97800
50,12,86,Florida,Miami-Dade County,9,11,204410,100464,103946
50,12,86,Florida,Miami-Dade County,9,12,171840,81547,90293
50,12,86,Florida,Miami-Dade County,9,13,148413,67734,80679
50,12,86,Florida,Miami-Dade County,9,14,125324,55930,69394
50,12,86,Florida,Miami-Dade County,9,15,99099,43222,55877
50,12,86,Florida,Miami-Dade County,9,16,79484,33166,46318
50,12,86,Florida,Miami-Dade County,9,17,57066,22327,34739
50,12,86,Florida,Miami-Dade County,9,18,59508,20547,38961
50,12,86,Florida,Miami-Dade County,10,0,2713295,1318403,1394892
50,12,86,Florida,Miami-Dade County,10,1,159517,81535,77982
50,12,86,Florida,Miami-Dade County,10,2,151569,77296,74273
50,12,86,Florida,Miami-Dade County,10,3,151866,77061,74805
50,12,86,Florida,Miami-Dade County,10,4,157410,80642,76768
50,12,86,Florida,Miami-Dade County,10,5,169115,86004,83111
50,12,86,Florida,Miami-Dade County,10,6,197245,100026,97219
50,12,86,Florida,Miami-Dade County,10,7,192542,98325,94217
50,12,86,Florida,Miami-Dade County,10,8,182472,91262,91210
50,12,86,Florida,Miami-Dade County,10,9,190351,94586,95765
50,12,86,Florida,Miami-Dade County,10,10,196721,98052,98669
50,12,86,Florida,Miami-Dade County,10,11,203913,100339,103574
50,12,86,Florida,Miami-Dade County,10,12,177208,84226,92982
50,12,86,Florida,Miami-Dade County,10,13,151812,69349,82463
50,12,86,Florida,Miami-Dade County,10,14,127257,56616,70641
50,12,86,Florida,Miami-Dade County,10,15,103338,45099,58239
50,12,86,Florida,Miami-Dade County,10,16,80985,33750,47235
50,12,86,Florida,Miami-Dade County,10,17,58766,23049,35717
50,12,86,Florida,Miami-Dade County,10,18,61208,21186,40022
50,12,86,Florida,Miami-Dade County,11,0,2714854,1319237,1395617
50,12,86,Florida,Miami-Dade County,11,1,158745,81202,77543
50,12,86,Florida,Miami-Dade County,11,2,149659,76293,73366
50,12,86,Florida,Miami-Dade County,11,3,152083,77253,74830
50,12,86,Florida,Miami-Dade County,11,4,155802,79688,76114
50,12,86,Florida,Miami-Dade County,11,5,165190,83912,81278
50,12,86,Florida,Miami-Dade County,11,6,194038,98443,95595
50,12,86,Florida,Miami-Dade County,11,7,192386,98645,93741
50,12,86,Florida,Miami-Dade County,11,8,182973,91864,91109
50,12,86,Florida,Miami-Dade County,11,9,187144,92703,94441
50,12,86,Florida,Miami-Dade County,11,10,198056,98617,99439
50,12,86,Florida,Miami-Dade County,11,11,199368,98347,101021
50,12,86,Florida,Miami-Dade County,11,12,183551,87739,95812
50,12,86,Florida,Miami-Dade County,11,13,153580,70433,83147
50,12,86,Florida,Miami-Dade County,11,14,130249,57634,72615
50,12,86,Florida,Miami-Dade County,11,15,105473,46121,59352
50,12,86,Florida,Miami-Dade County,11,16,82816,34605,48211
50,12,86,Florida,Miami-Dade County,11,17,61025,24057,36968
50,12,86,Florida,Miami-Dade County,11,18,62716,21681,41035
50,12,86,Florida,Miami-Dade County,12,0,2716940,1320180,1396760
50,12,86,Florida,Miami-Dade County,12,1,157229,80461,76768
50,12,86,Florida,Miami-Dade County,12,2,150127,76494,73633
50,12,86,Florida,Miami-Dade County,12,3,150969,76808,74161
50,12,86,Florida,Miami-Dade County,12,4,154003,78575,75428
50,12,86,Florida,Miami-Dade County,12,5,162524,82487,80037
50,12,86,Florida,Miami-Dade County,12,6,189314,96076,93238
50,12,86,Florida,Miami-Dade County,12,7,193704,99553,94151
50,12,86,Florida,Miami-Dade County,12,8,184876,93205,91671
50,12,86,Florida,Miami-Dade County,12,9,184388,91360,93028
50,12,86,Florida,Miami-Dade County,12,10,197549,98184,99365
50,12,86,Florida,Miami-Dade County,12,11,195001,96377,98624
50,12,86,Florida,Miami-Dade County,12,12,189311,90963,98348
50,12,86,Florida,Miami-Dade County,12,13,155338,71348,83990
50,12,86,Florida,Miami-Dade County,12,14,133162,58774,74388
50,12,86,Florida,Miami-Dade County,12,15,108234,47363,60871
50,12,86,Florida,Miami-Dade County,12,16,84061,35191,48870
50,12,86,Florida,Miami-Dade County,12,17,63452,24942,38510
50,12,86,Florida,Miami-Dade County,12,18,63698,22019,41679
50,12,87,Florida,Monroe County,1,0,73090,38962,34128
50,12,87,Florida,Monroe County,1,1,3189,1639,1550
50,12,87,Florida,Monroe County,1,2,2858,1409,1449
50,12,87,Florida,Monroe County,1,3,2937,1539,1398
50,12,87,Florida,Monroe County,1,4,3260,1763,1497
50,12,87,Florida,Monroe County,1,5,3758,2043,1715
50,12,87,Florida,Monroe County,1,6,4687,2539,2148
50,12,87,Florida,Monroe County,1,7,4198,2262,1936
50,12,87,Florida,Monroe County,1,8,4578,2466,2112
50,12,87,Florida,Monroe County,1,9,5309,2861,2448
50,12,87,Florida,Monroe County,1,10,6211,3296,2915
50,12,87,Florida,Monroe County,1,11,6665,3471,3194
50,12,87,Florida,Monroe County,1,12,6744,3557,3187
50,12,87,Florida,Monroe County,1,13,6227,3463,2764
50,12,87,Florida,Monroe County,1,14,4617,2537,2080
50,12,87,Florida,Monroe County,1,15,3079,1737,1342
50,12,87,Florida,Monroe County,1,16,2024,1086,938
50,12,87,Florida,Monroe County,1,17,1585,790,795
50,12,87,Florida,Monroe County,1,18,1164,504,660
50,12,87,Florida,Monroe County,2,0,73090,38962,34128
50,12,87,Florida,Monroe County,2,1,3189,1639,1550
50,12,87,Florida,Monroe County,2,2,2858,1409,1449
50,12,87,Florida,Monroe County,2,3,2937,1539,1398
50,12,87,Florida,Monroe County,2,4,3260,1763,1497
50,12,87,Florida,Monroe County,2,5,3758,2043,1715
50,12,87,Florida,Monroe County,2,6,4687,2539,2148
50,12,87,Florida,Monroe County,2,7,4198,2262,1936
50,12,87,Florida,Monroe County,2,8,4578,2466,2112
50,12,87,Florida,Monroe County,2,9,5309,2861,2448
50,12,87,Florida,Monroe County,2,10,6211,3296,2915
50,12,87,Florida,Monroe County,2,11,6665,3471,3194
50,12,87,Florida,Monroe County,2,12,6744,3557,3187
50,12,87,Florida,Monroe County,2,13,6227,3463,2764
50,12,87,Florida,Monroe County,2,14,4617,2537,2080
50,12,87,Florida,Monroe County,2,15,3079,1737,1342
50,12,87,Florida,Monroe County,2,16,2024,1086,938
50,12,87,Florida,Monroe County,2,17,1585,790,795
50,12,87,Florida,Monroe County,2,18,1164,504,660
50,12,87,Florida,Monroe County,3,0,73220,38991,34229
50,12,87,Florida,Monroe County,3,1,3203,1648,1555
50,12,87,Florida,Monroe County,3,2,2860,1420,1440
50,12,87,Florida,Monroe County,3,3,2947,1537,1410
50,12,87,Florida,Monroe County,3,4,3243,1743,1500
50,12,87,Florida,Monroe County,3,5,3794,2065,1729
50,12,87,Florida,Monroe County,3,6,4675,2527,2148
50,12,87,Florida,Monroe County,3,7,4236,2274,1962
50,12,87,Florida,Monroe County,3,8,4554,2460,2094
50,12,87,Florida,Monroe County,3,9,5261,2824,2437
50,12,87,Florida,Monroe County,3,10,6187,3285,2902
50,12,87,Florida,Monroe County,3,11,6637,3455,3182
50,12,87,Florida,Monroe County,3,12,6743,3552,3191
50,12,87,Florida,Monroe County,3,13,6275,3468,2807
50,12,87,Florida,Monroe County,3,14,4668,2570,2098
50,12,87,Florida,Monroe County,3,15,3106,1749,1357
50,12,87,Florida,Monroe County,3,16,2055,1109,946
50,12,87,Florida,Monroe County,3,17,1583,789,794
50,12,87,Florida,Monroe County,3,18,1193,516,677
50,12,87,Florida,Monroe County,4,0,73967,39248,34719
50,12,87,Florida,Monroe County,4,1,3317,1690,1627
50,12,87,Florida,Monroe County,4,2,2932,1472,1460
50,12,87,Florida,Monroe County,4,3,3032,1553,1479
50,12,87,Florida,Monroe County,4,4,3250,1737,1513
50,12,87,Florida,Monroe County,4,5,3836,2109,1727
50,12,87,Florida,Monroe County,4,6,4768,2600,2168
50,12,87,Florida,Monroe County,4,7,4345,2283,2062
50,12,87,Florida,Monroe County,4,8,4447,2418,2029
50,12,87,Florida,Monroe County,4,9,5244,2771,2473
50,12,87,Florida,Monroe County,4,10,6049,3229,2820
50,12,87,Florida,Monroe County,4,11,6521,3401,3120
50,12,87,Florida,Monroe County,4,12,6690,3475,3215
50,12,87,Florida,Monroe County,4,13,6471,3485,2986
50,12,87,Florida,Monroe County,4,14,4829,2695,2134
50,12,87,Florida,Monroe County,4,15,3222,1770,1452
50,12,87,Florida,Monroe County,4,16,2185,1205,980
50,12,87,Florida,Monroe County,4,17,1555,788,767
50,12,87,Florida,Monroe County,4,18,1274,567,707
50,12,87,Florida,Monroe County,5,0,74560,39450,35110
50,12,87,Florida,Monroe County,5,1,3368,1752,1616
50,12,87,Florida,Monroe County,5,2,3049,1551,1498
50,12,87,Florida,Monroe County,5,3,2977,1519,1458
50,12,87,Florida,Monroe County,5,4,3175,1685,1490
50,12,87,Florida,Monroe County,5,5,3860,2103,1757
50,12,87,Florida,Monroe County,5,6,4796,2634,2162
50,12,87,Florida,Monroe County,5,7,4446,2349,2097
50,12,87,Florida,Monroe County,5,8,4374,2332,2042
50,12,87,Florida,Monroe County,5,9,5166,2736,2430
50,12,87,Florida,Monroe County,5,10,5883,3148,2735
50,12,87,Florida,Monroe County,5,11,6447,3315,3132
50,12,87,Florida,Monroe County,5,12,6655,3450,3205
50,12,87,Florida,Monroe County,5,13,6320,3334,2986
50,12,87,Florida,Monroe County,5,14,5287,2950,2337
50,12,87,Florida,Monroe County,5,15,3472,1879,1593
50,12,87,Florida,Monroe County,5,16,2316,1312,1004
50,12,87,Florida,Monroe County,5,17,1564,787,777
50,12,87,Florida,Monroe County,5,18,1405,614,791
50,12,87,Florida,Monroe County,6,0,75813,40016,35797
50,12,87,Florida,Monroe County,6,1,3374,1739,1635
50,12,87,Florida,Monroe County,6,2,3085,1574,1511
50,12,87,Florida,Monroe County,6,3,2987,1512,1475
50,12,87,Florida,Monroe County,6,4,3185,1678,1507
50,12,87,Florida,Monroe County,6,5,4079,2235,1844
50,12,87,Florida,Monroe County,6,6,4910,2654,2256
50,12,87,Florida,Monroe County,6,7,4609,2478,2131
50,12,87,Florida,Monroe County,6,8,4448,2375,2073
50,12,87,Florida,Monroe County,6,9,5148,2720,2428
50,12,87,Florida,Monroe County,6,10,5840,3118,2722
50,12,87,Florida,Monroe County,6,11,6436,3293,3143
50,12,87,Florida,Monroe County,6,12,6632,3443,3189
50,12,87,Florida,Monroe County,6,13,6373,3318,3055
50,12,87,Florida,Monroe County,6,14,5387,2960,2427
50,12,87,Florida,Monroe County,6,15,3813,2089,1724
50,12,87,Florida,Monroe County,6,16,2376,1329,1047
50,12,87,Florida,Monroe County,6,17,1616,810,806
50,12,87,Florida,Monroe County,6,18,1515,691,824
50,12,87,Florida,Monroe County,7,0,76261,40074,36187
50,12,87,Florida,Monroe County,7,1,3492,1780,1712
50,12,87,Florida,Monroe County,7,2,3165,1622,1543
50,12,87,Florida,Monroe County,7,3,2999,1515,1484
50,12,87,Florida,Monroe County,7,4,3025,1587,1438
50,12,87,Florida,Monroe County,7,5,4029,2169,1860
50,12,87,Florida,Monroe County,7,6,4913,2616,2297
50,12,87,Florida,Monroe County,7,7,4726,2565,2161
50,12,87,Florida,Monroe County,7,8,4454,2380,2074
50,12,87,Florida,Monroe County,7,9,5016,2634,2382
50,12,87,Florida,Monroe County,7,10,5664,2993,2671
50,12,87,Florida,Monroe County,7,11,6489,3341,3148
50,12,87,Florida,Monroe County,7,12,6612,3434,3178
50,12,87,Florida,Monroe County,7,13,6323,3226,3097
50,12,87,Florida,Monroe County,7,14,5580,3025,2555
50,12,87,Florida,Monroe County,7,15,4073,2261,1812
50,12,87,Florida,Monroe County,7,16,2524,1385,1139
50,12,87,Florida,Monroe County,7,17,1576,810,766
50,12,87,Florida,Monroe County,7,18,1601,731,870
50,12,87,Florida,Monroe County,8,0,76648,40123,36525
50,12,87,Florida,Monroe County,8,1,3572,1796,1776
50,12,87,Florida,Monroe County,8,2,3111,1612,1499
50,12,87,Florida,Monroe County,8,3,2983,1520,1463
50,12,87,Florida,Monroe County,8,4,3032,1602,1430
50,12,87,Florida,Monroe County,8,5,3952,2093,1859
50,12,87,Florida,Monroe County,8,6,4965,2646,2319
50,12,87,Florida,Monroe County,8,7,4824,2608,2216
50,12,87,Florida,Monroe County,8,8,4531,2426,2105
50,12,87,Florida,Monroe County,8,9,4892,2523,2369
50,12,87,Florida,Monroe County,8,10,5531,2889,2642
50,12,87,Florida,Monroe County,8,11,6401,3327,3074
50,12,87,Florida,Monroe County,8,12,6588,3358,3230
50,12,87,Florida,Monroe County,8,13,6359,3239,3120
50,12,87,Florida,Monroe County,8,14,5753,3094,2659
50,12,87,Florida,Monroe County,8,15,4242,2332,1910
50,12,87,Florida,Monroe County,8,16,2704,1470,1234
50,12,87,Florida,Monroe County,8,17,1559,822,737
50,12,87,Florida,Monroe County,8,18,1649,766,883
50,12,87,Florida,Monroe County,9,0,76872,40115,36757
50,12,87,Florida,Monroe County,9,1,3565,1803,1762
50,12,87,Florida,Monroe County,9,2,3197,1644,1553
50,12,87,Florida,Monroe County,9,3,2996,1539,1457
50,12,87,Florida,Monroe County,9,4,2980,1548,1432
50,12,87,Florida,Monroe County,9,5,3914,2050,1864
50,12,87,Florida,Monroe County,9,6,4956,2607,2349
50,12,87,Florida,Monroe County,9,7,4948,2656,2292
50,12,87,Florida,Monroe County,9,8,4533,2375,2158
50,12,87,Florida,Monroe County,9,9,4761,2527,2234
50,12,87,Florida,Monroe County,9,10,5472,2821,2651
50,12,87,Florida,Monroe County,9,11,6303,3300,3003
50,12,87,Florida,Monroe County,9,12,6523,3331,3192
50,12,87,Florida,Monroe County,9,13,6350,3235,3115
50,12,87,Florida,Monroe County,9,14,5892,3094,2798
50,12,87,Florida,Monroe County,9,15,4402,2443,1959
50,12,87,Florida,Monroe County,9,16,2786,1480,1306
50,12,87,Florida,Monroe County,9,17,1642,892,750
50,12,87,Florida,Monroe County,9,18,1652,770,882
50,12,87,Florida,Monroe County,10,0,76483,39866,36617
50,12,87,Florida,Monroe County,10,1,3522,1803,1719
50,12,87,Florida,Monroe County,10,2,3163,1609,1554
50,12,87,Florida,Monroe County,10,3,3024,1565,1459
50,12,87,Florida,Monroe County,10,4,2941,1518,1423
50,12,87,Florida,Monroe County,10,5,3801,2001,1800
50,12,87,Florida,Monroe County,10,6,4873,2569,2304
50,12,87,Florida,Monroe County,10,7,4918,2602,2316
50,12,87,Florida,Monroe County,10,8,4592,2439,2153
50,12,87,Florida,Monroe County,10,9,4626,2460,2166
50,12,87,Florida,Monroe County,10,10,5317,2749,2568
50,12,87,Florida,Monroe County,10,11,6059,3120,2939
50,12,87,Florida,Monroe County,10,12,6533,3373,3160
50,12,87,Florida,Monroe County,10,13,6283,3196,3087
50,12,87,Florida,Monroe County,10,14,5828,3011,2817
50,12,87,Florida,Monroe County,10,15,4684,2584,2100
50,12,87,Florida,Monroe County,10,16,2914,1521,1393
50,12,87,Florida,Monroe County,10,17,1715,960,755
50,12,87,Florida,Monroe County,10,18,1690,786,904
50,12,87,Florida,Monroe County,11,0,74757,38958,35799
50,12,87,Florida,Monroe County,11,1,3464,1791,1673
50,12,87,Florida,Monroe County,11,2,3056,1536,1520
50,12,87,Florida,Monroe County,11,3,3044,1601,1443
50,12,87,Florida,Monroe County,11,4,2853,1450,1403
50,12,87,Florida,Monroe County,11,5,3557,1886,1671
50,12,87,Florida,Monroe County,11,6,4637,2432,2205
50,12,87,Florida,Monroe County,11,7,4638,2457,2181
50,12,87,Florida,Monroe County,11,8,4492,2405,2087
50,12,87,Florida,Monroe County,11,9,4479,2355,2124
50,12,87,Florida,Monroe County,11,10,5091,2616,2475
50,12,87,Florida,Monroe County,11,11,5806,3063,2743
50,12,87,Florida,Monroe County,11,12,6278,3223,3055
50,12,87,Florida,Monroe County,11,13,6114,3118,2996
50,12,87,Florida,Monroe County,11,14,5801,2975,2826
50,12,87,Florida,Monroe County,11,15,4750,2572,2178
50,12,87,Florida,Monroe County,11,16,3201,1677,1524
50,12,87,Florida,Monroe County,11,17,1771,979,792
50,12,87,Florida,Monroe County,11,18,1725,822,903
50,12,87,Florida,Monroe County,12,0,74228,38454,35774
50,12,87,Florida,Monroe County,12,1,3318,1690,1628
50,12,87,Florida,Monroe County,12,2,3100,1584,1516
50,12,87,Florida,Monroe County,12,3,3087,1615,1472
50,12,87,Florida,Monroe County,12,4,2882,1468,1414
50,12,87,Florida,Monroe County,12,5,3436,1807,1629
50,12,87,Florida,Monroe County,12,6,4560,2360,2200
50,12,87,Florida,Monroe County,12,7,4569,2400,2169
50,12,87,Florida,Monroe County,12,8,4521,2422,2099
50,12,87,Florida,Monroe County,12,9,4376,2292,2084
50,12,87,Florida,Monroe County,12,10,4895,2502,2393
50,12,87,Florida,Monroe County,12,11,5510,2861,2649
50,12,87,Florida,Monroe County,12,12,6369,3285,3084
50,12,87,Florida,Monroe County,12,13,5977,3030,2947
50,12,87,Florida,Monroe County,12,14,5716,2871,2845
50,12,87,Florida,Monroe County,12,15,4920,2658,2262
50,12,87,Florida,Monroe County,12,16,3395,1770,1625
50,12,87,Florida,Monroe County,12,17,1832,988,844
50,12,87,Florida,Monroe County,12,18,1765,851,914
50,12,89,Florida,Nassau County,1,0,73314,36146,37168
50,12,89,Florida,Nassau County,1,1,3983,2099,1884
50,12,89,Florida,Nassau County,1,2,4325,2201,2124
50,12,89,Florida,Nassau County,1,3,4816,2429,2387
50,12,89,Florida,Nassau County,1,4,4628,2360,2268
50,12,89,Florida,Nassau County,1,5,3895,2034,1861
50,12,89,Florida,Nassau County,1,6,3803,1907,1896
50,12,89,Florida,Nassau County,1,7,3810,1837,1973
50,12,89,Florida,Nassau County,1,8,4580,2253,2327
50,12,89,Florida,Nassau County,1,9,4910,2385,2525
50,12,89,Florida,Nassau County,1,10,5710,2771,2939
50,12,89,Florida,Nassau County,1,11,5853,2900,2953
50,12,89,Florida,Nassau County,1,12,5614,2690,2924
50,12,89,Florida,Nassau County,1,13,5479,2619,2860
50,12,89,Florida,Nassau County,1,14,4355,2156,2199
50,12,89,Florida,Nassau County,1,15,3041,1535,1506
50,12,89,Florida,Nassau County,1,16,2117,989,1128
50,12,89,Florida,Nassau County,1,17,1362,610,752
50,12,89,Florida,Nassau County,1,18,1033,371,662
50,12,89,Florida,Nassau County,2,0,73310,36143,37167
50,12,89,Florida,Nassau County,2,1,3983,2099,1884
50,12,89,Florida,Nassau County,2,2,4323,2199,2124
50,12,89,Florida,Nassau County,2,3,4815,2429,2386
50,12,89,Florida,Nassau County,2,4,4627,2359,2268
50,12,89,Florida,Nassau County,2,5,3896,2035,1861
50,12,89,Florida,Nassau County,2,6,3803,1907,1896
50,12,89,Florida,Nassau County,2,7,3810,1837,1973
50,12,89,Florida,Nassau County,2,8,4580,2253,2327
50,12,89,Florida,Nassau County,2,9,4910,2385,2525
50,12,89,Florida,Nassau County,2,10,5708,2770,2938
50,12,89,Florida,Nassau County,2,11,5854,2901,2953
50,12,89,Florida,Nassau County,2,12,5614,2690,2924
50,12,89,Florida,Nassau County,2,13,5479,2619,2860
50,12,89,Florida,Nassau County,2,14,4355,2156,2199
50,12,89,Florida,Nassau County,2,15,3041,1535,1506
50,12,89,Florida,Nassau County,2,16,2116,988,1128
50,12,89,Florida,Nassau County,2,17,1363,610,753
50,12,89,Florida,Nassau County,2,18,1033,371,662
50,12,89,Florida,Nassau County,3,0,73513,36250,37263
50,12,89,Florida,Nassau County,3,1,3971,2093,1878
50,12,89,Florida,Nassau County,3,2,4305,2192,2113
50,12,89,Florida,Nassau County,3,3,4830,2439,2391
50,12,89,Florida,Nassau County,3,4,4579,2342,2237
50,12,89,Florida,Nassau County,3,5,3985,2064,1921
50,12,89,Florida,Nassau County,3,6,3817,1926,1891
50,12,89,Florida,Nassau County,3,7,3846,1856,1990
50,12,89,Florida,Nassau County,3,8,4546,2231,2315
50,12,89,Florida,Nassau County,3,9,4884,2386,2498
50,12,89,Florida,Nassau County,3,10,5713,2761,2952
50,12,89,Florida,Nassau County,3,11,5847,2900,2947
50,12,89,Florida,Nassau County,3,12,5625,2696,2929
50,12,89,Florida,Nassau County,3,13,5503,2625,2878
50,12,89,Florida,Nassau County,3,14,4400,2183,2217
50,12,89,Florida,Nassau County,3,15,3087,1558,1529
50,12,89,Florida,Nassau County,3,16,2131,996,1135
50,12,89,Florida,Nassau County,3,17,1392,619,773
50,12,89,Florida,Nassau County,3,18,1052,383,669
50,12,89,Florida,Nassau County,4,0,74148,36555,37593
50,12,89,Florida,Nassau County,4,1,3970,2061,1909
50,12,89,Florida,Nassau County,4,2,4261,2180,2081
50,12,89,Florida,Nassau County,4,3,4787,2445,2342
50,12,89,Florida,Nassau County,4,4,4402,2269,2133
50,12,89,Florida,Nassau County,4,5,4169,2120,2049
50,12,89,Florida,Nassau County,4,6,3887,1976,1911
50,12,89,Florida,Nassau County,4,7,3900,1892,2008
50,12,89,Florida,Nassau County,4,8,4345,2124,2221
50,12,89,Florida,Nassau County,4,9,4986,2471,2515
50,12,89,Florida,Nassau County,4,10,5631,2706,2925
50,12,89,Florida,Nassau County,4,11,5818,2889,2929
50,12,89,Florida,Nassau County,4,12,5681,2719,2962
50,12,89,Florida,Nassau County,4,13,5691,2700,2991
50,12,89,Florida,Nassau County,4,14,4570,2272,2298
50,12,89,Florida,Nassau County,4,15,3234,1602,1632
50,12,89,Florida,Nassau County,4,16,2199,1046,1153
50,12,89,Florida,Nassau County,4,17,1458,651,807
50,12,89,Florida,Nassau County,4,18,1159,432,727
50,12,89,Florida,Nassau County,5,0,74519,36698,37821
50,12,89,Florida,Nassau County,5,1,3871,1942,1929
50,12,89,Florida,Nassau County,5,2,4249,2214,2035
50,12,89,Florida,Nassau County,5,3,4686,2400,2286
50,12,89,Florida,Nassau County,5,4,4362,2248,2114
50,12,89,Florida,Nassau County,5,5,4191,2137,2054
50,12,89,Florida,Nassau County,5,6,3945,2001,1944
50,12,89,Florida,Nassau County,5,7,4018,1979,2039
50,12,89,Florida,Nassau County,5,8,4180,2070,2110
50,12,89,Florida,Nassau County,5,9,4975,2444,2531
50,12,89,Florida,Nassau County,5,10,5417,2586,2831
50,12,89,Florida,Nassau County,5,11,5751,2848,2903
50,12,89,Florida,Nassau County,5,12,5817,2766,3051
50,12,89,Florida,Nassau County,5,13,5477,2600,2877
50,12,89,Florida,Nassau County,5,14,5070,2504,2566
50,12,89,Florida,Nassau County,5,15,3426,1682,1744
50,12,89,Florida,Nassau County,5,16,2306,1126,1180
50,12,89,Florida,Nassau County,5,17,1541,676,865
50,12,89,Florida,Nassau County,5,18,1237,475,762
50,12,89,Florida,Nassau County,6,0,75384,37084,38300
50,12,89,Florida,Nassau County,6,1,3840,1938,1902
50,12,89,Florida,Nassau County,6,2,4249,2189,2060
50,12,89,Florida,Nassau County,6,3,4642,2367,2275
50,12,89,Florida,Nassau County,6,4,4461,2287,2174
50,12,89,Florida,Nassau County,6,5,4215,2134,2081
50,12,89,Florida,Nassau County,6,6,3952,2032,1920
50,12,89,Florida,Nassau County,6,7,4080,2022,2058
50,12,89,Florida,Nassau County,6,8,4169,2050,2119
50,12,89,Florida,Nassau County,6,9,4905,2405,2500
50,12,89,Florida,Nassau County,6,10,5256,2535,2721
50,12,89,Florida,Nassau County,6,11,5849,2877,2972
50,12,89,Florida,Nassau County,6,12,5898,2819,3079
50,12,89,Florida,Nassau County,6,13,5596,2645,2951
50,12,89,Florida,Nassau County,6,14,5300,2579,2721
50,12,89,Florida,Nassau County,6,15,3699,1841,1858
50,12,89,Florida,Nassau County,6,16,2410,1170,1240
50,12,89,Florida,Nassau County,6,17,1586,709,877
50,12,89,Florida,Nassau County,6,18,1277,485,792
50,12,89,Florida,Nassau County,7,0,76250,37602,38648
50,12,89,Florida,Nassau County,7,1,3868,1966,1902
50,12,89,Florida,Nassau County,7,2,4246,2219,2027
50,12,89,Florida,Nassau County,7,3,4498,2279,2219
50,12,89,Florida,Nassau County,7,4,4457,2322,2135
50,12,89,Florida,Nassau County,7,5,4102,2068,2034
50,12,89,Florida,Nassau County,7,6,4232,2201,2031
50,12,89,Florida,Nassau County,7,7,4141,2058,2083
50,12,89,Florida,Nassau County,7,8,4075,1964,2111
50,12,89,Florida,Nassau County,7,9,4816,2407,2409
50,12,89,Florida,Nassau County,7,10,5135,2492,2643
50,12,89,Florida,Nassau County,7,11,5883,2842,3041
50,12,89,Florida,Nassau County,7,12,5919,2842,3077
50,12,89,Florida,Nassau County,7,13,5718,2725,2993
50,12,89,Florida,Nassau County,7,14,5648,2740,2908
50,12,89,Florida,Nassau County,7,15,3976,1952,2024
50,12,89,Florida,Nassau County,7,16,2557,1260,1297
50,12,89,Florida,Nassau County,7,17,1622,739,883
50,12,89,Florida,Nassau County,7,18,1357,526,831
50,12,89,Florida,Nassau County,8,0,77951,38354,39597
50,12,89,Florida,Nassau County,8,1,4012,2054,1958
50,12,89,Florida,Nassau County,8,2,4228,2170,2058
50,12,89,Florida,Nassau County,8,3,4585,2360,2225
50,12,89,Florida,Nassau County,8,4,4494,2311,2183
50,12,89,Florida,Nassau County,8,5,4016,2056,1960
50,12,89,Florida,Nassau County,8,6,4406,2232,2174
50,12,89,Florida,Nassau County,8,7,4222,2119,2103
50,12,89,Florida,Nassau County,8,8,4265,2041,2224
50,12,89,Florida,Nassau County,8,9,4710,2359,2351
50,12,89,Florida,Nassau County,8,10,5102,2489,2613
50,12,89,Florida,Nassau County,8,11,5854,2779,3075
50,12,89,Florida,Nassau County,8,12,6086,2955,3131
50,12,89,Florida,Nassau County,8,13,5992,2855,3137
50,12,89,Florida,Nassau County,8,14,5873,2822,3051
50,12,89,Florida,Nassau County,8,15,4240,2071,2169
50,12,89,Florida,Nassau County,8,16,2710,1349,1361
50,12,89,Florida,Nassau County,8,17,1690,766,924
50,12,89,Florida,Nassau County,8,18,1466,566,900
50,12,89,Florida,Nassau County,9,0,80055,39398,40657
50,12,89,Florida,Nassau County,9,1,4157,2144,2013
50,12,89,Florida,Nassau County,9,2,4332,2239,2093
50,12,89,Florida,Nassau County,9,3,4579,2338,2241
50,12,89,Florida,Nassau County,9,4,4512,2318,2194
50,12,89,Florida,Nassau County,9,5,3945,2033,1912
50,12,89,Florida,Nassau County,9,6,4709,2429,2280
50,12,89,Florida,Nassau County,9,7,4367,2153,2214
50,12,89,Florida,Nassau County,9,8,4397,2145,2252
50,12,89,Florida,Nassau County,9,9,4642,2290,2352
50,12,89,Florida,Nassau County,9,10,5216,2558,2658
50,12,89,Florida,Nassau County,9,11,5847,2754,3093
50,12,89,Florida,Nassau County,9,12,6239,3027,3212
50,12,89,Florida,Nassau County,9,13,6166,2896,3270
50,12,89,Florida,Nassau County,9,14,6159,2966,3193
50,12,89,Florida,Nassau County,9,15,4549,2251,2298
50,12,89,Florida,Nassau County,9,16,2893,1411,1482
50,12,89,Florida,Nassau County,9,17,1760,809,951
50,12,89,Florida,Nassau County,9,18,1586,637,949
50,12,89,Florida,Nassau County,10,0,82925,40773,42152
50,12,89,Florida,Nassau County,10,1,4285,2209,2076
50,12,89,Florida,Nassau County,10,2,4431,2241,2190
50,12,89,Florida,Nassau County,10,3,4750,2443,2307
50,12,89,Florida,Nassau County,10,4,4607,2381,2226
50,12,89,Florida,Nassau County,10,5,3907,2030,1877
50,12,89,Florida,Nassau County,10,6,4807,2438,2369
50,12,89,Florida,Nassau County,10,7,4685,2348,2337
50,12,89,Florida,Nassau County,10,8,4735,2346,2389
50,12,89,Florida,Nassau County,10,9,4676,2318,2358
50,12,89,Florida,Nassau County,10,10,5345,2594,2751
50,12,89,Florida,Nassau County,10,11,5878,2803,3075
50,12,89,Florida,Nassau County,10,12,6318,3029,3289
50,12,89,Florida,Nassau County,10,13,6515,3023,3492
50,12,89,Florida,Nassau County,10,14,6149,2979,3170
50,12,89,Florida,Nassau County,10,15,5172,2512,2660
50,12,89,Florida,Nassau County,10,16,3100,1512,1588
50,12,89,Florida,Nassau County,10,17,1882,872,1010
50,12,89,Florida,Nassau County,10,18,1683,695,988
50,12,89,Florida,Nassau County,11,0,85936,42227,43709
50,12,89,Florida,Nassau County,11,1,4388,2249,2139
50,12,89,Florida,Nassau County,11,2,4748,2388,2360
50,12,89,Florida,Nassau County,11,3,4868,2525,2343
50,12,89,Florida,Nassau County,11,4,4656,2422,2234
50,12,89,Florida,Nassau County,11,5,3982,2049,1933
50,12,89,Florida,Nassau County,11,6,4942,2477,2465
50,12,89,Florida,Nassau County,11,7,4930,2491,2439
50,12,89,Florida,Nassau County,11,8,4970,2495,2475
50,12,89,Florida,Nassau County,11,9,4713,2309,2404
50,12,89,Florida,Nassau County,11,10,5478,2654,2824
50,12,89,Florida,Nassau County,11,11,5858,2835,3023
50,12,89,Florida,Nassau County,11,12,6580,3118,3462
50,12,89,Florida,Nassau County,11,13,6729,3148,3581
50,12,89,Florida,Nassau County,11,14,6399,3064,3335
50,12,89,Florida,Nassau County,11,15,5527,2662,2865
50,12,89,Florida,Nassau County,11,16,3422,1689,1733
50,12,89,Florida,Nassau County,11,17,1975,915,1060
50,12,89,Florida,Nassau County,11,18,1771,737,1034
50,12,89,Florida,Nassau County,12,0,88625,43523,45102
50,12,89,Florida,Nassau County,12,1,4490,2334,2156
50,12,89,Florida,Nassau County,12,2,4934,2460,2474
50,12,89,Florida,Nassau County,12,3,5056,2621,2435
50,12,89,Florida,Nassau County,12,4,4637,2383,2254
50,12,89,Florida,Nassau County,12,5,4146,2137,2009
50,12,89,Florida,Nassau County,12,6,4892,2435,2457
50,12,89,Florida,Nassau County,12,7,5194,2622,2572
50,12,89,Florida,Nassau County,12,8,5191,2592,2599
50,12,89,Florida,Nassau County,12,9,4797,2371,2426
50,12,89,Florida,Nassau County,12,10,5560,2745,2815
50,12,89,Florida,Nassau County,12,11,5785,2789,2996
50,12,89,Florida,Nassau County,12,12,6771,3198,3573
50,12,89,Florida,Nassau County,12,13,6941,3233,3708
50,12,89,Florida,Nassau County,12,14,6695,3185,3510
50,12,89,Florida,Nassau County,12,15,5892,2838,3054
50,12,89,Florida,Nassau County,12,16,3702,1807,1895
50,12,89,Florida,Nassau County,12,17,2095,989,1106
50,12,89,Florida,Nassau County,12,18,1847,784,1063
50,12,91,Florida,Okaloosa County,1,0,180822,90843,89979
50,12,91,Florida,Okaloosa County,1,1,11608,5894,5714
50,12,91,Florida,Okaloosa County,1,2,10881,5488,5393
50,12,91,Florida,Okaloosa County,1,3,10674,5523,5151
50,12,91,Florida,Okaloosa County,1,4,11942,6402,5540
50,12,91,Florida,Okaloosa County,1,5,13678,7549,6129
50,12,91,Florida,Okaloosa County,1,6,13772,7331,6441
50,12,91,Florida,Okaloosa County,1,7,11223,5875,5348
50,12,91,Florida,Okaloosa County,1,8,10384,5240,5144
50,12,91,Florida,Okaloosa County,1,9,11291,5544,5747
50,12,91,Florida,Okaloosa County,1,10,14781,7544,7237
50,12,91,Florida,Okaloosa County,1,11,13967,6899,7068
50,12,91,Florida,Okaloosa County,1,12,11345,5428,5917
50,12,91,Florida,Okaloosa County,1,13,10058,4913,5145
50,12,91,Florida,Okaloosa County,1,14,7684,3662,4022
50,12,91,Florida,Okaloosa County,1,15,6410,2838,3572
50,12,91,Florida,Okaloosa County,1,16,5304,2467,2837
50,12,91,Florida,Okaloosa County,1,17,3273,1342,1931
50,12,91,Florida,Okaloosa County,1,18,2547,904,1643
50,12,91,Florida,Okaloosa County,2,0,180824,90842,89982
50,12,91,Florida,Okaloosa County,2,1,11608,5894,5714
50,12,91,Florida,Okaloosa County,2,2,10882,5488,5394
50,12,91,Florida,Okaloosa County,2,3,10675,5523,5152
50,12,91,Florida,Okaloosa County,2,4,11942,6402,5540
50,12,91,Florida,Okaloosa County,2,5,13678,7549,6129
50,12,91,Florida,Okaloosa County,2,6,13772,7331,6441
50,12,91,Florida,Okaloosa County,2,7,11225,5876,5349
50,12,91,Florida,Okaloosa County,2,8,10384,5240,5144
50,12,91,Florida,Okaloosa County,2,9,11290,5543,5747
50,12,91,Florida,Okaloosa County,2,10,14780,7544,7236
50,12,91,Florida,Okaloosa County,2,11,13966,6898,7068
50,12,91,Florida,Okaloosa County,2,12,11345,5428,5917
50,12,91,Florida,Okaloosa County,2,13,10058,4913,5145
50,12,91,Florida,Okaloosa County,2,14,7685,3662,4023
50,12,91,Florida,Okaloosa County,2,15,6410,2838,3572
50,12,91,Florida,Okaloosa County,2,16,5304,2467,2837
50,12,91,Florida,Okaloosa County,2,17,3273,1342,1931
50,12,91,Florida,Okaloosa County,2,18,2547,904,1643
50,12,91,Florida,Okaloosa County,3,0,180715,90816,89899
50,12,91,Florida,Okaloosa County,3,1,11549,5864,5685
50,12,91,Florida,Okaloosa County,3,2,10829,5462,5367
50,12,91,Florida,Okaloosa County,3,3,10664,5513,5151
50,12,91,Florida,Okaloosa County,3,4,11878,6401,5477
50,12,91,Florida,Okaloosa County,3,5,13722,7575,6147
50,12,91,Florida,Okaloosa County,3,6,13707,7294,6413
50,12,91,Florida,Okaloosa County,3,7,11280,5910,5370
50,12,91,Florida,Okaloosa County,3,8,10292,5196,5096
50,12,91,Florida,Okaloosa County,3,9,11210,5514,5696
50,12,91,Florida,Okaloosa County,3,10,14620,7438,7182
50,12,91,Florida,Okaloosa County,3,11,14020,6942,7078
50,12,91,Florida,Okaloosa County,3,12,11451,5487,5964
50,12,91,Florida,Okaloosa County,3,13,10125,4935,5190
50,12,91,Florida,Okaloosa County,3,14,7756,3695,4061
50,12,91,Florida,Okaloosa County,3,15,6394,2845,3549
50,12,91,Florida,Okaloosa County,3,16,5310,2436,2874
50,12,91,Florida,Okaloosa County,3,17,3337,1402,1935
50,12,91,Florida,Okaloosa County,3,18,2571,907,1664
50,12,91,Florida,Okaloosa County,4,0,183102,92095,91007
50,12,91,Florida,Okaloosa County,4,1,12081,6167,5914
50,12,91,Florida,Okaloosa County,4,2,10945,5498,5447
50,12,91,Florida,Okaloosa County,4,3,10739,5515,5224
50,12,91,Florida,Okaloosa County,4,4,11523,6283,5240
50,12,91,Florida,Okaloosa County,4,5,14337,7963,6374
50,12,91,Florida,Okaloosa County,4,6,14344,7628,6716
50,12,91,Florida,Okaloosa County,4,7,11741,6134,5607
50,12,91,Florida,Okaloosa County,4,8,10062,5061,5001
50,12,91,Florida,Okaloosa County,4,9,11069,5430,5639
50,12,91,Florida,Okaloosa County,4,10,13800,6963,6837
50,12,91,Florida,Okaloosa County,4,11,14301,7137,7164
50,12,91,Florida,Okaloosa County,4,12,11826,5722,6104
50,12,91,Florida,Okaloosa County,4,13,10496,5051,5445
50,12,91,Florida,Okaloosa County,4,14,7932,3802,4130
50,12,91,Florida,Okaloosa County,4,15,6373,2875,3498
50,12,91,Florida,Okaloosa County,4,16,5389,2397,2992
50,12,91,Florida,Okaloosa County,4,17,3536,1568,1968
50,12,91,Florida,Okaloosa County,4,18,2608,901,1707
50,12,91,Florida,Okaloosa County,5,0,189762,96152,93610
50,12,91,Florida,Okaloosa County,5,1,12883,6552,6331
50,12,91,Florida,Okaloosa County,5,2,11672,5838,5834
50,12,91,Florida,Okaloosa County,5,3,10932,5578,5354
50,12,91,Florida,Okaloosa County,5,4,11512,6287,5225
50,12,91,Florida,Okaloosa County,5,5,15384,8773,6611
50,12,91,Florida,Okaloosa County,5,6,15625,8467,7158
50,12,91,Florida,Okaloosa County,5,7,13022,6909,6113
50,12,91,Florida,Okaloosa County,5,8,10561,5368,5193
50,12,91,Florida,Okaloosa County,5,9,11202,5599,5603
50,12,91,Florida,Okaloosa County,5,10,13047,6573,6474
50,12,91,Florida,Okaloosa County,5,11,14427,7239,7188
50,12,91,Florida,Okaloosa County,5,12,12293,5959,6334
50,12,91,Florida,Okaloosa County,5,13,10313,4928,5385
50,12,91,Florida,Okaloosa County,5,14,8600,4175,4425
50,12,91,Florida,Okaloosa County,5,15,6418,2897,3521
50,12,91,Florida,Okaloosa County,5,16,5411,2391,3020
50,12,91,Florida,Okaloosa County,5,17,3733,1660,2073
50,12,91,Florida,Okaloosa County,5,18,2727,959,1768
50,12,91,Florida,Okaloosa County,6,0,192688,97853,94835
50,12,91,Florida,Okaloosa County,6,1,12947,6650,6297
50,12,91,Florida,Okaloosa County,6,2,12021,5984,6037
50,12,91,Florida,Okaloosa County,6,3,11064,5645,5419
50,12,91,Florida,Okaloosa County,6,4,11242,6142,5100
50,12,91,Florida,Okaloosa County,6,5,15570,8955,6615
50,12,91,Florida,Okaloosa County,6,6,16188,8854,7334
50,12,91,Florida,Okaloosa County,6,7,13770,7285,6485
50,12,91,Florida,Okaloosa County,6,8,10897,5553,5344
50,12,91,Florida,Okaloosa County,6,9,11012,5544,5468
50,12,91,Florida,Okaloosa County,6,10,12259,6125,6134
50,12,91,Florida,Okaloosa County,6,11,14494,7324,7170
50,12,91,Florida,Okaloosa County,6,12,12850,6260,6590
50,12,91,Florida,Okaloosa County,6,13,10424,4931,5493
50,12,91,Florida,Okaloosa County,6,14,9045,4388,4657
50,12,91,Florida,Okaloosa County,6,15,6635,3056,3579
50,12,91,Florida,Okaloosa County,6,16,5502,2404,3098
50,12,91,Florida,Okaloosa County,6,17,3917,1738,2179
50,12,91,Florida,Okaloosa County,6,18,2851,1015,1836
50,12,91,Florida,Okaloosa County,7,0,194615,98719,95896
50,12,91,Florida,Okaloosa County,7,1,13174,6750,6424
50,12,91,Florida,Okaloosa County,7,2,12169,6165,6004
50,12,91,Florida,Okaloosa County,7,3,11114,5678,5436
50,12,91,Florida,Okaloosa County,7,4,11029,5942,5087
50,12,91,Florida,Okaloosa County,7,5,14976,8556,6420
50,12,91,Florida,Okaloosa County,7,6,16597,9040,7557
50,12,91,Florida,Okaloosa County,7,7,14253,7519,6734
50,12,91,Florida,Okaloosa County,7,8,11345,5849,5496
50,12,91,Florida,Okaloosa County,7,9,10823,5485,5338
50,12,91,Florida,Okaloosa County,7,10,11594,5709,5885
50,12,91,Florida,Okaloosa County,7,11,14425,7261,7164
50,12,91,Florida,Okaloosa County,7,12,13275,6487,6788
50,12,91,Florida,Okaloosa County,7,13,10840,5138,5702
50,12,91,Florida,Okaloosa County,7,14,9539,4635,4904
50,12,91,Florida,Okaloosa County,7,15,6937,3278,3659
50,12,91,Florida,Okaloosa County,7,16,5532,2370,3162
50,12,91,Florida,Okaloosa County,7,17,4029,1784,2245
50,12,91,Florida,Okaloosa County,7,18,2964,1073,1891
50,12,91,Florida,Okaloosa County,8,0,197748,100402,97346
50,12,91,Florida,Okaloosa County,8,1,13438,6908,6530
50,12,91,Florida,Okaloosa County,8,2,12317,6216,6101
50,12,91,Florida,Okaloosa County,8,3,11228,5717,5511
50,12,91,Florida,Okaloosa County,8,4,11003,5931,5072
50,12,91,Florida,Okaloosa County,8,5,14969,8667,6302
50,12,91,Florida,Okaloosa County,8,6,17148,9294,7854
50,12,91,Florida,Okaloosa County,8,7,14779,7790,6989
50,12,91,Florida,Okaloosa County,8,8,11917,6246,5671
50,12,91,Florida,Okaloosa County,8,9,10684,5412,5272
50,12,91,Florida,Okaloosa County,8,10,11233,5483,5750
50,12,91,Florida,Okaloosa County,8,11,14112,7083,7029
50,12,91,Florida,Okaloosa County,8,12,13715,6691,7024
50,12,91,Florida,Okaloosa County,8,13,11263,5339,5924
50,12,91,Florida,Okaloosa County,8,14,9967,4864,5103
50,12,91,Florida,Okaloosa County,8,15,7269,3439,3830
50,12,91,Florida,Okaloosa County,8,16,5538,2394,3144
50,12,91,Florida,Okaloosa County,8,17,4092,1772,2320
50,12,91,Florida,Okaloosa County,8,18,3076,1156,1920
50,12,91,Florida,Okaloosa County,9,0,200071,101516,98555
50,12,91,Florida,Okaloosa County,9,1,13479,6876,6603
50,12,91,Florida,Okaloosa County,9,2,12530,6453,6077
50,12,91,Florida,Okaloosa County,9,3,11431,5760,5671
50,12,91,Florida,Okaloosa County,9,4,10965,5918,5047
50,12,91,Florida,Okaloosa County,9,5,14384,8338,6046
50,12,91,Florida,Okaloosa County,9,6,17267,9371,7896
50,12,91,Florida,Okaloosa County,9,7,15210,8058,7152
50,12,91,Florida,Okaloosa County,9,8,12475,6562,5913
50,12,91,Florida,Okaloosa County,9,9,10581,5286,5295
50,12,91,Florida,Okaloosa County,9,10,11189,5484,5705
50,12,91,Florida,Okaloosa County,9,11,13586,6765,6821
50,12,91,Florida,Okaloosa County,9,12,14181,6963,7218
50,12,91,Florida,Okaloosa County,9,13,11880,5675,6205
50,12,91,Florida,Okaloosa County,9,14,10511,5061,5450
50,12,91,Florida,Okaloosa County,9,15,7516,3552,3964
50,12,91,Florida,Okaloosa County,9,16,5507,2431,3076
50,12,91,Florida,Okaloosa County,9,17,4142,1714,2428
50,12,91,Florida,Okaloosa County,9,18,3237,1249,1988
50,12,91,Florida,Okaloosa County,10,0,203478,103224,100254
50,12,91,Florida,Okaloosa County,10,1,13423,6842,6581
50,12,91,Florida,Okaloosa County,10,2,12910,6591,6319
50,12,91,Florida,Okaloosa County,10,3,11726,5927,5799
50,12,91,Florida,Okaloosa County,10,4,11048,5917,5131
50,12,91,Florida,Okaloosa County,10,5,14330,8291,6039
50,12,91,Florida,Okaloosa County,10,6,17445,9525,7920
50,12,91,Florida,Okaloosa County,10,7,15499,8257,7242
50,12,91,Florida,Okaloosa County,10,8,13167,6890,6277
50,12,91,Florida,Okaloosa County,10,9,10826,5457,5369
50,12,91,Florida,Okaloosa County,10,10,11119,5436,5683
50,12,91,Florida,Okaloosa County,10,11,12926,6401,6525
50,12,91,Florida,Okaloosa County,10,12,14494,7134,7360
50,12,91,Florida,Okaloosa County,10,13,12553,6019,6534
50,12,91,Florida,Okaloosa County,10,14,10538,5040,5498
50,12,91,Florida,Okaloosa County,10,15,8196,3926,4270
50,12,91,Florida,Okaloosa County,10,16,5673,2521,3152
50,12,91,Florida,Okaloosa County,10,17,4137,1706,2431
50,12,91,Florida,Okaloosa County,10,18,3468,1344,2124
50,12,91,Florida,Okaloosa County,11,0,206934,104932,102002
50,12,91,Florida,Okaloosa County,11,1,13595,6943,6652
50,12,91,Florida,Okaloosa County,11,2,13110,6631,6479
50,12,91,Florida,Okaloosa County,11,3,12304,6246,6058
50,12,91,Florida,Okaloosa County,11,4,11210,6041,5169
50,12,91,Florida,Okaloosa County,11,5,14165,8220,5945
50,12,91,Florida,Okaloosa County,11,6,17368,9419,7949
50,12,91,Florida,Okaloosa County,11,7,15840,8456,7384
50,12,91,Florida,Okaloosa County,11,8,13756,7160,6596
50,12,91,Florida,Okaloosa County,11,9,11303,5662,5641
50,12,91,Florida,Okaloosa County,11,10,11026,5437,5589
50,12,91,Florida,Okaloosa County,11,11,12319,6078,6241
50,12,91,Florida,Okaloosa County,11,12,14706,7261,7445
50,12,91,Florida,Okaloosa County,11,13,13087,6286,6801
50,12,91,Florida,Okaloosa County,11,14,10812,5187,5625
50,12,91,Florida,Okaloosa County,11,15,8628,4136,4492
50,12,91,Florida,Okaloosa County,11,16,5905,2653,3252
50,12,91,Florida,Okaloosa County,11,17,4209,1722,2487
50,12,91,Florida,Okaloosa County,11,18,3591,1394,2197
50,12,91,Florida,Okaloosa County,12,0,210738,106779,103959
50,12,91,Florida,Okaloosa County,12,1,13602,6966,6636
50,12,91,Florida,Okaloosa County,12,2,13398,6848,6550
50,12,91,Florida,Okaloosa County,12,3,12719,6445,6274
50,12,91,Florida,Okaloosa County,12,4,11408,6105,5303
50,12,91,Florida,Okaloosa County,12,5,14170,8178,5992
50,12,91,Florida,Okaloosa County,12,6,17400,9418,7982
50,12,91,Florida,Okaloosa County,12,7,16271,8612,7659
50,12,91,Florida,Okaloosa County,12,8,14321,7422,6899
50,12,91,Florida,Okaloosa County,12,9,11925,6036,5889
50,12,91,Florida,Okaloosa County,12,10,11060,5499,5561
50,12,91,Florida,Okaloosa County,12,11,11778,5735,6043
50,12,91,Florida,Okaloosa County,12,12,14743,7269,7474
50,12,91,Florida,Okaloosa County,12,13,13567,6525,7042
50,12,91,Florida,Okaloosa County,12,14,11239,5457,5782
50,12,91,Florida,Okaloosa County,12,15,9058,4330,4728
50,12,91,Florida,Okaloosa County,12,16,6164,2805,3359
50,12,91,Florida,Okaloosa County,12,17,4251,1711,2540
50,12,91,Florida,Okaloosa County,12,18,3664,1418,2246
50,12,93,Florida,Okeechobee County,1,0,39996,21430,18566
50,12,93,Florida,Okeechobee County,1,1,2659,1411,1248
50,12,93,Florida,Okeechobee County,1,2,2543,1271,1272
50,12,93,Florida,Okeechobee County,1,3,2591,1354,1237
50,12,93,Florida,Okeechobee County,1,4,2899,1596,1303
50,12,93,Florida,Okeechobee County,1,5,2537,1461,1076
50,12,93,Florida,Okeechobee County,1,6,2568,1512,1056
50,12,93,Florida,Okeechobee County,1,7,2490,1429,1061
50,12,93,Florida,Okeechobee County,1,8,2438,1367,1071
50,12,93,Florida,Okeechobee County,1,9,2530,1456,1074
50,12,93,Florida,Okeechobee County,1,10,2710,1473,1237
50,12,93,Florida,Okeechobee County,1,11,2691,1432,1259
50,12,93,Florida,Okeechobee County,1,12,2332,1216,1116
50,12,93,Florida,Okeechobee County,1,13,2217,1094,1123
50,12,93,Florida,Okeechobee County,1,14,2102,1037,1065
50,12,93,Florida,Okeechobee County,1,15,1800,895,905
50,12,93,Florida,Okeechobee County,1,16,1277,695,582
50,12,93,Florida,Okeechobee County,1,17,950,467,483
50,12,93,Florida,Okeechobee County,1,18,662,264,398
50,12,93,Florida,Okeechobee County,2,0,39996,21430,18566
50,12,93,Florida,Okeechobee County,2,1,2659,1411,1248
50,12,93,Florida,Okeechobee County,2,2,2543,1271,1272
50,12,93,Florida,Okeechobee County,2,3,2591,1354,1237
50,12,93,Florida,Okeechobee County,2,4,2899,1596,1303
50,12,93,Florida,Okeechobee County,2,5,2537,1461,1076
50,12,93,Florida,Okeechobee County,2,6,2568,1512,1056
50,12,93,Florida,Okeechobee County,2,7,2490,1429,1061
50,12,93,Florida,Okeechobee County,2,8,2438,1367,1071
50,12,93,Florida,Okeechobee County,2,9,2530,1456,1074
50,12,93,Florida,Okeechobee County,2,10,2710,1473,1237
50,12,93,Florida,Okeechobee County,2,11,2691,1432,1259
50,12,93,Florida,Okeechobee County,2,12,2332,1216,1116
50,12,93,Florida,Okeechobee County,2,13,2217,1094,1123
50,12,93,Florida,Okeechobee County,2,14,2102,1037,1065
50,12,93,Florida,Okeechobee County,2,15,1800,895,905
50,12,93,Florida,Okeechobee County,2,16,1277,695,582
50,12,93,Florida,Okeechobee County,2,17,950,467,483
50,12,93,Florida,Okeechobee County,2,18,662,264,398
50,12,93,Florida,Okeechobee County,3,0,40025,21450,18575
50,12,93,Florida,Okeechobee County,3,1,2639,1405,1234
50,12,93,Florida,Okeechobee County,3,2,2549,1278,1271
50,12,93,Florida,Okeechobee County,3,3,2583,1343,1240
50,12,93,Florida,Okeechobee County,3,4,2859,1588,1271
50,12,93,Florida,Okeechobee County,3,5,2545,1455,1090
50,12,93,Florida,Okeechobee County,3,6,2565,1509,1056
50,12,93,Florida,Okeechobee County,3,7,2488,1429,1059
50,12,93,Florida,Okeechobee County,3,8,2440,1365,1075
50,12,93,Florida,Okeechobee County,3,9,2533,1458,1075
50,12,93,Florida,Okeechobee County,3,10,2710,1473,1237
50,12,93,Florida,Okeechobee County,3,11,2708,1432,1276
50,12,93,Florida,Okeechobee County,3,12,2357,1229,1128
50,12,93,Florida,Okeechobee County,3,13,2229,1109,1120
50,12,93,Florida,Okeechobee County,3,14,2100,1036,1064
50,12,93,Florida,Okeechobee County,3,15,1811,901,910
50,12,93,Florida,Okeechobee County,3,16,1283,696,587
50,12,93,Florida,Okeechobee County,3,17,955,475,480
50,12,93,Florida,Okeechobee County,3,18,671,269,402
50,12,93,Florida,Okeechobee County,4,0,39869,21367,18502
50,12,93,Florida,Okeechobee County,4,1,2571,1385,1186
50,12,93,Florida,Okeechobee County,4,2,2593,1338,1255
50,12,93,Florida,Okeechobee County,4,3,2542,1292,1250
50,12,93,Florida,Okeechobee County,4,4,2741,1541,1200
50,12,93,Florida,Okeechobee County,4,5,2606,1450,1156
50,12,93,Florida,Okeechobee County,4,6,2569,1500,1069
50,12,93,Florida,Okeechobee County,4,7,2506,1450,1056
50,12,93,Florida,Okeechobee County,4,8,2398,1355,1043
50,12,93,Florida,Okeechobee County,4,9,2512,1434,1078
50,12,93,Florida,Okeechobee County,4,10,2590,1414,1176
50,12,93,Florida,Okeechobee County,4,11,2674,1394,1280
50,12,93,Florida,Okeechobee County,4,12,2412,1259,1153
50,12,93,Florida,Okeechobee County,4,13,2283,1154,1129
50,12,93,Florida,Okeechobee County,4,14,2060,1014,1046
50,12,93,Florida,Okeechobee County,4,15,1848,919,929
50,12,93,Florida,Okeechobee County,4,16,1324,705,619
50,12,93,Florida,Okeechobee County,4,17,959,486,473
50,12,93,Florida,Okeechobee County,4,18,681,277,404
50,12,93,Florida,Okeechobee County,5,0,39710,21240,18470
50,12,93,Florida,Okeechobee County,5,1,2524,1374,1150
50,12,93,Florida,Okeechobee County,5,2,2517,1277,1240
50,12,93,Florida,Okeechobee County,5,3,2470,1262,1208
50,12,93,Florida,Okeechobee County,5,4,2648,1502,1146
50,12,93,Florida,Okeechobee County,5,5,2670,1469,1201
50,12,93,Florida,Okeechobee County,5,6,2513,1478,1035
50,12,93,Florida,Okeechobee County,5,7,2496,1436,1060
50,12,93,Florida,Okeechobee County,5,8,2349,1337,1012
50,12,93,Florida,Okeechobee County,5,9,2507,1421,1086
50,12,93,Florida,Okeechobee County,5,10,2530,1380,1150
50,12,93,Florida,Okeechobee County,5,11,2690,1412,1278
50,12,93,Florida,Okeechobee County,5,12,2493,1275,1218
50,12,93,Florida,Okeechobee County,5,13,2215,1102,1113
50,12,93,Florida,Okeechobee County,5,14,2126,1074,1052
50,12,93,Florida,Okeechobee County,5,15,1909,920,989
50,12,93,Florida,Okeechobee County,5,16,1344,711,633
50,12,93,Florida,Okeechobee County,5,17,956,486,470
50,12,93,Florida,Okeechobee County,5,18,753,324,429
50,12,93,Florida,Okeechobee County,6,0,39482,21206,18276
50,12,93,Florida,Okeechobee County,6,1,2417,1330,1087
50,12,93,Florida,Okeechobee County,6,2,2514,1290,1224
50,12,93,Florida,Okeechobee County,6,3,2376,1212,1164
50,12,93,Florida,Okeechobee County,6,4,2572,1486,1086
50,12,93,Florida,Okeechobee County,6,5,2566,1370,1196
50,12,93,Florida,Okeechobee County,6,6,2526,1502,1024
50,12,93,Florida,Okeechobee County,6,7,2429,1402,1027
50,12,93,Florida,Okeechobee County,6,8,2347,1334,1013
50,12,93,Florida,Okeechobee County,6,9,2429,1394,1035
50,12,93,Florida,Okeechobee County,6,10,2496,1419,1077
50,12,93,Florida,Okeechobee County,6,11,2721,1431,1290
50,12,93,Florida,Okeechobee County,6,12,2560,1323,1237
50,12,93,Florida,Okeechobee County,6,13,2161,1075,1086
50,12,93,Florida,Okeechobee County,6,14,2195,1085,1110
50,12,93,Florida,Okeechobee County,6,15,2003,972,1031
50,12,93,Florida,Okeechobee County,6,16,1410,738,672
50,12,93,Florida,Okeechobee County,6,17,965,496,469
50,12,93,Florida,Okeechobee County,6,18,795,347,448
50,12,93,Florida,Okeechobee County,7,0,39569,21248,18321
50,12,93,Florida,Okeechobee County,7,1,2471,1315,1156
50,12,93,Florida,Okeechobee County,7,2,2469,1286,1183
50,12,93,Florida,Okeechobee County,7,3,2302,1170,1132
50,12,93,Florida,Okeechobee County,7,4,2508,1468,1040
50,12,93,Florida,Okeechobee County,7,5,2548,1356,1192
50,12,93,Florida,Okeechobee County,7,6,2587,1536,1051
50,12,93,Florida,Okeechobee County,7,7,2419,1385,1034
50,12,93,Florida,Okeechobee County,7,8,2346,1345,1001
50,12,93,Florida,Okeechobee County,7,9,2454,1400,1054
50,12,93,Florida,Okeechobee County,7,10,2466,1419,1047
50,12,93,Florida,Okeechobee County,7,11,2717,1461,1256
50,12,93,Florida,Okeechobee County,7,12,2583,1310,1273
50,12,93,Florida,Okeechobee County,7,13,2186,1083,1103
50,12,93,Florida,Okeechobee County,7,14,2228,1094,1134
50,12,93,Florida,Okeechobee County,7,15,1980,975,1005
50,12,93,Florida,Okeechobee County,7,16,1491,763,728
50,12,93,Florida,Okeechobee County,7,17,957,500,457
50,12,93,Florida,Okeechobee County,7,18,857,382,475
50,12,93,Florida,Okeechobee County,8,0,39854,21276,18578
50,12,93,Florida,Okeechobee County,8,1,2483,1324,1159
50,12,93,Florida,Okeechobee County,8,2,2387,1270,1117
50,12,93,Florida,Okeechobee County,8,3,2305,1142,1163
50,12,93,Florida,Okeechobee County,8,4,2489,1433,1056
50,12,93,Florida,Okeechobee County,8,5,2428,1285,1143
50,12,93,Florida,Okeechobee County,8,6,2672,1564,1108
50,12,93,Florida,Okeechobee County,8,7,2416,1364,1052
50,12,93,Florida,Okeechobee County,8,8,2398,1362,1036
50,12,93,Florida,Okeechobee County,8,9,2468,1361,1107
50,12,93,Florida,Okeechobee County,8,10,2480,1456,1024
50,12,93,Florida,Okeechobee County,8,11,2702,1449,1253
50,12,93,Florida,Okeechobee County,8,12,2618,1330,1288
50,12,93,Florida,Okeechobee County,8,13,2268,1136,1132
50,12,93,Florida,Okeechobee County,8,14,2286,1114,1172
50,12,93,Florida,Okeechobee County,8,15,1979,974,1005
50,12,93,Florida,Okeechobee County,8,16,1553,761,792
50,12,93,Florida,Okeechobee County,8,17,1024,549,475
50,12,93,Florida,Okeechobee County,8,18,898,402,496
50,12,93,Florida,Okeechobee County,9,0,40769,21844,18925
50,12,93,Florida,Okeechobee County,9,1,2481,1318,1163
50,12,93,Florida,Okeechobee County,9,2,2423,1299,1124
50,12,93,Florida,Okeechobee County,9,3,2385,1189,1196
50,12,93,Florida,Okeechobee County,9,4,2551,1435,1116
50,12,93,Florida,Okeechobee County,9,5,2328,1281,1047
50,12,93,Florida,Okeechobee County,9,6,2843,1654,1189
50,12,93,Florida,Okeechobee County,9,7,2451,1381,1070
50,12,93,Florida,Okeechobee County,9,8,2506,1440,1066
50,12,93,Florida,Okeechobee County,9,9,2583,1432,1151
50,12,93,Florida,Okeechobee County,9,10,2550,1504,1046
50,12,93,Florida,Okeechobee County,9,11,2667,1466,1201
50,12,93,Florida,Okeechobee County,9,12,2686,1354,1332
50,12,93,Florida,Okeechobee County,9,13,2373,1194,1179
50,12,93,Florida,Okeechobee County,9,14,2404,1182,1222
50,12,93,Florida,Okeechobee County,9,15,1914,944,970
50,12,93,Florida,Okeechobee County,9,16,1628,791,837
50,12,93,Florida,Okeechobee County,9,17,1045,549,496
50,12,93,Florida,Okeechobee County,9,18,951,431,520
50,12,93,Florida,Okeechobee County,10,0,41275,22148,19127
50,12,93,Florida,Okeechobee County,10,1,2492,1325,1167
50,12,93,Florida,Okeechobee County,10,2,2393,1282,1111
50,12,93,Florida,Okeechobee County,10,3,2383,1188,1195
50,12,93,Florida,Okeechobee County,10,4,2525,1425,1100
50,12,93,Florida,Okeechobee County,10,5,2318,1305,1013
50,12,93,Florida,Okeechobee County,10,6,2880,1629,1251
50,12,93,Florida,Okeechobee County,10,7,2538,1475,1063
50,12,93,Florida,Okeechobee County,10,8,2518,1437,1081
50,12,93,Florida,Okeechobee County,10,9,2590,1434,1156
50,12,93,Florida,Okeechobee County,10,10,2636,1546,1090
50,12,93,Florida,Okeechobee County,10,11,2662,1484,1178
50,12,93,Florida,Okeechobee County,10,12,2722,1402,1320
50,12,93,Florida,Okeechobee County,10,13,2523,1259,1264
50,12,93,Florida,Okeechobee County,10,14,2323,1135,1188
50,12,93,Florida,Okeechobee County,10,15,2027,1025,1002
50,12,93,Florida,Okeechobee County,10,16,1694,793,901
50,12,93,Florida,Okeechobee County,10,17,1087,555,532
50,12,93,Florida,Okeechobee County,10,18,964,449,515
50,12,93,Florida,Okeechobee County,11,0,41654,22326,19328
50,12,93,Florida,Okeechobee County,11,1,2556,1362,1194
50,12,93,Florida,Okeechobee County,11,2,2389,1278,1111
50,12,93,Florida,Okeechobee County,11,3,2410,1232,1178
50,12,93,Florida,Okeechobee County,11,4,2480,1388,1092
50,12,93,Florida,Okeechobee County,11,5,2265,1305,960
50,12,93,Florida,Okeechobee County,11,6,2891,1596,1295
50,12,93,Florida,Okeechobee County,11,7,2630,1520,1110
50,12,93,Florida,Okeechobee County,11,8,2533,1471,1062
50,12,93,Florida,Okeechobee County,11,9,2587,1420,1167
50,12,93,Florida,Okeechobee County,11,10,2635,1518,1117
50,12,93,Florida,Okeechobee County,11,11,2678,1523,1155
50,12,93,Florida,Okeechobee County,11,12,2738,1404,1334
50,12,93,Florida,Okeechobee County,11,13,2600,1304,1296
50,12,93,Florida,Okeechobee County,11,14,2280,1113,1167
50,12,93,Florida,Okeechobee County,11,15,2113,1027,1086
50,12,93,Florida,Okeechobee County,11,16,1742,832,910
50,12,93,Florida,Okeechobee County,11,17,1146,580,566
50,12,93,Florida,Okeechobee County,11,18,981,453,528
50,12,93,Florida,Okeechobee County,12,0,42168,22637,19531
50,12,93,Florida,Okeechobee County,12,1,2564,1371,1193
50,12,93,Florida,Okeechobee County,12,2,2496,1329,1167
50,12,93,Florida,Okeechobee County,12,3,2398,1251,1147
50,12,93,Florida,Okeechobee County,12,4,2423,1352,1071
50,12,93,Florida,Okeechobee County,12,5,2259,1295,964
50,12,93,Florida,Okeechobee County,12,6,2889,1615,1274
50,12,93,Florida,Okeechobee County,12,7,2731,1564,1167
50,12,93,Florida,Okeechobee County,12,8,2560,1471,1089
50,12,93,Florida,Okeechobee County,12,9,2620,1468,1152
50,12,93,Florida,Okeechobee County,12,10,2699,1521,1178
50,12,93,Florida,Okeechobee County,12,11,2604,1507,1097
50,12,93,Florida,Okeechobee County,12,12,2782,1449,1333
50,12,93,Florida,Okeechobee County,12,13,2661,1336,1325
50,12,93,Florida,Okeechobee County,12,14,2324,1146,1178
50,12,93,Florida,Okeechobee County,12,15,2205,1066,1139
50,12,93,Florida,Okeechobee County,12,16,1707,821,886
50,12,93,Florida,Okeechobee County,12,17,1244,609,635
50,12,93,Florida,Okeechobee County,12,18,1002,466,536
50,12,95,Florida,Orange County,1,0,1145956,564326,581630
50,12,95,Florida,Orange County,1,1,74185,38130,36055
50,12,95,Florida,Orange County,1,2,73754,37440,36314
50,12,95,Florida,Orange County,1,3,74975,38221,36754
50,12,95,Florida,Orange County,1,4,88367,44855,43512
50,12,95,Florida,Orange County,1,5,105821,53541,52280
50,12,95,Florida,Orange County,1,6,93559,47142,46417
50,12,95,Florida,Orange County,1,7,83558,41733,41825
50,12,95,Florida,Orange County,1,8,82569,40853,41716
50,12,95,Florida,Orange County,1,9,81899,40995,40904
50,12,95,Florida,Orange County,1,10,85292,42407,42885
50,12,95,Florida,Orange County,1,11,76767,37430,39337
50,12,95,Florida,Orange County,1,12,63029,29938,33091
50,12,95,Florida,Orange County,1,13,51262,24203,27059
50,12,95,Florida,Orange County,1,14,35805,16561,19244
50,12,95,Florida,Orange County,1,15,26206,11777,14429
50,12,95,Florida,Orange County,1,16,20415,8798,11617
50,12,95,Florida,Orange County,1,17,14977,5834,9143
50,12,95,Florida,Orange County,1,18,13516,4468,9048
50,12,95,Florida,Orange County,2,0,1145957,564332,581625
50,12,95,Florida,Orange County,2,1,74185,38129,36056
50,12,95,Florida,Orange County,2,2,73755,37441,36314
50,12,95,Florida,Orange County,2,3,74977,38223,36754
50,12,95,Florida,Orange County,2,4,88369,44857,43512
50,12,95,Florida,Orange County,2,5,105822,53542,52280
50,12,95,Florida,Orange County,2,6,93562,47145,46417
50,12,95,Florida,Orange County,2,7,83558,41733,41825
50,12,95,Florida,Orange County,2,8,82572,40854,41718
50,12,95,Florida,Orange County,2,9,81897,40995,40902
50,12,95,Florida,Orange County,2,10,85290,42405,42885
50,12,95,Florida,Orange County,2,11,76764,37429,39335
50,12,95,Florida,Orange County,2,12,63029,29938,33091
50,12,95,Florida,Orange County,2,13,51261,24203,27058
50,12,95,Florida,Orange County,2,14,35804,16561,19243
50,12,95,Florida,Orange County,2,15,26205,11777,14428
50,12,95,Florida,Orange County,2,16,20415,8798,11617
50,12,95,Florida,Orange County,2,17,14977,5834,9143
50,12,95,Florida,Orange County,2,18,13515,4468,9047
50,12,95,Florida,Orange County,3,0,1148564,565438,583126
50,12,95,Florida,Orange County,3,1,74097,38101,35996
50,12,95,Florida,Orange County,3,2,73715,37492,36223
50,12,95,Florida,Orange County,3,3,75039,38223,36816
50,12,95,Florida,Orange County,3,4,87245,44221,43024
50,12,95,Florida,Orange County,3,5,106026,53577,52449
50,12,95,Florida,Orange County,3,6,94052,47410,46642
50,12,95,Florida,Orange County,3,7,84008,41911,42097
50,12,95,Florida,Orange County,3,8,82306,40737,41569
50,12,95,Florida,Orange County,3,9,82113,41059,41054
50,12,95,Florida,Orange County,3,10,85187,42314,42873
50,12,95,Florida,Orange County,3,11,77339,37764,39575
50,12,95,Florida,Orange County,3,12,63612,30252,33360
50,12,95,Florida,Orange County,3,13,51879,24443,27436
50,12,95,Florida,Orange County,3,14,36248,16794,19454
50,12,95,Florida,Orange County,3,15,26452,11882,14570
50,12,95,Florida,Orange County,3,16,20456,8822,11634
50,12,95,Florida,Orange County,3,17,15118,5911,9207
50,12,95,Florida,Orange County,3,18,13672,4525,9147
50,12,95,Florida,Orange County,4,0,1170579,575816,594763
50,12,95,Florida,Orange County,4,1,74489,38139,36350
50,12,95,Florida,Orange County,4,2,74642,38079,36563
50,12,95,Florida,Orange County,4,3,76493,38882,37611
50,12,95,Florida,Orange County,4,4,84652,42835,41817
50,12,95,Florida,Orange County,4,5,108306,54485,53821
50,12,95,Florida,Orange County,4,6,96756,49094,47662
50,12,95,Florida,Orange County,4,7,87001,43182,43819
50,12,95,Florida,Orange County,4,8,81978,40704,41274
50,12,95,Florida,Orange County,4,9,84238,41972,42266
50,12,95,Florida,Orange County,4,10,84707,41937,42770
50,12,95,Florida,Orange County,4,11,79834,39108,40726
50,12,95,Florida,Orange County,4,12,66203,31620,34583
50,12,95,Florida,Orange County,4,13,54992,25791,29201
50,12,95,Florida,Orange County,4,14,38267,17743,20524
50,12,95,Florida,Orange County,4,15,27357,12226,15131
50,12,95,Florida,Orange County,4,16,20862,9082,11780
50,12,95,Florida,Orange County,4,17,15590,6219,9371
50,12,95,Florida,Orange County,4,18,14212,4718,9494
50,12,95,Florida,Orange County,5,0,1202498,591561,610937
50,12,95,Florida,Orange County,5,1,75870,38884,36986
50,12,95,Florida,Orange County,5,2,76418,39073,37345
50,12,95,Florida,Orange County,5,3,77579,39330,38249
50,12,95,Florida,Orange County,5,4,84571,42630,41941
50,12,95,Florida,Orange County,5,5,109897,55303,54594
50,12,95,Florida,Orange County,5,6,100568,51003,49565
50,12,95,Florida,Orange County,5,7,90848,45288,45560
50,12,95,Florida,Orange County,5,8,83363,41184,42179
50,12,95,Florida,Orange County,5,9,86297,42982,43315
50,12,95,Florida,Orange County,5,10,85506,42385,43121
50,12,95,Florida,Orange County,5,11,82149,40375,41774
50,12,95,Florida,Orange County,5,12,69674,33309,36365
50,12,95,Florida,Orange County,5,13,56483,26500,29983
50,12,95,Florida,Orange County,5,14,42402,19673,22729
50,12,95,Florida,Orange County,5,15,28659,12914,15745
50,12,95,Florida,Orange County,5,16,21483,9305,12178
50,12,95,Florida,Orange County,5,17,15859,6423,9436
50,12,95,Florida,Orange County,5,18,14872,5000,9872
50,12,95,Florida,Orange County,6,0,1227435,603529,623906
50,12,95,Florida,Orange County,6,1,77018,39412,37606
50,12,95,Florida,Orange County,6,2,78135,40034,38101
50,12,95,Florida,Orange County,6,3,78360,39816,38544
50,12,95,Florida,Orange County,6,4,84499,42421,42078
50,12,95,Florida,Orange County,6,5,109120,54499,54621
50,12,95,Florida,Orange County,6,6,104700,53250,51450
50,12,95,Florida,Orange County,6,7,93783,46949,46834
50,12,95,Florida,Orange County,6,8,85145,42089,43056
50,12,95,Florida,Orange County,6,9,87348,43229,44119
50,12,95,Florida,Orange County,6,10,85267,42307,42960
50,12,95,Florida,Orange County,6,11,83889,41392,42497
50,12,95,Florida,Orange County,6,12,72039,34401,37638
50,12,95,Florida,Orange County,6,13,58204,27316,30888
50,12,95,Florida,Orange County,6,14,45478,21106,24372
50,12,95,Florida,Orange County,6,15,30640,13805,16835
50,12,95,Florida,Orange County,6,16,22209,9594,12615
50,12,95,Florida,Orange County,6,17,16131,6667,9464
50,12,95,Florida,Orange County,6,18,15470,5242,10228
50,12,95,Florida,Orange County,7,0,1256606,617182,639424
50,12,95,Florida,Orange County,7,1,78641,40174,38467
50,12,95,Florida,Orange County,7,2,79490,40799,38691
50,12,95,Florida,Orange County,7,3,79664,40531,39133
50,12,95,Florida,Orange County,7,4,85492,42733,42759
50,12,95,Florida,Orange County,7,5,107821,53420,54401
50,12,95,Florida,Orange County,7,6,109629,55874,53755
50,12,95,Florida,Orange County,7,7,96628,48418,48210
50,12,95,Florida,Orange County,7,8,87961,43289,44672
50,12,95,Florida,Orange County,7,9,88669,43751,44918
50,12,95,Florida,Orange County,7,10,85199,42344,42855
50,12,95,Florida,Orange County,7,11,85772,42275,43497
50,12,95,Florida,Orange County,7,12,74626,35819,38807
50,12,95,Florida,Orange County,7,13,60626,28400,32226
50,12,95,Florida,Orange County,7,14,48106,22223,25883
50,12,95,Florida,Orange County,7,15,32711,14813,17898
50,12,95,Florida,Orange County,7,16,22976,9927,13049
50,12,95,Florida,Orange County,7,17,16450,6859,9591
50,12,95,Florida,Orange County,7,18,16145,5533,10612
50,12,95,Florida,Orange County,8,0,1291301,633647,657654
50,12,95,Florida,Orange County,8,1,81012,41381,39631
50,12,95,Florida,Orange County,8,2,80925,41534,39391
50,12,95,Florida,Orange County,8,3,80830,41187,39643
50,12,95,Florida,Orange County,8,4,86966,43404,43562
50,12,95,Florida,Orange County,8,5,106658,52396,54262
50,12,95,Florida,Orange County,8,6,115712,59082,56630
50,12,95,Florida,Orange County,8,7,100287,50193,50094
50,12,95,Florida,Orange County,8,8,92005,45351,46654
50,12,95,Florida,Orange County,8,9,89317,43946,45371
50,12,95,Florida,Orange County,8,10,86646,42992,43654
50,12,95,Florida,Orange County,8,11,87351,42985,44366
50,12,95,Florida,Orange County,8,12,77359,37377,39982
50,12,95,Florida,Orange County,8,13,63267,29580,33687
50,12,95,Florida,Orange County,8,14,51132,23606,27526
50,12,95,Florida,Orange County,8,15,34526,15578,18948
50,12,95,Florida,Orange County,8,16,23850,10354,13496
50,12,95,Florida,Orange County,8,17,16665,6922,9743
50,12,95,Florida,Orange County,8,18,16793,5779,11014
50,12,95,Florida,Orange County,9,0,1326516,650722,675794
50,12,95,Florida,Orange County,9,1,82955,42535,40420
50,12,95,Florida,Orange County,9,2,82668,42339,40329
50,12,95,Florida,Orange County,9,3,82602,42136,40466
50,12,95,Florida,Orange County,9,4,88875,44250,44625
50,12,95,Florida,Orange County,9,5,105658,51664,53994
50,12,95,Florida,Orange County,9,6,119776,60962,58814
50,12,95,Florida,Orange County,9,7,103891,52229,51662
50,12,95,Florida,Orange County,9,8,96561,47596,48965
50,12,95,Florida,Orange County,9,9,90091,44212,45879
50,12,95,Florida,Orange County,9,10,89461,44308,45153
50,12,95,Florida,Orange County,9,11,88061,43336,44725
50,12,95,Florida,Orange County,9,12,80263,38843,41420
50,12,95,Florida,Orange County,9,13,65834,31018,34816
50,12,95,Florida,Orange County,9,14,54013,24916,29097
50,12,95,Florida,Orange County,9,15,36349,16337,20012
50,12,95,Florida,Orange County,9,16,24773,10690,14083
50,12,95,Florida,Orange County,9,17,17091,7237,9854
50,12,95,Florida,Orange County,9,18,17594,6114,11480
50,12,95,Florida,Orange County,10,0,1355921,664891,691030
50,12,95,Florida,Orange County,10,1,83688,42967,40721
50,12,95,Florida,Orange County,10,2,83969,43002,40967
50,12,95,Florida,Orange County,10,3,84558,43173,41385
50,12,95,Florida,Orange County,10,4,89866,44607,45259
50,12,95,Florida,Orange County,10,5,105284,51290,53994
50,12,95,Florida,Orange County,10,6,122150,61893,60257
50,12,95,Florida,Orange County,10,7,106909,53827,53082
50,12,95,Florida,Orange County,10,8,100102,49529,50573
50,12,95,Florida,Orange County,10,9,91941,45125,46816
50,12,95,Florida,Orange County,10,10,91518,45187,46331
50,12,95,Florida,Orange County,10,11,88417,43599,44818
50,12,95,Florida,Orange County,10,12,82120,39870,42250
50,12,95,Florida,Orange County,10,13,68433,32196,36237
50,12,95,Florida,Orange County,10,14,54763,25269,29494
50,12,95,Florida,Orange County,10,15,40323,18165,22158
50,12,95,Florida,Orange County,10,16,25946,11250,14696
50,12,95,Florida,Orange County,10,17,17805,7560,10245
50,12,95,Florida,Orange County,10,18,18129,6382,11747
50,12,95,Florida,Orange County,11,0,1381540,677354,704186
50,12,95,Florida,Orange County,11,1,84304,43168,41136
50,12,95,Florida,Orange County,11,2,84850,43398,41452
50,12,95,Florida,Orange County,11,3,86473,44193,42280
50,12,95,Florida,Orange County,11,4,90260,44845,45415
50,12,95,Florida,Orange County,11,5,104935,51126,53809
50,12,95,Florida,Orange County,11,6,122910,62248,60662
50,12,95,Florida,Orange County,11,7,109690,55169,54521
50,12,95,Florida,Orange County,11,8,103221,51086,52135
50,12,95,Florida,Orange County,11,9,94698,46547,48151
50,12,95,Florida,Orange County,11,10,92665,45617,47048
50,12,95,Florida,Orange County,11,11,88237,43532,44705
50,12,95,Florida,Orange County,11,12,84049,40985,43064
50,12,95,Florida,Orange County,11,13,70783,33434,37349
50,12,95,Florida,Orange County,11,14,56383,25951,30432
50,12,95,Florida,Orange County,11,15,43145,19502,23643
50,12,95,Florida,Orange County,11,16,27722,12058,15664
50,12,95,Florida,Orange County,11,17,18470,7770,10700
50,12,95,Florida,Orange County,11,18,18745,6725,12020
50,12,95,Florida,Orange County,12,0,1393452,683793,709659
50,12,95,Florida,Orange County,12,1,84020,43161,40859
50,12,95,Florida,Orange County,12,2,84914,43347,41567
50,12,95,Florida,Orange County,12,3,86112,44179,41933
50,12,95,Florida,Orange County,12,4,90098,44817,45281
50,12,95,Florida,Orange County,12,5,103419,50268,53151
50,12,95,Florida,Orange County,12,6,121447,61433,60014
50,12,95,Florida,Orange County,12,7,112483,57013,55470
50,12,95,Florida,Orange County,12,8,104347,51829,52518
50,12,95,Florida,Orange County,12,9,96608,47495,49113
50,12,95,Florida,Orange County,12,10,93040,45598,47442
50,12,95,Florida,Orange County,12,11,87448,43232,44216
50,12,95,Florida,Orange County,12,12,85471,41777,43694
50,12,95,Florida,Orange County,12,13,72488,34391,38097
50,12,95,Florida,Orange County,12,14,58274,26814,31460
50,12,95,Florida,Orange County,12,15,45529,20525,25004
50,12,95,Florida,Orange County,12,16,29456,12924,16532
50,12,95,Florida,Orange County,12,17,19122,8010,11112
50,12,95,Florida,Orange County,12,18,19176,6980,12196
50,12,97,Florida,Osceola County,1,0,268685,131634,137051
50,12,97,Florida,Osceola County,1,1,17796,9016,8780
50,12,97,Florida,Osceola County,1,2,18815,9658,9157
50,12,97,Florida,Osceola County,1,3,20572,10459,10113
50,12,97,Florida,Osceola County,1,4,21442,11142,10300
50,12,97,Florida,Osceola County,1,5,18007,9153,8854
50,12,97,Florida,Osceola County,1,6,17469,8845,8624
50,12,97,Florida,Osceola County,1,7,17832,8669,9163
50,12,97,Florida,Osceola County,1,8,19383,9319,10064
50,12,97,Florida,Osceola County,1,9,20101,9707,10394
50,12,97,Florida,Osceola County,1,10,20586,10082,10504
50,12,97,Florida,Osceola County,1,11,18290,8803,9487
50,12,97,Florida,Osceola County,1,12,15390,7294,8096
50,12,97,Florida,Osceola County,1,13,13346,6243,7103
50,12,97,Florida,Osceola County,1,14,10217,4785,5432
50,12,97,Florida,Osceola County,1,15,7396,3495,3901
50,12,97,Florida,Osceola County,1,16,5295,2387,2908
50,12,97,Florida,Osceola County,1,17,3695,1588,2107
50,12,97,Florida,Osceola County,1,18,3053,989,2064
50,12,97,Florida,Osceola County,2,0,268685,131633,137052
50,12,97,Florida,Osceola County,2,1,17795,9015,8780
50,12,97,Florida,Osceola County,2,2,18814,9657,9157
50,12,97,Florida,Osceola County,2,3,20572,10459,10113
50,12,97,Florida,Osceola County,2,4,21442,11142,10300
50,12,97,Florida,Osceola County,2,5,18008,9153,8855
50,12,97,Florida,Osceola County,2,6,17469,8845,8624
50,12,97,Florida,Osceola County,2,7,17830,8668,9162
50,12,97,Florida,Osceola County,2,8,19383,9319,10064
50,12,97,Florida,Osceola County,2,9,20101,9707,10394
50,12,97,Florida,Osceola County,2,10,20587,10082,10505
50,12,97,Florida,Osceola County,2,11,18292,8804,9488
50,12,97,Florida,Osceola County,2,12,15389,7294,8095
50,12,97,Florida,Osceola County,2,13,13346,6243,7103
50,12,97,Florida,Osceola County,2,14,10217,4785,5432
50,12,97,Florida,Osceola County,2,15,7396,3495,3901
50,12,97,Florida,Osceola County,2,16,5295,2387,2908
50,12,97,Florida,Osceola County,2,17,3696,1589,2107
50,12,97,Florida,Osceola County,2,18,3053,989,2064
50,12,97,Florida,Osceola County,3,0,269837,132197,137640
50,12,97,Florida,Osceola County,3,1,17849,9061,8788
50,12,97,Florida,Osceola County,3,2,18761,9598,9163
50,12,97,Florida,Osceola County,3,3,20609,10495,10114
50,12,97,Florida,Osceola County,3,4,21363,11094,10269
50,12,97,Florida,Osceola County,3,5,18236,9288,8948
50,12,97,Florida,Osceola County,3,6,17584,8896,8688
50,12,97,Florida,Osceola County,3,7,17970,8761,9209
50,12,97,Florida,Osceola County,3,8,19335,9304,10031
50,12,97,Florida,Osceola County,3,9,20150,9735,10415
50,12,97,Florida,Osceola County,3,10,20593,10062,10531
50,12,97,Florida,Osceola County,3,11,18386,8842,9544
50,12,97,Florida,Osceola County,3,12,15507,7360,8147
50,12,97,Florida,Osceola County,3,13,13490,6304,7186
50,12,97,Florida,Osceola County,3,14,10324,4836,5488
50,12,97,Florida,Osceola County,3,15,7504,3539,3965
50,12,97,Florida,Osceola County,3,16,5359,2413,2946
50,12,97,Florida,Osceola County,3,17,3736,1607,2129
50,12,97,Florida,Osceola County,3,18,3081,1002,2079
50,12,97,Florida,Osceola County,4,0,278636,136712,141924
50,12,97,Florida,Osceola County,4,1,18402,9388,9014
50,12,97,Florida,Osceola County,4,2,19013,9626,9387
50,12,97,Florida,Osceola County,4,3,21202,10774,10428
50,12,97,Florida,Osceola County,4,4,21574,11295,10279
50,12,97,Florida,Osceola County,4,5,19407,9961,9446
50,12,97,Florida,Osceola County,4,6,18366,9232,9134
50,12,97,Florida,Osceola County,4,7,18987,9405,9582
50,12,97,Florida,Osceola County,4,8,19480,9340,10140
50,12,97,Florida,Osceola County,4,9,20599,9946,10653
50,12,97,Florida,Osceola County,4,10,20833,10221,10612
50,12,97,Florida,Osceola County,4,11,18817,9066,9751
50,12,97,Florida,Osceola County,4,12,16065,7646,8419
50,12,97,Florida,Osceola County,4,13,14167,6670,7497
50,12,97,Florida,Osceola County,4,14,10904,5079,5825
50,12,97,Florida,Osceola County,4,15,7989,3776,4213
50,12,97,Florida,Osceola County,4,16,5656,2542,3114
50,12,97,Florida,Osceola County,4,17,3906,1672,2234
50,12,97,Florida,Osceola County,4,18,3269,1073,2196
50,12,97,Florida,Osceola County,5,0,288876,142048,146828
50,12,97,Florida,Osceola County,5,1,18993,9815,9178
50,12,97,Florida,Osceola County,5,2,19835,10044,9791
50,12,97,Florida,Osceola County,5,3,21643,11063,10580
50,12,97,Florida,Osceola County,5,4,21783,11453,10330
50,12,97,Florida,Osceola County,5,5,20857,10641,10216
50,12,97,Florida,Osceola County,5,6,19434,9824,9610
50,12,97,Florida,Osceola County,5,7,20101,10033,10068
50,12,97,Florida,Osceola County,5,8,19863,9577,10286
50,12,97,Florida,Osceola County,5,9,21194,10198,10996
50,12,97,Florida,Osceola County,5,10,20900,10268,10632
50,12,97,Florida,Osceola County,5,11,19287,9235,10052
50,12,97,Florida,Osceola County,5,12,16746,8036,8710
50,12,97,Florida,Osceola County,5,13,14199,6683,7516
50,12,97,Florida,Osceola County,5,14,12011,5546,6465
50,12,97,Florida,Osceola County,5,15,8516,4045,4471
50,12,97,Florida,Osceola County,5,16,5991,2658,3333
50,12,97,Florida,Osceola County,5,17,4024,1722,2302
50,12,97,Florida,Osceola County,5,18,3499,1207,2292
50,12,97,Florida,Osceola County,6,0,299238,147185,152053
50,12,97,Florida,Osceola County,6,1,19328,9997,9331
50,12,97,Florida,Osceola County,6,2,20822,10553,10269
50,12,97,Florida,Osceola County,6,3,22184,11406,10778
50,12,97,Florida,Osceola County,6,4,22034,11393,10641
50,12,97,Florida,Osceola County,6,5,21496,10953,10543
50,12,97,Florida,Osceola County,6,6,20559,10435,10124
50,12,97,Florida,Osceola County,6,7,21194,10640,10554
50,12,97,Florida,Osceola County,6,8,20903,10160,10743
50,12,97,Florida,Osceola County,6,9,21664,10388,11276
50,12,97,Florida,Osceola County,6,10,21062,10390,10672
50,12,97,Florida,Osceola County,6,11,19934,9561,10373
50,12,97,Florida,Osceola County,6,12,17379,8358,9021
50,12,97,Florida,Osceola County,6,13,14622,6865,7757
50,12,97,Florida,Osceola County,6,14,12727,5901,6826
50,12,97,Florida,Osceola County,6,15,9198,4312,4886
50,12,97,Florida,Osceola County,6,16,6300,2814,3486
50,12,97,Florida,Osceola County,6,17,4118,1752,2366
50,12,97,Florida,Osceola County,6,18,3714,1307,2407
50,12,97,Florida,Osceola County,7,0,311046,152956,158090
50,12,97,Florida,Osceola County,7,1,20051,10330,9721
50,12,97,Florida,Osceola County,7,2,21428,10909,10519
50,12,97,Florida,Osceola County,7,3,22825,11714,11111
50,12,97,Florida,Osceola County,7,4,22592,11625,10967
50,12,97,Florida,Osceola County,7,5,21916,11198,10718
50,12,97,Florida,Osceola County,7,6,22051,11239,10812
50,12,97,Florida,Osceola County,7,7,21913,11024,10889
50,12,97,Florida,Osceola County,7,8,22341,10965,11376
50,12,97,Florida,Osceola County,7,9,22139,10556,11583
50,12,97,Florida,Osceola County,7,10,21421,10469,10952
50,12,97,Florida,Osceola County,7,11,20772,10084,10688
50,12,97,Florida,Osceola County,7,12,18023,8673,9350
50,12,97,Florida,Osceola County,7,13,15352,7107,8245
50,12,97,Florida,Osceola County,7,14,13401,6224,7177
50,12,97,Florida,Osceola County,7,15,9951,4571,5380
50,12,97,Florida,Osceola County,7,16,6701,3031,3670
50,12,97,Florida,Osceola County,7,17,4272,1831,2441
50,12,97,Florida,Osceola County,7,18,3897,1406,2491
50,12,97,Florida,Osceola County,8,0,323736,159340,164396
50,12,97,Florida,Osceola County,8,1,20945,10810,10135
50,12,97,Florida,Osceola County,8,2,21917,11182,10735
50,12,97,Florida,Osceola County,8,3,23451,12030,11421
50,12,97,Florida,Osceola County,8,4,23379,11986,11393
50,12,97,Florida,Osceola County,8,5,22473,11650,10823
50,12,97,Florida,Osceola County,8,6,23187,11802,11385
50,12,97,Florida,Osceola County,8,7,22873,11513,11360
50,12,97,Florida,Osceola County,8,8,23400,11516,11884
50,12,97,Florida,Osceola County,8,9,23154,11105,12049
50,12,97,Florida,Osceola County,8,10,21995,10639,11356
50,12,97,Florida,Osceola County,8,11,21611,10550,11061
50,12,97,Florida,Osceola County,8,12,18739,9021,9718
50,12,97,Florida,Osceola County,8,13,16024,7413,8611
50,12,97,Florida,Osceola County,8,14,14188,6618,7570
50,12,97,Florida,Osceola County,8,15,10728,4869,5859
50,12,97,Florida,Osceola County,8,16,7105,3266,3839
50,12,97,Florida,Osceola County,8,17,4516,1888,2628
50,12,97,Florida,Osceola County,8,18,4051,1482,2569
50,12,97,Florida,Osceola County,9,0,338209,166636,171573
50,12,97,Florida,Osceola County,9,1,21612,11073,10539
50,12,97,Florida,Osceola County,9,2,22818,11712,11106
50,12,97,Florida,Osceola County,9,3,24234,12394,11840
50,12,97,Florida,Osceola County,9,4,24394,12505,11889
50,12,97,Florida,Osceola County,9,5,23094,11912,11182
50,12,97,Florida,Osceola County,9,6,24711,12564,12147
50,12,97,Florida,Osceola County,9,7,23792,12112,11680
50,12,97,Florida,Osceola County,9,8,24778,12333,12445
50,12,97,Florida,Osceola County,9,9,23914,11527,12387
50,12,97,Florida,Osceola County,9,10,23197,11169,12028
50,12,97,Florida,Osceola County,9,11,22246,10857,11389
50,12,97,Florida,Osceola County,9,12,19627,9483,10144
50,12,97,Florida,Osceola County,9,13,16753,7769,8984
50,12,97,Florida,Osceola County,9,14,14994,6991,8003
50,12,97,Florida,Osceola County,9,15,11332,5143,6189
50,12,97,Florida,Osceola County,9,16,7654,3466,4188
50,12,97,Florida,Osceola County,9,17,4800,2039,2761
50,12,97,Florida,Osceola County,9,18,4259,1587,2672
50,12,97,Florida,Osceola County,10,0,353623,174281,179342
50,12,97,Florida,Osceola County,10,1,22449,11550,10899
50,12,97,Florida,Osceola County,10,2,23655,12283,11372
50,12,97,Florida,Osceola County,10,3,25192,12838,12354
50,12,97,Florida,Osceola County,10,4,25253,12937,12316
50,12,97,Florida,Osceola County,10,5,23703,12075,11628
50,12,97,Florida,Osceola County,10,6,25879,13172,12707
50,12,97,Florida,Osceola County,10,7,25112,12731,12381
50,12,97,Florida,Osceola County,10,8,26337,13214,13123
50,12,97,Florida,Osceola County,10,9,24946,11999,12947
50,12,97,Florida,Osceola County,10,10,24319,11725,12594
50,12,97,Florida,Osceola County,10,11,22939,11216,11723
50,12,97,Florida,Osceola County,10,12,20532,9974,10558
50,12,97,Florida,Osceola County,10,13,17674,8175,9499
50,12,97,Florida,Osceola County,10,14,15423,7195,8228
50,12,97,Florida,Osceola County,10,15,12413,5632,6781
50,12,97,Florida,Osceola County,10,16,8239,3707,4532
50,12,97,Florida,Osceola County,10,17,5082,2150,2932
50,12,97,Florida,Osceola County,10,18,4476,1708,2768
50,12,97,Florida,Osceola County,11,0,368456,181850,186606
50,12,97,Florida,Osceola County,11,1,23134,11867,11267
50,12,97,Florida,Osceola County,11,2,24536,12810,11726
50,12,97,Florida,Osceola County,11,3,26553,13636,12917
50,12,97,Florida,Osceola County,11,4,25911,13246,12665
50,12,97,Florida,Osceola County,11,5,24501,12504,11997
50,12,97,Florida,Osceola County,11,6,26804,13601,13203
50,12,97,Florida,Osceola County,11,7,26264,13376,12888
50,12,97,Florida,Osceola County,11,8,27402,13779,13623
50,12,97,Florida,Osceola County,11,9,26477,12822,13655
50,12,97,Florida,Osceola County,11,10,25221,12152,13069
50,12,97,Florida,Osceola County,11,11,23608,11542,12066
50,12,97,Florida,Osceola County,11,12,21370,10404,10966
50,12,97,Florida,Osceola County,11,13,18345,8493,9852
50,12,97,Florida,Osceola County,11,14,16050,7453,8597
50,12,97,Florida,Osceola County,11,15,13189,6036,7153
50,12,97,Florida,Osceola County,11,16,8927,3978,4949
50,12,97,Florida,Osceola County,11,17,5480,2362,3118
50,12,97,Florida,Osceola County,11,18,4684,1789,2895
50,12,97,Florida,Osceola County,12,0,375751,185592,190159
50,12,97,Florida,Osceola County,12,1,23182,11951,11231
50,12,97,Florida,Osceola County,12,2,25048,13009,12039
50,12,97,Florida,Osceola County,12,3,26441,13598,12843
50,12,97,Florida,Osceola County,12,4,25877,13150,12727
50,12,97,Florida,Osceola County,12,5,24877,12574,12303
50,12,97,Florida,Osceola County,12,6,26857,13602,13255
50,12,97,Florida,Osceola County,12,7,27078,13902,13176
50,12,97,Florida,Osceola County,12,8,27856,14010,13846
50,12,97,Florida,Osceola County,12,9,27179,13294,13885
50,12,97,Florida,Osceola County,12,10,25716,12401,13315
50,12,97,Florida,Osceola County,12,11,23807,11629,12178
50,12,97,Florida,Osceola County,12,12,22148,10845,11303
50,12,97,Florida,Osceola County,12,13,18904,8960,9944
50,12,97,Florida,Osceola County,12,14,16788,7655,9133
50,12,97,Florida,Osceola County,12,15,13632,6365,7267
50,12,97,Florida,Osceola County,12,16,9592,4198,5394
50,12,97,Florida,Osceola County,12,17,5887,2554,3333
50,12,97,Florida,Osceola County,12,18,4882,1895,2987
50,12,99,Florida,Palm Beach County,1,0,1320134,638888,681246
50,12,99,Florida,Palm Beach County,1,1,70852,36025,34827
50,12,99,Florida,Palm Beach County,1,2,72847,37131,35716
50,12,99,Florida,Palm Beach County,1,3,76917,39321,37596
50,12,99,Florida,Palm Beach County,1,4,79570,40975,38595
50,12,99,Florida,Palm Beach County,1,5,74105,38722,35383
50,12,99,Florida,Palm Beach County,1,6,74695,38232,36463
50,12,99,Florida,Palm Beach County,1,7,71999,35868,36131
50,12,99,Florida,Palm Beach County,1,8,78802,38852,39950
50,12,99,Florida,Palm Beach County,1,9,86774,42587,44187
50,12,99,Florida,Palm Beach County,1,10,95732,46791,48941
50,12,99,Florida,Palm Beach County,1,11,92394,45090,47304
50,12,99,Florida,Palm Beach County,1,12,81829,38714,43115
50,12,99,Florida,Palm Beach County,1,13,78463,35986,42477
50,12,99,Florida,Palm Beach County,1,14,70465,31626,38839
50,12,99,Florida,Palm Beach County,1,15,59962,26773,33189
50,12,99,Florida,Palm Beach County,1,16,54879,24318,30561
50,12,99,Florida,Palm Beach County,1,17,50644,22054,28590
50,12,99,Florida,Palm Beach County,1,18,49205,19823,29382
50,12,99,Florida,Palm Beach County,2,0,1320135,638888,681247
50,12,99,Florida,Palm Beach County,2,1,70852,36025,34827
50,12,99,Florida,Palm Beach County,2,2,72847,37131,35716
50,12,99,Florida,Palm Beach County,2,3,76917,39321,37596
50,12,99,Florida,Palm Beach County,2,4,79570,40975,38595
50,12,99,Florida,Palm Beach County,2,5,74105,38722,35383
50,12,99,Florida,Palm Beach County,2,6,74695,38232,36463
50,12,99,Florida,Palm Beach County,2,7,71999,35868,36131
50,12,99,Florida,Palm Beach County,2,8,78803,38852,39951
50,12,99,Florida,Palm Beach County,2,9,86774,42587,44187
50,12,99,Florida,Palm Beach County,2,10,95732,46791,48941
50,12,99,Florida,Palm Beach County,2,11,92394,45090,47304
50,12,99,Florida,Palm Beach County,2,12,81829,38714,43115
50,12,99,Florida,Palm Beach County,2,13,78463,35986,42477
50,12,99,Florida,Palm Beach County,2,14,70465,31626,38839
50,12,99,Florida,Palm Beach County,2,15,59962,26773,33189
50,12,99,Florida,Palm Beach County,2,16,54879,24318,30561
50,12,99,Florida,Palm Beach County,2,17,50644,22054,28590
50,12,99,Florida,Palm Beach County,2,18,49205,19823,29382
50,12,99,Florida,Palm Beach County,3,0,1323619,640612,683007
50,12,99,Florida,Palm Beach County,3,1,70816,36052,34764
50,12,99,Florida,Palm Beach County,3,2,72749,37056,35693
50,12,99,Florida,Palm Beach County,3,3,76912,39300,37612
50,12,99,Florida,Palm Beach County,3,4,79774,41016,38758
50,12,99,Florida,Palm Beach County,3,5,74956,39154,35802
50,12,99,Florida,Palm Beach County,3,6,75118,38493,36625
50,12,99,Florida,Palm Beach County,3,7,72279,36019,36260
50,12,99,Florida,Palm Beach County,3,8,78335,38609,39726
50,12,99,Florida,Palm Beach County,3,9,86775,42597,44178
50,12,99,Florida,Palm Beach County,3,10,95695,46799,48896
50,12,99,Florida,Palm Beach County,3,11,92904,45316,47588
50,12,99,Florida,Palm Beach County,3,12,82405,39033,43372
50,12,99,Florida,Palm Beach County,3,13,78782,36136,42646
50,12,99,Florida,Palm Beach County,3,14,70866,31803,39063
50,12,99,Florida,Palm Beach County,3,15,60221,26897,33324
50,12,99,Florida,Palm Beach County,3,16,54566,24190,30376
50,12,99,Florida,Palm Beach County,3,17,50699,22069,28630
50,12,99,Florida,Palm Beach County,3,18,49767,20073,29694
50,12,99,Florida,Palm Beach County,4,0,1336760,646589,690171
50,12,99,Florida,Palm Beach County,4,1,70611,35895,34716
50,12,99,Florida,Palm Beach County,4,2,72996,37178,35818
50,12,99,Florida,Palm Beach County,4,3,77239,39483,37756
50,12,99,Florida,Palm Beach County,4,4,79285,40749,38536
50,12,99,Florida,Palm Beach County,4,5,76819,39922,36897
50,12,99,Florida,Palm Beach County,4,6,76434,39129,37305
50,12,99,Florida,Palm Beach County,4,7,73395,36452,36943
50,12,99,Florida,Palm Beach County,4,8,76191,37561,38630
50,12,99,Florida,Palm Beach County,4,9,87176,42855,44321
50,12,99,Florida,Palm Beach County,4,10,94714,46217,48497
50,12,99,Florida,Palm Beach County,4,11,94870,46248,48622
50,12,99,Florida,Palm Beach County,4,12,84349,40121,44228
50,12,99,Florida,Palm Beach County,4,13,81546,37487,44059
50,12,99,Florida,Palm Beach County,4,14,72537,32585,39952
50,12,99,Florida,Palm Beach County,4,15,61772,27480,34292
50,12,99,Florida,Palm Beach County,4,16,54057,24075,29982
50,12,99,Florida,Palm Beach County,4,17,50703,22017,28686
50,12,99,Florida,Palm Beach County,4,18,52066,21135,30931
50,12,99,Florida,Palm Beach County,5,0,1354936,655481,699455
50,12,99,Florida,Palm Beach County,5,1,70596,35976,34620
50,12,99,Florida,Palm Beach County,5,2,73644,37356,36288
50,12,99,Florida,Palm Beach County,5,3,77366,39549,37817
50,12,99,Florida,Palm Beach County,5,4,79154,40596,38558
50,12,99,Florida,Palm Beach County,5,5,79416,40925,38491
50,12,99,Florida,Palm Beach County,5,6,78562,40144,38418
50,12,99,Florida,Palm Beach County,5,7,75292,37639,37653
50,12,99,Florida,Palm Beach County,5,8,75500,37243,38257
50,12,99,Florida,Palm Beach County,5,9,87239,43070,44169
50,12,99,Florida,Palm Beach County,5,10,93638,45589,48049
50,12,99,Florida,Palm Beach County,5,11,96445,47107,49338
50,12,99,Florida,Palm Beach County,5,12,87334,41436,45898
50,12,99,Florida,Palm Beach County,5,13,79612,36866,42746
50,12,99,Florida,Palm Beach County,5,14,77336,34825,42511
50,12,99,Florida,Palm Beach County,5,15,64675,28712,35963
50,12,99,Florida,Palm Beach County,5,16,54635,24455,30180
50,12,99,Florida,Palm Beach County,5,17,50119,21760,28359
50,12,99,Florida,Palm Beach County,5,18,54373,22233,32140
50,12,99,Florida,Palm Beach County,6,0,1376462,666230,710232
50,12,99,Florida,Palm Beach County,6,1,70812,36035,34777
50,12,99,Florida,Palm Beach County,6,2,75282,38222,37060
50,12,99,Florida,Palm Beach County,6,3,77607,39624,37983
50,12,99,Florida,Palm Beach County,6,4,79558,40835,38723
50,12,99,Florida,Palm Beach County,6,5,80614,41403,39211
50,12,99,Florida,Palm Beach County,6,6,80093,41097,38996
50,12,99,Florida,Palm Beach County,6,7,77430,38840,38590
50,12,99,Florida,Palm Beach County,6,8,75987,37488,38499
50,12,99,Florida,Palm Beach County,6,9,87122,43034,44088
50,12,99,Florida,Palm Beach County,6,10,92507,44961,47546
50,12,99,Florida,Palm Beach County,6,11,98388,47992,50396
50,12,99,Florida,Palm Beach County,6,12,90858,43368,47490
50,12,99,Florida,Palm Beach County,6,13,80541,37455,43086
50,12,99,Florida,Palm Beach County,6,14,79107,35533,43574
50,12,99,Florida,Palm Beach County,6,15,68786,30603,38183
50,12,99,Florida,Palm Beach County,6,16,56070,25011,31059
50,12,99,Florida,Palm Beach County,6,17,49231,21387,27844
50,12,99,Florida,Palm Beach County,6,18,56469,23342,33127
50,12,99,Florida,Palm Beach County,7,0,1398656,677286,721370
50,12,99,Florida,Palm Beach County,7,1,71914,36729,35185
50,12,99,Florida,Palm Beach County,7,2,75647,38489,37158
50,12,99,Florida,Palm Beach County,7,3,78099,39873,38226
50,12,99,Florida,Palm Beach County,7,4,79146,40533,38613
50,12,99,Florida,Palm Beach County,7,5,81302,41549,39753
50,12,99,Florida,Palm Beach County,7,6,82722,42558,40164
50,12,99,Florida,Palm Beach County,7,7,80036,40208,39828
50,12,99,Florida,Palm Beach County,7,8,77448,38260,39188
50,12,99,Florida,Palm Beach County,7,9,86383,42597,43786
50,12,99,Florida,Palm Beach County,7,10,91316,44387,46929
50,12,99,Florida,Palm Beach County,7,11,99782,48542,51240
50,12,99,Florida,Palm Beach County,7,12,93478,44829,48649
50,12,99,Florida,Palm Beach County,7,13,82747,38481,44266
50,12,99,Florida,Palm Beach County,7,14,82338,37217,45121
50,12,99,Florida,Palm Beach County,7,15,71448,31676,39772
50,12,99,Florida,Palm Beach County,7,16,57979,25920,32059
50,12,99,Florida,Palm Beach County,7,17,48475,21232,27243
50,12,99,Florida,Palm Beach County,7,18,58396,24206,34190
50,12,99,Florida,Palm Beach County,8,0,1424256,690223,734033
50,12,99,Florida,Palm Beach County,8,1,73308,37358,35950
50,12,99,Florida,Palm Beach County,8,2,76288,38923,37365
50,12,99,Florida,Palm Beach County,8,3,78502,39986,38516
50,12,99,Florida,Palm Beach County,8,4,80423,41120,39303
50,12,99,Florida,Palm Beach County,8,5,80619,41299,39320
50,12,99,Florida,Palm Beach County,8,6,85855,44051,41804
50,12,99,Florida,Palm Beach County,8,7,82107,41603,40504
50,12,99,Florida,Palm Beach County,8,8,79926,39479,40447
50,12,99,Florida,Palm Beach County,8,9,85287,42198,43089
50,12,99,Florida,Palm Beach County,8,10,92310,44790,47520
50,12,99,Florida,Palm Beach County,8,11,100013,48540,51473
50,12,99,Florida,Palm Beach County,8,12,96404,46454,49950
50,12,99,Florida,Palm Beach County,8,13,85952,40004,45948
50,12,99,Florida,Palm Beach County,8,14,85332,38755,46577
50,12,99,Florida,Palm Beach County,8,15,74226,32940,41286
50,12,99,Florida,Palm Beach County,8,16,59591,26459,33132
50,12,99,Florida,Palm Beach County,8,17,48014,21169,26845
50,12,99,Florida,Palm Beach County,8,18,60099,25095,35004
50,12,99,Florida,Palm Beach County,9,0,1450890,703040,747850
50,12,99,Florida,Palm Beach County,9,1,74922,38306,36616
50,12,99,Florida,Palm Beach County,9,2,76796,38949,37847
50,12,99,Florida,Palm Beach County,9,3,79458,40440,39018
50,12,99,Florida,Palm Beach County,9,4,81604,41803,39801
50,12,99,Florida,Palm Beach County,9,5,79904,40845,39059
50,12,99,Florida,Palm Beach County,9,6,88955,45595,43360
50,12,99,Florida,Palm Beach County,9,7,84522,42862,41660
50,12,99,Florida,Palm Beach County,9,8,82484,40845,41639
50,12,99,Florida,Palm Beach County,9,9,84230,41487,42743
50,12,99,Florida,Palm Beach County,9,10,93410,45454,47956
50,12,99,Florida,Palm Beach County,9,11,99335,48182,51153
50,12,99,Florida,Palm Beach County,9,12,99653,47911,51742
50,12,99,Florida,Palm Beach County,9,13,88440,41462,46978
50,12,99,Florida,Palm Beach County,9,14,88464,40018,48446
50,12,99,Florida,Palm Beach County,9,15,76973,34220,42753
50,12,99,Florida,Palm Beach County,9,16,61812,27412,34400
50,12,99,Florida,Palm Beach County,9,17,48261,21338,26923
50,12,99,Florida,Palm Beach County,9,18,61667,25911,35756
50,12,99,Florida,Palm Beach County,10,0,1470344,712747,757597
50,12,99,Florida,Palm Beach County,10,1,75842,38844,36998
50,12,99,Florida,Palm Beach County,10,2,76842,39050,37792
50,12,99,Florida,Palm Beach County,10,3,80472,40890,39582
50,12,99,Florida,Palm Beach County,10,4,81983,42010,39973
50,12,99,Florida,Palm Beach County,10,5,79312,40566,38746
50,12,99,Florida,Palm Beach County,10,6,90620,46475,44145
50,12,99,Florida,Palm Beach County,10,7,85865,43605,42260
50,12,99,Florida,Palm Beach County,10,8,84146,41756,42390
50,12,99,Florida,Palm Beach County,10,9,84152,41398,42754
50,12,99,Florida,Palm Beach County,10,10,93786,45789,47997
50,12,99,Florida,Palm Beach County,10,11,98230,47490,50740
50,12,99,Florida,Palm Beach County,10,12,101089,48770,52319
50,12,99,Florida,Palm Beach County,10,13,91792,42942,48850
50,12,99,Florida,Palm Beach County,10,14,86892,39419,47473
50,12,99,Florida,Palm Beach County,10,15,82525,36674,45851
50,12,99,Florida,Palm Beach County,10,16,64803,28744,36059
50,12,99,Florida,Palm Beach County,10,17,49223,21864,27359
50,12,99,Florida,Palm Beach County,10,18,62770,26461,36309
50,12,99,Florida,Palm Beach County,11,0,1482876,718909,763967
50,12,99,Florida,Palm Beach County,11,1,75868,38820,37048
50,12,99,Florida,Palm Beach County,11,2,76155,38765,37390
50,12,99,Florida,Palm Beach County,11,3,81552,41439,40113
50,12,99,Florida,Palm Beach County,11,4,81683,41908,39775
50,12,99,Florida,Palm Beach County,11,5,79275,40464,38811
50,12,99,Florida,Palm Beach County,11,6,90007,45926,44081
50,12,99,Florida,Palm Beach County,11,7,86590,44172,42418
50,12,99,Florida,Palm Beach County,11,8,85826,42808,43018
50,12,99,Florida,Palm Beach County,11,9,84074,41320,42754
50,12,99,Florida,Palm Beach County,11,10,93282,45589,47693
50,12,99,Florida,Palm Beach County,11,11,96537,46723,49814
50,12,99,Florida,Palm Beach County,11,12,102377,49236,53141
50,12,99,Florida,Palm Beach County,11,13,94502,44421,50081
50,12,99,Florida,Palm Beach County,11,14,87397,39751,47646
50,12,99,Florida,Palm Beach County,11,15,84473,37523,46950
50,12,99,Florida,Palm Beach County,11,16,69124,30747,38377
50,12,99,Florida,Palm Beach County,11,17,50585,22402,28183
50,12,99,Florida,Palm Beach County,11,18,63569,26895,36674
50,12,99,Florida,Palm Beach County,12,0,1496770,725445,771325
50,12,99,Florida,Palm Beach County,12,1,76303,38883,37420
50,12,99,Florida,Palm Beach County,12,2,76765,39260,37505
50,12,99,Florida,Palm Beach County,12,3,81337,41255,40082
50,12,99,Florida,Palm Beach County,12,4,81611,41758,39853
50,12,99,Florida,Palm Beach County,12,5,78971,40155,38816
50,12,99,Florida,Palm Beach County,12,6,89305,45526,43779
50,12,99,Florida,Palm Beach County,12,7,88692,45370,43322
50,12,99,Florida,Palm Beach County,12,8,86888,43408,43480
50,12,99,Florida,Palm Beach County,12,9,85217,41821,43396
50,12,99,Florida,Palm Beach County,12,10,92076,45020,47056
50,12,99,Florida,Palm Beach County,12,11,95133,46020,49113
50,12,99,Florida,Palm Beach County,12,12,103234,49520,53714
50,12,99,Florida,Palm Beach County,12,13,96694,45689,51005
50,12,99,Florida,Palm Beach County,12,14,89034,40512,48522
50,12,99,Florida,Palm Beach County,12,15,87573,39037,48536
50,12,99,Florida,Palm Beach County,12,16,71577,31844,39733
50,12,99,Florida,Palm Beach County,12,17,52166,23065,29101
50,12,99,Florida,Palm Beach County,12,18,64194,27302,36892
50,12,101,Florida,Pasco County,1,0,464697,225886,238811
50,12,101,Florida,Pasco County,1,1,25664,13228,12436
50,12,101,Florida,Pasco County,1,2,27278,13942,13336
50,12,101,Florida,Pasco County,1,3,28407,14579,13828
50,12,101,Florida,Pasco County,1,4,27637,14236,13401
50,12,101,Florida,Pasco County,1,5,22191,11132,11059
50,12,101,Florida,Pasco County,1,6,23419,11393,12026
50,12,101,Florida,Pasco County,1,7,25788,12554,13234
50,12,101,Florida,Pasco County,1,8,29570,14545,15025
50,12,101,Florida,Pasco County,1,9,31141,15495,15646
50,12,101,Florida,Pasco County,1,10,34321,17082,17239
50,12,101,Florida,Pasco County,1,11,32273,15607,16666
50,12,101,Florida,Pasco County,1,12,29605,13847,15758
50,12,101,Florida,Pasco County,1,13,31158,14450,16708
50,12,101,Florida,Pasco County,1,14,27934,13124,14810
50,12,101,Florida,Pasco County,1,15,22936,10890,12046
50,12,101,Florida,Pasco County,1,16,18525,8622,9903
50,12,101,Florida,Pasco County,1,17,14297,6405,7892
50,12,101,Florida,Pasco County,1,18,12553,4755,7798
50,12,101,Florida,Pasco County,2,0,464705,225891,238814
50,12,101,Florida,Pasco County,2,1,25665,13229,12436
50,12,101,Florida,Pasco County,2,2,27278,13942,13336
50,12,101,Florida,Pasco County,2,3,28407,14579,13828
50,12,101,Florida,Pasco County,2,4,27638,14236,13402
50,12,101,Florida,Pasco County,2,5,22192,11133,11059
50,12,101,Florida,Pasco County,2,6,23418,11393,12025
50,12,101,Florida,Pasco County,2,7,25789,12554,13235
50,12,101,Florida,Pasco County,2,8,29572,14547,15025
50,12,101,Florida,Pasco County,2,9,31141,15495,15646
50,12,101,Florida,Pasco County,2,10,34322,17082,17240
50,12,101,Florida,Pasco County,2,11,32274,15608,16666
50,12,101,Florida,Pasco County,2,12,29607,13847,15760
50,12,101,Florida,Pasco County,2,13,31159,14451,16708
50,12,101,Florida,Pasco County,2,14,27934,13124,14810
50,12,101,Florida,Pasco County,2,15,22934,10889,12045
50,12,101,Florida,Pasco County,2,16,18524,8622,9902
50,12,101,Florida,Pasco County,2,17,14298,6405,7893
50,12,101,Florida,Pasco County,2,18,12553,4755,7798
50,12,101,Florida,Pasco County,3,0,465487,226273,239214
50,12,101,Florida,Pasco County,3,1,25533,13148,12385
50,12,101,Florida,Pasco County,3,2,27228,13906,13322
50,12,101,Florida,Pasco County,3,3,28475,14616,13859
50,12,101,Florida,Pasco County,3,4,27517,14191,13326
50,12,101,Florida,Pasco County,3,5,22501,11277,11224
50,12,101,Florida,Pasco County,3,6,23501,11442,12059
50,12,101,Florida,Pasco County,3,7,25893,12621,13272
50,12,101,Florida,Pasco County,3,8,29262,14367,14895
50,12,101,Florida,Pasco County,3,9,31305,15580,15725
50,12,101,Florida,Pasco County,3,10,34229,17046,17183
50,12,101,Florida,Pasco County,3,11,32454,15702,16752
50,12,101,Florida,Pasco County,3,12,29715,13903,15812
50,12,101,Florida,Pasco County,3,13,31266,14481,16785
50,12,101,Florida,Pasco County,3,14,28056,13172,14884
50,12,101,Florida,Pasco County,3,15,23039,10932,12107
50,12,101,Florida,Pasco County,3,16,18508,8636,9872
50,12,101,Florida,Pasco County,3,17,14369,6442,7927
50,12,101,Florida,Pasco County,3,18,12636,4811,7825
50,12,101,Florida,Pasco County,4,0,466464,226584,239880
50,12,101,Florida,Pasco County,4,1,25050,12781,12269
50,12,101,Florida,Pasco County,4,2,26767,13697,13070
50,12,101,Florida,Pasco County,4,3,28539,14572,13967
50,12,101,Florida,Pasco County,4,4,26958,13957,13001
50,12,101,Florida,Pasco County,4,5,23684,11879,11805
50,12,101,Florida,Pasco County,4,6,23381,11435,11946
50,12,101,Florida,Pasco County,4,7,25831,12547,13284
50,12,101,Florida,Pasco County,4,8,27876,13560,14316
50,12,101,Florida,Pasco County,4,9,31816,15832,15984
50,12,101,Florida,Pasco County,4,10,33503,16709,16794
50,12,101,Florida,Pasco County,4,11,33112,16008,17104
50,12,101,Florida,Pasco County,4,12,30003,14068,15935
50,12,101,Florida,Pasco County,4,13,32007,14836,17171
50,12,101,Florida,Pasco County,4,14,28473,13286,15187
50,12,101,Florida,Pasco County,4,15,23499,11157,12342
50,12,101,Florida,Pasco County,4,16,18722,8796,9926
50,12,101,Florida,Pasco County,4,17,14396,6509,7887
50,12,101,Florida,Pasco County,4,18,12847,4955,7892
50,12,101,Florida,Pasco County,5,0,469637,228338,241299
50,12,101,Florida,Pasco County,5,1,24943,12757,12186
50,12,101,Florida,Pasco County,5,2,26848,13713,13135
50,12,101,Florida,Pasco County,5,3,28639,14591,14048
50,12,101,Florida,Pasco County,5,4,26849,14000,12849
50,12,101,Florida,Pasco County,5,5,24538,12261,12277
50,12,101,Florida,Pasco County,5,6,23337,11428,11909
50,12,101,Florida,Pasco County,5,7,26052,12675,13377
50,12,101,Florida,Pasco County,5,8,27298,13326,13972
50,12,101,Florida,Pasco County,5,9,31619,15723,15896
50,12,101,Florida,Pasco County,5,10,32881,16369,16512
50,12,101,Florida,Pasco County,5,11,33586,16358,17228
50,12,101,Florida,Pasco County,5,12,30672,14497,16175
50,12,101,Florida,Pasco County,5,13,30845,14258,16587
50,12,101,Florida,Pasco County,5,14,30442,14204,16238
50,12,101,Florida,Pasco County,5,15,24526,11552,12974
50,12,101,Florida,Pasco County,5,16,19050,8962,10088
50,12,101,Florida,Pasco County,5,17,14276,6485,7791
50,12,101,Florida,Pasco County,5,18,13236,5179,8057
50,12,101,Florida,Pasco County,6,0,474352,230688,243664
50,12,101,Florida,Pasco County,6,1,24648,12611,12037
50,12,101,Florida,Pasco County,6,2,27234,13970,13264
50,12,101,Florida,Pasco County,6,3,28603,14583,14020
50,12,101,Florida,Pasco County,6,4,27135,14070,13065
50,12,101,Florida,Pasco County,6,5,24871,12540,12331
50,12,101,Florida,Pasco County,6,6,23598,11553,12045
50,12,101,Florida,Pasco County,6,7,26642,12971,13671
50,12,101,Florida,Pasco County,6,8,27087,13237,13850
50,12,101,Florida,Pasco County,6,9,31505,15608,15897
50,12,101,Florida,Pasco County,6,10,32377,15986,16391
50,12,101,Florida,Pasco County,6,11,34246,16835,17411
50,12,101,Florida,Pasco County,6,12,31608,14951,16657
50,12,101,Florida,Pasco County,6,13,30511,14030,16481
50,12,101,Florida,Pasco County,6,14,31136,14560,16576
50,12,101,Florida,Pasco County,6,15,26059,12216,13843
50,12,101,Florida,Pasco County,6,16,19526,9202,10324
50,12,101,Florida,Pasco County,6,17,14160,6428,7732
50,12,101,Florida,Pasco County,6,18,13406,5337,8069
50,12,101,Florida,Pasco County,7,0,483399,235262,248137
50,12,101,Florida,Pasco County,7,1,25014,12831,12183
50,12,101,Florida,Pasco County,7,2,27539,14176,13363
50,12,101,Florida,Pasco County,7,3,28975,14778,14197
50,12,101,Florida,Pasco County,7,4,27713,14297,13416
50,12,101,Florida,Pasco County,7,5,25192,12734,12458
50,12,101,Florida,Pasco County,7,6,24544,12124,12420
50,12,101,Florida,Pasco County,7,7,27195,13113,14082
50,12,101,Florida,Pasco County,7,8,27637,13486,14151
50,12,101,Florida,Pasco County,7,9,31525,15631,15894
50,12,101,Florida,Pasco County,7,10,32242,15929,16313
50,12,101,Florida,Pasco County,7,11,34807,17207,17600
50,12,101,Florida,Pasco County,7,12,32686,15445,17241
50,12,101,Florida,Pasco County,7,13,30844,14256,16588
50,12,101,Florida,Pasco County,7,14,32261,15066,17195
50,12,101,Florida,Pasco County,7,15,27107,12700,14407
50,12,101,Florida,Pasco County,7,16,20175,9473,10702
50,12,101,Florida,Pasco County,7,17,14172,6456,7716
50,12,101,Florida,Pasco County,7,18,13771,5560,8211
50,12,101,Florida,Pasco County,8,0,494895,240798,254097
50,12,101,Florida,Pasco County,8,1,25701,13235,12466
50,12,101,Florida,Pasco County,8,2,28069,14496,13573
50,12,101,Florida,Pasco County,8,3,29376,14876,14500
50,12,101,Florida,Pasco County,8,4,28512,14663,13849
50,12,101,Florida,Pasco County,8,5,25425,12875,12550
50,12,101,Florida,Pasco County,8,6,26063,12885,13178
50,12,101,Florida,Pasco County,8,7,27560,13302,14258
50,12,101,Florida,Pasco County,8,8,28702,13926,14776
50,12,101,Florida,Pasco County,8,9,31265,15454,15811
50,12,101,Florida,Pasco County,8,10,32843,16288,16555
50,12,101,Florida,Pasco County,8,11,35309,17441,17868
50,12,101,Florida,Pasco County,8,12,33655,15952,17703
50,12,101,Florida,Pasco County,8,13,31669,14714,16955
50,12,101,Florida,Pasco County,8,14,33391,15442,17949
50,12,101,Florida,Pasco County,8,15,28027,13129,14898
50,12,101,Florida,Pasco County,8,16,20719,9735,10984
50,12,101,Florida,Pasco County,8,17,14369,6617,7752
50,12,101,Florida,Pasco County,8,18,14240,5768,8472
50,12,101,Florida,Pasco County,9,0,509937,248277,261660
50,12,101,Florida,Pasco County,9,1,26638,13799,12839
50,12,101,Florida,Pasco County,9,2,28727,14719,14008
50,12,101,Florida,Pasco County,9,3,29916,15209,14707
50,12,101,Florida,Pasco County,9,4,29104,14905,14199
50,12,101,Florida,Pasco County,9,5,25875,13275,12600
50,12,101,Florida,Pasco County,9,6,27596,13645,13951
50,12,101,Florida,Pasco County,9,7,28377,13773,14604
50,12,101,Florida,Pasco County,9,8,30157,14539,15618
50,12,101,Florida,Pasco County,9,9,31033,15290,15743
50,12,101,Florida,Pasco County,9,10,34210,17056,17154
50,12,101,Florida,Pasco County,9,11,35732,17662,18070
50,12,101,Florida,Pasco County,9,12,35249,16751,18498
50,12,101,Florida,Pasco County,9,13,32605,15095,17510
50,12,101,Florida,Pasco County,9,14,34898,16218,18680
50,12,101,Florida,Pasco County,9,15,29008,13495,15513
50,12,101,Florida,Pasco County,9,16,21616,10201,11415
50,12,101,Florida,Pasco County,9,17,14723,6785,7938
50,12,101,Florida,Pasco County,9,18,14473,5860,8613
50,12,101,Florida,Pasco County,10,0,525141,255363,269778
50,12,101,Florida,Pasco County,10,1,27475,14019,13456
50,12,101,Florida,Pasco County,10,2,29499,15148,14351
50,12,101,Florida,Pasco County,10,3,30794,15673,15121
50,12,101,Florida,Pasco County,10,4,29936,15242,14694
50,12,101,Florida,Pasco County,10,5,26146,13485,12661
50,12,101,Florida,Pasco County,10,6,29170,14269,14901
50,12,101,Florida,Pasco County,10,7,29275,14154,15121
50,12,101,Florida,Pasco County,10,8,31349,15140,16209
50,12,101,Florida,Pasco County,10,9,31755,15589,16166
50,12,101,Florida,Pasco County,10,10,35161,17586,17575
50,12,101,Florida,Pasco County,10,11,35849,17620,18229
50,12,101,Florida,Pasco County,10,12,36636,17589,19047
50,12,101,Florida,Pasco County,10,13,33709,15653,18056
50,12,101,Florida,Pasco County,10,14,34089,15691,18398
50,12,101,Florida,Pasco County,10,15,31468,14662,16806
50,12,101,Florida,Pasco County,10,16,22761,10664,12097
50,12,101,Florida,Pasco County,10,17,15215,7082,8133
50,12,101,Florida,Pasco County,10,18,14854,6097,8757
50,12,101,Florida,Pasco County,11,0,539090,261989,277101
50,12,101,Florida,Pasco County,11,1,27994,14113,13881
50,12,101,Florida,Pasco County,11,2,30163,15449,14714
50,12,101,Florida,Pasco County,11,3,32121,16532,15589
50,12,101,Florida,Pasco County,11,4,30311,15422,14889
50,12,101,Florida,Pasco County,11,5,26732,13670,13062
50,12,101,Florida,Pasco County,11,6,29895,14718,15177
50,12,101,Florida,Pasco County,11,7,30104,14513,15591
50,12,101,Florida,Pasco County,11,8,32857,15836,17021
50,12,101,Florida,Pasco County,11,9,32476,15961,16515
50,12,101,Florida,Pasco County,11,10,35915,17908,18007
50,12,101,Florida,Pasco County,11,11,36121,17664,18457
50,12,101,Florida,Pasco County,11,12,37630,18257,19373
50,12,101,Florida,Pasco County,11,13,35004,16249,18755
50,12,101,Florida,Pasco County,11,14,34104,15740,18364
50,12,101,Florida,Pasco County,11,15,32447,15073,17374
50,12,101,Florida,Pasco County,11,16,24432,11360,13072
50,12,101,Florida,Pasco County,11,17,15807,7386,8421
50,12,101,Florida,Pasco County,11,18,14977,6138,8839
50,12,101,Florida,Pasco County,12,0,553947,269315,284632
50,12,101,Florida,Pasco County,12,1,28525,14354,14171
50,12,101,Florida,Pasco County,12,2,31309,16077,15232
50,12,101,Florida,Pasco County,12,3,32831,16959,15872
50,12,101,Florida,Pasco County,12,4,30766,15650,15116
50,12,101,Florida,Pasco County,12,5,27513,13971,13542
50,12,101,Florida,Pasco County,12,6,30425,15089,15336
50,12,101,Florida,Pasco County,12,7,31970,15568,16402
50,12,101,Florida,Pasco County,12,8,34052,16307,17745
50,12,101,Florida,Pasco County,12,9,33616,16542,17074
50,12,101,Florida,Pasco County,12,10,36235,17966,18269
50,12,101,Florida,Pasco County,12,11,36014,17650,18364
50,12,101,Florida,Pasco County,12,12,38762,18933,19829
50,12,101,Florida,Pasco County,12,13,36478,16938,19540
50,12,101,Florida,Pasco County,12,14,34584,15907,18677
50,12,101,Florida,Pasco County,12,15,33790,15679,18111
50,12,101,Florida,Pasco County,12,16,25536,11850,13686
50,12,101,Florida,Pasco County,12,17,16422,7692,8730
50,12,101,Florida,Pasco County,12,18,15119,6183,8936
50,12,103,Florida,Pinellas County,1,0,916542,440009,476533
50,12,103,Florida,Pinellas County,1,1,42349,21575,20774
50,12,103,Florida,Pinellas County,1,2,43079,22007,21072
50,12,103,Florida,Pinellas County,1,3,46769,24013,22756
50,12,103,Florida,Pinellas County,1,4,50416,25842,24574
50,12,103,Florida,Pinellas County,1,5,47098,23267,23831
50,12,103,Florida,Pinellas County,1,6,51142,25302,25840
50,12,103,Florida,Pinellas County,1,7,48237,23813,24424
50,12,103,Florida,Pinellas County,1,8,51997,25754,26243
50,12,103,Florida,Pinellas County,1,9,59366,29435,29931
50,12,103,Florida,Pinellas County,1,10,72618,35525,37093
50,12,103,Florida,Pinellas County,1,11,74973,36138,38835
50,12,103,Florida,Pinellas County,1,12,68714,32543,36171
50,12,103,Florida,Pinellas County,1,13,65685,31478,34207
50,12,103,Florida,Pinellas County,1,14,52994,24566,28428
50,12,103,Florida,Pinellas County,1,15,42300,19499,22801
50,12,103,Florida,Pinellas County,1,16,36090,15881,20209
50,12,103,Florida,Pinellas County,1,17,30880,12571,18309
50,12,103,Florida,Pinellas County,1,18,31835,10800,21035
50,12,103,Florida,Pinellas County,2,0,916800,440145,476655
50,12,103,Florida,Pinellas County,2,1,42349,21575,20774
50,12,103,Florida,Pinellas County,2,2,43079,22007,21072
50,12,103,Florida,Pinellas County,2,3,46768,24013,22755
50,12,103,Florida,Pinellas County,2,4,50420,25842,24578
50,12,103,Florida,Pinellas County,2,5,47117,23279,23838
50,12,103,Florida,Pinellas County,2,6,51158,25314,25844
50,12,103,Florida,Pinellas County,2,7,48250,23823,24427
50,12,103,Florida,Pinellas County,2,8,52008,25762,26246
50,12,103,Florida,Pinellas County,2,9,59391,29453,29938
50,12,103,Florida,Pinellas County,2,10,72654,35553,37101
50,12,103,Florida,Pinellas County,2,11,75013,36166,38847
50,12,103,Florida,Pinellas County,2,12,68727,32551,36176
50,12,103,Florida,Pinellas County,2,13,65693,31477,34216
50,12,103,Florida,Pinellas County,2,14,52996,24568,28428
50,12,103,Florida,Pinellas County,2,15,42301,19499,22802
50,12,103,Florida,Pinellas County,2,16,36093,15882,20211
50,12,103,Florida,Pinellas County,2,17,30891,12575,18316
50,12,103,Florida,Pinellas County,2,18,31892,10806,21086
50,12,103,Florida,Pinellas County,3,0,916412,439977,476435
50,12,103,Florida,Pinellas County,3,1,42137,21452,20685
50,12,103,Florida,Pinellas County,3,2,42900,21920,20980
50,12,103,Florida,Pinellas County,3,3,46680,23941,22739
50,12,103,Florida,Pinellas County,3,4,49958,25631,24327
50,12,103,Florida,Pinellas County,3,5,47393,23437,23956
50,12,103,Florida,Pinellas County,3,6,51150,25290,25860
50,12,103,Florida,Pinellas County,3,7,48445,23923,24522
50,12,103,Florida,Pinellas County,3,8,51420,25432,25988
50,12,103,Florida,Pinellas County,3,9,59186,29335,29851
50,12,103,Florida,Pinellas County,3,10,72164,35305,36859
50,12,103,Florida,Pinellas County,3,11,75145,36280,38865
50,12,103,Florida,Pinellas County,3,12,69043,32690,36353
50,12,103,Florida,Pinellas County,3,13,66097,31665,34432
50,12,103,Florida,Pinellas County,3,14,53305,24716,28589
50,12,103,Florida,Pinellas County,3,15,42471,19600,22871
50,12,103,Florida,Pinellas County,3,16,36013,15847,20166
50,12,103,Florida,Pinellas County,3,17,30873,12621,18252
50,12,103,Florida,Pinellas County,3,18,32032,10892,21140
50,12,103,Florida,Pinellas County,4,0,918455,441067,477388
50,12,103,Florida,Pinellas County,4,1,42238,21460,20778
50,12,103,Florida,Pinellas County,4,2,42631,21765,20866
50,12,103,Florida,Pinellas County,4,3,46266,23715,22551
50,12,103,Florida,Pinellas County,4,4,48374,24847,23527
50,12,103,Florida,Pinellas County,4,5,48899,24282,24617
50,12,103,Florida,Pinellas County,4,6,51349,25426,25923
50,12,103,Florida,Pinellas County,4,7,49800,24545,25255
50,12,103,Florida,Pinellas County,4,8,49119,24201,24918
50,12,103,Florida,Pinellas County,4,9,58625,28882,29743
50,12,103,Florida,Pinellas County,4,10,69652,34135,35517
50,12,103,Florida,Pinellas County,4,11,75581,36698,38883
50,12,103,Florida,Pinellas County,4,12,70464,33316,37148
50,12,103,Florida,Pinellas County,4,13,68232,32602,35630
50,12,103,Florida,Pinellas County,4,14,54586,25435,29151
50,12,103,Florida,Pinellas County,4,15,43384,20020,23364
50,12,103,Florida,Pinellas County,4,16,35943,15815,20128
50,12,103,Florida,Pinellas County,4,17,30656,12696,17960
50,12,103,Florida,Pinellas County,4,18,32656,11227,21429
50,12,103,Florida,Pinellas County,5,0,921642,442612,479030
50,12,103,Florida,Pinellas County,5,1,41948,21320,20628
50,12,103,Florida,Pinellas County,5,2,43018,21956,21062
50,12,103,Florida,Pinellas County,5,3,45693,23364,22329
50,12,103,Florida,Pinellas County,5,4,47215,24260,22955
50,12,103,Florida,Pinellas County,5,5,50309,25085,25224
50,12,103,Florida,Pinellas County,5,6,51151,25309,25842
50,12,103,Florida,Pinellas County,5,7,50976,25088,25888
50,12,103,Florida,Pinellas County,5,8,48091,23668,24423
50,12,103,Florida,Pinellas County,5,9,57824,28452,29372
50,12,103,Florida,Pinellas County,5,10,67157,32816,34341
50,12,103,Florida,Pinellas County,5,11,75168,36452,38716
50,12,103,Florida,Pinellas County,5,12,72049,34158,37891
50,12,103,Florida,Pinellas County,5,13,66840,31716,35124
50,12,103,Florida,Pinellas County,5,14,59048,27759,31289
50,12,103,Florida,Pinellas County,5,15,45078,20656,24422
50,12,103,Florida,Pinellas County,5,16,36062,16052,20010
50,12,103,Florida,Pinellas County,5,17,30531,12837,17694
50,12,103,Florida,Pinellas County,5,18,33484,11664,21820
50,12,103,Florida,Pinellas County,6,0,928414,445737,482677
50,12,103,Florida,Pinellas County,6,1,41740,21262,20478
50,12,103,Florida,Pinellas County,6,2,43728,22311,21417
50,12,103,Florida,Pinellas County,6,3,45358,23181,22177
50,12,103,Florida,Pinellas County,6,4,46565,23890,22675
50,12,103,Florida,Pinellas County,6,5,51182,25456,25726
50,12,103,Florida,Pinellas County,6,6,52003,25805,26198
50,12,103,Florida,Pinellas County,6,7,52180,25557,26623
50,12,103,Florida,Pinellas County,6,8,48385,23769,24616
50,12,103,Florida,Pinellas County,6,9,56815,27764,29051
50,12,103,Florida,Pinellas County,6,10,64623,31546,33077
50,12,103,Florida,Pinellas County,6,11,75491,36686,38805
50,12,103,Florida,Pinellas County,6,12,73853,35004,38849
50,12,103,Florida,Pinellas County,6,13,67028,31755,35273
50,12,103,Florida,Pinellas County,6,14,60937,28618,32319
50,12,103,Florida,Pinellas County,6,15,47870,21990,25880
50,12,103,Florida,Pinellas County,6,16,36552,16342,20210
50,12,103,Florida,Pinellas County,6,17,30074,12793,17281
50,12,103,Florida,Pinellas County,6,18,34030,12008,22022
50,12,103,Florida,Pinellas County,7,0,936400,449479,486921
50,12,103,Florida,Pinellas County,7,1,42278,21446,20832
50,12,103,Florida,Pinellas County,7,2,43521,22162,21359
50,12,103,Florida,Pinellas County,7,3,45139,23001,22138
50,12,103,Florida,Pinellas County,7,4,45948,23670,22278
50,12,103,Florida,Pinellas County,7,5,50982,25480,25502
50,12,103,Florida,Pinellas County,7,6,53731,26556,27175
50,12,103,Florida,Pinellas County,7,7,53271,26119,27152
50,12,103,Florida,Pinellas County,7,8,49083,24079,25004
50,12,103,Florida,Pinellas County,7,9,55371,27029,28342
50,12,103,Florida,Pinellas County,7,10,62547,30639,31908
50,12,103,Florida,Pinellas County,7,11,75712,36620,39092
50,12,103,Florida,Pinellas County,7,12,75240,35642,39598
50,12,103,Florida,Pinellas County,7,13,68526,32260,36266
50,12,103,Florida,Pinellas County,7,14,63437,29893,33544
50,12,103,Florida,Pinellas County,7,15,49791,22880,26911
50,12,103,Florida,Pinellas County,7,16,37550,16927,20623
50,12,103,Florida,Pinellas County,7,17,29577,12684,16893
50,12,103,Florida,Pinellas County,7,18,34696,12392,22304
50,12,103,Florida,Pinellas County,8,0,947060,454624,492436
50,12,103,Florida,Pinellas County,8,1,42719,21775,20944
50,12,103,Florida,Pinellas County,8,2,43441,22009,21432
50,12,103,Florida,Pinellas County,8,3,44680,22900,21780
50,12,103,Florida,Pinellas County,8,4,45660,23472,22188
50,12,103,Florida,Pinellas County,8,5,50059,25018,25041
50,12,103,Florida,Pinellas County,8,6,56290,27746,28544
50,12,103,Florida,Pinellas County,8,7,54263,26606,27657
50,12,103,Florida,Pinellas County,8,8,50568,24857,25711
50,12,103,Florida,Pinellas County,8,9,53800,26265,27535
50,12,103,Florida,Pinellas County,8,10,61783,30223,31560
50,12,103,Florida,Pinellas County,8,11,74826,36130,38696
50,12,103,Florida,Pinellas County,8,12,77032,36655,40377
50,12,103,Florida,Pinellas County,8,13,70440,32835,37605
50,12,103,Florida,Pinellas County,8,14,66177,31287,34890
50,12,103,Florida,Pinellas County,8,15,51763,23677,28086
50,12,103,Florida,Pinellas County,8,16,38652,17569,21083
50,12,103,Florida,Pinellas County,8,17,29450,12626,16824
50,12,103,Florida,Pinellas County,8,18,35457,12974,22483
50,12,103,Florida,Pinellas County,9,0,959874,460894,498980
50,12,103,Florida,Pinellas County,9,1,43047,21866,21181
50,12,103,Florida,Pinellas County,9,2,43585,22180,21405
50,12,103,Florida,Pinellas County,9,3,44677,22910,21767
50,12,103,Florida,Pinellas County,9,4,45723,23392,22331
50,12,103,Florida,Pinellas County,9,5,48971,24549,24422
50,12,103,Florida,Pinellas County,9,6,58970,29185,29785
50,12,103,Florida,Pinellas County,9,7,55434,27184,28250
50,12,103,Florida,Pinellas County,9,8,52415,25717,26698
50,12,103,Florida,Pinellas County,9,9,52123,25501,26622
50,12,103,Florida,Pinellas County,9,10,62135,30268,31867
50,12,103,Florida,Pinellas County,9,11,73230,35249,37981
50,12,103,Florida,Pinellas County,9,12,78504,37562,40942
50,12,103,Florida,Pinellas County,9,13,72441,33676,38765
50,12,103,Florida,Pinellas County,9,14,69241,32700,36541
50,12,103,Florida,Pinellas County,9,15,53468,24482,28986
50,12,103,Florida,Pinellas County,9,16,40038,18196,21842
50,12,103,Florida,Pinellas County,9,17,29797,12817,16980
50,12,103,Florida,Pinellas County,9,18,36075,13460,22615
50,12,103,Florida,Pinellas County,10,0,968341,464959,503382
50,12,103,Florida,Pinellas County,10,1,42756,21876,20880
50,12,103,Florida,Pinellas County,10,2,42923,21802,21121
50,12,103,Florida,Pinellas County,10,3,44932,22922,22010
50,12,103,Florida,Pinellas County,10,4,45155,23066,22089
50,12,103,Florida,Pinellas County,10,5,48072,24122,23950
50,12,103,Florida,Pinellas County,10,6,60797,30168,30629
50,12,103,Florida,Pinellas County,10,7,55939,27597,28342
50,12,103,Florida,Pinellas County,10,8,53977,26387,27590
50,12,103,Florida,Pinellas County,10,9,51556,25224,26332
50,12,103,Florida,Pinellas County,10,10,62018,30152,31866
50,12,103,Florida,Pinellas County,10,11,71148,34262,36886
50,12,103,Florida,Pinellas County,10,12,79133,37766,41367
50,12,103,Florida,Pinellas County,10,13,74822,34926,39896
50,12,103,Florida,Pinellas County,10,14,68480,32023,36457
50,12,103,Florida,Pinellas County,10,15,58103,26884,31219
50,12,103,Florida,Pinellas County,10,16,41711,18821,22890
50,12,103,Florida,Pinellas County,10,17,30084,13060,17024
50,12,103,Florida,Pinellas County,10,18,36735,13901,22834
50,12,103,Florida,Pinellas County,11,0,973058,467102,505956
50,12,103,Florida,Pinellas County,11,1,42245,21607,20638
50,12,103,Florida,Pinellas County,11,2,42503,21685,20818
50,12,103,Florida,Pinellas County,11,3,45170,22903,22267
50,12,103,Florida,Pinellas County,11,4,44229,22696,21533
50,12,103,Florida,Pinellas County,11,5,47517,23915,23602
50,12,103,Florida,Pinellas County,11,6,61238,30377,30861
50,12,103,Florida,Pinellas County,11,7,56620,27957,28663
50,12,103,Florida,Pinellas County,11,8,55038,26979,28059
50,12,103,Florida,Pinellas County,11,9,51493,25166,26327
50,12,103,Florida,Pinellas County,11,10,60943,29526,31417
50,12,103,Florida,Pinellas County,11,11,68395,33007,35388
50,12,103,Florida,Pinellas County,11,12,79495,37939,41556
50,12,103,Florida,Pinellas County,11,13,76899,35839,41060
50,12,103,Florida,Pinellas County,11,14,68865,32038,36827
50,12,103,Florida,Pinellas County,11,15,60258,27896,32362
50,12,103,Florida,Pinellas County,11,16,44524,20088,24436
50,12,103,Florida,Pinellas County,11,17,30593,13324,17269
50,12,103,Florida,Pinellas County,11,18,37033,14160,22873
50,12,103,Florida,Pinellas County,12,0,974996,468101,506895
50,12,103,Florida,Pinellas County,12,1,41227,21148,20079
50,12,103,Florida,Pinellas County,12,2,42317,21573,20744
50,12,103,Florida,Pinellas County,12,3,44456,22623,21833
50,12,103,Florida,Pinellas County,12,4,43663,22375,21288
50,12,103,Florida,Pinellas County,12,5,46671,23406,23265
50,12,103,Florida,Pinellas County,12,6,60472,30138,30334
50,12,103,Florida,Pinellas County,12,7,58054,28825,29229
50,12,103,Florida,Pinellas County,12,8,55687,27272,28415
50,12,103,Florida,Pinellas County,12,9,51830,25278,26552
50,12,103,Florida,Pinellas County,12,10,59004,28616,30388
50,12,103,Florida,Pinellas County,12,11,66073,32043,34030
50,12,103,Florida,Pinellas County,12,12,79627,37869,41758
50,12,103,Florida,Pinellas County,12,13,78285,36595,41690
50,12,103,Florida,Pinellas County,12,14,70253,32491,37762
50,12,103,Florida,Pinellas County,12,15,62519,28944,33575
50,12,103,Florida,Pinellas County,12,16,46387,20902,25485
50,12,103,Florida,Pinellas County,12,17,31510,13823,17687
50,12,103,Florida,Pinellas County,12,18,36961,14180,22781
50,12,105,Florida,Polk County,1,0,602095,295313,306782
50,12,105,Florida,Polk County,1,1,38839,19778,19061
50,12,105,Florida,Polk County,1,2,39316,20133,19183
50,12,105,Florida,Polk County,1,3,39282,20101,19181
50,12,105,Florida,Polk County,1,4,40847,21181,19666
50,12,105,Florida,Polk County,1,5,36499,18343,18156
50,12,105,Florida,Polk County,1,6,36235,17921,18314
50,12,105,Florida,Polk County,1,7,35013,17329,17684
50,12,105,Florida,Polk County,1,8,36600,18114,18486
50,12,105,Florida,Polk County,1,9,36847,18582,18265
50,12,105,Florida,Polk County,1,10,40418,20071,20347
50,12,105,Florida,Polk County,1,11,39659,19358,20301
50,12,105,Florida,Polk County,1,12,36929,17432,19497
50,12,105,Florida,Polk County,1,13,37315,17327,19988
50,12,105,Florida,Polk County,1,14,33508,15737,17771
50,12,105,Florida,Polk County,1,15,27250,13137,14113
50,12,105,Florida,Polk County,1,16,20537,9572,10965
50,12,105,Florida,Polk County,1,17,15007,6657,8350
50,12,105,Florida,Polk County,1,18,11994,4540,7454
50,12,105,Florida,Polk County,2,0,602073,295300,306773
50,12,105,Florida,Polk County,2,1,38839,19777,19062
50,12,105,Florida,Polk County,2,2,39315,20132,19183
50,12,105,Florida,Polk County,2,3,39278,20097,19181
50,12,105,Florida,Polk County,2,4,40840,21177,19663
50,12,105,Florida,Polk County,2,5,36498,18343,18155
50,12,105,Florida,Polk County,2,6,36234,17921,18313
50,12,105,Florida,Polk County,2,7,35013,17329,17684
50,12,105,Florida,Polk County,2,8,36597,18114,18483
50,12,105,Florida,Polk County,2,9,36845,18581,18264
50,12,105,Florida,Polk County,2,10,40417,20070,20347
50,12,105,Florida,Polk County,2,11,39657,19356,20301
50,12,105,Florida,Polk County,2,12,36928,17432,19496
50,12,105,Florida,Polk County,2,13,37316,17327,19989
50,12,105,Florida,Polk County,2,14,33508,15738,17770
50,12,105,Florida,Polk County,2,15,27250,13137,14113
50,12,105,Florida,Polk County,2,16,20537,9572,10965
50,12,105,Florida,Polk County,2,17,15007,6657,8350
50,12,105,Florida,Polk County,2,18,11994,4540,7454
50,12,105,Florida,Polk County,3,0,603102,295756,307346
50,12,105,Florida,Polk County,3,1,38547,19688,18859
50,12,105,Florida,Polk County,3,2,39256,20104,19152
50,12,105,Florida,Polk County,3,3,39378,20116,19262
50,12,105,Florida,Polk County,3,4,40611,21083,19528
50,12,105,Florida,Polk County,3,5,36965,18531,18434
50,12,105,Florida,Polk County,3,6,36239,17950,18289
50,12,105,Florida,Polk County,3,7,35194,17419,17775
50,12,105,Florida,Polk County,3,8,36385,17982,18403
50,12,105,Florida,Polk County,3,9,36918,18587,18331
50,12,105,Florida,Polk County,3,10,40338,20058,20280
50,12,105,Florida,Polk County,3,11,39781,19410,20371
50,12,105,Florida,Polk County,3,12,37069,17506,19563
50,12,105,Florida,Polk County,3,13,37482,17419,20063
50,12,105,Florida,Polk County,3,14,33630,15772,17858
50,12,105,Florida,Polk County,3,15,27403,13189,14214
50,12,105,Florida,Polk County,3,16,20645,9615,11030
50,12,105,Florida,Polk County,3,17,15101,6703,8398
50,12,105,Florida,Polk County,3,18,12160,4624,7536
50,12,105,Florida,Polk County,4,0,609948,299025,310923
50,12,105,Florida,Polk County,4,1,37941,19438,18503
50,12,105,Florida,Polk County,4,2,39357,20105,19252
50,12,105,Florida,Polk County,4,3,39933,20346,19587
50,12,105,Florida,Polk County,4,4,39867,20807,19060
50,12,105,Florida,Polk County,4,5,38912,19529,19383
50,12,105,Florida,Polk County,4,6,36722,18227,18495
50,12,105,Florida,Polk County,4,7,36071,17909,18162
50,12,105,Florida,Polk County,4,8,35614,17503,18111
50,12,105,Florida,Polk County,4,9,37788,18916,18872
50,12,105,Florida,Polk County,4,10,39732,19754,19978
50,12,105,Florida,Polk County,4,11,40429,19767,20662
50,12,105,Florida,Polk County,4,12,37619,17802,19817
50,12,105,Florida,Polk County,4,13,38676,17919,20757
50,12,105,Florida,Polk County,4,14,34167,15909,18258
50,12,105,Florida,Polk County,4,15,28053,13466,14587
50,12,105,Florida,Polk County,4,16,21238,9965,11273
50,12,105,Florida,Polk County,4,17,15228,6776,8452
50,12,105,Florida,Polk County,4,18,12601,4887,7714
50,12,105,Florida,Polk County,5,0,615453,301680,313773
50,12,105,Florida,Polk County,5,1,37202,18982,18220
50,12,105,Florida,Polk County,5,2,39680,20302,19378
50,12,105,Florida,Polk County,5,3,40533,20718,19815
50,12,105,Florida,Polk County,5,4,38928,20140,18788
50,12,105,Florida,Polk County,5,5,39617,19932,19685
50,12,105,Florida,Polk County,5,6,36988,18493,18495
50,12,105,Florida,Polk County,5,7,36794,18246,18548
50,12,105,Florida,Polk County,5,8,35417,17378,18039
50,12,105,Florida,Polk County,5,9,38299,19075,19224
50,12,105,Florida,Polk County,5,10,39465,19668,19797
50,12,105,Florida,Polk County,5,11,40372,19876,20496
50,12,105,Florida,Polk County,5,12,38490,18306,20184
50,12,105,Florida,Polk County,5,13,37611,17422,20189
50,12,105,Florida,Polk County,5,14,36443,16853,19590
50,12,105,Florida,Polk County,5,15,29222,13880,15342
50,12,105,Florida,Polk County,5,16,21909,10364,11545
50,12,105,Florida,Polk County,5,17,15338,6858,8480
50,12,105,Florida,Polk County,5,18,13145,5187,7958
50,12,105,Florida,Polk County,6,0,622633,305194,317439
50,12,105,Florida,Polk County,6,1,36862,18881,17981
50,12,105,Florida,Polk County,6,2,40296,20667,19629
50,12,105,Florida,Polk County,6,3,40884,20824,20060
50,12,105,Florida,Polk County,6,4,39375,20302,19073
50,12,105,Florida,Polk County,6,5,40214,20209,20005
50,12,105,Florida,Polk County,6,6,37570,18860,18710
50,12,105,Florida,Polk County,6,7,37316,18398,18918
50,12,105,Florida,Polk County,6,8,35394,17361,18033
50,12,105,Florida,Polk County,6,9,38465,19165,19300
50,12,105,Florida,Polk County,6,10,38886,19361,19525
50,12,105,Florida,Polk County,6,11,40665,20001,20664
50,12,105,Florida,Polk County,6,12,39173,18720,20453
50,12,105,Florida,Polk County,6,13,37433,17334,20099
50,12,105,Florida,Polk County,6,14,37298,17330,19968
50,12,105,Florida,Polk County,6,15,30725,14424,16301
50,12,105,Florida,Polk County,6,16,22955,10917,12038
50,12,105,Florida,Polk County,6,17,15467,6984,8483
50,12,105,Florida,Polk County,6,18,13655,5456,8199
50,12,105,Florida,Polk County,7,0,634398,311024,323374
50,12,105,Florida,Polk County,7,1,37550,19371,18179
50,12,105,Florida,Polk County,7,2,40486,20746,19740
50,12,105,Florida,Polk County,7,3,41274,21009,20265
50,12,105,Florida,Polk County,7,4,39780,20430,19350
50,12,105,Florida,Polk County,7,5,40920,20725,20195
50,12,105,Florida,Polk County,7,6,39359,19661,19698
50,12,105,Florida,Polk County,7,7,38387,18958,19429
50,12,105,Florida,Polk County,7,8,36047,17735,18312
50,12,105,Florida,Polk County,7,9,38632,19074,19558
50,12,105,Florida,Polk County,7,10,38555,19316,19239
50,12,105,Florida,Polk County,7,11,41343,20311,21032
50,12,105,Florida,Polk County,7,12,39854,19099,20755
50,12,105,Florida,Polk County,7,13,38115,17596,20519
50,12,105,Florida,Polk County,7,14,38290,17773,20517
50,12,105,Florida,Polk County,7,15,31952,14953,16999
50,12,105,Florida,Polk County,7,16,23931,11400,12531
50,12,105,Florida,Polk County,7,17,15710,7122,8588
50,12,105,Florida,Polk County,7,18,14213,5745,8468
50,12,105,Florida,Polk County,8,0,648523,317805,330718
50,12,105,Florida,Polk County,8,1,38176,19517,18659
50,12,105,Florida,Polk County,8,2,41200,21124,20076
50,12,105,Florida,Polk County,8,3,41707,21312,20395
50,12,105,Florida,Polk County,8,4,40805,20864,19941
50,12,105,Florida,Polk County,8,5,40472,20473,19999
50,12,105,Florida,Polk County,8,6,41764,20966,20798
50,12,105,Florida,Polk County,8,7,39326,19478,19848
50,12,105,Florida,Polk County,8,8,37439,18334,19105
50,12,105,Florida,Polk County,8,9,38558,18915,19643
50,12,105,Florida,Polk County,8,10,39040,19582,19458
50,12,105,Florida,Polk County,8,11,41605,20458,21147
50,12,105,Florida,Polk County,8,12,40890,19630,21260
50,12,105,Florida,Polk County,8,13,39028,18126,20902
50,12,105,Florida,Polk County,8,14,39741,18372,21369
50,12,105,Florida,Polk County,8,15,33229,15479,17750
50,12,105,Florida,Polk County,8,16,24631,11753,12878
50,12,105,Florida,Polk County,8,17,16241,7420,8821
50,12,105,Florida,Polk County,8,18,14671,6002,8669
50,12,105,Florida,Polk County,9,0,665823,326165,339658
50,12,105,Florida,Polk County,9,1,39085,19947,19138
50,12,105,Florida,Polk County,9,2,41551,21345,20206
50,12,105,Florida,Polk County,9,3,42605,21791,20814
50,12,105,Florida,Polk County,9,4,42119,21496,20623
50,12,105,Florida,Polk County,9,5,40366,20387,19979
50,12,105,Florida,Polk County,9,6,44366,22142,22224
50,12,105,Florida,Polk County,9,7,40603,20186,20417
50,12,105,Florida,Polk County,9,8,39382,19325,20057
50,12,105,Florida,Polk County,9,9,38374,18825,19549
50,12,105,Florida,Polk County,9,10,40347,20126,20221
50,12,105,Florida,Polk County,9,11,41446,20459,20987
50,12,105,Florida,Polk County,9,12,42044,20262,21782
50,12,105,Florida,Polk County,9,13,39939,18550,21389
50,12,105,Florida,Polk County,9,14,41646,19163,22483
50,12,105,Florida,Polk County,9,15,34312,15972,18340
50,12,105,Florida,Polk County,9,16,25626,12203,13423
50,12,105,Florida,Polk County,9,17,16928,7796,9132
50,12,105,Florida,Polk County,9,18,15084,6190,8894
50,12,105,Florida,Polk County,10,0,685368,335901,349467
50,12,105,Florida,Polk County,10,1,40148,20552,19596
50,12,105,Florida,Polk County,10,2,41905,21463,20442
50,12,105,Florida,Polk County,10,3,43980,22533,21447
50,12,105,Florida,Polk County,10,4,43394,22244,21150
50,12,105,Florida,Polk County,10,5,40969,20639,20330
50,12,105,Florida,Polk County,10,6,46413,23185,23228
50,12,105,Florida,Polk County,10,7,41892,20955,20937
50,12,105,Florida,Polk County,10,8,41291,20247,21044
50,12,105,Florida,Polk County,10,9,39202,19201,20001
50,12,105,Florida,Polk County,10,10,41503,20577,20926
50,12,105,Florida,Polk County,10,11,42005,20739,21266
50,12,105,Florida,Polk County,10,12,42786,20643,22143
50,12,105,Florida,Polk County,10,13,41554,19406,22148
50,12,105,Florida,Polk County,10,14,41064,18872,22192
50,12,105,Florida,Polk County,10,15,37099,17148,19951
50,12,105,Florida,Polk County,10,16,26859,12772,14087
50,12,105,Florida,Polk County,10,17,17662,8180,9482
50,12,105,Florida,Polk County,10,18,15642,6545,9097
50,12,105,Florida,Polk County,11,0,706597,346240,360357
50,12,105,Florida,Polk County,11,1,40976,20923,20053
50,12,105,Florida,Polk County,11,2,42705,21957,20748
50,12,105,Florida,Polk County,11,3,45488,23315,22173
50,12,105,Florida,Polk County,11,4,44399,22663,21736
50,12,105,Florida,Polk County,11,5,42103,21158,20945
50,12,105,Florida,Polk County,11,6,48390,24191,24199
50,12,105,Florida,Polk County,11,7,43972,22160,21812
50,12,105,Florida,Polk County,11,8,43483,21258,22225
50,12,105,Florida,Polk County,11,9,40467,19711,20756
50,12,105,Florida,Polk County,11,10,42821,21265,21556
50,12,105,Florida,Polk County,11,11,42250,20838,21412
50,12,105,Florida,Polk County,11,12,43670,21003,22667
50,12,105,Florida,Polk County,11,13,42707,20052,22655
50,12,105,Florida,Polk County,11,14,41513,19078,22435
50,12,105,Florida,Polk County,11,15,38520,17780,20740
50,12,105,Florida,Polk County,11,16,28399,13431,14968
50,12,105,Florida,Polk County,11,17,18509,8611,9898
50,12,105,Florida,Polk County,11,18,16225,6846,9379
50,12,105,Florida,Polk County,12,0,724777,355420,369357
50,12,105,Florida,Polk County,12,1,41558,21348,20210
50,12,105,Florida,Polk County,12,2,43897,22497,21400
50,12,105,Florida,Polk County,12,3,46240,23681,22559
50,12,105,Florida,Polk County,12,4,45178,23053,22125
50,12,105,Florida,Polk County,12,5,42932,21518,21414
50,12,105,Florida,Polk County,12,6,49189,24723,24466
50,12,105,Florida,Polk County,12,7,46434,23350,23084
50,12,105,Florida,Polk County,12,8,45148,22177,22971
50,12,105,Florida,Polk County,12,9,41985,20552,21433
50,12,105,Florida,Polk County,12,10,43326,21396,21930
50,12,105,Florida,Polk County,12,11,42158,20853,21305
50,12,105,Florida,Polk County,12,12,44899,21668,23231
50,12,105,Florida,Polk County,12,13,43665,20578,23087
50,12,105,Florida,Polk County,12,14,42476,19456,23020
50,12,105,Florida,Polk County,12,15,40057,18506,21551
50,12,105,Florida,Polk County,12,16,29586,13951,15635
50,12,105,Florida,Polk County,12,17,19300,9000,10300
50,12,105,Florida,Polk County,12,18,16749,7113,9636
50,12,107,Florida,Putnam County,1,0,74364,36884,37480
50,12,107,Florida,Putnam County,1,1,4689,2389,2300
50,12,107,Florida,Putnam County,1,2,4506,2292,2214
50,12,107,Florida,Putnam County,1,3,4675,2406,2269
50,12,107,Florida,Putnam County,1,4,4930,2631,2299
50,12,107,Florida,Putnam County,1,5,4046,2077,1969
50,12,107,Florida,Putnam County,1,6,3985,1981,2004
50,12,107,Florida,Putnam County,1,7,3762,1942,1820
50,12,107,Florida,Putnam County,1,8,3861,1901,1960
50,12,107,Florida,Putnam County,1,9,4126,2084,2042
50,12,107,Florida,Putnam County,1,10,5300,2571,2729
50,12,107,Florida,Putnam County,1,11,5714,2800,2914
50,12,107,Florida,Putnam County,1,12,5444,2640,2804
50,12,107,Florida,Putnam County,1,13,5256,2577,2679
50,12,107,Florida,Putnam County,1,14,4468,2156,2312
50,12,107,Florida,Putnam County,1,15,3497,1733,1764
50,12,107,Florida,Putnam County,1,16,2705,1307,1398
50,12,107,Florida,Putnam County,1,17,1932,849,1083
50,12,107,Florida,Putnam County,1,18,1468,548,920
50,12,107,Florida,Putnam County,2,0,74377,36891,37486
50,12,107,Florida,Putnam County,2,1,4690,2390,2300
50,12,107,Florida,Putnam County,2,2,4506,2292,2214
50,12,107,Florida,Putnam County,2,3,4676,2406,2270
50,12,107,Florida,Putnam County,2,4,4932,2632,2300
50,12,107,Florida,Putnam County,2,5,4047,2077,1970
50,12,107,Florida,Putnam County,2,6,3986,1982,2004
50,12,107,Florida,Putnam County,2,7,3764,1943,1821
50,12,107,Florida,Putnam County,2,8,3861,1901,1960
50,12,107,Florida,Putnam County,2,9,4128,2085,2043
50,12,107,Florida,Putnam County,2,10,5300,2571,2729
50,12,107,Florida,Putnam County,2,11,5715,2801,2914
50,12,107,Florida,Putnam County,2,12,5444,2640,2804
50,12,107,Florida,Putnam County,2,13,5258,2578,2680
50,12,107,Florida,Putnam County,2,14,4468,2156,2312
50,12,107,Florida,Putnam County,2,15,3496,1733,1763
50,12,107,Florida,Putnam County,2,16,2704,1306,1398
50,12,107,Florida,Putnam County,2,17,1933,850,1083
50,12,107,Florida,Putnam County,2,18,1469,548,921
50,12,107,Florida,Putnam County,3,0,74220,36793,37427
50,12,107,Florida,Putnam County,3,1,4658,2375,2283
50,12,107,Florida,Putnam County,3,2,4488,2275,2213
50,12,107,Florida,Putnam County,3,3,4655,2394,2261
50,12,107,Florida,Putnam County,3,4,4845,2578,2267
50,12,107,Florida,Putnam County,3,5,4089,2105,1984
50,12,107,Florida,Putnam County,3,6,3966,1975,1991
50,12,107,Florida,Putnam County,3,7,3779,1945,1834
50,12,107,Florida,Putnam County,3,8,3812,1880,1932
50,12,107,Florida,Putnam County,3,9,4115,2076,2039
50,12,107,Florida,Putnam County,3,10,5272,2561,2711
50,12,107,Florida,Putnam County,3,11,5699,2785,2914
50,12,107,Florida,Putnam County,3,12,5460,2643,2817
50,12,107,Florida,Putnam County,3,13,5314,2611,2703
50,12,107,Florida,Putnam County,3,14,4453,2154,2299
50,12,107,Florida,Putnam County,3,15,3495,1726,1769
50,12,107,Florida,Putnam County,3,16,2697,1301,1396
50,12,107,Florida,Putnam County,3,17,1933,849,1084
50,12,107,Florida,Putnam County,3,18,1490,560,930
50,12,107,Florida,Putnam County,4,0,73652,36459,37193
50,12,107,Florida,Putnam County,4,1,4562,2312,2250
50,12,107,Florida,Putnam County,4,2,4456,2241,2215
50,12,107,Florida,Putnam County,4,3,4604,2364,2240
50,12,107,Florida,Putnam County,4,4,4573,2393,2180
50,12,107,Florida,Putnam County,4,5,4260,2246,2014
50,12,107,Florida,Putnam County,4,6,3879,1928,1951
50,12,107,Florida,Putnam County,4,7,3801,1933,1868
50,12,107,Florida,Putnam County,4,8,3633,1839,1794
50,12,107,Florida,Putnam County,4,9,4002,1966,2036
50,12,107,Florida,Putnam County,4,10,5006,2440,2566
50,12,107,Florida,Putnam County,4,11,5624,2730,2894
50,12,107,Florida,Putnam County,4,12,5518,2692,2826
50,12,107,Florida,Putnam County,4,13,5481,2700,2781
50,12,107,Florida,Putnam County,4,14,4420,2148,2272
50,12,107,Florida,Putnam County,4,15,3583,1758,1825
50,12,107,Florida,Putnam County,4,16,2732,1301,1431
50,12,107,Florida,Putnam County,4,17,1955,870,1085
50,12,107,Florida,Putnam County,4,18,1563,598,965
50,12,107,Florida,Putnam County,5,0,72927,36059,36868
50,12,107,Florida,Putnam County,5,1,4429,2271,2158
50,12,107,Florida,Putnam County,5,2,4484,2255,2229
50,12,107,Florida,Putnam County,5,3,4478,2292,2186
50,12,107,Florida,Putnam County,5,4,4233,2199,2034
50,12,107,Florida,Putnam County,5,5,4331,2273,2058
50,12,107,Florida,Putnam County,5,6,3906,1977,1929
50,12,107,Florida,Putnam County,5,7,3798,1887,1911
50,12,107,Florida,Putnam County,5,8,3547,1799,1748
50,12,107,Florida,Putnam County,5,9,3912,1921,1991
50,12,107,Florida,Putnam County,5,10,4726,2320,2406
50,12,107,Florida,Putnam County,5,11,5529,2658,2871
50,12,107,Florida,Putnam County,5,12,5541,2678,2863
50,12,107,Florida,Putnam County,5,13,5369,2633,2736
50,12,107,Florida,Putnam County,5,14,4606,2252,2354
50,12,107,Florida,Putnam County,5,15,3708,1819,1889
50,12,107,Florida,Putnam County,5,16,2750,1299,1451
50,12,107,Florida,Putnam County,5,17,1956,887,1069
50,12,107,Florida,Putnam County,5,18,1624,639,985
50,12,107,Florida,Putnam County,6,0,72370,35765,36605
50,12,107,Florida,Putnam County,6,1,4226,2145,2081
50,12,107,Florida,Putnam County,6,2,4527,2303,2224
50,12,107,Florida,Putnam County,6,3,4438,2306,2132
50,12,107,Florida,Putnam County,6,4,4131,2115,2016
50,12,107,Florida,Putnam County,6,5,4396,2320,2076
50,12,107,Florida,Putnam County,6,6,3857,1963,1894
50,12,107,Florida,Putnam County,6,7,3742,1832,1910
50,12,107,Florida,Putnam County,6,8,3509,1789,1720
50,12,107,Florida,Putnam County,6,9,3904,1884,2020
50,12,107,Florida,Putnam County,6,10,4372,2197,2175
50,12,107,Florida,Putnam County,6,11,5491,2625,2866
50,12,107,Florida,Putnam County,6,12,5465,2634,2831
50,12,107,Florida,Putnam County,6,13,5417,2634,2783
50,12,107,Florida,Putnam County,6,14,4680,2285,2395
50,12,107,Florida,Putnam County,6,15,3794,1855,1939
50,12,107,Florida,Putnam County,6,16,2782,1299,1483
50,12,107,Florida,Putnam County,6,17,1978,918,1060
50,12,107,Florida,Putnam County,6,18,1661,661,1000
50,12,107,Florida,Putnam County,7,0,71971,35570,36401
50,12,107,Florida,Putnam County,7,1,4106,2090,2016
50,12,107,Florida,Putnam County,7,2,4477,2259,2218
50,12,107,Florida,Putnam County,7,3,4390,2287,2103
50,12,107,Florida,Putnam County,7,4,4030,2092,1938
50,12,107,Florida,Putnam County,7,5,4261,2254,2007
50,12,107,Florida,Putnam County,7,6,3904,1955,1949
50,12,107,Florida,Putnam County,7,7,3736,1826,1910
50,12,107,Florida,Putnam County,7,8,3531,1818,1713
50,12,107,Florida,Putnam County,7,9,3820,1838,1982
50,12,107,Florida,Putnam County,7,10,4162,2080,2082
50,12,107,Florida,Putnam County,7,11,5445,2639,2806
50,12,107,Florida,Putnam County,7,12,5498,2624,2874
50,12,107,Florida,Putnam County,7,13,5346,2578,2768
50,12,107,Florida,Putnam County,7,14,4904,2431,2473
50,12,107,Florida,Putnam County,7,15,3905,1888,2017
50,12,107,Florida,Putnam County,7,16,2798,1322,1476
50,12,107,Florida,Putnam County,7,17,1960,922,1038
50,12,107,Florida,Putnam County,7,18,1698,667,1031
50,12,107,Florida,Putnam County,8,0,71939,35524,36415
50,12,107,Florida,Putnam County,8,1,4148,2116,2032
50,12,107,Florida,Putnam County,8,2,4474,2284,2190
50,12,107,Florida,Putnam County,8,3,4312,2216,2096
50,12,107,Florida,Putnam County,8,4,4035,2074,1961
50,12,107,Florida,Putnam County,8,5,4053,2156,1897
50,12,107,Florida,Putnam County,8,6,4028,2035,1993
50,12,107,Florida,Putnam County,8,7,3701,1841,1860
50,12,107,Florida,Putnam County,8,8,3582,1801,1781
50,12,107,Florida,Putnam County,8,9,3679,1799,1880
50,12,107,Florida,Putnam County,8,10,4034,2009,2025
50,12,107,Florida,Putnam County,8,11,5295,2542,2753
50,12,107,Florida,Putnam County,8,12,5583,2710,2873
50,12,107,Florida,Putnam County,8,13,5386,2538,2848
50,12,107,Florida,Putnam County,8,14,5106,2539,2567
50,12,107,Florida,Putnam County,8,15,3991,1912,2079
50,12,107,Florida,Putnam County,8,16,2865,1377,1488
50,12,107,Florida,Putnam County,8,17,1952,904,1048
50,12,107,Florida,Putnam County,8,18,1715,671,1044
50,12,107,Florida,Putnam County,9,0,72373,35763,36610
50,12,107,Florida,Putnam County,9,1,4095,2108,1987
50,12,107,Florida,Putnam County,9,2,4455,2255,2200
50,12,107,Florida,Putnam County,9,3,4372,2255,2117
50,12,107,Florida,Putnam County,9,4,4098,2128,1970
50,12,107,Florida,Putnam County,9,5,3882,2034,1848
50,12,107,Florida,Putnam County,9,6,4230,2202,2028
50,12,107,Florida,Putnam County,9,7,3661,1784,1877
50,12,107,Florida,Putnam County,9,8,3656,1829,1827
50,12,107,Florida,Putnam County,9,9,3602,1780,1822
50,12,107,Florida,Putnam County,9,10,4058,1999,2059
50,12,107,Florida,Putnam County,9,11,5083,2456,2627
50,12,107,Florida,Putnam County,9,12,5665,2731,2934
50,12,107,Florida,Putnam County,9,13,5464,2586,2878
50,12,107,Florida,Putnam County,9,14,5361,2645,2716
50,12,107,Florida,Putnam County,9,15,4005,1942,2063
50,12,107,Florida,Putnam County,9,16,2959,1418,1541
50,12,107,Florida,Putnam County,9,17,1976,911,1065
50,12,107,Florida,Putnam County,9,18,1751,700,1051
50,12,107,Florida,Putnam County,10,0,73384,36313,37071
50,12,107,Florida,Putnam County,10,1,4252,2190,2062
50,12,107,Florida,Putnam County,10,2,4477,2280,2197
50,12,107,Florida,Putnam County,10,3,4497,2316,2181
50,12,107,Florida,Putnam County,10,4,4064,2115,1949
50,12,107,Florida,Putnam County,10,5,3819,1988,1831
50,12,107,Florida,Putnam County,10,6,4468,2289,2179
50,12,107,Florida,Putnam County,10,7,3705,1817,1888
50,12,107,Florida,Putnam County,10,8,3692,1838,1854
50,12,107,Florida,Putnam County,10,9,3528,1741,1787
50,12,107,Florida,Putnam County,10,10,4113,2020,2093
50,12,107,Florida,Putnam County,10,11,4875,2367,2508
50,12,107,Florida,Putnam County,10,12,5772,2786,2986
50,12,107,Florida,Putnam County,10,13,5549,2632,2917
50,12,107,Florida,Putnam County,10,14,5410,2674,2736
50,12,107,Florida,Putnam County,10,15,4228,2084,2144
50,12,107,Florida,Putnam County,10,16,3154,1526,1628
50,12,107,Florida,Putnam County,10,17,1954,896,1058
50,12,107,Florida,Putnam County,10,18,1827,754,1073
50,12,107,Florida,Putnam County,11,0,74043,36682,37361
50,12,107,Florida,Putnam County,11,1,4299,2225,2074
50,12,107,Florida,Putnam County,11,2,4353,2215,2138
50,12,107,Florida,Putnam County,11,3,4611,2364,2247
50,12,107,Florida,Putnam County,11,4,4064,2143,1921
50,12,107,Florida,Putnam County,11,5,3729,1940,1789
50,12,107,Florida,Putnam County,11,6,4512,2337,2175
50,12,107,Florida,Putnam County,11,7,3822,1888,1934
50,12,107,Florida,Putnam County,11,8,3775,1849,1926
50,12,107,Florida,Putnam County,11,9,3557,1773,1784
50,12,107,Florida,Putnam County,11,10,4145,2013,2132
50,12,107,Florida,Putnam County,11,11,4628,2282,2346
50,12,107,Florida,Putnam County,11,12,5802,2758,3044
50,12,107,Florida,Putnam County,11,13,5616,2681,2935
50,12,107,Florida,Putnam County,11,14,5517,2732,2785
50,12,107,Florida,Putnam County,11,15,4413,2183,2230
50,12,107,Florida,Putnam County,11,16,3344,1604,1740
50,12,107,Florida,Putnam County,11,17,1989,917,1072
50,12,107,Florida,Putnam County,11,18,1867,778,1089
50,12,107,Florida,Putnam County,12,0,74521,36909,37612
50,12,107,Florida,Putnam County,12,1,4259,2191,2068
50,12,107,Florida,Putnam County,12,2,4328,2221,2107
50,12,107,Florida,Putnam County,12,3,4613,2357,2256
50,12,107,Florida,Putnam County,12,4,4017,2123,1894
50,12,107,Florida,Putnam County,12,5,3791,1963,1828
50,12,107,Florida,Putnam County,12,6,4507,2340,2167
50,12,107,Florida,Putnam County,12,7,3929,1934,1995
50,12,107,Florida,Putnam County,12,8,3782,1841,1941
50,12,107,Florida,Putnam County,12,9,3625,1813,1812
50,12,107,Florida,Putnam County,12,10,4061,1945,2116
50,12,107,Florida,Putnam County,12,11,4401,2205,2196
50,12,107,Florida,Putnam County,12,12,5828,2766,3062
50,12,107,Florida,Putnam County,12,13,5705,2707,2998
50,12,107,Florida,Putnam County,12,14,5575,2756,2819
50,12,107,Florida,Putnam County,12,15,4693,2348,2345
50,12,107,Florida,Putnam County,12,16,3462,1638,1824
50,12,107,Florida,Putnam County,12,17,2095,987,1108
50,12,107,Florida,Putnam County,12,18,1850,774,1076
50,12,109,Florida,St. Johns County,1,0,190039,92425,97614
50,12,109,Florida,St. Johns County,1,1,10106,5084,5022
50,12,109,Florida,St. Johns County,1,2,12371,6346,6025
50,12,109,Florida,St. Johns County,1,3,13207,6724,6483
50,12,109,Florida,St. Johns County,1,4,12944,6730,6214
50,12,109,Florida,St. Johns County,1,5,9871,4873,4998
50,12,109,Florida,St. Johns County,1,6,9187,4443,4744
50,12,109,Florida,St. Johns County,1,7,9416,4524,4892
50,12,109,Florida,St. Johns County,1,8,11959,5760,6199
50,12,109,Florida,St. Johns County,1,9,13742,6682,7060
50,12,109,Florida,St. Johns County,1,10,15707,7476,8231
50,12,109,Florida,St. Johns County,1,11,15067,7275,7792
50,12,109,Florida,St. Johns County,1,12,13601,6507,7094
50,12,109,Florida,St. Johns County,1,13,13068,6362,6706
50,12,109,Florida,St. Johns County,1,14,9876,4792,5084
50,12,109,Florida,St. Johns County,1,15,6832,3246,3586
50,12,109,Florida,St. Johns County,1,16,5259,2471,2788
50,12,109,Florida,St. Johns County,1,17,4149,1780,2369
50,12,109,Florida,St. Johns County,1,18,3677,1350,2327
50,12,109,Florida,St. Johns County,2,0,190038,92424,97614
50,12,109,Florida,St. Johns County,2,1,10106,5084,5022
50,12,109,Florida,St. Johns County,2,2,12371,6346,6025
50,12,109,Florida,St. Johns County,2,3,13207,6724,6483
50,12,109,Florida,St. Johns County,2,4,12944,6730,6214
50,12,109,Florida,St. Johns County,2,5,9870,4872,4998
50,12,109,Florida,St. Johns County,2,6,9187,4443,4744
50,12,109,Florida,St. Johns County,2,7,9416,4524,4892
50,12,109,Florida,St. Johns County,2,8,11959,5760,6199
50,12,109,Florida,St. Johns County,2,9,13742,6682,7060
50,12,109,Florida,St. Johns County,2,10,15707,7476,8231
50,12,109,Florida,St. Johns County,2,11,15067,7275,7792
50,12,109,Florida,St. Johns County,2,12,13601,6507,7094
50,12,109,Florida,St. Johns County,2,13,13068,6362,6706
50,12,109,Florida,St. Johns County,2,14,9876,4792,5084
50,12,109,Florida,St. Johns County,2,15,6832,3246,3586
50,12,109,Florida,St. Johns County,2,16,5259,2471,2788
50,12,109,Florida,St. Johns County,2,17,4149,1780,2369
50,12,109,Florida,St. Johns County,2,18,3677,1350,2327
50,12,109,Florida,St. Johns County,3,0,191249,93003,98246
50,12,109,Florida,St. Johns County,3,1,10080,5062,5018
50,12,109,Florida,St. Johns County,3,2,12382,6349,6033
50,12,109,Florida,St. Johns County,3,3,13279,6757,6522
50,12,109,Florida,St. Johns County,3,4,13021,6766,6255
50,12,109,Florida,St. Johns County,3,5,9975,4942,5033
50,12,109,Florida,St. Johns County,3,6,9307,4503,4804
50,12,109,Florida,St. Johns County,3,7,9523,4577,4946
50,12,109,Florida,St. Johns County,3,8,11877,5728,6149
50,12,109,Florida,St. Johns County,3,9,13820,6721,7099
50,12,109,Florida,St. Johns County,3,10,15699,7471,8228
50,12,109,Florida,St. Johns County,3,11,15196,7331,7865
50,12,109,Florida,St. Johns County,3,12,13715,6553,7162
50,12,109,Florida,St. Johns County,3,13,13228,6435,6793
50,12,109,Florida,St. Johns County,3,14,10009,4865,5144
50,12,109,Florida,St. Johns County,3,15,6940,3295,3645
50,12,109,Florida,St. Johns County,3,16,5280,2477,2803
50,12,109,Florida,St. Johns County,3,17,4182,1800,2382
50,12,109,Florida,St. Johns County,3,18,3736,1371,2365
50,12,109,Florida,St. Johns County,4,0,196106,95421,100685
50,12,109,Florida,St. Johns County,4,1,10061,5112,4949
50,12,109,Florida,St. Johns County,4,2,12430,6354,6076
50,12,109,Florida,St. Johns County,4,3,13625,6895,6730
50,12,109,Florida,St. Johns County,4,4,13312,6904,6408
50,12,109,Florida,St. Johns County,4,5,10254,5123,5131
50,12,109,Florida,St. Johns County,4,6,9587,4665,4922
50,12,109,Florida,St. Johns County,4,7,9925,4755,5170
50,12,109,Florida,St. Johns County,4,8,11513,5563,5950
50,12,109,Florida,St. Johns County,4,9,14175,6923,7252
50,12,109,Florida,St. Johns County,4,10,15632,7452,8180
50,12,109,Florida,St. Johns County,4,11,15745,7579,8166
50,12,109,Florida,St. Johns County,4,12,14089,6672,7417
50,12,109,Florida,St. Johns County,4,13,13959,6742,7217
50,12,109,Florida,St. Johns County,4,14,10613,5164,5449
50,12,109,Florida,St. Johns County,4,15,7449,3567,3882
50,12,109,Florida,St. Johns County,4,16,5448,2573,2875
50,12,109,Florida,St. Johns County,4,17,4285,1879,2406
50,12,109,Florida,St. Johns County,4,18,4004,1499,2505
50,12,109,Florida,St. Johns County,5,0,202066,98341,103725
50,12,109,Florida,St. Johns County,5,1,10096,5140,4956
50,12,109,Florida,St. Johns County,5,2,12589,6427,6162
50,12,109,Florida,St. Johns County,5,3,13855,7005,6850
50,12,109,Florida,St. Johns County,5,4,13685,7071,6614
50,12,109,Florida,St. Johns County,5,5,10735,5436,5299
50,12,109,Florida,St. Johns County,5,6,9902,4841,5061
50,12,109,Florida,St. Johns County,5,7,10413,5031,5382
50,12,109,Florida,St. Johns County,5,8,11452,5581,5871
50,12,109,Florida,St. Johns County,5,9,14391,6943,7448
50,12,109,Florida,St. Johns County,5,10,15654,7458,8196
50,12,109,Florida,St. Johns County,5,11,16258,7807,8451
50,12,109,Florida,St. Johns County,5,12,14676,6914,7762
50,12,109,Florida,St. Johns County,5,13,14008,6776,7232
50,12,109,Florida,St. Johns County,5,14,11928,5772,6156
50,12,109,Florida,St. Johns County,5,15,8117,3919,4198
50,12,109,Florida,St. Johns County,5,16,5640,2641,2999
50,12,109,Florida,St. Johns County,5,17,4395,1954,2441
50,12,109,Florida,St. Johns County,5,18,4272,1625,2647
50,12,109,Florida,St. Johns County,6,0,209439,101932,107507
50,12,109,Florida,St. Johns County,6,1,10500,5319,5181
50,12,109,Florida,St. Johns County,6,2,12917,6598,6319
50,12,109,Florida,St. Johns County,6,3,14348,7238,7110
50,12,109,Florida,St. Johns County,6,4,13926,7196,6730
50,12,109,Florida,St. Johns County,6,5,11067,5625,5442
50,12,109,Florida,St. Johns County,6,6,10229,4998,5231
50,12,109,Florida,St. Johns County,6,7,11001,5260,5741
50,12,109,Florida,St. Johns County,6,8,11906,5847,6059
50,12,109,Florida,St. Johns County,6,9,14779,7137,7642
50,12,109,Florida,St. Johns County,6,10,15618,7511,8107
50,12,109,Florida,St. Johns County,6,11,16509,7863,8646
50,12,109,Florida,St. Johns County,6,12,15409,7333,8076
50,12,109,Florida,St. Johns County,6,13,14478,6892,7586
50,12,109,Florida,St. Johns County,6,14,12824,6201,6623
50,12,109,Florida,St. Johns County,6,15,9025,4397,4628
50,12,109,Florida,St. Johns County,6,16,5972,2791,3181
50,12,109,Florida,St. Johns County,6,17,4442,2012,2430
50,12,109,Florida,St. Johns County,6,18,4489,1714,2775
50,12,109,Florida,St. Johns County,7,0,217836,106118,111718
50,12,109,Florida,St. Johns County,7,1,10991,5564,5427
50,12,109,Florida,St. Johns County,7,2,13295,6738,6557
50,12,109,Florida,St. Johns County,7,3,14729,7464,7265
50,12,109,Florida,St. Johns County,7,4,14241,7372,6869
50,12,109,Florida,St. Johns County,7,5,11425,5820,5605
50,12,109,Florida,St. Johns County,7,6,10764,5261,5503
50,12,109,Florida,St. Johns County,7,7,11690,5611,6079
50,12,109,Florida,St. Johns County,7,8,12602,6129,6473
50,12,109,Florida,St. Johns County,7,9,15088,7370,7718
50,12,109,Florida,St. Johns County,7,10,15658,7573,8085
50,12,109,Florida,St. Johns County,7,11,17090,8152,8938
50,12,109,Florida,St. Johns County,7,12,15921,7689,8232
50,12,109,Florida,St. Johns County,7,13,14972,7032,7940
50,12,109,Florida,St. Johns County,7,14,14006,6758,7248
50,12,109,Florida,St. Johns County,7,15,9905,4832,5073
50,12,109,Florida,St. Johns County,7,16,6319,2954,3365
50,12,109,Florida,St. Johns County,7,17,4443,2032,2411
50,12,109,Florida,St. Johns County,7,18,4697,1767,2930
50,12,109,Florida,St. Johns County,8,0,226362,110436,115926
50,12,109,Florida,St. Johns County,8,1,11559,5925,5634
50,12,109,Florida,St. Johns County,8,2,13634,6947,6687
50,12,109,Florida,St. Johns County,8,3,15244,7734,7510
50,12,109,Florida,St. Johns County,8,4,14648,7593,7055
50,12,109,Florida,St. Johns County,8,5,11482,5869,5613
50,12,109,Florida,St. Johns County,8,6,11093,5451,5642
50,12,109,Florida,St. Johns County,8,7,12216,5864,6352
50,12,109,Florida,St. Johns County,8,8,13441,6556,6885
50,12,109,Florida,St. Johns County,8,9,15362,7550,7812
50,12,109,Florida,St. Johns County,8,10,16084,7833,8251
50,12,109,Florida,St. Johns County,8,11,17421,8284,9137
50,12,109,Florida,St. Johns County,8,12,16591,7987,8604
50,12,109,Florida,St. Johns County,8,13,15542,7246,8296
50,12,109,Florida,St. Johns County,8,14,15137,7263,7874
50,12,109,Florida,St. Johns County,8,15,10700,5204,5496
50,12,109,Florida,St. Johns County,8,16,6770,3178,3592
50,12,109,Florida,St. Johns County,8,17,4577,2093,2484
50,12,109,Florida,St. Johns County,8,18,4861,1859,3002
50,12,109,Florida,St. Johns County,9,0,234828,114551,120277
50,12,109,Florida,St. Johns County,9,1,11984,6174,5810
50,12,109,Florida,St. Johns County,9,2,14104,7207,6897
50,12,109,Florida,St. Johns County,9,3,15749,8035,7714
50,12,109,Florida,St. Johns County,9,4,15037,7718,7319
50,12,109,Florida,St. Johns County,9,5,11596,5941,5655
50,12,109,Florida,St. Johns County,9,6,11185,5546,5639
50,12,109,Florida,St. Johns County,9,7,12601,6068,6533
50,12,109,Florida,St. Johns County,9,8,14436,6920,7516
50,12,109,Florida,St. Johns County,9,9,15269,7534,7735
50,12,109,Florida,St. Johns County,9,10,16906,8326,8580
50,12,109,Florida,St. Johns County,9,11,17332,8296,9036
50,12,109,Florida,St. Johns County,9,12,17421,8337,9084
50,12,109,Florida,St. Johns County,9,13,16102,7444,8658
50,12,109,Florida,St. Johns County,9,14,16377,7829,8548
50,12,109,Florida,St. Johns County,9,15,11490,5524,5966
50,12,109,Florida,St. Johns County,9,16,7333,3450,3883
50,12,109,Florida,St. Johns County,9,17,4770,2201,2569
50,12,109,Florida,St. Johns County,9,18,5136,2001,3135
50,12,109,Florida,St. Johns County,10,0,243693,118732,124961
50,12,109,Florida,St. Johns County,10,1,12244,6220,6024
50,12,109,Florida,St. Johns County,10,2,14605,7449,7156
50,12,109,Florida,St. Johns County,10,3,16395,8309,8086
50,12,109,Florida,St. Johns County,10,4,15597,7973,7624
50,12,109,Florida,St. Johns County,10,5,11744,6044,5700
50,12,109,Florida,St. Johns County,10,6,11198,5574,5624
50,12,109,Florida,St. Johns County,10,7,12888,6198,6690
50,12,109,Florida,St. Johns County,10,8,15349,7401,7948
50,12,109,Florida,St. Johns County,10,9,15654,7715,7939
50,12,109,Florida,St. Johns County,10,10,17537,8620,8917
50,12,109,Florida,St. Johns County,10,11,17500,8468,9032
50,12,109,Florida,St. Johns County,10,12,18026,8583,9443
50,12,109,Florida,St. Johns County,10,13,16876,7827,9049
50,12,109,Florida,St. Johns County,10,14,16542,7865,8677
50,12,109,Florida,St. Johns County,10,15,13128,6291,6837
50,12,109,Florida,St. Johns County,10,16,8073,3827,4246
50,12,109,Florida,St. Johns County,10,17,5024,2285,2739
50,12,109,Florida,St. Johns County,10,18,5313,2083,3230
50,12,109,Florida,St. Johns County,11,0,253814,123710,130104
50,12,109,Florida,St. Johns County,11,1,12649,6457,6192
50,12,109,Florida,St. Johns County,11,2,15215,7735,7480
50,12,109,Florida,St. Johns County,11,3,17209,8700,8509
50,12,109,Florida,St. Johns County,11,4,16228,8327,7901
50,12,109,Florida,St. Johns County,11,5,11711,6052,5659
50,12,109,Florida,St. Johns County,11,6,11425,5712,5713
50,12,109,Florida,St. Johns County,11,7,13215,6327,6888
50,12,109,Florida,St. Johns County,11,8,16180,7759,8421
50,12,109,Florida,St. Johns County,11,9,16591,8176,8415
50,12,109,Florida,St. Johns County,11,10,18206,8994,9212
50,12,109,Florida,St. Johns County,11,11,17618,8601,9017
50,12,109,Florida,St. Johns County,11,12,18544,8792,9752
50,12,109,Florida,St. Johns County,11,13,17767,8299,9468
50,12,109,Florida,St. Johns County,11,14,17012,7964,9048
50,12,109,Florida,St. Johns County,11,15,14259,6881,7378
50,12,109,Florida,St. Johns County,11,16,9145,4322,4823
50,12,109,Florida,St. Johns County,11,17,5301,2418,2883
50,12,109,Florida,St. Johns County,11,18,5539,2194,3345
50,12,109,Florida,St. Johns County,12,0,264672,128943,135729
50,12,109,Florida,St. Johns County,12,1,12891,6588,6303
50,12,109,Florida,St. Johns County,12,2,16014,8065,7949
50,12,109,Florida,St. Johns County,12,3,17724,9025,8699
50,12,109,Florida,St. Johns County,12,4,16748,8603,8145
50,12,109,Florida,St. Johns County,12,5,12204,6251,5953
50,12,109,Florida,St. Johns County,12,6,11428,5722,5706
50,12,109,Florida,St. Johns County,12,7,13875,6639,7236
50,12,109,Florida,St. Johns County,12,8,17032,8122,8910
50,12,109,Florida,St. Johns County,12,9,17740,8708,9032
50,12,109,Florida,St. Johns County,12,10,18656,9265,9391
50,12,109,Florida,St. Johns County,12,11,17896,8764,9132
50,12,109,Florida,St. Johns County,12,12,19279,9171,10108
50,12,109,Florida,St. Johns County,12,13,18531,8723,9808
50,12,109,Florida,St. Johns County,12,14,17647,8157,9490
50,12,109,Florida,St. Johns County,12,15,15415,7450,7965
50,12,109,Florida,St. Johns County,12,16,10161,4772,5389
50,12,109,Florida,St. Johns County,12,17,5669,2593,3076
50,12,109,Florida,St. Johns County,12,18,5762,2325,3437
50,12,111,Florida,St. Lucie County,1,0,277789,135859,141930
50,12,111,Florida,St. Lucie County,1,1,16418,8403,8015
50,12,111,Florida,St. Lucie County,1,2,16964,8773,8191
50,12,111,Florida,St. Lucie County,1,3,17757,8998,8759
50,12,111,Florida,St. Lucie County,1,4,17656,9129,8527
50,12,111,Florida,St. Lucie County,1,5,14680,7437,7243
50,12,111,Florida,St. Lucie County,1,6,14812,7312,7500
50,12,111,Florida,St. Lucie County,1,7,15298,7512,7786
50,12,111,Florida,St. Lucie County,1,8,16749,8096,8653
50,12,111,Florida,St. Lucie County,1,9,17868,8894,8974
50,12,111,Florida,St. Lucie County,1,10,19885,9822,10063
50,12,111,Florida,St. Lucie County,1,11,19380,9436,9944
50,12,111,Florida,St. Lucie County,1,12,17371,8239,9132
50,12,111,Florida,St. Lucie County,1,13,17573,8308,9265
50,12,111,Florida,St. Lucie County,1,14,15865,7380,8485
50,12,111,Florida,St. Lucie County,1,15,13530,6493,7037
50,12,111,Florida,St. Lucie County,1,16,11135,5243,5892
50,12,111,Florida,St. Lucie County,1,17,8249,3797,4452
50,12,111,Florida,St. Lucie County,1,18,6599,2587,4012
50,12,111,Florida,St. Lucie County,2,0,277255,135585,141670
50,12,111,Florida,St. Lucie County,2,1,16402,8395,8007
50,12,111,Florida,St. Lucie County,2,2,16947,8765,8182
50,12,111,Florida,St. Lucie County,2,3,17718,8973,8745
50,12,111,Florida,St. Lucie County,2,4,17616,9104,8512
50,12,111,Florida,St. Lucie County,2,5,14659,7425,7234
50,12,111,Florida,St. Lucie County,2,6,14799,7305,7494
50,12,111,Florida,St. Lucie County,2,7,15288,7507,7781
50,12,111,Florida,St. Lucie County,2,8,16733,8089,8644
50,12,111,Florida,St. Lucie County,2,9,17822,8874,8948
50,12,111,Florida,St. Lucie County,2,10,19836,9799,10037
50,12,111,Florida,St. Lucie County,2,11,19333,9413,9920
50,12,111,Florida,St. Lucie County,2,12,17314,8212,9102
50,12,111,Florida,St. Lucie County,2,13,17523,8279,9244
50,12,111,Florida,St. Lucie County,2,14,15828,7361,8467
50,12,111,Florida,St. Lucie County,2,15,13499,6474,7025
50,12,111,Florida,St. Lucie County,2,16,11116,5236,5880
50,12,111,Florida,St. Lucie County,2,17,8232,3790,4442
50,12,111,Florida,St. Lucie County,2,18,6590,2584,4006
50,12,111,Florida,St. Lucie County,3,0,278264,136038,142226
50,12,111,Florida,St. Lucie County,3,1,16314,8331,7983
50,12,111,Florida,St. Lucie County,3,2,16941,8761,8180
50,12,111,Florida,St. Lucie County,3,3,17794,9017,8777
50,12,111,Florida,St. Lucie County,3,4,17489,9042,8447
50,12,111,Florida,St. Lucie County,3,5,14870,7522,7348
50,12,111,Florida,St. Lucie County,3,6,14899,7366,7533
50,12,111,Florida,St. Lucie County,3,7,15377,7562,7815
50,12,111,Florida,St. Lucie County,3,8,16642,8041,8601
50,12,111,Florida,St. Lucie County,3,9,17858,8888,8970
50,12,111,Florida,St. Lucie County,3,10,19835,9787,10048
50,12,111,Florida,St. Lucie County,3,11,19463,9478,9985
50,12,111,Florida,St. Lucie County,3,12,17474,8297,9177
50,12,111,Florida,St. Lucie County,3,13,17646,8312,9334
50,12,111,Florida,St. Lucie County,3,14,15951,7426,8525
50,12,111,Florida,St. Lucie County,3,15,13573,6491,7082
50,12,111,Florida,St. Lucie County,3,16,11131,5248,5883
50,12,111,Florida,St. Lucie County,3,17,8323,3847,4476
50,12,111,Florida,St. Lucie County,3,18,6684,2622,4062
50,12,111,Florida,St. Lucie County,4,0,280416,136929,143487
50,12,111,Florida,St. Lucie County,4,1,15981,8143,7838
50,12,111,Florida,St. Lucie County,4,2,16870,8762,8108
50,12,111,Florida,St. Lucie County,4,3,17866,9069,8797
50,12,111,Florida,St. Lucie County,4,4,16881,8746,8135
50,12,111,Florida,St. Lucie County,4,5,15551,7889,7662
50,12,111,Florida,St. Lucie County,4,6,15044,7428,7616
50,12,111,Florida,St. Lucie County,4,7,15618,7637,7981
50,12,111,Florida,St. Lucie County,4,8,16063,7714,8349
50,12,111,Florida,St. Lucie County,4,9,17809,8805,9004
50,12,111,Florida,St. Lucie County,4,10,19410,9501,9909
50,12,111,Florida,St. Lucie County,4,11,19797,9627,10170
50,12,111,Florida,St. Lucie County,4,12,18018,8615,9403
50,12,111,Florida,St. Lucie County,4,13,18149,8478,9671
50,12,111,Florida,St. Lucie County,4,14,16427,7722,8705
50,12,111,Florida,St. Lucie County,4,15,13944,6594,7350
50,12,111,Florida,St. Lucie County,4,16,11282,5342,5940
50,12,111,Florida,St. Lucie County,4,17,8687,4046,4641
50,12,111,Florida,St. Lucie County,4,18,7019,2811,4208
50,12,111,Florida,St. Lucie County,5,0,282931,138175,144756
50,12,111,Florida,St. Lucie County,5,1,15685,7967,7718
50,12,111,Florida,St. Lucie County,5,2,17067,8848,8219
50,12,111,Florida,St. Lucie County,5,3,17644,9044,8600
50,12,111,Florida,St. Lucie County,5,4,17027,8795,8232
50,12,111,Florida,St. Lucie County,5,5,15939,8041,7898
50,12,111,Florida,St. Lucie County,5,6,15226,7603,7623
50,12,111,Florida,St. Lucie County,5,7,15481,7511,7970
50,12,111,Florida,St. Lucie County,5,8,15751,7553,8198
50,12,111,Florida,St. Lucie County,5,9,17638,8665,8973
50,12,111,Florida,St. Lucie County,5,10,19124,9332,9792
50,12,111,Florida,St. Lucie County,5,11,19830,9663,10167
50,12,111,Florida,St. Lucie County,5,12,18696,8910,9786
50,12,111,Florida,St. Lucie County,5,13,17700,8292,9408
50,12,111,Florida,St. Lucie County,5,14,17721,8443,9278
50,12,111,Florida,St. Lucie County,5,15,14552,6864,7688
50,12,111,Florida,St. Lucie County,5,16,11541,5526,6015
50,12,111,Florida,St. Lucie County,5,17,8851,4111,4740
50,12,111,Florida,St. Lucie County,5,18,7458,3007,4451
50,12,111,Florida,St. Lucie County,6,0,285299,139409,145890
50,12,111,Florida,St. Lucie County,6,1,15234,7814,7420
50,12,111,Florida,St. Lucie County,6,2,16964,8783,8181
50,12,111,Florida,St. Lucie County,6,3,17501,9036,8465
50,12,111,Florida,St. Lucie County,6,4,16951,8721,8230
50,12,111,Florida,St. Lucie County,6,5,16203,8238,7965
50,12,111,Florida,St. Lucie County,6,6,15397,7739,7658
50,12,111,Florida,St. Lucie County,6,7,15454,7527,7927
50,12,111,Florida,St. Lucie County,6,8,15528,7425,8103
50,12,111,Florida,St. Lucie County,6,9,17523,8512,9011
50,12,111,Florida,St. Lucie County,6,10,18699,9214,9485
50,12,111,Florida,St. Lucie County,6,11,19960,9626,10334
50,12,111,Florida,St. Lucie County,6,12,19486,9295,10191
50,12,111,Florida,St. Lucie County,6,13,17895,8379,9516
50,12,111,Florida,St. Lucie County,6,14,18272,8631,9641
50,12,111,Florida,St. Lucie County,6,15,15527,7375,8152
50,12,111,Florida,St. Lucie County,6,16,11853,5652,6201
50,12,111,Florida,St. Lucie County,6,17,9021,4228,4793
50,12,111,Florida,St. Lucie County,6,18,7831,3214,4617
50,12,111,Florida,St. Lucie County,7,0,290045,141838,148207
50,12,111,Florida,St. Lucie County,7,1,15310,7905,7405
50,12,111,Florida,St. Lucie County,7,2,16826,8656,8170
50,12,111,Florida,St. Lucie County,7,3,17499,9130,8369
50,12,111,Florida,St. Lucie County,7,4,17038,8777,8261
50,12,111,Florida,St. Lucie County,7,5,16366,8459,7907
50,12,111,Florida,St. Lucie County,7,6,15936,8040,7896
50,12,111,Florida,St. Lucie County,7,7,15692,7535,8157
50,12,111,Florida,St. Lucie County,7,8,15729,7626,8103
50,12,111,Florida,St. Lucie County,7,9,17218,8267,8951
50,12,111,Florida,St. Lucie County,7,10,18403,9076,9327
50,12,111,Florida,St. Lucie County,7,11,20412,9880,10532
50,12,111,Florida,St. Lucie County,7,12,20078,9525,10553
50,12,111,Florida,St. Lucie County,7,13,18450,8671,9779
50,12,111,Florida,St. Lucie County,7,14,19344,9094,10250
50,12,111,Florida,St. Lucie County,7,15,16081,7577,8504
50,12,111,Florida,St. Lucie County,7,16,12346,5905,6441
50,12,111,Florida,St. Lucie County,7,17,9121,4279,4842
50,12,111,Florida,St. Lucie County,7,18,8196,3436,4760
50,12,111,Florida,St. Lucie County,8,0,297282,145198,152084
50,12,111,Florida,St. Lucie County,8,1,15630,8092,7538
50,12,111,Florida,St. Lucie County,8,2,16742,8517,8225
50,12,111,Florida,St. Lucie County,8,3,17563,9106,8457
50,12,111,Florida,St. Lucie County,8,4,17259,8891,8368
50,12,111,Florida,St. Lucie County,8,5,16372,8457,7915
50,12,111,Florida,St. Lucie County,8,6,17049,8566,8483
50,12,111,Florida,St. Lucie County,8,7,15965,7768,8197
50,12,111,Florida,St. Lucie County,8,8,16222,7901,8321
50,12,111,Florida,St. Lucie County,8,9,17086,8129,8957
50,12,111,Florida,St. Lucie County,8,10,18417,9049,9368
50,12,111,Florida,St. Lucie County,8,11,20704,10027,10677
50,12,111,Florida,St. Lucie County,8,12,20701,9839,10862
50,12,111,Florida,St. Lucie County,8,13,19579,9144,10435
50,12,111,Florida,St. Lucie County,8,14,20361,9600,10761
50,12,111,Florida,St. Lucie County,8,15,16727,7859,8868
50,12,111,Florida,St. Lucie County,8,16,12994,6241,6753
50,12,111,Florida,St. Lucie County,8,17,9262,4317,4945
50,12,111,Florida,St. Lucie County,8,18,8649,3695,4954
50,12,111,Florida,St. Lucie County,9,0,305566,149291,156275
50,12,111,Florida,St. Lucie County,9,1,16041,8369,7672
50,12,111,Florida,St. Lucie County,9,2,16928,8548,8380
50,12,111,Florida,St. Lucie County,9,3,17582,9169,8413
50,12,111,Florida,St. Lucie County,9,4,17633,9106,8527
50,12,111,Florida,St. Lucie County,9,5,16324,8477,7847
50,12,111,Florida,St. Lucie County,9,6,17971,9019,8952
50,12,111,Florida,St. Lucie County,9,7,16556,8122,8434
50,12,111,Florida,St. Lucie County,9,8,16725,8180,8545
50,12,111,Florida,St. Lucie County,9,9,16872,8073,8799
50,12,111,Florida,St. Lucie County,9,10,18715,9095,9620
50,12,111,Florida,St. Lucie County,9,11,20913,10083,10830
50,12,111,Florida,St. Lucie County,9,12,21722,10310,11412
50,12,111,Florida,St. Lucie County,9,13,20477,9616,10861
50,12,111,Florida,St. Lucie County,9,14,21430,9986,11444
50,12,111,Florida,St. Lucie County,9,15,17565,8359,9206
50,12,111,Florida,St. Lucie County,9,16,13512,6419,7093
50,12,111,Florida,St. Lucie County,9,17,9510,4485,5025
50,12,111,Florida,St. Lucie County,9,18,9090,3875,5215
50,12,111,Florida,St. Lucie County,10,0,313163,152888,160275
50,12,111,Florida,St. Lucie County,10,1,16190,8433,7757
50,12,111,Florida,St. Lucie County,10,2,17137,8619,8518
50,12,111,Florida,St. Lucie County,10,3,18130,9406,8724
50,12,111,Florida,St. Lucie County,10,4,17573,9150,8423
50,12,111,Florida,St. Lucie County,10,5,16387,8385,8002
50,12,111,Florida,St. Lucie County,10,6,18597,9386,9211
50,12,111,Florida,St. Lucie County,10,7,17116,8441,8675
50,12,111,Florida,St. Lucie County,10,8,17228,8466,8762
50,12,111,Florida,St. Lucie County,10,9,16997,8171,8826
50,12,111,Florida,St. Lucie County,10,10,19027,9200,9827
50,12,111,Florida,St. Lucie County,10,11,20771,9979,10792
50,12,111,Florida,St. Lucie County,10,12,22181,10462,11719
50,12,111,Florida,St. Lucie County,10,13,21497,10136,11361
50,12,111,Florida,St. Lucie County,10,14,21496,9932,11564
50,12,111,Florida,St. Lucie County,10,15,19270,9249,10021
50,12,111,Florida,St. Lucie County,10,16,14275,6737,7538
50,12,111,Florida,St. Lucie County,10,17,9759,4667,5092
50,12,111,Florida,St. Lucie County,10,18,9532,4069,5463
50,12,111,Florida,St. Lucie County,11,0,320425,156394,164031
50,12,111,Florida,St. Lucie County,11,1,16283,8420,7863
50,12,111,Florida,St. Lucie County,11,2,17182,8747,8435
50,12,111,Florida,St. Lucie County,11,3,18666,9597,9069
50,12,111,Florida,St. Lucie County,11,4,17558,9248,8310
50,12,111,Florida,St. Lucie County,11,5,16416,8375,8041
50,12,111,Florida,St. Lucie County,11,6,19032,9604,9428
50,12,111,Florida,St. Lucie County,11,7,17603,8743,8860
50,12,111,Florida,St. Lucie County,11,8,17800,8688,9112
50,12,111,Florida,St. Lucie County,11,9,17382,8405,8977
50,12,111,Florida,St. Lucie County,11,10,19116,9190,9926
50,12,111,Florida,St. Lucie County,11,11,20746,9994,10752
50,12,111,Florida,St. Lucie County,11,12,22635,10678,11957
50,12,111,Florida,St. Lucie County,11,13,22442,10592,11850
50,12,111,Florida,St. Lucie County,11,14,21879,10094,11785
50,12,111,Florida,St. Lucie County,11,15,20284,9686,10598
50,12,111,Florida,St. Lucie County,11,16,15465,7294,8171
50,12,111,Florida,St. Lucie County,11,17,10075,4782,5293
50,12,111,Florida,St. Lucie County,11,18,9861,4257,5604
50,12,111,Florida,St. Lucie County,12,0,328297,160134,168163
50,12,111,Florida,St. Lucie County,12,1,16449,8434,8015
50,12,111,Florida,St. Lucie County,12,2,17702,9036,8666
50,12,111,Florida,St. Lucie County,12,3,18853,9652,9201
50,12,111,Florida,St. Lucie County,12,4,17756,9345,8411
50,12,111,Florida,St. Lucie County,12,5,16815,8534,8281
50,12,111,Florida,St. Lucie County,12,6,19124,9712,9412
50,12,111,Florida,St. Lucie County,12,7,18439,9236,9203
50,12,111,Florida,St. Lucie County,12,8,18295,8816,9479
50,12,111,Florida,St. Lucie County,12,9,17775,8687,9088
50,12,111,Florida,St. Lucie County,12,10,19238,9206,10032
50,12,111,Florida,St. Lucie County,12,11,20478,9924,10554
50,12,111,Florida,St. Lucie County,12,12,23167,10964,12203
50,12,111,Florida,St. Lucie County,12,13,23278,10904,12374
50,12,111,Florida,St. Lucie County,12,14,22595,10462,12133
50,12,111,Florida,St. Lucie County,12,15,21529,10231,11298
50,12,111,Florida,St. Lucie County,12,16,16173,7598,8575
50,12,111,Florida,St. Lucie County,12,17,10537,5030,5507
50,12,111,Florida,St. Lucie County,12,18,10094,4363,5731
50,12,113,Florida,Santa Rosa County,1,0,151372,76422,74950
50,12,113,Florida,Santa Rosa County,1,1,9197,4673,4524
50,12,113,Florida,Santa Rosa County,1,2,9770,4985,4785
50,12,113,Florida,Santa Rosa County,1,3,10620,5453,5167
50,12,113,Florida,Santa Rosa County,1,4,10550,5525,5025
50,12,113,Florida,Santa Rosa County,1,5,8875,4866,4009
50,12,113,Florida,Santa Rosa County,1,6,9507,5157,4350
50,12,113,Florida,Santa Rosa County,1,7,9084,4696,4388
50,12,113,Florida,Santa Rosa County,1,8,9864,4950,4914
50,12,113,Florida,Santa Rosa County,1,9,11029,5548,5481
50,12,113,Florida,Santa Rosa County,1,10,13025,6527,6498
50,12,113,Florida,Santa Rosa County,1,11,11810,5905,5905
50,12,113,Florida,Santa Rosa County,1,12,9872,4830,5042
50,12,113,Florida,Santa Rosa County,1,13,8709,4312,4397
50,12,113,Florida,Santa Rosa County,1,14,6858,3266,3592
50,12,113,Florida,Santa Rosa County,1,15,5185,2528,2657
50,12,113,Florida,Santa Rosa County,1,16,3523,1667,1856
50,12,113,Florida,Santa Rosa County,1,17,2278,975,1303
50,12,113,Florida,Santa Rosa County,1,18,1616,559,1057
50,12,113,Florida,Santa Rosa County,2,0,151371,76421,74950
50,12,113,Florida,Santa Rosa County,2,1,9197,4673,4524
50,12,113,Florida,Santa Rosa County,2,2,9770,4985,4785
50,12,113,Florida,Santa Rosa County,2,3,10620,5453,5167
50,12,113,Florida,Santa Rosa County,2,4,10550,5525,5025
50,12,113,Florida,Santa Rosa County,2,5,8875,4866,4009
50,12,113,Florida,Santa Rosa County,2,6,9507,5157,4350
50,12,113,Florida,Santa Rosa County,2,7,9084,4696,4388
50,12,113,Florida,Santa Rosa County,2,8,9864,4950,4914
50,12,113,Florida,Santa Rosa County,2,9,11028,5548,5480
50,12,113,Florida,Santa Rosa County,2,10,13025,6527,6498
50,12,113,Florida,Santa Rosa County,2,11,11810,5905,5905
50,12,113,Florida,Santa Rosa County,2,12,9872,4830,5042
50,12,113,Florida,Santa Rosa County,2,13,8708,4311,4397
50,12,113,Florida,Santa Rosa County,2,14,6859,3266,3593
50,12,113,Florida,Santa Rosa County,2,15,5185,2528,2657
50,12,113,Florida,Santa Rosa County,2,16,3523,1667,1856
50,12,113,Florida,Santa Rosa County,2,17,2278,975,1303
50,12,113,Florida,Santa Rosa County,2,18,1616,559,1057
50,12,113,Florida,Santa Rosa County,3,0,152908,77641,75267
50,12,113,Florida,Santa Rosa County,3,1,9243,4694,4549
50,12,113,Florida,Santa Rosa County,3,2,9790,4998,4792
50,12,113,Florida,Santa Rosa County,3,3,10631,5454,5177
50,12,113,Florida,Santa Rosa County,3,4,10518,5527,4991
50,12,113,Florida,Santa Rosa County,3,5,9136,5065,4071
50,12,113,Florida,Santa Rosa County,3,6,9832,5431,4401
50,12,113,Florida,Santa Rosa County,3,7,9269,4861,4408
50,12,113,Florida,Santa Rosa County,3,8,9940,5065,4875
50,12,113,Florida,Santa Rosa County,3,9,11116,5630,5486
50,12,113,Florida,Santa Rosa County,3,10,13065,6576,6489
50,12,113,Florida,Santa Rosa County,3,11,11945,6008,5937
50,12,113,Florida,Santa Rosa County,3,12,9995,4903,5092
50,12,113,Florida,Santa Rosa County,3,13,8812,4362,4450
50,12,113,Florida,Santa Rosa County,3,14,6884,3286,3598
50,12,113,Florida,Santa Rosa County,3,15,5231,2540,2691
50,12,113,Florida,Santa Rosa County,3,16,3551,1682,1869
50,12,113,Florida,Santa Rosa County,3,17,2320,992,1328
50,12,113,Florida,Santa Rosa County,3,18,1630,567,1063
50,12,113,Florida,Santa Rosa County,4,0,155738,79393,76345
50,12,113,Florida,Santa Rosa County,4,1,9165,4613,4552
50,12,113,Florida,Santa Rosa County,4,2,9887,5074,4813
50,12,113,Florida,Santa Rosa County,4,3,10666,5430,5236
50,12,113,Florida,Santa Rosa County,4,4,10337,5433,4904
50,12,113,Florida,Santa Rosa County,4,5,9812,5451,4361
50,12,113,Florida,Santa Rosa County,4,6,10330,5792,4538
50,12,113,Florida,Santa Rosa County,4,7,9646,5182,4464
50,12,113,Florida,Santa Rosa County,4,8,9771,5083,4688
50,12,113,Florida,Santa Rosa County,4,9,11186,5638,5548
50,12,113,Florida,Santa Rosa County,4,10,12759,6469,6290
50,12,113,Florida,Santa Rosa County,4,11,12308,6198,6110
50,12,113,Florida,Santa Rosa County,4,12,10348,5091,5257
50,12,113,Florida,Santa Rosa County,4,13,9254,4558,4696
50,12,113,Florida,Santa Rosa County,4,14,6969,3387,3582
50,12,113,Florida,Santa Rosa County,4,15,5390,2576,2814
50,12,113,Florida,Santa Rosa County,4,16,3730,1761,1969
50,12,113,Florida,Santa Rosa County,4,17,2442,1047,1395
50,12,113,Florida,Santa Rosa County,4,18,1738,610,1128
50,12,113,Florida,Santa Rosa County,5,0,158190,80705,77485
50,12,113,Florida,Santa Rosa County,5,1,9147,4620,4527
50,12,113,Florida,Santa Rosa County,5,2,10001,5102,4899
50,12,113,Florida,Santa Rosa County,5,3,10684,5442,5242
50,12,113,Florida,Santa Rosa County,5,4,10200,5392,4808
50,12,113,Florida,Santa Rosa County,5,5,10196,5655,4541
50,12,113,Florida,Santa Rosa County,5,6,10772,6058,4714
50,12,113,Florida,Santa Rosa County,5,7,10007,5372,4635
50,12,113,Florida,Santa Rosa County,5,8,9711,5139,4572
50,12,113,Florida,Santa Rosa County,5,9,11244,5648,5596
50,12,113,Florida,Santa Rosa County,5,10,12284,6203,6081
50,12,113,Florida,Santa Rosa County,5,11,12677,6394,6283
50,12,113,Florida,Santa Rosa County,5,12,10601,5209,5392
50,12,113,Florida,Santa Rosa County,5,13,9188,4509,4679
50,12,113,Florida,Santa Rosa County,5,14,7617,3739,3878
50,12,113,Florida,Santa Rosa County,5,15,5558,2614,2944
50,12,113,Florida,Santa Rosa County,5,16,3940,1843,2097
50,12,113,Florida,Santa Rosa County,5,17,2499,1091,1408
50,12,113,Florida,Santa Rosa County,5,18,1864,675,1189
50,12,113,Florida,Santa Rosa County,6,0,160392,82009,78383
50,12,113,Florida,Santa Rosa County,6,1,9210,4724,4486
50,12,113,Florida,Santa Rosa County,6,2,10114,5161,4953
50,12,113,Florida,Santa Rosa County,6,3,10602,5417,5185
50,12,113,Florida,Santa Rosa County,6,4,10112,5330,4782
50,12,113,Florida,Santa Rosa County,6,5,10371,5814,4557
50,12,113,Florida,Santa Rosa County,6,6,11084,6233,4851
50,12,113,Florida,Santa Rosa County,6,7,10355,5570,4785
50,12,113,Florida,Santa Rosa County,6,8,9872,5207,4665
50,12,113,Florida,Santa Rosa County,6,9,11161,5630,5531
50,12,113,Florida,Santa Rosa County,6,10,11839,5982,5857
50,12,113,Florida,Santa Rosa County,6,11,12926,6501,6425
50,12,113,Florida,Santa Rosa County,6,12,10874,5368,5506
50,12,113,Florida,Santa Rosa County,6,13,9310,4545,4765
50,12,113,Florida,Santa Rosa County,6,14,7896,3887,4009
50,12,113,Florida,Santa Rosa County,6,15,5958,2818,3140
50,12,113,Florida,Santa Rosa County,6,16,4156,1960,2196
50,12,113,Florida,Santa Rosa County,6,17,2549,1143,1406
50,12,113,Florida,Santa Rosa County,6,18,2003,719,1284
50,12,113,Florida,Santa Rosa County,7,0,162668,83198,79470
50,12,113,Florida,Santa Rosa County,7,1,9301,4767,4534
50,12,113,Florida,Santa Rosa County,7,2,10152,5203,4949
50,12,113,Florida,Santa Rosa County,7,3,10619,5456,5163
50,12,113,Florida,Santa Rosa County,7,4,10222,5364,4858
50,12,113,Florida,Santa Rosa County,7,5,10215,5736,4479
50,12,113,Florida,Santa Rosa County,7,6,11334,6387,4947
50,12,113,Florida,Santa Rosa County,7,7,10759,5806,4953
50,12,113,Florida,Santa Rosa County,7,8,10023,5286,4737
50,12,113,Florida,Santa Rosa County,7,9,10983,5550,5433
50,12,113,Florida,Santa Rosa County,7,10,11469,5817,5652
50,12,113,Florida,Santa Rosa County,7,11,13130,6626,6504
50,12,113,Florida,Santa Rosa County,7,12,11237,5510,5727
50,12,113,Florida,Santa Rosa County,7,13,9606,4691,4915
50,12,113,Florida,Santa Rosa County,7,14,8274,4066,4208
50,12,113,Florida,Santa Rosa County,7,15,6193,2914,3279
50,12,113,Florida,Santa Rosa County,7,16,4407,2084,2323
50,12,113,Florida,Santa Rosa County,7,17,2635,1180,1455
50,12,113,Florida,Santa Rosa County,7,18,2109,755,1354
50,12,113,Florida,Santa Rosa County,8,0,166226,85233,80993
50,12,113,Florida,Santa Rosa County,8,1,9373,4858,4515
50,12,113,Florida,Santa Rosa County,8,2,10182,5146,5036
50,12,113,Florida,Santa Rosa County,8,3,10813,5556,5257
50,12,113,Florida,Santa Rosa County,8,4,10390,5473,4917
50,12,113,Florida,Santa Rosa County,8,5,10151,5795,4356
50,12,113,Florida,Santa Rosa County,8,6,11661,6604,5057
50,12,113,Florida,Santa Rosa County,8,7,11162,6070,5092
50,12,113,Florida,Santa Rosa County,8,8,10416,5499,4917
50,12,113,Florida,Santa Rosa County,8,9,10913,5579,5334
50,12,113,Florida,Santa Rosa County,8,10,11469,5857,5612
50,12,113,Florida,Santa Rosa County,8,11,13132,6579,6553
50,12,113,Florida,Santa Rosa County,8,12,11782,5831,5951
50,12,113,Florida,Santa Rosa County,8,13,10022,4852,5170
50,12,113,Florida,Santa Rosa County,8,14,8732,4307,4425
50,12,113,Florida,Santa Rosa County,8,15,6428,2999,3429
50,12,113,Florida,Santa Rosa County,8,16,4571,2158,2413
50,12,113,Florida,Santa Rosa County,8,17,2812,1254,1558
50,12,113,Florida,Santa Rosa County,8,18,2217,816,1401
50,12,113,Florida,Santa Rosa County,9,0,169894,87024,82870
50,12,113,Florida,Santa Rosa County,9,1,9682,5009,4673
50,12,113,Florida,Santa Rosa County,9,2,10187,5220,4967
50,12,113,Florida,Santa Rosa County,9,3,10944,5653,5291
50,12,113,Florida,Santa Rosa County,9,4,10617,5543,5074
50,12,113,Florida,Santa Rosa County,9,5,9935,5655,4280
50,12,113,Florida,Santa Rosa County,9,6,11994,6751,5243
50,12,113,Florida,Santa Rosa County,9,7,11610,6277,5333
50,12,113,Florida,Santa Rosa County,9,8,10987,5796,5191
50,12,113,Florida,Santa Rosa County,9,9,10717,5561,5156
50,12,113,Florida,Santa Rosa County,9,10,11685,5918,5767
50,12,113,Florida,Santa Rosa County,9,11,12956,6480,6476
50,12,113,Florida,Santa Rosa County,9,12,12305,6065,6240
50,12,113,Florida,Santa Rosa County,9,13,10356,5035,5321
50,12,113,Florida,Santa Rosa County,9,14,9304,4553,4751
50,12,113,Florida,Santa Rosa County,9,15,6581,3128,3453
50,12,113,Florida,Santa Rosa County,9,16,4742,2179,2563
50,12,113,Florida,Santa Rosa County,9,17,2938,1321,1617
50,12,113,Florida,Santa Rosa County,9,18,2354,880,1474
50,12,113,Florida,Santa Rosa County,10,0,174049,88793,85256
50,12,113,Florida,Santa Rosa County,10,1,9875,5042,4833
50,12,113,Florida,Santa Rosa County,10,2,10410,5301,5109
50,12,113,Florida,Santa Rosa County,10,3,11177,5851,5326
50,12,113,Florida,Santa Rosa County,10,4,10756,5616,5140
50,12,113,Florida,Santa Rosa County,10,5,9723,5543,4180
50,12,113,Florida,Santa Rosa County,10,6,12256,6746,5510
50,12,113,Florida,Santa Rosa County,10,7,11946,6460,5486
50,12,113,Florida,Santa Rosa County,10,8,11388,5957,5431
50,12,113,Florida,Santa Rosa County,10,9,10825,5572,5253
50,12,113,Florida,Santa Rosa County,10,10,11926,6031,5895
50,12,113,Florida,Santa Rosa County,10,11,12651,6336,6315
50,12,113,Florida,Santa Rosa County,10,12,12954,6356,6598
50,12,113,Florida,Santa Rosa County,10,13,10843,5222,5621
50,12,113,Florida,Santa Rosa County,10,14,9407,4582,4825
50,12,113,Florida,Santa Rosa County,10,15,7371,3553,3818
50,12,113,Florida,Santa Rosa County,10,16,4967,2257,2710
50,12,113,Florida,Santa Rosa County,10,17,3068,1392,1676
50,12,113,Florida,Santa Rosa County,10,18,2506,976,1530
50,12,113,Florida,Santa Rosa County,11,0,179295,91394,87901
50,12,113,Florida,Santa Rosa County,11,1,10163,5191,4972
50,12,113,Florida,Santa Rosa County,11,2,10662,5481,5181
50,12,113,Florida,Santa Rosa County,11,3,11620,6029,5591
50,12,113,Florida,Santa Rosa County,11,4,10754,5640,5114
50,12,113,Florida,Santa Rosa County,11,5,9999,5633,4366
50,12,113,Florida,Santa Rosa County,11,6,12468,6941,5527
50,12,113,Florida,Santa Rosa County,11,7,12529,6720,5809
50,12,113,Florida,Santa Rosa County,11,8,11932,6198,5734
50,12,113,Florida,Santa Rosa County,11,9,11157,5769,5388
50,12,113,Florida,Santa Rosa County,11,10,12048,6112,5936
50,12,113,Florida,Santa Rosa County,11,11,12400,6144,6256
50,12,113,Florida,Santa Rosa County,11,12,13485,6657,6828
50,12,113,Florida,Santa Rosa County,11,13,11422,5483,5939
50,12,113,Florida,Santa Rosa County,11,14,9745,4727,5018
50,12,113,Florida,Santa Rosa County,11,15,7763,3735,4028
50,12,113,Florida,Santa Rosa County,11,16,5301,2411,2890
50,12,113,Florida,Santa Rosa County,11,17,3280,1502,1778
50,12,113,Florida,Santa Rosa County,11,18,2567,1021,1546
50,12,113,Florida,Santa Rosa County,12,0,184313,93940,90373
50,12,113,Florida,Santa Rosa County,12,1,10258,5224,5034
50,12,113,Florida,Santa Rosa County,12,2,11048,5715,5333
50,12,113,Florida,Santa Rosa County,12,3,11874,6038,5836
50,12,113,Florida,Santa Rosa County,12,4,10818,5673,5145
50,12,113,Florida,Santa Rosa County,12,5,10190,5797,4393
50,12,113,Florida,Santa Rosa County,12,6,12617,7058,5559
50,12,113,Florida,Santa Rosa County,12,7,12926,6882,6044
50,12,113,Florida,Santa Rosa County,12,8,12642,6594,6048
50,12,113,Florida,Santa Rosa County,12,9,11525,5964,5561
50,12,113,Florida,Santa Rosa County,12,10,12161,6151,6010
50,12,113,Florida,Santa Rosa County,12,11,12201,6088,6113
50,12,113,Florida,Santa Rosa County,12,12,13910,6857,7053
50,12,113,Florida,Santa Rosa County,12,13,12022,5813,6209
50,12,113,Florida,Santa Rosa County,12,14,10176,4888,5288
50,12,113,Florida,Santa Rosa County,12,15,8260,3972,4288
50,12,113,Florida,Santa Rosa County,12,16,5639,2597,3042
50,12,113,Florida,Santa Rosa County,12,17,3441,1557,1884
50,12,113,Florida,Santa Rosa County,12,18,2605,1072,1533
50,12,115,Florida,Sarasota County,1,0,379448,181041,198407
50,12,115,Florida,Sarasota County,1,1,14624,7488,7136
50,12,115,Florida,Sarasota County,1,2,15902,8101,7801
50,12,115,Florida,Sarasota County,1,3,17814,9093,8721
50,12,115,Florida,Sarasota County,1,4,18363,9523,8840
50,12,115,Florida,Sarasota County,1,5,15253,7758,7495
50,12,115,Florida,Sarasota County,1,6,15816,8090,7726
50,12,115,Florida,Sarasota County,1,7,15366,7788,7578
50,12,115,Florida,Sarasota County,1,8,17649,8585,9064
50,12,115,Florida,Sarasota County,1,9,20467,10003,10464
50,12,115,Florida,Sarasota County,1,10,24875,11952,12923
50,12,115,Florida,Sarasota County,1,11,26757,12626,14131
50,12,115,Florida,Sarasota County,1,12,27384,12480,14904
50,12,115,Florida,Sarasota County,1,13,30951,14045,16906
50,12,115,Florida,Sarasota County,1,14,31362,14437,16925
50,12,115,Florida,Sarasota County,1,15,26961,12756,14205
50,12,115,Florida,Sarasota County,1,16,22833,10793,12040
50,12,115,Florida,Sarasota County,1,17,19045,8521,10524
50,12,115,Florida,Sarasota County,1,18,18026,7002,11024
50,12,115,Florida,Sarasota County,2,0,379433,181033,198400
50,12,115,Florida,Sarasota County,2,1,14624,7488,7136
50,12,115,Florida,Sarasota County,2,2,15902,8101,7801
50,12,115,Florida,Sarasota County,2,3,17814,9093,8721
50,12,115,Florida,Sarasota County,2,4,18363,9523,8840
50,12,115,Florida,Sarasota County,2,5,15253,7758,7495
50,12,115,Florida,Sarasota County,2,6,15816,8090,7726
50,12,115,Florida,Sarasota County,2,7,15366,7788,7578
50,12,115,Florida,Sarasota County,2,8,17649,8585,9064
50,12,115,Florida,Sarasota County,2,9,20467,10003,10464
50,12,115,Florida,Sarasota County,2,10,24874,11951,12923
50,12,115,Florida,Sarasota County,2,11,26756,12626,14130
50,12,115,Florida,Sarasota County,2,12,27383,12479,14904
50,12,115,Florida,Sarasota County,2,13,30950,14045,16905
50,12,115,Florida,Sarasota County,2,14,31361,14437,16924
50,12,115,Florida,Sarasota County,2,15,26956,12753,14203
50,12,115,Florida,Sarasota County,2,16,22832,10792,12040
50,12,115,Florida,Sarasota County,2,17,19042,8519,10523
50,12,115,Florida,Sarasota County,2,18,18025,7002,11023
50,12,115,Florida,Sarasota County,3,0,379930,181265,198665
50,12,115,Florida,Sarasota County,3,1,14614,7475,7139
50,12,115,Florida,Sarasota County,3,2,15866,8092,7774
50,12,115,Florida,Sarasota County,3,3,17763,9066,8697
50,12,115,Florida,Sarasota County,3,4,18369,9539,8830
50,12,115,Florida,Sarasota County,3,5,15440,7830,7610
50,12,115,Florida,Sarasota County,3,6,15746,8057,7689
50,12,115,Florida,Sarasota County,3,7,15417,7801,7616
50,12,115,Florida,Sarasota County,3,8,17407,8488,8919
50,12,115,Florida,Sarasota County,3,9,20480,9993,10487
50,12,115,Florida,Sarasota County,3,10,24760,11903,12857
50,12,115,Florida,Sarasota County,3,11,26776,12628,14148
50,12,115,Florida,Sarasota County,3,12,27512,12544,14968
50,12,115,Florida,Sarasota County,3,13,31057,14093,16964
50,12,115,Florida,Sarasota County,3,14,31438,14473,16965
50,12,115,Florida,Sarasota County,3,15,27105,12820,14285
50,12,115,Florida,Sarasota County,3,16,22870,10820,12050
50,12,115,Florida,Sarasota County,3,17,19086,8551,10535
50,12,115,Florida,Sarasota County,3,18,18224,7092,11132
50,12,115,Florida,Sarasota County,4,0,382226,182468,199758
50,12,115,Florida,Sarasota County,4,1,14634,7535,7099
50,12,115,Florida,Sarasota County,4,2,15768,8012,7756
50,12,115,Florida,Sarasota County,4,3,17618,8995,8623
50,12,115,Florida,Sarasota County,4,4,18087,9430,8657
50,12,115,Florida,Sarasota County,4,5,16042,8119,7923
50,12,115,Florida,Sarasota County,4,6,15755,8112,7643
50,12,115,Florida,Sarasota County,4,7,15676,7841,7835
50,12,115,Florida,Sarasota County,4,8,16477,8075,8402
50,12,115,Florida,Sarasota County,4,9,20517,9949,10568
50,12,115,Florida,Sarasota County,4,10,24123,11628,12495
50,12,115,Florida,Sarasota County,4,11,26895,12743,14152
50,12,115,Florida,Sarasota County,4,12,27701,12648,15053
50,12,115,Florida,Sarasota County,4,13,31639,14339,17300
50,12,115,Florida,Sarasota County,4,14,31877,14665,17212
50,12,115,Florida,Sarasota County,4,15,27876,13184,14692
50,12,115,Florida,Sarasota County,4,16,23186,10974,12212
50,12,115,Florida,Sarasota County,4,17,19341,8724,10617
50,12,115,Florida,Sarasota County,4,18,19014,7495,11519
50,12,115,Florida,Sarasota County,5,0,386437,184299,202138
50,12,115,Florida,Sarasota County,5,1,14581,7523,7058
50,12,115,Florida,Sarasota County,5,2,16029,8159,7870
50,12,115,Florida,Sarasota County,5,3,17531,8894,8637
50,12,115,Florida,Sarasota County,5,4,18118,9401,8717
50,12,115,Florida,Sarasota County,5,5,16691,8494,8197
50,12,115,Florida,Sarasota County,5,6,15670,7957,7713
50,12,115,Florida,Sarasota County,5,7,16055,8064,7991
50,12,115,Florida,Sarasota County,5,8,16185,7849,8336
50,12,115,Florida,Sarasota County,5,9,20191,9840,10351
50,12,115,Florida,Sarasota County,5,10,23534,11318,12216
50,12,115,Florida,Sarasota County,5,11,26896,12750,14146
50,12,115,Florida,Sarasota County,5,12,28152,12818,15334
50,12,115,Florida,Sarasota County,5,13,30733,13858,16875
50,12,115,Florida,Sarasota County,5,14,33919,15631,18288
50,12,115,Florida,Sarasota County,5,15,29136,13762,15374
50,12,115,Florida,Sarasota County,5,16,23749,11201,12548
50,12,115,Florida,Sarasota County,5,17,19495,8902,10593
50,12,115,Florida,Sarasota County,5,18,19772,7878,11894
50,12,115,Florida,Sarasota County,6,0,389941,186109,203832
50,12,115,Florida,Sarasota County,6,1,14535,7425,7110
50,12,115,Florida,Sarasota County,6,2,16076,8255,7821
50,12,115,Florida,Sarasota County,6,3,17431,8862,8569
50,12,115,Florida,Sarasota County,6,4,17938,9283,8655
50,12,115,Florida,Sarasota County,6,5,16968,8701,8267
50,12,115,Florida,Sarasota County,6,6,15828,8033,7795
50,12,115,Florida,Sarasota County,6,7,16210,8160,8050
50,12,115,Florida,Sarasota County,6,8,16142,7865,8277
50,12,115,Florida,Sarasota County,6,9,19809,9666,10143
50,12,115,Florida,Sarasota County,6,10,22631,10883,11748
50,12,115,Florida,Sarasota County,6,11,26910,12734,14176
50,12,115,Florida,Sarasota County,6,12,28387,13015,15372
50,12,115,Florida,Sarasota County,6,13,30737,13773,16964
50,12,115,Florida,Sarasota County,6,14,34550,15920,18630
50,12,115,Florida,Sarasota County,6,15,31145,14693,16452
50,12,115,Florida,Sarasota County,6,16,24486,11541,12945
50,12,115,Florida,Sarasota County,6,17,19554,8983,10571
50,12,115,Florida,Sarasota County,6,18,20604,8317,12287
50,12,115,Florida,Sarasota County,7,0,396363,189298,207065
50,12,115,Florida,Sarasota County,7,1,14627,7491,7136
50,12,115,Florida,Sarasota County,7,2,15942,8258,7684
50,12,115,Florida,Sarasota County,7,3,17523,8853,8670
50,12,115,Florida,Sarasota County,7,4,17824,9160,8664
50,12,115,Florida,Sarasota County,7,5,17322,8938,8384
50,12,115,Florida,Sarasota County,7,6,16447,8298,8149
50,12,115,Florida,Sarasota County,7,7,16518,8336,8182
50,12,115,Florida,Sarasota County,7,8,16205,7943,8262
50,12,115,Florida,Sarasota County,7,9,19370,9403,9967
50,12,115,Florida,Sarasota County,7,10,22101,10650,11451
50,12,115,Florida,Sarasota County,7,11,26964,12848,14116
50,12,115,Florida,Sarasota County,7,12,28920,13282,15638
50,12,115,Florida,Sarasota County,7,13,31558,14161,17397
50,12,115,Florida,Sarasota County,7,14,35591,16374,19217
50,12,115,Florida,Sarasota County,7,15,32802,15337,17465
50,12,115,Florida,Sarasota County,7,16,25602,12134,13468
50,12,115,Florida,Sarasota County,7,17,19466,9079,10387
50,12,115,Florida,Sarasota County,7,18,21581,8753,12828
50,12,115,Florida,Sarasota County,8,0,404761,193374,211387
50,12,115,Florida,Sarasota County,8,1,14942,7648,7294
50,12,115,Florida,Sarasota County,8,2,16096,8455,7641
50,12,115,Florida,Sarasota County,8,3,17474,8857,8617
50,12,115,Florida,Sarasota County,8,4,17990,9229,8761
50,12,115,Florida,Sarasota County,8,5,17537,9024,8513
50,12,115,Florida,Sarasota County,8,6,17275,8810,8465
50,12,115,Florida,Sarasota County,8,7,16652,8238,8414
50,12,115,Florida,Sarasota County,8,8,16590,8203,8387
50,12,115,Florida,Sarasota County,8,9,18888,9072,9816
50,12,115,Florida,Sarasota County,8,10,22228,10721,11507
50,12,115,Florida,Sarasota County,8,11,26848,12751,14097
50,12,115,Florida,Sarasota County,8,12,29685,13661,16024
50,12,115,Florida,Sarasota County,8,13,32345,14487,17858
50,12,115,Florida,Sarasota County,8,14,37269,17187,20082
50,12,115,Florida,Sarasota County,8,15,34194,15852,18342
50,12,115,Florida,Sarasota County,8,16,26463,12566,13897
50,12,115,Florida,Sarasota County,8,17,19895,9405,10490
50,12,115,Florida,Sarasota County,8,18,22390,9208,13182
50,12,115,Florida,Sarasota County,9,0,412968,197075,215893
50,12,115,Florida,Sarasota County,9,1,14987,7633,7354
50,12,115,Florida,Sarasota County,9,2,16176,8438,7738
50,12,115,Florida,Sarasota County,9,3,17628,9002,8626
50,12,115,Florida,Sarasota County,9,4,18117,9305,8812
50,12,115,Florida,Sarasota County,9,5,17464,8898,8566
50,12,115,Florida,Sarasota County,9,6,17733,9017,8716
50,12,115,Florida,Sarasota County,9,7,16712,8347,8365
50,12,115,Florida,Sarasota County,9,8,17143,8446,8697
50,12,115,Florida,Sarasota County,9,9,18210,8695,9515
50,12,115,Florida,Sarasota County,9,10,22559,10830,11729
50,12,115,Florida,Sarasota County,9,11,26574,12581,13993
50,12,115,Florida,Sarasota County,9,12,30363,14023,16340
50,12,115,Florida,Sarasota County,9,13,33297,14854,18443
50,12,115,Florida,Sarasota County,9,14,39161,17936,21225
50,12,115,Florida,Sarasota County,9,15,35424,16516,18908
50,12,115,Florida,Sarasota County,9,16,27768,13178,14590
50,12,115,Florida,Sarasota County,9,17,20446,9701,10745
50,12,115,Florida,Sarasota County,9,18,23206,9675,13531
50,12,115,Florida,Sarasota County,10,0,419680,199988,219692
50,12,115,Florida,Sarasota County,10,1,14928,7593,7335
50,12,115,Florida,Sarasota County,10,2,16207,8409,7798
50,12,115,Florida,Sarasota County,10,3,17850,9142,8708
50,12,115,Florida,Sarasota County,10,4,18217,9322,8895
50,12,115,Florida,Sarasota County,10,5,17319,8759,8560
50,12,115,Florida,Sarasota County,10,6,18319,9323,8996
50,12,115,Florida,Sarasota County,10,7,16755,8348,8407
50,12,115,Florida,Sarasota County,10,8,17399,8566,8833
50,12,115,Florida,Sarasota County,10,9,17932,8498,9434
50,12,115,Florida,Sarasota County,10,10,22432,10822,11610
50,12,115,Florida,Sarasota County,10,11,25924,12190,13734
50,12,115,Florida,Sarasota County,10,12,30988,14306,16682
50,12,115,Florida,Sarasota County,10,13,34144,15270,18874
50,12,115,Florida,Sarasota County,10,14,38640,17471,21169
50,12,115,Florida,Sarasota County,10,15,38357,18013,20344
50,12,115,Florida,Sarasota County,10,16,29337,13885,15452
50,12,115,Florida,Sarasota County,10,17,21025,9946,11079
50,12,115,Florida,Sarasota County,10,18,23907,10125,13782
50,12,115,Florida,Sarasota County,11,0,426329,203097,223232
50,12,115,Florida,Sarasota County,11,1,15017,7604,7413
50,12,115,Florida,Sarasota County,11,2,16194,8368,7826
50,12,115,Florida,Sarasota County,11,3,18079,9321,8758
50,12,115,Florida,Sarasota County,11,4,18307,9382,8925
50,12,115,Florida,Sarasota County,11,5,17150,8644,8506
50,12,115,Florida,Sarasota County,11,6,18589,9563,9026
50,12,115,Florida,Sarasota County,11,7,17085,8501,8584
50,12,115,Florida,Sarasota County,11,8,17853,8772,9081
50,12,115,Florida,Sarasota County,11,9,17929,8589,9340
50,12,115,Florida,Sarasota County,11,10,22042,10602,11440
50,12,115,Florida,Sarasota County,11,11,25167,11832,13335
50,12,115,Florida,Sarasota County,11,12,31366,14447,16919
50,12,115,Florida,Sarasota County,11,13,34983,15746,19237
50,12,115,Florida,Sarasota County,11,14,39111,17531,21580
50,12,115,Florida,Sarasota County,11,15,39503,18477,21026
50,12,115,Florida,Sarasota County,11,16,31620,14982,16638
50,12,115,Florida,Sarasota County,11,17,21902,10295,11607
50,12,115,Florida,Sarasota County,11,18,24432,10441,13991
50,12,115,Florida,Sarasota County,12,0,433742,206575,227167
50,12,115,Florida,Sarasota County,12,1,15038,7672,7366
50,12,115,Florida,Sarasota County,12,2,16415,8396,8019
50,12,115,Florida,Sarasota County,12,3,18018,9386,8632
50,12,115,Florida,Sarasota County,12,4,18508,9405,9103
50,12,115,Florida,Sarasota County,12,5,17233,8643,8590
50,12,115,Florida,Sarasota County,12,6,18862,9731,9131
50,12,115,Florida,Sarasota County,12,7,17641,8822,8819
50,12,115,Florida,Sarasota County,12,8,18125,8912,9213
50,12,115,Florida,Sarasota County,12,9,18159,8754,9405
50,12,115,Florida,Sarasota County,12,10,21696,10376,11320
50,12,115,Florida,Sarasota County,12,11,24703,11639,13064
50,12,115,Florida,Sarasota County,12,12,31773,14668,17105
50,12,115,Florida,Sarasota County,12,13,35623,16088,19535
50,12,115,Florida,Sarasota County,12,14,40068,17943,22125
50,12,115,Florida,Sarasota County,12,15,40976,19129,21847
50,12,115,Florida,Sarasota County,12,16,33333,15662,17671
50,12,115,Florida,Sarasota County,12,17,22872,10740,12132
50,12,115,Florida,Sarasota County,12,18,24699,10609,14090
50,12,117,Florida,Seminole County,1,0,422718,204799,217919
50,12,117,Florida,Seminole County,1,1,23363,11840,11523
50,12,117,Florida,Seminole County,1,2,25722,12982,12740
50,12,117,Florida,Seminole County,1,3,28998,14922,14076
50,12,117,Florida,Seminole County,1,4,30877,15796,15081
50,12,117,Florida,Seminole County,1,5,30888,15862,15026
50,12,117,Florida,Seminole County,1,6,28331,14129,14202
50,12,117,Florida,Seminole County,1,7,26477,12997,13480
50,12,117,Florida,Seminole County,1,8,27657,13237,14420
50,12,117,Florida,Seminole County,1,9,31202,15011,16191
50,12,117,Florida,Seminole County,1,10,34747,16785,17962
50,12,117,Florida,Seminole County,1,11,32563,15527,17036
50,12,117,Florida,Seminole County,1,12,27577,12871,14706
50,12,117,Florida,Seminole County,1,13,23639,11227,12412
50,12,117,Florida,Seminole County,1,14,16390,7674,8716
50,12,117,Florida,Seminole County,1,15,11243,5028,6215
50,12,117,Florida,Seminole County,1,16,9267,3890,5377
50,12,117,Florida,Seminole County,1,17,6879,2763,4116
50,12,117,Florida,Seminole County,1,18,6898,2258,4640
50,12,117,Florida,Seminole County,2,0,422710,204792,217918
50,12,117,Florida,Seminole County,2,1,23363,11841,11522
50,12,117,Florida,Seminole County,2,2,25722,12982,12740
50,12,117,Florida,Seminole County,2,3,28996,14920,14076
50,12,117,Florida,Seminole County,2,4,30874,15793,15081
50,12,117,Florida,Seminole County,2,5,30885,15860,15025
50,12,117,Florida,Seminole County,2,6,28328,14126,14202
50,12,117,Florida,Seminole County,2,7,26479,12998,13481
50,12,117,Florida,Seminole County,2,8,27655,13236,14419
50,12,117,Florida,Seminole County,2,9,31203,15011,16192
50,12,117,Florida,Seminole County,2,10,34748,16787,17961
50,12,117,Florida,Seminole County,2,11,32564,15527,17037
50,12,117,Florida,Seminole County,2,12,27577,12871,14706
50,12,117,Florida,Seminole County,2,13,23639,11227,12412
50,12,117,Florida,Seminole County,2,14,16390,7674,8716
50,12,117,Florida,Seminole County,2,15,11243,5028,6215
50,12,117,Florida,Seminole County,2,16,9267,3890,5377
50,12,117,Florida,Seminole County,2,17,6879,2763,4116
50,12,117,Florida,Seminole County,2,18,6898,2258,4640
50,12,117,Florida,Seminole County,3,0,423051,204907,218144
50,12,117,Florida,Seminole County,3,1,23274,11802,11472
50,12,117,Florida,Seminole County,3,2,25620,12915,12705
50,12,117,Florida,Seminole County,3,3,28913,14839,14074
50,12,117,Florida,Seminole County,3,4,30514,15631,14883
50,12,117,Florida,Seminole County,3,5,31071,15920,15151
50,12,117,Florida,Seminole County,3,6,28461,14224,14237
50,12,117,Florida,Seminole County,3,7,26679,13105,13574
50,12,117,Florida,Seminole County,3,8,27436,13137,14299
50,12,117,Florida,Seminole County,3,9,31135,14971,16164
50,12,117,Florida,Seminole County,3,10,34598,16714,17884
50,12,117,Florida,Seminole County,3,11,32669,15557,17112
50,12,117,Florida,Seminole County,3,12,27758,12969,14789
50,12,117,Florida,Seminole County,3,13,23840,11304,12536
50,12,117,Florida,Seminole County,3,14,16555,7769,8786
50,12,117,Florida,Seminole County,3,15,11390,5091,6299
50,12,117,Florida,Seminole County,3,16,9238,3884,5354
50,12,117,Florida,Seminole County,3,17,6946,2799,4147
50,12,117,Florida,Seminole County,3,18,6954,2276,4678
50,12,117,Florida,Seminole County,4,0,426334,206455,219879
50,12,117,Florida,Seminole County,4,1,23005,11798,11207
50,12,117,Florida,Seminole County,4,2,25399,12790,12609
50,12,117,Florida,Seminole County,4,3,28593,14645,13948
50,12,117,Florida,Seminole County,4,4,29386,15094,14292
50,12,117,Florida,Seminole County,4,5,31848,16268,15580
50,12,117,Florida,Seminole County,4,6,29119,14692,14427
50,12,117,Florida,Seminole County,4,7,27601,13572,14029
50,12,117,Florida,Seminole County,4,8,26739,12733,14006
50,12,117,Florida,Seminole County,4,9,31104,14876,16228
50,12,117,Florida,Seminole County,4,10,33767,16230,17537
50,12,117,Florida,Seminole County,4,11,33347,15943,17404
50,12,117,Florida,Seminole County,4,12,28445,13349,15096
50,12,117,Florida,Seminole County,4,13,24895,11679,13216
50,12,117,Florida,Seminole County,4,14,17327,8183,9144
50,12,117,Florida,Seminole County,4,15,11950,5365,6585
50,12,117,Florida,Seminole County,4,16,9325,3935,5390
50,12,117,Florida,Seminole County,4,17,7180,2897,4283
50,12,117,Florida,Seminole County,4,18,7304,2406,4898
50,12,117,Florida,Seminole County,5,0,430537,208050,222487
50,12,117,Florida,Seminole County,5,1,22904,11577,11327
50,12,117,Florida,Seminole County,5,2,25714,12912,12802
50,12,117,Florida,Seminole County,5,3,28261,14426,13835
50,12,117,Florida,Seminole County,5,4,28577,14782,13795
50,12,117,Florida,Seminole County,5,5,31769,16052,15717
50,12,117,Florida,Seminole County,5,6,29629,14909,14720
50,12,117,Florida,Seminole County,5,7,28554,14024,14530
50,12,117,Florida,Seminole County,5,8,26930,12900,14030
50,12,117,Florida,Seminole County,5,9,30948,14873,16075
50,12,117,Florida,Seminole County,5,10,32802,15614,17188
50,12,117,Florida,Seminole County,5,11,33693,16108,17585
50,12,117,Florida,Seminole County,5,12,29377,14031,15346
50,12,117,Florida,Seminole County,5,13,24780,11407,13373
50,12,117,Florida,Seminole County,5,14,19446,9167,10279
50,12,117,Florida,Seminole County,5,15,12729,5754,6975
50,12,117,Florida,Seminole County,5,16,9538,4038,5500
50,12,117,Florida,Seminole County,5,17,7244,2977,4267
50,12,117,Florida,Seminole County,5,18,7642,2499,5143
50,12,117,Florida,Seminole County,6,0,435503,210611,224892
50,12,117,Florida,Seminole County,6,1,23071,11754,11317
50,12,117,Florida,Seminole County,6,2,25849,13045,12804
50,12,117,Florida,Seminole County,6,3,28001,14212,13789
50,12,117,Florida,Seminole County,6,4,28258,14611,13647
50,12,117,Florida,Seminole County,6,5,31145,15746,15399
50,12,117,Florida,Seminole County,6,6,30549,15454,15095
50,12,117,Florida,Seminole County,6,7,29659,14574,15085
50,12,117,Florida,Seminole County,6,8,27471,13216,14255
50,12,117,Florida,Seminole County,6,9,30912,14847,16065
50,12,117,Florida,Seminole County,6,10,32136,15330,16806
50,12,117,Florida,Seminole County,6,11,33763,16109,17654
50,12,117,Florida,Seminole County,6,12,30209,14384,15825
50,12,117,Florida,Seminole County,6,13,25101,11560,13541
50,12,117,Florida,Seminole County,6,14,20505,9622,10883
50,12,117,Florida,Seminole County,6,15,13794,6268,7526
50,12,117,Florida,Seminole County,6,16,9783,4174,5609
50,12,117,Florida,Seminole County,6,17,7363,3023,4340
50,12,117,Florida,Seminole County,6,18,7934,2682,5252
50,12,117,Florida,Seminole County,7,0,441399,213263,228136
50,12,117,Florida,Seminole County,7,1,23363,11928,11435
50,12,117,Florida,Seminole County,7,2,25861,13142,12719
50,12,117,Florida,Seminole County,7,3,27920,14059,13861
50,12,117,Florida,Seminole County,7,4,28136,14517,13619
50,12,117,Florida,Seminole County,7,5,30201,15176,15025
50,12,117,Florida,Seminole County,7,6,31915,16298,15617
50,12,117,Florida,Seminole County,7,7,30419,14905,15514
50,12,117,Florida,Seminole County,7,8,28428,13793,14635
50,12,117,Florida,Seminole County,7,9,30639,14619,16020
50,12,117,Florida,Seminole County,7,10,31685,15077,16608
50,12,117,Florida,Seminole County,7,11,33903,16217,17686
50,12,117,Florida,Seminole County,7,12,31047,14761,16286
50,12,117,Florida,Seminole County,7,13,25655,11867,13788
50,12,117,Florida,Seminole County,7,14,21724,10074,11650
50,12,117,Florida,Seminole County,7,15,14653,6670,7983
50,12,117,Florida,Seminole County,7,16,10168,4305,5863
50,12,117,Florida,Seminole County,7,17,7466,3052,4414
50,12,117,Florida,Seminole County,7,18,8216,2803,5413
50,12,117,Florida,Seminole County,8,0,448318,216617,231701
50,12,117,Florida,Seminole County,8,1,23887,12253,11634
50,12,117,Florida,Seminole County,8,2,25984,13194,12790
50,12,117,Florida,Seminole County,8,3,27893,14026,13867
50,12,117,Florida,Seminole County,8,4,28284,14526,13758
50,12,117,Florida,Seminole County,8,5,29439,14820,14619
50,12,117,Florida,Seminole County,8,6,33065,16796,16269
50,12,117,Florida,Seminole County,8,7,30901,15248,15653
50,12,117,Florida,Seminole County,8,8,30018,14595,15423
50,12,117,Florida,Seminole County,8,9,30098,14347,15751
50,12,117,Florida,Seminole County,8,10,31957,15236,16721
50,12,117,Florida,Seminole County,8,11,33879,16288,17591
50,12,117,Florida,Seminole County,8,12,31553,14945,16608
50,12,117,Florida,Seminole County,8,13,26638,12327,14311
50,12,117,Florida,Seminole County,8,14,22608,10446,12162
50,12,117,Florida,Seminole County,8,15,15561,7076,8485
50,12,117,Florida,Seminole County,8,16,10433,4481,5952
50,12,117,Florida,Seminole County,8,17,7720,3097,4623
50,12,117,Florida,Seminole County,8,18,8400,2916,5484
50,12,117,Florida,Seminole County,9,0,455945,220326,235619
50,12,117,Florida,Seminole County,9,1,24233,12409,11824
50,12,117,Florida,Seminole County,9,2,26488,13498,12990
50,12,117,Florida,Seminole County,9,3,28207,14221,13986
50,12,117,Florida,Seminole County,9,4,28174,14335,13839
50,12,117,Florida,Seminole County,9,5,28881,14535,14346
50,12,117,Florida,Seminole County,9,6,34056,17350,16706
50,12,117,Florida,Seminole County,9,7,31881,15751,16130
50,12,117,Florida,Seminole County,9,8,31387,15379,16008
50,12,117,Florida,Seminole County,9,9,29877,14352,15525
50,12,117,Florida,Seminole County,9,10,32539,15460,17079
50,12,117,Florida,Seminole County,9,11,33275,15988,17287
50,12,117,Florida,Seminole County,9,12,32097,15235,16862
50,12,117,Florida,Seminole County,9,13,27353,12679,14674
50,12,117,Florida,Seminole County,9,14,23708,10845,12863
50,12,117,Florida,Seminole County,9,15,16211,7309,8902
50,12,117,Florida,Seminole County,9,16,11028,4797,6231
50,12,117,Florida,Seminole County,9,17,7790,3117,4673
50,12,117,Florida,Seminole County,9,18,8760,3066,5694
50,12,117,Florida,Seminole County,10,0,462801,223736,239065
50,12,117,Florida,Seminole County,10,1,24734,12725,12009
50,12,117,Florida,Seminole County,10,2,26682,13469,13213
50,12,117,Florida,Seminole County,10,3,28720,14523,14197
50,12,117,Florida,Seminole County,10,4,28028,14230,13798
50,12,117,Florida,Seminole County,10,5,28736,14539,14197
50,12,117,Florida,Seminole County,10,6,34787,17709,17078
50,12,117,Florida,Seminole County,10,7,32459,16163,16296
50,12,117,Florida,Seminole County,10,8,32806,16079,16727
50,12,117,Florida,Seminole County,10,9,30312,14569,15743
50,12,117,Florida,Seminole County,10,10,32725,15657,17068
50,12,117,Florida,Seminole County,10,11,32495,15518,16977
50,12,117,Florida,Seminole County,10,12,32258,15284,16974
50,12,117,Florida,Seminole County,10,13,27965,13147,14818
50,12,117,Florida,Seminole County,10,14,23461,10513,12948
50,12,117,Florida,Seminole County,10,15,18103,8158,9945
50,12,117,Florida,Seminole County,10,16,11533,5027,6506
50,12,117,Florida,Seminole County,10,17,7932,3215,4717
50,12,117,Florida,Seminole County,10,18,9065,3211,5854
50,12,117,Florida,Seminole County,11,0,468122,226191,241931
50,12,117,Florida,Seminole County,11,1,24753,12782,11971
50,12,117,Florida,Seminole County,11,2,26992,13696,13296
50,12,117,Florida,Seminole County,11,3,29164,14675,14489
50,12,117,Florida,Seminole County,11,4,27786,14033,13753
50,12,117,Florida,Seminole County,11,5,28663,14475,14188
50,12,117,Florida,Seminole County,11,6,34727,17593,17134
50,12,117,Florida,Seminole County,11,7,33211,16535,16676
50,12,117,Florida,Seminole County,11,8,33791,16676,17115
50,12,117,Florida,Seminole County,11,9,31085,14883,16202
50,12,117,Florida,Seminole County,11,10,32536,15654,16882
50,12,117,Florida,Seminole County,11,11,31907,15238,16669
50,12,117,Florida,Seminole County,11,12,32178,15263,16915
50,12,117,Florida,Seminole County,11,13,28606,13398,15208
50,12,117,Florida,Seminole County,11,14,23774,10684,13090
50,12,117,Florida,Seminole County,11,15,19083,8568,10515
50,12,117,Florida,Seminole County,11,16,12450,5442,7008
50,12,117,Florida,Seminole County,11,17,8050,3244,4806
50,12,117,Florida,Seminole County,11,18,9366,3352,6014
50,12,117,Florida,Seminole County,12,0,471826,228175,243651
50,12,117,Florida,Seminole County,12,1,24643,12697,11946
50,12,117,Florida,Seminole County,12,2,26979,13755,13224
50,12,117,Florida,Seminole County,12,3,29023,14667,14356
50,12,117,Florida,Seminole County,12,4,27666,13961,13705
50,12,117,Florida,Seminole County,12,5,28460,14245,14215
50,12,117,Florida,Seminole County,12,6,34825,17565,17260
50,12,117,Florida,Seminole County,12,7,34180,17266,16914
50,12,117,Florida,Seminole County,12,8,34302,16914,17388
50,12,117,Florida,Seminole County,12,9,31637,15369,16268
50,12,117,Florida,Seminole County,12,10,32296,15447,16849
50,12,117,Florida,Seminole County,12,11,31250,14871,16379
50,12,117,Florida,Seminole County,12,12,32332,15470,16862
50,12,117,Florida,Seminole County,12,13,28832,13463,15369
50,12,117,Florida,Seminole County,12,14,24254,10955,13299
50,12,117,Florida,Seminole County,12,15,20016,8920,11096
50,12,117,Florida,Seminole County,12,16,13211,5792,7419
50,12,117,Florida,Seminole County,12,17,8350,3410,4940
50,12,117,Florida,Seminole County,12,18,9570,3408,6162
50,12,119,Florida,Sumter County,1,0,93420,48611,44809
50,12,119,Florida,Sumter County,1,1,2243,1125,1118
50,12,119,Florida,Sumter County,1,2,2348,1193,1155
50,12,119,Florida,Sumter County,1,3,2360,1252,1108
50,12,119,Florida,Sumter County,1,4,2542,1323,1219
50,12,119,Florida,Sumter County,1,5,2453,1479,974
50,12,119,Florida,Sumter County,1,6,2932,1891,1041
50,12,119,Florida,Sumter County,1,7,3520,2443,1077
50,12,119,Florida,Sumter County,1,8,3824,2641,1183
50,12,119,Florida,Sumter County,1,9,3649,2334,1315
50,12,119,Florida,Sumter County,1,10,4138,2466,1672
50,12,119,Florida,Sumter County,1,11,4436,2167,2269
50,12,119,Florida,Sumter County,1,12,6481,2793,3688
50,12,119,Florida,Sumter County,1,13,11964,5271,6693
50,12,119,Florida,Sumter County,1,14,14788,7029,7759
50,12,119,Florida,Sumter County,1,15,11945,6109,5836
50,12,119,Florida,Sumter County,1,16,7378,3868,3510
50,12,119,Florida,Sumter County,1,17,3997,2117,1880
50,12,119,Florida,Sumter County,1,18,2422,1110,1312
50,12,119,Florida,Sumter County,2,0,93420,48611,44809
50,12,119,Florida,Sumter County,2,1,2243,1125,1118
50,12,119,Florida,Sumter County,2,2,2348,1193,1155
50,12,119,Florida,Sumter County,2,3,2360,1252,1108
50,12,119,Florida,Sumter County,2,4,2542,1323,1219
50,12,119,Florida,Sumter County,2,5,2453,1479,974
50,12,119,Florida,Sumter County,2,6,2932,1891,1041
50,12,119,Florida,Sumter County,2,7,3520,2443,1077
50,12,119,Florida,Sumter County,2,8,3824,2641,1183
50,12,119,Florida,Sumter County,2,9,3649,2334,1315
50,12,119,Florida,Sumter County,2,10,4138,2466,1672
50,12,119,Florida,Sumter County,2,11,4436,2167,2269
50,12,119,Florida,Sumter County,2,12,6481,2793,3688
50,12,119,Florida,Sumter County,2,13,11964,5271,6693
50,12,119,Florida,Sumter County,2,14,14788,7029,7759
50,12,119,Florida,Sumter County,2,15,11945,6109,5836
50,12,119,Florida,Sumter County,2,16,7378,3868,3510
50,12,119,Florida,Sumter County,2,17,3997,2117,1880
50,12,119,Florida,Sumter County,2,18,2422,1110,1312
50,12,119,Florida,Sumter County,3,0,94278,49004,45274
50,12,119,Florida,Sumter County,3,1,2238,1121,1117
50,12,119,Florida,Sumter County,3,2,2339,1186,1153
50,12,119,Florida,Sumter County,3,3,2353,1244,1109
50,12,119,Florida,Sumter County,3,4,2519,1311,1208
50,12,119,Florida,Sumter County,3,5,2476,1488,988
50,12,119,Florida,Sumter County,3,6,2922,1881,1041
50,12,119,Florida,Sumter County,3,7,3517,2443,1074
50,12,119,Florida,Sumter County,3,8,3799,2615,1184
50,12,119,Florida,Sumter County,3,9,3648,2339,1309
50,12,119,Florida,Sumter County,3,10,4121,2460,1661
50,12,119,Florida,Sumter County,3,11,4441,2178,2263
50,12,119,Florida,Sumter County,3,12,6500,2790,3710
50,12,119,Florida,Sumter County,3,13,12075,5327,6748
50,12,119,Florida,Sumter County,3,14,14928,7085,7843
50,12,119,Florida,Sumter County,3,15,12201,6228,5973
50,12,119,Florida,Sumter County,3,16,7573,3968,3605
50,12,119,Florida,Sumter County,3,17,4118,2191,1927
50,12,119,Florida,Sumter County,3,18,2510,1149,1361
50,12,119,Florida,Sumter County,4,0,97975,50612,47363
50,12,119,Florida,Sumter County,4,1,2259,1128,1131
50,12,119,Florida,Sumter County,4,2,2345,1197,1148
50,12,119,Florida,Sumter County,4,3,2343,1243,1100
50,12,119,Florida,Sumter County,4,4,2494,1295,1199
50,12,119,Florida,Sumter County,4,5,2650,1603,1047
50,12,119,Florida,Sumter County,4,6,2931,1868,1063
50,12,119,Florida,Sumter County,4,7,3561,2465,1096
50,12,119,Florida,Sumter County,4,8,3737,2557,1180
50,12,119,Florida,Sumter County,4,9,3677,2361,1316
50,12,119,Florida,Sumter County,4,10,4036,2391,1645
50,12,119,Florida,Sumter County,4,11,4441,2232,2209
50,12,119,Florida,Sumter County,4,12,6307,2627,3680
50,12,119,Florida,Sumter County,4,13,12559,5475,7084
50,12,119,Florida,Sumter County,4,14,15582,7343,8239
50,12,119,Florida,Sumter County,4,15,13283,6737,6546
50,12,119,Florida,Sumter County,4,16,8353,4388,3965
50,12,119,Florida,Sumter County,4,17,4554,2405,2149
50,12,119,Florida,Sumter County,4,18,2863,1297,1566
50,12,119,Florida,Sumter County,5,0,101669,52117,49552
50,12,119,Florida,Sumter County,5,1,2194,1125,1069
50,12,119,Florida,Sumter County,5,2,2364,1208,1156
50,12,119,Florida,Sumter County,5,3,2288,1187,1101
50,12,119,Florida,Sumter County,5,4,2375,1250,1125
50,12,119,Florida,Sumter County,5,5,2786,1652,1134
50,12,119,Florida,Sumter County,5,6,2955,1886,1069
50,12,119,Florida,Sumter County,5,7,3518,2405,1113
50,12,119,Florida,Sumter County,5,8,3637,2470,1167
50,12,119,Florida,Sumter County,5,9,3700,2368,1332
50,12,119,Florida,Sumter County,5,10,3922,2307,1615
50,12,119,Florida,Sumter County,5,11,4443,2241,2202
50,12,119,Florida,Sumter County,5,12,6336,2644,3692
50,12,119,Florida,Sumter County,5,13,12064,5119,6945
50,12,119,Florida,Sumter County,5,14,17170,8012,9158
50,12,119,Florida,Sumter County,5,15,14598,7322,7276
50,12,119,Florida,Sumter County,5,16,9219,4869,4350
50,12,119,Florida,Sumter County,5,17,4923,2588,2335
50,12,119,Florida,Sumter County,5,18,3177,1464,1713
50,12,119,Florida,Sumter County,6,0,106898,54537,52361
50,12,119,Florida,Sumter County,6,1,2205,1121,1084
50,12,119,Florida,Sumter County,6,2,2441,1244,1197
50,12,119,Florida,Sumter County,6,3,2283,1177,1106
50,12,119,Florida,Sumter County,6,4,2311,1218,1093
50,12,119,Florida,Sumter County,6,5,2928,1705,1223
50,12,119,Florida,Sumter County,6,6,3015,1904,1111
50,12,119,Florida,Sumter County,6,7,3590,2452,1138
50,12,119,Florida,Sumter County,6,8,3689,2520,1169
50,12,119,Florida,Sumter County,6,9,3715,2406,1309
50,12,119,Florida,Sumter County,6,10,3873,2279,1594
50,12,119,Florida,Sumter County,6,11,4495,2327,2168
50,12,119,Florida,Sumter County,6,12,6419,2693,3726
50,12,119,Florida,Sumter County,6,13,11982,4883,7099
50,12,119,Florida,Sumter County,6,14,18282,8547,9735
50,12,119,Florida,Sumter County,6,15,16471,8195,8276
50,12,119,Florida,Sumter County,6,16,10234,5351,4883
50,12,119,Florida,Sumter County,6,17,5338,2850,2488
50,12,119,Florida,Sumter County,6,18,3627,1665,1962
50,12,119,Florida,Sumter County,7,0,112236,56933,55303
50,12,119,Florida,Sumter County,7,1,2305,1182,1123
50,12,119,Florida,Sumter County,7,2,2433,1247,1186
50,12,119,Florida,Sumter County,7,3,2311,1201,1110
50,12,119,Florida,Sumter County,7,4,2267,1198,1069
50,12,119,Florida,Sumter County,7,5,2965,1728,1237
50,12,119,Florida,Sumter County,7,6,3131,1984,1147
50,12,119,Florida,Sumter County,7,7,3591,2431,1160
50,12,119,Florida,Sumter County,7,8,3648,2469,1179
50,12,119,Florida,Sumter County,7,9,3695,2335,1360
50,12,119,Florida,Sumter County,7,10,3797,2242,1555
50,12,119,Florida,Sumter County,7,11,4626,2384,2242
50,12,119,Florida,Sumter County,7,12,6426,2678,3748
50,12,119,Florida,Sumter County,7,13,12129,5020,7109
50,12,119,Florida,Sumter County,7,14,19515,8928,10587
50,12,119,Florida,Sumter County,7,15,18031,8924,9107
50,12,119,Florida,Sumter County,7,16,11472,6015,5457
50,12,119,Florida,Sumter County,7,17,5824,3080,2744
50,12,119,Florida,Sumter County,7,18,4070,1887,2183
50,12,119,Florida,Sumter County,8,0,117076,59043,58033
50,12,119,Florida,Sumter County,8,1,2383,1208,1175
50,12,119,Florida,Sumter County,8,2,2345,1224,1121
50,12,119,Florida,Sumter County,8,3,2331,1162,1169
50,12,119,Florida,Sumter County,8,4,2301,1251,1050
50,12,119,Florida,Sumter County,8,5,2981,1717,1264
50,12,119,Florida,Sumter County,8,6,3198,2008,1190
50,12,119,Florida,Sumter County,8,7,3720,2525,1195
50,12,119,Florida,Sumter County,8,8,3726,2523,1203
50,12,119,Florida,Sumter County,8,9,3682,2301,1381
50,12,119,Florida,Sumter County,8,10,3796,2229,1567
50,12,119,Florida,Sumter County,8,11,4609,2412,2197
50,12,119,Florida,Sumter County,8,12,6355,2656,3699
50,12,119,Florida,Sumter County,8,13,12053,4932,7121
50,12,119,Florida,Sumter County,8,14,20767,9394,11373
50,12,119,Florida,Sumter County,8,15,19180,9394,9786
50,12,119,Florida,Sumter County,8,16,12629,6547,6082
50,12,119,Florida,Sumter County,8,17,6512,3465,3047
50,12,119,Florida,Sumter County,8,18,4508,2095,2413
50,12,119,Florida,Sumter County,9,0,122009,61109,60900
50,12,119,Florida,Sumter County,9,1,2458,1248,1210
50,12,119,Florida,Sumter County,9,2,2408,1217,1191
50,12,119,Florida,Sumter County,9,3,2423,1247,1176
50,12,119,Florida,Sumter County,9,4,2279,1202,1077
50,12,119,Florida,Sumter County,9,5,2966,1726,1240
50,12,119,Florida,Sumter County,9,6,3406,2088,1318
50,12,119,Florida,Sumter County,9,7,3773,2522,1251
50,12,119,Florida,Sumter County,9,8,3813,2568,1245
50,12,119,Florida,Sumter County,9,9,3503,2166,1337
50,12,119,Florida,Sumter County,9,10,3922,2320,1602
50,12,119,Florida,Sumter County,9,11,4598,2402,2196
50,12,119,Florida,Sumter County,9,12,6411,2735,3676
50,12,119,Florida,Sumter County,9,13,11873,4749,7124
50,12,119,Florida,Sumter County,9,14,21715,9703,12012
50,12,119,Florida,Sumter County,9,15,20254,9791,10463
50,12,119,Florida,Sumter County,9,16,13968,7225,6743
50,12,119,Florida,Sumter County,9,17,7224,3833,3391
50,12,119,Florida,Sumter County,9,18,5015,2367,2648
50,12,119,Florida,Sumter County,10,0,124995,62419,62576
50,12,119,Florida,Sumter County,10,1,2497,1317,1180
50,12,119,Florida,Sumter County,10,2,2415,1222,1193
50,12,119,Florida,Sumter County,10,3,2516,1299,1217
50,12,119,Florida,Sumter County,10,4,2302,1213,1089
50,12,119,Florida,Sumter County,10,5,2972,1745,1227
50,12,119,Florida,Sumter County,10,6,3482,2136,1346
50,12,119,Florida,Sumter County,10,7,3801,2516,1285
50,12,119,Florida,Sumter County,10,8,3830,2576,1254
50,12,119,Florida,Sumter County,10,9,3510,2150,1360
50,12,119,Florida,Sumter County,10,10,3965,2319,1646
50,12,119,Florida,Sumter County,10,11,4560,2379,2181
50,12,119,Florida,Sumter County,10,12,6392,2799,3593
50,12,119,Florida,Sumter County,10,13,11414,4532,6882
50,12,119,Florida,Sumter County,10,14,20368,8950,11418
50,12,119,Florida,Sumter County,10,15,22352,10654,11698
50,12,119,Florida,Sumter County,10,16,15369,7853,7516
50,12,119,Florida,Sumter County,10,17,7948,4231,3717
50,12,119,Florida,Sumter County,10,18,5302,2528,2774
50,12,119,Florida,Sumter County,11,0,128719,64183,64536
50,12,119,Florida,Sumter County,11,1,2534,1339,1195
50,12,119,Florida,Sumter County,11,2,2508,1257,1251
50,12,119,Florida,Sumter County,11,3,2633,1323,1310
50,12,119,Florida,Sumter County,11,4,2300,1220,1080
50,12,119,Florida,Sumter County,11,5,2993,1746,1247
50,12,119,Florida,Sumter County,11,6,3625,2211,1414
50,12,119,Florida,Sumter County,11,7,3925,2605,1320
50,12,119,Florida,Sumter County,11,8,3979,2658,1321
50,12,119,Florida,Sumter County,11,9,3617,2215,1402
50,12,119,Florida,Sumter County,11,10,4045,2385,1660
50,12,119,Florida,Sumter County,11,11,4558,2372,2186
50,12,119,Florida,Sumter County,11,12,6512,2951,3561
50,12,119,Florida,Sumter County,11,13,11344,4529,6815
50,12,119,Florida,Sumter County,11,14,19451,8363,11088
50,12,119,Florida,Sumter County,11,15,23124,11003,12121
50,12,119,Florida,Sumter County,11,16,17239,8667,8572
50,12,119,Florida,Sumter County,11,17,8719,4585,4134
50,12,119,Florida,Sumter County,11,18,5613,2754,2859
50,12,119,Florida,Sumter County,12,0,132420,65847,66573
50,12,119,Florida,Sumter County,12,1,2535,1355,1180
50,12,119,Florida,Sumter County,12,2,2612,1301,1311
50,12,119,Florida,Sumter County,12,3,2686,1355,1331
50,12,119,Florida,Sumter County,12,4,2441,1291,1150
50,12,119,Florida,Sumter County,12,5,2924,1728,1196
50,12,119,Florida,Sumter County,12,6,3685,2238,1447
50,12,119,Florida,Sumter County,12,7,4084,2696,1388
50,12,119,Florida,Sumter County,12,8,4101,2716,1385
50,12,119,Florida,Sumter County,12,9,3757,2286,1471
50,12,119,Florida,Sumter County,12,10,4064,2349,1715
50,12,119,Florida,Sumter County,12,11,4563,2398,2165
50,12,119,Florida,Sumter County,12,12,6741,3040,3701
50,12,119,Florida,Sumter County,12,13,11193,4456,6737
50,12,119,Florida,Sumter County,12,14,18932,8182,10750
50,12,119,Florida,Sumter County,12,15,23895,11187,12708
50,12,119,Florida,Sumter County,12,16,18556,9200,9356
50,12,119,Florida,Sumter County,12,17,9718,5108,4610
50,12,119,Florida,Sumter County,12,18,5933,2961,2972
50,12,121,Florida,Suwannee County,1,0,41551,20945,20606
50,12,121,Florida,Suwannee County,1,1,2574,1338,1236
50,12,121,Florida,Suwannee County,1,2,2595,1343,1252
50,12,121,Florida,Suwannee County,1,3,2612,1315,1297
50,12,121,Florida,Suwannee County,1,4,2654,1438,1216
50,12,121,Florida,Suwannee County,1,5,2267,1283,984
50,12,121,Florida,Suwannee County,1,6,2429,1301,1128
50,12,121,Florida,Suwannee County,1,7,2251,1225,1026
50,12,121,Florida,Suwannee County,1,8,2339,1251,1088
50,12,121,Florida,Suwannee County,1,9,2491,1250,1241
50,12,121,Florida,Suwannee County,1,10,2873,1467,1406
50,12,121,Florida,Suwannee County,1,11,3002,1467,1535
50,12,121,Florida,Suwannee County,1,12,2761,1318,1443
50,12,121,Florida,Suwannee County,1,13,2853,1395,1458
50,12,121,Florida,Suwannee County,1,14,2496,1198,1298
50,12,121,Florida,Suwannee County,1,15,1952,948,1004
50,12,121,Florida,Suwannee County,1,16,1418,665,753
50,12,121,Florida,Suwannee County,1,17,1054,417,637
50,12,121,Florida,Suwannee County,1,18,930,326,604
50,12,121,Florida,Suwannee County,2,0,41555,20946,20609
50,12,121,Florida,Suwannee County,2,1,2575,1338,1237
50,12,121,Florida,Suwannee County,2,2,2596,1343,1253
50,12,121,Florida,Suwannee County,2,3,2612,1315,1297
50,12,121,Florida,Suwannee County,2,4,2654,1438,1216
50,12,121,Florida,Suwannee County,2,5,2267,1283,984
50,12,121,Florida,Suwannee County,2,6,2430,1301,1129
50,12,121,Florida,Suwannee County,2,7,2252,1226,1026
50,12,121,Florida,Suwannee County,2,8,2339,1251,1088
50,12,121,Florida,Suwannee County,2,9,2491,1250,1241
50,12,121,Florida,Suwannee County,2,10,2873,1467,1406
50,12,121,Florida,Suwannee County,2,11,3002,1467,1535
50,12,121,Florida,Suwannee County,2,12,2761,1318,1443
50,12,121,Florida,Suwannee County,2,13,2853,1395,1458
50,12,121,Florida,Suwannee County,2,14,2496,1198,1298
50,12,121,Florida,Suwannee County,2,15,1952,948,1004
50,12,121,Florida,Suwannee County,2,16,1418,665,753
50,12,121,Florida,Suwannee County,2,17,1054,417,637
50,12,121,Florida,Suwannee County,2,18,930,326,604
50,12,121,Florida,Suwannee County,3,0,42328,21673,20655
50,12,121,Florida,Suwannee County,3,1,2568,1331,1237
50,12,121,Florida,Suwannee County,3,2,2579,1331,1248
50,12,121,Florida,Suwannee County,3,3,2625,1329,1296
50,12,121,Florida,Suwannee County,3,4,2614,1411,1203
50,12,121,Florida,Suwannee County,3,5,2400,1401,999
50,12,121,Florida,Suwannee County,3,6,2633,1506,1127
50,12,121,Florida,Suwannee County,3,7,2396,1360,1036
50,12,121,Florida,Suwannee County,3,8,2424,1343,1081
50,12,121,Florida,Suwannee County,3,9,2534,1302,1232
50,12,121,Florida,Suwannee County,3,10,2932,1526,1406
50,12,121,Florida,Suwannee County,3,11,3040,1502,1538
50,12,121,Florida,Suwannee County,3,12,2793,1337,1456
50,12,121,Florida,Suwannee County,3,13,2882,1404,1478
50,12,121,Florida,Suwannee County,3,14,2500,1207,1293
50,12,121,Florida,Suwannee County,3,15,1954,945,1009
50,12,121,Florida,Suwannee County,3,16,1442,681,761
50,12,121,Florida,Suwannee County,3,17,1063,422,641
50,12,121,Florida,Suwannee County,3,18,949,335,614
50,12,121,Florida,Suwannee County,4,0,43368,22526,20842
50,12,121,Florida,Suwannee County,4,1,2614,1343,1271
50,12,121,Florida,Suwannee County,4,2,2576,1336,1240
50,12,121,Florida,Suwannee County,4,3,2771,1378,1393
50,12,121,Florida,Suwannee County,4,4,2514,1358,1156
50,12,121,Florida,Suwannee County,4,5,2606,1539,1067
50,12,121,Florida,Suwannee County,4,6,2810,1721,1089
50,12,121,Florida,Suwannee County,4,7,2603,1509,1094
50,12,121,Florida,Suwannee County,4,8,2446,1398,1048
50,12,121,Florida,Suwannee County,4,9,2557,1364,1193
50,12,121,Florida,Suwannee County,4,10,2933,1539,1394
50,12,121,Florida,Suwannee County,4,11,3083,1570,1513
50,12,121,Florida,Suwannee County,4,12,2864,1371,1493
50,12,121,Florida,Suwannee County,4,13,2969,1429,1540
50,12,121,Florida,Suwannee County,4,14,2490,1223,1267
50,12,121,Florida,Suwannee County,4,15,1975,950,1025
50,12,121,Florida,Suwannee County,4,16,1491,710,781
50,12,121,Florida,Suwannee County,4,17,1090,433,657
50,12,121,Florida,Suwannee County,4,18,976,355,621
50,12,121,Florida,Suwannee County,5,0,43534,22816,20718
50,12,121,Florida,Suwannee County,5,1,2542,1286,1256
50,12,121,Florida,Suwannee County,5,2,2558,1323,1235
50,12,121,Florida,Suwannee County,5,3,2756,1422,1334
50,12,121,Florida,Suwannee County,5,4,2443,1330,1113
50,12,121,Florida,Suwannee County,5,5,2676,1586,1090
50,12,121,Florida,Suwannee County,5,6,2837,1790,1047
50,12,121,Florida,Suwannee County,5,7,2648,1553,1095
50,12,121,Florida,Suwannee County,5,8,2438,1411,1027
50,12,121,Florida,Suwannee County,5,9,2581,1423,1158
50,12,121,Florida,Suwannee County,5,10,2924,1537,1387
50,12,121,Florida,Suwannee County,5,11,3035,1571,1464
50,12,121,Florida,Suwannee County,5,12,2940,1411,1529
50,12,121,Florida,Suwannee County,5,13,2839,1346,1493
50,12,121,Florida,Suwannee County,5,14,2664,1284,1380
50,12,121,Florida,Suwannee County,5,15,2054,993,1061
50,12,121,Florida,Suwannee County,5,16,1506,714,792
50,12,121,Florida,Suwannee County,5,17,1095,466,629
50,12,121,Florida,Suwannee County,5,18,998,370,628
50,12,121,Florida,Suwannee County,6,0,43588,22824,20764
50,12,121,Florida,Suwannee County,6,1,2488,1267,1221
50,12,121,Florida,Suwannee County,6,2,2576,1323,1253
50,12,121,Florida,Suwannee County,6,3,2689,1380,1309
50,12,121,Florida,Suwannee County,6,4,2500,1344,1156
50,12,121,Florida,Suwannee County,6,5,2747,1631,1116
50,12,121,Florida,Suwannee County,6,6,2885,1834,1051
50,12,121,Florida,Suwannee County,6,7,2679,1561,1118
50,12,121,Florida,Suwannee County,6,8,2361,1349,1012
50,12,121,Florida,Suwannee County,6,9,2598,1435,1163
50,12,121,Florida,Suwannee County,6,10,2832,1505,1327
50,12,121,Florida,Suwannee County,6,11,2940,1503,1437
50,12,121,Florida,Suwannee County,6,12,2991,1445,1546
50,12,121,Florida,Suwannee County,6,13,2837,1340,1497
50,12,121,Florida,Suwannee County,6,14,2655,1286,1369
50,12,121,Florida,Suwannee County,6,15,2174,1043,1131
50,12,121,Florida,Suwannee County,6,16,1530,753,777
50,12,121,Florida,Suwannee County,6,17,1104,454,650
50,12,121,Florida,Suwannee County,6,18,1002,371,631
50,12,121,Florida,Suwannee County,7,0,43786,22998,20788
50,12,121,Florida,Suwannee County,7,1,2427,1245,1182
50,12,121,Florida,Suwannee County,7,2,2658,1389,1269
50,12,121,Florida,Suwannee County,7,3,2660,1361,1299
50,12,121,Florida,Suwannee County,7,4,2482,1297,1185
50,12,121,Florida,Suwannee County,7,5,2747,1656,1091
50,12,121,Florida,Suwannee County,7,6,2969,1901,1068
50,12,121,Florida,Suwannee County,7,7,2700,1599,1101
50,12,121,Florida,Suwannee County,7,8,2383,1342,1041
50,12,121,Florida,Suwannee County,7,9,2542,1417,1125
50,12,121,Florida,Suwannee County,7,10,2704,1449,1255
50,12,121,Florida,Suwannee County,7,11,2974,1524,1450
50,12,121,Florida,Suwannee County,7,12,3101,1493,1608
50,12,121,Florida,Suwannee County,7,13,2756,1311,1445
50,12,121,Florida,Suwannee County,7,14,2746,1319,1427
50,12,121,Florida,Suwannee County,7,15,2212,1061,1151
50,12,121,Florida,Suwannee County,7,16,1601,786,815
50,12,121,Florida,Suwannee County,7,17,1084,462,622
50,12,121,Florida,Suwannee County,7,18,1040,386,654
50,12,121,Florida,Suwannee County,8,0,43677,22911,20766
50,12,121,Florida,Suwannee County,8,1,2389,1237,1152
50,12,121,Florida,Suwannee County,8,2,2600,1354,1246
50,12,121,Florida,Suwannee County,8,3,2659,1369,1290
50,12,121,Florida,Suwannee County,8,4,2450,1282,1168
50,12,121,Florida,Suwannee County,8,5,2666,1623,1043
50,12,121,Florida,Suwannee County,8,6,2970,1878,1092
50,12,121,Florida,Suwannee County,8,7,2708,1565,1143
50,12,121,Florida,Suwannee County,8,8,2424,1377,1047
50,12,121,Florida,Suwannee County,8,9,2468,1365,1103
50,12,121,Florida,Suwannee County,8,10,2641,1404,1237
50,12,121,Florida,Suwannee County,8,11,2958,1530,1428
50,12,121,Florida,Suwannee County,8,12,3080,1497,1583
50,12,121,Florida,Suwannee County,8,13,2843,1345,1498
50,12,121,Florida,Suwannee County,8,14,2780,1342,1438
50,12,121,Florida,Suwannee County,8,15,2233,1063,1170
50,12,121,Florida,Suwannee County,8,16,1654,803,851
50,12,121,Florida,Suwannee County,8,17,1088,490,598
50,12,121,Florida,Suwannee County,8,18,1066,387,679
50,12,121,Florida,Suwannee County,9,0,43834,22890,20944
50,12,121,Florida,Suwannee County,9,1,2399,1259,1140
50,12,121,Florida,Suwannee County,9,2,2594,1335,1259
50,12,121,Florida,Suwannee County,9,3,2567,1334,1233
50,12,121,Florida,Suwannee County,9,4,2509,1307,1202
50,12,121,Florida,Suwannee County,9,5,2523,1530,993
50,12,121,Florida,Suwannee County,9,6,2988,1853,1135
50,12,121,Florida,Suwannee County,9,7,2683,1553,1130
50,12,121,Florida,Suwannee County,9,8,2473,1381,1092
50,12,121,Florida,Suwannee County,9,9,2395,1305,1090
50,12,121,Florida,Suwannee County,9,10,2666,1422,1244
50,12,121,Florida,Suwannee County,9,11,2938,1504,1434
50,12,121,Florida,Suwannee County,9,12,3148,1559,1589
50,12,121,Florida,Suwannee County,9,13,2930,1370,1560
50,12,121,Florida,Suwannee County,9,14,2863,1387,1476
50,12,121,Florida,Suwannee County,9,15,2250,1077,1173
50,12,121,Florida,Suwannee County,9,16,1681,810,871
50,12,121,Florida,Suwannee County,9,17,1139,509,630
50,12,121,Florida,Suwannee County,9,18,1088,395,693
50,12,121,Florida,Suwannee County,10,0,44124,22950,21174
50,12,121,Florida,Suwannee County,10,1,2368,1221,1147
50,12,121,Florida,Suwannee County,10,2,2599,1313,1286
50,12,121,Florida,Suwannee County,10,3,2648,1368,1280
50,12,121,Florida,Suwannee County,10,4,2546,1358,1188
50,12,121,Florida,Suwannee County,10,5,2458,1458,1000
50,12,121,Florida,Suwannee County,10,6,3027,1859,1168
50,12,121,Florida,Suwannee County,10,7,2683,1551,1132
50,12,121,Florida,Suwannee County,10,8,2533,1391,1142
50,12,121,Florida,Suwannee County,10,9,2357,1292,1065
50,12,121,Florida,Suwannee County,10,10,2668,1414,1254
50,12,121,Florida,Suwannee County,10,11,2911,1486,1425
50,12,121,Florida,Suwannee County,10,12,3062,1524,1538
50,12,121,Florida,Suwannee County,10,13,3053,1432,1621
50,12,121,Florida,Suwannee County,10,14,2835,1365,1470
50,12,121,Florida,Suwannee County,10,15,2383,1150,1233
50,12,121,Florida,Suwannee County,10,16,1724,821,903
50,12,121,Florida,Suwannee County,10,17,1157,533,624
50,12,121,Florida,Suwannee County,10,18,1112,414,698
50,12,121,Florida,Suwannee County,11,0,44179,22750,21429
50,12,121,Florida,Suwannee County,11,1,2382,1203,1179
50,12,121,Florida,Suwannee County,11,2,2648,1348,1300
50,12,121,Florida,Suwannee County,11,3,2738,1403,1335
50,12,121,Florida,Suwannee County,11,4,2525,1331,1194
50,12,121,Florida,Suwannee County,11,5,2420,1409,1011
50,12,121,Florida,Suwannee County,11,6,2834,1694,1140
50,12,121,Florida,Suwannee County,11,7,2671,1509,1162
50,12,121,Florida,Suwannee County,11,8,2538,1383,1155
50,12,121,Florida,Suwannee County,11,9,2281,1226,1055
50,12,121,Florida,Suwannee County,11,10,2649,1377,1272
50,12,121,Florida,Suwannee County,11,11,2828,1445,1383
50,12,121,Florida,Suwannee County,11,12,3062,1506,1556
50,12,121,Florida,Suwannee County,11,13,3171,1497,1674
50,12,121,Florida,Suwannee County,11,14,2836,1356,1480
50,12,121,Florida,Suwannee County,11,15,2415,1184,1231
50,12,121,Florida,Suwannee County,11,16,1843,890,953
50,12,121,Florida,Suwannee County,11,17,1200,564,636
50,12,121,Florida,Suwannee County,11,18,1138,425,713
50,12,121,Florida,Suwannee County,12,0,44417,22851,21566
50,12,121,Florida,Suwannee County,12,1,2379,1208,1171
50,12,121,Florida,Suwannee County,12,2,2561,1290,1271
50,12,121,Florida,Suwannee County,12,3,2795,1417,1378
50,12,121,Florida,Suwannee County,12,4,2533,1351,1182
50,12,121,Florida,Suwannee County,12,5,2410,1395,1015
50,12,121,Florida,Suwannee County,12,6,2844,1699,1145
50,12,121,Florida,Suwannee County,12,7,2661,1529,1132
50,12,121,Florida,Suwannee County,12,8,2516,1358,1158
50,12,121,Florida,Suwannee County,12,9,2319,1205,1114
50,12,121,Florida,Suwannee County,12,10,2645,1388,1257
50,12,121,Florida,Suwannee County,12,11,2682,1372,1310
50,12,121,Florida,Suwannee County,12,12,3110,1543,1567
50,12,121,Florida,Suwannee County,12,13,3312,1571,1741
50,12,121,Florida,Suwannee County,12,14,2845,1355,1490
50,12,121,Florida,Suwannee County,12,15,2516,1225,1291
50,12,121,Florida,Suwannee County,12,16,1860,895,965
50,12,121,Florida,Suwannee County,12,17,1271,616,655
50,12,121,Florida,Suwannee County,12,18,1158,434,724
50,12,123,Florida,Taylor County,1,0,22570,12554,10016
50,12,123,Florida,Taylor County,1,1,1289,652,637
50,12,123,Florida,Taylor County,1,2,1193,616,577
50,12,123,Florida,Taylor County,1,3,1198,609,589
50,12,123,Florida,Taylor County,1,4,1256,633,623
50,12,123,Florida,Taylor County,1,5,1458,898,560
50,12,123,Florida,Taylor County,1,6,1678,1132,546
50,12,123,Florida,Taylor County,1,7,1335,880,455
50,12,123,Florida,Taylor County,1,8,1524,936,588
50,12,123,Florida,Taylor County,1,9,1521,956,565
50,12,123,Florida,Taylor County,1,10,1756,1033,723
50,12,123,Florida,Taylor County,1,11,1716,945,771
50,12,123,Florida,Taylor County,1,12,1630,883,747
50,12,123,Florida,Taylor County,1,13,1488,753,735
50,12,123,Florida,Taylor County,1,14,1203,602,601
50,12,123,Florida,Taylor County,1,15,949,444,505
50,12,123,Florida,Taylor County,1,16,646,280,366
50,12,123,Florida,Taylor County,1,17,449,195,254
50,12,123,Florida,Taylor County,1,18,281,107,174
50,12,123,Florida,Taylor County,2,0,22574,12556,10018
50,12,123,Florida,Taylor County,2,1,1289,652,637
50,12,123,Florida,Taylor County,2,2,1193,616,577
50,12,123,Florida,Taylor County,2,3,1198,609,589
50,12,123,Florida,Taylor County,2,4,1256,633,623
50,12,123,Florida,Taylor County,2,5,1459,899,560
50,12,123,Florida,Taylor County,2,6,1678,1132,546
50,12,123,Florida,Taylor County,2,7,1335,880,455
50,12,123,Florida,Taylor County,2,8,1524,936,588
50,12,123,Florida,Taylor County,2,9,1521,956,565
50,12,123,Florida,Taylor County,2,10,1757,1033,724
50,12,123,Florida,Taylor County,2,11,1718,946,772
50,12,123,Florida,Taylor County,2,12,1630,883,747
50,12,123,Florida,Taylor County,2,13,1487,753,734
50,12,123,Florida,Taylor County,2,14,1203,602,601
50,12,123,Florida,Taylor County,2,15,950,444,506
50,12,123,Florida,Taylor County,2,16,646,280,366
50,12,123,Florida,Taylor County,2,17,449,195,254
50,12,123,Florida,Taylor County,2,18,281,107,174
50,12,123,Florida,Taylor County,3,0,22595,12558,10037
50,12,123,Florida,Taylor County,3,1,1288,647,641
50,12,123,Florida,Taylor County,3,2,1188,618,570
50,12,123,Florida,Taylor County,3,3,1201,610,591
50,12,123,Florida,Taylor County,3,4,1233,619,614
50,12,123,Florida,Taylor County,3,5,1488,913,575
50,12,123,Florida,Taylor County,3,6,1671,1126,545
50,12,123,Florida,Taylor County,3,7,1338,881,457
50,12,123,Florida,Taylor County,3,8,1515,936,579
50,12,123,Florida,Taylor County,3,9,1519,954,565
50,12,123,Florida,Taylor County,3,10,1751,1028,723
50,12,123,Florida,Taylor County,3,11,1715,943,772
50,12,123,Florida,Taylor County,3,12,1632,884,748
50,12,123,Florida,Taylor County,3,13,1488,751,737
50,12,123,Florida,Taylor County,3,14,1219,611,608
50,12,123,Florida,Taylor County,3,15,945,442,503
50,12,123,Florida,Taylor County,3,16,663,287,376
50,12,123,Florida,Taylor County,3,17,456,199,257
50,12,123,Florida,Taylor County,3,18,285,109,176
50,12,123,Florida,Taylor County,4,0,22662,12612,10050
50,12,123,Florida,Taylor County,4,1,1297,636,661
50,12,123,Florida,Taylor County,4,2,1187,625,562
50,12,123,Florida,Taylor County,4,3,1200,617,583
50,12,123,Florida,Taylor County,4,4,1183,599,584
50,12,123,Florida,Taylor County,4,5,1544,962,582
50,12,123,Florida,Taylor County,4,6,1708,1142,566
50,12,123,Florida,Taylor County,4,7,1357,893,464
50,12,123,Florida,Taylor County,4,8,1445,906,539
50,12,123,Florida,Taylor County,4,9,1534,964,570
50,12,123,Florida,Taylor County,4,10,1697,996,701
50,12,123,Florida,Taylor County,4,11,1724,947,777
50,12,123,Florida,Taylor County,4,12,1600,859,741
50,12,123,Florida,Taylor County,4,13,1528,770,758
50,12,123,Florida,Taylor County,4,14,1238,617,621
50,12,123,Florida,Taylor County,4,15,930,438,492
50,12,123,Florida,Taylor County,4,16,712,312,400
50,12,123,Florida,Taylor County,4,17,468,202,266
50,12,123,Florida,Taylor County,4,18,310,127,183
50,12,123,Florida,Taylor County,5,0,22758,12877,9881
50,12,123,Florida,Taylor County,5,1,1294,672,622
50,12,123,Florida,Taylor County,5,2,1180,603,577
50,12,123,Florida,Taylor County,5,3,1191,618,573
50,12,123,Florida,Taylor County,5,4,1125,564,561
50,12,123,Florida,Taylor County,5,5,1558,1001,557
50,12,123,Florida,Taylor County,5,6,1798,1228,570
50,12,123,Florida,Taylor County,5,7,1412,968,444
50,12,123,Florida,Taylor County,5,8,1439,927,512
50,12,123,Florida,Taylor County,5,9,1519,973,546
50,12,123,Florida,Taylor County,5,10,1644,987,657
50,12,123,Florida,Taylor County,5,11,1704,956,748
50,12,123,Florida,Taylor County,5,12,1612,861,751
50,12,123,Florida,Taylor County,5,13,1443,740,703
50,12,123,Florida,Taylor County,5,14,1320,654,666
50,12,123,Florida,Taylor County,5,15,960,457,503
50,12,123,Florida,Taylor County,5,16,732,328,404
50,12,123,Florida,Taylor County,5,17,481,208,273
50,12,123,Florida,Taylor County,5,18,346,132,214
50,12,123,Florida,Taylor County,6,0,22873,12934,9939
50,12,123,Florida,Taylor County,6,1,1265,639,626
50,12,123,Florida,Taylor County,6,2,1244,637,607
50,12,123,Florida,Taylor County,6,3,1185,630,555
50,12,123,Florida,Taylor County,6,4,1066,539,527
50,12,123,Florida,Taylor County,6,5,1586,1001,585
50,12,123,Florida,Taylor County,6,6,1820,1268,552
50,12,123,Florida,Taylor County,6,7,1455,960,495
50,12,123,Florida,Taylor County,6,8,1418,928,490
50,12,123,Florida,Taylor County,6,9,1535,976,559
50,12,123,Florida,Taylor County,6,10,1612,984,628
50,12,123,Florida,Taylor County,6,11,1659,934,725
50,12,123,Florida,Taylor County,6,12,1621,848,773
50,12,123,Florida,Taylor County,6,13,1456,759,697
50,12,123,Florida,Taylor County,6,14,1344,657,687
50,12,123,Florida,Taylor County,6,15,999,482,517
50,12,123,Florida,Taylor County,6,16,785,359,426
50,12,123,Florida,Taylor County,6,17,466,201,265
50,12,123,Florida,Taylor County,6,18,357,132,225
50,12,123,Florida,Taylor County,7,0,22584,12715,9869
50,12,123,Florida,Taylor County,7,1,1250,639,611
50,12,123,Florida,Taylor County,7,2,1262,655,607
50,12,123,Florida,Taylor County,7,3,1178,601,577
50,12,123,Florida,Taylor County,7,4,1032,551,481
50,12,123,Florida,Taylor County,7,5,1525,949,576
50,12,123,Florida,Taylor County,7,6,1796,1250,546
50,12,123,Florida,Taylor County,7,7,1454,944,510
50,12,123,Florida,Taylor County,7,8,1361,903,458
50,12,123,Florida,Taylor County,7,9,1479,932,547
50,12,123,Florida,Taylor County,7,10,1543,936,607
50,12,123,Florida,Taylor County,7,11,1600,893,707
50,12,123,Florida,Taylor County,7,12,1600,842,758
50,12,123,Florida,Taylor County,7,13,1459,755,704
50,12,123,Florida,Taylor County,7,14,1368,664,704
50,12,123,Florida,Taylor County,7,15,1036,496,540
50,12,123,Florida,Taylor County,7,16,782,362,420
50,12,123,Florida,Taylor County,7,17,480,196,284
50,12,123,Florida,Taylor County,7,18,379,147,232
50,12,123,Florida,Taylor County,8,0,22355,12543,9812
50,12,123,Florida,Taylor County,8,1,1218,630,588
50,12,123,Florida,Taylor County,8,2,1261,650,611
50,12,123,Florida,Taylor County,8,3,1162,598,564
50,12,123,Florida,Taylor County,8,4,1048,555,493
50,12,123,Florida,Taylor County,8,5,1435,890,545
50,12,123,Florida,Taylor County,8,6,1809,1244,565
50,12,123,Florida,Taylor County,8,7,1467,944,523
50,12,123,Florida,Taylor County,8,8,1332,866,466
50,12,123,Florida,Taylor County,8,9,1441,924,517
50,12,123,Florida,Taylor County,8,10,1483,897,586
50,12,123,Florida,Taylor County,8,11,1545,860,685
50,12,123,Florida,Taylor County,8,12,1571,823,748
50,12,123,Florida,Taylor County,8,13,1491,763,728
50,12,123,Florida,Taylor County,8,14,1362,660,702
50,12,123,Florida,Taylor County,8,15,1052,505,547
50,12,123,Florida,Taylor County,8,16,775,367,408
50,12,123,Florida,Taylor County,8,17,512,208,304
50,12,123,Florida,Taylor County,8,18,391,159,232
50,12,123,Florida,Taylor County,9,0,22099,12268,9831
50,12,123,Florida,Taylor County,9,1,1224,611,613
50,12,123,Florida,Taylor County,9,2,1273,634,639
50,12,123,Florida,Taylor County,9,3,1154,608,546
50,12,123,Florida,Taylor County,9,4,1054,554,500
50,12,123,Florida,Taylor County,9,5,1364,845,519
50,12,123,Florida,Taylor County,9,6,1783,1214,569
50,12,123,Florida,Taylor County,9,7,1442,909,533
50,12,123,Florida,Taylor County,9,8,1330,854,476
50,12,123,Florida,Taylor County,9,9,1375,864,511
50,12,123,Florida,Taylor County,9,10,1403,848,555
50,12,123,Florida,Taylor County,9,11,1483,820,663
50,12,123,Florida,Taylor County,9,12,1545,807,738
50,12,123,Florida,Taylor County,9,13,1464,749,715
50,12,123,Florida,Taylor County,9,14,1384,670,714
50,12,123,Florida,Taylor County,9,15,1111,535,576
50,12,123,Florida,Taylor County,9,16,762,350,412
50,12,123,Florida,Taylor County,9,17,536,231,305
50,12,123,Florida,Taylor County,9,18,412,165,247
50,12,123,Florida,Taylor County,10,0,21781,11919,9862
50,12,123,Florida,Taylor County,10,1,1181,579,602
50,12,123,Florida,Taylor County,10,2,1282,662,620
50,12,123,Florida,Taylor County,10,3,1164,583,581
50,12,123,Florida,Taylor County,10,4,1067,574,493
50,12,123,Florida,Taylor County,10,5,1242,758,484
50,12,123,Florida,Taylor County,10,6,1765,1148,617
50,12,123,Florida,Taylor County,10,7,1443,901,542
50,12,123,Florida,Taylor County,10,8,1262,804,458
50,12,123,Florida,Taylor County,10,9,1314,803,511
50,12,123,Florida,Taylor County,10,10,1342,797,545
50,12,123,Florida,Taylor County,10,11,1430,780,650
50,12,123,Florida,Taylor County,10,12,1495,780,715
50,12,123,Florida,Taylor County,10,13,1497,746,751
50,12,123,Florida,Taylor County,10,14,1354,664,690
50,12,123,Florida,Taylor County,10,15,1182,571,611
50,12,123,Florida,Taylor County,10,16,787,352,435
50,12,123,Florida,Taylor County,10,17,548,250,298
50,12,123,Florida,Taylor County,10,18,426,167,259
50,12,123,Florida,Taylor County,11,0,21545,11710,9835
50,12,123,Florida,Taylor County,11,1,1211,599,612
50,12,123,Florida,Taylor County,11,2,1239,642,597
50,12,123,Florida,Taylor County,11,3,1187,593,594
50,12,123,Florida,Taylor County,11,4,1029,547,482
50,12,123,Florida,Taylor County,11,5,1199,723,476
50,12,123,Florida,Taylor County,11,6,1706,1098,608
50,12,123,Florida,Taylor County,11,7,1438,904,534
50,12,123,Florida,Taylor County,11,8,1268,773,495
50,12,123,Florida,Taylor County,11,9,1248,763,485
50,12,123,Florida,Taylor County,11,10,1333,780,553
50,12,123,Florida,Taylor County,11,11,1371,745,626
50,12,123,Florida,Taylor County,11,12,1409,736,673
50,12,123,Florida,Taylor County,11,13,1484,731,753
50,12,123,Florida,Taylor County,11,14,1361,681,680
50,12,123,Florida,Taylor County,11,15,1217,577,640
50,12,123,Florida,Taylor County,11,16,825,379,446
50,12,123,Florida,Taylor County,11,17,578,261,317
50,12,123,Florida,Taylor County,11,18,442,178,264
50,12,123,Florida,Taylor County,12,0,21569,11713,9856
50,12,123,Florida,Taylor County,12,1,1165,570,595
50,12,123,Florida,Taylor County,12,2,1208,621,587
50,12,123,Florida,Taylor County,12,3,1210,611,599
50,12,123,Florida,Taylor County,12,4,1054,549,505
50,12,123,Florida,Taylor County,12,5,1186,725,461
50,12,123,Florida,Taylor County,12,6,1673,1081,592
50,12,123,Florida,Taylor County,12,7,1460,913,547
50,12,123,Florida,Taylor County,12,8,1326,788,538
50,12,123,Florida,Taylor County,12,9,1226,761,465
50,12,123,Florida,Taylor County,12,10,1350,809,541
50,12,123,Florida,Taylor County,12,11,1341,728,613
50,12,123,Florida,Taylor County,12,12,1389,713,676
50,12,123,Florida,Taylor County,12,13,1456,720,736
50,12,123,Florida,Taylor County,12,14,1380,697,683
50,12,123,Florida,Taylor County,12,15,1244,593,651
50,12,123,Florida,Taylor County,12,16,855,377,478
50,12,123,Florida,Taylor County,12,17,588,264,324
50,12,123,Florida,Taylor County,12,18,458,193,265
50,12,125,Florida,Union County,1,0,15535,10045,5490
50,12,125,Florida,Union County,1,1,827,430,397
50,12,125,Florida,Union County,1,2,769,390,379
50,12,125,Florida,Union County,1,3,880,443,437
50,12,125,Florida,Union County,1,4,896,506,390
50,12,125,Florida,Union County,1,5,1075,754,321
50,12,125,Florida,Union County,1,6,1276,897,379
50,12,125,Florida,Union County,1,7,1139,798,341
50,12,125,Florida,Union County,1,8,1123,761,362
50,12,125,Florida,Union County,1,9,1047,718,329
50,12,125,Florida,Union County,1,10,1266,830,436
50,12,125,Florida,Union County,1,11,1319,902,417
50,12,125,Florida,Union County,1,12,1325,976,349
50,12,125,Florida,Union County,1,13,1039,745,294
50,12,125,Florida,Union County,1,14,638,414,224
50,12,125,Florida,Union County,1,15,394,238,156
50,12,125,Florida,Union County,1,16,274,145,129
50,12,125,Florida,Union County,1,17,148,66,82
50,12,125,Florida,Union County,1,18,100,32,68
50,12,125,Florida,Union County,2,0,15535,10045,5490
50,12,125,Florida,Union County,2,1,827,430,397
50,12,125,Florida,Union County,2,2,769,390,379
50,12,125,Florida,Union County,2,3,880,443,437
50,12,125,Florida,Union County,2,4,896,506,390
50,12,125,Florida,Union County,2,5,1075,754,321
50,12,125,Florida,Union County,2,6,1276,897,379
50,12,125,Florida,Union County,2,7,1139,798,341
50,12,125,Florida,Union County,2,8,1123,761,362
50,12,125,Florida,Union County,2,9,1047,718,329
50,12,125,Florida,Union County,2,10,1266,830,436
50,12,125,Florida,Union County,2,11,1319,902,417
50,12,125,Florida,Union County,2,12,1325,976,349
50,12,125,Florida,Union County,2,13,1039,745,294
50,12,125,Florida,Union County,2,14,638,414,224
50,12,125,Florida,Union County,2,15,394,238,156
50,12,125,Florida,Union County,2,16,274,145,129
50,12,125,Florida,Union County,2,17,148,66,82
50,12,125,Florida,Union County,2,18,100,32,68
50,12,125,Florida,Union County,3,0,15542,10036,5506
50,12,125,Florida,Union County,3,1,824,429,395
50,12,125,Florida,Union County,3,2,776,398,378
50,12,125,Florida,Union County,3,3,878,441,437
50,12,125,Florida,Union County,3,4,889,499,390
50,12,125,Florida,Union County,3,5,1082,757,325
50,12,125,Florida,Union County,3,6,1269,891,378
50,12,125,Florida,Union County,3,7,1144,796,348
50,12,125,Florida,Union County,3,8,1112,753,359
50,12,125,Florida,Union County,3,9,1051,724,327
50,12,125,Florida,Union County,3,10,1257,825,432
50,12,125,Florida,Union County,3,11,1318,899,419
50,12,125,Florida,Union County,3,12,1321,974,347
50,12,125,Florida,Union County,3,13,1039,743,296
50,12,125,Florida,Union County,3,14,648,417,231
50,12,125,Florida,Union County,3,15,400,240,160
50,12,125,Florida,Union County,3,16,278,148,130
50,12,125,Florida,Union County,3,17,154,69,85
50,12,125,Florida,Union County,3,18,102,33,69
50,12,125,Florida,Union County,4,0,15302,9840,5462
50,12,125,Florida,Union County,4,1,790,379,411
50,12,125,Florida,Union County,4,2,752,385,367
50,12,125,Florida,Union County,4,3,885,438,447
50,12,125,Florida,Union County,4,4,866,486,380
50,12,125,Florida,Union County,4,5,1046,724,322
50,12,125,Florida,Union County,4,6,1221,871,350
50,12,125,Florida,Union County,4,7,1138,804,334
50,12,125,Florida,Union County,4,8,1072,722,350
50,12,125,Florida,Union County,4,9,1046,728,318
50,12,125,Florida,Union County,4,10,1193,785,408
50,12,125,Florida,Union County,4,11,1292,878,414
50,12,125,Florida,Union County,4,12,1315,962,353
50,12,125,Florida,Union County,4,13,1027,727,300
50,12,125,Florida,Union County,4,14,667,429,238
50,12,125,Florida,Union County,4,15,427,249,178
50,12,125,Florida,Union County,4,16,294,162,132
50,12,125,Florida,Union County,4,17,166,75,91
50,12,125,Florida,Union County,4,18,105,36,69
50,12,125,Florida,Union County,5,0,15255,9840,5415
50,12,125,Florida,Union County,5,1,800,386,414
50,12,125,Florida,Union County,5,2,770,392,378
50,12,125,Florida,Union County,5,3,834,413,421
50,12,125,Florida,Union County,5,4,876,500,376
50,12,125,Florida,Union County,5,5,1047,731,316
50,12,125,Florida,Union County,5,6,1190,859,331
50,12,125,Florida,Union County,5,7,1124,793,331
50,12,125,Florida,Union County,5,8,1039,701,338
50,12,125,Florida,Union County,5,9,1077,751,326
50,12,125,Florida,Union County,5,10,1140,752,388
50,12,125,Florida,Union County,5,11,1256,875,381
50,12,125,Florida,Union County,5,12,1328,962,366
50,12,125,Florida,Union County,5,13,970,695,275
50,12,125,Florida,Union County,5,14,735,462,273
50,12,125,Florida,Union County,5,15,451,261,190
50,12,125,Florida,Union County,5,16,324,184,140
50,12,125,Florida,Union County,5,17,181,80,101
50,12,125,Florida,Union County,5,18,113,43,70
50,12,125,Florida,Union County,6,0,15160,9816,5344
50,12,125,Florida,Union County,6,1,789,399,390
50,12,125,Florida,Union County,6,2,799,396,403
50,12,125,Florida,Union County,6,3,776,388,388
50,12,125,Florida,Union County,6,4,883,499,384
50,12,125,Florida,Union County,6,5,1011,710,301
50,12,125,Florida,Union County,6,6,1201,877,324
50,12,125,Florida,Union County,6,7,1136,807,329
50,12,125,Florida,Union County,6,8,1009,691,318
50,12,125,Florida,Union County,6,9,1047,732,315
50,12,125,Florida,Union County,6,10,1101,731,370
50,12,125,Florida,Union County,6,11,1253,870,383
50,12,125,Florida,Union County,6,12,1304,950,354
50,12,125,Florida,Union County,6,13,964,701,263
50,12,125,Florida,Union County,6,14,762,479,283
50,12,125,Florida,Union County,6,15,459,258,201
50,12,125,Florida,Union County,6,16,349,190,159
50,12,125,Florida,Union County,6,17,204,100,104
50,12,125,Florida,Union County,6,18,113,38,75
50,12,125,Florida,Union County,7,0,15258,9887,5371
50,12,125,Florida,Union County,7,1,841,420,421
50,12,125,Florida,Union County,7,2,797,396,401
50,12,125,Florida,Union County,7,3,769,383,386
50,12,125,Florida,Union County,7,4,866,488,378
50,12,125,Florida,Union County,7,5,1011,712,299
50,12,125,Florida,Union County,7,6,1214,900,314
50,12,125,Florida,Union County,7,7,1178,823,355
50,12,125,Florida,Union County,7,8,1004,693,311
50,12,125,Florida,Union County,7,9,1059,727,332
50,12,125,Florida,Union County,7,10,1014,712,302
50,12,125,Florida,Union County,7,11,1261,869,392
50,12,125,Florida,Union County,7,12,1291,941,350
50,12,125,Florida,Union County,7,13,975,705,270
50,12,125,Florida,Union County,7,14,775,492,283
50,12,125,Florida,Union County,7,15,508,277,231
50,12,125,Florida,Union County,7,16,364,198,166
50,12,125,Florida,Union County,7,17,216,104,112
50,12,125,Florida,Union County,7,18,115,47,68
50,12,125,Florida,Union County,8,0,15265,9929,5336
50,12,125,Florida,Union County,8,1,833,418,415
50,12,125,Florida,Union County,8,2,815,400,415
50,12,125,Florida,Union County,8,3,758,382,376
50,12,125,Florida,Union County,8,4,887,507,380
50,12,125,Florida,Union County,8,5,971,692,279
50,12,125,Florida,Union County,8,6,1225,912,313
50,12,125,Florida,Union County,8,7,1178,839,339
50,12,125,Florida,Union County,8,8,983,681,302
50,12,125,Florida,Union County,8,9,1080,750,330
50,12,125,Florida,Union County,8,10,970,691,279
50,12,125,Florida,Union County,8,11,1241,858,383
50,12,125,Florida,Union County,8,12,1289,945,344
50,12,125,Florida,Union County,8,13,1012,729,283
50,12,125,Florida,Union County,8,14,774,487,287
50,12,125,Florida,Union County,8,15,537,286,251
50,12,125,Florida,Union County,8,16,343,184,159
50,12,125,Florida,Union County,8,17,237,119,118
50,12,125,Florida,Union County,8,18,132,49,83
50,12,125,Florida,Union County,9,0,15238,9952,5286
50,12,125,Florida,Union County,9,1,795,409,386
50,12,125,Florida,Union County,9,2,816,394,422
50,12,125,Florida,Union County,9,3,787,408,379
50,12,125,Florida,Union County,9,4,849,486,363
50,12,125,Florida,Union County,9,5,977,696,281
50,12,125,Florida,Union County,9,6,1231,900,331
50,12,125,Florida,Union County,9,7,1143,832,311
50,12,125,Florida,Union County,9,8,1015,702,313
50,12,125,Florida,Union County,9,9,1044,738,306
50,12,125,Florida,Union County,9,10,980,707,273
50,12,125,Florida,Union County,9,11,1209,859,350
50,12,125,Florida,Union County,9,12,1285,946,339
50,12,125,Florida,Union County,9,13,1032,743,289
50,12,125,Florida,Union County,9,14,759,467,292
50,12,125,Florida,Union County,9,15,559,295,264
50,12,125,Florida,Union County,9,16,359,187,172
50,12,125,Florida,Union County,9,17,245,123,122
50,12,125,Florida,Union County,9,18,153,60,93
50,12,125,Florida,Union County,10,0,15448,10109,5339
50,12,125,Florida,Union County,10,1,799,413,386
50,12,125,Florida,Union County,10,2,796,377,419
50,12,125,Florida,Union County,10,3,817,424,393
50,12,125,Florida,Union County,10,4,839,477,362
50,12,125,Florida,Union County,10,5,1009,723,286
50,12,125,Florida,Union County,10,6,1230,910,320
50,12,125,Florida,Union County,10,7,1168,848,320
50,12,125,Florida,Union County,10,8,1040,728,312
50,12,125,Florida,Union County,10,9,1033,734,299
50,12,125,Florida,Union County,10,10,1025,739,286
50,12,125,Florida,Union County,10,11,1174,851,323
50,12,125,Florida,Union County,10,12,1305,973,332
50,12,125,Florida,Union County,10,13,1041,731,310
50,12,125,Florida,Union County,10,14,721,452,269
50,12,125,Florida,Union County,10,15,628,338,290
50,12,125,Florida,Union County,10,16,378,186,192
50,12,125,Florida,Union County,10,17,278,142,136
50,12,125,Florida,Union County,10,18,167,63,104
50,12,125,Florida,Union County,11,0,15328,10019,5309
50,12,125,Florida,Union County,11,1,798,430,368
50,12,125,Florida,Union County,11,2,790,392,398
50,12,125,Florida,Union County,11,3,862,434,428
50,12,125,Florida,Union County,11,4,813,464,349
50,12,125,Florida,Union County,11,5,1002,721,281
50,12,125,Florida,Union County,11,6,1218,902,316
50,12,125,Florida,Union County,11,7,1146,829,317
50,12,125,Florida,Union County,11,8,1060,745,315
50,12,125,Florida,Union County,11,9,1000,714,286
50,12,125,Florida,Union County,11,10,1034,735,299
50,12,125,Florida,Union County,11,11,1108,817,291
50,12,125,Florida,Union County,11,12,1255,932,323
50,12,125,Florida,Union County,11,13,994,705,289
50,12,125,Florida,Union County,11,14,728,456,272
50,12,125,Florida,Union County,11,15,651,344,307
50,12,125,Florida,Union County,11,16,383,180,203
50,12,125,Florida,Union County,11,17,311,147,164
50,12,125,Florida,Union County,11,18,175,72,103
50,12,125,Florida,Union County,12,0,15237,9843,5394
50,12,125,Florida,Union County,12,1,795,432,363
50,12,125,Florida,Union County,12,2,852,430,422
50,12,125,Florida,Union County,12,3,868,435,433
50,12,125,Florida,Union County,12,4,817,473,344
50,12,125,Florida,Union County,12,5,974,689,285
50,12,125,Florida,Union County,12,6,1177,868,309
50,12,125,Florida,Union County,12,7,1152,820,332
50,12,125,Florida,Union County,12,8,1047,720,327
50,12,125,Florida,Union County,12,9,971,690,281
50,12,125,Florida,Union County,12,10,1011,711,300
50,12,125,Florida,Union County,12,11,1062,782,280
50,12,125,Florida,Union County,12,12,1257,918,339
50,12,125,Florida,Union County,12,13,937,652,285
50,12,125,Florida,Union County,12,14,735,461,274
50,12,125,Florida,Union County,12,15,651,347,304
50,12,125,Florida,Union County,12,16,422,185,237
50,12,125,Florida,Union County,12,17,312,148,164
50,12,125,Florida,Union County,12,18,197,82,115
50,12,127,Florida,Volusia County,1,0,494593,241715,252878
50,12,127,Florida,Volusia County,1,1,24337,12398,11939
50,12,127,Florida,Volusia County,1,2,24819,12725,12094
50,12,127,Florida,Volusia County,1,3,26923,13689,13234
50,12,127,Florida,Volusia County,1,4,31095,16313,14782
50,12,127,Florida,Volusia County,1,5,30798,16323,14475
50,12,127,Florida,Volusia County,1,6,25952,13128,12824
50,12,127,Florida,Volusia County,1,7,24890,12515,12375
50,12,127,Florida,Volusia County,1,8,26838,13478,13360
50,12,127,Florida,Volusia County,1,9,29773,14881,14892
50,12,127,Florida,Volusia County,1,10,36408,17836,18572
50,12,127,Florida,Volusia County,1,11,37785,18263,19522
50,12,127,Florida,Volusia County,1,12,35429,16849,18580
50,12,127,Florida,Volusia County,1,13,35257,16794,18463
50,12,127,Florida,Volusia County,1,14,29761,14078,15683
50,12,127,Florida,Volusia County,1,15,24006,11281,12725
50,12,127,Florida,Volusia County,1,16,19810,9045,10765
50,12,127,Florida,Volusia County,1,17,16062,6818,9244
50,12,127,Florida,Volusia County,1,18,14650,5301,9349
50,12,127,Florida,Volusia County,2,0,494596,241718,252878
50,12,127,Florida,Volusia County,2,1,24337,12398,11939
50,12,127,Florida,Volusia County,2,2,24820,12725,12095
50,12,127,Florida,Volusia County,2,3,26923,13689,13234
50,12,127,Florida,Volusia County,2,4,31098,16315,14783
50,12,127,Florida,Volusia County,2,5,30798,16323,14475
50,12,127,Florida,Volusia County,2,6,25951,13127,12824
50,12,127,Florida,Volusia County,2,7,24888,12514,12374
50,12,127,Florida,Volusia County,2,8,26839,13478,13361
50,12,127,Florida,Volusia County,2,9,29774,14882,14892
50,12,127,Florida,Volusia County,2,10,36406,17835,18571
50,12,127,Florida,Volusia County,2,11,37783,18263,19520
50,12,127,Florida,Volusia County,2,12,35429,16849,18580
50,12,127,Florida,Volusia County,2,13,35259,16796,18463
50,12,127,Florida,Volusia County,2,14,29762,14079,15683
50,12,127,Florida,Volusia County,2,15,24006,11281,12725
50,12,127,Florida,Volusia County,2,16,19810,9045,10765
50,12,127,Florida,Volusia County,2,17,16063,6818,9245
50,12,127,Florida,Volusia County,2,18,14650,5301,9349
50,12,127,Florida,Volusia County,3,0,494440,241582,252858
50,12,127,Florida,Volusia County,3,1,24279,12374,11905
50,12,127,Florida,Volusia County,3,2,24699,12666,12033
50,12,127,Florida,Volusia County,3,3,26850,13660,13190
50,12,127,Florida,Volusia County,3,4,30676,16085,14591
50,12,127,Florida,Volusia County,3,5,31069,16421,14648
50,12,127,Florida,Volusia County,3,6,26045,13198,12847
50,12,127,Florida,Volusia County,3,7,24926,12531,12395
50,12,127,Florida,Volusia County,3,8,26590,13326,13264
50,12,127,Florida,Volusia County,3,9,29630,14822,14808
50,12,127,Florida,Volusia County,3,10,36101,17667,18434
50,12,127,Florida,Volusia County,3,11,37857,18305,19552
50,12,127,Florida,Volusia County,3,12,35628,16957,18671
50,12,127,Florida,Volusia County,3,13,35499,16903,18596
50,12,127,Florida,Volusia County,3,14,29869,14124,15745
50,12,127,Florida,Volusia County,3,15,24086,11312,12774
50,12,127,Florida,Volusia County,3,16,19790,9037,10753
50,12,127,Florida,Volusia County,3,17,16050,6824,9226
50,12,127,Florida,Volusia County,3,18,14796,5370,9426
50,12,127,Florida,Volusia County,4,0,494464,241293,253171
50,12,127,Florida,Volusia County,4,1,23938,12255,11683
50,12,127,Florida,Volusia County,4,2,24346,12406,11940
50,12,127,Florida,Volusia County,4,3,26798,13633,13165
50,12,127,Florida,Volusia County,4,4,29439,15413,14026
50,12,127,Florida,Volusia County,4,5,32074,16806,15268
50,12,127,Florida,Volusia County,4,6,26339,13503,12836
50,12,127,Florida,Volusia County,4,7,25143,12587,12556
50,12,127,Florida,Volusia County,4,8,25386,12630,12756
50,12,127,Florida,Volusia County,4,9,29362,14729,14633
50,12,127,Florida,Volusia County,4,10,34643,16928,17715
50,12,127,Florida,Volusia County,4,11,38047,18360,19687
50,12,127,Florida,Volusia County,4,12,36178,17210,18968
50,12,127,Florida,Volusia County,4,13,36684,17405,19279
50,12,127,Florida,Volusia County,4,14,30364,14385,15979
50,12,127,Florida,Volusia County,4,15,24669,11600,13069
50,12,127,Florida,Volusia County,4,16,19791,9017,10774
50,12,127,Florida,Volusia County,4,17,15935,6818,9117
50,12,127,Florida,Volusia County,4,18,15328,5608,9720
50,12,127,Florida,Volusia County,5,0,496535,241750,254785
50,12,127,Florida,Volusia County,5,1,23824,12164,11660
50,12,127,Florida,Volusia County,5,2,24544,12414,12130
50,12,127,Florida,Volusia County,5,3,26343,13477,12866
50,12,127,Florida,Volusia County,5,4,28812,15026,13786
50,12,127,Florida,Volusia County,5,5,32448,16852,15596
50,12,127,Florida,Volusia County,5,6,26774,13763,13011
50,12,127,Florida,Volusia County,5,7,25454,12732,12722
50,12,127,Florida,Volusia County,5,8,24846,12222,12624
50,12,127,Florida,Volusia County,5,9,29166,14581,14585
50,12,127,Florida,Volusia County,5,10,33309,16290,17019
50,12,127,Florida,Volusia County,5,11,38023,18272,19751
50,12,127,Florida,Volusia County,5,12,36979,17521,19458
50,12,127,Florida,Volusia County,5,13,35956,16948,19008
50,12,127,Florida,Volusia County,5,14,32843,15628,17215
50,12,127,Florida,Volusia County,5,15,25683,12116,13567
50,12,127,Florida,Volusia County,5,16,19924,9023,10901
50,12,127,Florida,Volusia County,5,17,15887,6879,9008
50,12,127,Florida,Volusia County,5,18,15720,5842,9878
50,12,127,Florida,Volusia County,6,0,500438,243709,256729
50,12,127,Florida,Volusia County,6,1,23721,11985,11736
50,12,127,Florida,Volusia County,6,2,24808,12575,12233
50,12,127,Florida,Volusia County,6,3,25817,13176,12641
50,12,127,Florida,Volusia County,6,4,28893,15086,13807
50,12,127,Florida,Volusia County,6,5,32289,16677,15612
50,12,127,Florida,Volusia County,6,6,27887,14481,13406
50,12,127,Florida,Volusia County,6,7,25715,12868,12847
50,12,127,Florida,Volusia County,6,8,24791,12225,12566
50,12,127,Florida,Volusia County,6,9,28718,14391,14327
50,12,127,Florida,Volusia County,6,10,32104,15677,16427
50,12,127,Florida,Volusia County,6,11,37786,18228,19558
50,12,127,Florida,Volusia County,6,12,37939,17885,20054
50,12,127,Florida,Volusia County,6,13,36347,17096,19251
50,12,127,Florida,Volusia County,6,14,34004,16219,17785
50,12,127,Florida,Volusia County,6,15,27229,12847,14382
50,12,127,Florida,Volusia County,6,16,20417,9308,11109
50,12,127,Florida,Volusia County,6,17,15869,6925,8944
50,12,127,Florida,Volusia County,6,18,16104,6060,10044
50,12,127,Florida,Volusia County,7,0,506715,246838,259877
50,12,127,Florida,Volusia County,7,1,23894,12075,11819
50,12,127,Florida,Volusia County,7,2,25151,12790,12361
50,12,127,Florida,Volusia County,7,3,25737,13121,12616
50,12,127,Florida,Volusia County,7,4,28905,15022,13883
50,12,127,Florida,Volusia County,7,5,31765,16373,15392
50,12,127,Florida,Volusia County,7,6,29346,15226,14120
50,12,127,Florida,Volusia County,7,7,26114,13086,13028
50,12,127,Florida,Volusia County,7,8,25184,12524,12660
50,12,127,Florida,Volusia County,7,9,28503,14191,14312
50,12,127,Florida,Volusia County,7,10,31361,15384,15977
50,12,127,Florida,Volusia County,7,11,38019,18362,19657
50,12,127,Florida,Volusia County,7,12,38477,18203,20274
50,12,127,Florida,Volusia County,7,13,37088,17385,19703
50,12,127,Florida,Volusia County,7,14,35777,17100,18677
50,12,127,Florida,Volusia County,7,15,28311,13286,15025
50,12,127,Florida,Volusia County,7,16,21074,9644,11430
50,12,127,Florida,Volusia County,7,17,15714,6906,8808
50,12,127,Florida,Volusia County,7,18,16295,6160,10135
50,12,127,Florida,Volusia County,8,0,516730,251988,264742
50,12,127,Florida,Volusia County,8,1,24443,12253,12190
50,12,127,Florida,Volusia County,8,2,25685,13127,12558
50,12,127,Florida,Volusia County,8,3,25894,13261,12633
50,12,127,Florida,Volusia County,8,4,29216,15149,14067
50,12,127,Florida,Volusia County,8,5,31279,16129,15150
50,12,127,Florida,Volusia County,8,6,31038,16168,14870
50,12,127,Florida,Volusia County,8,7,26850,13521,13329
50,12,127,Florida,Volusia County,8,8,26116,13031,13085
50,12,127,Florida,Volusia County,8,9,28029,13882,14147
50,12,127,Florida,Volusia County,8,10,31093,15408,15685
50,12,127,Florida,Volusia County,8,11,37991,18182,19809
50,12,127,Florida,Volusia County,8,12,39409,18625,20784
50,12,127,Florida,Volusia County,8,13,38345,18027,20318
50,12,127,Florida,Volusia County,8,14,37727,17959,19768
50,12,127,Florida,Volusia County,8,15,29539,13884,15655
50,12,127,Florida,Volusia County,8,16,21669,10038,11631
50,12,127,Florida,Volusia County,8,17,15885,7050,8835
50,12,127,Florida,Volusia County,8,18,16522,6294,10228
50,12,127,Florida,Volusia County,9,0,528453,257653,270800
50,12,127,Florida,Volusia County,9,1,25120,12561,12559
50,12,127,Florida,Volusia County,9,2,26013,13277,12736
50,12,127,Florida,Volusia County,9,3,26138,13371,12767
50,12,127,Florida,Volusia County,9,4,29849,15608,14241
50,12,127,Florida,Volusia County,9,5,31184,16006,15178
50,12,127,Florida,Volusia County,9,6,32725,16941,15784
50,12,127,Florida,Volusia County,9,7,28033,14212,13821
50,12,127,Florida,Volusia County,9,8,27195,13588,13607
50,12,127,Florida,Volusia County,9,9,27693,13631,14062
50,12,127,Florida,Volusia County,9,10,31503,15666,15837
50,12,127,Florida,Volusia County,9,11,37252,17764,19488
50,12,127,Florida,Volusia County,9,12,40600,19156,21444
50,12,127,Florida,Volusia County,9,13,39518,18607,20911
50,12,127,Florida,Volusia County,9,14,39648,18768,20880
50,12,127,Florida,Volusia County,9,15,30538,14413,16125
50,12,127,Florida,Volusia County,9,16,22404,10359,12045
50,12,127,Florida,Volusia County,9,17,16092,7130,8962
50,12,127,Florida,Volusia County,9,18,16948,6595,10353
50,12,127,Florida,Volusia County,10,0,537868,262165,275703
50,12,127,Florida,Volusia County,10,1,25526,12867,12659
50,12,127,Florida,Volusia County,10,2,26364,13457,12907
50,12,127,Florida,Volusia County,10,3,26749,13727,13022
50,12,127,Florida,Volusia County,10,4,29767,15559,14208
50,12,127,Florida,Volusia County,10,5,31173,16046,15127
50,12,127,Florida,Volusia County,10,6,33552,17207,16345
50,12,127,Florida,Volusia County,10,7,28939,14732,14207
50,12,127,Florida,Volusia County,10,8,28207,14102,14105
50,12,127,Florida,Volusia County,10,9,27692,13641,14051
50,12,127,Florida,Volusia County,10,10,31782,15716,16066
50,12,127,Florida,Volusia County,10,11,36297,17345,18952
50,12,127,Florida,Volusia County,10,12,41455,19555,21900
50,12,127,Florida,Volusia County,10,13,40826,19079,21747
50,12,127,Florida,Volusia County,10,14,39337,18538,20799
50,12,127,Florida,Volusia County,10,15,33314,15799,17515
50,12,127,Florida,Volusia County,10,16,23481,10922,12559
50,12,127,Florida,Volusia County,10,17,16293,7131,9162
50,12,127,Florida,Volusia County,10,18,17114,6742,10372
50,12,127,Florida,Volusia County,11,0,546101,266310,279791
50,12,127,Florida,Volusia County,11,1,25769,13070,12699
50,12,127,Florida,Volusia County,11,2,26476,13454,13022
50,12,127,Florida,Volusia County,11,3,27411,14061,13350
50,12,127,Florida,Volusia County,11,4,29601,15520,14081
50,12,127,Florida,Volusia County,11,5,31106,15998,15108
50,12,127,Florida,Volusia County,11,6,33938,17390,16548
50,12,127,Florida,Volusia County,11,7,30348,15540,14808
50,12,127,Florida,Volusia County,11,8,29010,14510,14500
50,12,127,Florida,Volusia County,11,9,28066,13839,14227
50,12,127,Florida,Volusia County,11,10,31871,15783,16088
50,12,127,Florida,Volusia County,11,11,35435,16937,18498
50,12,127,Florida,Volusia County,11,12,41802,19737,22065
50,12,127,Florida,Volusia County,11,13,41837,19501,22336
50,12,127,Florida,Volusia County,11,14,39928,18750,21178
50,12,127,Florida,Volusia County,11,15,34692,16516,18176
50,12,127,Florida,Volusia County,11,16,25041,11687,13354
50,12,127,Florida,Volusia County,11,17,16703,7280,9423
50,12,127,Florida,Volusia County,11,18,17067,6737,10330
50,12,127,Florida,Volusia County,12,0,553284,269803,283481
50,12,127,Florida,Volusia County,12,1,25844,13148,12696
50,12,127,Florida,Volusia County,12,2,26728,13571,13157
50,12,127,Florida,Volusia County,12,3,27668,14163,13505
50,12,127,Florida,Volusia County,12,4,29573,15467,14106
50,12,127,Florida,Volusia County,12,5,30963,15970,14993
50,12,127,Florida,Volusia County,12,6,33579,17268,16311
50,12,127,Florida,Volusia County,12,7,31837,16267,15570
50,12,127,Florida,Volusia County,12,8,29520,14771,14749
50,12,127,Florida,Volusia County,12,9,28510,14107,14403
50,12,127,Florida,Volusia County,12,10,31609,15606,16003
50,12,127,Florida,Volusia County,12,11,34744,16656,18088
50,12,127,Florida,Volusia County,12,12,41952,19787,22165
50,12,127,Florida,Volusia County,12,13,42946,20062,22884
50,12,127,Florida,Volusia County,12,14,40920,19162,21758
50,12,127,Florida,Volusia County,12,15,36561,17367,19194
50,12,127,Florida,Volusia County,12,16,25972,12037,13935
50,12,127,Florida,Volusia County,12,17,17375,7642,9733
50,12,127,Florida,Volusia County,12,18,16983,6752,10231
50,12,129,Florida,Wakulla County,1,0,30776,16992,13784
50,12,129,Florida,Wakulla County,1,1,1740,904,836
50,12,129,Florida,Wakulla County,1,2,2000,1074,926
50,12,129,Florida,Wakulla County,1,3,1951,1050,901
50,12,129,Florida,Wakulla County,1,4,1905,965,940
50,12,129,Florida,Wakulla County,1,5,1770,999,771
50,12,129,Florida,Wakulla County,1,6,2099,1282,817
50,12,129,Florida,Wakulla County,1,7,2177,1326,851
50,12,129,Florida,Wakulla County,1,8,2384,1388,996
50,12,129,Florida,Wakulla County,1,9,2394,1439,955
50,12,129,Florida,Wakulla County,1,10,2681,1535,1146
50,12,129,Florida,Wakulla County,1,11,2486,1367,1119
50,12,129,Florida,Wakulla County,1,12,2072,1097,975
50,12,129,Florida,Wakulla County,1,13,1778,948,830
50,12,129,Florida,Wakulla County,1,14,1256,646,610
50,12,129,Florida,Wakulla County,1,15,867,421,446
50,12,129,Florida,Wakulla County,1,16,580,283,297
50,12,129,Florida,Wakulla County,1,17,378,163,215
50,12,129,Florida,Wakulla County,1,18,258,105,153
50,12,129,Florida,Wakulla County,2,0,30783,16996,13787
50,12,129,Florida,Wakulla County,2,1,1740,904,836
50,12,129,Florida,Wakulla County,2,2,2002,1075,927
50,12,129,Florida,Wakulla County,2,3,1952,1051,901
50,12,129,Florida,Wakulla County,2,4,1905,965,940
50,12,129,Florida,Wakulla County,2,5,1770,999,771
50,12,129,Florida,Wakulla County,2,6,2099,1282,817
50,12,129,Florida,Wakulla County,2,7,2179,1327,852
50,12,129,Florida,Wakulla County,2,8,2384,1388,996
50,12,129,Florida,Wakulla County,2,9,2394,1439,955
50,12,129,Florida,Wakulla County,2,10,2681,1535,1146
50,12,129,Florida,Wakulla County,2,11,2488,1368,1120
50,12,129,Florida,Wakulla County,2,12,2072,1097,975
50,12,129,Florida,Wakulla County,2,13,1778,948,830
50,12,129,Florida,Wakulla County,2,14,1256,646,610
50,12,129,Florida,Wakulla County,2,15,867,421,446
50,12,129,Florida,Wakulla County,2,16,580,283,297
50,12,129,Florida,Wakulla County,2,17,378,163,215
50,12,129,Florida,Wakulla County,2,18,258,105,153
50,12,129,Florida,Wakulla County,3,0,30825,17032,13793
50,12,129,Florida,Wakulla County,3,1,1725,897,828
50,12,129,Florida,Wakulla County,3,2,1985,1064,921
50,12,129,Florida,Wakulla County,3,3,1955,1052,903
50,12,129,Florida,Wakulla County,3,4,1893,965,928
50,12,129,Florida,Wakulla County,3,5,1794,1014,780
50,12,129,Florida,Wakulla County,3,6,2101,1289,812
50,12,129,Florida,Wakulla County,3,7,2192,1333,859
50,12,129,Florida,Wakulla County,3,8,2380,1391,989
50,12,129,Florida,Wakulla County,3,9,2394,1440,954
50,12,129,Florida,Wakulla County,3,10,2667,1523,1144
50,12,129,Florida,Wakulla County,3,11,2501,1373,1128
50,12,129,Florida,Wakulla County,3,12,2087,1104,983
50,12,129,Florida,Wakulla County,3,13,1788,952,836
50,12,129,Florida,Wakulla County,3,14,1277,661,616
50,12,129,Florida,Wakulla County,3,15,866,424,442
50,12,129,Florida,Wakulla County,3,16,581,280,301
50,12,129,Florida,Wakulla County,3,17,377,167,210
50,12,129,Florida,Wakulla County,3,18,262,103,159
50,12,129,Florida,Wakulla County,4,0,30973,17111,13862
50,12,129,Florida,Wakulla County,4,1,1719,877,842
50,12,129,Florida,Wakulla County,4,2,1920,1056,864
50,12,129,Florida,Wakulla County,4,3,1990,1075,915
50,12,129,Florida,Wakulla County,4,4,1845,957,888
50,12,129,Florida,Wakulla County,4,5,1815,1025,790
50,12,129,Florida,Wakulla County,4,6,2083,1277,806
50,12,129,Florida,Wakulla County,4,7,2237,1347,890
50,12,129,Florida,Wakulla County,4,8,2309,1353,956
50,12,129,Florida,Wakulla County,4,9,2400,1452,948
50,12,129,Florida,Wakulla County,4,10,2597,1492,1105
50,12,129,Florida,Wakulla County,4,11,2529,1371,1158
50,12,129,Florida,Wakulla County,4,12,2127,1121,1006
50,12,129,Florida,Wakulla County,4,13,1884,995,889
50,12,129,Florida,Wakulla County,4,14,1361,719,642
50,12,129,Florida,Wakulla County,4,15,908,445,463
50,12,129,Florida,Wakulla County,4,16,585,273,312
50,12,129,Florida,Wakulla County,4,17,389,179,210
50,12,129,Florida,Wakulla County,4,18,275,97,178
50,12,129,Florida,Wakulla County,5,0,30859,16979,13880
50,12,129,Florida,Wakulla County,5,1,1689,860,829
50,12,129,Florida,Wakulla County,5,2,1879,1033,846
50,12,129,Florida,Wakulla County,5,3,1996,1068,928
50,12,129,Florida,Wakulla County,5,4,1768,930,838
50,12,129,Florida,Wakulla County,5,5,1822,1026,796
50,12,129,Florida,Wakulla County,5,6,2102,1263,839
50,12,129,Florida,Wakulla County,5,7,2249,1343,906
50,12,129,Florida,Wakulla County,5,8,2189,1268,921
50,12,129,Florida,Wakulla County,5,9,2400,1436,964
50,12,129,Florida,Wakulla County,5,10,2508,1465,1043
50,12,129,Florida,Wakulla County,5,11,2469,1346,1123
50,12,129,Florida,Wakulla County,5,12,2151,1107,1044
50,12,129,Florida,Wakulla County,5,13,1862,991,871
50,12,129,Florida,Wakulla County,5,14,1498,767,731
50,12,129,Florida,Wakulla County,5,15,958,484,474
50,12,129,Florida,Wakulla County,5,16,623,296,327
50,12,129,Florida,Wakulla County,5,17,418,189,229
50,12,129,Florida,Wakulla County,5,18,278,107,171
50,12,129,Florida,Wakulla County,6,0,31004,17173,13831
50,12,129,Florida,Wakulla County,6,1,1613,818,795
50,12,129,Florida,Wakulla County,6,2,1874,1009,865
50,12,129,Florida,Wakulla County,6,3,1922,1025,897
50,12,129,Florida,Wakulla County,6,4,1703,917,786
50,12,129,Florida,Wakulla County,6,5,1851,1034,817
50,12,129,Florida,Wakulla County,6,6,2181,1353,828
50,12,129,Florida,Wakulla County,6,7,2292,1408,884
50,12,129,Florida,Wakulla County,6,8,2176,1280,896
50,12,129,Florida,Wakulla County,6,9,2448,1453,995
50,12,129,Florida,Wakulla County,6,10,2438,1488,950
50,12,129,Florida,Wakulla County,6,11,2447,1332,1115
50,12,129,Florida,Wakulla County,6,12,2221,1147,1074
50,12,129,Florida,Wakulla County,6,13,1832,957,875
50,12,129,Florida,Wakulla County,6,14,1586,826,760
50,12,129,Florida,Wakulla County,6,15,1041,521,520
50,12,129,Florida,Wakulla County,6,16,661,309,352
50,12,129,Florida,Wakulla County,6,17,441,200,241
50,12,129,Florida,Wakulla County,6,18,277,96,181
50,12,129,Florida,Wakulla County,7,0,31416,17412,14004
50,12,129,Florida,Wakulla County,7,1,1621,833,788
50,12,129,Florida,Wakulla County,7,2,1816,955,861
50,12,129,Florida,Wakulla County,7,3,1970,1058,912
50,12,129,Florida,Wakulla County,7,4,1742,939,803
50,12,129,Florida,Wakulla County,7,5,1807,1034,773
50,12,129,Florida,Wakulla County,7,6,2262,1384,878
50,12,129,Florida,Wakulla County,7,7,2260,1406,854
50,12,129,Florida,Wakulla County,7,8,2197,1299,898
50,12,129,Florida,Wakulla County,7,9,2465,1460,1005
50,12,129,Florida,Wakulla County,7,10,2436,1495,941
50,12,129,Florida,Wakulla County,7,11,2494,1366,1128
50,12,129,Florida,Wakulla County,7,12,2295,1203,1092
50,12,129,Florida,Wakulla County,7,13,1858,953,905
50,12,129,Florida,Wakulla County,7,14,1663,857,806
50,12,129,Florida,Wakulla County,7,15,1091,537,554
50,12,129,Florida,Wakulla County,7,16,706,325,381
50,12,129,Florida,Wakulla County,7,17,417,194,223
50,12,129,Florida,Wakulla County,7,18,316,114,202
50,12,129,Florida,Wakulla County,8,0,31523,17346,14177
50,12,129,Florida,Wakulla County,8,1,1682,834,848
50,12,129,Florida,Wakulla County,8,2,1775,942,833
50,12,129,Florida,Wakulla County,8,3,1960,1018,942
50,12,129,Florida,Wakulla County,8,4,1796,972,824
50,12,129,Florida,Wakulla County,8,5,1730,1004,726
50,12,129,Florida,Wakulla County,8,6,2320,1399,921
50,12,129,Florida,Wakulla County,8,7,2204,1351,853
50,12,129,Florida,Wakulla County,8,8,2213,1322,891
50,12,129,Florida,Wakulla County,8,9,2354,1362,992
50,12,129,Florida,Wakulla County,8,10,2432,1509,923
50,12,129,Florida,Wakulla County,8,11,2438,1335,1103
50,12,129,Florida,Wakulla County,8,12,2347,1214,1133
50,12,129,Florida,Wakulla County,8,13,1885,952,933
50,12,129,Florida,Wakulla County,8,14,1699,869,830
50,12,129,Florida,Wakulla County,8,15,1201,608,593
50,12,129,Florida,Wakulla County,8,16,742,344,398
50,12,129,Florida,Wakulla County,8,17,398,173,225
50,12,129,Florida,Wakulla County,8,18,347,138,209
50,12,129,Florida,Wakulla County,9,0,31882,17427,14455
50,12,129,Florida,Wakulla County,9,1,1723,854,869
50,12,129,Florida,Wakulla County,9,2,1817,930,887
50,12,129,Florida,Wakulla County,9,3,2028,1083,945
50,12,129,Florida,Wakulla County,9,4,1847,963,884
50,12,129,Florida,Wakulla County,9,5,1648,963,685
50,12,129,Florida,Wakulla County,9,6,2306,1377,929
50,12,129,Florida,Wakulla County,9,7,2217,1353,864
50,12,129,Florida,Wakulla County,9,8,2268,1348,920
50,12,129,Florida,Wakulla County,9,9,2301,1310,991
50,12,129,Florida,Wakulla County,9,10,2428,1501,927
50,12,129,Florida,Wakulla County,9,11,2365,1296,1069
50,12,129,Florida,Wakulla County,9,12,2377,1234,1143
50,12,129,Florida,Wakulla County,9,13,1969,960,1009
50,12,129,Florida,Wakulla County,9,14,1731,883,848
50,12,129,Florida,Wakulla County,9,15,1285,666,619
50,12,129,Florida,Wakulla County,9,16,775,375,400
50,12,129,Florida,Wakulla County,9,17,424,196,228
50,12,129,Florida,Wakulla County,9,18,373,135,238
50,12,129,Florida,Wakulla County,10,0,32050,17315,14735
50,12,129,Florida,Wakulla County,10,1,1759,873,886
50,12,129,Florida,Wakulla County,10,2,1812,919,893
50,12,129,Florida,Wakulla County,10,3,2043,1117,926
50,12,129,Florida,Wakulla County,10,4,1908,988,920
50,12,129,Florida,Wakulla County,10,5,1578,902,676
50,12,129,Florida,Wakulla County,10,6,2185,1308,877
50,12,129,Florida,Wakulla County,10,7,2278,1345,933
50,12,129,Florida,Wakulla County,10,8,2243,1312,931
50,12,129,Florida,Wakulla County,10,9,2256,1258,998
50,12,129,Florida,Wakulla County,10,10,2438,1458,980
50,12,129,Florida,Wakulla County,10,11,2368,1296,1072
50,12,129,Florida,Wakulla County,10,12,2299,1200,1099
50,12,129,Florida,Wakulla County,10,13,2068,985,1083
50,12,129,Florida,Wakulla County,10,14,1754,894,860
50,12,129,Florida,Wakulla County,10,15,1407,706,701
50,12,129,Florida,Wakulla County,10,16,821,395,426
50,12,129,Florida,Wakulla County,10,17,455,217,238
50,12,129,Florida,Wakulla County,10,18,378,142,236
50,12,129,Florida,Wakulla County,11,0,32413,17306,15107
50,12,129,Florida,Wakulla County,11,1,1793,885,908
50,12,129,Florida,Wakulla County,11,2,1820,939,881
50,12,129,Florida,Wakulla County,11,3,2094,1105,989
50,12,129,Florida,Wakulla County,11,4,1916,1006,910
50,12,129,Florida,Wakulla County,11,5,1579,900,679
50,12,129,Florida,Wakulla County,11,6,2152,1256,896
50,12,129,Florida,Wakulla County,11,7,2279,1334,945
50,12,129,Florida,Wakulla County,11,8,2279,1316,963
50,12,129,Florida,Wakulla County,11,9,2156,1180,976
50,12,129,Florida,Wakulla County,11,10,2454,1423,1031
50,12,129,Florida,Wakulla County,11,11,2315,1256,1059
50,12,129,Florida,Wakulla County,11,12,2321,1193,1128
50,12,129,Florida,Wakulla County,11,13,2176,1039,1137
50,12,129,Florida,Wakulla County,11,14,1796,890,906
50,12,129,Florida,Wakulla County,11,15,1491,758,733
50,12,129,Florida,Wakulla County,11,16,902,441,461
50,12,129,Florida,Wakulla County,11,17,497,234,263
50,12,129,Florida,Wakulla County,11,18,393,151,242
50,12,129,Florida,Wakulla County,12,0,33739,18239,15500
50,12,129,Florida,Wakulla County,12,1,1759,888,871
50,12,129,Florida,Wakulla County,12,2,1860,941,919
50,12,129,Florida,Wakulla County,12,3,2090,1072,1018
50,12,129,Florida,Wakulla County,12,4,1934,1022,912
50,12,129,Florida,Wakulla County,12,5,1680,989,691
50,12,129,Florida,Wakulla County,12,6,2213,1338,875
50,12,129,Florida,Wakulla County,12,7,2499,1467,1032
50,12,129,Florida,Wakulla County,12,8,2392,1420,972
50,12,129,Florida,Wakulla County,12,9,2291,1312,979
50,12,129,Florida,Wakulla County,12,10,2586,1516,1070
50,12,129,Florida,Wakulla County,12,11,2347,1321,1026
50,12,129,Florida,Wakulla County,12,12,2479,1264,1215
50,12,129,Florida,Wakulla County,12,13,2243,1088,1155
50,12,129,Florida,Wakulla County,12,14,1878,922,956
50,12,129,Florida,Wakulla County,12,15,1592,803,789
50,12,129,Florida,Wakulla County,12,16,960,470,490
50,12,129,Florida,Wakulla County,12,17,529,242,287
50,12,129,Florida,Wakulla County,12,18,407,164,243
50,12,131,Florida,Walton County,1,0,55043,28177,26866
50,12,131,Florida,Walton County,1,1,3355,1771,1584
50,12,131,Florida,Walton County,1,2,3159,1556,1603
50,12,131,Florida,Walton County,1,3,2916,1521,1395
50,12,131,Florida,Walton County,1,4,3124,1686,1438
50,12,131,Florida,Walton County,1,5,2945,1567,1378
50,12,131,Florida,Walton County,1,6,3556,1977,1579
50,12,131,Florida,Walton County,1,7,3382,1851,1531
50,12,131,Florida,Walton County,1,8,3574,1935,1639
50,12,131,Florida,Walton County,1,9,3542,1885,1657
50,12,131,Florida,Walton County,1,10,4294,2187,2107
50,12,131,Florida,Walton County,1,11,4420,2207,2213
50,12,131,Florida,Walton County,1,12,3967,1956,2011
50,12,131,Florida,Walton County,1,13,3866,1894,1972
50,12,131,Florida,Walton County,1,14,3154,1579,1575
50,12,131,Florida,Walton County,1,15,2304,1102,1202
50,12,131,Florida,Walton County,1,16,1567,749,818
50,12,131,Florida,Walton County,1,17,1063,449,614
50,12,131,Florida,Walton County,1,18,855,305,550
50,12,131,Florida,Walton County,2,0,55046,28180,26866
50,12,131,Florida,Walton County,2,1,3355,1771,1584
50,12,131,Florida,Walton County,2,2,3159,1556,1603
50,12,131,Florida,Walton County,2,3,2916,1521,1395
50,12,131,Florida,Walton County,2,4,3124,1686,1438
50,12,131,Florida,Walton County,2,5,2945,1567,1378
50,12,131,Florida,Walton County,2,6,3556,1977,1579
50,12,131,Florida,Walton County,2,7,3382,1851,1531
50,12,131,Florida,Walton County,2,8,3574,1935,1639
50,12,131,Florida,Walton County,2,9,3545,1887,1658
50,12,131,Florida,Walton County,2,10,4294,2187,2107
50,12,131,Florida,Walton County,2,11,4421,2208,2213
50,12,131,Florida,Walton County,2,12,3967,1956,2011
50,12,131,Florida,Walton County,2,13,3866,1894,1972
50,12,131,Florida,Walton County,2,14,3154,1579,1575
50,12,131,Florida,Walton County,2,15,2304,1102,1202
50,12,131,Florida,Walton County,2,16,1567,749,818
50,12,131,Florida,Walton County,2,17,1062,449,613
50,12,131,Florida,Walton County,2,18,855,305,550
50,12,131,Florida,Walton County,3,0,55217,28269,26948
50,12,131,Florida,Walton County,3,1,3319,1748,1571
50,12,131,Florida,Walton County,3,2,3162,1561,1601
50,12,131,Florida,Walton County,3,3,2939,1526,1413
50,12,131,Florida,Walton County,3,4,3058,1658,1400
50,12,131,Florida,Walton County,3,5,3001,1596,1405
50,12,131,Florida,Walton County,3,6,3572,1983,1589
50,12,131,Florida,Walton County,3,7,3399,1856,1543
50,12,131,Florida,Walton County,3,8,3563,1923,1640
50,12,131,Florida,Walton County,3,9,3567,1912,1655
50,12,131,Florida,Walton County,3,10,4277,2179,2098
50,12,131,Florida,Walton County,3,11,4448,2220,2228
50,12,131,Florida,Walton County,3,12,4001,1971,2030
50,12,131,Florida,Walton County,3,13,3888,1915,1973
50,12,131,Florida,Walton County,3,14,3182,1589,1593
50,12,131,Florida,Walton County,3,15,2322,1118,1204
50,12,131,Florida,Walton County,3,16,1576,750,826
50,12,131,Florida,Walton County,3,17,1082,458,624
50,12,131,Florida,Walton County,3,18,861,306,555
50,12,131,Florida,Walton County,4,0,55602,28483,27119
50,12,131,Florida,Walton County,4,1,3197,1655,1542
50,12,131,Florida,Walton County,4,2,3186,1586,1600
50,12,131,Florida,Walton County,4,3,2987,1546,1441
50,12,131,Florida,Walton County,4,4,2943,1653,1290
50,12,131,Florida,Walton County,4,5,3056,1637,1419
50,12,131,Florida,Walton County,4,6,3499,1904,1595
50,12,131,Florida,Walton County,4,7,3438,1903,1535
50,12,131,Florida,Walton County,4,8,3408,1828,1580
50,12,131,Florida,Walton County,4,9,3612,1974,1638
50,12,131,Florida,Walton County,4,10,4155,2123,2032
50,12,131,Florida,Walton County,4,11,4534,2276,2258
50,12,131,Florida,Walton County,4,12,4146,2014,2132
50,12,131,Florida,Walton County,4,13,4040,1997,2043
50,12,131,Florida,Walton County,4,14,3326,1648,1678
50,12,131,Florida,Walton County,4,15,2427,1165,1262
50,12,131,Florida,Walton County,4,16,1656,788,868
50,12,131,Florida,Walton County,4,17,1132,495,637
50,12,131,Florida,Walton County,4,18,860,291,569
50,12,131,Florida,Walton County,5,0,57190,29205,27985
50,12,131,Florida,Walton County,5,1,3323,1682,1641
50,12,131,Florida,Walton County,5,2,3255,1663,1592
50,12,131,Florida,Walton County,5,3,3175,1589,1586
50,12,131,Florida,Walton County,5,4,2925,1634,1291
50,12,131,Florida,Walton County,5,5,3128,1683,1445
50,12,131,Florida,Walton County,5,6,3529,1884,1645
50,12,131,Florida,Walton County,5,7,3591,1972,1619
50,12,131,Florida,Walton County,5,8,3434,1852,1582
50,12,131,Florida,Walton County,5,9,3731,2052,1679
50,12,131,Florida,Walton County,5,10,4182,2121,2061
50,12,131,Florida,Walton County,5,11,4527,2283,2244
50,12,131,Florida,Walton County,5,12,4384,2117,2267
50,12,131,Florida,Walton County,5,13,4026,1974,2052
50,12,131,Florida,Walton County,5,14,3648,1796,1852
50,12,131,Florida,Walton County,5,15,2527,1222,1305
50,12,131,Florida,Walton County,5,16,1759,850,909
50,12,131,Florida,Walton County,5,17,1144,520,624
50,12,131,Florida,Walton County,5,18,902,311,591
50,12,131,Florida,Walton County,6,0,59193,29980,29213
50,12,131,Florida,Walton County,6,1,3434,1692,1742
50,12,131,Florida,Walton County,6,2,3518,1797,1721
50,12,131,Florida,Walton County,6,3,3219,1603,1616
50,12,131,Florida,Walton County,6,4,2930,1595,1335
50,12,131,Florida,Walton County,6,5,3226,1737,1489
50,12,131,Florida,Walton County,6,6,3659,1938,1721
50,12,131,Florida,Walton County,6,7,3797,2062,1735
50,12,131,Florida,Walton County,6,8,3523,1893,1630
50,12,131,Florida,Walton County,6,9,3838,2049,1789
50,12,131,Florida,Walton County,6,10,4094,2110,1984
50,12,131,Florida,Walton County,6,11,4682,2311,2371
50,12,131,Florida,Walton County,6,12,4518,2218,2300
50,12,131,Florida,Walton County,6,13,4133,2016,2117
50,12,131,Florida,Walton County,6,14,3859,1888,1971
50,12,131,Florida,Walton County,6,15,2749,1303,1446
50,12,131,Florida,Walton County,6,16,1874,887,987
50,12,131,Florida,Walton County,6,17,1171,547,624
50,12,131,Florida,Walton County,6,18,969,334,635
50,12,131,Florida,Walton County,7,0,61186,31121,30065
50,12,131,Florida,Walton County,7,1,3556,1785,1771
50,12,131,Florida,Walton County,7,2,3590,1856,1734
50,12,131,Florida,Walton County,7,3,3340,1656,1684
50,12,131,Florida,Walton County,7,4,2969,1622,1347
50,12,131,Florida,Walton County,7,5,3265,1796,1469
50,12,131,Florida,Walton County,7,6,3747,2019,1728
50,12,131,Florida,Walton County,7,7,3943,2176,1767
50,12,131,Florida,Walton County,7,8,3683,1949,1734
50,12,131,Florida,Walton County,7,9,3935,2087,1848
50,12,131,Florida,Walton County,7,10,4068,2117,1951
50,12,131,Florida,Walton County,7,11,4767,2345,2422
50,12,131,Florida,Walton County,7,12,4719,2306,2413
50,12,131,Florida,Walton County,7,13,4406,2131,2275
50,12,131,Florida,Walton County,7,14,4032,2002,2030
50,12,131,Florida,Walton County,7,15,2963,1443,1520
50,12,131,Florida,Walton County,7,16,1956,903,1053
50,12,131,Florida,Walton County,7,17,1226,559,667
50,12,131,Florida,Walton County,7,18,1021,369,652
50,12,131,Florida,Walton County,8,0,63066,31999,31067
50,12,131,Florida,Walton County,8,1,3744,1883,1861
50,12,131,Florida,Walton County,8,2,3658,1894,1764
50,12,131,Florida,Walton County,8,3,3495,1742,1753
50,12,131,Florida,Walton County,8,4,3000,1585,1415
50,12,131,Florida,Walton County,8,5,3127,1730,1397
50,12,131,Florida,Walton County,8,6,3901,2073,1828
50,12,131,Florida,Walton County,8,7,4056,2190,1866
50,12,131,Florida,Walton County,8,8,3857,2073,1784
50,12,131,Florida,Walton County,8,9,3953,2068,1885
50,12,131,Florida,Walton County,8,10,4039,2114,1925
50,12,131,Florida,Walton County,8,11,4855,2398,2457
50,12,131,Florida,Walton County,8,12,4931,2421,2510
50,12,131,Florida,Walton County,8,13,4639,2210,2429
50,12,131,Florida,Walton County,8,14,4242,2107,2135
50,12,131,Florida,Walton County,8,15,3197,1585,1612
50,12,131,Florida,Walton County,8,16,2012,930,1082
50,12,131,Florida,Walton County,8,17,1261,576,685
50,12,131,Florida,Walton County,8,18,1099,420,679
50,12,131,Florida,Walton County,9,0,65421,33145,32276
50,12,131,Florida,Walton County,9,1,3881,1960,1921
50,12,131,Florida,Walton County,9,2,3728,1868,1860
50,12,131,Florida,Walton County,9,3,3638,1804,1834
50,12,131,Florida,Walton County,9,4,3182,1686,1496
50,12,131,Florida,Walton County,9,5,3018,1687,1331
50,12,131,Florida,Walton County,9,6,4132,2233,1899
50,12,131,Florida,Walton County,9,7,4223,2249,1974
50,12,131,Florida,Walton County,9,8,4067,2171,1896
50,12,131,Florida,Walton County,9,9,3905,2056,1849
50,12,131,Florida,Walton County,9,10,4222,2220,2002
50,12,131,Florida,Walton County,9,11,4869,2387,2482
50,12,131,Florida,Walton County,9,12,5165,2565,2600
50,12,131,Florida,Walton County,9,13,4920,2299,2621
50,12,131,Florida,Walton County,9,14,4518,2243,2275
50,12,131,Florida,Walton County,9,15,3314,1649,1665
50,12,131,Florida,Walton County,9,16,2148,1009,1139
50,12,131,Florida,Walton County,9,17,1335,597,738
50,12,131,Florida,Walton County,9,18,1156,462,694
50,12,131,Florida,Walton County,10,0,68021,34509,33512
50,12,131,Florida,Walton County,10,1,4014,2040,1974
50,12,131,Florida,Walton County,10,2,3864,1930,1934
50,12,131,Florida,Walton County,10,3,3778,1891,1887
50,12,131,Florida,Walton County,10,4,3321,1738,1583
50,12,131,Florida,Walton County,10,5,3064,1725,1339
50,12,131,Florida,Walton County,10,6,4165,2265,1900
50,12,131,Florida,Walton County,10,7,4367,2296,2071
50,12,131,Florida,Walton County,10,8,4308,2290,2018
50,12,131,Florida,Walton County,10,9,4001,2146,1855
50,12,131,Florida,Walton County,10,10,4381,2289,2092
50,12,131,Florida,Walton County,10,11,4974,2439,2535
50,12,131,Florida,Walton County,10,12,5347,2634,2713
50,12,131,Florida,Walton County,10,13,5254,2514,2740
50,12,131,Florida,Walton County,10,14,4620,2270,2350
50,12,131,Florida,Walton County,10,15,3699,1826,1873
50,12,131,Florida,Walton County,10,16,2260,1088,1172
50,12,131,Florida,Walton County,10,17,1419,657,762
50,12,131,Florida,Walton County,10,18,1185,471,714
50,12,131,Florida,Walton County,11,0,70732,35805,34927
50,12,131,Florida,Walton County,11,1,4098,2076,2022
50,12,131,Florida,Walton County,11,2,3998,2015,1983
50,12,131,Florida,Walton County,11,3,4055,2055,2000
50,12,131,Florida,Walton County,11,4,3448,1764,1684
50,12,131,Florida,Walton County,11,5,3046,1693,1353
50,12,131,Florida,Walton County,11,6,4231,2320,1911
50,12,131,Florida,Walton County,11,7,4390,2309,2081
50,12,131,Florida,Walton County,11,8,4571,2426,2145
50,12,131,Florida,Walton County,11,9,4168,2222,1946
50,12,131,Florida,Walton County,11,10,4493,2346,2147
50,12,131,Florida,Walton County,11,11,5035,2460,2575
50,12,131,Florida,Walton County,11,12,5662,2745,2917
50,12,131,Florida,Walton County,11,13,5514,2669,2845
50,12,131,Florida,Walton County,11,14,4817,2337,2480
50,12,131,Florida,Walton County,11,15,4000,1965,2035
50,12,131,Florida,Walton County,11,16,2481,1201,1280
50,12,131,Florida,Walton County,11,17,1482,676,806
50,12,131,Florida,Walton County,11,18,1243,526,717
50,12,131,Florida,Walton County,12,0,74071,37388,36683
50,12,131,Florida,Walton County,12,1,4141,2143,1998
50,12,131,Florida,Walton County,12,2,4282,2129,2153
50,12,131,Florida,Walton County,12,3,4314,2204,2110
50,12,131,Florida,Walton County,12,4,3592,1795,1797
50,12,131,Florida,Walton County,12,5,3242,1787,1455
50,12,131,Florida,Walton County,12,6,4235,2317,1918
50,12,131,Florida,Walton County,12,7,4610,2421,2189
50,12,131,Florida,Walton County,12,8,4795,2476,2319
50,12,131,Florida,Walton County,12,9,4433,2339,2094
50,12,131,Florida,Walton County,12,10,4611,2433,2178
50,12,131,Florida,Walton County,12,11,4967,2439,2528
50,12,131,Florida,Walton County,12,12,5958,2857,3101
50,12,131,Florida,Walton County,12,13,5914,2888,3026
50,12,131,Florida,Walton County,12,14,5155,2465,2690
50,12,131,Florida,Walton County,12,15,4204,2088,2116
50,12,131,Florida,Walton County,12,16,2742,1340,1402
50,12,131,Florida,Walton County,12,17,1514,678,836
50,12,131,Florida,Walton County,12,18,1362,589,773
50,12,133,Florida,Washington County,1,0,24896,13575,11321
50,12,133,Florida,Washington County,1,1,1444,706,738
50,12,133,Florida,Washington County,1,2,1404,764,640
50,12,133,Florida,Washington County,1,3,1465,771,694
50,12,133,Florida,Washington County,1,4,1596,862,734
50,12,133,Florida,Washington County,1,5,1528,936,592
50,12,133,Florida,Washington County,1,6,1544,989,555
50,12,133,Florida,Washington County,1,7,1665,1038,627
50,12,133,Florida,Washington County,1,8,1693,993,700
50,12,133,Florida,Washington County,1,9,1781,1067,714
50,12,133,Florida,Washington County,1,10,1927,1079,848
50,12,133,Florida,Washington County,1,11,1893,1014,879
50,12,133,Florida,Washington County,1,12,1603,823,780
50,12,133,Florida,Washington County,1,13,1526,750,776
50,12,133,Florida,Washington County,1,14,1369,651,718
50,12,133,Florida,Washington County,1,15,959,495,464
50,12,133,Florida,Washington County,1,16,682,325,357
50,12,133,Florida,Washington County,1,17,442,190,252
50,12,133,Florida,Washington County,1,18,375,122,253
50,12,133,Florida,Washington County,2,0,24896,13575,11321
50,12,133,Florida,Washington County,2,1,1444,706,738
50,12,133,Florida,Washington County,2,2,1404,764,640
50,12,133,Florida,Washington County,2,3,1465,771,694
50,12,133,Florida,Washington County,2,4,1596,862,734
50,12,133,Florida,Washington County,2,5,1528,936,592
50,12,133,Florida,Washington County,2,6,1544,989,555
50,12,133,Florida,Washington County,2,7,1665,1038,627
50,12,133,Florida,Washington County,2,8,1693,993,700
50,12,133,Florida,Washington County,2,9,1781,1067,714
50,12,133,Florida,Washington County,2,10,1927,1079,848
50,12,133,Florida,Washington County,2,11,1893,1014,879
50,12,133,Florida,Washington County,2,12,1603,823,780
50,12,133,Florida,Washington County,2,13,1526,750,776
50,12,133,Florida,Washington County,2,14,1369,651,718
50,12,133,Florida,Washington County,2,15,959,495,464
50,12,133,Florida,Washington County,2,16,682,325,357
50,12,133,Florida,Washington County,2,17,442,190,252
50,12,133,Florida,Washington County,2,18,375,122,253
50,12,133,Florida,Washington County,3,0,24720,13417,11303
50,12,133,Florida,Washington County,3,1,1433,705,728
50,12,133,Florida,Washington County,3,2,1410,756,654
50,12,133,Florida,Washington County,3,3,1453,766,687
50,12,133,Florida,Washington County,3,4,1578,848,730
50,12,133,Florida,Washington County,3,5,1523,926,597
50,12,133,Florida,Washington County,3,6,1530,969,561
50,12,133,Florida,Washington County,3,7,1637,1021,616
50,12,133,Florida,Washington County,3,8,1652,961,691
50,12,133,Florida,Washington County,3,9,1753,1043,710
50,12,133,Florida,Washington County,3,10,1907,1068,839
50,12,133,Florida,Washington County,3,11,1881,999,882
50,12,133,Florida,Washington County,3,12,1611,828,783
50,12,133,Florida,Washington County,3,13,1529,748,781
50,12,133,Florida,Washington County,3,14,1361,645,716
50,12,133,Florida,Washington County,3,15,963,497,466
50,12,133,Florida,Washington County,3,16,693,328,365
50,12,133,Florida,Washington County,3,17,436,191,245
50,12,133,Florida,Washington County,3,18,370,118,252
50,12,133,Florida,Washington County,4,0,24510,13237,11273
50,12,133,Florida,Washington County,4,1,1319,650,669
50,12,133,Florida,Washington County,4,2,1447,746,701
50,12,133,Florida,Washington County,4,3,1481,786,695
50,12,133,Florida,Washington County,4,4,1529,836,693
50,12,133,Florida,Washington County,4,5,1532,943,589
50,12,133,Florida,Washington County,4,6,1521,939,582
50,12,133,Florida,Washington County,4,7,1545,953,592
50,12,133,Florida,Washington County,4,8,1582,906,676
50,12,133,Florida,Washington County,4,9,1745,1013,732
50,12,133,Florida,Washington County,4,10,1896,1080,816
50,12,133,Florida,Washington County,4,11,1860,964,896
50,12,133,Florida,Washington County,4,12,1641,855,786
50,12,133,Florida,Washington County,4,13,1530,745,785
50,12,133,Florida,Washington County,4,14,1356,646,710
50,12,133,Florida,Washington County,4,15,970,498,472
50,12,133,Florida,Washington County,4,16,727,347,380
50,12,133,Florida,Washington County,4,17,440,201,239
50,12,133,Florida,Washington County,4,18,389,129,260
50,12,133,Florida,Washington County,5,0,24741,13509,11232
50,12,133,Florida,Washington County,5,1,1302,640,662
50,12,133,Florida,Washington County,5,2,1463,748,715
50,12,133,Florida,Washington County,5,3,1448,770,678
50,12,133,Florida,Washington County,5,4,1470,820,650
50,12,133,Florida,Washington County,5,5,1614,998,616
50,12,133,Florida,Washington County,5,6,1597,1003,594
50,12,133,Florida,Washington County,5,7,1609,1031,578
50,12,133,Florida,Washington County,5,8,1604,940,664
50,12,133,Florida,Washington County,5,9,1726,1009,717
50,12,133,Florida,Washington County,5,10,1890,1103,787
50,12,133,Florida,Washington County,5,11,1859,982,877
50,12,133,Florida,Washington County,5,12,1700,879,821
50,12,133,Florida,Washington County,5,13,1485,717,768
50,12,133,Florida,Washington County,5,14,1395,684,711
50,12,133,Florida,Washington County,5,15,1007,483,524
50,12,133,Florida,Washington County,5,16,720,355,365
50,12,133,Florida,Washington County,5,17,446,210,236
50,12,133,Florida,Washington County,5,18,406,137,269
50,12,133,Florida,Washington County,6,0,24504,13373,11131
50,12,133,Florida,Washington County,6,1,1243,623,620
50,12,133,Florida,Washington County,6,2,1441,718,723
50,12,133,Florida,Washington County,6,3,1422,769,653
50,12,133,Florida,Washington County,6,4,1449,801,648
50,12,133,Florida,Washington County,6,5,1609,1005,604
50,12,133,Florida,Washington County,6,6,1596,993,603
50,12,133,Florida,Washington County,6,7,1570,1016,554
50,12,133,Florida,Washington County,6,8,1583,931,652
50,12,133,Florida,Washington County,6,9,1726,994,732
50,12,133,Florida,Washington County,6,10,1797,1044,753
50,12,133,Florida,Washington County,6,11,1842,993,849
50,12,133,Florida,Washington County,6,12,1682,858,824
50,12,133,Florida,Washington County,6,13,1513,742,771
50,12,133,Florida,Washington County,6,14,1362,653,709
50,12,133,Florida,Washington County,6,15,1077,503,574
50,12,133,Florida,Washington County,6,16,726,362,364
50,12,133,Florida,Washington County,6,17,474,231,243
50,12,133,Florida,Washington County,6,18,392,137,255
50,12,133,Florida,Washington County,7,0,24299,13292,11007
50,12,133,Florida,Washington County,7,1,1205,590,615
50,12,133,Florida,Washington County,7,2,1388,683,705
50,12,133,Florida,Washington County,7,3,1384,740,644
50,12,133,Florida,Washington County,7,4,1424,798,626
50,12,133,Florida,Washington County,7,5,1638,1031,607
50,12,133,Florida,Washington County,7,6,1568,965,603
50,12,133,Florida,Washington County,7,7,1604,1041,563
50,12,133,Florida,Washington County,7,8,1527,921,606
50,12,133,Florida,Washington County,7,9,1706,999,707
50,12,133,Florida,Washington County,7,10,1764,1023,741
50,12,133,Florida,Washington County,7,11,1800,961,839
50,12,133,Florida,Washington County,7,12,1670,861,809
50,12,133,Florida,Washington County,7,13,1507,751,756
50,12,133,Florida,Washington County,7,14,1383,655,728
50,12,133,Florida,Washington County,7,15,1112,532,580
50,12,133,Florida,Washington County,7,16,750,366,384
50,12,133,Florida,Washington County,7,17,485,242,243
50,12,133,Florida,Washington County,7,18,384,133,251
50,12,133,Florida,Washington County,8,0,24552,13426,11126
50,12,133,Florida,Washington County,8,1,1232,626,606
50,12,133,Florida,Washington County,8,2,1354,668,686
50,12,133,Florida,Washington County,8,3,1400,741,659
50,12,133,Florida,Washington County,8,4,1455,810,645
50,12,133,Florida,Washington County,8,5,1649,1022,627
50,12,133,Florida,Washington County,8,6,1617,1015,602
50,12,133,Florida,Washington County,8,7,1601,1026,575
50,12,133,Florida,Washington County,8,8,1582,928,654
50,12,133,Florida,Washington County,8,9,1702,1004,698
50,12,133,Florida,Washington County,8,10,1701,997,704
50,12,133,Florida,Washington County,8,11,1811,977,834
50,12,133,Florida,Washington County,8,12,1694,855,839
50,12,133,Florida,Washington County,8,13,1558,780,778
50,12,133,Florida,Washington County,8,14,1369,660,709
50,12,133,Florida,Washington County,8,15,1192,559,633
50,12,133,Florida,Washington County,8,16,755,376,379
50,12,133,Florida,Washington County,8,17,508,241,267
50,12,133,Florida,Washington County,8,18,372,141,231
50,12,133,Florida,Washington County,9,0,24454,13267,11187
50,12,133,Florida,Washington County,9,1,1230,633,597
50,12,133,Florida,Washington County,9,2,1311,646,665
50,12,133,Florida,Washington County,9,3,1447,734,713
50,12,133,Florida,Washington County,9,4,1423,775,648
50,12,133,Florida,Washington County,9,5,1588,977,611
50,12,133,Florida,Washington County,9,6,1663,1031,632
50,12,133,Florida,Washington County,9,7,1596,994,602
50,12,133,Florida,Washington County,9,8,1563,933,630
50,12,133,Florida,Washington County,9,9,1627,958,669
50,12,133,Florida,Washington County,9,10,1690,966,724
50,12,133,Florida,Washington County,9,11,1782,991,791
50,12,133,Florida,Washington County,9,12,1721,843,878
50,12,133,Florida,Washington County,9,13,1550,787,763
50,12,133,Florida,Washington County,9,14,1422,671,751
50,12,133,Florida,Washington County,9,15,1168,547,621
50,12,133,Florida,Washington County,9,16,773,376,397
50,12,133,Florida,Washington County,9,17,526,251,275
50,12,133,Florida,Washington County,9,18,374,154,220
50,12,133,Florida,Washington County,10,0,24546,13264,11282
50,12,133,Florida,Washington County,10,1,1271,623,648
50,12,133,Florida,Washington County,10,2,1285,640,645
50,12,133,Florida,Washington County,10,3,1446,736,710
50,12,133,Florida,Washington County,10,4,1375,740,635
50,12,133,Florida,Washington County,10,5,1545,952,593
50,12,133,Florida,Washington County,10,6,1801,1113,688
50,12,133,Florida,Washington County,10,7,1603,992,611
50,12,133,Florida,Washington County,10,8,1507,895,612
50,12,133,Florida,Washington County,10,9,1618,962,656
50,12,133,Florida,Washington County,10,10,1708,958,750
50,12,133,Florida,Washington County,10,11,1778,990,788
50,12,133,Florida,Washington County,10,12,1755,867,888
50,12,133,Florida,Washington County,10,13,1560,787,773
50,12,133,Florida,Washington County,10,14,1404,650,754
50,12,133,Florida,Washington County,10,15,1210,580,630
50,12,133,Florida,Washington County,10,16,800,359,441
50,12,133,Florida,Washington County,10,17,501,248,253
50,12,133,Florida,Washington County,10,18,379,172,207
50,12,133,Florida,Washington County,11,0,24793,13309,11484
50,12,133,Florida,Washington County,11,1,1283,624,659
50,12,133,Florida,Washington County,11,2,1313,656,657
50,12,133,Florida,Washington County,11,3,1482,733,749
50,12,133,Florida,Washington County,11,4,1362,745,617
50,12,133,Florida,Washington County,11,5,1593,976,617
50,12,133,Florida,Washington County,11,6,1827,1116,711
50,12,133,Florida,Washington County,11,7,1651,1001,650
50,12,133,Florida,Washington County,11,8,1506,899,607
50,12,133,Florida,Washington County,11,9,1599,924,675
50,12,133,Florida,Washington County,11,10,1715,947,768
50,12,133,Florida,Washington County,11,11,1738,958,780
50,12,133,Florida,Washington County,11,12,1816,919,897
50,12,133,Florida,Washington County,11,13,1582,786,796
50,12,133,Florida,Washington County,11,14,1409,672,737
50,12,133,Florida,Washington County,11,15,1181,548,633
50,12,133,Florida,Washington County,11,16,874,392,482
50,12,133,Florida,Washington County,11,17,502,242,260
50,12,133,Florida,Washington County,11,18,360,171,189
50,12,133,Florida,Washington County,12,0,25473,13794,11679
50,12,133,Florida,Washington County,12,1,1323,668,655
50,12,133,Florida,Washington County,12,2,1377,701,676
50,12,133,Florida,Washington County,12,3,1499,760,739
50,12,133,Florida,Washington County,12,4,1393,746,647
50,12,133,Florida,Washington County,12,5,1646,996,650
50,12,133,Florida,Washington County,12,6,1885,1168,717
50,12,133,Florida,Washington County,12,7,1756,1067,689
50,12,133,Florida,Washington County,12,8,1611,975,636
50,12,133,Florida,Washington County,12,9,1592,944,648
50,12,133,Florida,Washington County,12,10,1775,991,784
50,12,133,Florida,Washington County,12,11,1721,970,751
50,12,133,Florida,Washington County,12,12,1867,942,925
50,12,133,Florida,Washington County,12,13,1648,827,821
50,12,133,Florida,Washington County,12,14,1385,668,717
50,12,133,Florida,Washington County,12,15,1215,554,661
50,12,133,Florida,Washington County,12,16,915,416,499
50,12,133,Florida,Washington County,12,17,518,240,278
50,12,133,Florida,Washington County,12,18,347,161,186
