SUMLEV,STATE,COUNTY,STNAME,CTYNAME,YEAR,AGEGRP,TOT_POP,TOT_MALE,TOT_FEMALE
50,6,1,California,Alameda County,1,0,1510271,740573,769698
50,6,1,California,Alameda County,1,1,97652,50259,47393
50,6,1,California,Alameda County,1,2,94546,48145,46401
50,6,1,California,Alameda County,1,3,91070,46403,44667
50,6,1,California,Alameda County,1,4,100394,51445,48949
50,6,1,California,Alameda County,1,5,107049,54515,52534
50,6,1,California,Alameda County,1,6,113597,56185,57412
50,6,1,California,Alameda County,1,7,114607,56256,58351
50,6,1,California,Alameda County,1,8,115275,57062,58213
50,6,1,California,Alameda County,1,9,112216,55959,56257
50,6,1,California,Alameda County,1,10,114111,56168,57943
50,6,1,California,Alameda County,1,11,108506,53431,55075
50,6,1,California,Alameda County,1,12,94648,45580,49068
50,6,1,California,Alameda County,1,13,78854,37509,41345
50,6,1,California,Alameda County,1,14,52663,24568,28095
50,6,1,California,Alameda County,1,15,37774,17060,20714
50,6,1,California,Alameda County,1,16,29185,12617,16568
50,6,1,California,Alameda County,1,17,23391,9144,14247
50,6,1,California,Alameda County,1,18,24733,8267,16466
50,6,1,California,Alameda County,2,0,1510283,740576,769707
50,6,1,California,Alameda County,2,1,97650,50257,47393
50,6,1,California,Alameda County,2,2,94545,48145,46400
50,6,1,California,Alameda County,2,3,91070,46402,44668
50,6,1,California,Alameda County,2,4,100395,51446,48949
50,6,1,California,Alameda County,2,5,107048,54515,52533
50,6,1,California,Alameda County,2,6,113595,56184,57411
50,6,1,California,Alameda County,2,7,114607,56257,58350
50,6,1,California,Alameda County,2,8,115273,57061,58212
50,6,1,California,Alameda County,2,9,112215,55957,56258
50,6,1,California,Alameda County,2,10,114112,56168,57944
50,6,1,California,Alameda County,2,11,108502,53429,55073
50,6,1,California,Alameda County,2,12,94648,45579,49069
50,6,1,California,Alameda County,2,13,78862,37512,41350
50,6,1,California,Alameda County,2,14,52668,24571,28097
50,6,1,California,Alameda County,2,15,37777,17061,20716
50,6,1,California,Alameda County,2,16,29188,12618,16570
50,6,1,California,Alameda County,2,17,23390,9144,14246
50,6,1,California,Alameda County,2,18,24738,8270,16468
50,6,1,California,Alameda County,3,0,1512997,741756,771241
50,6,1,California,Alameda County,3,1,97656,50202,47454
50,6,1,California,Alameda County,3,2,94490,48154,46336
50,6,1,California,Alameda County,3,3,90979,46395,44584
50,6,1,California,Alameda County,3,4,99687,51062,48625
50,6,1,California,Alameda County,3,5,107546,54596,52950
50,6,1,California,Alameda County,3,6,113572,56243,57329
50,6,1,California,Alameda County,3,7,114815,56335,58480
50,6,1,California,Alameda County,3,8,114899,56849,58050
50,6,1,California,Alameda County,3,9,112600,56135,56465
50,6,1,California,Alameda County,3,10,113881,56109,57772
50,6,1,California,Alameda County,3,11,108869,53595,55274
50,6,1,California,Alameda County,3,12,95302,45953,49349
50,6,1,California,Alameda County,3,13,79708,37863,41845
50,6,1,California,Alameda County,3,14,53356,24905,28451
50,6,1,California,Alameda County,3,15,38072,17202,20870
50,6,1,California,Alameda County,3,16,29246,12649,16597
50,6,1,California,Alameda County,3,17,23338,9173,14165
50,6,1,California,Alameda County,3,18,24981,8336,16645
50,6,1,California,Alameda County,4,0,1530893,750073,780820
50,6,1,California,Alameda County,4,1,97798,50128,47670
50,6,1,California,Alameda County,4,2,95096,48571,46525
50,6,1,California,Alameda County,4,3,91092,46525,44567
50,6,1,California,Alameda County,4,4,97338,49770,47568
50,6,1,California,Alameda County,4,5,110005,55360,54645
50,6,1,California,Alameda County,4,6,114831,57097,57734
50,6,1,California,Alameda County,4,7,117132,57509,59623
50,6,1,California,Alameda County,4,8,113890,56307,57583
50,6,1,California,Alameda County,4,9,114448,57000,57448
50,6,1,California,Alameda County,4,10,112952,55772,57180
50,6,1,California,Alameda County,4,11,110380,54263,56117
50,6,1,California,Alameda County,4,12,97839,47345,50494
50,6,1,California,Alameda County,4,13,83641,39562,44079
50,6,1,California,Alameda County,4,14,56096,26290,29806
50,6,1,California,Alameda County,4,15,39334,17703,21631
50,6,1,California,Alameda County,4,16,29811,12915,16896
50,6,1,California,Alameda County,4,17,23209,9242,13967
50,6,1,California,Alameda County,4,18,26001,8714,17287
50,6,1,California,Alameda County,5,0,1553729,760689,793040
50,6,1,California,Alameda County,5,1,97591,49895,47696
50,6,1,California,Alameda County,5,2,96702,49452,47250
50,6,1,California,Alameda County,5,3,91299,46627,44672
50,6,1,California,Alameda County,5,4,96358,49059,47299
50,6,1,California,Alameda County,5,5,110739,55709,55030
50,6,1,California,Alameda County,5,6,117107,58200,58907
50,6,1,California,Alameda County,5,7,121010,59364,61646
50,6,1,California,Alameda County,5,8,114844,56586,58258
50,6,1,California,Alameda County,5,9,116406,57896,58510
50,6,1,California,Alameda County,5,10,111700,55297,56403
50,6,1,California,Alameda County,5,11,111539,54785,56754
50,6,1,California,Alameda County,5,12,100457,48680,51777
50,6,1,California,Alameda County,5,13,84819,40115,44704
50,6,1,California,Alameda County,5,14,61740,28937,32803
50,6,1,California,Alameda County,5,15,41011,18479,22532
50,6,1,California,Alameda County,5,16,30383,13151,17232
50,6,1,California,Alameda County,5,17,23274,9362,13912
50,6,1,California,Alameda County,5,18,26750,9095,17655
50,6,1,California,Alameda County,6,0,1579508,773625,805883
50,6,1,California,Alameda County,6,1,97533,49888,47645
50,6,1,California,Alameda County,6,2,98198,50378,47820
50,6,1,California,Alameda County,6,3,92221,47079,45142
50,6,1,California,Alameda County,6,4,95448,48336,47112
50,6,1,California,Alameda County,6,5,110257,55296,54961
50,6,1,California,Alameda County,6,6,121512,60658,60854
50,6,1,California,Alameda County,6,7,125802,61848,63954
50,6,1,California,Alameda County,6,8,116602,57616,58986
50,6,1,California,Alameda County,6,9,117412,58180,59232
50,6,1,California,Alameda County,6,10,110735,55112,55623
50,6,1,California,Alameda County,6,11,112707,55237,57470
50,6,1,California,Alameda County,6,12,103052,50156,52896
50,6,1,California,Alameda County,6,13,86605,40831,45774
50,6,1,California,Alameda County,6,14,65834,30768,35066
50,6,1,California,Alameda County,6,15,43427,19748,23679
50,6,1,California,Alameda County,6,16,31306,13586,17720
50,6,1,California,Alameda County,6,17,23452,9534,13918
50,6,1,California,Alameda County,6,18,27405,9374,18031
50,6,1,California,Alameda County,7,0,1607638,787566,820072
50,6,1,California,Alameda County,7,1,98139,50146,47993
50,6,1,California,Alameda County,7,2,98627,50571,48056
50,6,1,California,Alameda County,7,3,93539,47542,45997
50,6,1,California,Alameda County,7,4,94455,47705,46750
50,6,1,California,Alameda County,7,5,108809,54626,54183
50,6,1,California,Alameda County,7,6,128015,63975,64040
50,6,1,California,Alameda County,7,7,130283,64052,66231
50,6,1,California,Alameda County,7,8,119551,59394,60157
50,6,1,California,Alameda County,7,9,117999,58359,59640
50,6,1,California,Alameda County,7,10,110489,55157,55332
50,6,1,California,Alameda County,7,11,113903,55800,58103
50,6,1,California,Alameda County,7,12,104999,51166,53833
50,6,1,California,Alameda County,7,13,88745,42013,46732
50,6,1,California,Alameda County,7,14,69825,32557,37268
50,6,1,California,Alameda County,7,15,45793,20894,24899
50,6,1,California,Alameda County,7,16,32507,14229,18278
50,6,1,California,Alameda County,7,17,23855,9722,14133
50,6,1,California,Alameda County,7,18,28105,9658,18447
50,6,1,California,Alameda County,8,0,1634326,801459,832867
50,6,1,California,Alameda County,8,1,98700,50477,48223
50,6,1,California,Alameda County,8,2,99077,50616,48461
50,6,1,California,Alameda County,8,3,94180,47992,46188
50,6,1,California,Alameda County,8,4,94060,47394,46666
50,6,1,California,Alameda County,8,5,105909,53261,52648
50,6,1,California,Alameda County,8,6,134254,67113,67141
50,6,1,California,Alameda County,8,7,134310,66458,67852
50,6,1,California,Alameda County,8,8,124103,61857,62246
50,6,1,California,Alameda County,8,9,117580,58202,59378
50,6,1,California,Alameda County,8,10,112463,56073,56390
50,6,1,California,Alameda County,8,11,113025,55541,57484
50,6,1,California,Alameda County,8,12,106765,52066,54699
50,6,1,California,Alameda County,8,13,91105,43398,47707
50,6,1,California,Alameda County,8,14,73705,34252,39453
50,6,1,California,Alameda County,8,15,48353,22003,26350
50,6,1,California,Alameda County,8,16,33663,14813,18850
50,6,1,California,Alameda County,8,17,24277,10003,14274
50,6,1,California,Alameda County,8,18,28797,9940,18857
50,6,1,California,Alameda County,9,0,1650765,810640,840125
50,6,1,California,Alameda County,9,1,98194,50464,47730
50,6,1,California,Alameda County,9,2,98544,50293,48251
50,6,1,California,Alameda County,9,3,94319,48139,46180
50,6,1,California,Alameda County,9,4,93822,47335,46487
50,6,1,California,Alameda County,9,5,103170,51822,51348
50,6,1,California,Alameda County,9,6,138326,69164,69162
50,6,1,California,Alameda County,9,7,137597,68538,69059
50,6,1,California,Alameda County,9,8,127643,63637,64006
50,6,1,California,Alameda County,9,9,116787,57946,58841
50,6,1,California,Alameda County,9,10,113919,56835,57084
50,6,1,California,Alameda County,9,11,111283,54885,56398
50,6,1,California,Alameda County,9,12,107430,52354,55076
50,6,1,California,Alameda County,9,13,93055,44615,48440
50,6,1,California,Alameda County,9,14,76751,35490,41261
50,6,1,California,Alameda County,9,15,50879,23207,27672
50,6,1,California,Alameda County,9,16,34710,15280,19430
50,6,1,California,Alameda County,9,17,24867,10331,14536
50,6,1,California,Alameda County,9,18,29469,10305,19164
50,6,1,California,Alameda County,10,0,1659824,815738,844086
50,6,1,California,Alameda County,10,1,97808,50109,47699
50,6,1,California,Alameda County,10,2,97224,49616,47608
50,6,1,California,Alameda County,10,3,95059,48597,46462
50,6,1,California,Alameda County,10,4,93447,47233,46214
50,6,1,California,Alameda County,10,5,100952,50540,50412
50,6,1,California,Alameda County,10,6,138897,69734,69163
50,6,1,California,Alameda County,10,7,139160,69701,69459
50,6,1,California,Alameda County,10,8,131058,65364,65694
50,6,1,California,Alameda County,10,9,116873,57999,58874
50,6,1,California,Alameda County,10,10,114528,57074,57454
50,6,1,California,Alameda County,10,11,108937,53928,55009
50,6,1,California,Alameda County,10,12,107420,52416,55004
50,6,1,California,Alameda County,10,13,94470,45461,49009
50,6,1,California,Alameda County,10,14,77193,35685,41508
50,6,1,California,Alameda County,10,15,55313,25191,30122
50,6,1,California,Alameda County,10,16,36194,15960,20234
50,6,1,California,Alameda County,10,17,25300,10559,14741
50,6,1,California,Alameda County,10,18,29991,10571,19420
50,6,1,California,Alameda County,11,0,1666596,819588,847008
50,6,1,California,Alameda County,11,1,96452,49230,47222
50,6,1,California,Alameda County,11,2,96067,49042,47025
50,6,1,California,Alameda County,11,3,95043,48735,46308
50,6,1,California,Alameda County,11,4,93542,47285,46257
50,6,1,California,Alameda County,11,5,98679,49156,49523
50,6,1,California,Alameda County,11,6,137529,69169,68360
50,6,1,California,Alameda County,11,7,141540,71088,70452
50,6,1,California,Alameda County,11,8,134310,67318,66992
50,6,1,California,Alameda County,11,9,117213,58253,58960
50,6,1,California,Alameda County,11,10,114639,56983,57656
50,6,1,California,Alameda County,11,11,106955,53266,53689
50,6,1,California,Alameda County,11,12,107270,52297,54973
50,6,1,California,Alameda County,11,13,95894,46261,49633
50,6,1,California,Alameda County,11,14,78184,36194,41990
50,6,1,California,Alameda County,11,15,58570,26697,31873
50,6,1,California,Alameda County,11,16,38174,16900,21274
50,6,1,California,Alameda County,11,17,26088,10917,15171
50,6,1,California,Alameda County,11,18,30447,10797,19650
50,6,1,California,Alameda County,12,0,1668412,821135,847277
50,6,1,California,Alameda County,12,1,94531,48349,46182
50,6,1,California,Alameda County,12,2,95493,48787,46706
50,6,1,California,Alameda County,12,3,94264,48364,45900
50,6,1,California,Alameda County,12,4,94022,47314,46708
50,6,1,California,Alameda County,12,5,95929,47745,48184
50,6,1,California,Alameda County,12,6,134440,67845,66595
50,6,1,California,Alameda County,12,7,144933,73126,71807
50,6,1,California,Alameda County,12,8,136827,68474,68353
50,6,1,California,Alameda County,12,9,117784,58925,58859
50,6,1,California,Alameda County,12,10,113120,56171,56949
50,6,1,California,Alameda County,12,11,105537,52616,52921
50,6,1,California,Alameda County,12,12,106693,52059,54634
50,6,1,California,Alameda County,12,13,96156,46450,49706
50,6,1,California,Alameda County,12,14,79234,36782,42452
50,6,1,California,Alameda County,12,15,61520,28004,33516
50,6,1,California,Alameda County,12,16,39867,17667,22200
50,6,1,California,Alameda County,12,17,26897,11322,15575
50,6,1,California,Alameda County,12,18,31165,11135,20030
50,6,1,California,Alameda County,13,0,1665644,820124,845520
50,6,1,California,Alameda County,13,1,93161,47572,45589
50,6,1,California,Alameda County,13,2,94671,48500,46171
50,6,1,California,Alameda County,13,3,93512,47942,45570
50,6,1,California,Alameda County,13,4,93750,47210,46540
50,6,1,California,Alameda County,13,5,93897,46698,47199
50,6,1,California,Alameda County,13,6,129777,65507,64270
50,6,1,California,Alameda County,13,7,146802,74086,72716
50,6,1,California,Alameda County,13,8,137424,68836,68588
50,6,1,California,Alameda County,13,9,119159,59707,59452
50,6,1,California,Alameda County,13,10,111722,55558,56164
50,6,1,California,Alameda County,13,11,105805,52683,53122
50,6,1,California,Alameda County,13,12,105481,51602,53879
50,6,1,California,Alameda County,13,13,96465,46692,49773
50,6,1,California,Alameda County,13,14,79928,37280,42648
50,6,1,California,Alameda County,13,15,63693,28983,34710
50,6,1,California,Alameda County,13,16,41354,18232,23122
50,6,1,California,Alameda County,13,17,27514,11655,15859
50,6,1,California,Alameda County,13,18,31529,11381,20148
50,6,1,California,Alameda County,14,0,1662323,818610,843713
50,6,1,California,Alameda County,14,1,92605,47254,45351
50,6,1,California,Alameda County,14,2,94155,48279,45876
50,6,1,California,Alameda County,14,3,93238,47792,45446
50,6,1,California,Alameda County,14,4,93376,47033,46343
50,6,1,California,Alameda County,14,5,92982,46229,46753
50,6,1,California,Alameda County,14,6,127869,64569,63300
50,6,1,California,Alameda County,14,7,147242,74312,72930
50,6,1,California,Alameda County,14,8,137607,68967,68640
50,6,1,California,Alameda County,14,9,119493,59897,59596
50,6,1,California,Alameda County,14,10,111224,55346,55878
50,6,1,California,Alameda County,14,11,105976,52738,53238
50,6,1,California,Alameda County,14,12,104972,51411,53561
50,6,1,California,Alameda County,14,13,96448,46691,49757
50,6,1,California,Alameda County,14,14,80120,37429,42691
50,6,1,California,Alameda County,14,15,64202,29195,35007
50,6,1,California,Alameda County,14,16,41741,18366,23375
50,6,1,California,Alameda County,14,17,27643,11727,15916
50,6,1,California,Alameda County,14,18,31430,11375,20055
50,6,3,California,Alpine County,1,0,1175,606,569
50,6,3,California,Alpine County,1,1,71,40,31
50,6,3,California,Alpine County,1,2,80,36,44
50,6,3,California,Alpine County,1,3,69,26,43
50,6,3,California,Alpine County,1,4,55,29,26
50,6,3,California,Alpine County,1,5,51,31,20
50,6,3,California,Alpine County,1,6,50,22,28
50,6,3,California,Alpine County,1,7,47,20,27
50,6,3,California,Alpine County,1,8,54,34,20
50,6,3,California,Alpine County,1,9,82,40,42
50,6,3,California,Alpine County,1,10,102,52,50
50,6,3,California,Alpine County,1,11,113,59,54
50,6,3,California,Alpine County,1,12,125,70,55
50,6,3,California,Alpine County,1,13,110,57,53
50,6,3,California,Alpine County,1,14,65,37,28
50,6,3,California,Alpine County,1,15,44,20,24
50,6,3,California,Alpine County,1,16,31,21,10
50,6,3,California,Alpine County,1,17,20,8,12
50,6,3,California,Alpine County,1,18,6,4,2
50,6,3,California,Alpine County,2,0,1175,606,569
50,6,3,California,Alpine County,2,1,71,40,31
50,6,3,California,Alpine County,2,2,80,36,44
50,6,3,California,Alpine County,2,3,69,26,43
50,6,3,California,Alpine County,2,4,55,29,26
50,6,3,California,Alpine County,2,5,51,31,20
50,6,3,California,Alpine County,2,6,50,22,28
50,6,3,California,Alpine County,2,7,47,20,27
50,6,3,California,Alpine County,2,8,54,34,20
50,6,3,California,Alpine County,2,9,82,40,42
50,6,3,California,Alpine County,2,10,102,52,50
50,6,3,California,Alpine County,2,11,113,59,54
50,6,3,California,Alpine County,2,12,125,70,55
50,6,3,California,Alpine County,2,13,110,57,53
50,6,3,California,Alpine County,2,14,65,37,28
50,6,3,California,Alpine County,2,15,44,20,24
50,6,3,California,Alpine County,2,16,31,21,10
50,6,3,California,Alpine County,2,17,20,8,12
50,6,3,California,Alpine County,2,18,6,4,2
50,6,3,California,Alpine County,3,0,1161,600,561
50,6,3,California,Alpine County,3,1,69,39,30
50,6,3,California,Alpine County,3,2,82,38,44
50,6,3,California,Alpine County,3,3,67,25,42
50,6,3,California,Alpine County,3,4,55,28,27
50,6,3,California,Alpine County,3,5,51,31,20
50,6,3,California,Alpine County,3,6,48,21,27
50,6,3,California,Alpine County,3,7,48,22,26
50,6,3,California,Alpine County,3,8,51,31,20
50,6,3,California,Alpine County,3,9,80,40,40
50,6,3,California,Alpine County,3,10,98,50,48
50,6,3,California,Alpine County,3,11,111,57,54
50,6,3,California,Alpine County,3,12,127,73,54
50,6,3,California,Alpine County,3,13,108,54,54
50,6,3,California,Alpine County,3,14,65,37,28
50,6,3,California,Alpine County,3,15,42,21,21
50,6,3,California,Alpine County,3,16,31,20,11
50,6,3,California,Alpine County,3,17,22,9,13
50,6,3,California,Alpine County,3,18,6,4,2
50,6,3,California,Alpine County,4,0,1093,567,526
50,6,3,California,Alpine County,4,1,49,23,26
50,6,3,California,Alpine County,4,2,70,38,32
50,6,3,California,Alpine County,4,3,59,26,33
50,6,3,California,Alpine County,4,4,52,23,29
50,6,3,California,Alpine County,4,5,43,26,17
50,6,3,California,Alpine County,4,6,51,26,25
50,6,3,California,Alpine County,4,7,42,20,22
50,6,3,California,Alpine County,4,8,47,28,19
50,6,3,California,Alpine County,4,9,75,39,36
50,6,3,California,Alpine County,4,10,91,48,43
50,6,3,California,Alpine County,4,11,106,55,51
50,6,3,California,Alpine County,4,12,121,68,53
50,6,3,California,Alpine County,4,13,120,58,62
50,6,3,California,Alpine County,4,14,65,35,30
50,6,3,California,Alpine County,4,15,36,19,17
50,6,3,California,Alpine County,4,16,36,20,16
50,6,3,California,Alpine County,4,17,26,14,12
50,6,3,California,Alpine County,4,18,4,1,3
50,6,3,California,Alpine County,5,0,1111,585,526
50,6,3,California,Alpine County,5,1,47,27,20
50,6,3,California,Alpine County,5,2,86,44,42
50,6,3,California,Alpine County,5,3,72,34,38
50,6,3,California,Alpine County,5,4,54,27,27
50,6,3,California,Alpine County,5,5,45,24,21
50,6,3,California,Alpine County,5,6,52,28,24
50,6,3,California,Alpine County,5,7,41,22,19
50,6,3,California,Alpine County,5,8,55,34,21
50,6,3,California,Alpine County,5,9,69,31,38
50,6,3,California,Alpine County,5,10,85,47,38
50,6,3,California,Alpine County,5,11,97,52,45
50,6,3,California,Alpine County,5,12,117,70,47
50,6,3,California,Alpine County,5,13,106,50,56
50,6,3,California,Alpine County,5,14,77,41,36
50,6,3,California,Alpine County,5,15,35,17,18
50,6,3,California,Alpine County,5,16,43,23,20
50,6,3,California,Alpine County,5,17,21,11,10
50,6,3,California,Alpine County,5,18,9,3,6
50,6,3,California,Alpine County,6,0,1131,594,537
50,6,3,California,Alpine County,6,1,40,24,16
50,6,3,California,Alpine County,6,2,80,36,44
50,6,3,California,Alpine County,6,3,80,45,35
50,6,3,California,Alpine County,6,4,66,33,33
50,6,3,California,Alpine County,6,5,51,30,21
50,6,3,California,Alpine County,6,6,55,28,27
50,6,3,California,Alpine County,6,7,38,21,17
50,6,3,California,Alpine County,6,8,46,25,21
50,6,3,California,Alpine County,6,9,68,36,32
50,6,3,California,Alpine County,6,10,75,33,42
50,6,3,California,Alpine County,6,11,102,61,41
50,6,3,California,Alpine County,6,12,112,64,48
50,6,3,California,Alpine County,6,13,109,53,56
50,6,3,California,Alpine County,6,14,90,44,46
50,6,3,California,Alpine County,6,15,38,21,17
50,6,3,California,Alpine County,6,16,45,23,22
50,6,3,California,Alpine County,6,17,25,14,11
50,6,3,California,Alpine County,6,18,11,3,8
50,6,3,California,Alpine County,7,0,1083,557,526
50,6,3,California,Alpine County,7,1,35,18,17
50,6,3,California,Alpine County,7,2,72,30,42
50,6,3,California,Alpine County,7,3,72,41,31
50,6,3,California,Alpine County,7,4,68,33,35
50,6,3,California,Alpine County,7,5,47,29,18
50,6,3,California,Alpine County,7,6,48,29,19
50,6,3,California,Alpine County,7,7,42,22,20
50,6,3,California,Alpine County,7,8,47,19,28
50,6,3,California,Alpine County,7,9,67,38,29
50,6,3,California,Alpine County,7,10,68,30,38
50,6,3,California,Alpine County,7,11,96,56,40
50,6,3,California,Alpine County,7,12,98,50,48
50,6,3,California,Alpine County,7,13,108,56,52
50,6,3,California,Alpine County,7,14,97,48,49
50,6,3,California,Alpine County,7,15,46,23,23
50,6,3,California,Alpine County,7,16,36,17,19
50,6,3,California,Alpine County,7,17,23,15,8
50,6,3,California,Alpine County,7,18,13,3,10
50,6,3,California,Alpine County,8,0,1080,568,512
50,6,3,California,Alpine County,8,1,39,19,20
50,6,3,California,Alpine County,8,2,62,30,32
50,6,3,California,Alpine County,8,3,68,40,28
50,6,3,California,Alpine County,8,4,63,31,32
50,6,3,California,Alpine County,8,5,54,34,20
50,6,3,California,Alpine County,8,6,60,37,23
50,6,3,California,Alpine County,8,7,36,16,20
50,6,3,California,Alpine County,8,8,42,20,22
50,6,3,California,Alpine County,8,9,58,30,28
50,6,3,California,Alpine County,8,10,76,40,36
50,6,3,California,Alpine County,8,11,98,53,45
50,6,3,California,Alpine County,8,12,92,47,45
50,6,3,California,Alpine County,8,13,108,63,45
50,6,3,California,Alpine County,8,14,96,44,52
50,6,3,California,Alpine County,8,15,55,28,27
50,6,3,California,Alpine County,8,16,32,14,18
50,6,3,California,Alpine County,8,17,24,17,7
50,6,3,California,Alpine County,8,18,17,5,12
50,6,3,California,Alpine County,9,0,1053,558,495
50,6,3,California,Alpine County,9,1,37,21,16
50,6,3,California,Alpine County,9,2,57,24,33
50,6,3,California,Alpine County,9,3,62,37,25
50,6,3,California,Alpine County,9,4,60,28,32
50,6,3,California,Alpine County,9,5,54,31,23
50,6,3,California,Alpine County,9,6,56,33,23
50,6,3,California,Alpine County,9,7,42,20,22
50,6,3,California,Alpine County,9,8,31,14,17
50,6,3,California,Alpine County,9,9,43,25,18
50,6,3,California,Alpine County,9,10,87,46,41
50,6,3,California,Alpine County,9,11,83,47,36
50,6,3,California,Alpine County,9,12,100,51,49
50,6,3,California,Alpine County,9,13,103,63,40
50,6,3,California,Alpine County,9,14,108,53,55
50,6,3,California,Alpine County,9,15,55,26,29
50,6,3,California,Alpine County,9,16,26,14,12
50,6,3,California,Alpine County,9,17,28,17,11
50,6,3,California,Alpine County,9,18,21,8,13
50,6,3,California,Alpine County,10,0,1116,608,508
50,6,3,California,Alpine County,10,1,39,24,15
50,6,3,California,Alpine County,10,2,55,28,27
50,6,3,California,Alpine County,10,3,75,44,31
50,6,3,California,Alpine County,10,4,68,34,34
50,6,3,California,Alpine County,10,5,62,40,22
50,6,3,California,Alpine County,10,6,64,36,28
50,6,3,California,Alpine County,10,7,50,27,23
50,6,3,California,Alpine County,10,8,40,22,18
50,6,3,California,Alpine County,10,9,50,25,25
50,6,3,California,Alpine County,10,10,71,38,33
50,6,3,California,Alpine County,10,11,79,42,37
50,6,3,California,Alpine County,10,12,111,61,50
50,6,3,California,Alpine County,10,13,98,59,39
50,6,3,California,Alpine County,10,14,108,56,52
50,6,3,California,Alpine County,10,15,67,33,34
50,6,3,California,Alpine County,10,16,29,14,15
50,6,3,California,Alpine County,10,17,28,16,12
50,6,3,California,Alpine County,10,18,22,9,13
50,6,3,California,Alpine County,11,0,1081,571,510
50,6,3,California,Alpine County,11,1,43,20,23
50,6,3,California,Alpine County,11,2,40,22,18
50,6,3,California,Alpine County,11,3,69,35,34
50,6,3,California,Alpine County,11,4,68,38,30
50,6,3,California,Alpine County,11,5,60,34,26
50,6,3,California,Alpine County,11,6,54,34,20
50,6,3,California,Alpine County,11,7,53,30,23
50,6,3,California,Alpine County,11,8,36,22,14
50,6,3,California,Alpine County,11,9,47,19,28
50,6,3,California,Alpine County,11,10,61,34,27
50,6,3,California,Alpine County,11,11,70,29,41
50,6,3,California,Alpine County,11,12,114,68,46
50,6,3,California,Alpine County,11,13,103,60,43
50,6,3,California,Alpine County,11,14,108,54,54
50,6,3,California,Alpine County,11,15,72,33,39
50,6,3,California,Alpine County,11,16,32,16,16
50,6,3,California,Alpine County,11,17,25,13,12
50,6,3,California,Alpine County,11,18,26,10,16
50,6,3,California,Alpine County,12,0,1113,592,521
50,6,3,California,Alpine County,12,1,46,18,28
50,6,3,California,Alpine County,12,2,43,20,23
50,6,3,California,Alpine County,12,3,66,39,27
50,6,3,California,Alpine County,12,4,75,43,32
50,6,3,California,Alpine County,12,5,70,33,37
50,6,3,California,Alpine County,12,6,62,42,20
50,6,3,California,Alpine County,12,7,56,29,27
50,6,3,California,Alpine County,12,8,44,25,19
50,6,3,California,Alpine County,12,9,49,26,23
50,6,3,California,Alpine County,12,10,61,27,34
50,6,3,California,Alpine County,12,11,60,24,36
50,6,3,California,Alpine County,12,12,89,62,27
50,6,3,California,Alpine County,12,13,109,55,54
50,6,3,California,Alpine County,12,14,114,67,47
50,6,3,California,Alpine County,12,15,83,43,40
50,6,3,California,Alpine County,12,16,36,16,20
50,6,3,California,Alpine County,12,17,25,13,12
50,6,3,California,Alpine County,12,18,25,10,15
50,6,3,California,Alpine County,13,0,1110,583,527
50,6,3,California,Alpine County,13,1,51,19,32
50,6,3,California,Alpine County,13,2,48,22,26
50,6,3,California,Alpine County,13,3,64,37,27
50,6,3,California,Alpine County,13,4,73,41,32
50,6,3,California,Alpine County,13,5,70,34,36
50,6,3,California,Alpine County,13,6,64,40,24
50,6,3,California,Alpine County,13,7,55,31,24
50,6,3,California,Alpine County,13,8,42,23,19
50,6,3,California,Alpine County,13,9,43,23,20
50,6,3,California,Alpine County,13,10,64,27,37
50,6,3,California,Alpine County,13,11,59,28,31
50,6,3,California,Alpine County,13,12,80,50,30
50,6,3,California,Alpine County,13,13,110,53,57
50,6,3,California,Alpine County,13,14,113,69,44
50,6,3,California,Alpine County,13,15,87,44,43
50,6,3,California,Alpine County,13,16,44,20,24
50,6,3,California,Alpine County,13,17,24,13,11
50,6,3,California,Alpine County,13,18,19,9,10
50,6,3,California,Alpine County,14,0,1119,585,534
50,6,3,California,Alpine County,14,1,50,18,32
50,6,3,California,Alpine County,14,2,50,23,27
50,6,3,California,Alpine County,14,3,63,37,26
50,6,3,California,Alpine County,14,4,74,41,33
50,6,3,California,Alpine County,14,5,69,32,37
50,6,3,California,Alpine County,14,6,64,40,24
50,6,3,California,Alpine County,14,7,59,34,25
50,6,3,California,Alpine County,14,8,46,26,20
50,6,3,California,Alpine County,14,9,43,23,20
50,6,3,California,Alpine County,14,10,63,26,37
50,6,3,California,Alpine County,14,11,65,32,33
50,6,3,California,Alpine County,14,12,79,48,31
50,6,3,California,Alpine County,14,13,107,50,57
50,6,3,California,Alpine County,14,14,114,70,44
50,6,3,California,Alpine County,14,15,88,44,44
50,6,3,California,Alpine County,14,16,46,21,25
50,6,3,California,Alpine County,14,17,22,12,10
50,6,3,California,Alpine County,14,18,17,8,9
50,6,5,California,Amador County,1,0,38091,20749,17342
50,6,5,California,Amador County,1,1,1431,697,734
50,6,5,California,Amador County,1,2,1655,819,836
50,6,5,California,Amador County,1,3,1881,934,947
50,6,5,California,Amador County,1,4,2288,1341,947
50,6,5,California,Amador County,1,5,1648,996,652
50,6,5,California,Amador County,1,6,1778,1065,713
50,6,5,California,Amador County,1,7,1862,1186,676
50,6,5,California,Amador County,1,8,2048,1267,781
50,6,5,California,Amador County,1,9,2470,1572,898
50,6,5,California,Amador County,1,10,3114,1848,1266
50,6,5,California,Amador County,1,11,3255,1795,1460
50,6,5,California,Amador County,1,12,3405,1731,1674
50,6,5,California,Amador County,1,13,3391,1708,1683
50,6,5,California,Amador County,1,14,2533,1297,1236
50,6,5,California,Amador County,1,15,1922,955,967
50,6,5,California,Amador County,1,16,1312,643,669
50,6,5,California,Amador County,1,17,1096,501,595
50,6,5,California,Amador County,1,18,1002,394,608
50,6,5,California,Amador County,2,0,38091,20749,17342
50,6,5,California,Amador County,2,1,1431,697,734
50,6,5,California,Amador County,2,2,1655,819,836
50,6,5,California,Amador County,2,3,1881,934,947
50,6,5,California,Amador County,2,4,2288,1341,947
50,6,5,California,Amador County,2,5,1648,996,652
50,6,5,California,Amador County,2,6,1778,1065,713
50,6,5,California,Amador County,2,7,1862,1186,676
50,6,5,California,Amador County,2,8,2048,1267,781
50,6,5,California,Amador County,2,9,2470,1572,898
50,6,5,California,Amador County,2,10,3114,1848,1266
50,6,5,California,Amador County,2,11,3255,1795,1460
50,6,5,California,Amador County,2,12,3405,1731,1674
50,6,5,California,Amador County,2,13,3391,1708,1683
50,6,5,California,Amador County,2,14,2533,1297,1236
50,6,5,California,Amador County,2,15,1922,955,967
50,6,5,California,Amador County,2,16,1312,643,669
50,6,5,California,Amador County,2,17,1096,501,595
50,6,5,California,Amador County,2,18,1002,394,608
50,6,5,California,Amador County,3,0,37883,20560,17323
50,6,5,California,Amador County,3,1,1432,696,736
50,6,5,California,Amador County,3,2,1635,812,823
50,6,5,California,Amador County,3,3,1849,918,931
50,6,5,California,Amador County,3,4,2223,1281,942
50,6,5,California,Amador County,3,5,1654,991,663
50,6,5,California,Amador County,3,6,1763,1047,716
50,6,5,California,Amador County,3,7,1859,1181,678
50,6,5,California,Amador County,3,8,2012,1241,771
50,6,5,California,Amador County,3,9,2436,1538,898
50,6,5,California,Amador County,3,10,3064,1818,1246
50,6,5,California,Amador County,3,11,3226,1776,1450
50,6,5,California,Amador County,3,12,3396,1728,1668
50,6,5,California,Amador County,3,13,3400,1710,1690
50,6,5,California,Amador County,3,14,2563,1306,1257
50,6,5,California,Amador County,3,15,1935,963,972
50,6,5,California,Amador County,3,16,1329,649,680
50,6,5,California,Amador County,3,17,1087,499,588
50,6,5,California,Amador County,3,18,1020,406,614
50,6,5,California,Amador County,4,0,37539,20301,17238
50,6,5,California,Amador County,4,1,1375,682,693
50,6,5,California,Amador County,4,2,1612,801,811
50,6,5,California,Amador County,4,3,1776,873,903
50,6,5,California,Amador County,4,4,2135,1216,919
50,6,5,California,Amador County,4,5,1658,983,675
50,6,5,California,Amador County,4,6,1768,1040,728
50,6,5,California,Amador County,4,7,1891,1178,713
50,6,5,California,Amador County,4,8,1936,1199,737
50,6,5,California,Amador County,4,9,2399,1497,902
50,6,5,California,Amador County,4,10,2894,1732,1162
50,6,5,California,Amador County,4,11,3168,1740,1428
50,6,5,California,Amador County,4,12,3364,1722,1642
50,6,5,California,Amador County,4,13,3460,1731,1729
50,6,5,California,Amador County,4,14,2692,1342,1350
50,6,5,California,Amador County,4,15,1960,984,976
50,6,5,California,Amador County,4,16,1358,660,698
50,6,5,California,Amador County,4,17,1064,491,573
50,6,5,California,Amador County,4,18,1029,430,599
50,6,5,California,Amador County,5,0,37105,19954,17151
50,6,5,California,Amador County,5,1,1366,674,692
50,6,5,California,Amador County,5,2,1561,764,797
50,6,5,California,Amador County,5,3,1710,852,858
50,6,5,California,Amador County,5,4,1876,1003,873
50,6,5,California,Amador County,5,5,1669,942,727
50,6,5,California,Amador County,5,6,1750,1067,683
50,6,5,California,Amador County,5,7,1921,1183,738
50,6,5,California,Amador County,5,8,1904,1172,732
50,6,5,California,Amador County,5,9,2293,1434,859
50,6,5,California,Amador County,5,10,2717,1660,1057
50,6,5,California,Amador County,5,11,3149,1728,1421
50,6,5,California,Amador County,5,12,3300,1698,1602
50,6,5,California,Amador County,5,13,3331,1656,1675
50,6,5,California,Amador County,5,14,2984,1478,1506
50,6,5,California,Amador County,5,15,2054,1013,1041
50,6,5,California,Amador County,5,16,1423,705,718
50,6,5,California,Amador County,5,17,1017,465,552
50,6,5,California,Amador County,5,18,1080,460,620
50,6,5,California,Amador County,6,0,36624,19475,17149
50,6,5,California,Amador County,6,1,1355,728,627
50,6,5,California,Amador County,6,2,1524,747,777
50,6,5,California,Amador County,6,3,1689,844,845
50,6,5,California,Amador County,6,4,1772,930,842
50,6,5,California,Amador County,6,5,1705,930,775
50,6,5,California,Amador County,6,6,1705,1018,687
50,6,5,California,Amador County,6,7,1875,1114,761
50,6,5,California,Amador County,6,8,1819,1128,691
50,6,5,California,Amador County,6,9,2179,1319,860
50,6,5,California,Amador County,6,10,2489,1496,993
50,6,5,California,Amador County,6,11,3058,1639,1419
50,6,5,California,Amador County,6,12,3194,1624,1570
50,6,5,California,Amador County,6,13,3385,1647,1738
50,6,5,California,Amador County,6,14,3120,1564,1556
50,6,5,California,Amador County,6,15,2130,1056,1074
50,6,5,California,Amador County,6,16,1512,766,746
50,6,5,California,Amador County,6,17,993,455,538
50,6,5,California,Amador County,6,18,1120,470,650
50,6,5,California,Amador County,7,0,36734,19510,17224
50,6,5,California,Amador County,7,1,1411,753,658
50,6,5,California,Amador County,7,2,1509,733,776
50,6,5,California,Amador County,7,3,1656,831,825
50,6,5,California,Amador County,7,4,1707,893,814
50,6,5,California,Amador County,7,5,1748,950,798
50,6,5,California,Amador County,7,6,1721,1037,684
50,6,5,California,Amador County,7,7,1923,1121,802
50,6,5,California,Amador County,7,8,1849,1155,694
50,6,5,California,Amador County,7,9,2105,1282,823
50,6,5,California,Amador County,7,10,2376,1422,954
50,6,5,California,Amador County,7,11,3002,1634,1368
50,6,5,California,Amador County,7,12,3094,1575,1519
50,6,5,California,Amador County,7,13,3422,1671,1751
50,6,5,California,Amador County,7,14,3237,1586,1651
50,6,5,California,Amador County,7,15,2242,1117,1125
50,6,5,California,Amador County,7,16,1581,783,798
50,6,5,California,Amador County,7,17,1004,484,520
50,6,5,California,Amador County,7,18,1147,483,664
50,6,5,California,Amador County,8,0,37039,19659,17380
50,6,5,California,Amador County,8,1,1469,800,669
50,6,5,California,Amador County,8,2,1493,733,760
50,6,5,California,Amador County,8,3,1668,846,822
50,6,5,California,Amador County,8,4,1713,880,833
50,6,5,California,Amador County,8,5,1664,914,750
50,6,5,California,Amador County,8,6,1864,1102,762
50,6,5,California,Amador County,8,7,1922,1116,806
50,6,5,California,Amador County,8,8,1896,1180,716
50,6,5,California,Amador County,8,9,2058,1266,792
50,6,5,California,Amador County,8,10,2374,1438,936
50,6,5,California,Amador County,8,11,2900,1603,1297
50,6,5,California,Amador County,8,12,3088,1544,1544
50,6,5,California,Amador County,8,13,3380,1659,1721
50,6,5,California,Amador County,8,14,3399,1640,1759
50,6,5,California,Amador County,8,15,2384,1187,1197
50,6,5,California,Amador County,8,16,1645,807,838
50,6,5,California,Amador County,8,17,992,471,521
50,6,5,California,Amador County,8,18,1130,473,657
50,6,5,California,Amador County,9,0,37443,19844,17599
50,6,5,California,Amador County,9,1,1562,827,735
50,6,5,California,Amador County,9,2,1548,773,775
50,6,5,California,Amador County,9,3,1679,863,816
50,6,5,California,Amador County,9,4,1672,862,810
50,6,5,California,Amador County,9,5,1621,897,724
50,6,5,California,Amador County,9,6,1928,1123,805
50,6,5,California,Amador County,9,7,1976,1144,832
50,6,5,California,Amador County,9,8,2030,1239,791
50,6,5,California,Amador County,9,9,2027,1266,761
50,6,5,California,Amador County,9,10,2346,1396,950
50,6,5,California,Amador County,9,11,2801,1556,1245
50,6,5,California,Amador County,9,12,3114,1568,1546
50,6,5,California,Amador County,9,13,3305,1624,1681
50,6,5,California,Amador County,9,14,3543,1701,1842
50,6,5,California,Amador County,9,15,2487,1233,1254
50,6,5,California,Amador County,9,16,1665,830,835
50,6,5,California,Amador County,9,17,1029,477,552
50,6,5,California,Amador County,9,18,1110,465,645
50,6,5,California,Amador County,10,0,38549,20764,17785
50,6,5,California,Amador County,10,1,1589,836,753
50,6,5,California,Amador County,10,2,1550,809,741
50,6,5,California,Amador County,10,3,1656,830,826
50,6,5,California,Amador County,10,4,1689,883,806
50,6,5,California,Amador County,10,5,1644,936,708
50,6,5,California,Amador County,10,6,2045,1218,827
50,6,5,California,Amador County,10,7,2088,1258,830
50,6,5,California,Amador County,10,8,2201,1369,832
50,6,5,California,Amador County,10,9,2174,1394,780
50,6,5,California,Amador County,10,10,2457,1505,952
50,6,5,California,Amador County,10,11,2802,1608,1194
50,6,5,California,Amador County,10,12,3152,1605,1547
50,6,5,California,Amador County,10,13,3303,1646,1657
50,6,5,California,Amador County,10,14,3485,1674,1811
50,6,5,California,Amador County,10,15,2819,1369,1450
50,6,5,California,Amador County,10,16,1727,846,881
50,6,5,California,Amador County,10,17,1091,524,567
50,6,5,California,Amador County,10,18,1077,454,623
50,6,5,California,Amador County,11,0,39349,21393,17956
50,6,5,California,Amador County,11,1,1619,849,770
50,6,5,California,Amador County,11,2,1583,865,718
50,6,5,California,Amador County,11,3,1697,834,863
50,6,5,California,Amador County,11,4,1673,884,789
50,6,5,California,Amador County,11,5,1591,910,681
50,6,5,California,Amador County,11,6,2166,1288,878
50,6,5,California,Amador County,11,7,2142,1322,820
50,6,5,California,Amador County,11,8,2375,1482,893
50,6,5,California,Amador County,11,9,2287,1530,757
50,6,5,California,Amador County,11,10,2501,1553,948
50,6,5,California,Amador County,11,11,2738,1580,1158
50,6,5,California,Amador County,11,12,3150,1655,1495
50,6,5,California,Amador County,11,13,3313,1648,1665
50,6,5,California,Amador County,11,14,3483,1663,1820
50,6,5,California,Amador County,11,15,2940,1428,1512
50,6,5,California,Amador County,11,16,1842,895,947
50,6,5,California,Amador County,11,17,1164,569,595
50,6,5,California,Amador County,11,18,1085,438,647
50,6,5,California,Amador County,12,0,39693,21565,18128
50,6,5,California,Amador County,12,1,1596,840,756
50,6,5,California,Amador County,12,2,1669,912,757
50,6,5,California,Amador County,12,3,1710,838,872
50,6,5,California,Amador County,12,4,1657,893,764
50,6,5,California,Amador County,12,5,1565,885,680
50,6,5,California,Amador County,12,6,2152,1267,885
50,6,5,California,Amador County,12,7,2225,1367,858
50,6,5,California,Amador County,12,8,2358,1456,902
50,6,5,California,Amador County,12,9,2378,1579,799
50,6,5,California,Amador County,12,10,2450,1551,899
50,6,5,California,Amador County,12,11,2601,1512,1089
50,6,5,California,Amador County,12,12,3165,1654,1511
50,6,5,California,Amador County,12,13,3293,1668,1625
50,6,5,California,Amador County,12,14,3450,1655,1795
50,6,5,California,Amador County,12,15,3132,1494,1638
50,6,5,California,Amador County,12,16,1942,945,997
50,6,5,California,Amador County,12,17,1225,586,639
50,6,5,California,Amador County,12,18,1125,463,662
50,6,5,California,Amador County,13,0,40045,21761,18284
50,6,5,California,Amador County,13,1,1597,848,749
50,6,5,California,Amador County,13,2,1715,918,797
50,6,5,California,Amador County,13,3,1676,840,836
50,6,5,California,Amador County,13,4,1651,884,767
50,6,5,California,Amador County,13,5,1583,906,677
50,6,5,California,Amador County,13,6,2157,1280,877
50,6,5,California,Amador County,13,7,2329,1415,914
50,6,5,California,Amador County,13,8,2361,1445,916
50,6,5,California,Amador County,13,9,2417,1614,803
50,6,5,California,Amador County,13,10,2395,1509,886
50,6,5,California,Amador County,13,11,2579,1521,1058
50,6,5,California,Amador County,13,12,3083,1599,1484
50,6,5,California,Amador County,13,13,3325,1672,1653
50,6,5,California,Amador County,13,14,3500,1686,1814
50,6,5,California,Amador County,13,15,3237,1537,1700
50,6,5,California,Amador County,13,16,2060,1016,1044
50,6,5,California,Amador County,13,17,1251,603,648
50,6,5,California,Amador County,13,18,1129,468,661
50,6,5,California,Amador County,14,0,40083,21781,18302
50,6,5,California,Amador County,14,1,1591,848,743
50,6,5,California,Amador County,14,2,1720,917,803
50,6,5,California,Amador County,14,3,1661,839,822
50,6,5,California,Amador County,14,4,1644,876,768
50,6,5,California,Amador County,14,5,1589,912,677
50,6,5,California,Amador County,14,6,2152,1283,869
50,6,5,California,Amador County,14,7,2366,1432,934
50,6,5,California,Amador County,14,8,2362,1444,918
50,6,5,California,Amador County,14,9,2436,1629,807
50,6,5,California,Amador County,14,10,2374,1496,878
50,6,5,California,Amador County,14,11,2578,1525,1053
50,6,5,California,Amador County,14,12,3054,1579,1475
50,6,5,California,Amador County,14,13,3324,1667,1657
50,6,5,California,Amador County,14,14,3506,1688,1818
50,6,5,California,Amador County,14,15,3266,1545,1721
50,6,5,California,Amador County,14,16,2086,1031,1055
50,6,5,California,Amador County,14,17,1249,602,647
50,6,5,California,Amador County,14,18,1125,468,657
50,6,7,California,Butte County,1,0,220000,108931,111069
50,6,7,California,Butte County,1,1,12409,6243,6166
50,6,7,California,Butte County,1,2,12439,6320,6119
50,6,7,California,Butte County,1,3,12911,6616,6295
50,6,7,California,Butte County,1,4,17841,9158,8683
50,6,7,California,Butte County,1,5,22818,11905,10913
50,6,7,California,Butte County,1,6,14721,7824,6897
50,6,7,California,Butte County,1,7,11960,6213,5747
50,6,7,California,Butte County,1,8,11482,5864,5618
50,6,7,California,Butte County,1,9,11847,5969,5878
50,6,7,California,Butte County,1,10,13849,6683,7166
50,6,7,California,Butte County,1,11,15028,7405,7623
50,6,7,California,Butte County,1,12,15265,7340,7925
50,6,7,California,Butte County,1,13,13613,6640,6973
50,6,7,California,Butte County,1,14,9805,4647,5158
50,6,7,California,Butte County,1,15,7380,3414,3966
50,6,7,California,Butte County,1,16,5925,2680,3245
50,6,7,California,Butte County,1,17,5037,2052,2985
50,6,7,California,Butte County,1,18,5670,1958,3712
50,6,7,California,Butte County,2,0,220005,108933,111072
50,6,7,California,Butte County,2,1,12410,6243,6167
50,6,7,California,Butte County,2,2,12439,6320,6119
50,6,7,California,Butte County,2,3,12911,6616,6295
50,6,7,California,Butte County,2,4,17841,9158,8683
50,6,7,California,Butte County,2,5,22819,11905,10914
50,6,7,California,Butte County,2,6,14721,7824,6897
50,6,7,California,Butte County,2,7,11960,6213,5747
50,6,7,California,Butte County,2,8,11482,5864,5618
50,6,7,California,Butte County,2,9,11847,5969,5878
50,6,7,California,Butte County,2,10,13850,6684,7166
50,6,7,California,Butte County,2,11,15030,7406,7624
50,6,7,California,Butte County,2,12,15265,7340,7925
50,6,7,California,Butte County,2,13,13613,6640,6973
50,6,7,California,Butte County,2,14,9805,4647,5158
50,6,7,California,Butte County,2,15,7380,3414,3966
50,6,7,California,Butte County,2,16,5925,2680,3245
50,6,7,California,Butte County,2,17,5037,2052,2985
50,6,7,California,Butte County,2,18,5670,1958,3712
50,6,7,California,Butte County,3,0,219951,108854,111097
50,6,7,California,Butte County,3,1,12399,6259,6140
50,6,7,California,Butte County,3,2,12398,6291,6107
50,6,7,California,Butte County,3,3,12867,6586,6281
50,6,7,California,Butte County,3,4,17444,8929,8515
50,6,7,California,Butte County,3,5,23242,12128,11114
50,6,7,California,Butte County,3,6,14692,7757,6935
50,6,7,California,Butte County,3,7,12051,6265,5786
50,6,7,California,Butte County,3,8,11393,5814,5579
50,6,7,California,Butte County,3,9,11824,5958,5866
50,6,7,California,Butte County,3,10,13735,6646,7089
50,6,7,California,Butte County,3,11,14969,7364,7605
50,6,7,California,Butte County,3,12,15256,7349,7907
50,6,7,California,Butte County,3,13,13764,6710,7054
50,6,7,California,Butte County,3,14,9872,4674,5198
50,6,7,California,Butte County,3,15,7438,3443,3995
50,6,7,California,Butte County,3,16,5912,2675,3237
50,6,7,California,Butte County,3,17,5004,2041,2963
50,6,7,California,Butte County,3,18,5691,1965,3726
50,6,7,California,Butte County,4,0,219983,108981,111002
50,6,7,California,Butte County,4,1,12285,6322,5963
50,6,7,California,Butte County,4,2,12442,6247,6195
50,6,7,California,Butte County,4,3,12716,6533,6183
50,6,7,California,Butte County,4,4,16382,8365,8017
50,6,7,California,Butte County,4,5,24812,13007,11805
50,6,7,California,Butte County,4,6,14220,7389,6831
50,6,7,California,Butte County,4,7,12409,6447,5962
50,6,7,California,Butte County,4,8,11083,5636,5447
50,6,7,California,Butte County,4,9,11864,6000,5864
50,6,7,California,Butte County,4,10,13108,6387,6721
50,6,7,California,Butte County,4,11,14730,7208,7522
50,6,7,California,Butte County,4,12,15213,7345,7868
50,6,7,California,Butte County,4,13,14368,6971,7397
50,6,7,California,Butte County,4,14,10147,4839,5308
50,6,7,California,Butte County,4,15,7594,3526,4068
50,6,7,California,Butte County,4,16,5946,2705,3241
50,6,7,California,Butte County,4,17,4900,2033,2867
50,6,7,California,Butte County,4,18,5764,2021,3743
50,6,7,California,Butte County,5,0,220877,109427,111450
50,6,7,California,Butte County,5,1,12124,6225,5899
50,6,7,California,Butte County,5,2,12586,6325,6261
50,6,7,California,Butte County,5,3,12600,6543,6057
50,6,7,California,Butte County,5,4,16158,8182,7976
50,6,7,California,Butte County,5,5,26108,13609,12499
50,6,7,California,Butte County,5,6,13606,7089,6517
50,6,7,California,Butte County,5,7,12685,6617,6068
50,6,7,California,Butte County,5,8,11078,5645,5433
50,6,7,California,Butte County,5,9,11772,5959,5813
50,6,7,California,Butte County,5,10,12618,6173,6445
50,6,7,California,Butte County,5,11,14404,7045,7359
50,6,7,California,Butte County,5,12,15183,7339,7844
50,6,7,California,Butte County,5,13,14268,6873,7395
50,6,7,California,Butte County,5,14,11214,5374,5840
50,6,7,California,Butte County,5,15,7839,3655,4184
50,6,7,California,Butte County,5,16,6010,2685,3325
50,6,7,California,Butte County,5,17,4808,2048,2760
50,6,7,California,Butte County,5,18,5816,2041,3775
50,6,7,California,Butte County,6,0,221649,109713,111936
50,6,7,California,Butte County,6,1,12065,6163,5902
50,6,7,California,Butte County,6,2,12602,6368,6234
50,6,7,California,Butte County,6,3,12619,6530,6089
50,6,7,California,Butte County,6,4,15953,8099,7854
50,6,7,California,Butte County,6,5,26508,13669,12839
50,6,7,California,Butte County,6,6,13545,7149,6396
50,6,7,California,Butte County,6,7,13013,6751,6262
50,6,7,California,Butte County,6,8,11260,5748,5512
50,6,7,California,Butte County,6,9,11670,5904,5766
50,6,7,California,Butte County,6,10,12143,5948,6195
50,6,7,California,Butte County,6,11,14104,6842,7262
50,6,7,California,Butte County,6,12,14981,7279,7702
50,6,7,California,Butte County,6,13,14569,6972,7597
50,6,7,California,Butte County,6,14,11796,5653,6143
50,6,7,California,Butte County,6,15,8234,3841,4393
50,6,7,California,Butte County,6,16,6160,2771,3389
50,6,7,California,Butte County,6,17,4661,2021,2640
50,6,7,California,Butte County,6,18,5766,2005,3761
50,6,7,California,Butte County,7,0,223525,110572,112953
50,6,7,California,Butte County,7,1,12294,6347,5947
50,6,7,California,Butte County,7,2,12536,6377,6159
50,6,7,California,Butte County,7,3,12771,6480,6291
50,6,7,California,Butte County,7,4,15779,8006,7773
50,6,7,California,Butte County,7,5,26444,13560,12884
50,6,7,California,Butte County,7,6,13873,7361,6512
50,6,7,California,Butte County,7,7,13454,6988,6466
50,6,7,California,Butte County,7,8,11586,5890,5696
50,6,7,California,Butte County,7,9,11557,5863,5694
50,6,7,California,Butte County,7,10,11864,5869,5995
50,6,7,California,Butte County,7,11,13835,6662,7173
50,6,7,California,Butte County,7,12,14938,7241,7697
50,6,7,California,Butte County,7,13,14785,7067,7718
50,6,7,California,Butte County,7,14,12472,5990,6482
50,6,7,California,Butte County,7,15,8640,4021,4619
50,6,7,California,Butte County,7,16,6309,2858,3451
50,6,7,California,Butte County,7,17,4655,2015,2640
50,6,7,California,Butte County,7,18,5733,1977,3756
50,6,7,California,Butte County,8,0,224643,111062,113581
50,6,7,California,Butte County,8,1,12381,6439,5942
50,6,7,California,Butte County,8,2,12563,6370,6193
50,6,7,California,Butte County,8,3,12717,6474,6243
50,6,7,California,Butte County,8,4,15711,7919,7792
50,6,7,California,Butte County,8,5,25799,13205,12594
50,6,7,California,Butte County,8,6,14639,7759,6880
50,6,7,California,Butte County,8,7,13459,6925,6534
50,6,7,California,Butte County,8,8,12061,6185,5876
50,6,7,California,Butte County,8,9,11376,5798,5578
50,6,7,California,Butte County,8,10,11754,5823,5931
50,6,7,California,Butte County,8,11,13502,6451,7051
50,6,7,California,Butte County,8,12,14811,7185,7626
50,6,7,California,Butte County,8,13,14875,7066,7809
50,6,7,California,Butte County,8,14,13122,6339,6783
50,6,7,California,Butte County,8,15,9019,4217,4802
50,6,7,California,Butte County,8,16,6417,2901,3516
50,6,7,California,Butte County,8,17,4714,2033,2681
50,6,7,California,Butte County,8,18,5723,1973,3750
50,6,7,California,Butte County,9,0,226222,111795,114427
50,6,7,California,Butte County,9,1,12378,6397,5981
50,6,7,California,Butte County,9,2,12619,6484,6135
50,6,7,California,Butte County,9,3,12679,6412,6267
50,6,7,California,Butte County,9,4,15604,7875,7729
50,6,7,California,Butte County,9,5,25137,12809,12328
50,6,7,California,Butte County,9,6,15706,8360,7346
50,6,7,California,Butte County,9,7,13558,6927,6631
50,6,7,California,Butte County,9,8,12570,6465,6105
50,6,7,California,Butte County,9,9,11259,5718,5541
50,6,7,California,Butte County,9,10,11848,5885,5963
50,6,7,California,Butte County,9,11,13004,6255,6749
50,6,7,California,Butte County,9,12,14580,7035,7545
50,6,7,California,Butte County,9,13,14993,7139,7854
50,6,7,California,Butte County,9,14,13906,6655,7251
50,6,7,California,Butte County,9,15,9323,4345,4978
50,6,7,California,Butte County,9,16,6628,3001,3627
50,6,7,California,Butte County,9,17,4726,2050,2676
50,6,7,California,Butte County,9,18,5704,1983,3721
50,6,7,California,Butte County,10,0,228700,112893,115807
50,6,7,California,Butte County,10,1,12521,6421,6100
50,6,7,California,Butte County,10,2,12718,6538,6180
50,6,7,California,Butte County,10,3,12790,6453,6337
50,6,7,California,Butte County,10,4,15573,7888,7685
50,6,7,California,Butte County,10,5,24993,12615,12378
50,6,7,California,Butte County,10,6,16519,8778,7741
50,6,7,California,Butte County,10,7,13402,6811,6591
50,6,7,California,Butte County,10,8,13177,6787,6390
50,6,7,California,Butte County,10,9,11381,5759,5622
50,6,7,California,Butte County,10,10,11979,5983,5996
50,6,7,California,Butte County,10,11,12634,6134,6500
50,6,7,California,Butte County,10,12,14398,6901,7497
50,6,7,California,Butte County,10,13,15140,7211,7929
50,6,7,California,Butte County,10,14,13956,6611,7345
50,6,7,California,Butte County,10,15,10361,4862,5499
50,6,7,California,Butte County,10,16,6791,3131,3660
50,6,7,California,Butte County,10,17,4754,2035,2719
50,6,7,California,Butte County,10,18,5613,1975,3638
50,6,7,California,Butte County,11,0,230330,113681,116649
50,6,7,California,Butte County,11,1,12639,6492,6147
50,6,7,California,Butte County,11,2,12722,6561,6161
50,6,7,California,Butte County,11,3,12926,6584,6342
50,6,7,California,Butte County,11,4,15618,7872,7746
50,6,7,California,Butte County,11,5,24812,12531,12281
50,6,7,California,Butte County,11,6,16823,8803,8020
50,6,7,California,Butte County,11,7,13381,6866,6515
50,6,7,California,Butte County,11,8,13639,7011,6628
50,6,7,California,Butte County,11,9,11661,5926,5735
50,6,7,California,Butte County,11,10,11918,5947,5971
50,6,7,California,Butte County,11,11,12206,5932,6274
50,6,7,California,Butte County,11,12,14259,6816,7443
50,6,7,California,Butte County,11,13,15007,7134,7873
50,6,7,California,Butte County,11,14,14280,6749,7531
50,6,7,California,Butte County,11,15,10944,5160,5784
50,6,7,California,Butte County,11,16,7073,3241,3832
50,6,7,California,Butte County,11,17,4875,2105,2770
50,6,7,California,Butte County,11,18,5547,1951,3596
50,6,7,California,Butte County,12,0,218726,108163,110563
50,6,7,California,Butte County,12,1,11897,6096,5801
50,6,7,California,Butte County,12,2,12399,6424,5975
50,6,7,California,Butte County,12,3,12356,6300,6056
50,6,7,California,Butte County,12,4,15191,7572,7619
50,6,7,California,Butte County,12,5,23871,12043,11828
50,6,7,California,Butte County,12,6,15976,8321,7655
50,6,7,California,Butte County,12,7,12863,6626,6237
50,6,7,California,Butte County,12,8,13173,6778,6395
50,6,7,California,Butte County,12,9,11592,5859,5733
50,6,7,California,Butte County,12,10,11178,5596,5582
50,6,7,California,Butte County,12,11,11356,5626,5730
50,6,7,California,Butte County,12,12,13172,6292,6880
50,6,7,California,Butte County,12,13,13742,6608,7134
50,6,7,California,Butte County,12,14,13233,6211,7022
50,6,7,California,Butte County,12,15,10554,5049,5505
50,6,7,California,Butte County,12,16,6722,3062,3660
50,6,7,California,Butte County,12,17,4458,1925,2533
50,6,7,California,Butte County,12,18,4993,1775,3218
50,6,7,California,Butte County,13,0,214384,106059,108325
50,6,7,California,Butte County,13,1,11560,5925,5635
50,6,7,California,Butte County,13,2,12164,6331,5833
50,6,7,California,Butte County,13,3,12166,6179,5987
50,6,7,California,Butte County,13,4,15000,7411,7589
50,6,7,California,Butte County,13,5,23522,11914,11608
50,6,7,California,Butte County,13,6,15299,7975,7324
50,6,7,California,Butte County,13,7,12801,6640,6161
50,6,7,California,Butte County,13,8,12967,6620,6347
50,6,7,California,Butte County,13,9,11614,5926,5688
50,6,7,California,Butte County,13,10,10828,5451,5377
50,6,7,California,Butte County,13,11,11055,5463,5592
50,6,7,California,Butte County,13,12,12610,5991,6619
50,6,7,California,Butte County,13,13,13411,6445,6966
50,6,7,California,Butte County,13,14,12769,5992,6777
50,6,7,California,Butte County,13,15,10598,5084,5514
50,6,7,California,Butte County,13,16,6753,3071,3682
50,6,7,California,Butte County,13,17,4349,1894,2455
50,6,7,California,Butte County,13,18,4918,1747,3171
50,6,7,California,Butte County,14,0,212744,105259,107485
50,6,7,California,Butte County,14,1,11440,5863,5577
50,6,7,California,Butte County,14,2,12063,6288,5775
50,6,7,California,Butte County,14,3,12098,6134,5964
50,6,7,California,Butte County,14,4,14919,7348,7571
50,6,7,California,Butte County,14,5,23373,11856,11517
50,6,7,California,Butte County,14,6,15059,7857,7202
50,6,7,California,Butte County,14,7,12778,6639,6139
50,6,7,California,Butte County,14,8,12916,6577,6339
50,6,7,California,Butte County,14,9,11624,5950,5674
50,6,7,California,Butte County,14,10,10708,5399,5309
50,6,7,California,Butte County,14,11,10978,5420,5558
50,6,7,California,Butte County,14,12,12421,5891,6530
50,6,7,California,Butte County,14,13,13285,6379,6906
50,6,7,California,Butte County,14,14,12608,5918,6690
50,6,7,California,Butte County,14,15,10576,5077,5499
50,6,7,California,Butte County,14,16,6737,3062,3675
50,6,7,California,Butte County,14,17,4301,1877,2424
50,6,7,California,Butte County,14,18,4860,1724,3136
50,6,9,California,Calaveras County,1,0,45578,22822,22756
50,6,9,California,Calaveras County,1,1,1992,1000,992
50,6,9,California,Calaveras County,1,2,2239,1149,1090
50,6,9,California,Calaveras County,1,3,2770,1429,1341
50,6,9,California,Calaveras County,1,4,2893,1589,1304
50,6,9,California,Calaveras County,1,5,1883,994,889
50,6,9,California,Calaveras County,1,6,1829,972,857
50,6,9,California,Calaveras County,1,7,1779,892,887
50,6,9,California,Calaveras County,1,8,2017,1008,1009
50,6,9,California,Calaveras County,1,9,2588,1258,1330
50,6,9,California,Calaveras County,1,10,3421,1689,1732
50,6,9,California,Calaveras County,1,11,4144,2027,2117
50,6,9,California,Calaveras County,1,12,4233,2031,2202
50,6,9,California,Calaveras County,1,13,4225,2102,2123
50,6,9,California,Calaveras County,1,14,3307,1671,1636
50,6,9,California,Calaveras County,1,15,2502,1268,1234
50,6,9,California,Calaveras County,1,16,1686,849,837
50,6,9,California,Calaveras County,1,17,1098,529,569
50,6,9,California,Calaveras County,1,18,972,365,607
50,6,9,California,Calaveras County,2,0,45577,22822,22755
50,6,9,California,Calaveras County,2,1,1992,1000,992
50,6,9,California,Calaveras County,2,2,2239,1149,1090
50,6,9,California,Calaveras County,2,3,2770,1429,1341
50,6,9,California,Calaveras County,2,4,2893,1589,1304
50,6,9,California,Calaveras County,2,5,1883,994,889
50,6,9,California,Calaveras County,2,6,1829,972,857
50,6,9,California,Calaveras County,2,7,1779,892,887
50,6,9,California,Calaveras County,2,8,2017,1008,1009
50,6,9,California,Calaveras County,2,9,2588,1258,1330
50,6,9,California,Calaveras County,2,10,3421,1689,1732
50,6,9,California,Calaveras County,2,11,4144,2027,2117
50,6,9,California,Calaveras County,2,12,4233,2031,2202
50,6,9,California,Calaveras County,2,13,4225,2102,2123
50,6,9,California,Calaveras County,2,14,3307,1671,1636
50,6,9,California,Calaveras County,2,15,2502,1268,1234
50,6,9,California,Calaveras County,2,16,1686,849,837
50,6,9,California,Calaveras County,2,17,1098,529,569
50,6,9,California,Calaveras County,2,18,971,365,606
50,6,9,California,Calaveras County,3,0,45467,22751,22716
50,6,9,California,Calaveras County,3,1,1966,991,975
50,6,9,California,Calaveras County,3,2,2210,1133,1077
50,6,9,California,Calaveras County,3,3,2747,1416,1331
50,6,9,California,Calaveras County,3,4,2875,1578,1297
50,6,9,California,Calaveras County,3,5,1899,1002,897
50,6,9,California,Calaveras County,3,6,1848,983,865
50,6,9,California,Calaveras County,3,7,1775,889,886
50,6,9,California,Calaveras County,3,8,1991,998,993
50,6,9,California,Calaveras County,3,9,2559,1233,1326
50,6,9,California,Calaveras County,3,10,3375,1677,1698
50,6,9,California,Calaveras County,3,11,4127,2010,2117
50,6,9,California,Calaveras County,3,12,4242,2021,2221
50,6,9,California,Calaveras County,3,13,4225,2109,2116
50,6,9,California,Calaveras County,3,14,3338,1688,1650
50,6,9,California,Calaveras County,3,15,2518,1276,1242
50,6,9,California,Calaveras County,3,16,1691,852,839
50,6,9,California,Calaveras County,3,17,1105,528,577
50,6,9,California,Calaveras County,3,18,976,367,609
50,6,9,California,Calaveras County,4,0,45159,22606,22553
50,6,9,California,Calaveras County,4,1,1897,972,925
50,6,9,California,Calaveras County,4,2,2118,1076,1042
50,6,9,California,Calaveras County,4,3,2653,1377,1276
50,6,9,California,Calaveras County,4,4,2835,1525,1310
50,6,9,California,Calaveras County,4,5,1942,1018,924
50,6,9,California,Calaveras County,4,6,1933,1044,889
50,6,9,California,Calaveras County,4,7,1818,925,893
50,6,9,California,Calaveras County,4,8,1874,939,935
50,6,9,California,Calaveras County,4,9,2452,1161,1291
50,6,9,California,Calaveras County,4,10,3118,1567,1551
50,6,9,California,Calaveras County,4,11,4004,1949,2055
50,6,9,California,Calaveras County,4,12,4235,1981,2254
50,6,9,California,Calaveras County,4,13,4311,2187,2124
50,6,9,California,Calaveras County,4,14,3455,1752,1703
50,6,9,California,Calaveras County,4,15,2625,1315,1310
50,6,9,California,Calaveras County,4,16,1768,902,866
50,6,9,California,Calaveras County,4,17,1128,532,596
50,6,9,California,Calaveras County,4,18,993,384,609
50,6,9,California,Calaveras County,5,0,44816,22458,22358
50,6,9,California,Calaveras County,5,1,1786,931,855
50,6,9,California,Calaveras County,5,2,2138,1077,1061
50,6,9,California,Calaveras County,5,3,2520,1319,1201
50,6,9,California,Calaveras County,5,4,2787,1459,1328
50,6,9,California,Calaveras County,5,5,1954,1025,929
50,6,9,California,Calaveras County,5,6,1849,1008,841
50,6,9,California,Calaveras County,5,7,1843,940,903
50,6,9,California,Calaveras County,5,8,1841,946,895
50,6,9,California,Calaveras County,5,9,2355,1126,1229
50,6,9,California,Calaveras County,5,10,2990,1477,1513
50,6,9,California,Calaveras County,5,11,3807,1861,1946
50,6,9,California,Calaveras County,5,12,4267,2026,2241
50,6,9,California,Calaveras County,5,13,4176,2094,2082
50,6,9,California,Calaveras County,5,14,3759,1909,1850
50,6,9,California,Calaveras County,5,15,2688,1359,1329
50,6,9,California,Calaveras County,5,16,1888,952,936
50,6,9,California,Calaveras County,5,17,1124,534,590
50,6,9,California,Calaveras County,5,18,1044,415,629
50,6,9,California,Calaveras County,6,0,44658,22347,22311
50,6,9,California,Calaveras County,6,1,1739,906,833
50,6,9,California,Calaveras County,6,2,2091,1048,1043
50,6,9,California,Calaveras County,6,3,2422,1254,1168
50,6,9,California,Calaveras County,6,4,2719,1444,1275
50,6,9,California,Calaveras County,6,5,2026,1056,970
50,6,9,California,Calaveras County,6,6,1847,992,855
50,6,9,California,Calaveras County,6,7,1896,957,939
50,6,9,California,Calaveras County,6,8,1846,970,876
50,6,9,California,Calaveras County,6,9,2243,1069,1174
50,6,9,California,Calaveras County,6,10,2782,1374,1408
50,6,9,California,Calaveras County,6,11,3707,1803,1904
50,6,9,California,Calaveras County,6,12,4238,2049,2189
50,6,9,California,Calaveras County,6,13,4204,2052,2152
50,6,9,California,Calaveras County,6,14,3868,1987,1881
50,6,9,California,Calaveras County,6,15,2805,1402,1403
50,6,9,California,Calaveras County,6,16,2022,1007,1015
50,6,9,California,Calaveras County,6,17,1164,556,608
50,6,9,California,Calaveras County,6,18,1039,421,618
50,6,9,California,Calaveras County,7,0,44677,22358,22319
50,6,9,California,Calaveras County,7,1,1762,920,842
50,6,9,California,Calaveras County,7,2,2088,1026,1062
50,6,9,California,Calaveras County,7,3,2336,1226,1110
50,6,9,California,Calaveras County,7,4,2617,1422,1195
50,6,9,California,Calaveras County,7,5,2019,1076,943
50,6,9,California,Calaveras County,7,6,1922,987,935
50,6,9,California,Calaveras County,7,7,1920,994,926
50,6,9,California,Calaveras County,7,8,1911,1002,909
50,6,9,California,Calaveras County,7,9,2153,1050,1103
50,6,9,California,Calaveras County,7,10,2618,1283,1335
50,6,9,California,Calaveras County,7,11,3597,1744,1853
50,6,9,California,Calaveras County,7,12,4165,2014,2151
50,6,9,California,Calaveras County,7,13,4293,2052,2241
50,6,9,California,Calaveras County,7,14,4004,2049,1955
50,6,9,California,Calaveras County,7,15,2964,1487,1477
50,6,9,California,Calaveras County,7,16,2043,1029,1014
50,6,9,California,Calaveras County,7,17,1207,578,629
50,6,9,California,Calaveras County,7,18,1058,419,639
50,6,9,California,Calaveras County,8,0,44972,22456,22516
50,6,9,California,Calaveras County,8,1,1819,947,872
50,6,9,California,Calaveras County,8,2,2066,1018,1048
50,6,9,California,Calaveras County,8,3,2259,1173,1086
50,6,9,California,Calaveras County,8,4,2518,1361,1157
50,6,9,California,Calaveras County,8,5,2068,1134,934
50,6,9,California,Calaveras County,8,6,1953,982,971
50,6,9,California,Calaveras County,8,7,2029,1051,978
50,6,9,California,Calaveras County,8,8,1974,1001,973
50,6,9,California,Calaveras County,8,9,2050,1043,1007
50,6,9,California,Calaveras County,8,10,2576,1244,1332
50,6,9,California,Calaveras County,8,11,3385,1688,1697
50,6,9,California,Calaveras County,8,12,4219,1994,2225
50,6,9,California,Calaveras County,8,13,4342,2045,2297
50,6,9,California,Calaveras County,8,14,4189,2113,2076
50,6,9,California,Calaveras County,8,15,3057,1557,1500
50,6,9,California,Calaveras County,8,16,2098,1049,1049
50,6,9,California,Calaveras County,8,17,1273,623,650
50,6,9,California,Calaveras County,8,18,1097,433,664
50,6,9,California,Calaveras County,9,0,45307,22596,22711
50,6,9,California,Calaveras County,9,1,1855,974,881
50,6,9,California,Calaveras County,9,2,2039,1025,1014
50,6,9,California,Calaveras County,9,3,2247,1149,1098
50,6,9,California,Calaveras County,9,4,2437,1331,1106
50,6,9,California,Calaveras County,9,5,2071,1106,965
50,6,9,California,Calaveras County,9,6,2011,1028,983
50,6,9,California,Calaveras County,9,7,2142,1116,1026
50,6,9,California,Calaveras County,9,8,2101,1067,1034
50,6,9,California,Calaveras County,9,9,1935,983,952
50,6,9,California,Calaveras County,9,10,2612,1246,1366
50,6,9,California,Calaveras County,9,11,3228,1614,1614
50,6,9,California,Calaveras County,9,12,4160,1978,2182
50,6,9,California,Calaveras County,9,13,4417,2034,2383
50,6,9,California,Calaveras County,9,14,4303,2162,2141
50,6,9,California,Calaveras County,9,15,3167,1627,1540
50,6,9,California,Calaveras County,9,16,2158,1079,1079
50,6,9,California,Calaveras County,9,17,1279,621,658
50,6,9,California,Calaveras County,9,18,1145,456,689
50,6,9,California,Calaveras County,10,0,45658,22773,22885
50,6,9,California,Calaveras County,10,1,1951,1037,914
50,6,9,California,Calaveras County,10,2,2011,1041,970
50,6,9,California,Calaveras County,10,3,2257,1146,1111
50,6,9,California,Calaveras County,10,4,2359,1274,1085
50,6,9,California,Calaveras County,10,5,2064,1107,957
50,6,9,California,Calaveras County,10,6,2105,1065,1040
50,6,9,California,Calaveras County,10,7,2273,1171,1102
50,6,9,California,Calaveras County,10,8,2174,1102,1072
50,6,9,California,Calaveras County,10,9,1983,1007,976
50,6,9,California,Calaveras County,10,10,2550,1229,1321
50,6,9,California,Calaveras County,10,11,3102,1533,1569
50,6,9,California,Calaveras County,10,12,4075,1944,2131
50,6,9,California,Calaveras County,10,13,4454,2063,2391
50,6,9,California,Calaveras County,10,14,4158,2051,2107
50,6,9,California,Calaveras County,10,15,3402,1736,1666
50,6,9,California,Calaveras County,10,16,2232,1123,1109
50,6,9,California,Calaveras County,10,17,1373,668,705
50,6,9,California,Calaveras County,10,18,1135,476,659
50,6,9,California,Calaveras County,11,0,45747,22757,22990
50,6,9,California,Calaveras County,11,1,1996,1046,950
50,6,9,California,Calaveras County,11,2,2019,1056,963
50,6,9,California,Calaveras County,11,3,2230,1097,1133
50,6,9,California,Calaveras County,11,4,2304,1255,1049
50,6,9,California,Calaveras County,11,5,2023,1061,962
50,6,9,California,Calaveras County,11,6,2123,1102,1021
50,6,9,California,Calaveras County,11,7,2264,1156,1108
50,6,9,California,Calaveras County,11,8,2288,1181,1107
50,6,9,California,Calaveras County,11,9,2005,1021,984
50,6,9,California,Calaveras County,11,10,2472,1181,1291
50,6,9,California,Calaveras County,11,11,2970,1464,1506
50,6,9,California,Calaveras County,11,12,3889,1842,2047
50,6,9,California,Calaveras County,11,13,4487,2144,2343
50,6,9,California,Calaveras County,11,14,4139,1992,2147
50,6,9,California,Calaveras County,11,15,3555,1801,1754
50,6,9,California,Calaveras County,11,16,2338,1159,1179
50,6,9,California,Calaveras County,11,17,1484,725,759
50,6,9,California,Calaveras County,11,18,1161,474,687
50,6,9,California,Calaveras County,12,0,46119,22977,23142
50,6,9,California,Calaveras County,12,1,2048,1075,973
50,6,9,California,Calaveras County,12,2,2109,1080,1029
50,6,9,California,Calaveras County,12,3,2189,1085,1104
50,6,9,California,Calaveras County,12,4,2289,1255,1034
50,6,9,California,Calaveras County,12,5,1929,1016,913
50,6,9,California,Calaveras County,12,6,2186,1138,1048
50,6,9,California,Calaveras County,12,7,2331,1173,1158
50,6,9,California,Calaveras County,12,8,2341,1231,1110
50,6,9,California,Calaveras County,12,9,2087,1079,1008
50,6,9,California,Calaveras County,12,10,2384,1160,1224
50,6,9,California,Calaveras County,12,11,2875,1384,1491
50,6,9,California,Calaveras County,12,12,3790,1805,1985
50,6,9,California,Calaveras County,12,13,4421,2147,2274
50,6,9,California,Calaveras County,12,14,4245,1993,2252
50,6,9,California,Calaveras County,12,15,3672,1853,1819
50,6,9,California,Calaveras County,12,16,2465,1232,1233
50,6,9,California,Calaveras County,12,17,1535,752,783
50,6,9,California,Calaveras County,12,18,1223,519,704
50,6,9,California,Calaveras County,13,0,46296,23072,23224
50,6,9,California,Calaveras County,13,1,2037,1081,956
50,6,9,California,Calaveras County,13,2,2141,1105,1036
50,6,9,California,Calaveras County,13,3,2181,1076,1105
50,6,9,California,Calaveras County,13,4,2244,1220,1024
50,6,9,California,Calaveras County,13,5,1914,998,916
50,6,9,California,Calaveras County,13,6,2199,1153,1046
50,6,9,California,Calaveras County,13,7,2319,1162,1157
50,6,9,California,Calaveras County,13,8,2389,1265,1124
50,6,9,California,Calaveras County,13,9,2189,1124,1065
50,6,9,California,Calaveras County,13,10,2263,1132,1131
50,6,9,California,Calaveras County,13,11,2886,1396,1490
50,6,9,California,Calaveras County,13,12,3713,1778,1935
50,6,9,California,Calaveras County,13,13,4451,2123,2328
50,6,9,California,Calaveras County,13,14,4260,2016,2244
50,6,9,California,Calaveras County,13,15,3776,1893,1883
50,6,9,California,Calaveras County,13,16,2530,1265,1265
50,6,9,California,Calaveras County,13,17,1536,742,794
50,6,9,California,Calaveras County,13,18,1268,543,725
50,6,9,California,Calaveras County,14,0,46308,23088,23220
50,6,9,California,Calaveras County,14,1,2027,1081,946
50,6,9,California,Calaveras County,14,2,2144,1107,1037
50,6,9,California,Calaveras County,14,3,2178,1072,1106
50,6,9,California,Calaveras County,14,4,2227,1211,1016
50,6,9,California,Calaveras County,14,5,1909,996,913
50,6,9,California,Calaveras County,14,6,2200,1158,1042
50,6,9,California,Calaveras County,14,7,2317,1159,1158
50,6,9,California,Calaveras County,14,8,2410,1276,1134
50,6,9,California,Calaveras County,14,9,2222,1138,1084
50,6,9,California,Calaveras County,14,10,2226,1123,1103
50,6,9,California,Calaveras County,14,11,2898,1405,1493
50,6,9,California,Calaveras County,14,12,3688,1769,1919
50,6,9,California,Calaveras County,14,13,4460,2116,2344
50,6,9,California,Calaveras County,14,14,4260,2021,2239
50,6,9,California,Calaveras County,14,15,3800,1902,1898
50,6,9,California,Calaveras County,14,16,2535,1270,1265
50,6,9,California,Calaveras County,14,17,1534,738,796
50,6,9,California,Calaveras County,14,18,1273,546,727
50,6,11,California,Colusa County,1,0,21419,11012,10407
50,6,11,California,Colusa County,1,1,1841,987,854
50,6,11,California,Colusa County,1,2,1733,914,819
50,6,11,California,Colusa County,1,3,1692,881,811
50,6,11,California,Colusa County,1,4,1773,965,808
50,6,11,California,Colusa County,1,5,1287,691,596
50,6,11,California,Colusa County,1,6,1440,736,704
50,6,11,California,Colusa County,1,7,1340,673,667
50,6,11,California,Colusa County,1,8,1325,660,665
50,6,11,California,Colusa County,1,9,1353,711,642
50,6,11,California,Colusa County,1,10,1356,700,656
50,6,11,California,Colusa County,1,11,1411,713,698
50,6,11,California,Colusa County,1,12,1296,646,650
50,6,11,California,Colusa County,1,13,1077,565,512
50,6,11,California,Colusa County,1,14,812,403,409
50,6,11,California,Colusa County,1,15,555,282,273
50,6,11,California,Colusa County,1,16,422,200,222
50,6,11,California,Colusa County,1,17,357,160,197
50,6,11,California,Colusa County,1,18,349,125,224
50,6,11,California,Colusa County,2,0,21407,11004,10403
50,6,11,California,Colusa County,2,1,1841,987,854
50,6,11,California,Colusa County,2,2,1733,914,819
50,6,11,California,Colusa County,2,3,1692,881,811
50,6,11,California,Colusa County,2,4,1773,965,808
50,6,11,California,Colusa County,2,5,1287,691,596
50,6,11,California,Colusa County,2,6,1440,736,704
50,6,11,California,Colusa County,2,7,1340,673,667
50,6,11,California,Colusa County,2,8,1324,659,665
50,6,11,California,Colusa County,2,9,1352,711,641
50,6,11,California,Colusa County,2,10,1355,699,656
50,6,11,California,Colusa County,2,11,1411,713,698
50,6,11,California,Colusa County,2,12,1294,644,650
50,6,11,California,Colusa County,2,13,1074,563,511
50,6,11,California,Colusa County,2,14,809,402,407
50,6,11,California,Colusa County,2,15,554,281,273
50,6,11,California,Colusa County,2,16,422,200,222
50,6,11,California,Colusa County,2,17,357,160,197
50,6,11,California,Colusa County,2,18,349,125,224
50,6,11,California,Colusa County,3,0,21435,11033,10402
50,6,11,California,Colusa County,3,1,1819,972,847
50,6,11,California,Colusa County,3,2,1730,915,815
50,6,11,California,Colusa County,3,3,1685,874,811
50,6,11,California,Colusa County,3,4,1771,969,802
50,6,11,California,Colusa County,3,5,1302,697,605
50,6,11,California,Colusa County,3,6,1440,743,697
50,6,11,California,Colusa County,3,7,1346,670,676
50,6,11,California,Colusa County,3,8,1321,665,656
50,6,11,California,Colusa County,3,9,1351,710,641
50,6,11,California,Colusa County,3,10,1346,695,651
50,6,11,California,Colusa County,3,11,1422,719,703
50,6,11,California,Colusa County,3,12,1293,648,645
50,6,11,California,Colusa County,3,13,1098,574,524
50,6,11,California,Colusa County,3,14,813,405,408
50,6,11,California,Colusa County,3,15,560,286,274
50,6,11,California,Colusa County,3,16,422,200,222
50,6,11,California,Colusa County,3,17,365,166,199
50,6,11,California,Colusa County,3,18,351,125,226
50,6,11,California,Colusa County,4,0,21315,10971,10344
50,6,11,California,Colusa County,4,1,1764,915,849
50,6,11,California,Colusa County,4,2,1741,931,810
50,6,11,California,Colusa County,4,3,1680,857,823
50,6,11,California,Colusa County,4,4,1749,971,778
50,6,11,California,Colusa County,4,5,1321,719,602
50,6,11,California,Colusa County,4,6,1413,733,680
50,6,11,California,Colusa County,4,7,1317,643,674
50,6,11,California,Colusa County,4,8,1277,647,630
50,6,11,California,Colusa County,4,9,1355,699,656
50,6,11,California,Colusa County,4,10,1303,675,628
50,6,11,California,Colusa County,4,11,1424,719,705
50,6,11,California,Colusa County,4,12,1281,665,616
50,6,11,California,Colusa County,4,13,1155,593,562
50,6,11,California,Colusa County,4,14,823,419,404
50,6,11,California,Colusa County,4,15,597,307,290
50,6,11,California,Colusa County,4,16,405,189,216
50,6,11,California,Colusa County,4,17,362,165,197
50,6,11,California,Colusa County,4,18,348,124,224
50,6,11,California,Colusa County,5,0,21274,10938,10336
50,6,11,California,Colusa County,5,1,1685,880,805
50,6,11,California,Colusa County,5,2,1748,927,821
50,6,11,California,Colusa County,5,3,1654,840,814
50,6,11,California,Colusa County,5,4,1647,905,742
50,6,11,California,Colusa County,5,5,1422,769,653
50,6,11,California,Colusa County,5,6,1390,720,670
50,6,11,California,Colusa County,5,7,1328,692,636
50,6,11,California,Colusa County,5,8,1263,615,648
50,6,11,California,Colusa County,5,9,1313,683,630
50,6,11,California,Colusa County,5,10,1310,671,639
50,6,11,California,Colusa County,5,11,1374,697,677
50,6,11,California,Colusa County,5,12,1367,711,656
50,6,11,California,Colusa County,5,13,1130,578,552
50,6,11,California,Colusa County,5,14,884,445,439
50,6,11,California,Colusa County,5,15,639,323,316
50,6,11,California,Colusa County,5,16,406,192,214
50,6,11,California,Colusa County,5,17,356,164,192
50,6,11,California,Colusa County,5,18,358,126,232
50,6,11,California,Colusa County,6,0,21239,10920,10319
50,6,11,California,Colusa County,6,1,1606,823,783
50,6,11,California,Colusa County,6,2,1788,953,835
50,6,11,California,Colusa County,6,3,1609,829,780
50,6,11,California,Colusa County,6,4,1627,889,738
50,6,11,California,Colusa County,6,5,1473,785,688
50,6,11,California,Colusa County,6,6,1390,722,668
50,6,11,California,Colusa County,6,7,1340,713,627
50,6,11,California,Colusa County,6,8,1252,617,635
50,6,11,California,Colusa County,6,9,1279,660,619
50,6,11,California,Colusa County,6,10,1292,669,623
50,6,11,California,Colusa County,6,11,1356,692,664
50,6,11,California,Colusa County,6,12,1355,703,652
50,6,11,California,Colusa County,6,13,1137,567,570
50,6,11,California,Colusa County,6,14,887,455,432
50,6,11,California,Colusa County,6,15,694,348,346
50,6,11,California,Colusa County,6,16,442,215,227
50,6,11,California,Colusa County,6,17,335,146,189
50,6,11,California,Colusa County,6,18,377,134,243
50,6,11,California,Colusa County,7,0,21156,10840,10316
50,6,11,California,Colusa County,7,1,1572,785,787
50,6,11,California,Colusa County,7,2,1768,932,836
50,6,11,California,Colusa County,7,3,1621,860,761
50,6,11,California,Colusa County,7,4,1594,864,730
50,6,11,California,Colusa County,7,5,1464,776,688
50,6,11,California,Colusa County,7,6,1344,708,636
50,6,11,California,Colusa County,7,7,1407,731,676
50,6,11,California,Colusa County,7,8,1247,624,623
50,6,11,California,Colusa County,7,9,1207,615,592
50,6,11,California,Colusa County,7,10,1275,665,610
50,6,11,California,Colusa County,7,11,1340,679,661
50,6,11,California,Colusa County,7,12,1329,691,638
50,6,11,California,Colusa County,7,13,1169,573,596
50,6,11,California,Colusa County,7,14,924,469,455
50,6,11,California,Colusa County,7,15,718,362,356
50,6,11,California,Colusa County,7,16,466,227,239
50,6,11,California,Colusa County,7,17,317,139,178
50,6,11,California,Colusa County,7,18,394,140,254
50,6,11,California,Colusa County,8,0,21208,10842,10366
50,6,11,California,Colusa County,8,1,1557,774,783
50,6,11,California,Colusa County,8,2,1714,904,810
50,6,11,California,Colusa County,8,3,1606,860,746
50,6,11,California,Colusa County,8,4,1578,836,742
50,6,11,California,Colusa County,8,5,1502,783,719
50,6,11,California,Colusa County,8,6,1312,713,599
50,6,11,California,Colusa County,8,7,1442,732,710
50,6,11,California,Colusa County,8,8,1252,625,627
50,6,11,California,Colusa County,8,9,1194,608,586
50,6,11,California,Colusa County,8,10,1267,657,610
50,6,11,California,Colusa County,8,11,1306,669,637
50,6,11,California,Colusa County,8,12,1363,699,664
50,6,11,California,Colusa County,8,13,1197,595,602
50,6,11,California,Colusa County,8,14,968,496,472
50,6,11,California,Colusa County,8,15,735,365,370
50,6,11,California,Colusa County,8,16,489,239,250
50,6,11,California,Colusa County,8,17,319,142,177
50,6,11,California,Colusa County,8,18,407,145,262
50,6,11,California,Colusa County,9,0,21476,10959,10517
50,6,11,California,Colusa County,9,1,1557,761,796
50,6,11,California,Colusa County,9,2,1719,901,818
50,6,11,California,Colusa County,9,3,1659,885,774
50,6,11,California,Colusa County,9,4,1581,841,740
50,6,11,California,Colusa County,9,5,1479,763,716
50,6,11,California,Colusa County,9,6,1373,751,622
50,6,11,California,Colusa County,9,7,1434,726,708
50,6,11,California,Colusa County,9,8,1341,675,666
50,6,11,California,Colusa County,9,9,1172,586,586
50,6,11,California,Colusa County,9,10,1300,660,640
50,6,11,California,Colusa County,9,11,1252,647,605
50,6,11,California,Colusa County,9,12,1394,716,678
50,6,11,California,Colusa County,9,13,1217,628,589
50,6,11,California,Colusa County,9,14,1016,508,508
50,6,11,California,Colusa County,9,15,726,357,369
50,6,11,California,Colusa County,9,16,515,256,259
50,6,11,California,Colusa County,9,17,322,139,183
50,6,11,California,Colusa County,9,18,419,159,260
50,6,11,California,Colusa County,10,0,21558,10992,10566
50,6,11,California,Colusa County,10,1,1605,803,802
50,6,11,California,Colusa County,10,2,1673,866,807
50,6,11,California,Colusa County,10,3,1713,899,814
50,6,11,California,Colusa County,10,4,1607,865,742
50,6,11,California,Colusa County,10,5,1418,712,706
50,6,11,California,Colusa County,10,6,1426,762,664
50,6,11,California,Colusa County,10,7,1416,724,692
50,6,11,California,Colusa County,10,8,1370,712,658
50,6,11,California,Colusa County,10,9,1200,593,607
50,6,11,California,Colusa County,10,10,1276,650,626
50,6,11,California,Colusa County,10,11,1236,638,598
50,6,11,California,Colusa County,10,12,1302,655,647
50,6,11,California,Colusa County,10,13,1272,672,600
50,6,11,California,Colusa County,10,14,1000,498,502
50,6,11,California,Colusa County,10,15,767,375,392
50,6,11,California,Colusa County,10,16,554,273,281
50,6,11,California,Colusa County,10,17,318,142,176
50,6,11,California,Colusa County,10,18,405,153,252
50,6,11,California,Colusa County,11,0,21389,10918,10471
50,6,11,California,Colusa County,11,1,1503,772,731
50,6,11,California,Colusa County,11,2,1618,836,782
50,6,11,California,Colusa County,11,3,1738,914,824
50,6,11,California,Colusa County,11,4,1596,854,742
50,6,11,California,Colusa County,11,5,1395,722,673
50,6,11,California,Colusa County,11,6,1458,753,705
50,6,11,California,Colusa County,11,7,1394,722,672
50,6,11,California,Colusa County,11,8,1375,702,673
50,6,11,California,Colusa County,11,9,1200,599,601
50,6,11,California,Colusa County,11,10,1232,620,612
50,6,11,California,Colusa County,11,11,1251,639,612
50,6,11,California,Colusa County,11,12,1265,651,614
50,6,11,California,Colusa County,11,13,1244,645,599
50,6,11,California,Colusa County,11,14,1028,505,523
50,6,11,California,Colusa County,11,15,766,382,384
50,6,11,California,Colusa County,11,16,594,290,304
50,6,11,California,Colusa County,11,17,342,164,178
50,6,11,California,Colusa County,11,18,390,148,242
50,6,11,California,Colusa County,12,0,21474,10938,10536
50,6,11,California,Colusa County,12,1,1470,747,723
50,6,11,California,Colusa County,12,2,1589,809,780
50,6,11,California,Colusa County,12,3,1758,931,827
50,6,11,California,Colusa County,12,4,1600,870,730
50,6,11,California,Colusa County,12,5,1344,667,677
50,6,11,California,Colusa County,12,6,1493,764,729
50,6,11,California,Colusa County,12,7,1406,742,664
50,6,11,California,Colusa County,12,8,1450,726,724
50,6,11,California,Colusa County,12,9,1218,624,594
50,6,11,California,Colusa County,12,10,1186,592,594
50,6,11,California,Colusa County,12,11,1225,622,603
50,6,11,California,Colusa County,12,12,1266,661,605
50,6,11,California,Colusa County,12,13,1253,645,608
50,6,11,California,Colusa County,12,14,1070,519,551
50,6,11,California,Colusa County,12,15,794,394,400
50,6,11,California,Colusa County,12,16,616,308,308
50,6,11,California,Colusa County,12,17,364,176,188
50,6,11,California,Colusa County,12,18,372,141,231
50,6,11,California,Colusa County,13,0,21548,10986,10562
50,6,11,California,Colusa County,13,1,1467,738,729
50,6,11,California,Colusa County,13,2,1591,798,793
50,6,11,California,Colusa County,13,3,1745,929,816
50,6,11,California,Colusa County,13,4,1592,879,713
50,6,11,California,Colusa County,13,5,1356,681,675
50,6,11,California,Colusa County,13,6,1494,755,739
50,6,11,California,Colusa County,13,7,1394,755,639
50,6,11,California,Colusa County,13,8,1478,735,743
50,6,11,California,Colusa County,13,9,1226,626,600
50,6,11,California,Colusa County,13,10,1179,586,593
50,6,11,California,Colusa County,13,11,1214,612,602
50,6,11,California,Colusa County,13,12,1232,647,585
50,6,11,California,Colusa County,13,13,1292,651,641
50,6,11,California,Colusa County,13,14,1064,529,535
50,6,11,California,Colusa County,13,15,844,425,419
50,6,11,California,Colusa County,13,16,623,306,317
50,6,11,California,Colusa County,13,17,375,179,196
50,6,11,California,Colusa County,13,18,382,155,227
50,6,11,California,Colusa County,14,0,21558,10974,10584
50,6,11,California,Colusa County,14,1,1464,733,731
50,6,11,California,Colusa County,14,2,1591,793,798
50,6,11,California,Colusa County,14,3,1738,930,808
50,6,11,California,Colusa County,14,4,1585,877,708
50,6,11,California,Colusa County,14,5,1357,680,677
50,6,11,California,Colusa County,14,6,1491,750,741
50,6,11,California,Colusa County,14,7,1389,756,633
50,6,11,California,Colusa County,14,8,1486,737,749
50,6,11,California,Colusa County,14,9,1230,623,607
50,6,11,California,Colusa County,14,10,1178,583,595
50,6,11,California,Colusa County,14,11,1216,612,604
50,6,11,California,Colusa County,14,12,1219,639,580
50,6,11,California,Colusa County,14,13,1301,650,651
50,6,11,California,Colusa County,14,14,1069,535,534
50,6,11,California,Colusa County,14,15,862,437,425
50,6,11,California,Colusa County,14,16,623,303,320
50,6,11,California,Colusa County,14,17,378,178,200
50,6,11,California,Colusa County,14,18,381,158,223
50,6,13,California,Contra Costa County,1,0,1049025,511526,537499
50,6,13,California,Contra Costa County,1,1,67018,34004,33014
50,6,13,California,Contra Costa County,1,2,72285,36983,35302
50,6,13,California,Contra Costa County,1,3,74444,38052,36392
50,6,13,California,Contra Costa County,1,4,73766,38187,35579
50,6,13,California,Contra Costa County,1,5,59943,30793,29150
50,6,13,California,Contra Costa County,1,6,64747,32303,32444
50,6,13,California,Contra Costa County,1,7,64896,31637,33259
50,6,13,California,Contra Costa County,1,8,70520,34253,36267
50,6,13,California,Contra Costa County,1,9,78130,38033,40097
50,6,13,California,Contra Costa County,1,10,84006,40737,43269
50,6,13,California,Contra Costa County,1,11,80074,38882,41192
50,6,13,California,Contra Costa County,1,12,69400,33301,36099
50,6,13,California,Contra Costa County,1,13,59358,28062,31296
50,6,13,California,Contra Costa County,1,14,41276,19189,22087
50,6,13,California,Contra Costa County,1,15,29443,13534,15909
50,6,13,California,Contra Costa County,1,16,22383,9761,12622
50,6,13,California,Contra Costa County,1,17,17964,7197,10767
50,6,13,California,Contra Costa County,1,18,19372,6618,12754
50,6,13,California,Contra Costa County,2,0,1049188,511608,537580
50,6,13,California,Contra Costa County,2,1,67020,34005,33015
50,6,13,California,Contra Costa County,2,2,72287,36984,35303
50,6,13,California,Contra Costa County,2,3,74445,38052,36393
50,6,13,California,Contra Costa County,2,4,73765,38186,35579
50,6,13,California,Contra Costa County,2,5,59944,30793,29151
50,6,13,California,Contra Costa County,2,6,64749,32304,32445
50,6,13,California,Contra Costa County,2,7,64897,31637,33260
50,6,13,California,Contra Costa County,2,8,70524,34255,36269
50,6,13,California,Contra Costa County,2,9,78137,38039,40098
50,6,13,California,Contra Costa County,2,10,84008,40740,43268
50,6,13,California,Contra Costa County,2,11,80082,38887,41195
50,6,13,California,Contra Costa County,2,12,69411,33308,36103
50,6,13,California,Contra Costa County,2,13,59360,28066,31294
50,6,13,California,Contra Costa County,2,14,41293,19195,22098
50,6,13,California,Contra Costa County,2,15,29460,13547,15913
50,6,13,California,Contra Costa County,2,16,22409,9773,12636
50,6,13,California,Contra Costa County,2,17,17984,7209,10775
50,6,13,California,Contra Costa County,2,18,19413,6628,12785
50,6,13,California,Contra Costa County,3,0,1052516,513188,539328
50,6,13,California,Contra Costa County,3,1,66916,33962,32954
50,6,13,California,Contra Costa County,3,2,72278,36962,35316
50,6,13,California,Contra Costa County,3,3,74445,38029,36416
50,6,13,California,Contra Costa County,3,4,73787,38165,35622
50,6,13,California,Contra Costa County,3,5,60454,31047,29407
50,6,13,California,Contra Costa County,3,6,64903,32415,32488
50,6,13,California,Contra Costa County,3,7,65330,31841,33489
50,6,13,California,Contra Costa County,3,8,70288,34115,36173
50,6,13,California,Contra Costa County,3,9,78213,38067,40146
50,6,13,California,Contra Costa County,3,10,83880,40695,43185
50,6,13,California,Contra Costa County,3,11,80467,39068,41399
50,6,13,California,Contra Costa County,3,12,69935,33615,36320
50,6,13,California,Contra Costa County,3,13,59943,28335,31608
50,6,13,California,Contra Costa County,3,14,41828,19419,22409
50,6,13,California,Contra Costa County,3,15,29768,13704,16064
50,6,13,California,Contra Costa County,3,16,22448,9806,12642
50,6,13,California,Contra Costa County,3,17,18048,7259,10789
50,6,13,California,Contra Costa County,3,18,19585,6684,12901
50,6,13,California,Contra Costa County,4,0,1065361,519310,546051
50,6,13,California,Contra Costa County,4,1,66371,33693,32678
50,6,13,California,Contra Costa County,4,2,72623,37098,35525
50,6,13,California,Contra Costa County,4,3,74600,38056,36544
50,6,13,California,Contra Costa County,4,4,73580,37928,35652
50,6,13,California,Contra Costa County,4,5,62721,32148,30573
50,6,13,California,Contra Costa County,4,6,65064,32534,32530
50,6,13,California,Contra Costa County,4,7,66731,32519,34212
50,6,13,California,Contra Costa County,4,8,69153,33383,35770
50,6,13,California,Contra Costa County,4,9,78852,38442,40410
50,6,13,California,Contra Costa County,4,10,82779,40269,42510
50,6,13,California,Contra Costa County,4,11,81801,39753,42048
50,6,13,California,Contra Costa County,4,12,72169,34840,37329
50,6,13,California,Contra Costa County,4,13,62559,29530,33029
50,6,13,California,Contra Costa County,4,14,44053,20400,23653
50,6,13,California,Contra Costa County,4,15,31188,14348,16840
50,6,13,California,Contra Costa County,4,16,22837,10069,12768
50,6,13,California,Contra Costa County,4,17,18207,7433,10774
50,6,13,California,Contra Costa County,4,18,20073,6867,13206
50,6,13,California,Contra Costa County,5,0,1077439,525303,552136
50,6,13,California,Contra Costa County,5,1,65199,33181,32018
50,6,13,California,Contra Costa County,5,2,73197,37444,35753
50,6,13,California,Contra Costa County,5,3,74838,38057,36781
50,6,13,California,Contra Costa County,5,4,73052,37640,35412
50,6,13,California,Contra Costa County,5,5,65073,33285,31788
50,6,13,California,Contra Costa County,5,6,64901,32449,32452
50,6,13,California,Contra Costa County,5,7,68189,33533,34656
50,6,13,California,Contra Costa County,5,8,69148,33334,35814
50,6,13,California,Contra Costa County,5,9,78548,38354,40194
50,6,13,California,Contra Costa County,5,10,81551,39704,41847
50,6,13,California,Contra Costa County,5,11,82505,40121,42384
50,6,13,California,Contra Costa County,5,12,74422,35985,38437
50,6,13,California,Contra Costa County,5,13,62783,29511,33272
50,6,13,California,Contra Costa County,5,14,48512,22534,25978
50,6,13,California,Contra Costa County,5,15,32987,15112,17875
50,6,13,California,Contra Costa County,5,16,23521,10401,13120
50,6,13,California,Contra Costa County,5,17,18394,7604,10790
50,6,13,California,Contra Costa County,5,18,20619,7054,13565
50,6,13,California,Contra Costa County,6,0,1093253,533129,560124
50,6,13,California,Contra Costa County,6,1,65121,33052,32069
50,6,13,California,Contra Costa County,6,2,73538,37539,35999
50,6,13,California,Contra Costa County,6,3,75564,38459,37105
50,6,13,California,Contra Costa County,6,4,72724,37466,35258
50,6,13,California,Contra Costa County,6,5,67553,34523,33030
50,6,13,California,Contra Costa County,6,6,65432,32887,32545
50,6,13,California,Contra Costa County,6,7,70038,34445,35593
50,6,13,California,Contra Costa County,6,8,69975,33843,36132
50,6,13,California,Contra Costa County,6,9,78060,38121,39939
50,6,13,California,Contra Costa County,6,10,80788,39361,41427
50,6,13,California,Contra Costa County,6,11,83546,40605,42941
50,6,13,California,Contra Costa County,6,12,76033,36842,39191
50,6,13,California,Contra Costa County,6,13,63958,30051,33907
50,6,13,California,Contra Costa County,6,14,51290,23799,27491
50,6,13,California,Contra Costa County,6,15,35281,16143,19138
50,6,13,California,Contra Costa County,6,16,24560,10908,13652
50,6,13,California,Contra Costa County,6,17,18655,7791,10864
50,6,13,California,Contra Costa County,6,18,21137,7294,13843
50,6,13,California,Contra Costa County,7,0,1108665,540939,567726
50,6,13,California,Contra Costa County,7,1,65458,33318,32140
50,6,13,California,Contra Costa County,7,2,73254,37425,35829
50,6,13,California,Contra Costa County,7,3,76386,38858,37528
50,6,13,California,Contra Costa County,7,4,72411,37193,35218
50,6,13,California,Contra Costa County,7,5,68927,35054,33873
50,6,13,California,Contra Costa County,7,6,66823,33695,33128
50,6,13,California,Contra Costa County,7,7,71893,35472,36421
50,6,13,California,Contra Costa County,7,8,71234,34512,36722
50,6,13,California,Contra Costa County,7,9,77096,37619,39477
50,6,13,California,Contra Costa County,7,10,80395,39281,41114
50,6,13,California,Contra Costa County,7,11,84515,41211,43304
50,6,13,California,Contra Costa County,7,12,77125,37332,39793
50,6,13,California,Contra Costa County,7,13,65603,30957,34646
50,6,13,California,Contra Costa County,7,14,54042,25054,28988
50,6,13,California,Contra Costa County,7,15,37367,17007,20360
50,6,13,California,Contra Costa County,7,16,25666,11480,14186
50,6,13,California,Contra Costa County,7,17,18760,7839,10921
50,6,13,California,Contra Costa County,7,18,21710,7632,14078
50,6,13,California,Contra Costa County,8,0,1124148,548689,575459
50,6,13,California,Contra Costa County,8,1,65917,33546,32371
50,6,13,California,Contra Costa County,8,2,73307,37413,35894
50,6,13,California,Contra Costa County,8,3,76740,39082,37658
50,6,13,California,Contra Costa County,8,4,72766,37356,35410
50,6,13,California,Contra Costa County,8,5,69174,35247,33927
50,6,13,California,Contra Costa County,8,6,68570,34717,33853
50,6,13,California,Contra Costa County,8,7,72950,35999,36951
50,6,13,California,Contra Costa County,8,8,73433,35658,37775
50,6,13,California,Contra Costa County,8,9,75840,36999,38841
50,6,13,California,Contra Costa County,8,10,81050,39648,41402
50,6,13,California,Contra Costa County,8,11,84438,41156,43282
50,6,13,California,Contra Costa County,8,12,78601,38107,40494
50,6,13,California,Contra Costa County,8,13,67304,31851,35453
50,6,13,California,Contra Costa County,8,14,56652,26184,30468
50,6,13,California,Contra Costa County,8,15,39304,17769,21535
50,6,13,California,Contra Costa County,8,16,26822,12053,14769
50,6,13,California,Contra Costa County,8,17,18911,7951,10960
50,6,13,California,Contra Costa County,8,18,22369,7953,14416
50,6,13,California,Contra Costa County,9,0,1137259,555529,581730
50,6,13,California,Contra Costa County,9,1,66186,33707,32479
50,6,13,California,Contra Costa County,9,2,73105,37313,35792
50,6,13,California,Contra Costa County,9,3,76853,39008,37845
50,6,13,California,Contra Costa County,9,4,72998,37418,35580
50,6,13,California,Contra Costa County,9,5,68183,34882,33301
50,6,13,California,Contra Costa County,9,6,71351,36095,35256
50,6,13,California,Contra Costa County,9,7,73921,36702,37219
50,6,13,California,Contra Costa County,9,8,75758,36947,38811
50,6,13,California,Contra Costa County,9,9,75426,36699,38727
50,6,13,California,Contra Costa County,9,10,81423,39801,41622
50,6,13,California,Contra Costa County,9,11,83409,40815,42594
50,6,13,California,Contra Costa County,9,12,79427,38625,40802
50,6,13,California,Contra Costa County,9,13,69103,32876,36227
50,6,13,California,Contra Costa County,9,14,58807,27180,31627
50,6,13,California,Contra Costa County,9,15,41246,18597,22649
50,6,13,California,Contra Costa County,9,16,28094,12597,15497
50,6,13,California,Contra Costa County,9,17,19188,8133,11055
50,6,13,California,Contra Costa County,9,18,22781,8134,14647
50,6,13,California,Contra Costa County,10,0,1145623,559881,585742
50,6,13,California,Contra Costa County,10,1,65829,33336,32493
50,6,13,California,Contra Costa County,10,2,72198,36810,35388
50,6,13,California,Contra Costa County,10,3,77395,39514,37881
50,6,13,California,Contra Costa County,10,4,73179,37339,35840
50,6,13,California,Contra Costa County,10,5,67666,34525,33141
50,6,13,California,Contra Costa County,10,6,72898,37048,35850
50,6,13,California,Contra Costa County,10,7,73457,36370,37087
50,6,13,California,Contra Costa County,10,8,77751,38307,39444
50,6,13,California,Contra Costa County,10,9,75767,36821,38946
50,6,13,California,Contra Costa County,10,10,81428,39908,41520
50,6,13,California,Contra Costa County,10,11,81815,40029,41786
50,6,13,California,Contra Costa County,10,12,79806,38881,40925
50,6,13,California,Contra Costa County,10,13,70621,33719,36902
50,6,13,California,Contra Costa County,10,14,58474,26955,31519
50,6,13,California,Contra Costa County,10,15,45062,20443,24619
50,6,13,California,Contra Costa County,10,16,29592,13213,16379
50,6,13,California,Contra Costa County,10,17,19694,8369,11325
50,6,13,California,Contra Costa County,10,18,22991,8294,14697
50,6,13,California,Contra Costa County,11,0,1150840,562883,587957
50,6,13,California,Contra Costa County,11,1,65207,33253,31954
50,6,13,California,Contra Costa County,11,2,71246,36215,35031
50,6,13,California,Contra Costa County,11,3,77450,39531,37919
50,6,13,California,Contra Costa County,11,4,73537,37656,35881
50,6,13,California,Contra Costa County,11,5,66503,33928,32575
50,6,13,California,Contra Costa County,11,6,73145,37194,35951
50,6,13,California,Contra Costa County,11,7,73803,36729,37074
50,6,13,California,Contra Costa County,11,8,78998,38901,40097
50,6,13,California,Contra Costa County,11,9,76337,37208,39129
50,6,13,California,Contra Costa County,11,10,80587,39524,41063
50,6,13,California,Contra Costa County,11,11,80535,39334,41201
50,6,13,California,Contra Costa County,11,12,80317,39245,41072
50,6,13,California,Contra Costa County,11,13,71558,34303,37255
50,6,13,California,Contra Costa County,11,14,59033,27122,31911
50,6,13,California,Contra Costa County,11,15,47390,21504,25886
50,6,13,California,Contra Costa County,11,16,31550,13966,17584
50,6,13,California,Contra Costa County,11,17,20503,8818,11685
50,6,13,California,Contra Costa County,11,18,23141,8452,14689
50,6,13,California,Contra Costa County,12,0,1152883,563674,589209
50,6,13,California,Contra Costa County,12,1,64423,32825,31598
50,6,13,California,Contra Costa County,12,2,70959,36069,34890
50,6,13,California,Contra Costa County,12,3,76451,38967,37484
50,6,13,California,Contra Costa County,12,4,73766,37788,35978
50,6,13,California,Contra Costa County,12,5,65670,33410,32260
50,6,13,California,Contra Costa County,12,6,72428,36794,35634
50,6,13,California,Contra Costa County,12,7,73756,36769,36987
50,6,13,California,Contra Costa County,12,8,79580,39228,40352
50,6,13,California,Contra Costa County,12,9,77042,37617,39425
50,6,13,California,Contra Costa County,12,10,79169,38686,40483
50,6,13,California,Contra Costa County,12,11,79465,38985,40480
50,6,13,California,Contra Costa County,12,12,80508,39383,41125
50,6,13,California,Contra Costa County,12,13,72088,34478,37610
50,6,13,California,Contra Costa County,12,14,60080,27809,32271
50,6,13,California,Contra Costa County,12,15,49358,22338,27020
50,6,13,California,Contra Costa County,12,16,33302,14673,18629
50,6,13,California,Contra Costa County,12,17,21348,9233,12115
50,6,13,California,Contra Costa County,12,18,23490,8622,14868
50,6,13,California,Contra Costa County,13,0,1153445,563912,589533
50,6,13,California,Contra Costa County,13,1,63512,32388,31124
50,6,13,California,Contra Costa County,13,2,70862,36040,34822
50,6,13,California,Contra Costa County,13,3,75649,38549,37100
50,6,13,California,Contra Costa County,13,4,73488,37665,35823
50,6,13,California,Contra Costa County,13,5,65232,33181,32051
50,6,13,California,Contra Costa County,13,6,71319,36328,34991
50,6,13,California,Contra Costa County,13,7,74204,37046,37158
50,6,13,California,Contra Costa County,13,8,79672,39268,40404
50,6,13,California,Contra Costa County,13,9,78030,38093,39937
50,6,13,California,Contra Costa County,13,10,77837,38011,39826
50,6,13,California,Contra Costa County,13,11,79199,38887,40312
50,6,13,California,Contra Costa County,13,12,80053,39112,40941
50,6,13,California,Contra Costa County,13,13,72541,34815,37726
50,6,13,California,Contra Costa County,13,14,60711,28123,32588
50,6,13,California,Contra Costa County,13,15,50839,22955,27884
50,6,13,California,Contra Costa County,13,16,34537,15166,19371
50,6,13,California,Contra Costa County,13,17,21987,9535,12452
50,6,13,California,Contra Costa County,13,18,23773,8750,15023
50,6,13,California,Contra Costa County,14,0,1152333,563379,588954
50,6,13,California,Contra Costa County,14,1,63162,32212,30950
50,6,13,California,Contra Costa County,14,2,70693,35963,34730
50,6,13,California,Contra Costa County,14,3,75347,38398,36949
50,6,13,California,Contra Costa County,14,4,73243,37544,35699
50,6,13,California,Contra Costa County,14,5,64965,33040,31925
50,6,13,California,Contra Costa County,14,6,70803,36108,34695
50,6,13,California,Contra Costa County,14,7,74312,37110,37202
50,6,13,California,Contra Costa County,14,8,79746,39320,40426
50,6,13,California,Contra Costa County,14,9,78318,38236,40082
50,6,13,California,Contra Costa County,14,10,77382,37785,39597
50,6,13,California,Contra Costa County,14,11,79210,38899,40311
50,6,13,California,Contra Costa County,14,12,79829,38998,40831
50,6,13,California,Contra Costa County,14,13,72589,34864,37725
50,6,13,California,Contra Costa County,14,14,60895,28220,32675
50,6,13,California,Contra Costa County,14,15,51173,23077,28096
50,6,13,California,Contra Costa County,14,16,34828,15271,19557
50,6,13,California,Contra Costa County,14,17,22150,9614,12536
50,6,13,California,Contra Costa County,14,18,23688,8720,14968
50,6,15,California,Del Norte County,1,0,28610,15907,12703
50,6,15,California,Del Norte County,1,1,1703,850,853
50,6,15,California,Del Norte County,1,2,1567,827,740
50,6,15,California,Del Norte County,1,3,1718,872,846
50,6,15,California,Del Norte County,1,4,1870,986,884
50,6,15,California,Del Norte County,1,5,1799,1110,689
50,6,15,California,Del Norte County,1,6,2081,1354,727
50,6,15,California,Del Norte County,1,7,2000,1351,649
50,6,15,California,Del Norte County,1,8,1937,1284,653
50,6,15,California,Del Norte County,1,9,1895,1184,711
50,6,15,California,Del Norte County,1,10,2204,1254,950
50,6,15,California,Del Norte County,1,11,2246,1172,1074
50,6,15,California,Del Norte County,1,12,1975,1003,972
50,6,15,California,Del Norte County,1,13,1742,905,837
50,6,15,California,Del Norte County,1,14,1245,613,632
50,6,15,California,Del Norte County,1,15,908,411,497
50,6,15,California,Del Norte County,1,16,739,332,407
50,6,15,California,Del Norte County,1,17,524,229,295
50,6,15,California,Del Norte County,1,18,457,170,287
50,6,15,California,Del Norte County,2,0,28610,15907,12703
50,6,15,California,Del Norte County,2,1,1703,850,853
50,6,15,California,Del Norte County,2,2,1567,827,740
50,6,15,California,Del Norte County,2,3,1718,872,846
50,6,15,California,Del Norte County,2,4,1870,986,884
50,6,15,California,Del Norte County,2,5,1799,1110,689
50,6,15,California,Del Norte County,2,6,2081,1354,727
50,6,15,California,Del Norte County,2,7,2000,1351,649
50,6,15,California,Del Norte County,2,8,1937,1284,653
50,6,15,California,Del Norte County,2,9,1895,1184,711
50,6,15,California,Del Norte County,2,10,2204,1254,950
50,6,15,California,Del Norte County,2,11,2246,1172,1074
50,6,15,California,Del Norte County,2,12,1975,1003,972
50,6,15,California,Del Norte County,2,13,1742,905,837
50,6,15,California,Del Norte County,2,14,1245,613,632
50,6,15,California,Del Norte County,2,15,908,411,497
50,6,15,California,Del Norte County,2,16,739,332,407
50,6,15,California,Del Norte County,2,17,524,229,295
50,6,15,California,Del Norte County,2,18,457,170,287
50,6,15,California,Del Norte County,3,0,28568,15877,12691
50,6,15,California,Del Norte County,3,1,1715,858,857
50,6,15,California,Del Norte County,3,2,1569,830,739
50,6,15,California,Del Norte County,3,3,1723,869,854
50,6,15,California,Del Norte County,3,4,1841,974,867
50,6,15,California,Del Norte County,3,5,1796,1105,691
50,6,15,California,Del Norte County,3,6,2084,1349,735
50,6,15,California,Del Norte County,3,7,2007,1348,659
50,6,15,California,Del Norte County,3,8,1914,1267,647
50,6,15,California,Del Norte County,3,9,1883,1178,705
50,6,15,California,Del Norte County,3,10,2191,1249,942
50,6,15,California,Del Norte County,3,11,2233,1172,1061
50,6,15,California,Del Norte County,3,12,1973,998,975
50,6,15,California,Del Norte County,3,13,1753,910,843
50,6,15,California,Del Norte County,3,14,1260,618,642
50,6,15,California,Del Norte County,3,15,915,421,494
50,6,15,California,Del Norte County,3,16,727,328,399
50,6,15,California,Del Norte County,3,17,529,231,298
50,6,15,California,Del Norte County,3,18,455,172,283
50,6,15,California,Del Norte County,4,0,28447,15819,12628
50,6,15,California,Del Norte County,4,1,1697,846,851
50,6,15,California,Del Norte County,4,2,1602,844,758
50,6,15,California,Del Norte County,4,3,1686,845,841
50,6,15,California,Del Norte County,4,4,1750,936,814
50,6,15,California,Del Norte County,4,5,1814,1115,699
50,6,15,California,Del Norte County,4,6,2088,1346,742
50,6,15,California,Del Norte County,4,7,2051,1380,671
50,6,15,California,Del Norte County,4,8,1876,1242,634
50,6,15,California,Del Norte County,4,9,1839,1145,694
50,6,15,California,Del Norte County,4,10,2081,1204,877
50,6,15,California,Del Norte County,4,11,2213,1174,1039
50,6,15,California,Del Norte County,4,12,2021,1008,1013
50,6,15,California,Del Norte County,4,13,1807,936,871
50,6,15,California,Del Norte County,4,14,1267,620,647
50,6,15,California,Del Norte County,4,15,953,451,502
50,6,15,California,Del Norte County,4,16,686,313,373
50,6,15,California,Del Norte County,4,17,546,239,307
50,6,15,California,Del Norte County,4,18,470,175,295
50,6,15,California,Del Norte County,5,0,28195,15663,12532
50,6,15,California,Del Norte County,5,1,1645,827,818
50,6,15,California,Del Norte County,5,2,1649,841,808
50,6,15,California,Del Norte County,5,3,1624,814,810
50,6,15,California,Del Norte County,5,4,1708,932,776
50,6,15,California,Del Norte County,5,5,1819,1105,714
50,6,15,California,Del Norte County,5,6,2040,1317,723
50,6,15,California,Del Norte County,5,7,2104,1425,679
50,6,15,California,Del Norte County,5,8,1838,1217,621
50,6,15,California,Del Norte County,5,9,1787,1115,672
50,6,15,California,Del Norte County,5,10,1965,1154,811
50,6,15,California,Del Norte County,5,11,2130,1120,1010
50,6,15,California,Del Norte County,5,12,2013,976,1037
50,6,15,California,Del Norte County,5,13,1809,936,873
50,6,15,California,Del Norte County,5,14,1370,679,691
50,6,15,California,Del Norte County,5,15,1008,486,522
50,6,15,California,Del Norte County,5,16,658,294,364
50,6,15,California,Del Norte County,5,17,574,245,329
50,6,15,California,Del Norte County,5,18,454,180,274
50,6,15,California,Del Norte County,6,0,27821,15408,12413
50,6,15,California,Del Norte County,6,1,1625,834,791
50,6,15,California,Del Norte County,6,2,1684,848,836
50,6,15,California,Del Norte County,6,3,1559,807,752
50,6,15,California,Del Norte County,6,4,1642,897,745
50,6,15,California,Del Norte County,6,5,1751,1063,688
50,6,15,California,Del Norte County,6,6,1963,1239,724
50,6,15,California,Del Norte County,6,7,2099,1399,700
50,6,15,California,Del Norte County,6,8,1824,1207,617
50,6,15,California,Del Norte County,6,9,1708,1045,663
50,6,15,California,Del Norte County,6,10,1853,1090,763
50,6,15,California,Del Norte County,6,11,2055,1103,952
50,6,15,California,Del Norte County,6,12,2064,983,1081
50,6,15,California,Del Norte County,6,13,1826,945,881
50,6,15,California,Del Norte County,6,14,1399,718,681
50,6,15,California,Del Norte County,6,15,1066,504,562
50,6,15,California,Del Norte County,6,16,677,290,387
50,6,15,California,Del Norte County,6,17,557,242,315
50,6,15,California,Del Norte County,6,18,469,194,275
50,6,15,California,Del Norte County,7,0,27182,14859,12323
50,6,15,California,Del Norte County,7,1,1588,770,818
50,6,15,California,Del Norte County,7,2,1664,842,822
50,6,15,California,Del Norte County,7,3,1583,824,759
50,6,15,California,Del Norte County,7,4,1547,842,705
50,6,15,California,Del Norte County,7,5,1620,973,647
50,6,15,California,Del Norte County,7,6,1869,1171,698
50,6,15,California,Del Norte County,7,7,2056,1329,727
50,6,15,California,Del Norte County,7,8,1807,1180,627
50,6,15,California,Del Norte County,7,9,1633,986,647
50,6,15,California,Del Norte County,7,10,1687,986,701
50,6,15,California,Del Norte County,7,11,1990,1062,928
50,6,15,California,Del Norte County,7,12,2035,978,1057
50,6,15,California,Del Norte County,7,13,1826,911,915
50,6,15,California,Del Norte County,7,14,1484,773,711
50,6,15,California,Del Norte County,7,15,1077,503,574
50,6,15,California,Del Norte County,7,16,712,300,412
50,6,15,California,Del Norte County,7,17,537,247,290
50,6,15,California,Del Norte County,7,18,467,182,285
50,6,15,California,Del Norte County,8,0,27198,14884,12314
50,6,15,California,Del Norte County,8,1,1581,809,772
50,6,15,California,Del Norte County,8,2,1652,842,810
50,6,15,California,Del Norte County,8,3,1534,781,753
50,6,15,California,Del Norte County,8,4,1556,856,700
50,6,15,California,Del Norte County,8,5,1593,943,650
50,6,15,California,Del Norte County,8,6,1887,1204,683
50,6,15,California,Del Norte County,8,7,2038,1323,715
50,6,15,California,Del Norte County,8,8,1837,1174,663
50,6,15,California,Del Norte County,8,9,1608,987,621
50,6,15,California,Del Norte County,8,10,1642,952,690
50,6,15,California,Del Norte County,8,11,1892,1005,887
50,6,15,California,Del Norte County,8,12,2062,1018,1044
50,6,15,California,Del Norte County,8,13,1865,904,961
50,6,15,California,Del Norte County,8,14,1625,830,795
50,6,15,California,Del Norte County,8,15,1055,503,552
50,6,15,California,Del Norte County,8,16,753,329,424
50,6,15,California,Del Norte County,8,17,537,242,295
50,6,15,California,Del Norte County,8,18,481,182,299
50,6,15,California,Del Norte County,9,0,27415,14883,12532
50,6,15,California,Del Norte County,9,1,1674,856,818
50,6,15,California,Del Norte County,9,2,1653,832,821
50,6,15,California,Del Norte County,9,3,1565,810,755
50,6,15,California,Del Norte County,9,4,1545,827,718
50,6,15,California,Del Norte County,9,5,1563,938,625
50,6,15,California,Del Norte County,9,6,1880,1196,684
50,6,15,California,Del Norte County,9,7,2006,1248,758
50,6,15,California,Del Norte County,9,8,1900,1216,684
50,6,15,California,Del Norte County,9,9,1584,944,640
50,6,15,California,Del Norte County,9,10,1637,951,686
50,6,15,California,Del Norte County,9,11,1828,992,836
50,6,15,California,Del Norte County,9,12,2037,1001,1036
50,6,15,California,Del Norte County,9,13,1927,920,1007
50,6,15,California,Del Norte County,9,14,1722,866,856
50,6,15,California,Del Norte County,9,15,1100,518,582
50,6,15,California,Del Norte County,9,16,788,358,430
50,6,15,California,Del Norte County,9,17,494,226,268
50,6,15,California,Del Norte County,9,18,512,184,328
50,6,15,California,Del Norte County,10,0,27383,14743,12640
50,6,15,California,Del Norte County,10,1,1613,839,774
50,6,15,California,Del Norte County,10,2,1686,846,840
50,6,15,California,Del Norte County,10,3,1686,876,810
50,6,15,California,Del Norte County,10,4,1520,796,724
50,6,15,California,Del Norte County,10,5,1524,922,602
50,6,15,California,Del Norte County,10,6,1846,1125,721
50,6,15,California,Del Norte County,10,7,1961,1214,747
50,6,15,California,Del Norte County,10,8,1964,1217,747
50,6,15,California,Del Norte County,10,9,1534,901,633
50,6,15,California,Del Norte County,10,10,1591,911,680
50,6,15,California,Del Norte County,10,11,1723,934,789
50,6,15,California,Del Norte County,10,12,1987,983,1004
50,6,15,California,Del Norte County,10,13,1963,916,1047
50,6,15,California,Del Norte County,10,14,1730,875,855
50,6,15,California,Del Norte County,10,15,1202,589,613
50,6,15,California,Del Norte County,10,16,831,378,453
50,6,15,California,Del Norte County,10,17,483,217,266
50,6,15,California,Del Norte County,10,18,539,204,335
50,6,15,California,Del Norte County,11,0,27793,15121,12672
50,6,15,California,Del Norte County,11,1,1543,774,769
50,6,15,California,Del Norte County,11,2,1705,882,823
50,6,15,California,Del Norte County,11,3,1706,871,835
50,6,15,California,Del Norte County,11,4,1481,776,705
50,6,15,California,Del Norte County,11,5,1580,959,621
50,6,15,California,Del Norte County,11,6,1920,1203,717
50,6,15,California,Del Norte County,11,7,2004,1297,707
50,6,15,California,Del Norte County,11,8,2065,1271,794
50,6,15,California,Del Norte County,11,9,1635,994,641
50,6,15,California,Del Norte County,11,10,1629,962,667
50,6,15,California,Del Norte County,11,11,1635,889,746
50,6,15,California,Del Norte County,11,12,1931,989,942
50,6,15,California,Del Norte County,11,13,2006,920,1086
50,6,15,California,Del Norte County,11,14,1771,876,895
50,6,15,California,Del Norte County,11,15,1273,652,621
50,6,15,California,Del Norte County,11,16,861,383,478
50,6,15,California,Del Norte County,11,17,504,215,289
50,6,15,California,Del Norte County,11,18,544,208,336
50,6,15,California,Del Norte County,12,0,27903,15195,12708
50,6,15,California,Del Norte County,12,1,1486,755,731
50,6,15,California,Del Norte County,12,2,1724,871,853
50,6,15,California,Del Norte County,12,3,1721,889,832
50,6,15,California,Del Norte County,12,4,1506,805,701
50,6,15,California,Del Norte County,12,5,1514,915,599
50,6,15,California,Del Norte County,12,6,1891,1198,693
50,6,15,California,Del Norte County,12,7,1997,1302,695
50,6,15,California,Del Norte County,12,8,2084,1281,803
50,6,15,California,Del Norte County,12,9,1712,1035,677
50,6,15,California,Del Norte County,12,10,1610,959,651
50,6,15,California,Del Norte County,12,11,1521,814,707
50,6,15,California,Del Norte County,12,12,1979,996,983
50,6,15,California,Del Norte County,12,13,2025,952,1073
50,6,15,California,Del Norte County,12,14,1814,894,920
50,6,15,California,Del Norte County,12,15,1363,699,664
50,6,15,California,Del Norte County,12,16,871,380,491
50,6,15,California,Del Norte County,12,17,531,229,302
50,6,15,California,Del Norte County,12,18,554,221,333
50,6,15,California,Del Norte County,13,0,27973,15260,12713
50,6,15,California,Del Norte County,13,1,1445,724,721
50,6,15,California,Del Norte County,13,2,1702,884,818
50,6,15,California,Del Norte County,13,3,1730,890,840
50,6,15,California,Del Norte County,13,4,1483,802,681
50,6,15,California,Del Norte County,13,5,1530,926,604
50,6,15,California,Del Norte County,13,6,1867,1189,678
50,6,15,California,Del Norte County,13,7,1991,1299,692
50,6,15,California,Del Norte County,13,8,2083,1296,787
50,6,15,California,Del Norte County,13,9,1786,1068,718
50,6,15,California,Del Norte County,13,10,1621,963,658
50,6,15,California,Del Norte County,13,11,1505,796,709
50,6,15,California,Del Norte County,13,12,1900,950,950
50,6,15,California,Del Norte County,13,13,2045,986,1059
50,6,15,California,Del Norte County,13,14,1856,897,959
50,6,15,California,Del Norte County,13,15,1437,734,703
50,6,15,California,Del Norte County,13,16,886,401,485
50,6,15,California,Del Norte County,13,17,547,231,316
50,6,15,California,Del Norte County,13,18,559,224,335
50,6,15,California,Del Norte County,14,0,27968,15270,12698
50,6,15,California,Del Norte County,14,1,1429,711,718
50,6,15,California,Del Norte County,14,2,1693,891,802
50,6,15,California,Del Norte County,14,3,1731,889,842
50,6,15,California,Del Norte County,14,4,1474,800,674
50,6,15,California,Del Norte County,14,5,1533,928,605
50,6,15,California,Del Norte County,14,6,1854,1181,673
50,6,15,California,Del Norte County,14,7,1995,1303,692
50,6,15,California,Del Norte County,14,8,2090,1304,786
50,6,15,California,Del Norte County,14,9,1808,1075,733
50,6,15,California,Del Norte County,14,10,1624,964,660
50,6,15,California,Del Norte County,14,11,1497,788,709
50,6,15,California,Del Norte County,14,12,1873,934,939
50,6,15,California,Del Norte County,14,13,2044,995,1049
50,6,15,California,Del Norte County,14,14,1868,898,970
50,6,15,California,Del Norte County,14,15,1457,744,713
50,6,15,California,Del Norte County,14,16,887,409,478
50,6,15,California,Del Norte County,14,17,552,232,320
50,6,15,California,Del Norte County,14,18,559,224,335
50,6,17,California,El Dorado County,1,0,181058,90571,90487
50,6,17,California,El Dorado County,1,1,9513,4870,4643
50,6,17,California,El Dorado County,1,2,11126,5664,5462
50,6,17,California,El Dorado County,1,3,12506,6410,6096
50,6,17,California,El Dorado County,1,4,12522,6543,5979
50,6,17,California,El Dorado County,1,5,8958,4889,4069
50,6,17,California,El Dorado County,1,6,8682,4544,4138
50,6,17,California,El Dorado County,1,7,8562,4302,4260
50,6,17,California,El Dorado County,1,8,9993,4954,5039
50,6,17,California,El Dorado County,1,9,12210,5974,6236
50,6,17,California,El Dorado County,1,10,15516,7521,7995
50,6,17,California,El Dorado County,1,11,16830,8310,8520
50,6,17,California,El Dorado County,1,12,15146,7501,7645
50,6,17,California,El Dorado County,1,13,12970,6533,6437
50,6,17,California,El Dorado County,1,14,9141,4519,4622
50,6,17,California,El Dorado County,1,15,6296,3148,3148
50,6,17,California,El Dorado County,1,16,4656,2294,2362
50,6,17,California,El Dorado County,1,17,3313,1432,1881
50,6,17,California,El Dorado County,1,18,3118,1163,1955
50,6,17,California,El Dorado County,2,0,181079,90583,90496
50,6,17,California,El Dorado County,2,1,9515,4871,4644
50,6,17,California,El Dorado County,2,2,11126,5664,5462
50,6,17,California,El Dorado County,2,3,12505,6409,6096
50,6,17,California,El Dorado County,2,4,12523,6544,5979
50,6,17,California,El Dorado County,2,5,8960,4889,4071
50,6,17,California,El Dorado County,2,6,8684,4546,4138
50,6,17,California,El Dorado County,2,7,8561,4302,4259
50,6,17,California,El Dorado County,2,8,9992,4953,5039
50,6,17,California,El Dorado County,2,9,12210,5974,6236
50,6,17,California,El Dorado County,2,10,15516,7521,7995
50,6,17,California,El Dorado County,2,11,16833,8311,8522
50,6,17,California,El Dorado County,2,12,15151,7505,7646
50,6,17,California,El Dorado County,2,13,12974,6535,6439
50,6,17,California,El Dorado County,2,14,9144,4520,4624
50,6,17,California,El Dorado County,2,15,6297,3149,3148
50,6,17,California,El Dorado County,2,16,4656,2294,2362
50,6,17,California,El Dorado County,2,17,3313,1432,1881
50,6,17,California,El Dorado County,2,18,3119,1164,1955
50,6,17,California,El Dorado County,3,0,181161,90602,90559
50,6,17,California,El Dorado County,3,1,9408,4814,4594
50,6,17,California,El Dorado County,3,2,11097,5644,5453
50,6,17,California,El Dorado County,3,3,12431,6373,6058
50,6,17,California,El Dorado County,3,4,12466,6517,5949
50,6,17,California,El Dorado County,3,5,9071,4928,4143
50,6,17,California,El Dorado County,3,6,8708,4559,4149
50,6,17,California,El Dorado County,3,7,8595,4322,4273
50,6,17,California,El Dorado County,3,8,9878,4899,4979
50,6,17,California,El Dorado County,3,9,12156,5958,6198
50,6,17,California,El Dorado County,3,10,15359,7446,7913
50,6,17,California,El Dorado County,3,11,16830,8298,8532
50,6,17,California,El Dorado County,3,12,15213,7528,7685
50,6,17,California,El Dorado County,3,13,13167,6628,6539
50,6,17,California,El Dorado County,3,14,9236,4566,4670
50,6,17,California,El Dorado County,3,15,6383,3192,3191
50,6,17,California,El Dorado County,3,16,4661,2302,2359
50,6,17,California,El Dorado County,3,17,3340,1452,1888
50,6,17,California,El Dorado County,3,18,3162,1176,1986
50,6,17,California,El Dorado County,4,0,180963,90457,90506
50,6,17,California,El Dorado County,4,1,8919,4582,4337
50,6,17,California,El Dorado County,4,2,10999,5607,5392
50,6,17,California,El Dorado County,4,3,12196,6209,5987
50,6,17,California,El Dorado County,4,4,12204,6391,5813
50,6,17,California,El Dorado County,4,5,9567,5098,4469
50,6,17,California,El Dorado County,4,6,8680,4566,4114
50,6,17,California,El Dorado County,4,7,8633,4397,4236
50,6,17,California,El Dorado County,4,8,9262,4617,4645
50,6,17,California,El Dorado County,4,9,11867,5814,6053
50,6,17,California,El Dorado County,4,10,14583,7087,7496
50,6,17,California,El Dorado County,4,11,16837,8247,8590
50,6,17,California,El Dorado County,4,12,15453,7621,7832
50,6,17,California,El Dorado County,4,13,13918,6991,6927
50,6,17,California,El Dorado County,4,14,9649,4765,4884
50,6,17,California,El Dorado County,4,15,6730,3345,3385
50,6,17,California,El Dorado County,4,16,4696,2335,2361
50,6,17,California,El Dorado County,4,17,3437,1547,1890
50,6,17,California,El Dorado County,4,18,3333,1238,2095
50,6,17,California,El Dorado County,5,0,180613,90254,90359
50,6,17,California,El Dorado County,5,1,8576,4389,4187
50,6,17,California,El Dorado County,5,2,10915,5596,5319
50,6,17,California,El Dorado County,5,3,11914,6080,5834
50,6,17,California,El Dorado County,5,4,11936,6233,5703
50,6,17,California,El Dorado County,5,5,9855,5219,4636
50,6,17,California,El Dorado County,5,6,8532,4512,4020
50,6,17,California,El Dorado County,5,7,8836,4485,4351
50,6,17,California,El Dorado County,5,8,8994,4452,4542
50,6,17,California,El Dorado County,5,9,11568,5714,5854
50,6,17,California,El Dorado County,5,10,13614,6609,7005
50,6,17,California,El Dorado County,5,11,16558,8117,8441
50,6,17,California,El Dorado County,5,12,15748,7669,8079
50,6,17,California,El Dorado County,5,13,13867,7023,6844
50,6,17,California,El Dorado County,5,14,10767,5316,5451
50,6,17,California,El Dorado County,5,15,7155,3529,3626
50,6,17,California,El Dorado County,5,16,4850,2417,2433
50,6,17,California,El Dorado County,5,17,3500,1610,1890
50,6,17,California,El Dorado County,5,18,3428,1284,2144
50,6,17,California,El Dorado County,6,0,181529,90722,90807
50,6,17,California,El Dorado County,6,1,8341,4271,4070
50,6,17,California,El Dorado County,6,2,10718,5500,5218
50,6,17,California,El Dorado County,6,3,11899,6109,5790
50,6,17,California,El Dorado County,6,4,11745,6080,5665
50,6,17,California,El Dorado County,6,5,9973,5311,4662
50,6,17,California,El Dorado County,6,6,8552,4534,4018
50,6,17,California,El Dorado County,6,7,9105,4574,4531
50,6,17,California,El Dorado County,6,8,9020,4466,4554
50,6,17,California,El Dorado County,6,9,11366,5643,5723
50,6,17,California,El Dorado County,6,10,12873,6301,6572
50,6,17,California,El Dorado County,6,11,16101,7880,8221
50,6,17,California,El Dorado County,6,12,16154,7899,8255
50,6,17,California,El Dorado County,6,13,14271,7135,7136
50,6,17,California,El Dorado County,6,14,11301,5612,5689
50,6,17,California,El Dorado County,6,15,7784,3819,3965
50,6,17,California,El Dorado County,6,16,5100,2524,2576
50,6,17,California,El Dorado County,6,17,3626,1709,1917
50,6,17,California,El Dorado County,6,18,3600,1355,2245
50,6,17,California,El Dorado County,7,0,183157,91567,91590
50,6,17,California,El Dorado County,7,1,8465,4362,4103
50,6,17,California,El Dorado County,7,2,10596,5432,5164
50,6,17,California,El Dorado County,7,3,11705,6019,5686
50,6,17,California,El Dorado County,7,4,11656,6081,5575
50,6,17,California,El Dorado County,7,5,10169,5399,4770
50,6,17,California,El Dorado County,7,6,8822,4655,4167
50,6,17,California,El Dorado County,7,7,9248,4703,4545
50,6,17,California,El Dorado County,7,8,9256,4575,4681
50,6,17,California,El Dorado County,7,9,10944,5433,5511
50,6,17,California,El Dorado County,7,10,12508,6143,6365
50,6,17,California,El Dorado County,7,11,15642,7645,7997
50,6,17,California,El Dorado County,7,12,16374,8007,8367
50,6,17,California,El Dorado County,7,13,14567,7213,7354
50,6,17,California,El Dorado County,7,14,12098,6046,6052
50,6,17,California,El Dorado County,7,15,8195,3997,4198
50,6,17,California,El Dorado County,7,16,5404,2656,2748
50,6,17,California,El Dorado County,7,17,3744,1774,1970
50,6,17,California,El Dorado County,7,18,3764,1427,2337
50,6,17,California,El Dorado County,8,0,184627,92159,92468
50,6,17,California,El Dorado County,8,1,8699,4469,4230
50,6,17,California,El Dorado County,8,2,10317,5289,5028
50,6,17,California,El Dorado County,8,3,11614,5970,5644
50,6,17,California,El Dorado County,8,4,11462,5963,5499
50,6,17,California,El Dorado County,8,5,10186,5356,4830
50,6,17,California,El Dorado County,8,6,9025,4724,4301
50,6,17,California,El Dorado County,8,7,9413,4826,4587
50,6,17,California,El Dorado County,8,8,9648,4791,4857
50,6,17,California,El Dorado County,8,9,10586,5272,5314
50,6,17,California,El Dorado County,8,10,12416,6084,6332
50,6,17,California,El Dorado County,8,11,15106,7345,7761
50,6,17,California,El Dorado County,8,12,16556,8119,8437
50,6,17,California,El Dorado County,8,13,14737,7257,7480
50,6,17,California,El Dorado County,8,14,12853,6399,6454
50,6,17,California,El Dorado County,8,15,8636,4215,4421
50,6,17,California,El Dorado County,8,16,5678,2792,2886
50,6,17,California,El Dorado County,8,17,3807,1814,1993
50,6,17,California,El Dorado County,8,18,3888,1474,2414
50,6,17,California,El Dorado County,9,0,186027,92691,93336
50,6,17,California,El Dorado County,9,1,8653,4475,4178
50,6,17,California,El Dorado County,9,2,10132,5173,4959
50,6,17,California,El Dorado County,9,3,11692,5975,5717
50,6,17,California,El Dorado County,9,4,11253,5849,5404
50,6,17,California,El Dorado County,9,5,9926,5161,4765
50,6,17,California,El Dorado County,9,6,9165,4793,4372
50,6,17,California,El Dorado County,9,7,9493,4847,4646
50,6,17,California,El Dorado County,9,8,10020,4970,5050
50,6,17,California,El Dorado County,9,9,10226,5126,5100
50,6,17,California,El Dorado County,9,10,12444,6108,6336
50,6,17,California,El Dorado County,9,11,14565,7123,7442
50,6,17,California,El Dorado County,9,12,16671,8151,8520
50,6,17,California,El Dorado County,9,13,15109,7392,7717
50,6,17,California,El Dorado County,9,14,13625,6781,6844
50,6,17,California,El Dorado County,9,15,9127,4424,4703
50,6,17,California,El Dorado County,9,16,6022,2937,3085
50,6,17,California,El Dorado County,9,17,3824,1859,1965
50,6,17,California,El Dorado County,9,18,4080,1547,2533
50,6,17,California,El Dorado County,10,0,188793,94035,94758
50,6,17,California,El Dorado County,10,1,8770,4491,4279
50,6,17,California,El Dorado County,10,2,10126,5162,4964
50,6,17,California,El Dorado County,10,3,11853,6068,5785
50,6,17,California,El Dorado County,10,4,11178,5823,5355
50,6,17,California,El Dorado County,10,5,9668,5031,4637
50,6,17,California,El Dorado County,10,6,9704,5096,4608
50,6,17,California,El Dorado County,10,7,9596,4919,4677
50,6,17,California,El Dorado County,10,8,10590,5241,5349
50,6,17,California,El Dorado County,10,9,10210,5075,5135
50,6,17,California,El Dorado County,10,10,12286,6052,6234
50,6,17,California,El Dorado County,10,11,13952,6858,7094
50,6,17,California,El Dorado County,10,12,16568,8080,8488
50,6,17,California,El Dorado County,10,13,15753,7602,8151
50,6,17,California,El Dorado County,10,14,13695,6879,6816
50,6,17,California,El Dorado County,10,15,10259,4986,5273
50,6,17,California,El Dorado County,10,16,6388,3103,3285
50,6,17,California,El Dorado County,10,17,3947,1916,2031
50,6,17,California,El Dorado County,10,18,4250,1653,2597
50,6,17,California,El Dorado County,11,0,190925,95054,95871
50,6,17,California,El Dorado County,11,1,8769,4460,4309
50,6,17,California,El Dorado County,11,2,10177,5244,4933
50,6,17,California,El Dorado County,11,3,11817,6003,5814
50,6,17,California,El Dorado County,11,4,11143,5801,5342
50,6,17,California,El Dorado County,11,5,9520,4940,4580
50,6,17,California,El Dorado County,11,6,9704,5156,4548
50,6,17,California,El Dorado County,11,7,9759,4991,4768
50,6,17,California,El Dorado County,11,8,10977,5396,5581
50,6,17,California,El Dorado County,11,9,10499,5204,5295
50,6,17,California,El Dorado County,11,10,12188,6099,6089
50,6,17,California,El Dorado County,11,11,13343,6576,6767
50,6,17,California,El Dorado County,11,12,16300,7906,8394
50,6,17,California,El Dorado County,11,13,16185,7836,8349
50,6,17,California,El Dorado County,11,14,14174,7040,7134
50,6,17,California,El Dorado County,11,15,10831,5278,5553
50,6,17,California,El Dorado County,11,16,6962,3374,3588
50,6,17,California,El Dorado County,11,17,4169,2013,2156
50,6,17,California,El Dorado County,11,18,4408,1737,2671
50,6,17,California,El Dorado County,12,0,193057,96125,96932
50,6,17,California,El Dorado County,12,1,8814,4435,4379
50,6,17,California,El Dorado County,12,2,10311,5366,4945
50,6,17,California,El Dorado County,12,3,11722,5980,5742
50,6,17,California,El Dorado County,12,4,11120,5771,5349
50,6,17,California,El Dorado County,12,5,9467,4894,4573
50,6,17,California,El Dorado County,12,6,9745,5169,4576
50,6,17,California,El Dorado County,12,7,9920,5026,4894
50,6,17,California,El Dorado County,12,8,11242,5523,5719
50,6,17,California,El Dorado County,12,9,10946,5477,5469
50,6,17,California,El Dorado County,12,10,11775,5904,5871
50,6,17,California,El Dorado County,12,11,13013,6422,6591
50,6,17,California,El Dorado County,12,12,16059,7809,8250
50,6,17,California,El Dorado County,12,13,16459,7977,8482
50,6,17,California,El Dorado County,12,14,14500,7158,7342
50,6,17,California,El Dorado County,12,15,11584,5684,5900
50,6,17,California,El Dorado County,12,16,7393,3593,3800
50,6,17,California,El Dorado County,12,17,4421,2116,2305
50,6,17,California,El Dorado County,12,18,4566,1821,2745
50,6,17,California,El Dorado County,13,0,193078,96055,97023
50,6,17,California,El Dorado County,13,1,8714,4418,4296
50,6,17,California,El Dorado County,13,2,10365,5351,5014
50,6,17,California,El Dorado County,13,3,11551,5903,5648
50,6,17,California,El Dorado County,13,4,11055,5718,5337
50,6,17,California,El Dorado County,13,5,9370,4806,4564
50,6,17,California,El Dorado County,13,6,9499,5034,4465
50,6,17,California,El Dorado County,13,7,9945,5004,4941
50,6,17,California,El Dorado County,13,8,11337,5620,5717
50,6,17,California,El Dorado County,13,9,11195,5609,5586
50,6,17,California,El Dorado County,13,10,11399,5712,5687
50,6,17,California,El Dorado County,13,11,12848,6334,6514
50,6,17,California,El Dorado County,13,12,15543,7589,7954
50,6,17,California,El Dorado County,13,13,16592,8035,8557
50,6,17,California,El Dorado County,13,14,14686,7238,7448
50,6,17,California,El Dorado County,13,15,12036,5892,6144
50,6,17,California,El Dorado County,13,16,7733,3733,4000
50,6,17,California,El Dorado County,13,17,4559,2170,2389
50,6,17,California,El Dorado County,13,18,4651,1889,2762
50,6,17,California,El Dorado County,14,0,192925,95954,96971
50,6,17,California,El Dorado County,14,1,8673,4406,4267
50,6,17,California,El Dorado County,14,2,10362,5331,5031
50,6,17,California,El Dorado County,14,3,11494,5874,5620
50,6,17,California,El Dorado County,14,4,11022,5698,5324
50,6,17,California,El Dorado County,14,5,9334,4778,4556
50,6,17,California,El Dorado County,14,6,9402,4983,4419
50,6,17,California,El Dorado County,14,7,9951,4989,4962
50,6,17,California,El Dorado County,14,8,11388,5663,5725
50,6,17,California,El Dorado County,14,9,11287,5659,5628
50,6,17,California,El Dorado County,14,10,11273,5651,5622
50,6,17,California,El Dorado County,14,11,12827,6319,6508
50,6,17,California,El Dorado County,14,12,15361,7514,7847
50,6,17,California,El Dorado County,14,13,16610,8041,8569
50,6,17,California,El Dorado County,14,14,14744,7264,7480
50,6,17,California,El Dorado County,14,15,12147,5941,6206
50,6,17,California,El Dorado County,14,16,7809,3763,4046
50,6,17,California,El Dorado County,14,17,4599,2185,2414
50,6,17,California,El Dorado County,14,18,4642,1895,2747
50,6,19,California,Fresno County,1,0,930450,464811,465639
50,6,19,California,Fresno County,1,1,78980,40476,38504
50,6,19,California,Fresno County,1,2,75040,38161,36879
50,6,19,California,Fresno County,1,3,75409,38453,36956
50,6,19,California,Fresno County,1,4,81306,41878,39428
50,6,19,California,Fresno County,1,5,75290,38646,36644
50,6,19,California,Fresno County,1,6,70495,36186,34309
50,6,19,California,Fresno County,1,7,62234,31790,30444
50,6,19,California,Fresno County,1,8,57710,29033,28677
50,6,19,California,Fresno County,1,9,56659,28663,27996
50,6,19,California,Fresno County,1,10,59046,29446,29600
50,6,19,California,Fresno County,1,11,56006,27908,28098
50,6,19,California,Fresno County,1,12,48907,23911,24996
50,6,19,California,Fresno County,1,13,39947,19497,20450
50,6,19,California,Fresno County,1,14,28529,13580,14949
50,6,19,California,Fresno County,1,15,20970,9670,11300
50,6,19,California,Fresno County,1,16,16700,7145,9555
50,6,19,California,Fresno County,1,17,13604,5512,8092
50,6,19,California,Fresno County,1,18,13618,4856,8762
50,6,19,California,Fresno County,2,0,930503,464839,465664
50,6,19,California,Fresno County,2,1,78986,40479,38507
50,6,19,California,Fresno County,2,2,75044,38162,36882
50,6,19,California,Fresno County,2,3,75414,38456,36958
50,6,19,California,Fresno County,2,4,81314,41883,39431
50,6,19,California,Fresno County,2,5,75299,38651,36648
50,6,19,California,Fresno County,2,6,70497,36187,34310
50,6,19,California,Fresno County,2,7,62238,31791,30447
50,6,19,California,Fresno County,2,8,57717,29037,28680
50,6,19,California,Fresno County,2,9,56658,28662,27996
50,6,19,California,Fresno County,2,10,59046,29446,29600
50,6,19,California,Fresno County,2,11,56007,27909,28098
50,6,19,California,Fresno County,2,12,48908,23913,24995
50,6,19,California,Fresno County,2,13,39949,19498,20451
50,6,19,California,Fresno County,2,14,28528,13579,14949
50,6,19,California,Fresno County,2,15,20972,9671,11301
50,6,19,California,Fresno County,2,16,16704,7147,9557
50,6,19,California,Fresno County,2,17,13604,5512,8092
50,6,19,California,Fresno County,2,18,13618,4856,8762
50,6,19,California,Fresno County,3,0,932011,465282,466729
50,6,19,California,Fresno County,3,1,79111,40474,38637
50,6,19,California,Fresno County,3,2,75183,38269,36914
50,6,19,California,Fresno County,3,3,75249,38343,36906
50,6,19,California,Fresno County,3,4,80415,41389,39026
50,6,19,California,Fresno County,3,5,75937,38933,37004
50,6,19,California,Fresno County,3,6,70694,36263,34431
50,6,19,California,Fresno County,3,7,62649,31961,30688
50,6,19,California,Fresno County,3,8,57654,29024,28630
50,6,19,California,Fresno County,3,9,56717,28632,28085
50,6,19,California,Fresno County,3,10,58795,29330,29465
50,6,19,California,Fresno County,3,11,56222,27981,28241
50,6,19,California,Fresno County,3,12,49149,24029,25120
50,6,19,California,Fresno County,3,13,40373,19664,20709
50,6,19,California,Fresno County,3,14,28771,13709,15062
50,6,19,California,Fresno County,3,15,21104,9720,11384
50,6,19,California,Fresno County,3,16,16652,7146,9506
50,6,19,California,Fresno County,3,17,13636,5516,8120
50,6,19,California,Fresno County,3,18,13700,4899,8801
50,6,19,California,Fresno County,4,0,939251,468349,470902
50,6,19,California,Fresno County,4,1,79740,40628,39112
50,6,19,California,Fresno County,4,2,75984,38807,37177
50,6,19,California,Fresno County,4,3,74839,38186,36653
50,6,19,California,Fresno County,4,4,77211,39670,37541
50,6,19,California,Fresno County,4,5,78214,39942,38272
50,6,19,California,Fresno County,4,6,71360,36729,34631
50,6,19,California,Fresno County,4,7,64142,32553,31589
50,6,19,California,Fresno County,4,8,57414,29077,28337
50,6,19,California,Fresno County,4,9,57004,28530,28474
50,6,19,California,Fresno County,4,10,57680,28803,28877
50,6,19,California,Fresno County,4,11,57103,28272,28831
50,6,19,California,Fresno County,4,12,49991,24397,25594
50,6,19,California,Fresno County,4,13,42455,20610,21845
50,6,19,California,Fresno County,4,14,29870,14307,15563
50,6,19,California,Fresno County,4,15,21695,9957,11738
50,6,19,California,Fresno County,4,16,16816,7300,9516
50,6,19,California,Fresno County,4,17,13638,5521,8117
50,6,19,California,Fresno County,4,18,14095,5060,9035
50,6,19,California,Fresno County,5,0,944779,470886,473893
50,6,19,California,Fresno County,5,1,79581,40553,39028
50,6,19,California,Fresno County,5,2,77407,39737,37670
50,6,19,California,Fresno County,5,3,74172,37880,36292
50,6,19,California,Fresno County,5,4,74992,38358,36634
50,6,19,California,Fresno County,5,5,79288,40374,38914
50,6,19,California,Fresno County,5,6,71629,36956,34673
50,6,19,California,Fresno County,5,7,65676,33245,32431
50,6,19,California,Fresno County,5,8,57661,29289,28372
50,6,19,California,Fresno County,5,9,56957,28372,28585
50,6,19,California,Fresno County,5,10,56746,28388,28358
50,6,19,California,Fresno County,5,11,57135,28217,28918
50,6,19,California,Fresno County,5,12,50894,24857,26037
50,6,19,California,Fresno County,5,13,42969,20800,22169
50,6,19,California,Fresno County,5,14,32147,15396,16751
50,6,19,California,Fresno County,5,15,22550,10321,12229
50,6,19,California,Fresno County,5,16,17030,7469,9561
50,6,19,California,Fresno County,5,17,13569,5561,8008
50,6,19,California,Fresno County,5,18,14376,5113,9263
50,6,19,California,Fresno County,6,0,951143,474155,476988
50,6,19,California,Fresno County,6,1,78914,40164,38750
50,6,19,California,Fresno County,6,2,78693,40426,38267
50,6,19,California,Fresno County,6,3,74215,37711,36504
50,6,19,California,Fresno County,6,4,73620,37666,35954
50,6,19,California,Fresno County,6,5,79059,40301,38758
50,6,19,California,Fresno County,6,6,72442,37351,35091
50,6,19,California,Fresno County,6,7,67117,34067,33050
50,6,19,California,Fresno County,6,8,58592,29781,28811
50,6,19,California,Fresno County,6,9,56680,28294,28386
50,6,19,California,Fresno County,6,10,55923,28046,27877
50,6,19,California,Fresno County,6,11,57270,28358,28912
50,6,19,California,Fresno County,6,12,51881,25369,26512
50,6,19,California,Fresno County,6,13,43863,21207,22656
50,6,19,California,Fresno County,6,14,33779,16105,17674
50,6,19,California,Fresno County,6,15,23804,10971,12833
50,6,19,California,Fresno County,6,16,17361,7662,9699
50,6,19,California,Fresno County,6,17,13455,5512,7943
50,6,19,California,Fresno County,6,18,14475,5164,9311
50,6,19,California,Fresno County,7,0,960072,478991,481081
50,6,19,California,Fresno County,7,1,79493,40526,38967
50,6,19,California,Fresno County,7,2,79070,40549,38521
50,6,19,California,Fresno County,7,3,74719,37982,36737
50,6,19,California,Fresno County,7,4,72491,37005,35486
50,6,19,California,Fresno County,7,5,78460,40124,38336
50,6,19,California,Fresno County,7,6,74487,38367,36120
50,6,19,California,Fresno County,7,7,68162,34728,33434
50,6,19,California,Fresno County,7,8,59796,30329,29467
50,6,19,California,Fresno County,7,9,56421,28287,28134
50,6,19,California,Fresno County,7,10,55312,27744,27568
50,6,19,California,Fresno County,7,11,57455,28507,28948
50,6,19,California,Fresno County,7,12,52709,25866,26843
50,6,19,California,Fresno County,7,13,44938,21714,23224
50,6,19,California,Fresno County,7,14,35500,16997,18503
50,6,19,California,Fresno County,7,15,25007,11511,13496
50,6,19,California,Fresno County,7,16,17915,7970,9945
50,6,19,California,Fresno County,7,17,13337,5474,7863
50,6,19,California,Fresno County,7,18,14800,5311,9489
50,6,19,California,Fresno County,8,0,968889,483246,485643
50,6,19,California,Fresno County,8,1,79585,40535,39050
50,6,19,California,Fresno County,8,2,79568,40728,38840
50,6,19,California,Fresno County,8,3,75224,38283,36941
50,6,19,California,Fresno County,8,4,72303,36713,35590
50,6,19,California,Fresno County,8,5,76461,39079,37382
50,6,19,California,Fresno County,8,6,76938,39501,37437
50,6,19,California,Fresno County,8,7,68817,35229,33588
50,6,19,California,Fresno County,8,8,61572,31155,30417
50,6,19,California,Fresno County,8,9,56405,28326,28079
50,6,19,California,Fresno County,8,10,55359,27890,27469
50,6,19,California,Fresno County,8,11,56738,28177,28561
50,6,19,California,Fresno County,8,12,53516,26381,27135
50,6,19,California,Fresno County,8,13,46077,22072,24005
50,6,19,California,Fresno County,8,14,37420,17986,19434
50,6,19,California,Fresno County,8,15,26051,12068,13983
50,6,19,California,Fresno County,8,16,18508,8294,10214
50,6,19,California,Fresno County,8,17,13215,5373,7842
50,6,19,California,Fresno County,8,18,15132,5456,9676
50,6,19,California,Fresno County,9,0,976231,486845,489386
50,6,19,California,Fresno County,9,1,78792,40180,38612
50,6,19,California,Fresno County,9,2,80475,41089,39386
50,6,19,California,Fresno County,9,3,76497,39033,37464
50,6,19,California,Fresno County,9,4,71915,36551,35364
50,6,19,California,Fresno County,9,5,73470,37524,35946
50,6,19,California,Fresno County,9,6,79111,40511,38600
50,6,19,California,Fresno County,9,7,70051,35867,34184
50,6,19,California,Fresno County,9,8,63174,31974,31200
50,6,19,California,Fresno County,9,9,56331,28466,27865
50,6,19,California,Fresno County,9,10,55690,27977,27713
50,6,19,California,Fresno County,9,11,55614,27687,27927
50,6,19,California,Fresno County,9,12,54369,26716,27653
50,6,19,California,Fresno County,9,13,46721,22398,24323
50,6,19,California,Fresno County,9,14,39169,18741,20428
50,6,19,California,Fresno County,9,15,26991,12581,14410
50,6,19,California,Fresno County,9,16,18990,8411,10579
50,6,19,California,Fresno County,9,17,13376,5566,7810
50,6,19,California,Fresno County,9,18,15495,5573,9922
50,6,19,California,Fresno County,10,0,984726,491174,493552
50,6,19,California,Fresno County,10,1,77797,39606,38191
50,6,19,California,Fresno County,10,2,80979,41337,39642
50,6,19,California,Fresno County,10,3,78338,40159,38179
50,6,19,California,Fresno County,10,4,71504,36362,35142
50,6,19,California,Fresno County,10,5,71538,36454,35084
50,6,19,California,Fresno County,10,6,80728,41301,39427
50,6,19,California,Fresno County,10,7,70885,36370,34515
50,6,19,California,Fresno County,10,8,65182,32954,32228
50,6,19,California,Fresno County,10,9,57190,28970,28220
50,6,19,California,Fresno County,10,10,55765,27921,27844
50,6,19,California,Fresno County,10,11,54873,27420,27453
50,6,19,California,Fresno County,10,12,54649,26808,27841
50,6,19,California,Fresno County,10,13,47720,22992,24728
50,6,19,California,Fresno County,10,14,39693,18925,20768
50,6,19,California,Fresno County,10,15,29064,13527,15537
50,6,19,California,Fresno County,10,16,19656,8715,10941
50,6,19,California,Fresno County,10,17,13674,5780,7894
50,6,19,California,Fresno County,10,18,15491,5573,9918
50,6,19,California,Fresno County,11,0,991298,494420,496878
50,6,19,California,Fresno County,11,1,76662,39094,37568
50,6,19,California,Fresno County,11,2,80887,41219,39668
50,6,19,California,Fresno County,11,3,79871,41078,38793
50,6,19,California,Fresno County,11,4,71813,36456,35357
50,6,19,California,Fresno County,11,5,70423,35876,34547
50,6,19,California,Fresno County,11,6,80501,41119,39382
50,6,19,California,Fresno County,11,7,71790,36916,34874
50,6,19,California,Fresno County,11,8,66884,33812,33072
50,6,19,California,Fresno County,11,9,58265,29564,28701
50,6,19,California,Fresno County,11,10,55526,27782,27744
50,6,19,California,Fresno County,11,11,54299,27182,27117
50,6,19,California,Fresno County,11,12,54771,26823,27948
50,6,19,California,Fresno County,11,13,48544,23376,25168
50,6,19,California,Fresno County,11,14,40331,19161,21170
50,6,19,California,Fresno County,11,15,30460,14230,16230
50,6,19,California,Fresno County,11,16,20716,9212,11504
50,6,19,California,Fresno County,11,17,14014,5921,8093
50,6,19,California,Fresno County,11,18,15541,5599,9942
50,6,19,California,Fresno County,12,0,997847,497983,499864
50,6,19,California,Fresno County,12,1,75176,38381,36795
50,6,19,California,Fresno County,12,2,81432,41601,39831
50,6,19,California,Fresno County,12,3,80185,41032,39153
50,6,19,California,Fresno County,12,4,72456,36863,35593
50,6,19,California,Fresno County,12,5,69322,35215,34107
50,6,19,California,Fresno County,12,6,80167,41153,39014
50,6,19,California,Fresno County,12,7,73796,37874,35922
50,6,19,California,Fresno County,12,8,68146,34515,33631
50,6,19,California,Fresno County,12,9,59580,30125,29455
50,6,19,California,Fresno County,12,10,55285,27800,27485
50,6,19,California,Fresno County,12,11,53663,26946,26717
50,6,19,California,Fresno County,12,12,54675,26844,27831
50,6,19,California,Fresno County,12,13,49112,23745,25367
50,6,19,California,Fresno County,12,14,41115,19476,21639
50,6,19,California,Fresno County,12,15,32081,14987,17094
50,6,19,California,Fresno County,12,16,21680,9659,12021
50,6,19,California,Fresno County,12,17,14434,6155,8279
50,6,19,California,Fresno County,12,18,15542,5612,9930
50,6,19,California,Fresno County,13,0,1000999,499645,501354
50,6,19,California,Fresno County,13,1,73835,37774,36061
50,6,19,California,Fresno County,13,2,81402,41532,39870
50,6,19,California,Fresno County,13,3,80439,41151,39288
50,6,19,California,Fresno County,13,4,72829,37071,35758
50,6,19,California,Fresno County,13,5,69143,35062,34081
50,6,19,California,Fresno County,13,6,78620,40404,38216
50,6,19,California,Fresno County,13,7,75229,38613,36616
50,6,19,California,Fresno County,13,8,68462,34771,33691
50,6,19,California,Fresno County,13,9,60748,30684,30064
50,6,19,California,Fresno County,13,10,55309,27813,27496
50,6,19,California,Fresno County,13,11,53499,26904,26595
50,6,19,California,Fresno County,13,12,54127,26558,27569
50,6,19,California,Fresno County,13,13,49573,24077,25496
50,6,19,California,Fresno County,13,14,41765,19677,22088
50,6,19,California,Fresno County,13,15,33333,15560,17773
50,6,19,California,Fresno County,13,16,22321,10000,12321
50,6,19,California,Fresno County,13,17,14721,6300,8421
50,6,19,California,Fresno County,13,18,15644,5694,9950
50,6,19,California,Fresno County,14,0,1000918,499639,501279
50,6,19,California,Fresno County,14,1,73361,37549,35812
50,6,19,California,Fresno County,14,2,81241,41435,39806
50,6,19,California,Fresno County,14,3,80438,41153,39285
50,6,19,California,Fresno County,14,4,72835,37079,35756
50,6,19,California,Fresno County,14,5,68953,34940,34013
50,6,19,California,Fresno County,14,6,77949,40084,37865
50,6,19,California,Fresno County,14,7,75667,38832,36835
50,6,19,California,Fresno County,14,8,68590,34880,33710
50,6,19,California,Fresno County,14,9,61103,30857,30246
50,6,19,California,Fresno County,14,10,55319,27820,27499
50,6,19,California,Fresno County,14,11,53490,26908,26582
50,6,19,California,Fresno County,14,12,53892,26448,27444
50,6,19,California,Fresno County,14,13,49659,24141,25518
50,6,19,California,Fresno County,14,14,41953,19734,22219
50,6,19,California,Fresno County,14,15,33657,15699,17958
50,6,19,California,Fresno County,14,16,22461,10074,12387
50,6,19,California,Fresno County,14,17,14787,6331,8456
50,6,19,California,Fresno County,14,18,15563,5675,9888
50,6,21,California,Glenn County,1,0,28122,14191,13931
50,6,21,California,Glenn County,1,1,2178,1116,1062
50,6,21,California,Glenn County,1,2,2115,1050,1065
50,6,21,California,Glenn County,1,3,2227,1163,1064
50,6,21,California,Glenn County,1,4,2156,1123,1033
50,6,21,California,Glenn County,1,5,1770,915,855
50,6,21,California,Glenn County,1,6,1818,966,852
50,6,21,California,Glenn County,1,7,1692,860,832
50,6,21,California,Glenn County,1,8,1635,817,818
50,6,21,California,Glenn County,1,9,1708,869,839
50,6,21,California,Glenn County,1,10,1909,946,963
50,6,21,California,Glenn County,1,11,1926,960,966
50,6,21,California,Glenn County,1,12,1817,943,874
50,6,21,California,Glenn County,1,13,1434,738,696
50,6,21,California,Glenn County,1,14,1165,596,569
50,6,21,California,Glenn County,1,15,881,422,459
50,6,21,California,Glenn County,1,16,673,302,371
50,6,21,California,Glenn County,1,17,512,223,289
50,6,21,California,Glenn County,1,18,506,182,324
50,6,21,California,Glenn County,2,0,28121,14191,13930
50,6,21,California,Glenn County,2,1,2178,1116,1062
50,6,21,California,Glenn County,2,2,2115,1050,1065
50,6,21,California,Glenn County,2,3,2227,1163,1064
50,6,21,California,Glenn County,2,4,2156,1123,1033
50,6,21,California,Glenn County,2,5,1770,915,855
50,6,21,California,Glenn County,2,6,1818,966,852
50,6,21,California,Glenn County,2,7,1692,860,832
50,6,21,California,Glenn County,2,8,1636,818,818
50,6,21,California,Glenn County,2,9,1708,869,839
50,6,21,California,Glenn County,2,10,1910,946,964
50,6,21,California,Glenn County,2,11,1926,960,966
50,6,21,California,Glenn County,2,12,1817,943,874
50,6,21,California,Glenn County,2,13,1434,738,696
50,6,21,California,Glenn County,2,14,1163,596,567
50,6,21,California,Glenn County,2,15,880,421,459
50,6,21,California,Glenn County,2,16,673,302,371
50,6,21,California,Glenn County,2,17,512,223,289
50,6,21,California,Glenn County,2,18,506,182,324
50,6,21,California,Glenn County,3,0,28125,14195,13930
50,6,21,California,Glenn County,3,1,2166,1109,1057
50,6,21,California,Glenn County,3,2,2117,1060,1057
50,6,21,California,Glenn County,3,3,2210,1147,1063
50,6,21,California,Glenn County,3,4,2150,1122,1028
50,6,21,California,Glenn County,3,5,1788,931,857
50,6,21,California,Glenn County,3,6,1798,951,847
50,6,21,California,Glenn County,3,7,1695,865,830
50,6,21,California,Glenn County,3,8,1629,812,817
50,6,21,California,Glenn County,3,9,1708,867,841
50,6,21,California,Glenn County,3,10,1898,942,956
50,6,21,California,Glenn County,3,11,1926,960,966
50,6,21,California,Glenn County,3,12,1826,943,883
50,6,21,California,Glenn County,3,13,1459,749,710
50,6,21,California,Glenn County,3,14,1160,592,568
50,6,21,California,Glenn County,3,15,892,433,459
50,6,21,California,Glenn County,3,16,673,303,370
50,6,21,California,Glenn County,3,17,515,223,292
50,6,21,California,Glenn County,3,18,515,186,329
50,6,21,California,Glenn County,4,0,28131,14206,13925
50,6,21,California,Glenn County,4,1,2164,1125,1039
50,6,21,California,Glenn County,4,2,2103,1071,1032
50,6,21,California,Glenn County,4,3,2161,1119,1042
50,6,21,California,Glenn County,4,4,2135,1113,1022
50,6,21,California,Glenn County,4,5,1830,955,875
50,6,21,California,Glenn County,4,6,1788,924,864
50,6,21,California,Glenn County,4,7,1717,886,831
50,6,21,California,Glenn County,4,8,1600,799,801
50,6,21,California,Glenn County,4,9,1660,829,831
50,6,21,California,Glenn County,4,10,1837,917,920
50,6,21,California,Glenn County,4,11,1917,964,953
50,6,21,California,Glenn County,4,12,1879,959,920
50,6,21,California,Glenn County,4,13,1546,791,755
50,6,21,California,Glenn County,4,14,1138,577,561
50,6,21,California,Glenn County,4,15,928,458,470
50,6,21,California,Glenn County,4,16,685,318,367
50,6,21,California,Glenn County,4,17,524,210,314
50,6,21,California,Glenn County,4,18,519,191,328
50,6,21,California,Glenn County,5,0,27836,14037,13799
50,6,21,California,Glenn County,5,1,2077,1072,1005
50,6,21,California,Glenn County,5,2,2083,1087,996
50,6,21,California,Glenn County,5,3,2110,1082,1028
50,6,21,California,Glenn County,5,4,2122,1108,1014
50,6,21,California,Glenn County,5,5,1813,935,878
50,6,21,California,Glenn County,5,6,1704,905,799
50,6,21,California,Glenn County,5,7,1741,876,865
50,6,21,California,Glenn County,5,8,1600,785,815
50,6,21,California,Glenn County,5,9,1586,796,790
50,6,21,California,Glenn County,5,10,1748,858,890
50,6,21,California,Glenn County,5,11,1908,970,938
50,6,21,California,Glenn County,5,12,1870,948,922
50,6,21,California,Glenn County,5,13,1587,799,788
50,6,21,California,Glenn County,5,14,1184,597,587
50,6,21,California,Glenn County,5,15,960,477,483
50,6,21,California,Glenn County,5,16,695,326,369
50,6,21,California,Glenn County,5,17,529,223,306
50,6,21,California,Glenn County,5,18,519,193,326
50,6,21,California,Glenn County,6,0,27784,14031,13753
50,6,21,California,Glenn County,6,1,2025,1046,979
50,6,21,California,Glenn County,6,2,2107,1098,1009
50,6,21,California,Glenn County,6,3,2064,1072,992
50,6,21,California,Glenn County,6,4,2085,1081,1004
50,6,21,California,Glenn County,6,5,1802,942,860
50,6,21,California,Glenn County,6,6,1735,910,825
50,6,21,California,Glenn County,6,7,1723,877,846
50,6,21,California,Glenn County,6,8,1603,785,818
50,6,21,California,Glenn County,6,9,1574,790,784
50,6,21,California,Glenn County,6,10,1658,816,842
50,6,21,California,Glenn County,6,11,1912,957,955
50,6,21,California,Glenn County,6,12,1893,959,934
50,6,21,California,Glenn County,6,13,1581,802,779
50,6,21,California,Glenn County,6,14,1215,628,587
50,6,21,California,Glenn County,6,15,1008,495,513
50,6,21,California,Glenn County,6,16,711,334,377
50,6,21,California,Glenn County,6,17,545,236,309
50,6,21,California,Glenn County,6,18,543,203,340
50,6,21,California,Glenn County,7,0,27802,14025,13777
50,6,21,California,Glenn County,7,1,2008,1063,945
50,6,21,California,Glenn County,7,2,2175,1119,1056
50,6,21,California,Glenn County,7,3,2014,1021,993
50,6,21,California,Glenn County,7,4,2102,1084,1018
50,6,21,California,Glenn County,7,5,1767,917,850
50,6,21,California,Glenn County,7,6,1788,921,867
50,6,21,California,Glenn County,7,7,1728,885,843
50,6,21,California,Glenn County,7,8,1615,809,806
50,6,21,California,Glenn County,7,9,1557,762,795
50,6,21,California,Glenn County,7,10,1562,802,760
50,6,21,California,Glenn County,7,11,1910,931,979
50,6,21,California,Glenn County,7,12,1861,940,921
50,6,21,California,Glenn County,7,13,1624,836,788
50,6,21,California,Glenn County,7,14,1258,632,626
50,6,21,California,Glenn County,7,15,1027,520,507
50,6,21,California,Glenn County,7,16,740,345,395
50,6,21,California,Glenn County,7,17,537,234,303
50,6,21,California,Glenn County,7,18,529,204,325
50,6,21,California,Glenn County,8,0,27723,13985,13738
50,6,21,California,Glenn County,8,1,1968,1044,924
50,6,21,California,Glenn County,8,2,2156,1102,1054
50,6,21,California,Glenn County,8,3,2052,1016,1036
50,6,21,California,Glenn County,8,4,2044,1058,986
50,6,21,California,Glenn County,8,5,1832,968,864
50,6,21,California,Glenn County,8,6,1737,892,845
50,6,21,California,Glenn County,8,7,1738,909,829
50,6,21,California,Glenn County,8,8,1639,808,831
50,6,21,California,Glenn County,8,9,1530,751,779
50,6,21,California,Glenn County,8,10,1536,791,745
50,6,21,California,Glenn County,8,11,1818,896,922
50,6,21,California,Glenn County,8,12,1854,926,928
50,6,21,California,Glenn County,8,13,1674,851,823
50,6,21,California,Glenn County,8,14,1312,667,645
50,6,21,California,Glenn County,8,15,1029,520,509
50,6,21,California,Glenn County,8,16,749,351,398
50,6,21,California,Glenn County,8,17,527,234,293
50,6,21,California,Glenn County,8,18,528,201,327
50,6,21,California,Glenn County,9,0,27796,14104,13692
50,6,21,California,Glenn County,9,1,1972,1041,931
50,6,21,California,Glenn County,9,2,2134,1125,1009
50,6,21,California,Glenn County,9,3,2046,1020,1026
50,6,21,California,Glenn County,9,4,2041,1065,976
50,6,21,California,Glenn County,9,5,1843,960,883
50,6,21,California,Glenn County,9,6,1791,929,862
50,6,21,California,Glenn County,9,7,1701,888,813
50,6,21,California,Glenn County,9,8,1671,834,837
50,6,21,California,Glenn County,9,9,1501,746,755
50,6,21,California,Glenn County,9,10,1529,783,746
50,6,21,California,Glenn County,9,11,1755,876,879
50,6,21,California,Glenn County,9,12,1816,914,902
50,6,21,California,Glenn County,9,13,1734,885,849
50,6,21,California,Glenn County,9,14,1401,703,698
50,6,21,California,Glenn County,9,15,1027,519,508
50,6,21,California,Glenn County,9,16,777,384,393
50,6,21,California,Glenn County,9,17,523,232,291
50,6,21,California,Glenn County,9,18,534,200,334
50,6,21,California,Glenn County,10,0,27876,14154,13722
50,6,21,California,Glenn County,10,1,2008,1067,941
50,6,21,California,Glenn County,10,2,2109,1097,1012
50,6,21,California,Glenn County,10,3,2104,1068,1036
50,6,21,California,Glenn County,10,4,1974,1022,952
50,6,21,California,Glenn County,10,5,1802,941,861
50,6,21,California,Glenn County,10,6,1869,979,890
50,6,21,California,Glenn County,10,7,1668,876,792
50,6,21,California,Glenn County,10,8,1732,876,856
50,6,21,California,Glenn County,10,9,1520,748,772
50,6,21,California,Glenn County,10,10,1501,766,735
50,6,21,California,Glenn County,10,11,1684,834,850
50,6,21,California,Glenn County,10,12,1826,936,890
50,6,21,California,Glenn County,10,13,1744,873,871
50,6,21,California,Glenn County,10,14,1408,707,701
50,6,21,California,Glenn County,10,15,1069,538,531
50,6,21,California,Glenn County,10,16,794,389,405
50,6,21,California,Glenn County,10,17,546,243,303
50,6,21,California,Glenn County,10,18,518,194,324
50,6,21,California,Glenn County,11,0,27899,14188,13711
50,6,21,California,Glenn County,11,1,1998,1067,931
50,6,21,California,Glenn County,11,2,2109,1105,1004
50,6,21,California,Glenn County,11,3,2183,1107,1076
50,6,21,California,Glenn County,11,4,1929,1008,921
50,6,21,California,Glenn County,11,5,1807,939,868
50,6,21,California,Glenn County,11,6,1869,988,881
50,6,21,California,Glenn County,11,7,1741,901,840
50,6,21,California,Glenn County,11,8,1720,870,850
50,6,21,California,Glenn County,11,9,1505,747,758
50,6,21,California,Glenn County,11,10,1530,772,758
50,6,21,California,Glenn County,11,11,1593,798,795
50,6,21,California,Glenn County,11,12,1806,909,897
50,6,21,California,Glenn County,11,13,1749,877,872
50,6,21,California,Glenn County,11,14,1408,712,696
50,6,21,California,Glenn County,11,15,1090,556,534
50,6,21,California,Glenn County,11,16,823,400,423
50,6,21,California,Glenn County,11,17,544,239,305
50,6,21,California,Glenn County,11,18,495,193,302
50,6,21,California,Glenn County,12,0,28445,14487,13958
50,6,21,California,Glenn County,12,1,1990,1062,928
50,6,21,California,Glenn County,12,2,2132,1134,998
50,6,21,California,Glenn County,12,3,2213,1119,1094
50,6,21,California,Glenn County,12,4,1970,1013,957
50,6,21,California,Glenn County,12,5,1853,970,883
50,6,21,California,Glenn County,12,6,1884,990,894
50,6,21,California,Glenn County,12,7,1845,974,871
50,6,21,California,Glenn County,12,8,1751,898,853
50,6,21,California,Glenn County,12,9,1551,796,755
50,6,21,California,Glenn County,12,10,1533,737,796
50,6,21,California,Glenn County,12,11,1541,804,737
50,6,21,California,Glenn County,12,12,1854,900,954
50,6,21,California,Glenn County,12,13,1766,887,879
50,6,21,California,Glenn County,12,14,1500,769,731
50,6,21,California,Glenn County,12,15,1114,548,566
50,6,21,California,Glenn County,12,16,877,431,446
50,6,21,California,Glenn County,12,17,566,254,312
50,6,21,California,Glenn County,12,18,505,201,304
50,6,21,California,Glenn County,13,0,28342,14451,13891
50,6,21,California,Glenn County,13,1,1938,1031,907
50,6,21,California,Glenn County,13,2,2149,1158,991
50,6,21,California,Glenn County,13,3,2214,1136,1078
50,6,21,California,Glenn County,13,4,1972,1003,969
50,6,21,California,Glenn County,13,5,1829,964,865
50,6,21,California,Glenn County,13,6,1864,969,895
50,6,21,California,Glenn County,13,7,1858,985,873
50,6,21,California,Glenn County,13,8,1752,902,850
50,6,21,California,Glenn County,13,9,1560,799,761
50,6,21,California,Glenn County,13,10,1501,727,774
50,6,21,California,Glenn County,13,11,1508,780,728
50,6,21,California,Glenn County,13,12,1793,880,913
50,6,21,California,Glenn County,13,13,1740,863,877
50,6,21,California,Glenn County,13,14,1550,785,765
50,6,21,California,Glenn County,13,15,1142,568,574
50,6,21,California,Glenn County,13,16,878,434,444
50,6,21,California,Glenn County,13,17,584,262,322
50,6,21,California,Glenn County,13,18,510,205,305
50,6,21,California,Glenn County,14,0,28283,14401,13882
50,6,21,California,Glenn County,14,1,1922,1019,903
50,6,21,California,Glenn County,14,2,2150,1163,987
50,6,21,California,Glenn County,14,3,2217,1139,1078
50,6,21,California,Glenn County,14,4,1971,994,977
50,6,21,California,Glenn County,14,5,1820,958,862
50,6,21,California,Glenn County,14,6,1845,958,887
50,6,21,California,Glenn County,14,7,1861,987,874
50,6,21,California,Glenn County,14,8,1751,900,851
50,6,21,California,Glenn County,14,9,1564,799,765
50,6,21,California,Glenn County,14,10,1487,718,769
50,6,21,California,Glenn County,14,11,1502,775,727
50,6,21,California,Glenn County,14,12,1769,871,898
50,6,21,California,Glenn County,14,13,1730,852,878
50,6,21,California,Glenn County,14,14,1564,790,774
50,6,21,California,Glenn County,14,15,1152,572,580
50,6,21,California,Glenn County,14,16,877,434,443
50,6,21,California,Glenn County,14,17,594,268,326
50,6,21,California,Glenn County,14,18,507,204,303
50,6,23,California,Humboldt County,1,0,134623,67595,67028
50,6,23,California,Humboldt County,1,1,7738,3977,3761
50,6,23,California,Humboldt County,1,2,7324,3699,3625
50,6,23,California,Humboldt County,1,3,7242,3721,3521
50,6,23,California,Humboldt County,1,4,9531,4807,4724
50,6,23,California,Humboldt County,1,5,11878,6064,5814
50,6,23,California,Humboldt County,1,6,10743,5686,5057
50,6,23,California,Humboldt County,1,7,9252,4899,4353
50,6,23,California,Humboldt County,1,8,7989,4323,3666
50,6,23,California,Humboldt County,1,9,7079,3701,3378
50,6,23,California,Humboldt County,1,10,8771,4401,4370
50,6,23,California,Humboldt County,1,11,9978,4846,5132
50,6,23,California,Humboldt County,1,12,10339,5060,5279
50,6,23,California,Humboldt County,1,13,9034,4538,4496
50,6,23,California,Humboldt County,1,14,5691,2773,2918
50,6,23,California,Humboldt County,1,15,3980,1888,2092
50,6,23,California,Humboldt County,1,16,3040,1337,1703
50,6,23,California,Humboldt County,1,17,2449,1021,1428
50,6,23,California,Humboldt County,1,18,2565,854,1711
50,6,23,California,Humboldt County,2,0,134613,67590,67023
50,6,23,California,Humboldt County,2,1,7738,3977,3761
50,6,23,California,Humboldt County,2,2,7324,3699,3625
50,6,23,California,Humboldt County,2,3,7242,3721,3521
50,6,23,California,Humboldt County,2,4,9531,4807,4724
50,6,23,California,Humboldt County,2,5,11878,6064,5814
50,6,23,California,Humboldt County,2,6,10743,5686,5057
50,6,23,California,Humboldt County,2,7,9252,4899,4353
50,6,23,California,Humboldt County,2,8,7989,4323,3666
50,6,23,California,Humboldt County,2,9,7079,3701,3378
50,6,23,California,Humboldt County,2,10,8771,4401,4370
50,6,23,California,Humboldt County,2,11,9978,4846,5132
50,6,23,California,Humboldt County,2,12,10338,5060,5278
50,6,23,California,Humboldt County,2,13,9032,4536,4496
50,6,23,California,Humboldt County,2,14,5693,2774,2919
50,6,23,California,Humboldt County,2,15,3979,1888,2091
50,6,23,California,Humboldt County,2,16,3038,1335,1703
50,6,23,California,Humboldt County,2,17,2446,1020,1426
50,6,23,California,Humboldt County,2,18,2562,853,1709
50,6,23,California,Humboldt County,3,0,135010,67790,67220
50,6,23,California,Humboldt County,3,1,7737,3974,3763
50,6,23,California,Humboldt County,3,2,7330,3711,3619
50,6,23,California,Humboldt County,3,3,7234,3723,3511
50,6,23,California,Humboldt County,3,4,9635,4850,4785
50,6,23,California,Humboldt County,3,5,12141,6174,5967
50,6,23,California,Humboldt County,3,6,10605,5620,4985
50,6,23,California,Humboldt County,3,7,9375,4960,4415
50,6,23,California,Humboldt County,3,8,7988,4322,3666
50,6,23,California,Humboldt County,3,9,7130,3738,3392
50,6,23,California,Humboldt County,3,10,8641,4337,4304
50,6,23,California,Humboldt County,3,11,9899,4808,5091
50,6,23,California,Humboldt County,3,12,10346,5053,5293
50,6,23,California,Humboldt County,3,13,9148,4597,4551
50,6,23,California,Humboldt County,3,14,5756,2811,2945
50,6,23,California,Humboldt County,3,15,4020,1915,2105
50,6,23,California,Humboldt County,3,16,3013,1324,1689
50,6,23,California,Humboldt County,3,17,2446,1017,1429
50,6,23,California,Humboldt County,3,18,2566,856,1710
50,6,23,California,Humboldt County,4,0,135257,67848,67409
50,6,23,California,Humboldt County,4,1,7643,3929,3714
50,6,23,California,Humboldt County,4,2,7315,3753,3562
50,6,23,California,Humboldt County,4,3,7220,3705,3515
50,6,23,California,Humboldt County,4,4,9496,4807,4689
50,6,23,California,Humboldt County,4,5,12656,6306,6350
50,6,23,California,Humboldt County,4,6,9910,5266,4644
50,6,23,California,Humboldt County,4,7,9702,5080,4622
50,6,23,California,Humboldt County,4,8,7999,4314,3685
50,6,23,California,Humboldt County,4,9,7316,3871,3445
50,6,23,California,Humboldt County,4,10,8082,4067,4015
50,6,23,California,Humboldt County,4,11,9658,4716,4942
50,6,23,California,Humboldt County,4,12,10307,4988,5319
50,6,23,California,Humboldt County,4,13,9703,4877,4826
50,6,23,California,Humboldt County,4,14,5997,2936,3061
50,6,23,California,Humboldt County,4,15,4209,2040,2169
50,6,23,California,Humboldt County,4,16,2975,1305,1670
50,6,23,California,Humboldt County,4,17,2420,991,1429
50,6,23,California,Humboldt County,4,18,2649,897,1752
50,6,23,California,Humboldt County,5,0,134597,67358,67239
50,6,23,California,Humboldt County,5,1,7339,3736,3603
50,6,23,California,Humboldt County,5,2,7401,3778,3623
50,6,23,California,Humboldt County,5,3,7191,3666,3525
50,6,23,California,Humboldt County,5,4,9254,4671,4583
50,6,23,California,Humboldt County,5,5,13054,6459,6595
50,6,23,California,Humboldt County,5,6,9147,4843,4304
50,6,23,California,Humboldt County,5,7,9801,5134,4667
50,6,23,California,Humboldt County,5,8,8221,4397,3824
50,6,23,California,Humboldt County,5,9,7375,3948,3427
50,6,23,California,Humboldt County,5,10,7623,3829,3794
50,6,23,California,Humboldt County,5,11,9285,4552,4733
50,6,23,California,Humboldt County,5,12,10117,4860,5257
50,6,23,California,Humboldt County,5,13,9665,4786,4879
50,6,23,California,Humboldt County,5,14,6689,3319,3370
50,6,23,California,Humboldt County,5,15,4346,2120,2226
50,6,23,California,Humboldt County,5,16,3044,1375,1669
50,6,23,California,Humboldt County,5,17,2378,967,1411
50,6,23,California,Humboldt County,5,18,2667,918,1749
50,6,23,California,Humboldt County,6,0,134447,67184,67263
50,6,23,California,Humboldt County,6,1,7389,3753,3636
50,6,23,California,Humboldt County,6,2,7498,3828,3670
50,6,23,California,Humboldt County,6,3,7061,3581,3480
50,6,23,California,Humboldt County,6,4,9109,4586,4523
50,6,23,California,Humboldt County,6,5,13250,6499,6751
50,6,23,California,Humboldt County,6,6,8723,4604,4119
50,6,23,California,Humboldt County,6,7,9772,5111,4661
50,6,23,California,Humboldt County,6,8,8340,4464,3876
50,6,23,California,Humboldt County,6,9,7494,3987,3507
50,6,23,California,Humboldt County,6,10,7222,3647,3575
50,6,23,California,Humboldt County,6,11,9036,4463,4573
50,6,23,California,Humboldt County,6,12,9866,4763,5103
50,6,23,California,Humboldt County,6,13,9847,4782,5065
50,6,23,California,Humboldt County,6,14,7141,3575,3566
50,6,23,California,Humboldt County,6,15,4576,2225,2351
50,6,23,California,Humboldt County,6,16,3085,1417,1668
50,6,23,California,Humboldt County,6,17,2343,940,1403
50,6,23,California,Humboldt County,6,18,2695,959,1736
50,6,23,California,Humboldt County,7,0,134556,67246,67310
50,6,23,California,Humboldt County,7,1,7405,3776,3629
50,6,23,California,Humboldt County,7,2,7452,3848,3604
50,6,23,California,Humboldt County,7,3,7054,3542,3512
50,6,23,California,Humboldt County,7,4,8939,4497,4442
50,6,23,California,Humboldt County,7,5,13409,6621,6788
50,6,23,California,Humboldt County,7,6,8739,4622,4117
50,6,23,California,Humboldt County,7,7,9547,4950,4597
50,6,23,California,Humboldt County,7,8,8472,4475,3997
50,6,23,California,Humboldt County,7,9,7638,4025,3613
50,6,23,California,Humboldt County,7,10,6998,3584,3414
50,6,23,California,Humboldt County,7,11,8706,4330,4376
50,6,23,California,Humboldt County,7,12,9593,4630,4963
50,6,23,California,Humboldt County,7,13,9831,4752,5079
50,6,23,California,Humboldt County,7,14,7808,3860,3948
50,6,23,California,Humboldt County,7,15,4770,2303,2467
50,6,23,California,Humboldt County,7,16,3189,1491,1698
50,6,23,California,Humboldt County,7,17,2268,919,1349
50,6,23,California,Humboldt County,7,18,2738,1021,1717
50,6,23,California,Humboldt County,8,0,135177,67478,67699
50,6,23,California,Humboldt County,8,1,7477,3860,3617
50,6,23,California,Humboldt County,8,2,7404,3801,3603
50,6,23,California,Humboldt County,8,3,7161,3649,3512
50,6,23,California,Humboldt County,8,4,8844,4418,4426
50,6,23,California,Humboldt County,8,5,13283,6591,6692
50,6,23,California,Humboldt County,8,6,8911,4605,4306
50,6,23,California,Humboldt County,8,7,9277,4794,4483
50,6,23,California,Humboldt County,8,8,8782,4601,4181
50,6,23,California,Humboldt County,8,9,7727,4110,3617
50,6,23,California,Humboldt County,8,10,6968,3623,3345
50,6,23,California,Humboldt County,8,11,8282,4122,4160
50,6,23,California,Humboldt County,8,12,9476,4539,4937
50,6,23,California,Humboldt County,8,13,9755,4643,5112
50,6,23,California,Humboldt County,8,14,8461,4188,4273
50,6,23,California,Humboldt County,8,15,5042,2410,2632
50,6,23,California,Humboldt County,8,16,3350,1573,1777
50,6,23,California,Humboldt County,8,17,2243,949,1294
50,6,23,California,Humboldt County,8,18,2734,1002,1732
50,6,23,California,Humboldt County,9,0,136477,68049,68428
50,6,23,California,Humboldt County,9,1,7535,3879,3656
50,6,23,California,Humboldt County,9,2,7425,3780,3645
50,6,23,California,Humboldt County,9,3,7254,3705,3549
50,6,23,California,Humboldt County,9,4,9015,4488,4527
50,6,23,California,Humboldt County,9,5,13055,6461,6594
50,6,23,California,Humboldt County,9,6,9314,4797,4517
50,6,23,California,Humboldt County,9,7,9047,4690,4357
50,6,23,California,Humboldt County,9,8,9265,4804,4461
50,6,23,California,Humboldt County,9,9,7794,4160,3634
50,6,23,California,Humboldt County,9,10,7214,3793,3421
50,6,23,California,Humboldt County,9,11,7787,3862,3925
50,6,23,California,Humboldt County,9,12,9310,4489,4821
50,6,23,California,Humboldt County,9,13,9662,4582,5080
50,6,23,California,Humboldt County,9,14,8982,4397,4585
50,6,23,California,Humboldt County,9,15,5285,2532,2753
50,6,23,California,Humboldt County,9,16,3535,1688,1847
50,6,23,California,Humboldt County,9,17,2227,944,1283
50,6,23,California,Humboldt County,9,18,2771,998,1773
50,6,23,California,Humboldt County,10,0,136710,68015,68695
50,6,23,California,Humboldt County,10,1,7452,3793,3659
50,6,23,California,Humboldt County,10,2,7207,3666,3541
50,6,23,California,Humboldt County,10,3,7312,3740,3572
50,6,23,California,Humboldt County,10,4,8975,4470,4505
50,6,23,California,Humboldt County,10,5,12937,6407,6530
50,6,23,California,Humboldt County,10,6,9651,4936,4715
50,6,23,California,Humboldt County,10,7,8662,4500,4162
50,6,23,California,Humboldt County,10,8,9467,4868,4599
50,6,23,California,Humboldt County,10,9,8114,4332,3782
50,6,23,California,Humboldt County,10,10,7305,3843,3462
50,6,23,California,Humboldt County,10,11,7480,3716,3764
50,6,23,California,Humboldt County,10,12,8986,4352,4634
50,6,23,California,Humboldt County,10,13,9520,4480,5040
50,6,23,California,Humboldt County,10,14,8906,4293,4613
50,6,23,California,Humboldt County,10,15,6011,2917,3094
50,6,23,California,Humboldt County,10,16,3679,1734,1945
50,6,23,California,Humboldt County,10,17,2301,997,1304
50,6,23,California,Humboldt County,10,18,2745,971,1774
50,6,23,California,Humboldt County,11,0,136502,67857,68645
50,6,23,California,Humboldt County,11,1,7126,3628,3498
50,6,23,California,Humboldt County,11,2,7228,3689,3539
50,6,23,California,Humboldt County,11,3,7403,3783,3620
50,6,23,California,Humboldt County,11,4,8912,4449,4463
50,6,23,California,Humboldt County,11,5,12709,6266,6443
50,6,23,California,Humboldt County,11,6,9790,5029,4761
50,6,23,California,Humboldt County,11,7,8334,4290,4044
50,6,23,California,Humboldt County,11,8,9504,4871,4633
50,6,23,California,Humboldt County,11,9,8386,4441,3945
50,6,23,California,Humboldt County,11,10,7396,3898,3498
50,6,23,California,Humboldt County,11,11,7090,3544,3546
50,6,23,California,Humboldt County,11,12,8788,4262,4526
50,6,23,California,Humboldt County,11,13,9317,4426,4891
50,6,23,California,Humboldt County,11,14,9129,4312,4817
50,6,23,California,Humboldt County,11,15,6375,3101,3274
50,6,23,California,Humboldt County,11,16,3880,1827,2053
50,6,23,California,Humboldt County,11,17,2381,1056,1325
50,6,23,California,Humboldt County,11,18,2754,985,1769
50,6,23,California,Humboldt County,12,0,135839,67377,68462
50,6,23,California,Humboldt County,12,1,6932,3490,3442
50,6,23,California,Humboldt County,12,2,7194,3653,3541
50,6,23,California,Humboldt County,12,3,7324,3748,3576
50,6,23,California,Humboldt County,12,4,8824,4425,4399
50,6,23,California,Humboldt County,12,5,12557,6179,6378
50,6,23,California,Humboldt County,12,6,9792,4950,4842
50,6,23,California,Humboldt County,12,7,8302,4329,3973
50,6,23,California,Humboldt County,12,8,9169,4670,4499
50,6,23,California,Humboldt County,12,9,8497,4461,4036
50,6,23,California,Humboldt County,12,10,7548,3942,3606
50,6,23,California,Humboldt County,12,11,6945,3506,3439
50,6,23,California,Humboldt County,12,12,8435,4129,4306
50,6,23,California,Humboldt County,12,13,9073,4314,4759
50,6,23,California,Humboldt County,12,14,9035,4240,4795
50,6,23,California,Humboldt County,12,15,6999,3377,3622
50,6,23,California,Humboldt County,12,16,4059,1881,2178
50,6,23,California,Humboldt County,12,17,2418,1078,1340
50,6,23,California,Humboldt County,12,18,2736,1005,1731
50,6,23,California,Humboldt County,13,0,135268,67005,68263
50,6,23,California,Humboldt County,13,1,6898,3464,3434
50,6,23,California,Humboldt County,13,2,7140,3645,3495
50,6,23,California,Humboldt County,13,3,7213,3665,3548
50,6,23,California,Humboldt County,13,4,8725,4391,4334
50,6,23,California,Humboldt County,13,5,12402,6095,6307
50,6,23,California,Humboldt County,13,6,9629,4906,4723
50,6,23,California,Humboldt County,13,7,8288,4266,4022
50,6,23,California,Humboldt County,13,8,9022,4572,4450
50,6,23,California,Humboldt County,13,9,8664,4510,4154
50,6,23,California,Humboldt County,13,10,7596,3999,3597
50,6,23,California,Humboldt County,13,11,6859,3529,3330
50,6,23,California,Humboldt County,13,12,8154,3963,4191
50,6,23,California,Humboldt County,13,13,8996,4249,4747
50,6,23,California,Humboldt County,13,14,8987,4189,4798
50,6,23,California,Humboldt County,13,15,7328,3526,3802
50,6,23,California,Humboldt County,13,16,4184,1927,2257
50,6,23,California,Humboldt County,13,17,2503,1121,1382
50,6,23,California,Humboldt County,13,18,2680,988,1692
50,6,23,California,Humboldt County,14,0,134977,66831,68146
50,6,23,California,Humboldt County,14,1,6881,3450,3431
50,6,23,California,Humboldt County,14,2,7107,3637,3470
50,6,23,California,Humboldt County,14,3,7172,3636,3536
50,6,23,California,Humboldt County,14,4,8683,4375,4308
50,6,23,California,Humboldt County,14,5,12339,6059,6280
50,6,23,California,Humboldt County,14,6,9566,4884,4682
50,6,23,California,Humboldt County,14,7,8295,4251,4044
50,6,23,California,Humboldt County,14,8,8975,4540,4435
50,6,23,California,Humboldt County,14,9,8728,4531,4197
50,6,23,California,Humboldt County,14,10,7608,4016,3592
50,6,23,California,Humboldt County,14,11,6845,3543,3302
50,6,23,California,Humboldt County,14,12,8054,3907,4147
50,6,23,California,Humboldt County,14,13,8962,4221,4741
50,6,23,California,Humboldt County,14,14,8965,4170,4795
50,6,23,California,Humboldt County,14,15,7421,3572,3849
50,6,23,California,Humboldt County,14,16,4206,1932,2274
50,6,23,California,Humboldt County,14,17,2528,1133,1395
50,6,23,California,Humboldt County,14,18,2642,974,1668
50,6,25,California,Imperial County,1,0,174528,89646,84882
50,6,25,California,Imperial County,1,1,13526,6874,6652
50,6,25,California,Imperial County,1,2,13841,7028,6813
50,6,25,California,Imperial County,1,3,14536,7593,6943
50,6,25,California,Imperial County,1,4,15047,7721,7326
50,6,25,California,Imperial County,1,5,13188,7235,5953
50,6,25,California,Imperial County,1,6,12511,7042,5469
50,6,25,California,Imperial County,1,7,11686,6558,5128
50,6,25,California,Imperial County,1,8,11374,6069,5305
50,6,25,California,Imperial County,1,9,11567,6057,5510
50,6,25,California,Imperial County,1,10,11413,5750,5663
50,6,25,California,Imperial County,1,11,11084,5518,5566
50,6,25,California,Imperial County,1,12,9236,4440,4796
50,6,25,California,Imperial County,1,13,7367,3526,3841
50,6,25,California,Imperial County,1,14,5371,2452,2919
50,6,25,California,Imperial County,1,15,4420,2099,2321
50,6,25,California,Imperial County,1,16,3618,1631,1987
50,6,25,California,Imperial County,1,17,2738,1247,1491
50,6,25,California,Imperial County,1,18,2005,806,1199
50,6,25,California,Imperial County,2,0,174522,89644,84878
50,6,25,California,Imperial County,2,1,13525,6874,6651
50,6,25,California,Imperial County,2,2,13841,7028,6813
50,6,25,California,Imperial County,2,3,14536,7593,6943
50,6,25,California,Imperial County,2,4,15047,7721,7326
50,6,25,California,Imperial County,2,5,13188,7235,5953
50,6,25,California,Imperial County,2,6,12510,7042,5468
50,6,25,California,Imperial County,2,7,11686,6558,5128
50,6,25,California,Imperial County,2,8,11374,6069,5305
50,6,25,California,Imperial County,2,9,11567,6057,5510
50,6,25,California,Imperial County,2,10,11413,5750,5663
50,6,25,California,Imperial County,2,11,11083,5517,5566
50,6,25,California,Imperial County,2,12,9236,4440,4796
50,6,25,California,Imperial County,2,13,7366,3526,3840
50,6,25,California,Imperial County,2,14,5371,2452,2919
50,6,25,California,Imperial County,2,15,4419,2098,2321
50,6,25,California,Imperial County,2,16,3618,1631,1987
50,6,25,California,Imperial County,2,17,2737,1247,1490
50,6,25,California,Imperial County,2,18,2005,806,1199
50,6,25,California,Imperial County,3,0,174704,89649,85055
50,6,25,California,Imperial County,3,1,13586,6900,6686
50,6,25,California,Imperial County,3,2,13844,7014,6830
50,6,25,California,Imperial County,3,3,14494,7566,6928
50,6,25,California,Imperial County,3,4,14981,7685,7296
50,6,25,California,Imperial County,3,5,13345,7320,6025
50,6,25,California,Imperial County,3,6,12574,7062,5512
50,6,25,California,Imperial County,3,7,11706,6561,5145
50,6,25,California,Imperial County,3,8,11300,6009,5291
50,6,25,California,Imperial County,3,9,11521,6021,5500
50,6,25,California,Imperial County,3,10,11357,5722,5635
50,6,25,California,Imperial County,3,11,11022,5483,5539
50,6,25,California,Imperial County,3,12,9298,4459,4839
50,6,25,California,Imperial County,3,13,7421,3554,3867
50,6,25,California,Imperial County,3,14,5394,2469,2925
50,6,25,California,Imperial County,3,15,4423,2092,2331
50,6,25,California,Imperial County,3,16,3628,1646,1982
50,6,25,California,Imperial County,3,17,2758,1256,1502
50,6,25,California,Imperial County,3,18,2052,830,1222
50,6,25,California,Imperial County,4,0,175731,90191,85540
50,6,25,California,Imperial County,4,1,14028,7166,6862
50,6,25,California,Imperial County,4,2,13744,6917,6827
50,6,25,California,Imperial County,4,3,14305,7444,6861
50,6,25,California,Imperial County,4,4,14706,7586,7120
50,6,25,California,Imperial County,4,5,13915,7647,6268
50,6,25,California,Imperial County,4,6,12718,7186,5532
50,6,25,California,Imperial County,4,7,11851,6640,5211
50,6,25,California,Imperial County,4,8,11060,5852,5208
50,6,25,California,Imperial County,4,9,11385,5946,5439
50,6,25,California,Imperial County,4,10,11180,5637,5543
50,6,25,California,Imperial County,4,11,10805,5370,5435
50,6,25,California,Imperial County,4,12,9668,4643,5025
50,6,25,California,Imperial County,4,13,7707,3701,4006
50,6,25,California,Imperial County,4,14,5504,2539,2965
50,6,25,California,Imperial County,4,15,4470,2053,2417
50,6,25,California,Imperial County,4,16,3685,1695,1990
50,6,25,California,Imperial County,4,17,2813,1278,1535
50,6,25,California,Imperial County,4,18,2187,891,1296
50,6,25,California,Imperial County,5,0,176487,90588,85899
50,6,25,California,Imperial County,5,1,14367,7386,6981
50,6,25,California,Imperial County,5,2,13812,6883,6929
50,6,25,California,Imperial County,5,3,13972,7233,6739
50,6,25,California,Imperial County,5,4,14370,7457,6913
50,6,25,California,Imperial County,5,5,14296,7895,6401
50,6,25,California,Imperial County,5,6,12755,7207,5548
50,6,25,California,Imperial County,5,7,12074,6751,5323
50,6,25,California,Imperial County,5,8,11046,5904,5142
50,6,25,California,Imperial County,5,9,11102,5761,5341
50,6,25,California,Imperial County,5,10,10975,5555,5420
50,6,25,California,Imperial County,5,11,10785,5373,5412
50,6,25,California,Imperial County,5,12,9813,4688,5125
50,6,25,California,Imperial County,5,13,7797,3761,4036
50,6,25,California,Imperial County,5,14,5867,2720,3147
50,6,25,California,Imperial County,5,15,4569,2062,2507
50,6,25,California,Imperial County,5,16,3705,1710,1995
50,6,25,California,Imperial County,5,17,2799,1268,1531
50,6,25,California,Imperial County,5,18,2383,974,1409
50,6,25,California,Imperial County,6,0,176301,89931,86370
50,6,25,California,Imperial County,6,1,14625,7531,7094
50,6,25,California,Imperial County,6,2,13806,6878,6928
50,6,25,California,Imperial County,6,3,13938,7158,6780
50,6,25,California,Imperial County,6,4,14102,7308,6794
50,6,25,California,Imperial County,6,5,14364,7836,6528
50,6,25,California,Imperial County,6,6,12639,7122,5517
50,6,25,California,Imperial County,6,7,12120,6662,5458
50,6,25,California,Imperial County,6,8,10801,5812,4989
50,6,25,California,Imperial County,6,9,10727,5498,5229
50,6,25,California,Imperial County,6,10,10719,5370,5349
50,6,25,California,Imperial County,6,11,10619,5268,5351
50,6,25,California,Imperial County,6,12,9934,4717,5217
50,6,25,California,Imperial County,6,13,7910,3775,4135
50,6,25,California,Imperial County,6,14,6178,2887,3291
50,6,25,California,Imperial County,6,15,4707,2131,2576
50,6,25,California,Imperial County,6,16,3773,1712,2061
50,6,25,California,Imperial County,6,17,2810,1238,1572
50,6,25,California,Imperial County,6,18,2529,1028,1501
50,6,25,California,Imperial County,7,0,177786,90798,86988
50,6,25,California,Imperial County,7,1,14971,7702,7269
50,6,25,California,Imperial County,7,2,13959,7041,6918
50,6,25,California,Imperial County,7,3,13914,7095,6819
50,6,25,California,Imperial County,7,4,13911,7276,6635
50,6,25,California,Imperial County,7,5,14435,7858,6577
50,6,25,California,Imperial County,7,6,12986,7329,5657
50,6,25,California,Imperial County,7,7,12296,6793,5503
50,6,25,California,Imperial County,7,8,10875,5882,4993
50,6,25,California,Imperial County,7,9,10560,5407,5153
50,6,25,California,Imperial County,7,10,10629,5359,5270
50,6,25,California,Imperial County,7,11,10543,5206,5337
50,6,25,California,Imperial County,7,12,9950,4745,5205
50,6,25,California,Imperial County,7,13,8102,3828,4274
50,6,25,California,Imperial County,7,14,6494,3090,3404
50,6,25,California,Imperial County,7,15,4810,2131,2679
50,6,25,California,Imperial County,7,16,3836,1730,2106
50,6,25,California,Imperial County,7,17,2847,1239,1608
50,6,25,California,Imperial County,7,18,2668,1087,1581
50,6,25,California,Imperial County,8,0,178701,91313,87388
50,6,25,California,Imperial County,8,1,15402,7870,7532
50,6,25,California,Imperial County,8,2,13857,7028,6829
50,6,25,California,Imperial County,8,3,13841,7004,6837
50,6,25,California,Imperial County,8,4,13864,7261,6603
50,6,25,California,Imperial County,8,5,14042,7627,6415
50,6,25,California,Imperial County,8,6,13444,7597,5847
50,6,25,California,Imperial County,8,7,12326,6852,5474
50,6,25,California,Imperial County,8,8,11077,6075,5002
50,6,25,California,Imperial County,8,9,10374,5287,5087
50,6,25,California,Imperial County,8,10,10568,5398,5170
50,6,25,California,Imperial County,8,11,10338,5062,5276
50,6,25,California,Imperial County,8,12,9885,4767,5118
50,6,25,California,Imperial County,8,13,8372,3926,4446
50,6,25,California,Imperial County,8,14,6768,3228,3540
50,6,25,California,Imperial County,8,15,4964,2204,2760
50,6,25,California,Imperial County,8,16,3841,1705,2136
50,6,25,California,Imperial County,8,17,2889,1260,1629
50,6,25,California,Imperial County,8,18,2849,1162,1687
50,6,25,California,Imperial County,9,0,179881,91928,87953
50,6,25,California,Imperial County,9,1,15384,7789,7595
50,6,25,California,Imperial County,9,2,14241,7239,7002
50,6,25,California,Imperial County,9,3,13896,6979,6917
50,6,25,California,Imperial County,9,4,13819,7220,6599
50,6,25,California,Imperial County,9,5,13741,7458,6283
50,6,25,California,Imperial County,9,6,13787,7786,6001
50,6,25,California,Imperial County,9,7,12511,7031,5480
50,6,25,California,Imperial County,9,8,11337,6198,5139
50,6,25,California,Imperial County,9,9,10272,5282,4990
50,6,25,California,Imperial County,9,10,10414,5281,5133
50,6,25,California,Imperial County,9,11,10179,5035,5144
50,6,25,California,Imperial County,9,12,9784,4736,5048
50,6,25,California,Imperial County,9,13,8621,4051,4570
50,6,25,California,Imperial County,9,14,7034,3350,3684
50,6,25,California,Imperial County,9,15,5097,2291,2806
50,6,25,California,Imperial County,9,16,3883,1693,2190
50,6,25,California,Imperial County,9,17,2973,1318,1655
50,6,25,California,Imperial County,9,18,2908,1191,1717
50,6,25,California,Imperial County,10,0,181250,93027,88223
50,6,25,California,Imperial County,10,1,15223,7705,7518
50,6,25,California,Imperial County,10,2,14536,7433,7103
50,6,25,California,Imperial County,10,3,13972,6973,6999
50,6,25,California,Imperial County,10,4,13570,7073,6497
50,6,25,California,Imperial County,10,5,13550,7465,6085
50,6,25,California,Imperial County,10,6,14255,8100,6155
50,6,25,California,Imperial County,10,7,12669,7147,5522
50,6,25,California,Imperial County,10,8,11648,6396,5252
50,6,25,California,Imperial County,10,9,10326,5425,4901
50,6,25,California,Imperial County,10,10,10287,5235,5052
50,6,25,California,Imperial County,10,11,10008,4976,5032
50,6,25,California,Imperial County,10,12,9757,4737,5020
50,6,25,California,Imperial County,10,13,8835,4148,4687
50,6,25,California,Imperial County,10,14,7144,3431,3713
50,6,25,California,Imperial County,10,15,5436,2440,2996
50,6,25,California,Imperial County,10,16,4000,1755,2245
50,6,25,California,Imperial County,10,17,3005,1348,1657
50,6,25,California,Imperial County,10,18,3029,1240,1789
50,6,25,California,Imperial County,11,0,181062,92833,88229
50,6,25,California,Imperial County,11,1,14905,7527,7378
50,6,25,California,Imperial County,11,2,14687,7582,7105
50,6,25,California,Imperial County,11,3,14004,6954,7050
50,6,25,California,Imperial County,11,4,13601,7028,6573
50,6,25,California,Imperial County,11,5,13116,7189,5927
50,6,25,California,Imperial County,11,6,14262,8047,6215
50,6,25,California,Imperial County,11,7,12660,7204,5456
50,6,25,California,Imperial County,11,8,11935,6499,5436
50,6,25,California,Imperial County,11,9,10154,5391,4763
50,6,25,California,Imperial County,11,10,10036,5082,4954
50,6,25,California,Imperial County,11,11,9856,4900,4956
50,6,25,California,Imperial County,11,12,9686,4703,4983
50,6,25,California,Imperial County,11,13,8941,4232,4709
50,6,25,California,Imperial County,11,14,7222,3412,3810
50,6,25,California,Imperial County,11,15,5726,2635,3091
50,6,25,California,Imperial County,11,16,4146,1851,2295
50,6,25,California,Imperial County,11,17,3020,1332,1688
50,6,25,California,Imperial County,11,18,3105,1265,1840
50,6,25,California,Imperial County,12,0,180439,92436,88003
50,6,25,California,Imperial County,12,1,14354,7180,7174
50,6,25,California,Imperial County,12,2,14854,7640,7214
50,6,25,California,Imperial County,12,3,14027,7027,7000
50,6,25,California,Imperial County,12,4,13415,6890,6525
50,6,25,California,Imperial County,12,5,12841,7053,5788
50,6,25,California,Imperial County,12,6,13994,7853,6141
50,6,25,California,Imperial County,12,7,12885,7337,5548
50,6,25,California,Imperial County,12,8,11958,6527,5431
50,6,25,California,Imperial County,12,9,10207,5473,4734
50,6,25,California,Imperial County,12,10,9780,4954,4826
50,6,25,California,Imperial County,12,11,9730,4847,4883
50,6,25,California,Imperial County,12,12,9575,4627,4948
50,6,25,California,Imperial County,12,13,8942,4262,4680
50,6,25,California,Imperial County,12,14,7388,3456,3932
50,6,25,California,Imperial County,12,15,5994,2830,3164
50,6,25,California,Imperial County,12,16,4184,1814,2370
50,6,25,California,Imperial County,12,17,3126,1367,1759
50,6,25,California,Imperial County,12,18,3185,1299,1886
50,6,25,California,Imperial County,13,0,180476,92361,88115
50,6,25,California,Imperial County,13,1,13900,6994,6906
50,6,25,California,Imperial County,13,2,15177,7738,7439
50,6,25,California,Imperial County,13,3,14019,7053,6966
50,6,25,California,Imperial County,13,4,13422,6864,6558
50,6,25,California,Imperial County,13,5,12711,7002,5709
50,6,25,California,Imperial County,13,6,13761,7654,6107
50,6,25,California,Imperial County,13,7,13097,7454,5643
50,6,25,California,Imperial County,13,8,11970,6527,5443
50,6,25,California,Imperial County,13,9,10308,5569,4739
50,6,25,California,Imperial County,13,10,9579,4830,4749
50,6,25,California,Imperial County,13,11,9717,4856,4861
50,6,25,California,Imperial County,13,12,9396,4528,4868
50,6,25,California,Imperial County,13,13,8983,4332,4651
50,6,25,California,Imperial County,13,14,7559,3506,4053
50,6,25,California,Imperial County,13,15,6174,2891,3283
50,6,25,California,Imperial County,13,16,4289,1875,2414
50,6,25,California,Imperial County,13,17,3131,1355,1776
50,6,25,California,Imperial County,13,18,3283,1333,1950
50,6,25,California,Imperial County,14,0,180267,92224,88043
50,6,25,California,Imperial County,14,1,13747,6927,6820
50,6,25,California,Imperial County,14,2,15260,7761,7499
50,6,25,California,Imperial County,14,3,13995,7051,6944
50,6,25,California,Imperial County,14,4,13406,6845,6561
50,6,25,California,Imperial County,14,5,12645,6974,5671
50,6,25,California,Imperial County,14,6,13650,7572,6078
50,6,25,California,Imperial County,14,7,13159,7489,5670
50,6,25,California,Imperial County,14,8,11979,6531,5448
50,6,25,California,Imperial County,14,9,10344,5600,4744
50,6,25,California,Imperial County,14,10,9517,4793,4724
50,6,25,California,Imperial County,14,11,9716,4858,4858
50,6,25,California,Imperial County,14,12,9324,4491,4833
50,6,25,California,Imperial County,14,13,8979,4341,4638
50,6,25,California,Imperial County,14,14,7599,3517,4082
50,6,25,California,Imperial County,14,15,6219,2903,3316
50,6,25,California,Imperial County,14,16,4310,1887,2423
50,6,25,California,Imperial County,14,17,3128,1350,1778
50,6,25,California,Imperial County,14,18,3290,1334,1956
50,6,27,California,Inyo County,1,0,18546,9354,9192
50,6,27,California,Inyo County,1,1,1070,560,510
50,6,27,California,Inyo County,1,2,985,529,456
50,6,27,California,Inyo County,1,3,1134,580,554
50,6,27,California,Inyo County,1,4,1087,549,538
50,6,27,California,Inyo County,1,5,865,465,400
50,6,27,California,Inyo County,1,6,1041,519,522
50,6,27,California,Inyo County,1,7,979,522,457
50,6,27,California,Inyo County,1,8,977,506,471
50,6,27,California,Inyo County,1,9,992,494,498
50,6,27,California,Inyo County,1,10,1367,673,694
50,6,27,California,Inyo County,1,11,1594,821,773
50,6,27,California,Inyo County,1,12,1581,810,771
50,6,27,California,Inyo County,1,13,1339,678,661
50,6,27,California,Inyo County,1,14,1035,527,508
50,6,27,California,Inyo County,1,15,783,396,387
50,6,27,California,Inyo County,1,16,676,315,361
50,6,27,California,Inyo County,1,17,520,216,304
50,6,27,California,Inyo County,1,18,521,194,327
50,6,27,California,Inyo County,2,0,18533,9346,9187
50,6,27,California,Inyo County,2,1,1070,560,510
50,6,27,California,Inyo County,2,2,984,529,455
50,6,27,California,Inyo County,2,3,1133,579,554
50,6,27,California,Inyo County,2,4,1085,548,537
50,6,27,California,Inyo County,2,5,863,464,399
50,6,27,California,Inyo County,2,6,1040,518,522
50,6,27,California,Inyo County,2,7,977,521,456
50,6,27,California,Inyo County,2,8,977,506,471
50,6,27,California,Inyo County,2,9,991,494,497
50,6,27,California,Inyo County,2,10,1366,672,694
50,6,27,California,Inyo County,2,11,1594,821,773
50,6,27,California,Inyo County,2,12,1580,809,771
50,6,27,California,Inyo County,2,13,1339,678,661
50,6,27,California,Inyo County,2,14,1035,527,508
50,6,27,California,Inyo County,2,15,782,395,387
50,6,27,California,Inyo County,2,16,676,315,361
50,6,27,California,Inyo County,2,17,520,216,304
50,6,27,California,Inyo County,2,18,521,194,327
50,6,27,California,Inyo County,3,0,18503,9335,9168
50,6,27,California,Inyo County,3,1,1061,556,505
50,6,27,California,Inyo County,3,2,990,531,459
50,6,27,California,Inyo County,3,3,1115,572,543
50,6,27,California,Inyo County,3,4,1094,557,537
50,6,27,California,Inyo County,3,5,861,462,399
50,6,27,California,Inyo County,3,6,1030,513,517
50,6,27,California,Inyo County,3,7,985,525,460
50,6,27,California,Inyo County,3,8,960,496,464
50,6,27,California,Inyo County,3,9,995,502,493
50,6,27,California,Inyo County,3,10,1340,656,684
50,6,27,California,Inyo County,3,11,1586,814,772
50,6,27,California,Inyo County,3,12,1576,803,773
50,6,27,California,Inyo County,3,13,1361,692,669
50,6,27,California,Inyo County,3,14,1039,528,511
50,6,27,California,Inyo County,3,15,786,398,388
50,6,27,California,Inyo County,3,16,675,317,358
50,6,27,California,Inyo County,3,17,519,216,303
50,6,27,California,Inyo County,3,18,530,197,333
50,6,27,California,Inyo County,4,0,18385,9261,9124
50,6,27,California,Inyo County,4,1,1042,532,510
50,6,27,California,Inyo County,4,2,1014,534,480
50,6,27,California,Inyo County,4,3,1060,546,514
50,6,27,California,Inyo County,4,4,1132,585,547
50,6,27,California,Inyo County,4,5,869,464,405
50,6,27,California,Inyo County,4,6,1001,505,496
50,6,27,California,Inyo County,4,7,1014,536,478
50,6,27,California,Inyo County,4,8,911,475,436
50,6,27,California,Inyo County,4,9,1021,511,510
50,6,27,California,Inyo County,4,10,1236,620,616
50,6,27,California,Inyo County,4,11,1533,776,757
50,6,27,California,Inyo County,4,12,1582,781,801
50,6,27,California,Inyo County,4,13,1408,723,685
50,6,27,California,Inyo County,4,14,1055,533,522
50,6,27,California,Inyo County,4,15,787,404,383
50,6,27,California,Inyo County,4,16,665,317,348
50,6,27,California,Inyo County,4,17,502,218,284
50,6,27,California,Inyo County,4,18,553,201,352
50,6,27,California,Inyo County,5,0,18344,9220,9124
50,6,27,California,Inyo County,5,1,1065,541,524
50,6,27,California,Inyo County,5,2,1015,529,486
50,6,27,California,Inyo County,5,3,1033,541,492
50,6,27,California,Inyo County,5,4,1121,583,538
50,6,27,California,Inyo County,5,5,886,459,427
50,6,27,California,Inyo County,5,6,973,495,478
50,6,27,California,Inyo County,5,7,1050,545,505
50,6,27,California,Inyo County,5,8,939,497,442
50,6,27,California,Inyo County,5,9,1021,511,510
50,6,27,California,Inyo County,5,10,1108,550,558
50,6,27,California,Inyo County,5,11,1513,743,770
50,6,27,California,Inyo County,5,12,1589,786,803
50,6,27,California,Inyo County,5,13,1390,712,678
50,6,27,California,Inyo County,5,14,1113,571,542
50,6,27,California,Inyo County,5,15,803,406,397
50,6,27,California,Inyo County,5,16,656,318,338
50,6,27,California,Inyo County,5,17,498,224,274
50,6,27,California,Inyo County,5,18,571,209,362
50,6,27,California,Inyo County,6,0,18348,9198,9150
50,6,27,California,Inyo County,6,1,1088,557,531
50,6,27,California,Inyo County,6,2,1044,541,503
50,6,27,California,Inyo County,6,3,1030,546,484
50,6,27,California,Inyo County,6,4,1091,548,543
50,6,27,California,Inyo County,6,5,899,447,452
50,6,27,California,Inyo County,6,6,922,481,441
50,6,27,California,Inyo County,6,7,1085,564,521
50,6,27,California,Inyo County,6,8,957,507,450
50,6,27,California,Inyo County,6,9,969,490,479
50,6,27,California,Inyo County,6,10,1028,490,538
50,6,27,California,Inyo County,6,11,1474,741,733
50,6,27,California,Inyo County,6,12,1616,801,815
50,6,27,California,Inyo County,6,13,1408,712,696
50,6,27,California,Inyo County,6,14,1141,592,549
50,6,27,California,Inyo County,6,15,847,422,425
50,6,27,California,Inyo County,6,16,651,313,338
50,6,27,California,Inyo County,6,17,524,240,284
50,6,27,California,Inyo County,6,18,574,206,368
50,6,27,California,Inyo County,7,0,18280,9165,9115
50,6,27,California,Inyo County,7,1,1090,556,534
50,6,27,California,Inyo County,7,2,1055,538,517
50,6,27,California,Inyo County,7,3,990,524,466
50,6,27,California,Inyo County,7,4,1066,538,528
50,6,27,California,Inyo County,7,5,875,436,439
50,6,27,California,Inyo County,7,6,923,486,437
50,6,27,California,Inyo County,7,7,1080,559,521
50,6,27,California,Inyo County,7,8,995,525,470
50,6,27,California,Inyo County,7,9,948,480,468
50,6,27,California,Inyo County,7,10,1002,492,510
50,6,27,California,Inyo County,7,11,1394,697,697
50,6,27,California,Inyo County,7,12,1594,796,798
50,6,27,California,Inyo County,7,13,1433,721,712
50,6,27,California,Inyo County,7,14,1180,605,575
50,6,27,California,Inyo County,7,15,891,441,450
50,6,27,California,Inyo County,7,16,667,316,351
50,6,27,California,Inyo County,7,17,523,249,274
50,6,27,California,Inyo County,7,18,574,206,368
50,6,27,California,Inyo County,8,0,18097,9061,9036
50,6,27,California,Inyo County,8,1,1068,538,530
50,6,27,California,Inyo County,8,2,1069,549,520
50,6,27,California,Inyo County,8,3,959,513,446
50,6,27,California,Inyo County,8,4,1052,547,505
50,6,27,California,Inyo County,8,5,845,410,435
50,6,27,California,Inyo County,8,6,882,460,422
50,6,27,California,Inyo County,8,7,1082,550,532
50,6,27,California,Inyo County,8,8,987,534,453
50,6,27,California,Inyo County,8,9,924,462,462
50,6,27,California,Inyo County,8,10,976,484,492
50,6,27,California,Inyo County,8,11,1284,631,653
50,6,27,California,Inyo County,8,12,1557,787,770
50,6,27,California,Inyo County,8,13,1474,724,750
50,6,27,California,Inyo County,8,14,1239,622,617
50,6,27,California,Inyo County,8,15,913,458,455
50,6,27,California,Inyo County,8,16,675,328,347
50,6,27,California,Inyo County,8,17,547,251,296
50,6,27,California,Inyo County,8,18,564,213,351
50,6,27,California,Inyo County,9,0,17897,8988,8909
50,6,27,California,Inyo County,9,1,1055,539,516
50,6,27,California,Inyo County,9,2,1032,538,494
50,6,27,California,Inyo County,9,3,971,508,463
50,6,27,California,Inyo County,9,4,988,524,464
50,6,27,California,Inyo County,9,5,842,435,407
50,6,27,California,Inyo County,9,6,882,458,424
50,6,27,California,Inyo County,9,7,1075,548,527
50,6,27,California,Inyo County,9,8,1001,531,470
50,6,27,California,Inyo County,9,9,905,465,440
50,6,27,California,Inyo County,9,10,949,465,484
50,6,27,California,Inyo County,9,11,1170,577,593
50,6,27,California,Inyo County,9,12,1507,752,755
50,6,27,California,Inyo County,9,13,1520,740,780
50,6,27,California,Inyo County,9,14,1270,648,622
50,6,27,California,Inyo County,9,15,908,446,462
50,6,27,California,Inyo County,9,16,696,336,360
50,6,27,California,Inyo County,9,17,530,248,282
50,6,27,California,Inyo County,9,18,596,230,366
50,6,27,California,Inyo County,10,0,17819,8985,8834
50,6,27,California,Inyo County,10,1,1025,526,499
50,6,27,California,Inyo County,10,2,1043,553,490
50,6,27,California,Inyo County,10,3,995,504,491
50,6,27,California,Inyo County,10,4,941,507,434
50,6,27,California,Inyo County,10,5,847,444,403
50,6,27,California,Inyo County,10,6,890,449,441
50,6,27,California,Inyo County,10,7,1054,545,509
50,6,27,California,Inyo County,10,8,1037,551,486
50,6,27,California,Inyo County,10,9,914,484,430
50,6,27,California,Inyo County,10,10,993,494,499
50,6,27,California,Inyo County,10,11,1047,516,531
50,6,27,California,Inyo County,10,12,1510,731,779
50,6,27,California,Inyo County,10,13,1476,721,755
50,6,27,California,Inyo County,10,14,1270,657,613
50,6,27,California,Inyo County,10,15,978,491,487
50,6,27,California,Inyo County,10,16,682,325,357
50,6,27,California,Inyo County,10,17,514,243,271
50,6,27,California,Inyo County,10,18,603,244,359
50,6,27,California,Inyo County,11,0,17894,9002,8892
50,6,27,California,Inyo County,11,1,1024,492,532
50,6,27,California,Inyo County,11,2,1074,568,506
50,6,27,California,Inyo County,11,3,1016,520,496
50,6,27,California,Inyo County,11,4,931,501,430
50,6,27,California,Inyo County,11,5,823,425,398
50,6,27,California,Inyo County,11,6,895,440,455
50,6,27,California,Inyo County,11,7,1057,550,507
50,6,27,California,Inyo County,11,8,1109,584,525
50,6,27,California,Inyo County,11,9,907,476,431
50,6,27,California,Inyo County,11,10,961,488,473
50,6,27,California,Inyo County,11,11,987,470,517
50,6,27,California,Inyo County,11,12,1458,727,731
50,6,27,California,Inyo County,11,13,1508,739,769
50,6,27,California,Inyo County,11,14,1288,663,625
50,6,27,California,Inyo County,11,15,1000,517,483
50,6,27,California,Inyo County,11,16,722,337,385
50,6,27,California,Inyo County,11,17,529,252,277
50,6,27,California,Inyo County,11,18,605,253,352
50,6,27,California,Inyo County,12,0,17993,9039,8954
50,6,27,California,Inyo County,12,1,985,478,507
50,6,27,California,Inyo County,12,2,1093,555,538
50,6,27,California,Inyo County,12,3,1051,550,501
50,6,27,California,Inyo County,12,4,918,487,431
50,6,27,California,Inyo County,12,5,808,394,414
50,6,27,California,Inyo County,12,6,928,450,478
50,6,27,California,Inyo County,12,7,1019,528,491
50,6,27,California,Inyo County,12,8,1199,645,554
50,6,27,California,Inyo County,12,9,957,508,449
50,6,27,California,Inyo County,12,10,935,471,464
50,6,27,California,Inyo County,12,11,960,475,485
50,6,27,California,Inyo County,12,12,1347,663,684
50,6,27,California,Inyo County,12,13,1534,763,771
50,6,27,California,Inyo County,12,14,1316,669,647
50,6,27,California,Inyo County,12,15,1026,522,504
50,6,27,California,Inyo County,12,16,768,368,400
50,6,27,California,Inyo County,12,17,534,245,289
50,6,27,California,Inyo County,12,18,615,268,347
50,6,27,California,Inyo County,13,0,18062,9043,9019
50,6,27,California,Inyo County,13,1,978,473,505
50,6,27,California,Inyo County,13,2,1088,541,547
50,6,27,California,Inyo County,13,3,1065,551,514
50,6,27,California,Inyo County,13,4,920,496,424
50,6,27,California,Inyo County,13,5,791,387,404
50,6,27,California,Inyo County,13,6,941,454,487
50,6,27,California,Inyo County,13,7,1019,537,482
50,6,27,California,Inyo County,13,8,1225,635,590
50,6,27,California,Inyo County,13,9,1004,553,451
50,6,27,California,Inyo County,13,10,944,478,466
50,6,27,California,Inyo County,13,11,956,475,481
50,6,27,California,Inyo County,13,12,1267,604,663
50,6,27,California,Inyo County,13,13,1504,753,751
50,6,27,California,Inyo County,13,14,1362,673,689
50,6,27,California,Inyo County,13,15,1081,544,537
50,6,27,California,Inyo County,13,16,779,380,399
50,6,27,California,Inyo County,13,17,530,254,276
50,6,27,California,Inyo County,13,18,608,255,353
50,6,27,California,Inyo County,14,0,18046,9033,9013
50,6,27,California,Inyo County,14,1,976,473,503
50,6,27,California,Inyo County,14,2,1082,536,546
50,6,27,California,Inyo County,14,3,1071,553,518
50,6,27,California,Inyo County,14,4,925,497,428
50,6,27,California,Inyo County,14,5,780,383,397
50,6,27,California,Inyo County,14,6,940,452,488
50,6,27,California,Inyo County,14,7,1017,540,477
50,6,27,California,Inyo County,14,8,1228,627,601
50,6,27,California,Inyo County,14,9,1013,566,447
50,6,27,California,Inyo County,14,10,949,483,466
50,6,27,California,Inyo County,14,11,954,476,478
50,6,27,California,Inyo County,14,12,1238,582,656
50,6,27,California,Inyo County,14,13,1488,749,739
50,6,27,California,Inyo County,14,14,1377,678,699
50,6,27,California,Inyo County,14,15,1098,552,546
50,6,27,California,Inyo County,14,16,777,380,397
50,6,27,California,Inyo County,14,17,531,257,274
50,6,27,California,Inyo County,14,18,602,249,353
50,6,29,California,Kern County,1,0,839631,433108,406523
50,6,29,California,Kern County,1,1,72885,36952,35933
50,6,29,California,Kern County,1,2,68694,35022,33672
50,6,29,California,Kern County,1,3,68473,34899,33574
50,6,29,California,Kern County,1,4,72493,37862,34631
50,6,29,California,Kern County,1,5,65339,35895,29444
50,6,29,California,Kern County,1,6,63630,34949,28681
50,6,29,California,Kern County,1,7,58416,31585,26831
50,6,29,California,Kern County,1,8,54558,28846,25712
50,6,29,California,Kern County,1,9,53942,28542,25400
50,6,29,California,Kern County,1,10,55879,28993,26886
50,6,29,California,Kern County,1,11,52600,26980,25620
50,6,29,California,Kern County,1,12,43233,21756,21477
50,6,29,California,Kern County,1,13,34052,16807,17245
50,6,29,California,Kern County,1,14,25040,12058,12982
50,6,29,California,Kern County,1,15,18462,8752,9710
50,6,29,California,Kern County,1,16,13555,6076,7479
50,6,29,California,Kern County,1,17,9918,4109,5809
50,6,29,California,Kern County,1,18,8462,3025,5437
50,6,29,California,Kern County,2,0,839619,433102,406517
50,6,29,California,Kern County,2,1,72885,36952,35933
50,6,29,California,Kern County,2,2,68694,35022,33672
50,6,29,California,Kern County,2,3,68471,34898,33573
50,6,29,California,Kern County,2,4,72491,37861,34630
50,6,29,California,Kern County,2,5,65340,35896,29444
50,6,29,California,Kern County,2,6,63630,34949,28681
50,6,29,California,Kern County,2,7,58416,31585,26831
50,6,29,California,Kern County,2,8,54557,28846,25711
50,6,29,California,Kern County,2,9,53941,28541,25400
50,6,29,California,Kern County,2,10,55875,28992,26883
50,6,29,California,Kern County,2,11,52599,26979,25620
50,6,29,California,Kern County,2,12,43235,21757,21478
50,6,29,California,Kern County,2,13,34051,16806,17245
50,6,29,California,Kern County,2,14,25038,12057,12981
50,6,29,California,Kern County,2,15,18461,8751,9710
50,6,29,California,Kern County,2,16,13555,6076,7479
50,6,29,California,Kern County,2,17,9918,4109,5809
50,6,29,California,Kern County,2,18,8462,3025,5437
50,6,29,California,Kern County,3,0,841365,433817,407548
50,6,29,California,Kern County,3,1,72900,36969,35931
50,6,29,California,Kern County,3,2,68845,35061,33784
50,6,29,California,Kern County,3,3,68466,34898,33568
50,6,29,California,Kern County,3,4,71938,37591,34347
50,6,29,California,Kern County,3,5,65918,36123,29795
50,6,29,California,Kern County,3,6,63831,35071,28760
50,6,29,California,Kern County,3,7,58660,31709,26951
50,6,29,California,Kern County,3,8,54571,28827,25744
50,6,29,California,Kern County,3,9,53907,28467,25440
50,6,29,California,Kern County,3,10,55673,28898,26775
50,6,29,California,Kern County,3,11,52792,27045,25747
50,6,29,California,Kern County,3,12,43667,22003,21664
50,6,29,California,Kern County,3,13,34395,16944,17451
50,6,29,California,Kern County,3,14,25147,12106,13041
50,6,29,California,Kern County,3,15,18592,8823,9769
50,6,29,California,Kern County,3,16,13614,6120,7494
50,6,29,California,Kern County,3,17,9904,4109,5795
50,6,29,California,Kern County,3,18,8545,3053,5492
50,6,29,California,Kern County,4,0,848651,437040,411611
50,6,29,California,Kern County,4,1,72980,36952,36028
50,6,29,California,Kern County,4,2,69643,35370,34273
50,6,29,California,Kern County,4,3,68384,34830,33554
50,6,29,California,Kern County,4,4,69890,36529,33361
50,6,29,California,Kern County,4,5,68407,37292,31115
50,6,29,California,Kern County,4,6,64862,35649,29213
50,6,29,California,Kern County,4,7,59702,32233,27469
50,6,29,California,Kern County,4,8,54519,28795,25724
50,6,29,California,Kern County,4,9,53789,28249,25540
50,6,29,California,Kern County,4,10,54457,28323,26134
50,6,29,California,Kern County,4,11,53354,27238,26116
50,6,29,California,Kern County,4,12,45174,22839,22335
50,6,29,California,Kern County,4,13,35941,17594,18347
50,6,29,California,Kern County,4,14,25747,12398,13349
50,6,29,California,Kern County,4,15,19252,9184,10068
50,6,29,California,Kern County,4,16,13879,6291,7588
50,6,29,California,Kern County,4,17,9805,4068,5737
50,6,29,California,Kern County,4,18,8866,3206,5660
50,6,29,California,Kern County,5,0,854392,438075,416317
50,6,29,California,Kern County,5,1,72857,36867,35990
50,6,29,California,Kern County,5,2,71416,36192,35224
50,6,29,California,Kern County,5,3,68383,34803,33580
50,6,29,California,Kern County,5,4,68376,35552,32824
50,6,29,California,Kern County,5,5,69867,37758,32109
50,6,29,California,Kern County,5,6,65125,35556,29569
50,6,29,California,Kern County,5,7,60375,32435,27940
50,6,29,California,Kern County,5,8,54343,28535,25808
50,6,29,California,Kern County,5,9,53180,27658,25522
50,6,29,California,Kern County,5,10,53213,27514,25699
50,6,29,California,Kern County,5,11,53489,27179,26310
50,6,29,California,Kern County,5,12,46603,23519,23084
50,6,29,California,Kern County,5,13,36367,17843,18524
50,6,29,California,Kern County,5,14,27669,13224,14445
50,6,29,California,Kern County,5,15,19961,9531,10430
50,6,29,California,Kern County,5,16,14161,6472,7689
50,6,29,California,Kern County,5,17,9914,4133,5781
50,6,29,California,Kern County,5,18,9093,3304,5789
50,6,29,California,Kern County,6,0,862727,441942,420785
50,6,29,California,Kern County,6,1,72870,36876,35994
50,6,29,California,Kern County,6,2,73170,37068,36102
50,6,29,California,Kern County,6,3,68771,35002,33769
50,6,29,California,Kern County,6,4,67272,34869,32403
50,6,29,California,Kern County,6,5,70891,38166,32725
50,6,29,California,Kern County,6,6,66193,36084,30109
50,6,29,California,Kern County,6,7,61815,33157,28658
50,6,29,California,Kern County,6,8,54717,28782,25935
50,6,29,California,Kern County,6,9,53032,27512,25520
50,6,29,California,Kern County,6,10,52076,26881,25195
50,6,29,California,Kern County,6,11,53559,27043,26516
50,6,29,California,Kern County,6,12,47582,24108,23474
50,6,29,California,Kern County,6,13,37315,18479,18836
50,6,29,California,Kern County,6,14,28643,13636,15007
50,6,29,California,Kern County,6,15,21004,9973,11031
50,6,29,California,Kern County,6,16,14544,6694,7850
50,6,29,California,Kern County,6,17,10049,4260,5789
50,6,29,California,Kern County,6,18,9224,3352,5872
50,6,29,California,Kern County,7,0,869837,446136,423701
50,6,29,California,Kern County,7,1,72399,36786,35613
50,6,29,California,Kern County,7,2,73887,37505,36382
50,6,29,California,Kern County,7,3,69213,35167,34046
50,6,29,California,Kern County,7,4,66435,34401,32034
50,6,29,California,Kern County,7,5,71289,38477,32812
50,6,29,California,Kern County,7,6,67605,36692,30913
50,6,29,California,Kern County,7,7,63078,34123,28955
50,6,29,California,Kern County,7,8,55534,29343,26191
50,6,29,California,Kern County,7,9,52713,27385,25328
50,6,29,California,Kern County,7,10,51255,26522,24733
50,6,29,California,Kern County,7,11,53132,26755,26377
50,6,29,California,Kern County,7,12,48553,24594,23959
50,6,29,California,Kern County,7,13,38714,19156,19558
50,6,29,California,Kern County,7,14,29728,14236,15492
50,6,29,California,Kern County,7,15,21792,10319,11473
50,6,29,California,Kern County,7,16,15029,6939,8090
50,6,29,California,Kern County,7,17,10053,4259,5794
50,6,29,California,Kern County,7,18,9428,3477,5951
50,6,29,California,Kern County,8,0,876548,449812,426736
50,6,29,California,Kern County,8,1,71919,36686,35233
50,6,29,California,Kern County,8,2,74407,37653,36754
50,6,29,California,Kern County,8,3,69652,35378,34274
50,6,29,California,Kern County,8,4,65978,34135,31843
50,6,29,California,Kern County,8,5,70755,38136,32619
50,6,29,California,Kern County,8,6,69417,37749,31668
50,6,29,California,Kern County,8,7,64027,34629,29398
50,6,29,California,Kern County,8,8,56573,30020,26553
50,6,29,California,Kern County,8,9,52454,27265,25189
50,6,29,California,Kern County,8,10,51170,26491,24679
50,6,29,California,Kern County,8,11,52026,26226,25800
50,6,29,California,Kern County,8,12,49456,24991,24465
50,6,29,California,Kern County,8,13,40095,19778,20317
50,6,29,California,Kern County,8,14,30972,14936,16036
50,6,29,California,Kern County,8,15,22245,10500,11745
50,6,29,California,Kern County,8,16,15596,7269,8327
50,6,29,California,Kern County,8,17,10201,4382,5819
50,6,29,California,Kern County,8,18,9605,3588,6017
50,6,29,California,Kern County,9,0,881094,451913,429181
50,6,29,California,Kern County,9,1,71036,36297,34739
50,6,29,California,Kern County,9,2,74351,37639,36712
50,6,29,California,Kern County,9,3,70511,35686,34825
50,6,29,California,Kern County,9,4,65942,34134,31808
50,6,29,California,Kern County,9,5,68537,36928,31609
50,6,29,California,Kern County,9,6,71392,38635,32757
50,6,29,California,Kern County,9,7,64635,34979,29656
50,6,29,California,Kern County,9,8,57648,30637,27011
50,6,29,California,Kern County,9,9,52234,27242,24992
50,6,29,California,Kern County,9,10,51002,26313,24689
50,6,29,California,Kern County,9,11,50830,25662,25168
50,6,29,California,Kern County,9,12,50078,25185,24893
50,6,29,California,Kern County,9,13,41271,20516,20755
50,6,29,California,Kern County,9,14,32383,15493,16890
50,6,29,California,Kern County,9,15,22902,10791,12111
50,6,29,California,Kern County,9,16,16167,7567,8600
50,6,29,California,Kern County,9,17,10450,4562,5888
50,6,29,California,Kern County,9,18,9725,3647,6078
50,6,29,California,Kern County,10,0,887316,455065,432251
50,6,29,California,Kern County,10,1,70500,36066,34434
50,6,29,California,Kern County,10,2,74226,37646,36580
50,6,29,California,Kern County,10,3,72005,36402,35603
50,6,29,California,Kern County,10,4,65781,33974,31807
50,6,29,California,Kern County,10,5,66960,36050,30910
50,6,29,California,Kern County,10,6,72819,39347,33472
50,6,29,California,Kern County,10,7,65261,35363,29898
50,6,29,California,Kern County,10,8,59107,31454,27653
50,6,29,California,Kern County,10,9,52677,27692,24985
50,6,29,California,Kern County,10,10,50798,26113,24685
50,6,29,California,Kern County,10,11,49783,25166,24617
50,6,29,California,Kern County,10,12,50160,25131,25029
50,6,29,California,Kern County,10,13,42660,21242,21418
50,6,29,California,Kern County,10,14,32672,15714,16958
50,6,29,California,Kern County,10,15,24479,11450,13029
50,6,29,California,Kern County,10,16,16803,7796,9007
50,6,29,California,Kern County,10,17,10590,4664,5926
50,6,29,California,Kern County,10,18,10035,3795,6240
50,6,29,California,Kern County,11,0,893618,458195,435423
50,6,29,California,Kern County,11,1,69179,35401,33778
50,6,29,California,Kern County,11,2,74016,37578,36438
50,6,29,California,Kern County,11,3,73591,37290,36301
50,6,29,California,Kern County,11,4,66399,34252,32147
50,6,29,California,Kern County,11,5,65647,35308,30339
50,6,29,California,Kern County,11,6,73540,39789,33751
50,6,29,California,Kern County,11,7,66025,35726,30299
50,6,29,California,Kern County,11,8,60802,32315,28487
50,6,29,California,Kern County,11,9,53135,28035,25100
50,6,29,California,Kern County,11,10,50808,26064,24744
50,6,29,California,Kern County,11,11,48833,24722,24111
50,6,29,California,Kern County,11,12,49978,24850,25128
50,6,29,California,Kern County,11,13,43792,21890,21902
50,6,29,California,Kern County,11,14,33754,16350,17404
50,6,29,California,Kern County,11,15,25314,11790,13524
50,6,29,California,Kern County,11,16,17662,8152,9510
50,6,29,California,Kern County,11,17,10915,4836,6079
50,6,29,California,Kern County,11,18,10228,3847,6381
50,6,29,California,Kern County,12,0,898898,460537,438361
50,6,29,California,Kern County,12,1,68062,34790,33272
50,6,29,California,Kern County,12,2,74147,37802,36345
50,6,29,California,Kern County,12,3,74361,37736,36625
50,6,29,California,Kern County,12,4,67002,34480,32522
50,6,29,California,Kern County,12,5,64650,34699,29951
50,6,29,California,Kern County,12,6,73826,39939,33887
50,6,29,California,Kern County,12,7,66864,35981,30883
50,6,29,California,Kern County,12,8,61837,32821,29016
50,6,29,California,Kern County,12,9,54087,28544,25543
50,6,29,California,Kern County,12,10,50448,25952,24496
50,6,29,California,Kern County,12,11,48123,24356,23767
50,6,29,California,Kern County,12,12,49678,24592,25086
50,6,29,California,Kern County,12,13,44543,22276,22267
50,6,29,California,Kern County,12,14,34952,16914,18038
50,6,29,California,Kern County,12,15,26354,12345,14009
50,6,29,California,Kern County,12,16,18242,8382,9860
50,6,29,California,Kern County,12,17,11344,5022,6322
50,6,29,California,Kern County,12,18,10378,3906,6472
50,6,29,California,Kern County,13,0,901373,460909,440464
50,6,29,California,Kern County,13,1,67219,34371,32848
50,6,29,California,Kern County,13,2,73982,37708,36274
50,6,29,California,Kern County,13,3,74928,37948,36980
50,6,29,California,Kern County,13,4,67318,34637,32681
50,6,29,California,Kern County,13,5,63983,34342,29641
50,6,29,California,Kern County,13,6,73025,39187,33838
50,6,29,California,Kern County,13,7,67932,36429,31503
50,6,29,California,Kern County,13,8,62253,32982,29271
50,6,29,California,Kern County,13,9,54804,28893,25911
50,6,29,California,Kern County,13,10,50170,25730,24440
50,6,29,California,Kern County,13,11,47997,24237,23760
50,6,29,California,Kern County,13,12,48846,24204,24642
50,6,29,California,Kern County,13,13,45219,22518,22701
50,6,29,California,Kern County,13,14,35816,17365,18451
50,6,29,California,Kern County,13,15,27176,12742,14434
50,6,29,California,Kern County,13,16,18608,8500,10108
50,6,29,California,Kern County,13,17,11611,5158,6453
50,6,29,California,Kern County,13,18,10486,3958,6528
50,6,29,California,Kern County,14,0,901362,460613,440749
50,6,29,California,Kern County,14,1,66922,34216,32706
50,6,29,California,Kern County,14,2,73820,37626,36194
50,6,29,California,Kern County,14,3,75040,37984,37056
50,6,29,California,Kern County,14,4,67351,34649,32702
50,6,29,California,Kern County,14,5,63665,34171,29494
50,6,29,California,Kern County,14,6,72641,38885,33756
50,6,29,California,Kern County,14,7,68278,36567,31711
50,6,29,California,Kern County,14,8,62418,33060,29358
50,6,29,California,Kern County,14,9,55018,28999,26019
50,6,29,California,Kern County,14,10,50080,25659,24421
50,6,29,California,Kern County,14,11,48000,24217,23783
50,6,29,California,Kern County,14,12,48518,24057,24461
50,6,29,California,Kern County,14,13,45381,22555,22826
50,6,29,California,Kern County,14,14,36076,17498,18578
50,6,29,California,Kern County,14,15,27371,12832,14539
50,6,29,California,Kern County,14,16,18666,8505,10161
50,6,29,California,Kern County,14,17,11675,5191,6484
50,6,29,California,Kern County,14,18,10442,3942,6500
50,6,31,California,Kings County,1,0,152982,86344,66638
50,6,31,California,Kings County,1,1,12877,6543,6334
50,6,31,California,Kings County,1,2,11564,5904,5660
50,6,31,California,Kings County,1,3,11324,5749,5575
50,6,31,California,Kings County,1,4,11356,5947,5409
50,6,31,California,Kings County,1,5,13158,7927,5231
50,6,31,California,Kings County,1,6,13424,8282,5142
50,6,31,California,Kings County,1,7,12165,7435,4730
50,6,31,California,Kings County,1,8,11183,6962,4221
50,6,31,California,Kings County,1,9,10695,6699,3996
50,6,31,California,Kings County,1,10,10909,6683,4226
50,6,31,California,Kings County,1,11,9373,5547,3826
50,6,31,California,Kings County,1,12,7321,4194,3127
50,6,31,California,Kings County,1,13,5603,2940,2663
50,6,31,California,Kings County,1,14,3857,1997,1860
50,6,31,California,Kings County,1,15,2987,1412,1575
50,6,31,California,Kings County,1,16,2255,995,1260
50,6,31,California,Kings County,1,17,1554,643,911
50,6,31,California,Kings County,1,18,1377,485,892
50,6,31,California,Kings County,2,0,152990,86350,66640
50,6,31,California,Kings County,2,1,12878,6543,6335
50,6,31,California,Kings County,2,2,11564,5905,5659
50,6,31,California,Kings County,2,3,11323,5748,5575
50,6,31,California,Kings County,2,4,11356,5948,5408
50,6,31,California,Kings County,2,5,13161,7929,5232
50,6,31,California,Kings County,2,6,13426,8284,5142
50,6,31,California,Kings County,2,7,12165,7435,4730
50,6,31,California,Kings County,2,8,11181,6961,4220
50,6,31,California,Kings County,2,9,10695,6699,3996
50,6,31,California,Kings County,2,10,10912,6685,4227
50,6,31,California,Kings County,2,11,9374,5547,3827
50,6,31,California,Kings County,2,12,7322,4194,3128
50,6,31,California,Kings County,2,13,5604,2941,2663
50,6,31,California,Kings County,2,14,3856,1996,1860
50,6,31,California,Kings County,2,15,2987,1412,1575
50,6,31,California,Kings County,2,16,2255,995,1260
50,6,31,California,Kings County,2,17,1554,643,911
50,6,31,California,Kings County,2,18,1377,485,892
50,6,31,California,Kings County,3,0,152342,85678,66664
50,6,31,California,Kings County,3,1,12802,6514,6288
50,6,31,California,Kings County,3,2,11564,5890,5674
50,6,31,California,Kings County,3,3,11298,5730,5568
50,6,31,California,Kings County,3,4,11296,5911,5385
50,6,31,California,Kings County,3,5,13090,7837,5253
50,6,31,California,Kings County,3,6,13367,8208,5159
50,6,31,California,Kings County,3,7,12080,7357,4723
50,6,31,California,Kings County,3,8,11083,6870,4213
50,6,31,California,Kings County,3,9,10597,6614,3983
50,6,31,California,Kings County,3,10,10778,6577,4201
50,6,31,California,Kings County,3,11,9355,5499,3856
50,6,31,California,Kings County,3,12,7321,4176,3145
50,6,31,California,Kings County,3,13,5618,2949,2669
50,6,31,California,Kings County,3,14,3867,1986,1881
50,6,31,California,Kings County,3,15,2988,1415,1573
50,6,31,California,Kings County,3,16,2273,999,1274
50,6,31,California,Kings County,3,17,1572,651,921
50,6,31,California,Kings County,3,18,1393,495,898
50,6,31,California,Kings County,4,0,151779,84995,66784
50,6,31,California,Kings County,4,1,12715,6507,6208
50,6,31,California,Kings County,4,2,11647,5883,5764
50,6,31,California,Kings County,4,3,11188,5714,5474
50,6,31,California,Kings County,4,4,10999,5711,5288
50,6,31,California,Kings County,4,5,13076,7750,5326
50,6,31,California,Kings County,4,6,13311,8136,5175
50,6,31,California,Kings County,4,7,12011,7263,4748
50,6,31,California,Kings County,4,8,10896,6720,4176
50,6,31,California,Kings County,4,9,10423,6505,3918
50,6,31,California,Kings County,4,10,10512,6390,4122
50,6,31,California,Kings County,4,11,9356,5452,3904
50,6,31,California,Kings County,4,12,7444,4241,3203
50,6,31,California,Kings County,4,13,5778,3043,2735
50,6,31,California,Kings County,4,14,4003,2019,1984
50,6,31,California,Kings County,4,15,3035,1436,1599
50,6,31,California,Kings County,4,16,2320,1025,1295
50,6,31,California,Kings County,4,17,1623,674,949
50,6,31,California,Kings County,4,18,1442,526,916
50,6,31,California,Kings County,5,0,150884,84300,66584
50,6,31,California,Kings County,5,1,12185,6233,5952
50,6,31,California,Kings County,5,2,11745,5949,5796
50,6,31,California,Kings County,5,3,11039,5604,5435
50,6,31,California,Kings County,5,4,10725,5560,5165
50,6,31,California,Kings County,5,5,13120,7719,5401
50,6,31,California,Kings County,5,6,13197,8079,5118
50,6,31,California,Kings County,5,7,11979,7264,4715
50,6,31,California,Kings County,5,8,10873,6648,4225
50,6,31,California,Kings County,5,9,10250,6382,3868
50,6,31,California,Kings County,5,10,10177,6180,3997
50,6,31,California,Kings County,5,11,9288,5407,3881
50,6,31,California,Kings County,5,12,7607,4271,3336
50,6,31,California,Kings County,5,13,5781,3058,2723
50,6,31,California,Kings County,5,14,4264,2164,2100
50,6,31,California,Kings County,5,15,3162,1482,1680
50,6,31,California,Kings County,5,16,2357,1065,1292
50,6,31,California,Kings County,5,17,1645,679,966
50,6,31,California,Kings County,5,18,1490,556,934
50,6,31,California,Kings County,6,0,150237,83499,66738
50,6,31,California,Kings County,6,1,12061,6129,5932
50,6,31,California,Kings County,6,2,12002,6155,5847
50,6,31,California,Kings County,6,3,10821,5418,5403
50,6,31,California,Kings County,6,4,10678,5588,5090
50,6,31,California,Kings County,6,5,13142,7741,5401
50,6,31,California,Kings County,6,6,13069,7908,5161
50,6,31,California,Kings County,6,7,11899,7137,4762
50,6,31,California,Kings County,6,8,10664,6499,4165
50,6,31,California,Kings County,6,9,9998,6155,3843
50,6,31,California,Kings County,6,10,9779,5934,3845
50,6,31,California,Kings County,6,11,9231,5343,3888
50,6,31,California,Kings County,6,12,7648,4232,3416
50,6,31,California,Kings County,6,13,5908,3113,2795
50,6,31,California,Kings County,6,14,4446,2235,2211
50,6,31,California,Kings County,6,15,3244,1524,1720
50,6,31,California,Kings County,6,16,2400,1095,1305
50,6,31,California,Kings County,6,17,1669,701,968
50,6,31,California,Kings County,6,18,1578,592,986
50,6,31,California,Kings County,7,0,149373,82468,66905
50,6,31,California,Kings County,7,1,11818,6032,5786
50,6,31,California,Kings County,7,2,12049,6117,5932
50,6,31,California,Kings County,7,3,10831,5472,5359
50,6,31,California,Kings County,7,4,10597,5531,5066
50,6,31,California,Kings County,7,5,13132,7762,5370
50,6,31,California,Kings County,7,6,12927,7767,5160
50,6,31,California,Kings County,7,7,11940,7043,4897
50,6,31,California,Kings County,7,8,10498,6294,4204
50,6,31,California,Kings County,7,9,9725,5907,3818
50,6,31,California,Kings County,7,10,9340,5630,3710
50,6,31,California,Kings County,7,11,9062,5152,3910
50,6,31,California,Kings County,7,12,7686,4235,3451
50,6,31,California,Kings County,7,13,5999,3190,2809
50,6,31,California,Kings County,7,14,4614,2285,2329
50,6,31,California,Kings County,7,15,3295,1575,1720
50,6,31,California,Kings County,7,16,2486,1124,1362
50,6,31,California,Kings County,7,17,1750,750,1000
50,6,31,California,Kings County,7,18,1624,602,1022
50,6,31,California,Kings County,8,0,149960,82746,67214
50,6,31,California,Kings County,8,1,11847,6008,5839
50,6,31,California,Kings County,8,2,12009,6042,5967
50,6,31,California,Kings County,8,3,10839,5507,5332
50,6,31,California,Kings County,8,4,10535,5506,5029
50,6,31,California,Kings County,8,5,13108,7757,5351
50,6,31,California,Kings County,8,6,12978,7830,5148
50,6,31,California,Kings County,8,7,11903,7057,4846
50,6,31,California,Kings County,8,8,10765,6442,4323
50,6,31,California,Kings County,8,9,9642,5796,3846
50,6,31,California,Kings County,8,10,9264,5633,3631
50,6,31,California,Kings County,8,11,8990,5112,3878
50,6,31,California,Kings County,8,12,7748,4232,3516
50,6,31,California,Kings County,8,13,6119,3273,2846
50,6,31,California,Kings County,8,14,4807,2376,2431
50,6,31,California,Kings County,8,15,3350,1612,1738
50,6,31,California,Kings County,8,16,2566,1157,1409
50,6,31,California,Kings County,8,17,1794,763,1031
50,6,31,California,Kings County,8,18,1696,643,1053
50,6,31,California,Kings County,9,0,149269,82238,67031
50,6,31,California,Kings County,9,1,11559,5881,5678
50,6,31,California,Kings County,9,2,11907,6008,5899
50,6,31,California,Kings County,9,3,10838,5500,5338
50,6,31,California,Kings County,9,4,10436,5423,5013
50,6,31,California,Kings County,9,5,12763,7589,5174
50,6,31,California,Kings County,9,6,13087,7890,5197
50,6,31,California,Kings County,9,7,12008,7097,4911
50,6,31,California,Kings County,9,8,10728,6418,4310
50,6,31,California,Kings County,9,9,9474,5713,3761
50,6,31,California,Kings County,9,10,9117,5502,3615
50,6,31,California,Kings County,9,11,8749,4962,3787
50,6,31,California,Kings County,9,12,7760,4195,3565
50,6,31,California,Kings County,9,13,6231,3334,2897
50,6,31,California,Kings County,9,14,4957,2452,2505
50,6,31,California,Kings County,9,15,3487,1672,1815
50,6,31,California,Kings County,9,16,2547,1137,1410
50,6,31,California,Kings County,9,17,1859,812,1047
50,6,31,California,Kings County,9,18,1762,653,1109
50,6,31,California,Kings County,10,0,149542,81995,67547
50,6,31,California,Kings County,10,1,11554,5959,5595
50,6,31,California,Kings County,10,2,11842,5944,5898
50,6,31,California,Kings County,10,3,11114,5649,5465
50,6,31,California,Kings County,10,4,10339,5368,4971
50,6,31,California,Kings County,10,5,12686,7471,5215
50,6,31,California,Kings County,10,6,13234,7899,5335
50,6,31,California,Kings County,10,7,12064,7102,4962
50,6,31,California,Kings County,10,8,10724,6323,4401
50,6,31,California,Kings County,10,9,9480,5685,3795
50,6,31,California,Kings County,10,10,8859,5345,3514
50,6,31,California,Kings County,10,11,8436,4768,3668
50,6,31,California,Kings County,10,12,7771,4195,3576
50,6,31,California,Kings County,10,13,6401,3382,3019
50,6,31,California,Kings County,10,14,4980,2449,2531
50,6,31,California,Kings County,10,15,3700,1770,1930
50,6,31,California,Kings County,10,16,2657,1171,1486
50,6,31,California,Kings County,10,17,1872,828,1044
50,6,31,California,Kings County,10,18,1829,687,1142
50,6,31,California,Kings County,11,0,151221,83142,68079
50,6,31,California,Kings County,11,1,11503,5932,5571
50,6,31,California,Kings County,11,2,11880,5931,5949
50,6,31,California,Kings County,11,3,11489,5840,5649
50,6,31,California,Kings County,11,4,10142,5267,4875
50,6,31,California,Kings County,11,5,12652,7484,5168
50,6,31,California,Kings County,11,6,13387,7961,5426
50,6,31,California,Kings County,11,7,12305,7287,5018
50,6,31,California,Kings County,11,8,11085,6571,4514
50,6,31,California,Kings County,11,9,9691,5885,3806
50,6,31,California,Kings County,11,10,8903,5378,3525
50,6,31,California,Kings County,11,11,8339,4758,3581
50,6,31,California,Kings County,11,12,7768,4212,3556
50,6,31,California,Kings County,11,13,6508,3435,3073
50,6,31,California,Kings County,11,14,5107,2520,2587
50,6,31,California,Kings County,11,15,3903,1867,2036
50,6,31,California,Kings County,11,16,2739,1241,1498
50,6,31,California,Kings County,11,17,1933,852,1081
50,6,31,California,Kings County,11,18,1887,721,1166
50,6,31,California,Kings County,12,0,152727,84251,68476
50,6,31,California,Kings County,12,1,11517,5908,5609
50,6,31,California,Kings County,12,2,11777,5983,5794
50,6,31,California,Kings County,12,3,11679,5933,5746
50,6,31,California,Kings County,12,4,10220,5359,4861
50,6,31,California,Kings County,12,5,12516,7427,5089
50,6,31,California,Kings County,12,6,13557,8054,5503
50,6,31,California,Kings County,12,7,12452,7410,5042
50,6,31,California,Kings County,12,8,11556,6878,4678
50,6,31,California,Kings County,12,9,9801,5942,3859
50,6,31,California,Kings County,12,10,8865,5383,3482
50,6,31,California,Kings County,12,11,8167,4723,3444
50,6,31,California,Kings County,12,12,7817,4203,3614
50,6,31,California,Kings County,12,13,6654,3521,3133
50,6,31,California,Kings County,12,14,5227,2653,2574
50,6,31,California,Kings County,12,15,4095,1915,2180
50,6,31,California,Kings County,12,16,2867,1320,1547
50,6,31,California,Kings County,12,17,2007,886,1121
50,6,31,California,Kings County,12,18,1953,753,1200
50,6,31,California,Kings County,13,0,152804,84075,68729
50,6,31,California,Kings County,13,1,11374,5817,5557
50,6,31,California,Kings County,13,2,11740,5976,5764
50,6,31,California,Kings County,13,3,11681,5910,5771
50,6,31,California,Kings County,13,4,10271,5366,4905
50,6,31,California,Kings County,13,5,12461,7391,5070
50,6,31,California,Kings County,13,6,13420,7950,5470
50,6,31,California,Kings County,13,7,12495,7406,5089
50,6,31,California,Kings County,13,8,11567,6880,4687
50,6,31,California,Kings County,13,9,9974,6001,3973
50,6,31,California,Kings County,13,10,8795,5295,3500
50,6,31,California,Kings County,13,11,8016,4681,3335
50,6,31,California,Kings County,13,12,7791,4140,3651
50,6,31,California,Kings County,13,13,6715,3529,3186
50,6,31,California,Kings County,13,14,5332,2745,2587
50,6,31,California,Kings County,13,15,4211,1970,2241
50,6,31,California,Kings County,13,16,2921,1350,1571
50,6,31,California,Kings County,13,17,2064,904,1160
50,6,31,California,Kings County,13,18,1976,764,1212
50,6,31,California,Kings County,14,0,152692,83940,68752
50,6,31,California,Kings County,14,1,11319,5782,5537
50,6,31,California,Kings County,14,2,11715,5965,5750
50,6,31,California,Kings County,14,3,11678,5902,5776
50,6,31,California,Kings County,14,4,10274,5359,4915
50,6,31,California,Kings County,14,5,12434,7372,5062
50,6,31,California,Kings County,14,6,13354,7902,5452
50,6,31,California,Kings County,14,7,12504,7405,5099
50,6,31,California,Kings County,14,8,11575,6885,4690
50,6,31,California,Kings County,14,9,10021,6016,4005
50,6,31,California,Kings County,14,10,8772,5264,3508
50,6,31,California,Kings County,14,11,7974,4666,3308
50,6,31,California,Kings County,14,12,7771,4113,3658
50,6,31,California,Kings County,14,13,6722,3525,3197
50,6,31,California,Kings County,14,14,5364,2775,2589
50,6,31,California,Kings County,14,15,4234,1980,2254
50,6,31,California,Kings County,14,16,2930,1358,1572
50,6,31,California,Kings County,14,17,2080,908,1172
50,6,31,California,Kings County,14,18,1971,763,1208
50,6,33,California,Lake County,1,0,64665,32469,32196
50,6,33,California,Lake County,1,1,3633,1873,1760
50,6,33,California,Lake County,1,2,3574,1841,1733
50,6,33,California,Lake County,1,3,3888,2044,1844
50,6,33,California,Lake County,1,4,4190,2190,2000
50,6,33,California,Lake County,1,5,3362,1745,1617
50,6,33,California,Lake County,1,6,3346,1763,1583
50,6,33,California,Lake County,1,7,3257,1717,1540
50,6,33,California,Lake County,1,8,3255,1601,1654
50,6,33,California,Lake County,1,9,3840,1925,1915
50,6,33,California,Lake County,1,10,4725,2301,2424
50,6,33,California,Lake County,1,11,5530,2744,2786
50,6,33,California,Lake County,1,12,5468,2658,2810
50,6,33,California,Lake County,1,13,5157,2638,2519
50,6,33,California,Lake County,1,14,3791,1858,1933
50,6,33,California,Lake County,1,15,2762,1376,1386
50,6,33,California,Lake County,1,16,2007,989,1018
50,6,33,California,Lake County,1,17,1495,662,833
50,6,33,California,Lake County,1,18,1385,544,841
50,6,33,California,Lake County,2,0,64662,32467,32195
50,6,33,California,Lake County,2,1,3633,1873,1760
50,6,33,California,Lake County,2,2,3574,1841,1733
50,6,33,California,Lake County,2,3,3888,2044,1844
50,6,33,California,Lake County,2,4,4190,2190,2000
50,6,33,California,Lake County,2,5,3362,1745,1617
50,6,33,California,Lake County,2,6,3346,1763,1583
50,6,33,California,Lake County,2,7,3257,1717,1540
50,6,33,California,Lake County,2,8,3255,1601,1654
50,6,33,California,Lake County,2,9,3840,1925,1915
50,6,33,California,Lake County,2,10,4725,2301,2424
50,6,33,California,Lake County,2,11,5530,2744,2786
50,6,33,California,Lake County,2,12,5468,2658,2810
50,6,33,California,Lake County,2,13,5156,2637,2519
50,6,33,California,Lake County,2,14,3789,1857,1932
50,6,33,California,Lake County,2,15,2762,1376,1386
50,6,33,California,Lake County,2,16,2007,989,1018
50,6,33,California,Lake County,2,17,1495,662,833
50,6,33,California,Lake County,2,18,1385,544,841
50,6,33,California,Lake County,3,0,64736,32470,32266
50,6,33,California,Lake County,3,1,3631,1870,1761
50,6,33,California,Lake County,3,2,3575,1843,1732
50,6,33,California,Lake County,3,3,3853,2018,1835
50,6,33,California,Lake County,3,4,4141,2165,1976
50,6,33,California,Lake County,3,5,3421,1777,1644
50,6,33,California,Lake County,3,6,3380,1783,1597
50,6,33,California,Lake County,3,7,3261,1717,1544
50,6,33,California,Lake County,3,8,3225,1590,1635
50,6,33,California,Lake County,3,9,3830,1907,1923
50,6,33,California,Lake County,3,10,4694,2281,2413
50,6,33,California,Lake County,3,11,5529,2749,2780
50,6,33,California,Lake County,3,12,5489,2659,2830
50,6,33,California,Lake County,3,13,5203,2651,2552
50,6,33,California,Lake County,3,14,3830,1886,1944
50,6,33,California,Lake County,3,15,2776,1379,1397
50,6,33,California,Lake County,3,16,2017,990,1027
50,6,33,California,Lake County,3,17,1484,662,822
50,6,33,California,Lake County,3,18,1397,543,854
50,6,33,California,Lake County,4,0,64258,32169,32089
50,6,33,California,Lake County,4,1,3603,1886,1717
50,6,33,California,Lake County,4,2,3562,1840,1722
50,6,33,California,Lake County,4,3,3637,1883,1754
50,6,33,California,Lake County,4,4,3935,2053,1882
50,6,33,California,Lake County,4,5,3501,1838,1663
50,6,33,California,Lake County,4,6,3368,1768,1600
50,6,33,California,Lake County,4,7,3272,1728,1544
50,6,33,California,Lake County,4,8,3033,1498,1535
50,6,33,California,Lake County,4,9,3735,1818,1917
50,6,33,California,Lake County,4,10,4463,2151,2312
50,6,33,California,Lake County,4,11,5413,2684,2729
50,6,33,California,Lake County,4,12,5508,2641,2867
50,6,33,California,Lake County,4,13,5439,2749,2690
50,6,33,California,Lake County,4,14,3961,1979,1982
50,6,33,California,Lake County,4,15,2842,1409,1433
50,6,33,California,Lake County,4,16,2095,1022,1073
50,6,33,California,Lake County,4,17,1463,671,792
50,6,33,California,Lake County,4,18,1428,551,877
50,6,33,California,Lake County,5,0,63966,32032,31934
50,6,33,California,Lake County,5,1,3616,1878,1738
50,6,33,California,Lake County,5,2,3566,1840,1726
50,6,33,California,Lake County,5,3,3610,1842,1768
50,6,33,California,Lake County,5,4,3746,1994,1752
50,6,33,California,Lake County,5,5,3574,1870,1704
50,6,33,California,Lake County,5,6,3320,1727,1593
50,6,33,California,Lake County,5,7,3337,1774,1563
50,6,33,California,Lake County,5,8,3069,1556,1513
50,6,33,California,Lake County,5,9,3522,1680,1842
50,6,33,California,Lake County,5,10,4291,2105,2186
50,6,33,California,Lake County,5,11,5126,2500,2626
50,6,33,California,Lake County,5,12,5555,2664,2891
50,6,33,California,Lake County,5,13,5326,2655,2671
50,6,33,California,Lake County,5,14,4340,2187,2153
50,6,33,California,Lake County,5,15,2948,1479,1469
50,6,33,California,Lake County,5,16,2102,1033,1069
50,6,33,California,Lake County,5,17,1470,672,798
50,6,33,California,Lake County,5,18,1448,576,872
50,6,33,California,Lake County,6,0,63811,31876,31935
50,6,33,California,Lake County,6,1,3588,1832,1756
50,6,33,California,Lake County,6,2,3554,1869,1685
50,6,33,California,Lake County,6,3,3601,1820,1781
50,6,33,California,Lake County,6,4,3628,1974,1654
50,6,33,California,Lake County,6,5,3517,1826,1691
50,6,33,California,Lake County,6,6,3337,1710,1627
50,6,33,California,Lake County,6,7,3321,1763,1558
50,6,33,California,Lake County,6,8,3094,1572,1522
50,6,33,California,Lake County,6,9,3531,1684,1847
50,6,33,California,Lake County,6,10,4005,1937,2068
50,6,33,California,Lake County,6,11,4908,2379,2529
50,6,33,California,Lake County,6,12,5565,2692,2873
50,6,33,California,Lake County,6,13,5388,2655,2733
50,6,33,California,Lake County,6,14,4495,2265,2230
50,6,33,California,Lake County,6,15,3163,1583,1580
50,6,33,California,Lake County,6,16,2174,1063,1111
50,6,33,California,Lake County,6,17,1452,666,786
50,6,33,California,Lake County,6,18,1490,586,904
50,6,33,California,Lake County,7,0,64056,31955,32101
50,6,33,California,Lake County,7,1,3668,1832,1836
50,6,33,California,Lake County,7,2,3619,1903,1716
50,6,33,California,Lake County,7,3,3580,1815,1765
50,6,33,California,Lake County,7,4,3557,1901,1656
50,6,33,California,Lake County,7,5,3450,1781,1669
50,6,33,California,Lake County,7,6,3491,1832,1659
50,6,33,California,Lake County,7,7,3395,1753,1642
50,6,33,California,Lake County,7,8,3184,1647,1537
50,6,33,California,Lake County,7,9,3367,1623,1744
50,6,33,California,Lake County,7,10,3887,1888,1999
50,6,33,California,Lake County,7,11,4728,2300,2428
50,6,33,California,Lake County,7,12,5489,2634,2855
50,6,33,California,Lake County,7,13,5346,2611,2735
50,6,33,California,Lake County,7,14,4774,2418,2356
50,6,33,California,Lake County,7,15,3308,1631,1677
50,6,33,California,Lake County,7,16,2254,1106,1148
50,6,33,California,Lake County,7,17,1462,686,776
50,6,33,California,Lake County,7,18,1497,594,903
50,6,33,California,Lake County,8,0,64266,32002,32264
50,6,33,California,Lake County,8,1,3713,1860,1853
50,6,33,California,Lake County,8,2,3671,1881,1790
50,6,33,California,Lake County,8,3,3601,1840,1761
50,6,33,California,Lake County,8,4,3462,1813,1649
50,6,33,California,Lake County,8,5,3323,1753,1570
50,6,33,California,Lake County,8,6,3589,1867,1722
50,6,33,California,Lake County,8,7,3449,1784,1665
50,6,33,California,Lake County,8,8,3266,1665,1601
50,6,33,California,Lake County,8,9,3179,1552,1627
50,6,33,California,Lake County,8,10,3767,1859,1908
50,6,33,California,Lake County,8,11,4563,2189,2374
50,6,33,California,Lake County,8,12,5502,2656,2846
50,6,33,California,Lake County,8,13,5385,2570,2815
50,6,33,California,Lake County,8,14,5014,2562,2452
50,6,33,California,Lake County,8,15,3450,1689,1761
50,6,33,California,Lake County,8,16,2306,1135,1171
50,6,33,California,Lake County,8,17,1549,735,814
50,6,33,California,Lake County,8,18,1477,592,885
50,6,33,California,Lake County,9,0,63912,31837,32075
50,6,33,California,Lake County,9,1,3659,1818,1841
50,6,33,California,Lake County,9,2,3712,1928,1784
50,6,33,California,Lake County,9,3,3653,1886,1767
50,6,33,California,Lake County,9,4,3448,1782,1666
50,6,33,California,Lake County,9,5,3114,1677,1437
50,6,33,California,Lake County,9,6,3665,1905,1760
50,6,33,California,Lake County,9,7,3487,1809,1678
50,6,33,California,Lake County,9,8,3326,1699,1627
50,6,33,California,Lake County,9,9,3057,1505,1552
50,6,33,California,Lake County,9,10,3679,1781,1898
50,6,33,California,Lake County,9,11,4432,2135,2297
50,6,33,California,Lake County,9,12,5289,2574,2715
50,6,33,California,Lake County,9,13,5332,2497,2835
50,6,33,California,Lake County,9,14,5133,2616,2517
50,6,33,California,Lake County,9,15,3522,1731,1791
50,6,33,California,Lake County,9,16,2355,1154,1201
50,6,33,California,Lake County,9,17,1570,737,833
50,6,33,California,Lake County,9,18,1479,603,876
50,6,33,California,Lake County,10,0,64132,31934,32198
50,6,33,California,Lake County,10,1,3770,1874,1896
50,6,33,California,Lake County,10,2,3742,1910,1832
50,6,33,California,Lake County,10,3,3696,1916,1780
50,6,33,California,Lake County,10,4,3401,1749,1652
50,6,33,California,Lake County,10,5,3040,1632,1408
50,6,33,California,Lake County,10,6,3737,1944,1793
50,6,33,California,Lake County,10,7,3536,1811,1725
50,6,33,California,Lake County,10,8,3443,1791,1652
50,6,33,California,Lake County,10,9,3161,1588,1573
50,6,33,California,Lake County,10,10,3578,1675,1903
50,6,33,California,Lake County,10,11,4291,2123,2168
50,6,33,California,Lake County,10,12,5069,2429,2640
50,6,33,California,Lake County,10,13,5366,2524,2842
50,6,33,California,Lake County,10,14,4937,2506,2431
50,6,33,California,Lake County,10,15,3880,1911,1969
50,6,33,California,Lake County,10,16,2445,1209,1236
50,6,33,California,Lake County,10,17,1575,738,837
50,6,33,California,Lake County,10,18,1465,604,861
50,6,33,California,Lake County,11,0,64394,32083,32311
50,6,33,California,Lake County,11,1,3828,1921,1907
50,6,33,California,Lake County,11,2,3762,1924,1838
50,6,33,California,Lake County,11,3,3737,1952,1785
50,6,33,California,Lake County,11,4,3423,1763,1660
50,6,33,California,Lake County,11,5,3011,1621,1390
50,6,33,California,Lake County,11,6,3660,1910,1750
50,6,33,California,Lake County,11,7,3677,1863,1814
50,6,33,California,Lake County,11,8,3506,1812,1694
50,6,33,California,Lake County,11,9,3211,1634,1577
50,6,33,California,Lake County,11,10,3597,1704,1893
50,6,33,California,Lake County,11,11,4088,1994,2094
50,6,33,California,Lake County,11,12,4838,2348,2490
50,6,33,California,Lake County,11,13,5359,2541,2818
50,6,33,California,Lake County,11,14,4976,2452,2524
50,6,33,California,Lake County,11,15,3983,1983,2000
50,6,33,California,Lake County,11,16,2620,1287,1333
50,6,33,California,Lake County,11,17,1604,764,840
50,6,33,California,Lake County,11,18,1514,610,904
50,6,33,California,Lake County,12,0,64463,32146,32317
50,6,33,California,Lake County,12,1,3805,1945,1860
50,6,33,California,Lake County,12,2,3845,1938,1907
50,6,33,California,Lake County,12,3,3802,1973,1829
50,6,33,California,Lake County,12,4,3408,1764,1644
50,6,33,California,Lake County,12,5,3007,1608,1399
50,6,33,California,Lake County,12,6,3569,1856,1713
50,6,33,California,Lake County,12,7,3731,1914,1817
50,6,33,California,Lake County,12,8,3600,1847,1753
50,6,33,California,Lake County,12,9,3273,1679,1594
50,6,33,California,Lake County,12,10,3473,1672,1801
50,6,33,California,Lake County,12,11,3966,1927,2039
50,6,33,California,Lake County,12,12,4761,2314,2447
50,6,33,California,Lake County,12,13,5272,2491,2781
50,6,33,California,Lake County,12,14,4919,2394,2525
50,6,33,California,Lake County,12,15,4163,2105,2058
50,6,33,California,Lake County,12,16,2730,1317,1413
50,6,33,California,Lake County,12,17,1634,780,854
50,6,33,California,Lake County,12,18,1505,622,883
50,6,33,California,Lake County,13,0,64521,32187,32334
50,6,33,California,Lake County,13,1,3858,1961,1897
50,6,33,California,Lake County,13,2,3893,1977,1916
50,6,33,California,Lake County,13,3,3842,1959,1883
50,6,33,California,Lake County,13,4,3373,1766,1607
50,6,33,California,Lake County,13,5,2988,1580,1408
50,6,33,California,Lake County,13,6,3550,1868,1682
50,6,33,California,Lake County,13,7,3781,1940,1841
50,6,33,California,Lake County,13,8,3663,1890,1773
50,6,33,California,Lake County,13,9,3369,1717,1652
50,6,33,California,Lake County,13,10,3338,1620,1718
50,6,33,California,Lake County,13,11,3897,1911,1986
50,6,33,California,Lake County,13,12,4598,2198,2400
50,6,33,California,Lake County,13,13,5257,2514,2743
50,6,33,California,Lake County,13,14,4905,2336,2569
50,6,33,California,Lake County,13,15,4247,2178,2069
50,6,33,California,Lake County,13,16,2791,1337,1454
50,6,33,California,Lake County,13,17,1674,804,870
50,6,33,California,Lake County,13,18,1497,631,866
50,6,33,California,Lake County,14,0,64479,32170,32309
50,6,33,California,Lake County,14,1,3881,1969,1912
50,6,33,California,Lake County,14,2,3894,1987,1907
50,6,33,California,Lake County,14,3,3848,1950,1898
50,6,33,California,Lake County,14,4,3358,1765,1593
50,6,33,California,Lake County,14,5,2975,1568,1407
50,6,33,California,Lake County,14,6,3547,1873,1674
50,6,33,California,Lake County,14,7,3799,1949,1850
50,6,33,California,Lake County,14,8,3685,1906,1779
50,6,33,California,Lake County,14,9,3396,1728,1668
50,6,33,California,Lake County,14,10,3286,1601,1685
50,6,33,California,Lake County,14,11,3886,1907,1979
50,6,33,California,Lake County,14,12,4547,2162,2385
50,6,33,California,Lake County,14,13,5246,2517,2729
50,6,33,California,Lake County,14,14,4899,2316,2583
50,6,33,California,Lake County,14,15,4266,2198,2068
50,6,33,California,Lake County,14,16,2799,1337,1462
50,6,33,California,Lake County,14,17,1684,809,875
50,6,33,California,Lake County,14,18,1483,628,855
50,6,35,California,Lassen County,1,0,34895,22416,12479
50,6,35,California,Lassen County,1,1,1625,866,759
50,6,35,California,Lassen County,1,2,1595,850,745
50,6,35,California,Lassen County,1,3,1853,933,920
50,6,35,California,Lassen County,1,4,2107,1203,904
50,6,35,California,Lassen County,1,5,2831,2199,632
50,6,35,California,Lassen County,1,6,3343,2635,708
50,6,35,California,Lassen County,1,7,2994,2335,659
50,6,35,California,Lassen County,1,8,2807,2031,776
50,6,35,California,Lassen County,1,9,2706,1933,773
50,6,35,California,Lassen County,1,10,2853,1895,958
50,6,35,California,Lassen County,1,11,2594,1558,1036
50,6,35,California,Lassen County,1,12,2281,1258,1023
50,6,35,California,Lassen County,1,13,1832,1000,832
50,6,35,California,Lassen County,1,14,1190,634,556
50,6,35,California,Lassen County,1,15,794,410,384
50,6,35,California,Lassen County,1,16,584,304,280
50,6,35,California,Lassen County,1,17,457,209,248
50,6,35,California,Lassen County,1,18,449,163,286
50,6,35,California,Lassen County,2,0,34895,22416,12479
50,6,35,California,Lassen County,2,1,1625,866,759
50,6,35,California,Lassen County,2,2,1595,850,745
50,6,35,California,Lassen County,2,3,1853,933,920
50,6,35,California,Lassen County,2,4,2107,1203,904
50,6,35,California,Lassen County,2,5,2831,2199,632
50,6,35,California,Lassen County,2,6,3343,2635,708
50,6,35,California,Lassen County,2,7,2994,2335,659
50,6,35,California,Lassen County,2,8,2807,2031,776
50,6,35,California,Lassen County,2,9,2706,1933,773
50,6,35,California,Lassen County,2,10,2853,1895,958
50,6,35,California,Lassen County,2,11,2594,1558,1036
50,6,35,California,Lassen County,2,12,2281,1258,1023
50,6,35,California,Lassen County,2,13,1832,1000,832
50,6,35,California,Lassen County,2,14,1190,634,556
50,6,35,California,Lassen County,2,15,794,410,384
50,6,35,California,Lassen County,2,16,584,304,280
50,6,35,California,Lassen County,2,17,457,209,248
50,6,35,California,Lassen County,2,18,449,163,286
50,6,35,California,Lassen County,3,0,34828,22402,12426
50,6,35,California,Lassen County,3,1,1617,853,764
50,6,35,California,Lassen County,3,2,1587,848,739
50,6,35,California,Lassen County,3,3,1839,933,906
50,6,35,California,Lassen County,3,4,2072,1181,891
50,6,35,California,Lassen County,3,5,2859,2218,641
50,6,35,California,Lassen County,3,6,3358,2651,707
50,6,35,California,Lassen County,3,7,2994,2328,666
50,6,35,California,Lassen County,3,8,2797,2045,752
50,6,35,California,Lassen County,3,9,2703,1932,771
50,6,35,California,Lassen County,3,10,2824,1875,949
50,6,35,California,Lassen County,3,11,2580,1555,1025
50,6,35,California,Lassen County,3,12,2269,1246,1023
50,6,35,California,Lassen County,3,13,1861,1018,843
50,6,35,California,Lassen County,3,14,1186,630,556
50,6,35,California,Lassen County,3,15,797,411,386
50,6,35,California,Lassen County,3,16,584,304,280
50,6,35,California,Lassen County,3,17,452,210,242
50,6,35,California,Lassen County,3,18,449,164,285
50,6,35,California,Lassen County,4,0,34235,22075,12160
50,6,35,California,Lassen County,4,1,1542,775,767
50,6,35,California,Lassen County,4,2,1527,821,706
50,6,35,California,Lassen County,4,3,1731,889,842
50,6,35,California,Lassen County,4,4,1951,1121,830
50,6,35,California,Lassen County,4,5,2867,2213,654
50,6,35,California,Lassen County,4,6,3367,2662,705
50,6,35,California,Lassen County,4,7,2932,2274,658
50,6,35,California,Lassen County,4,8,2742,2051,691
50,6,35,California,Lassen County,4,9,2638,1892,746
50,6,35,California,Lassen County,4,10,2719,1813,906
50,6,35,California,Lassen County,4,11,2534,1553,981
50,6,35,California,Lassen County,4,12,2213,1201,1012
50,6,35,California,Lassen County,4,13,1936,1067,869
50,6,35,California,Lassen County,4,14,1207,631,576
50,6,35,California,Lassen County,4,15,809,411,398
50,6,35,California,Lassen County,4,16,585,303,282
50,6,35,California,Lassen County,4,17,474,223,251
50,6,35,California,Lassen County,4,18,461,175,286
50,6,35,California,Lassen County,5,0,33622,21666,11956
50,6,35,California,Lassen County,5,1,1545,774,771
50,6,35,California,Lassen County,5,2,1526,809,717
50,6,35,California,Lassen County,5,3,1625,858,767
50,6,35,California,Lassen County,5,4,1916,1074,842
50,6,35,California,Lassen County,5,5,2790,2152,638
50,6,35,California,Lassen County,5,6,3292,2607,685
50,6,35,California,Lassen County,5,7,2911,2251,660
50,6,35,California,Lassen County,5,8,2632,1997,635
50,6,35,California,Lassen County,5,9,2593,1826,767
50,6,35,California,Lassen County,5,10,2629,1764,865
50,6,35,California,Lassen County,5,11,2450,1531,919
50,6,35,California,Lassen County,5,12,2179,1161,1018
50,6,35,California,Lassen County,5,13,1880,1055,825
50,6,35,California,Lassen County,5,14,1317,693,624
50,6,35,California,Lassen County,5,15,853,433,420
50,6,35,California,Lassen County,5,16,563,286,277
50,6,35,California,Lassen County,5,17,466,216,250
50,6,35,California,Lassen County,5,18,455,179,276
50,6,35,California,Lassen County,6,0,32128,20372,11756
50,6,35,California,Lassen County,6,1,1492,734,758
50,6,35,California,Lassen County,6,2,1492,783,709
50,6,35,California,Lassen County,6,3,1582,831,751
50,6,35,California,Lassen County,6,4,1881,1058,823
50,6,35,California,Lassen County,6,5,2586,1956,630
50,6,35,California,Lassen County,6,6,3013,2371,642
50,6,35,California,Lassen County,6,7,2757,2086,671
50,6,35,California,Lassen County,6,8,2441,1827,614
50,6,35,California,Lassen County,6,9,2395,1664,731
50,6,35,California,Lassen County,6,10,2379,1594,785
50,6,35,California,Lassen County,6,11,2321,1425,896
50,6,35,California,Lassen County,6,12,2109,1132,977
50,6,35,California,Lassen County,6,13,1841,1019,822
50,6,35,California,Lassen County,6,14,1416,728,688
50,6,35,California,Lassen County,6,15,904,452,452
50,6,35,California,Lassen County,6,16,577,298,279
50,6,35,California,Lassen County,6,17,467,223,244
50,6,35,California,Lassen County,6,18,475,191,284
50,6,35,California,Lassen County,7,0,31664,20185,11479
50,6,35,California,Lassen County,7,1,1419,695,724
50,6,35,California,Lassen County,7,2,1439,740,699
50,6,35,California,Lassen County,7,3,1478,782,696
50,6,35,California,Lassen County,7,4,1788,994,794
50,6,35,California,Lassen County,7,5,2586,1967,619
50,6,35,California,Lassen County,7,6,2995,2377,618
50,6,35,California,Lassen County,7,7,2782,2117,665
50,6,35,California,Lassen County,7,8,2373,1790,583
50,6,35,California,Lassen County,7,9,2346,1642,704
50,6,35,California,Lassen County,7,10,2291,1573,718
50,6,35,California,Lassen County,7,11,2278,1399,879
50,6,35,California,Lassen County,7,12,2032,1131,901
50,6,35,California,Lassen County,7,13,1885,1025,860
50,6,35,California,Lassen County,7,14,1481,755,726
50,6,35,California,Lassen County,7,15,944,488,456
50,6,35,California,Lassen County,7,16,611,292,319
50,6,35,California,Lassen County,7,17,449,222,227
50,6,35,California,Lassen County,7,18,487,196,291
50,6,35,California,Lassen County,8,0,31256,19747,11509
50,6,35,California,Lassen County,8,1,1445,705,740
50,6,35,California,Lassen County,8,2,1429,758,671
50,6,35,California,Lassen County,8,3,1443,745,698
50,6,35,California,Lassen County,8,4,1727,948,779
50,6,35,California,Lassen County,8,5,2570,1925,645
50,6,35,California,Lassen County,8,6,3006,2336,670
50,6,35,California,Lassen County,8,7,2710,2050,660
50,6,35,California,Lassen County,8,8,2334,1728,606
50,6,35,California,Lassen County,8,9,2253,1580,673
50,6,35,California,Lassen County,8,10,2190,1506,684
50,6,35,California,Lassen County,8,11,2155,1322,833
50,6,35,California,Lassen County,8,12,1999,1102,897
50,6,35,California,Lassen County,8,13,1915,1017,898
50,6,35,California,Lassen County,8,14,1527,795,732
50,6,35,California,Lassen County,8,15,1001,511,490
50,6,35,California,Lassen County,8,16,626,301,325
50,6,35,California,Lassen County,8,17,437,220,217
50,6,35,California,Lassen County,8,18,489,198,291
50,6,35,California,Lassen County,9,0,30715,19136,11579
50,6,35,California,Lassen County,9,1,1497,740,757
50,6,35,California,Lassen County,9,2,1438,718,720
50,6,35,California,Lassen County,9,3,1435,759,676
50,6,35,California,Lassen County,9,4,1677,942,735
50,6,35,California,Lassen County,9,5,2466,1815,651
50,6,35,California,Lassen County,9,6,2944,2238,706
50,6,35,California,Lassen County,9,7,2636,1962,674
50,6,35,California,Lassen County,9,8,2266,1635,631
50,6,35,California,Lassen County,9,9,2149,1516,633
50,6,35,California,Lassen County,9,10,2119,1427,692
50,6,35,California,Lassen County,9,11,2093,1269,824
50,6,35,California,Lassen County,9,12,1963,1094,869
50,6,35,California,Lassen County,9,13,1854,943,911
50,6,35,California,Lassen County,9,14,1578,834,744
50,6,35,California,Lassen County,9,15,1023,517,506
50,6,35,California,Lassen County,9,16,649,311,338
50,6,35,California,Lassen County,9,17,431,215,216
50,6,35,California,Lassen County,9,18,497,201,296
50,6,35,California,Lassen County,10,0,30919,19382,11537
50,6,35,California,Lassen County,10,1,1562,825,737
50,6,35,California,Lassen County,10,2,1438,697,741
50,6,35,California,Lassen County,10,3,1476,786,690
50,6,35,California,Lassen County,10,4,1536,874,662
50,6,35,California,Lassen County,10,5,2444,1821,623
50,6,35,California,Lassen County,10,6,3037,2318,719
50,6,35,California,Lassen County,10,7,2676,1985,691
50,6,35,California,Lassen County,10,8,2350,1701,649
50,6,35,California,Lassen County,10,9,2146,1543,603
50,6,35,California,Lassen County,10,10,2106,1410,696
50,6,35,California,Lassen County,10,11,2011,1221,790
50,6,35,California,Lassen County,10,12,1950,1111,839
50,6,35,California,Lassen County,10,13,1839,924,915
50,6,35,California,Lassen County,10,14,1568,842,726
50,6,35,California,Lassen County,10,15,1151,571,580
50,6,35,California,Lassen County,10,16,685,327,358
50,6,35,California,Lassen County,10,17,448,221,227
50,6,35,California,Lassen County,10,18,496,205,291
50,6,35,California,Lassen County,11,0,30658,19112,11546
50,6,35,California,Lassen County,11,1,1562,831,731
50,6,35,California,Lassen County,11,2,1453,700,753
50,6,35,California,Lassen County,11,3,1444,761,683
50,6,35,California,Lassen County,11,4,1510,864,646
50,6,35,California,Lassen County,11,5,2346,1754,592
50,6,35,California,Lassen County,11,6,2981,2254,727
50,6,35,California,Lassen County,11,7,2695,2002,693
50,6,35,California,Lassen County,11,8,2358,1675,683
50,6,35,California,Lassen County,11,9,2130,1521,609
50,6,35,California,Lassen County,11,10,2043,1355,688
50,6,35,California,Lassen County,11,11,1873,1149,724
50,6,35,California,Lassen County,11,12,1839,1036,803
50,6,35,California,Lassen County,11,13,1834,925,909
50,6,35,California,Lassen County,11,14,1630,867,763
50,6,35,California,Lassen County,11,15,1248,620,628
50,6,35,California,Lassen County,11,16,738,352,386
50,6,35,California,Lassen County,11,17,452,220,232
50,6,35,California,Lassen County,11,18,522,226,296
50,6,35,California,Lassen County,12,0,30694,19107,11587
50,6,35,California,Lassen County,12,1,1504,797,707
50,6,35,California,Lassen County,12,2,1498,750,748
50,6,35,California,Lassen County,12,3,1466,753,713
50,6,35,California,Lassen County,12,4,1462,841,621
50,6,35,California,Lassen County,12,5,2308,1732,576
50,6,35,California,Lassen County,12,6,2955,2240,715
50,6,35,California,Lassen County,12,7,2738,2025,713
50,6,35,California,Lassen County,12,8,2381,1687,694
50,6,35,California,Lassen County,12,9,2117,1510,607
50,6,35,California,Lassen County,12,10,2018,1336,682
50,6,35,California,Lassen County,12,11,1826,1144,682
50,6,35,California,Lassen County,12,12,1810,1002,808
50,6,35,California,Lassen County,12,13,1793,914,879
50,6,35,California,Lassen County,12,14,1659,857,802
50,6,35,California,Lassen County,12,15,1326,655,671
50,6,35,California,Lassen County,12,16,799,401,398
50,6,35,California,Lassen County,12,17,488,224,264
50,6,35,California,Lassen County,12,18,546,239,307
50,6,35,California,Lassen County,13,0,30193,18587,11606
50,6,35,California,Lassen County,13,1,1494,779,715
50,6,35,California,Lassen County,13,2,1506,746,760
50,6,35,California,Lassen County,13,3,1464,752,712
50,6,35,California,Lassen County,13,4,1465,831,634
50,6,35,California,Lassen County,13,5,2206,1640,566
50,6,35,California,Lassen County,13,6,2871,2162,709
50,6,35,California,Lassen County,13,7,2687,1957,730
50,6,35,California,Lassen County,13,8,2354,1663,691
50,6,35,California,Lassen County,13,9,2060,1444,616
50,6,35,California,Lassen County,13,10,1959,1295,664
50,6,35,California,Lassen County,13,11,1752,1081,671
50,6,35,California,Lassen County,13,12,1748,970,778
50,6,35,California,Lassen County,13,13,1758,894,864
50,6,35,California,Lassen County,13,14,1651,825,826
50,6,35,California,Lassen County,13,15,1354,673,681
50,6,35,California,Lassen County,13,16,819,416,403
50,6,35,California,Lassen County,13,17,506,230,276
50,6,35,California,Lassen County,13,18,539,229,310
50,6,35,California,Lassen County,14,0,30016,18430,11586
50,6,35,California,Lassen County,14,1,1486,773,713
50,6,35,California,Lassen County,14,2,1504,741,763
50,6,35,California,Lassen County,14,3,1471,758,713
50,6,35,California,Lassen County,14,4,1463,829,634
50,6,35,California,Lassen County,14,5,2174,1611,563
50,6,35,California,Lassen County,14,6,2839,2137,702
50,6,35,California,Lassen County,14,7,2668,1935,733
50,6,35,California,Lassen County,14,8,2347,1659,688
50,6,35,California,Lassen County,14,9,2042,1425,617
50,6,35,California,Lassen County,14,10,1939,1281,658
50,6,35,California,Lassen County,14,11,1727,1061,666
50,6,35,California,Lassen County,14,12,1731,961,770
50,6,35,California,Lassen County,14,13,1743,888,855
50,6,35,California,Lassen County,14,14,1654,818,836
50,6,35,California,Lassen County,14,15,1364,681,683
50,6,35,California,Lassen County,14,16,822,418,404
50,6,35,California,Lassen County,14,17,509,230,279
50,6,35,California,Lassen County,14,18,533,224,309
50,6,37,California,Los Angeles County,1,0,9818605,4839654,4978951
50,6,37,California,Los Angeles County,1,1,645793,330265,315528
50,6,37,California,Los Angeles County,1,2,633690,323676,310014
50,6,37,California,Los Angeles County,1,3,678845,347102,331743
50,6,37,California,Los Angeles County,1,4,753630,385012,368618
50,6,37,California,Los Angeles County,1,5,752788,385393,367395
50,6,37,California,Los Angeles County,1,6,759602,386393,373209
50,6,37,California,Los Angeles County,1,7,716129,360263,355866
50,6,37,California,Los Angeles County,1,8,715635,356358,359277
50,6,37,California,Los Angeles County,1,9,714691,357282,357409
50,6,37,California,Los Angeles County,1,10,706742,349671,357071
50,6,37,California,Los Angeles County,1,11,662205,323330,338875
50,6,37,California,Los Angeles County,1,12,560920,269289,291631
50,6,37,California,Los Angeles County,1,13,452236,212254,239982
50,6,37,California,Los Angeles County,1,14,323287,148148,175139
50,6,37,California,Los Angeles County,1,15,245183,109338,135845
50,6,37,California,Los Angeles County,1,16,192881,82327,110554
50,6,37,California,Los Angeles County,1,17,152722,60853,91869
50,6,37,California,Los Angeles County,1,18,151626,52700,98926
50,6,37,California,Los Angeles County,2,0,9818646,4839682,4978964
50,6,37,California,Los Angeles County,2,1,645795,330266,315529
50,6,37,California,Los Angeles County,2,2,633697,323677,310020
50,6,37,California,Los Angeles County,2,3,678845,347103,331742
50,6,37,California,Los Angeles County,2,4,753650,385031,368619
50,6,37,California,Los Angeles County,2,5,752787,385393,367394
50,6,37,California,Los Angeles County,2,6,759599,386391,373208
50,6,37,California,Los Angeles County,2,7,716130,360264,355866
50,6,37,California,Los Angeles County,2,8,715629,356355,359274
50,6,37,California,Los Angeles County,2,9,714698,357282,357416
50,6,37,California,Los Angeles County,2,10,706744,349673,357071
50,6,37,California,Los Angeles County,2,11,662202,323333,338869
50,6,37,California,Los Angeles County,2,12,560925,269291,291634
50,6,37,California,Los Angeles County,2,13,452241,212256,239985
50,6,37,California,Los Angeles County,2,14,323289,148148,175141
50,6,37,California,Los Angeles County,2,15,245186,109340,135846
50,6,37,California,Los Angeles County,2,16,192877,82325,110552
50,6,37,California,Los Angeles County,2,17,152726,60855,91871
50,6,37,California,Los Angeles County,2,18,151626,52699,98927
50,6,37,California,Los Angeles County,3,0,9821647,4840152,4981495
50,6,37,California,Los Angeles County,3,1,644688,329744,314944
50,6,37,California,Los Angeles County,3,2,631438,322448,308990
50,6,37,California,Los Angeles County,3,3,674505,344676,329829
50,6,37,California,Los Angeles County,3,4,748543,382398,366145
50,6,37,California,Los Angeles County,3,5,755956,386509,369447
50,6,37,California,Los Angeles County,3,6,759821,386484,373337
50,6,37,California,Los Angeles County,3,7,717323,361040,356283
50,6,37,California,Los Angeles County,3,8,711715,354229,357486
50,6,37,California,Los Angeles County,3,9,714974,357257,357717
50,6,37,California,Los Angeles County,3,10,705357,349073,356284
50,6,37,California,Los Angeles County,3,11,663989,324440,339549
50,6,37,California,Los Angeles County,3,12,564804,271230,293574
50,6,37,California,Los Angeles County,3,13,456593,214295,242298
50,6,37,California,Los Angeles County,3,14,326025,149439,176586
50,6,37,California,Los Angeles County,3,15,246516,110000,136516
50,6,37,California,Los Angeles County,3,16,192943,82388,110555
50,6,37,California,Los Angeles County,3,17,153133,61177,91956
50,6,37,California,Los Angeles County,3,18,153324,53325,99999
50,6,37,California,Los Angeles County,4,0,9873700,4863389,5010311
50,6,37,California,Los Angeles County,4,1,646083,330587,315496
50,6,37,California,Los Angeles County,4,2,627686,320671,307015
50,6,37,California,Los Angeles County,4,3,660539,337232,323307
50,6,37,California,Los Angeles County,4,4,729426,372409,357017
50,6,37,California,Los Angeles County,4,5,772706,393228,379478
50,6,37,California,Los Angeles County,4,6,767784,391084,376700
50,6,37,California,Los Angeles County,4,7,725553,365935,359618
50,6,37,California,Los Angeles County,4,8,696654,346165,350489
50,6,37,California,Los Angeles County,4,9,720401,359253,361148
50,6,37,California,Los Angeles County,4,10,700174,346749,353425
50,6,37,California,Los Angeles County,4,11,670484,328383,342101
50,6,37,California,Los Angeles County,4,12,581266,279250,302016
50,6,37,California,Los Angeles County,4,13,477093,224095,252998
50,6,37,California,Los Angeles County,4,14,337131,154642,182489
50,6,37,California,Los Angeles County,4,15,252308,112603,139705
50,6,37,California,Los Angeles County,4,16,195441,83663,111778
50,6,37,California,Los Angeles County,4,17,153884,61962,91922
50,6,37,California,Los Angeles County,4,18,159087,55478,103609
50,6,37,California,Los Angeles County,5,0,9931394,4891478,5039916
50,6,37,California,Los Angeles County,5,1,641610,328103,313507
50,6,37,California,Los Angeles County,5,2,630310,322240,308070
50,6,37,California,Los Angeles County,5,3,647026,330293,316733
50,6,37,California,Los Angeles County,5,4,711823,362865,348958
50,6,37,California,Los Angeles County,5,5,782992,397320,385672
50,6,37,California,Los Angeles County,5,6,776393,396316,380077
50,6,37,California,Los Angeles County,5,7,735911,371737,364174
50,6,37,California,Los Angeles County,5,8,691569,343918,347651
50,6,37,California,Los Angeles County,5,9,721519,359241,362278
50,6,37,California,Los Angeles County,5,10,695431,344580,350851
50,6,37,California,Los Angeles County,5,11,675122,331349,343773
50,6,37,California,Los Angeles County,5,12,598285,287853,310432
50,6,37,California,Los Angeles County,5,13,483712,227183,256529
50,6,37,California,Los Angeles County,5,14,361527,166442,195085
50,6,37,California,Los Angeles County,5,15,260549,116413,144136
50,6,37,California,Los Angeles County,5,16,198972,85251,113721
50,6,37,California,Los Angeles County,5,17,154136,62561,91575
50,6,37,California,Los Angeles County,5,18,164507,57813,106694
50,6,37,California,Los Angeles County,6,0,9987189,4919940,5067249
50,6,37,California,Los Angeles County,6,1,638263,326389,311874
50,6,37,California,Los Angeles County,6,2,632069,323090,308979
50,6,37,California,Los Angeles County,6,3,635929,324424,311505
50,6,37,California,Los Angeles County,6,4,696755,354767,341988
50,6,37,California,Los Angeles County,6,5,781946,396601,385345
50,6,37,California,Los Angeles County,6,6,791470,404272,387198
50,6,37,California,Los Angeles County,6,7,747308,378479,368829
50,6,37,California,Los Angeles County,6,8,690559,344388,346171
50,6,37,California,Los Angeles County,6,9,715380,355371,360009
50,6,37,California,Los Angeles County,6,10,691130,343395,347735
50,6,37,California,Los Angeles County,6,11,680520,334464,346056
50,6,37,California,Los Angeles County,6,12,612950,295315,317635
50,6,37,California,Los Angeles County,6,13,495313,232981,262332
50,6,37,California,Los Angeles County,6,14,378477,174609,203868
50,6,37,California,Los Angeles County,6,15,271765,121316,150449
50,6,37,California,Los Angeles County,6,16,203858,87596,116262
50,6,37,California,Los Angeles County,6,17,154688,62944,91744
50,6,37,California,Los Angeles County,6,18,168809,59539,109270
50,6,37,California,Los Angeles County,7,0,10033449,4943255,5090194
50,6,37,California,Los Angeles County,7,1,638554,326994,311560
50,6,37,California,Los Angeles County,7,2,628169,321495,306674
50,6,37,California,Los Angeles County,7,3,628240,320381,307859
50,6,37,California,Los Angeles County,7,4,680358,346000,334358
50,6,37,California,Los Angeles County,7,5,775487,392508,382979
50,6,37,California,Los Angeles County,7,6,810646,414106,396540
50,6,37,California,Los Angeles County,7,7,754094,382633,371461
50,6,37,California,Los Angeles County,7,8,690960,345493,345467
50,6,37,California,Los Angeles County,7,9,704257,349268,354989
50,6,37,California,Los Angeles County,7,10,687716,342030,345686
50,6,37,California,Los Angeles County,7,11,684830,336952,347878
50,6,37,California,Los Angeles County,7,12,623122,300950,322172
50,6,37,California,Los Angeles County,7,13,510038,240914,269124
50,6,37,California,Los Angeles County,7,14,396195,182531,213664
50,6,37,California,Los Angeles County,7,15,281678,125516,156162
50,6,37,California,Los Angeles County,7,16,209398,90219,119179
50,6,37,California,Los Angeles County,7,17,155656,63516,92140
50,6,37,California,Los Angeles County,7,18,174051,61749,112302
50,6,37,California,Los Angeles County,8,0,10077263,4965853,5111410
50,6,37,California,Los Angeles County,8,1,637025,326518,310507
50,6,37,California,Los Angeles County,8,2,623612,319248,304364
50,6,37,California,Los Angeles County,8,3,619892,316233,303659
50,6,37,California,Los Angeles County,8,4,668928,340121,328807
50,6,37,California,Los Angeles County,8,5,758919,383822,375097
50,6,37,California,Los Angeles County,8,6,831575,424518,407057
50,6,37,California,Los Angeles County,8,7,758439,384953,373486
50,6,37,California,Los Angeles County,8,8,696862,349841,347021
50,6,37,California,Los Angeles County,8,9,689875,341835,348040
50,6,37,California,Los Angeles County,8,10,692601,344648,347953
50,6,37,California,Los Angeles County,8,11,681249,335364,345885
50,6,37,California,Los Angeles County,8,12,633374,306788,326586
50,6,37,California,Los Angeles County,8,13,526549,249699,276850
50,6,37,California,Los Angeles County,8,14,414552,190826,223726
50,6,37,California,Los Angeles County,8,15,292572,130550,162022
50,6,37,California,Los Angeles County,8,16,214600,92624,121976
50,6,37,California,Los Angeles County,8,17,156865,64091,92774
50,6,37,California,Los Angeles County,8,18,179774,64174,115600
50,6,37,California,Los Angeles County,9,0,10094865,4975091,5119774
50,6,37,California,Los Angeles County,9,1,625730,320884,304846
50,6,37,California,Los Angeles County,9,2,621366,318069,303297
50,6,37,California,Los Angeles County,9,3,613694,313154,300540
50,6,37,California,Los Angeles County,9,4,654838,332924,321914
50,6,37,California,Los Angeles County,9,5,736878,372247,364631
50,6,37,California,Los Angeles County,9,6,851084,433611,417473
50,6,37,California,Los Angeles County,9,7,766440,390710,375730
50,6,37,California,Los Angeles County,9,8,704249,354385,349864
50,6,37,California,Los Angeles County,9,9,674582,334072,340510
50,6,37,California,Los Angeles County,9,10,696274,346004,350270
50,6,37,California,Los Angeles County,9,11,674811,332911,341900
50,6,37,California,Los Angeles County,9,12,638485,310059,328426
50,6,37,California,Los Angeles County,9,13,540536,256715,283821
50,6,37,California,Los Angeles County,9,14,432296,199045,233251
50,6,37,California,Los Angeles County,9,15,301727,134768,166959
50,6,37,California,Los Angeles County,9,16,219253,94714,124539
50,6,37,California,Los Angeles County,9,17,158948,65020,93928
50,6,37,California,Los Angeles County,9,18,183674,65799,117875
50,6,37,California,Los Angeles County,10,0,10092365,4975410,5116955
50,6,37,California,Los Angeles County,10,1,615565,315841,299724
50,6,37,California,Los Angeles County,10,2,612927,313556,299371
50,6,37,California,Los Angeles County,10,3,612793,313381,299412
50,6,37,California,Los Angeles County,10,4,640090,325470,314620
50,6,37,California,Los Angeles County,10,5,716073,361093,354980
50,6,37,California,Los Angeles County,10,6,859339,437431,421908
50,6,37,California,Los Angeles County,10,7,772729,395445,377284
50,6,37,California,Los Angeles County,10,8,710426,358546,351880
50,6,37,California,Los Angeles County,10,9,666198,329990,336208
50,6,37,California,Los Angeles County,10,10,693159,344059,349100
50,6,37,California,Los Angeles County,10,11,666428,329071,337357
50,6,37,California,Los Angeles County,10,12,639801,311569,328232
50,6,37,California,Los Angeles County,10,13,554071,263638,290433
50,6,37,California,Los Angeles County,10,14,436481,201146,235335
50,6,37,California,Los Angeles County,10,15,322055,144366,177689
50,6,37,California,Los Angeles County,10,16,225520,97396,128124
50,6,37,California,Los Angeles County,10,17,161780,66237,95543
50,6,37,California,Los Angeles County,10,18,186930,67175,119755
50,6,37,California,Los Angeles County,11,0,10061533,4960497,5101036
50,6,37,California,Los Angeles County,11,1,596461,305927,290534
50,6,37,California,Los Angeles County,11,2,604613,309389,295224
50,6,37,California,Los Angeles County,11,3,610705,312545,298160
50,6,37,California,Los Angeles County,11,4,627670,318947,308723
50,6,37,California,Los Angeles County,11,5,696518,350621,345897
50,6,37,California,Los Angeles County,11,6,854415,434842,419573
50,6,37,California,Los Angeles County,11,7,782298,400565,381733
50,6,37,California,Los Angeles County,11,8,715394,361847,353547
50,6,37,California,Los Angeles County,11,9,659423,327657,331766
50,6,37,California,Los Angeles County,11,10,682700,338110,344590
50,6,37,California,Los Angeles County,11,11,657384,325260,332124
50,6,37,California,Los Angeles County,11,12,640675,312725,327950
50,6,37,California,Los Angeles County,11,13,563968,268607,295361
50,6,37,California,Los Angeles County,11,14,444740,205448,239292
50,6,37,California,Los Angeles County,11,15,335441,150722,184719
50,6,37,California,Los Angeles County,11,16,234388,101240,133148
50,6,37,California,Los Angeles County,11,17,165216,67742,97474
50,6,37,California,Los Angeles County,11,18,189524,68303,121221
50,6,37,California,Los Angeles County,12,0,10011602,4935416,5076186
50,6,37,California,Los Angeles County,12,1,574750,293901,280849
50,6,37,California,Los Angeles County,12,2,599582,307113,292469
50,6,37,California,Los Angeles County,12,3,602414,308609,293805
50,6,37,California,Los Angeles County,12,4,617171,313447,303724
50,6,37,California,Los Angeles County,12,5,675861,339956,335905
50,6,37,California,Los Angeles County,12,6,840564,427203,413361
50,6,37,California,Los Angeles County,12,7,795226,407368,387858
50,6,37,California,Los Angeles County,12,8,716505,363213,353292
50,6,37,California,Los Angeles County,12,9,653453,325720,327733
50,6,37,California,Los Angeles County,12,10,667944,330151,337793
50,6,37,California,Los Angeles County,12,11,649881,321829,328052
50,6,37,California,Los Angeles County,12,12,640389,312962,327427
50,6,37,California,Los Angeles County,12,13,569589,271978,297611
50,6,37,California,Los Angeles County,12,14,455637,211362,244275
50,6,37,California,Los Angeles County,12,15,349067,156889,192178
50,6,37,California,Los Angeles County,12,16,241827,104419,137408
50,6,37,California,Los Angeles County,12,17,169274,69718,99556
50,6,37,California,Los Angeles County,12,18,192468,69578,122890
50,6,37,California,Los Angeles County,13,0,9968969,4914145,5054824
50,6,37,California,Los Angeles County,13,1,558501,285117,273384
50,6,37,California,Los Angeles County,13,2,595408,305222,290186
50,6,37,California,Los Angeles County,13,3,596303,305500,290803
50,6,37,California,Los Angeles County,13,4,608743,309150,299593
50,6,37,California,Los Angeles County,13,5,663067,333562,329505
50,6,37,California,Los Angeles County,13,6,822251,417288,404963
50,6,37,California,Los Angeles County,13,7,806577,413435,393142
50,6,37,California,Los Angeles County,13,8,713571,361722,351849
50,6,37,California,Los Angeles County,13,9,653534,326674,326860
50,6,37,California,Los Angeles County,13,10,653881,322797,331084
50,6,37,California,Los Angeles County,13,11,649174,321823,327351
50,6,37,California,Los Angeles County,13,12,635057,310510,324547
50,6,37,California,Los Angeles County,13,13,574495,275159,299336
50,6,37,California,Los Angeles County,13,14,463817,215677,248140
50,6,37,California,Los Angeles County,13,15,359895,161729,198166
50,6,37,California,Los Angeles County,13,16,248033,107247,140786
50,6,37,California,Los Angeles County,13,17,171811,70879,100932
50,6,37,California,Los Angeles County,13,18,194851,70654,124197
50,6,37,California,Los Angeles County,14,0,9943046,4901414,5041632
50,6,37,California,Los Angeles County,14,1,552762,281963,270799
50,6,37,California,Los Angeles County,14,2,592947,304065,288882
50,6,37,California,Los Angeles County,14,3,593663,304187,289476
50,6,37,California,Los Angeles County,14,4,604891,307171,297720
50,6,37,California,Los Angeles County,14,5,657531,330747,326784
50,6,37,California,Los Angeles County,14,6,814453,413226,401227
50,6,37,California,Los Angeles County,14,7,809920,415162,394758
50,6,37,California,Los Angeles County,14,8,712793,361465,351328
50,6,37,California,Los Angeles County,14,9,653121,326780,326341
50,6,37,California,Los Angeles County,14,10,649217,320390,328827
50,6,37,California,Los Angeles County,14,11,649273,321940,327333
50,6,37,California,Los Angeles County,14,12,632603,309470,323133
50,6,37,California,Los Angeles County,14,13,575392,275721,299671
50,6,37,California,Los Angeles County,14,14,466157,216978,249179
50,6,37,California,Los Angeles County,14,15,362475,162789,199686
50,6,37,California,Los Angeles County,14,16,249403,107843,141560
50,6,37,California,Los Angeles County,14,17,172239,71078,101161
50,6,37,California,Los Angeles County,14,18,194206,70439,123767
50,6,39,California,Madera County,1,0,150865,72682,78183
50,6,39,California,Madera County,1,1,11983,6052,5931
50,6,39,California,Madera County,1,2,11756,5899,5857
50,6,39,California,Madera County,1,3,11755,6093,5662
50,6,39,California,Madera County,1,4,12224,6515,5709
50,6,39,California,Madera County,1,5,11032,5547,5485
50,6,39,California,Madera County,1,6,10541,4846,5695
50,6,39,California,Madera County,1,7,10021,4524,5497
50,6,39,California,Madera County,1,8,9661,4368,5293
50,6,39,California,Madera County,1,9,9506,4325,5181
50,6,39,California,Madera County,1,10,9893,4473,5420
50,6,39,California,Madera County,1,11,9398,4378,5020
50,6,39,California,Madera County,1,12,8467,3996,4471
50,6,39,California,Madera County,1,13,7366,3598,3768
50,6,39,California,Madera County,1,14,5642,2714,2928
50,6,39,California,Madera County,1,15,4226,2049,2177
50,6,39,California,Madera County,1,16,3240,1557,1683
50,6,39,California,Madera County,1,17,2228,988,1240
50,6,39,California,Madera County,1,18,1926,760,1166
50,6,39,California,Madera County,2,0,150834,72665,78169
50,6,39,California,Madera County,2,1,11977,6050,5927
50,6,39,California,Madera County,2,2,11755,5898,5857
50,6,39,California,Madera County,2,3,11753,6092,5661
50,6,39,California,Madera County,2,4,12220,6512,5708
50,6,39,California,Madera County,2,5,11024,5542,5482
50,6,39,California,Madera County,2,6,10538,4845,5693
50,6,39,California,Madera County,2,7,10019,4523,5496
50,6,39,California,Madera County,2,8,9661,4368,5293
50,6,39,California,Madera County,2,9,9505,4325,5180
50,6,39,California,Madera County,2,10,9893,4473,5420
50,6,39,California,Madera County,2,11,9397,4377,5020
50,6,39,California,Madera County,2,12,8466,3995,4471
50,6,39,California,Madera County,2,13,7366,3598,3768
50,6,39,California,Madera County,2,14,5642,2714,2928
50,6,39,California,Madera County,2,15,4226,2049,2177
50,6,39,California,Madera County,2,16,3238,1556,1682
50,6,39,California,Madera County,2,17,2228,988,1240
50,6,39,California,Madera County,2,18,1926,760,1166
50,6,39,California,Madera County,3,0,151006,72766,78240
50,6,39,California,Madera County,3,1,11983,6042,5941
50,6,39,California,Madera County,3,2,11800,5920,5880
50,6,39,California,Madera County,3,3,11747,6093,5654
50,6,39,California,Madera County,3,4,12136,6440,5696
50,6,39,California,Madera County,3,5,11097,5571,5526
50,6,39,California,Madera County,3,6,10552,4873,5679
50,6,39,California,Madera County,3,7,10045,4545,5500
50,6,39,California,Madera County,3,8,9631,4375,5256
50,6,39,California,Madera County,3,9,9497,4315,5182
50,6,39,California,Madera County,3,10,9856,4464,5392
50,6,39,California,Madera County,3,11,9408,4377,5031
50,6,39,California,Madera County,3,12,8490,4014,4476
50,6,39,California,Madera County,3,13,7456,3649,3807
50,6,39,California,Madera County,3,14,5640,2715,2925
50,6,39,California,Madera County,3,15,4269,2067,2202
50,6,39,California,Madera County,3,16,3223,1547,1676
50,6,39,California,Madera County,3,17,2234,994,1240
50,6,39,California,Madera County,3,18,1942,765,1177
50,6,39,California,Madera County,4,0,151685,73103,78582
50,6,39,California,Madera County,4,1,11943,6036,5907
50,6,39,California,Madera County,4,2,11860,5962,5898
50,6,39,California,Madera County,4,3,11753,6081,5672
50,6,39,California,Madera County,4,4,11819,6184,5635
50,6,39,California,Madera County,4,5,11346,5725,5621
50,6,39,California,Madera County,4,6,10665,4964,5701
50,6,39,California,Madera County,4,7,10168,4606,5562
50,6,39,California,Madera County,4,8,9452,4292,5160
50,6,39,California,Madera County,4,9,9512,4325,5187
50,6,39,California,Madera County,4,10,9665,4377,5288
50,6,39,California,Madera County,4,11,9435,4400,5035
50,6,39,California,Madera County,4,12,8570,4060,4510
50,6,39,California,Madera County,4,13,7830,3820,4010
50,6,39,California,Madera County,4,14,5756,2774,2982
50,6,39,California,Madera County,4,15,4435,2142,2293
50,6,39,California,Madera County,4,16,3222,1549,1673
50,6,39,California,Madera County,4,17,2294,1032,1262
50,6,39,California,Madera County,4,18,1960,774,1186
50,6,39,California,Madera County,5,0,151520,73457,78063
50,6,39,California,Madera County,5,1,11976,6049,5927
50,6,39,California,Madera County,5,2,11976,6023,5953
50,6,39,California,Madera County,5,3,11682,6022,5660
50,6,39,California,Madera County,5,4,11580,6056,5524
50,6,39,California,Madera County,5,5,11340,5720,5620
50,6,39,California,Madera County,5,6,10577,4989,5588
50,6,39,California,Madera County,5,7,10203,4711,5492
50,6,39,California,Madera County,5,8,9290,4263,5027
50,6,39,California,Madera County,5,9,9374,4330,5044
50,6,39,California,Madera County,5,10,9370,4307,5063
50,6,39,California,Madera County,5,11,9308,4374,4934
50,6,39,California,Madera County,5,12,8644,4129,4515
50,6,39,California,Madera County,5,13,7782,3788,3994
50,6,39,California,Madera County,5,14,6207,3029,3178
50,6,39,California,Madera County,5,15,4596,2240,2356
50,6,39,California,Madera County,5,16,3233,1543,1690
50,6,39,California,Madera County,5,17,2374,1083,1291
50,6,39,California,Madera County,5,18,2008,801,1207
50,6,39,California,Madera County,6,0,151295,73509,77786
50,6,39,California,Madera County,6,1,11774,5963,5811
50,6,39,California,Madera County,6,2,12167,6093,6074
50,6,39,California,Madera County,6,3,11577,5938,5639
50,6,39,California,Madera County,6,4,11399,5896,5503
50,6,39,California,Madera County,6,5,11326,5687,5639
50,6,39,California,Madera County,6,6,10366,4984,5382
50,6,39,California,Madera County,6,7,10243,4750,5493
50,6,39,California,Madera County,6,8,9314,4294,5020
50,6,39,California,Madera County,6,9,9322,4376,4946
50,6,39,California,Madera County,6,10,9111,4256,4855
50,6,39,California,Madera County,6,11,9242,4326,4916
50,6,39,California,Madera County,6,12,8627,4151,4476
50,6,39,California,Madera County,6,13,7952,3845,4107
50,6,39,California,Madera County,6,14,6388,3100,3288
50,6,39,California,Madera County,6,15,4743,2324,2419
50,6,39,California,Madera County,6,16,3302,1580,1722
50,6,39,California,Madera County,6,17,2344,1113,1231
50,6,39,California,Madera County,6,18,2098,833,1265
50,6,39,California,Madera County,7,0,153357,73794,79563
50,6,39,California,Madera County,7,1,11785,6021,5764
50,6,39,California,Madera County,7,2,12256,6158,6098
50,6,39,California,Madera County,7,3,11593,5878,5715
50,6,39,California,Madera County,7,4,11245,5799,5446
50,6,39,California,Madera County,7,5,11496,5678,5818
50,6,39,California,Madera County,7,6,10677,4982,5695
50,6,39,California,Madera County,7,7,10453,4781,5672
50,6,39,California,Madera County,7,8,9625,4382,5243
50,6,39,California,Madera County,7,9,9498,4320,5178
50,6,39,California,Madera County,7,10,9125,4221,4904
50,6,39,California,Madera County,7,11,9311,4281,5030
50,6,39,California,Madera County,7,12,8717,4181,4536
50,6,39,California,Madera County,7,13,8086,3901,4185
50,6,39,California,Madera County,7,14,6713,3255,3458
50,6,39,California,Madera County,7,15,4867,2332,2535
50,6,39,California,Madera County,7,16,3397,1639,1758
50,6,39,California,Madera County,7,17,2349,1106,1243
50,6,39,California,Madera County,7,18,2164,879,1285
50,6,39,California,Madera County,8,0,153448,73984,79464
50,6,39,California,Madera County,8,1,11790,6003,5787
50,6,39,California,Madera County,8,2,12161,6133,6028
50,6,39,California,Madera County,8,3,11650,5864,5786
50,6,39,California,Madera County,8,4,11093,5776,5317
50,6,39,California,Madera County,8,5,11241,5498,5743
50,6,39,California,Madera County,8,6,10836,5119,5717
50,6,39,California,Madera County,8,7,10358,4806,5552
50,6,39,California,Madera County,8,8,9758,4442,5316
50,6,39,California,Madera County,8,9,9317,4237,5080
50,6,39,California,Madera County,8,10,9053,4176,4877
50,6,39,California,Madera County,8,11,9108,4246,4862
50,6,39,California,Madera County,8,12,8860,4242,4618
50,6,39,California,Madera County,8,13,8130,3925,4205
50,6,39,California,Madera County,8,14,7055,3433,3622
50,6,39,California,Madera County,8,15,5020,2432,2588
50,6,39,California,Madera County,8,16,3498,1683,1815
50,6,39,California,Madera County,8,17,2329,1082,1247
50,6,39,California,Madera County,8,18,2191,887,1304
50,6,39,California,Madera County,9,0,153694,74274,79420
50,6,39,California,Madera County,9,1,11624,5902,5722
50,6,39,California,Madera County,9,2,12186,6180,6006
50,6,39,California,Madera County,9,3,11729,5898,5831
50,6,39,California,Madera County,9,4,11106,5781,5325
50,6,39,California,Madera County,9,5,10898,5281,5617
50,6,39,California,Madera County,9,6,10996,5284,5712
50,6,39,California,Madera County,9,7,10305,4843,5462
50,6,39,California,Madera County,9,8,9833,4478,5355
50,6,39,California,Madera County,9,9,9152,4161,4991
50,6,39,California,Madera County,9,10,9131,4242,4889
50,6,39,California,Madera County,9,11,8972,4244,4728
50,6,39,California,Madera County,9,12,8897,4233,4664
50,6,39,California,Madera County,9,13,8161,3948,4213
50,6,39,California,Madera County,9,14,7348,3560,3788
50,6,39,California,Madera County,9,15,5132,2502,2630
50,6,39,California,Madera County,9,16,3668,1747,1921
50,6,39,California,Madera County,9,17,2317,1062,1255
50,6,39,California,Madera County,9,18,2239,928,1311
50,6,39,California,Madera County,10,0,155079,74816,80263
50,6,39,California,Madera County,10,1,11623,5966,5657
50,6,39,California,Madera County,10,2,12180,6171,6009
50,6,39,California,Madera County,10,3,11972,6027,5945
50,6,39,California,Madera County,10,4,11055,5742,5313
50,6,39,California,Madera County,10,5,10748,5141,5607
50,6,39,California,Madera County,10,6,11366,5431,5935
50,6,39,California,Madera County,10,7,10385,4847,5538
50,6,39,California,Madera County,10,8,10071,4587,5484
50,6,39,California,Madera County,10,9,9186,4184,5002
50,6,39,California,Madera County,10,10,9160,4198,4962
50,6,39,California,Madera County,10,11,8825,4188,4637
50,6,39,California,Madera County,10,12,8896,4251,4645
50,6,39,California,Madera County,10,13,8373,4035,4338
50,6,39,California,Madera County,10,14,7292,3544,3748
50,6,39,California,Madera County,10,15,5539,2688,2851
50,6,39,California,Madera County,10,16,3769,1808,1961
50,6,39,California,Madera County,10,17,2301,1038,1263
50,6,39,California,Madera County,10,18,2338,970,1368
50,6,39,California,Madera County,11,0,156373,75426,80947
50,6,39,California,Madera County,11,1,11519,5917,5602
50,6,39,California,Madera County,11,2,12173,6237,5936
50,6,39,California,Madera County,11,3,12282,6161,6121
50,6,39,California,Madera County,11,4,11065,5713,5352
50,6,39,California,Madera County,11,5,10684,5094,5590
50,6,39,California,Madera County,11,6,11532,5466,6066
50,6,39,California,Madera County,11,7,10397,4888,5509
50,6,39,California,Madera County,11,8,10357,4740,5617
50,6,39,California,Madera County,11,9,9327,4152,5175
50,6,39,California,Madera County,11,10,9216,4250,4966
50,6,39,California,Madera County,11,11,8741,4145,4596
50,6,39,California,Madera County,11,12,8876,4277,4599
50,6,39,California,Madera County,11,13,8369,4008,4361
50,6,39,California,Madera County,11,14,7489,3673,3816
50,6,39,California,Madera County,11,15,5756,2768,2988
50,6,39,California,Madera County,11,16,3872,1855,2017
50,6,39,California,Madera County,11,17,2359,1081,1278
50,6,39,California,Madera County,11,18,2359,1001,1358
50,6,39,California,Madera County,12,0,156717,75663,81054
50,6,39,California,Madera County,12,1,11340,5841,5499
50,6,39,California,Madera County,12,2,12237,6233,6004
50,6,39,California,Madera County,12,3,12354,6226,6128
50,6,39,California,Madera County,12,4,11090,5615,5475
50,6,39,California,Madera County,12,5,10420,5004,5416
50,6,39,California,Madera County,12,6,11372,5394,5978
50,6,39,California,Madera County,12,7,10528,4927,5601
50,6,39,California,Madera County,12,8,10362,4837,5525
50,6,39,California,Madera County,12,9,9437,4257,5180
50,6,39,California,Madera County,12,10,9205,4224,4981
50,6,39,California,Madera County,12,11,8572,4132,4440
50,6,39,California,Madera County,12,12,8834,4257,4577
50,6,39,California,Madera County,12,13,8433,4042,4391
50,6,39,California,Madera County,12,14,7598,3687,3911
50,6,39,California,Madera County,12,15,6030,2913,3117
50,6,39,California,Madera County,12,16,4000,1884,2116
50,6,39,California,Madera County,12,17,2520,1182,1338
50,6,39,California,Madera County,12,18,2385,1008,1377
50,6,39,California,Madera County,13,0,157606,76192,81414
50,6,39,California,Madera County,13,1,11172,5766,5406
50,6,39,California,Madera County,13,2,12381,6304,6077
50,6,39,California,Madera County,13,3,12441,6258,6183
50,6,39,California,Madera County,13,4,11217,5656,5561
50,6,39,California,Madera County,13,5,10345,5018,5327
50,6,39,California,Madera County,13,6,11259,5335,5924
50,6,39,California,Madera County,13,7,10697,5053,5644
50,6,39,California,Madera County,13,8,10419,4863,5556
50,6,39,California,Madera County,13,9,9643,4386,5257
50,6,39,California,Madera County,13,10,9138,4169,4969
50,6,39,California,Madera County,13,11,8595,4150,4445
50,6,39,California,Madera County,13,12,8752,4291,4461
50,6,39,California,Madera County,13,13,8547,4101,4446
50,6,39,California,Madera County,13,14,7648,3685,3963
50,6,39,California,Madera County,13,15,6242,3001,3241
50,6,39,California,Madera County,13,16,4094,1929,2165
50,6,39,California,Madera County,13,17,2583,1208,1375
50,6,39,California,Madera County,13,18,2433,1019,1414
50,6,39,California,Madera County,14,0,157761,76283,81478
50,6,39,California,Madera County,14,1,11111,5735,5376
50,6,39,California,Madera County,14,2,12411,6321,6090
50,6,39,California,Madera County,14,3,12459,6262,6197
50,6,39,California,Madera County,14,4,11251,5667,5584
50,6,39,California,Madera County,14,5,10311,5013,5298
50,6,39,California,Madera County,14,6,11206,5306,5900
50,6,39,California,Madera County,14,7,10751,5094,5657
50,6,39,California,Madera County,14,8,10444,4880,5564
50,6,39,California,Madera County,14,9,9705,4424,5281
50,6,39,California,Madera County,14,10,9118,4153,4965
50,6,39,California,Madera County,14,11,8614,4158,4456
50,6,39,California,Madera County,14,12,8720,4301,4419
50,6,39,California,Madera County,14,13,8568,4112,4456
50,6,39,California,Madera County,14,14,7660,3679,3981
50,6,39,California,Madera County,14,15,6300,3020,3280
50,6,39,California,Madera County,14,16,4104,1931,2173
50,6,39,California,Madera County,14,17,2596,1212,1384
50,6,39,California,Madera County,14,18,2432,1015,1417
50,6,41,California,Marin County,1,0,252409,124072,128337
50,6,41,California,Marin County,1,1,13932,7118,6814
50,6,41,California,Marin County,1,2,15481,7919,7562
50,6,41,California,Marin County,1,3,14241,7153,7088
50,6,41,California,Marin County,1,4,12798,6758,6040
50,6,41,California,Marin County,1,5,10308,5707,4601
50,6,41,California,Marin County,1,6,11960,6449,5511
50,6,41,California,Marin County,1,7,12876,6598,6278
50,6,41,California,Marin County,1,8,16376,8226,8150
50,6,41,California,Marin County,1,9,20102,9988,10114
50,6,41,California,Marin County,1,10,20971,10411,10560
50,6,41,California,Marin County,1,11,21084,10185,10899
50,6,41,California,Marin County,1,12,20826,9873,10953
50,6,41,California,Marin County,1,13,19262,9031,10231
50,6,41,California,Marin County,1,14,14037,6784,7253
50,6,41,California,Marin County,1,15,9174,4278,4896
50,6,41,California,Marin County,1,16,6837,3124,3713
50,6,41,California,Marin County,1,17,5588,2275,3313
50,6,41,California,Marin County,1,18,6556,2195,4361
50,6,41,California,Marin County,2,0,252425,124083,128342
50,6,41,California,Marin County,2,1,13932,7118,6814
50,6,41,California,Marin County,2,2,15479,7918,7561
50,6,41,California,Marin County,2,3,14240,7153,7087
50,6,41,California,Marin County,2,4,12796,6758,6038
50,6,41,California,Marin County,2,5,10312,5710,4602
50,6,41,California,Marin County,2,6,11961,6449,5512
50,6,41,California,Marin County,2,7,12877,6599,6278
50,6,41,California,Marin County,2,8,16376,8226,8150
50,6,41,California,Marin County,2,9,20102,9988,10114
50,6,41,California,Marin County,2,10,20973,10411,10562
50,6,41,California,Marin County,2,11,21089,10189,10900
50,6,41,California,Marin County,2,12,20826,9873,10953
50,6,41,California,Marin County,2,13,19266,9033,10233
50,6,41,California,Marin County,2,14,14036,6783,7253
50,6,41,California,Marin County,2,15,9175,4278,4897
50,6,41,California,Marin County,2,16,6839,3125,3714
50,6,41,California,Marin County,2,17,5589,2276,3313
50,6,41,California,Marin County,2,18,6557,2196,4361
50,6,41,California,Marin County,3,0,252906,124358,128548
50,6,41,California,Marin County,3,1,13848,7072,6776
50,6,41,California,Marin County,3,2,15509,7945,7564
50,6,41,California,Marin County,3,3,14314,7191,7123
50,6,41,California,Marin County,3,4,12982,6838,6144
50,6,41,California,Marin County,3,5,10246,5679,4567
50,6,41,California,Marin County,3,6,11933,6436,5497
50,6,41,California,Marin County,3,7,12883,6618,6265
50,6,41,California,Marin County,3,8,16195,8131,8064
50,6,41,California,Marin County,3,9,20102,10007,10095
50,6,41,California,Marin County,3,10,20949,10405,10544
50,6,41,California,Marin County,3,11,21112,10197,10915
50,6,41,California,Marin County,3,12,20852,9885,10967
50,6,41,California,Marin County,3,13,19377,9098,10279
50,6,41,California,Marin County,3,14,14301,6897,7404
50,6,41,California,Marin County,3,15,9266,4316,4950
50,6,41,California,Marin County,3,16,6829,3137,3692
50,6,41,California,Marin County,3,17,5610,2301,3309
50,6,41,California,Marin County,3,18,6598,2205,4393
50,6,41,California,Marin County,4,0,255380,125514,129866
50,6,41,California,Marin County,4,1,13669,6995,6674
50,6,41,California,Marin County,4,2,15705,8027,7678
50,6,41,California,Marin County,4,3,14721,7385,7336
50,6,41,California,Marin County,4,4,13529,7046,6483
50,6,41,California,Marin County,4,5,10211,5669,4542
50,6,41,California,Marin County,4,6,11604,6267,5337
50,6,41,California,Marin County,4,7,12991,6681,6310
50,6,41,California,Marin County,4,8,15499,7768,7731
50,6,41,California,Marin County,4,9,20148,10079,10069
50,6,41,California,Marin County,4,10,20904,10394,10510
50,6,41,California,Marin County,4,11,21277,10285,10992
50,6,41,California,Marin County,4,12,20861,9909,10952
50,6,41,California,Marin County,4,13,19989,9414,10575
50,6,41,California,Marin County,4,14,15123,7200,7923
50,6,41,California,Marin County,4,15,9731,4527,5204
50,6,41,California,Marin County,4,16,6896,3178,3718
50,6,41,California,Marin County,4,17,5725,2409,3316
50,6,41,California,Marin County,4,18,6797,2281,4516
50,6,41,California,Marin County,5,0,256087,125313,130774
50,6,41,California,Marin County,5,1,13261,6805,6456
50,6,41,California,Marin County,5,2,15847,8067,7780
50,6,41,California,Marin County,5,3,15089,7589,7500
50,6,41,California,Marin County,5,4,13683,7042,6641
50,6,41,California,Marin County,5,5,10384,5714,4670
50,6,41,California,Marin County,5,6,11151,6007,5144
50,6,41,California,Marin County,5,7,12760,6544,6216
50,6,41,California,Marin County,5,8,15080,7474,7606
50,6,41,California,Marin County,5,9,19811,9898,9913
50,6,41,California,Marin County,5,10,20659,10148,10511
50,6,41,California,Marin County,5,11,21118,10236,10882
50,6,41,California,Marin County,5,12,20659,9739,10920
50,6,41,California,Marin County,5,13,19713,9249,10464
50,6,41,California,Marin County,5,14,16443,7780,8663
50,6,41,California,Marin County,5,15,10533,4902,5631
50,6,41,California,Marin County,5,16,7161,3295,3866
50,6,41,California,Marin County,5,17,5781,2472,3309
50,6,41,California,Marin County,5,18,6954,2352,4602
50,6,41,California,Marin County,6,0,258441,126133,132308
50,6,41,California,Marin County,6,1,12810,6482,6328
50,6,41,California,Marin County,6,2,15995,8178,7817
50,6,41,California,Marin County,6,3,15716,7922,7794
50,6,41,California,Marin County,6,4,13718,6955,6763
50,6,41,California,Marin County,6,5,10950,5901,5049
50,6,41,California,Marin County,6,6,10940,5942,4998
50,6,41,California,Marin County,6,7,12715,6507,6208
50,6,41,California,Marin County,6,8,14884,7359,7525
50,6,41,California,Marin County,6,9,19501,9645,9856
50,6,41,California,Marin County,6,10,20687,10229,10458
50,6,41,California,Marin County,6,11,21061,10275,10786
50,6,41,California,Marin County,6,12,20524,9651,10873
50,6,41,California,Marin County,6,13,19890,9305,10585
50,6,41,California,Marin County,6,14,16969,7940,9029
50,6,41,California,Marin County,6,15,11629,5413,6216
50,6,41,California,Marin County,6,16,7510,3476,4034
50,6,41,California,Marin County,6,17,5786,2483,3303
50,6,41,California,Marin County,6,18,7156,2470,4686
50,6,41,California,Marin County,7,0,260403,127090,133313
50,6,41,California,Marin County,7,1,12702,6443,6259
50,6,41,California,Marin County,7,2,15836,8059,7777
50,6,41,California,Marin County,7,3,16184,8180,8004
50,6,41,California,Marin County,7,4,13795,6911,6884
50,6,41,California,Marin County,7,5,11522,6167,5355
50,6,41,California,Marin County,7,6,10671,5819,4852
50,6,41,California,Marin County,7,7,12750,6562,6188
50,6,41,California,Marin County,7,8,14722,7262,7460
50,6,41,California,Marin County,7,9,18906,9377,9529
50,6,41,California,Marin County,7,10,20801,10339,10462
50,6,41,California,Marin County,7,11,21054,10309,10745
50,6,41,California,Marin County,7,12,20381,9641,10740
50,6,41,California,Marin County,7,13,20001,9360,10641
50,6,41,California,Marin County,7,14,17563,8121,9442
50,6,41,California,Marin County,7,15,12329,5748,6581
50,6,41,California,Marin County,7,16,8035,3732,4303
50,6,41,California,Marin County,7,17,5769,2490,3279
50,6,41,California,Marin County,7,18,7382,2570,4812
50,6,41,California,Marin County,8,0,260974,127426,133548
50,6,41,California,Marin County,8,1,12562,6355,6207
50,6,41,California,Marin County,8,2,15464,7878,7586
50,6,41,California,Marin County,8,3,16444,8372,8072
50,6,41,California,Marin County,8,4,14041,6997,7044
50,6,41,California,Marin County,8,5,11883,6367,5516
50,6,41,California,Marin County,8,6,10502,5718,4784
50,6,41,California,Marin County,8,7,12444,6464,5980
50,6,41,California,Marin County,8,8,14677,7237,7440
50,6,41,California,Marin County,8,9,17927,8965,8962
50,6,41,California,Marin County,8,10,20976,10348,10628
50,6,41,California,Marin County,8,11,20790,10235,10555
50,6,41,California,Marin County,8,12,20522,9778,10744
50,6,41,California,Marin County,8,13,19810,9194,10616
50,6,41,California,Marin County,8,14,18084,8300,9784
50,6,41,California,Marin County,8,15,13154,6184,6970
50,6,41,California,Marin County,8,16,8384,3803,4581
50,6,41,California,Marin County,8,17,5784,2575,3209
50,6,41,California,Marin County,8,18,7526,2656,4870
50,6,41,California,Marin County,9,0,260722,127161,133561
50,6,41,California,Marin County,9,1,12482,6345,6137
50,6,41,California,Marin County,9,2,14904,7560,7344
50,6,41,California,Marin County,9,3,16659,8498,8161
50,6,41,California,Marin County,9,4,14297,7120,7177
50,6,41,California,Marin County,9,5,11963,6328,5635
50,6,41,California,Marin County,9,6,10362,5636,4726
50,6,41,California,Marin County,9,7,12133,6314,5819
50,6,41,California,Marin County,9,8,14703,7225,7478
50,6,41,California,Marin County,9,9,17068,8520,8548
50,6,41,California,Marin County,9,10,20894,10371,10523
50,6,41,California,Marin County,9,11,20596,10115,10481
50,6,41,California,Marin County,9,12,20481,9763,10718
50,6,41,California,Marin County,9,13,19715,9162,10553
50,6,41,California,Marin County,9,14,18389,8453,9936
50,6,41,California,Marin County,9,15,13762,6395,7367
50,6,41,California,Marin County,9,16,8770,3973,4797
50,6,41,California,Marin County,9,17,5820,2607,3213
50,6,41,California,Marin County,9,18,7724,2776,4948
50,6,41,California,Marin County,10,0,259975,126933,133042
50,6,41,California,Marin County,10,1,12211,6176,6035
50,6,41,California,Marin County,10,2,14414,7335,7079
50,6,41,California,Marin County,10,3,16596,8450,8146
50,6,41,California,Marin County,10,4,14593,7306,7287
50,6,41,California,Marin County,10,5,11905,6179,5726
50,6,41,California,Marin County,10,6,10502,5782,4720
50,6,41,California,Marin County,10,7,11860,6209,5651
50,6,41,California,Marin County,10,8,14409,7208,7201
50,6,41,California,Marin County,10,9,16630,8282,8348
50,6,41,California,Marin County,10,10,20562,10234,10328
50,6,41,California,Marin County,10,11,20441,10042,10399
50,6,41,California,Marin County,10,12,20270,9703,10567
50,6,41,California,Marin County,10,13,19428,9107,10321
50,6,41,California,Marin County,10,14,18058,8225,9833
50,6,41,California,Marin County,10,15,14937,6913,8024
50,6,41,California,Marin County,10,16,9371,4288,5083
50,6,41,California,Marin County,10,17,6046,2665,3381
50,6,41,California,Marin County,10,18,7742,2829,4913
50,6,41,California,Marin County,11,0,260091,127092,132999
50,6,41,California,Marin County,11,1,12006,6062,5944
50,6,41,California,Marin County,11,2,13897,7011,6886
50,6,41,California,Marin County,11,3,16424,8358,8066
50,6,41,California,Marin County,11,4,15151,7643,7508
50,6,41,California,Marin County,11,5,11946,6122,5824
50,6,41,California,Marin County,11,6,10752,5869,4883
50,6,41,California,Marin County,11,7,11712,6217,5495
50,6,41,California,Marin County,11,8,14315,7213,7102
50,6,41,California,Marin County,11,9,16181,8123,8058
50,6,41,California,Marin County,11,10,19968,9872,10096
50,6,41,California,Marin County,11,11,20259,10043,10216
50,6,41,California,Marin County,11,12,20143,9733,10410
50,6,41,California,Marin County,11,13,19353,9066,10287
50,6,41,California,Marin County,11,14,18093,8274,9819
50,6,41,California,Marin County,11,15,15379,7058,8321
50,6,41,California,Marin County,11,16,10322,4715,5607
50,6,41,California,Marin County,11,17,6335,2837,3498
50,6,41,California,Marin County,11,18,7855,2876,4979
50,6,41,California,Marin County,12,0,259085,126664,132421
50,6,41,California,Marin County,12,1,11580,5876,5704
50,6,41,California,Marin County,12,2,13554,6870,6684
50,6,41,California,Marin County,12,3,16088,8168,7920
50,6,41,California,Marin County,12,4,15516,7842,7674
50,6,41,California,Marin County,12,5,11754,5951,5803
50,6,41,California,Marin County,12,6,10812,5874,4938
50,6,41,California,Marin County,12,7,11528,6137,5391
50,6,41,California,Marin County,12,8,14327,7218,7109
50,6,41,California,Marin County,12,9,15776,7963,7813
50,6,41,California,Marin County,12,10,19247,9519,9728
50,6,41,California,Marin County,12,11,20394,10104,10290
50,6,41,California,Marin County,12,12,19922,9714,10208
50,6,41,California,Marin County,12,13,19095,8996,10099
50,6,41,California,Marin County,12,14,18095,8236,9859
50,6,41,California,Marin County,12,15,15755,7181,8574
50,6,41,California,Marin County,12,16,10938,5018,5920
50,6,41,California,Marin County,12,17,6764,3037,3727
50,6,41,California,Marin County,12,18,7940,2960,4980
50,6,41,California,Marin County,13,0,257948,126198,131750
50,6,41,California,Marin County,13,1,11402,5820,5582
50,6,41,California,Marin County,13,2,13313,6690,6623
50,6,41,California,Marin County,13,3,15665,8011,7654
50,6,41,California,Marin County,13,4,15497,7873,7624
50,6,41,California,Marin County,13,5,11711,5893,5818
50,6,41,California,Marin County,13,6,10716,5806,4910
50,6,41,California,Marin County,13,7,11659,6230,5429
50,6,41,California,Marin County,13,8,14169,7190,6979
50,6,41,California,Marin County,13,9,15664,7837,7827
50,6,41,California,Marin County,13,10,18408,9165,9243
50,6,41,California,Marin County,13,11,20537,10170,10367
50,6,41,California,Marin County,13,12,19720,9648,10072
50,6,41,California,Marin County,13,13,18992,8988,10004
50,6,41,California,Marin County,13,14,18041,8222,9819
50,6,41,California,Marin County,13,15,16044,7265,8779
50,6,41,California,Marin County,13,16,11463,5298,6165
50,6,41,California,Marin County,13,17,6926,3055,3871
50,6,41,California,Marin County,13,18,8021,3037,4984
50,6,41,California,Marin County,14,0,257332,125933,131399
50,6,41,California,Marin County,14,1,11327,5793,5534
50,6,41,California,Marin County,14,2,13211,6620,6591
50,6,41,California,Marin County,14,3,15524,7957,7567
50,6,41,California,Marin County,14,4,15473,7877,7596
50,6,41,California,Marin County,14,5,11679,5863,5816
50,6,41,California,Marin County,14,6,10670,5780,4890
50,6,41,California,Marin County,14,7,11710,6263,5447
50,6,41,California,Marin County,14,8,14127,7189,6938
50,6,41,California,Marin County,14,9,15640,7800,7840
50,6,41,California,Marin County,14,10,18126,9048,9078
50,6,41,California,Marin County,14,11,20620,10203,10417
50,6,41,California,Marin County,14,12,19638,9620,10018
50,6,41,California,Marin County,14,13,18932,8971,9961
50,6,41,California,Marin County,14,14,18014,8215,9799
50,6,41,California,Marin County,14,15,16090,7266,8824
50,6,41,California,Marin County,14,16,11598,5374,6224
50,6,41,California,Marin County,14,17,6964,3056,3908
50,6,41,California,Marin County,14,18,7989,3038,4951
50,6,43,California,Mariposa County,1,0,18251,9269,8982
50,6,43,California,Mariposa County,1,1,775,381,394
50,6,43,California,Mariposa County,1,2,821,426,395
50,6,43,California,Mariposa County,1,3,987,495,492
50,6,43,California,Mariposa County,1,4,1026,517,509
50,6,43,California,Mariposa County,1,5,827,450,377
50,6,43,California,Mariposa County,1,6,828,427,401
50,6,43,California,Mariposa County,1,7,823,423,400
50,6,43,California,Mariposa County,1,8,840,447,393
50,6,43,California,Mariposa County,1,9,988,494,494
50,6,43,California,Mariposa County,1,10,1456,739,717
50,6,43,California,Mariposa County,1,11,1776,890,886
50,6,43,California,Mariposa County,1,12,1693,822,871
50,6,43,California,Mariposa County,1,13,1590,872,718
50,6,43,California,Mariposa County,1,14,1304,654,650
50,6,43,California,Mariposa County,1,15,949,499,450
50,6,43,California,Mariposa County,1,16,707,339,368
50,6,43,California,Mariposa County,1,17,479,250,229
50,6,43,California,Mariposa County,1,18,382,144,238
50,6,43,California,Mariposa County,2,0,18271,9279,8992
50,6,43,California,Mariposa County,2,1,776,381,395
50,6,43,California,Mariposa County,2,2,824,427,397
50,6,43,California,Mariposa County,2,3,988,496,492
50,6,43,California,Mariposa County,2,4,1026,517,509
50,6,43,California,Mariposa County,2,5,827,450,377
50,6,43,California,Mariposa County,2,6,830,428,402
50,6,43,California,Mariposa County,2,7,823,422,401
50,6,43,California,Mariposa County,2,8,842,449,393
50,6,43,California,Mariposa County,2,9,988,494,494
50,6,43,California,Mariposa County,2,10,1456,739,717
50,6,43,California,Mariposa County,2,11,1778,891,887
50,6,43,California,Mariposa County,2,12,1698,825,873
50,6,43,California,Mariposa County,2,13,1592,872,720
50,6,43,California,Mariposa County,2,14,1306,656,650
50,6,43,California,Mariposa County,2,15,949,499,450
50,6,43,California,Mariposa County,2,16,707,339,368
50,6,43,California,Mariposa County,2,17,479,250,229
50,6,43,California,Mariposa County,2,18,382,144,238
50,6,43,California,Mariposa County,3,0,18302,9305,8997
50,6,43,California,Mariposa County,3,1,773,381,392
50,6,43,California,Mariposa County,3,2,821,423,398
50,6,43,California,Mariposa County,3,3,976,494,482
50,6,43,California,Mariposa County,3,4,1013,507,506
50,6,43,California,Mariposa County,3,5,844,460,384
50,6,43,California,Mariposa County,3,6,848,438,410
50,6,43,California,Mariposa County,3,7,820,420,400
50,6,43,California,Mariposa County,3,8,840,448,392
50,6,43,California,Mariposa County,3,9,978,493,485
50,6,43,California,Mariposa County,3,10,1442,731,711
50,6,43,California,Mariposa County,3,11,1769,882,887
50,6,43,California,Mariposa County,3,12,1705,833,872
50,6,43,California,Mariposa County,3,13,1618,884,734
50,6,43,California,Mariposa County,3,14,1306,659,647
50,6,43,California,Mariposa County,3,15,956,505,451
50,6,43,California,Mariposa County,3,16,716,347,369
50,6,43,California,Mariposa County,3,17,487,252,235
50,6,43,California,Mariposa County,3,18,390,148,242
50,6,43,California,Mariposa County,4,0,18199,9251,8948
50,6,43,California,Mariposa County,4,1,781,399,382
50,6,43,California,Mariposa County,4,2,837,421,416
50,6,43,California,Mariposa County,4,3,941,487,454
50,6,43,California,Mariposa County,4,4,976,478,498
50,6,43,California,Mariposa County,4,5,876,457,419
50,6,43,California,Mariposa County,4,6,892,472,420
50,6,43,California,Mariposa County,4,7,847,438,409
50,6,43,California,Mariposa County,4,8,807,420,387
50,6,43,California,Mariposa County,4,9,940,480,460
50,6,43,California,Mariposa County,4,10,1326,691,635
50,6,43,California,Mariposa County,4,11,1704,823,881
50,6,43,California,Mariposa County,4,12,1696,850,846
50,6,43,California,Mariposa County,4,13,1667,875,792
50,6,43,California,Mariposa County,4,14,1296,665,631
50,6,43,California,Mariposa County,4,15,987,519,468
50,6,43,California,Mariposa County,4,16,711,358,353
50,6,43,California,Mariposa County,4,17,498,257,241
50,6,43,California,Mariposa County,4,18,417,161,256
50,6,43,California,Mariposa County,5,0,17912,9127,8785
50,6,43,California,Mariposa County,5,1,750,377,373
50,6,43,California,Mariposa County,5,2,800,403,397
50,6,43,California,Mariposa County,5,3,903,482,421
50,6,43,California,Mariposa County,5,4,968,478,490
50,6,43,California,Mariposa County,5,5,835,442,393
50,6,43,California,Mariposa County,5,6,862,454,408
50,6,43,California,Mariposa County,5,7,814,429,385
50,6,43,California,Mariposa County,5,8,786,414,372
50,6,43,California,Mariposa County,5,9,904,463,441
50,6,43,California,Mariposa County,5,10,1195,626,569
50,6,43,California,Mariposa County,5,11,1641,793,848
50,6,43,California,Mariposa County,5,12,1695,862,833
50,6,43,California,Mariposa County,5,13,1601,805,796
50,6,43,California,Mariposa County,5,14,1418,743,675
50,6,43,California,Mariposa County,5,15,1062,551,511
50,6,43,California,Mariposa County,5,16,716,368,348
50,6,43,California,Mariposa County,5,17,518,259,259
50,6,43,California,Mariposa County,5,18,444,178,266
50,6,43,California,Mariposa County,6,0,17840,9080,8760
50,6,43,California,Mariposa County,6,1,758,382,376
50,6,43,California,Mariposa County,6,2,791,402,389
50,6,43,California,Mariposa County,6,3,851,458,393
50,6,43,California,Mariposa County,6,4,958,487,471
50,6,43,California,Mariposa County,6,5,867,439,428
50,6,43,California,Mariposa County,6,6,860,454,406
50,6,43,California,Mariposa County,6,7,838,452,386
50,6,43,California,Mariposa County,6,8,781,399,382
50,6,43,California,Mariposa County,6,9,870,458,412
50,6,43,California,Mariposa County,6,10,1110,554,556
50,6,43,California,Mariposa County,6,11,1548,773,775
50,6,43,California,Mariposa County,6,12,1709,855,854
50,6,43,California,Mariposa County,6,13,1600,798,802
50,6,43,California,Mariposa County,6,14,1480,792,688
50,6,43,California,Mariposa County,6,15,1099,561,538
50,6,43,California,Mariposa County,6,16,741,384,357
50,6,43,California,Mariposa County,6,17,507,242,265
50,6,43,California,Mariposa County,6,18,472,190,282
50,6,43,California,Mariposa County,7,0,17745,9053,8692
50,6,43,California,Mariposa County,7,1,763,402,361
50,6,43,California,Mariposa County,7,2,789,391,398
50,6,43,California,Mariposa County,7,3,819,446,373
50,6,43,California,Mariposa County,7,4,892,450,442
50,6,43,California,Mariposa County,7,5,886,470,416
50,6,43,California,Mariposa County,7,6,886,468,418
50,6,43,California,Mariposa County,7,7,854,455,399
50,6,43,California,Mariposa County,7,8,737,376,361
50,6,43,California,Mariposa County,7,9,823,429,394
50,6,43,California,Mariposa County,7,10,1008,502,506
50,6,43,California,Mariposa County,7,11,1494,759,735
50,6,43,California,Mariposa County,7,12,1722,856,866
50,6,43,California,Mariposa County,7,13,1648,814,834
50,6,43,California,Mariposa County,7,14,1495,808,687
50,6,43,California,Mariposa County,7,15,1132,566,566
50,6,43,California,Mariposa County,7,16,801,423,378
50,6,43,California,Mariposa County,7,17,506,241,265
50,6,43,California,Mariposa County,7,18,490,197,293
50,6,43,California,Mariposa County,8,0,17653,8949,8704
50,6,43,California,Mariposa County,8,1,740,386,354
50,6,43,California,Mariposa County,8,2,767,357,410
50,6,43,California,Mariposa County,8,3,823,443,380
50,6,43,California,Mariposa County,8,4,874,465,409
50,6,43,California,Mariposa County,8,5,882,472,410
50,6,43,California,Mariposa County,8,6,903,479,424
50,6,43,California,Mariposa County,8,7,843,417,426
50,6,43,California,Mariposa County,8,8,814,416,398
50,6,43,California,Mariposa County,8,9,800,405,395
50,6,43,California,Mariposa County,8,10,964,495,469
50,6,43,California,Mariposa County,8,11,1373,694,679
50,6,43,California,Mariposa County,8,12,1687,817,870
50,6,43,California,Mariposa County,8,13,1644,809,835
50,6,43,California,Mariposa County,8,14,1541,820,721
50,6,43,California,Mariposa County,8,15,1170,595,575
50,6,43,California,Mariposa County,8,16,818,427,391
50,6,43,California,Mariposa County,8,17,522,252,270
50,6,43,California,Mariposa County,8,18,488,200,288
50,6,43,California,Mariposa County,9,0,17498,8893,8605
50,6,43,California,Mariposa County,9,1,774,386,388
50,6,43,California,Mariposa County,9,2,745,373,372
50,6,43,California,Mariposa County,9,3,834,423,411
50,6,43,California,Mariposa County,9,4,815,454,361
50,6,43,California,Mariposa County,9,5,838,448,390
50,6,43,California,Mariposa County,9,6,935,500,435
50,6,43,California,Mariposa County,9,7,892,463,429
50,6,43,California,Mariposa County,9,8,834,430,404
50,6,43,California,Mariposa County,9,9,779,392,387
50,6,43,California,Mariposa County,9,10,897,463,434
50,6,43,California,Mariposa County,9,11,1234,637,597
50,6,43,California,Mariposa County,9,12,1650,786,864
50,6,43,California,Mariposa County,9,13,1666,837,829
50,6,43,California,Mariposa County,9,14,1573,803,770
50,6,43,California,Mariposa County,9,15,1172,582,590
50,6,43,California,Mariposa County,9,16,835,445,390
50,6,43,California,Mariposa County,9,17,530,262,268
50,6,43,California,Mariposa County,9,18,495,209,286
50,6,43,California,Mariposa County,10,0,17461,8899,8562
50,6,43,California,Mariposa County,10,1,762,396,366
50,6,43,California,Mariposa County,10,2,774,389,385
50,6,43,California,Mariposa County,10,3,789,403,386
50,6,43,California,Mariposa County,10,4,787,423,364
50,6,43,California,Mariposa County,10,5,842,461,381
50,6,43,California,Mariposa County,10,6,968,510,458
50,6,43,California,Mariposa County,10,7,911,485,426
50,6,43,California,Mariposa County,10,8,849,433,416
50,6,43,California,Mariposa County,10,9,767,397,370
50,6,43,California,Mariposa County,10,10,892,447,445
50,6,43,California,Mariposa County,10,11,1109,579,530
50,6,43,California,Mariposa County,10,12,1611,778,833
50,6,43,California,Mariposa County,10,13,1675,840,835
50,6,43,California,Mariposa County,10,14,1544,768,776
50,6,43,California,Mariposa County,10,15,1257,652,605
50,6,43,California,Mariposa County,10,16,870,446,424
50,6,43,California,Mariposa County,10,17,536,278,258
50,6,43,California,Mariposa County,10,18,518,214,304
50,6,43,California,Mariposa County,11,0,17361,8804,8557
50,6,43,California,Mariposa County,11,1,750,399,351
50,6,43,California,Mariposa County,11,2,787,390,397
50,6,43,California,Mariposa County,11,3,790,386,404
50,6,43,California,Mariposa County,11,4,767,411,356
50,6,43,California,Mariposa County,11,5,828,457,371
50,6,43,California,Mariposa County,11,6,992,515,477
50,6,43,California,Mariposa County,11,7,883,466,417
50,6,43,California,Mariposa County,11,8,890,441,449
50,6,43,California,Mariposa County,11,9,775,403,372
50,6,43,California,Mariposa County,11,10,877,463,414
50,6,43,California,Mariposa County,11,11,1081,526,555
50,6,43,California,Mariposa County,11,12,1500,745,755
50,6,43,California,Mariposa County,11,13,1662,825,837
50,6,43,California,Mariposa County,11,14,1530,757,773
50,6,43,California,Mariposa County,11,15,1264,665,599
50,6,43,California,Mariposa County,11,16,910,452,458
50,6,43,California,Mariposa County,11,17,559,283,276
50,6,43,California,Mariposa County,11,18,516,220,296
50,6,43,California,Mariposa County,12,0,17117,8675,8442
50,6,43,California,Mariposa County,12,1,723,360,363
50,6,43,California,Mariposa County,12,2,774,394,380
50,6,43,California,Mariposa County,12,3,795,394,401
50,6,43,California,Mariposa County,12,4,772,409,363
50,6,43,California,Mariposa County,12,5,734,401,333
50,6,43,California,Mariposa County,12,6,972,521,451
50,6,43,California,Mariposa County,12,7,916,480,436
50,6,43,California,Mariposa County,12,8,868,446,422
50,6,43,California,Mariposa County,12,9,791,396,395
50,6,43,California,Mariposa County,12,10,854,457,397
50,6,43,California,Mariposa County,12,11,968,476,492
50,6,43,California,Mariposa County,12,12,1403,705,698
50,6,43,California,Mariposa County,12,13,1674,823,851
50,6,43,California,Mariposa County,12,14,1546,749,797
50,6,43,California,Mariposa County,12,15,1309,703,606
50,6,43,California,Mariposa County,12,16,906,435,471
50,6,43,California,Mariposa County,12,17,590,306,284
50,6,43,California,Mariposa County,12,18,522,220,302
50,6,43,California,Mariposa County,13,0,17182,8677,8505
50,6,43,California,Mariposa County,13,1,737,366,371
50,6,43,California,Mariposa County,13,2,795,398,397
50,6,43,California,Mariposa County,13,3,796,384,412
50,6,43,California,Mariposa County,13,4,764,402,362
50,6,43,California,Mariposa County,13,5,735,402,333
50,6,43,California,Mariposa County,13,6,949,492,457
50,6,43,California,Mariposa County,13,7,984,519,465
50,6,43,California,Mariposa County,13,8,897,479,418
50,6,43,California,Mariposa County,13,9,822,413,409
50,6,43,California,Mariposa County,13,10,834,445,389
50,6,43,California,Mariposa County,13,11,946,470,476
50,6,43,California,Mariposa County,13,12,1343,667,676
50,6,43,California,Mariposa County,13,13,1633,793,840
50,6,43,California,Mariposa County,13,14,1513,737,776
50,6,43,California,Mariposa County,13,15,1347,700,647
50,6,43,California,Mariposa County,13,16,950,473,477
50,6,43,California,Mariposa County,13,17,601,306,295
50,6,43,California,Mariposa County,13,18,536,231,305
50,6,43,California,Mariposa County,14,0,17160,8659,8501
50,6,43,California,Mariposa County,14,1,736,366,370
50,6,43,California,Mariposa County,14,2,803,402,401
50,6,43,California,Mariposa County,14,3,791,380,411
50,6,43,California,Mariposa County,14,4,762,400,362
50,6,43,California,Mariposa County,14,5,733,403,330
50,6,43,California,Mariposa County,14,6,946,485,461
50,6,43,California,Mariposa County,14,7,1001,528,473
50,6,43,California,Mariposa County,14,8,903,487,416
50,6,43,California,Mariposa County,14,9,836,421,415
50,6,43,California,Mariposa County,14,10,824,439,385
50,6,43,California,Mariposa County,14,11,943,468,475
50,6,43,California,Mariposa County,14,12,1324,653,671
50,6,43,California,Mariposa County,14,13,1623,787,836
50,6,43,California,Mariposa County,14,14,1499,733,766
50,6,43,California,Mariposa County,14,15,1354,696,658
50,6,43,California,Mariposa County,14,16,952,477,475
50,6,43,California,Mariposa County,14,17,594,302,292
50,6,43,California,Mariposa County,14,18,536,232,304
50,6,45,California,Mendocino County,1,0,87841,43983,43858
50,6,45,California,Mendocino County,1,1,5347,2786,2561
50,6,45,California,Mendocino County,1,2,5259,2656,2603
50,6,45,California,Mendocino County,1,3,5390,2735,2655
50,6,45,California,Mendocino County,1,4,5613,2991,2622
50,6,45,California,Mendocino County,1,5,4874,2635,2239
50,6,45,California,Mendocino County,1,6,5485,2833,2652
50,6,45,California,Mendocino County,1,7,5219,2724,2495
50,6,45,California,Mendocino County,1,8,5097,2647,2450
50,6,45,California,Mendocino County,1,9,5171,2688,2483
50,6,45,California,Mendocino County,1,10,5759,2838,2921
50,6,45,California,Mendocino County,1,11,6717,3289,3428
50,6,45,California,Mendocino County,1,12,7283,3487,3796
50,6,45,California,Mendocino County,1,13,7134,3540,3594
50,6,45,California,Mendocino County,1,14,4632,2287,2345
50,6,45,California,Mendocino County,1,15,2924,1427,1497
50,6,45,California,Mendocino County,1,16,2178,1010,1168
50,6,45,California,Mendocino County,1,17,1805,759,1046
50,6,45,California,Mendocino County,1,18,1954,651,1303
50,6,45,California,Mendocino County,2,0,87850,43987,43863
50,6,45,California,Mendocino County,2,1,5347,2786,2561
50,6,45,California,Mendocino County,2,2,5259,2656,2603
50,6,45,California,Mendocino County,2,3,5390,2735,2655
50,6,45,California,Mendocino County,2,4,5613,2991,2622
50,6,45,California,Mendocino County,2,5,4874,2635,2239
50,6,45,California,Mendocino County,2,6,5485,2833,2652
50,6,45,California,Mendocino County,2,7,5219,2724,2495
50,6,45,California,Mendocino County,2,8,5097,2647,2450
50,6,45,California,Mendocino County,2,9,5171,2688,2483
50,6,45,California,Mendocino County,2,10,5758,2837,2921
50,6,45,California,Mendocino County,2,11,6717,3289,3428
50,6,45,California,Mendocino County,2,12,7284,3487,3797
50,6,45,California,Mendocino County,2,13,7135,3542,3593
50,6,45,California,Mendocino County,2,14,4631,2286,2345
50,6,45,California,Mendocino County,2,15,2925,1427,1498
50,6,45,California,Mendocino County,2,16,2180,1012,1168
50,6,45,California,Mendocino County,2,17,1808,760,1048
50,6,45,California,Mendocino County,2,18,1957,652,1305
50,6,45,California,Mendocino County,3,0,87796,43932,43864
50,6,45,California,Mendocino County,3,1,5358,2795,2563
50,6,45,California,Mendocino County,3,2,5262,2645,2617
50,6,45,California,Mendocino County,3,3,5384,2739,2645
50,6,45,California,Mendocino County,3,4,5559,2969,2590
50,6,45,California,Mendocino County,3,5,4859,2617,2242
50,6,45,California,Mendocino County,3,6,5452,2809,2643
50,6,45,California,Mendocino County,3,7,5233,2726,2507
50,6,45,California,Mendocino County,3,8,5070,2630,2440
50,6,45,California,Mendocino County,3,9,5188,2699,2489
50,6,45,California,Mendocino County,3,10,5700,2819,2881
50,6,45,California,Mendocino County,3,11,6677,3267,3410
50,6,45,California,Mendocino County,3,12,7250,3468,3782
50,6,45,California,Mendocino County,3,13,7218,3573,3645
50,6,45,California,Mendocino County,3,14,4682,2312,2370
50,6,45,California,Mendocino County,3,15,2944,1436,1508
50,6,45,California,Mendocino County,3,16,2189,1021,1168
50,6,45,California,Mendocino County,3,17,1796,755,1041
50,6,45,California,Mendocino County,3,18,1975,652,1323
50,6,45,California,Mendocino County,4,0,87335,43580,43755
50,6,45,California,Mendocino County,4,1,5275,2718,2557
50,6,45,California,Mendocino County,4,2,5286,2661,2625
50,6,45,California,Mendocino County,4,3,5353,2735,2618
50,6,45,California,Mendocino County,4,4,5399,2891,2508
50,6,45,California,Mendocino County,4,5,4825,2542,2283
50,6,45,California,Mendocino County,4,6,5232,2700,2532
50,6,45,California,Mendocino County,4,7,5287,2738,2549
50,6,45,California,Mendocino County,4,8,4929,2548,2381
50,6,45,California,Mendocino County,4,9,5229,2703,2526
50,6,45,California,Mendocino County,4,10,5380,2682,2698
50,6,45,California,Mendocino County,4,11,6486,3173,3313
50,6,45,California,Mendocino County,4,12,7081,3399,3682
50,6,45,California,Mendocino County,4,13,7499,3663,3836
50,6,45,California,Mendocino County,4,14,4950,2457,2493
50,6,45,California,Mendocino County,4,15,3075,1518,1557
50,6,45,California,Mendocino County,4,16,2270,1066,1204
50,6,45,California,Mendocino County,4,17,1741,733,1008
50,6,45,California,Mendocino County,4,18,2038,653,1385
50,6,45,California,Mendocino County,5,0,87293,43523,43770
50,6,45,California,Mendocino County,5,1,5319,2765,2554
50,6,45,California,Mendocino County,5,2,5294,2681,2613
50,6,45,California,Mendocino County,5,3,5315,2713,2602
50,6,45,California,Mendocino County,5,4,5282,2753,2529
50,6,45,California,Mendocino County,5,5,4788,2515,2273
50,6,45,California,Mendocino County,5,6,5003,2602,2401
50,6,45,California,Mendocino County,5,7,5331,2787,2544
50,6,45,California,Mendocino County,5,8,4987,2586,2401
50,6,45,California,Mendocino County,5,9,5218,2671,2547
50,6,45,California,Mendocino County,5,10,5130,2578,2552
50,6,45,California,Mendocino County,5,11,6267,3065,3202
50,6,45,California,Mendocino County,5,12,7019,3365,3654
50,6,45,California,Mendocino County,5,13,7303,3520,3783
50,6,45,California,Mendocino County,5,14,5639,2810,2829
50,6,45,California,Mendocino County,5,15,3316,1608,1708
50,6,45,California,Mendocino County,5,16,2317,1105,1212
50,6,45,California,Mendocino County,5,17,1684,712,972
50,6,45,California,Mendocino County,5,18,2081,687,1394
50,6,45,California,Mendocino County,6,0,87070,43342,43728
50,6,45,California,Mendocino County,6,1,5302,2730,2572
50,6,45,California,Mendocino County,6,2,5273,2718,2555
50,6,45,California,Mendocino County,6,3,5247,2677,2570
50,6,45,California,Mendocino County,6,4,5202,2663,2539
50,6,45,California,Mendocino County,6,5,4777,2530,2247
50,6,45,California,Mendocino County,6,6,4985,2603,2382
50,6,45,California,Mendocino County,6,7,5303,2729,2574
50,6,45,California,Mendocino County,6,8,4988,2581,2407
50,6,45,California,Mendocino County,6,9,5134,2587,2547
50,6,45,California,Mendocino County,6,10,5034,2555,2479
50,6,45,California,Mendocino County,6,11,5985,2883,3102
50,6,45,California,Mendocino County,6,12,6822,3304,3518
50,6,45,California,Mendocino County,6,13,7216,3441,3775
50,6,45,California,Mendocino County,6,14,6030,3018,3012
50,6,45,California,Mendocino County,6,15,3650,1799,1851
50,6,45,California,Mendocino County,6,16,2351,1123,1228
50,6,45,California,Mendocino County,6,17,1708,730,978
50,6,45,California,Mendocino County,6,18,2063,671,1392
50,6,45,California,Mendocino County,7,0,87247,43399,43848
50,6,45,California,Mendocino County,7,1,5311,2706,2605
50,6,45,California,Mendocino County,7,2,5353,2763,2590
50,6,45,California,Mendocino County,7,3,5211,2623,2588
50,6,45,California,Mendocino County,7,4,5165,2672,2493
50,6,45,California,Mendocino County,7,5,4839,2559,2280
50,6,45,California,Mendocino County,7,6,4875,2539,2336
50,6,45,California,Mendocino County,7,7,5296,2732,2564
50,6,45,California,Mendocino County,7,8,5084,2591,2493
50,6,45,California,Mendocino County,7,9,5037,2557,2480
50,6,45,California,Mendocino County,7,10,4961,2542,2419
50,6,45,California,Mendocino County,7,11,5845,2816,3029
50,6,45,California,Mendocino County,7,12,6571,3197,3374
50,6,45,California,Mendocino County,7,13,7133,3367,3766
50,6,45,California,Mendocino County,7,14,6425,3215,3210
50,6,45,California,Mendocino County,7,15,3966,1954,2012
50,6,45,California,Mendocino County,7,16,2408,1144,1264
50,6,45,California,Mendocino County,7,17,1687,741,946
50,6,45,California,Mendocino County,7,18,2080,681,1399
50,6,45,California,Mendocino County,8,0,87131,43329,43802
50,6,45,California,Mendocino County,8,1,5236,2688,2548
50,6,45,California,Mendocino County,8,2,5348,2746,2602
50,6,45,California,Mendocino County,8,3,5138,2584,2554
50,6,45,California,Mendocino County,8,4,5044,2594,2450
50,6,45,California,Mendocino County,8,5,4847,2593,2254
50,6,45,California,Mendocino County,8,6,4740,2491,2249
50,6,45,California,Mendocino County,8,7,5263,2663,2600
50,6,45,California,Mendocino County,8,8,5138,2638,2500
50,6,45,California,Mendocino County,8,9,5003,2572,2431
50,6,45,California,Mendocino County,8,10,5011,2549,2462
50,6,45,California,Mendocino County,8,11,5568,2686,2882
50,6,45,California,Mendocino County,8,12,6437,3154,3283
50,6,45,California,Mendocino County,8,13,6982,3297,3685
50,6,45,California,Mendocino County,8,14,6839,3351,3488
50,6,45,California,Mendocino County,8,15,4222,2087,2135
50,6,45,California,Mendocino County,8,16,2527,1218,1309
50,6,45,California,Mendocino County,8,17,1707,744,963
50,6,45,California,Mendocino County,8,18,2081,674,1407
50,6,45,California,Mendocino County,9,0,87319,43327,43992
50,6,45,California,Mendocino County,9,1,5249,2659,2590
50,6,45,California,Mendocino County,9,2,5218,2699,2519
50,6,45,California,Mendocino County,9,3,5201,2603,2598
50,6,45,California,Mendocino County,9,4,5100,2668,2432
50,6,45,California,Mendocino County,9,5,4643,2456,2187
50,6,45,California,Mendocino County,9,6,4827,2493,2334
50,6,45,California,Mendocino County,9,7,5131,2609,2522
50,6,45,California,Mendocino County,9,8,5255,2711,2544
50,6,45,California,Mendocino County,9,9,4973,2534,2439
50,6,45,California,Mendocino County,9,10,5111,2604,2507
50,6,45,California,Mendocino County,9,11,5378,2613,2765
50,6,45,California,Mendocino County,9,12,6302,3087,3215
50,6,45,California,Mendocino County,9,13,6927,3259,3668
50,6,45,California,Mendocino County,9,14,7109,3441,3668
50,6,45,California,Mendocino County,9,15,4455,2191,2264
50,6,45,California,Mendocino County,9,16,2570,1247,1323
50,6,45,California,Mendocino County,9,17,1761,781,980
50,6,45,California,Mendocino County,9,18,2109,672,1437
50,6,45,California,Mendocino County,10,0,87690,43449,44241
50,6,45,California,Mendocino County,10,1,5172,2578,2594
50,6,45,California,Mendocino County,10,2,5320,2766,2554
50,6,45,California,Mendocino County,10,3,5213,2666,2547
50,6,45,California,Mendocino County,10,4,5065,2640,2425
50,6,45,California,Mendocino County,10,5,4531,2341,2190
50,6,45,California,Mendocino County,10,6,4917,2493,2424
50,6,45,California,Mendocino County,10,7,5046,2593,2453
50,6,45,California,Mendocino County,10,8,5408,2738,2670
50,6,45,California,Mendocino County,10,9,5052,2622,2430
50,6,45,California,Mendocino County,10,10,5101,2544,2557
50,6,45,California,Mendocino County,10,11,5186,2580,2606
50,6,45,California,Mendocino County,10,12,6160,3015,3145
50,6,45,California,Mendocino County,10,13,6831,3238,3593
50,6,45,California,Mendocino County,10,14,6910,3297,3613
50,6,45,California,Mendocino County,10,15,5105,2510,2595
50,6,45,California,Mendocino County,10,16,2800,1344,1456
50,6,45,California,Mendocino County,10,17,1753,783,970
50,6,45,California,Mendocino County,10,18,2120,701,1419
50,6,45,California,Mendocino County,11,0,87549,43376,44173
50,6,45,California,Mendocino County,11,1,5079,2552,2527
50,6,45,California,Mendocino County,11,2,5252,2674,2578
50,6,45,California,Mendocino County,11,3,5235,2720,2515
50,6,45,California,Mendocino County,11,4,4983,2573,2410
50,6,45,California,Mendocino County,11,5,4494,2288,2206
50,6,45,California,Mendocino County,11,6,4904,2555,2349
50,6,45,California,Mendocino County,11,7,4947,2536,2411
50,6,45,California,Mendocino County,11,8,5408,2724,2684
50,6,45,California,Mendocino County,11,9,5094,2633,2461
50,6,45,California,Mendocino County,11,10,5127,2551,2576
50,6,45,California,Mendocino County,11,11,5056,2536,2520
50,6,45,California,Mendocino County,11,12,5894,2861,3033
50,6,45,California,Mendocino County,11,13,6671,3202,3469
50,6,45,California,Mendocino County,11,14,6910,3226,3684
50,6,45,California,Mendocino County,11,15,5505,2730,2775
50,6,45,California,Mendocino County,11,16,3071,1470,1601
50,6,45,California,Mendocino County,11,17,1787,823,964
50,6,45,California,Mendocino County,11,18,2132,722,1410
50,6,45,California,Mendocino County,12,0,86932,43066,43866
50,6,45,California,Mendocino County,12,1,4919,2495,2424
50,6,45,California,Mendocino County,12,2,5177,2597,2580
50,6,45,California,Mendocino County,12,3,5197,2705,2492
50,6,45,California,Mendocino County,12,4,4899,2490,2409
50,6,45,California,Mendocino County,12,5,4341,2248,2093
50,6,45,California,Mendocino County,12,6,4899,2561,2338
50,6,45,California,Mendocino County,12,7,4856,2487,2369
50,6,45,California,Mendocino County,12,8,5376,2728,2648
50,6,45,California,Mendocino County,12,9,5082,2594,2488
50,6,45,California,Mendocino County,12,10,5021,2507,2514
50,6,45,California,Mendocino County,12,11,4943,2497,2446
50,6,45,California,Mendocino County,12,12,5743,2783,2960
50,6,45,California,Mendocino County,12,13,6418,3095,3323
50,6,45,California,Mendocino County,12,14,6857,3169,3688
50,6,45,California,Mendocino County,12,15,5870,2893,2977
50,6,45,California,Mendocino County,12,16,3362,1629,1733
50,6,45,California,Mendocino County,12,17,1841,840,1001
50,6,45,California,Mendocino County,12,18,2131,748,1383
50,6,45,California,Mendocino County,13,0,86349,42786,43563
50,6,45,California,Mendocino County,13,1,4792,2443,2349
50,6,45,California,Mendocino County,13,2,5192,2599,2593
50,6,45,California,Mendocino County,13,3,5178,2687,2491
50,6,45,California,Mendocino County,13,4,4845,2463,2382
50,6,45,California,Mendocino County,13,5,4237,2192,2045
50,6,45,California,Mendocino County,13,6,4810,2543,2267
50,6,45,California,Mendocino County,13,7,4821,2452,2369
50,6,45,California,Mendocino County,13,8,5330,2687,2643
50,6,45,California,Mendocino County,13,9,5156,2652,2504
50,6,45,California,Mendocino County,13,10,4973,2508,2465
50,6,45,California,Mendocino County,13,11,4881,2428,2453
50,6,45,California,Mendocino County,13,12,5466,2657,2809
50,6,45,California,Mendocino County,13,13,6285,3037,3248
50,6,45,California,Mendocino County,13,14,6661,3104,3557
50,6,45,California,Mendocino County,13,15,6141,2983,3158
50,6,45,California,Mendocino County,13,16,3543,1715,1828
50,6,45,California,Mendocino County,13,17,1917,890,1027
50,6,45,California,Mendocino County,13,18,2121,746,1375
50,6,45,California,Mendocino County,14,0,86061,42649,43412
50,6,45,California,Mendocino County,14,1,4743,2422,2321
50,6,45,California,Mendocino County,14,2,5194,2600,2594
50,6,45,California,Mendocino County,14,3,5174,2681,2493
50,6,45,California,Mendocino County,14,4,4824,2454,2370
50,6,45,California,Mendocino County,14,5,4200,2172,2028
50,6,45,California,Mendocino County,14,6,4773,2535,2238
50,6,45,California,Mendocino County,14,7,4804,2435,2369
50,6,45,California,Mendocino County,14,8,5321,2675,2646
50,6,45,California,Mendocino County,14,9,5179,2667,2512
50,6,45,California,Mendocino County,14,10,4957,2511,2446
50,6,45,California,Mendocino County,14,11,4864,2407,2457
50,6,45,California,Mendocino County,14,12,5369,2614,2755
50,6,45,California,Mendocino County,14,13,6239,3017,3222
50,6,45,California,Mendocino County,14,14,6590,3080,3510
50,6,45,California,Mendocino County,14,15,6211,3003,3208
50,6,45,California,Mendocino County,14,16,3585,1736,1849
50,6,45,California,Mendocino County,14,17,1935,902,1033
50,6,45,California,Mendocino County,14,18,2099,738,1361
50,6,47,California,Merced County,1,0,255793,128737,127056
50,6,47,California,Merced County,1,1,22226,11407,10819
50,6,47,California,Merced County,1,2,22167,11312,10855
50,6,47,California,Merced County,1,3,22115,11387,10728
50,6,47,California,Merced County,1,4,24451,12722,11729
50,6,47,California,Merced County,1,5,20195,10513,9682
50,6,47,California,Merced County,1,6,18190,9413,8777
50,6,47,California,Merced County,1,7,16870,8580,8290
50,6,47,California,Merced County,1,8,16243,8130,8113
50,6,47,California,Merced County,1,9,15724,7975,7749
50,6,47,California,Merced County,1,10,16146,8018,8128
50,6,47,California,Merced County,1,11,14861,7452,7409
50,6,47,California,Merced County,1,12,12363,6132,6231
50,6,47,California,Merced County,1,13,10282,5093,5189
50,6,47,California,Merced County,1,14,7606,3606,4000
50,6,47,California,Merced County,1,15,5599,2589,3010
50,6,47,California,Merced County,1,16,4470,1993,2477
50,6,47,California,Merced County,1,17,3247,1334,1913
50,6,47,California,Merced County,1,18,3038,1081,1957
50,6,47,California,Merced County,2,0,255797,128738,127059
50,6,47,California,Merced County,2,1,22227,11408,10819
50,6,47,California,Merced County,2,2,22168,11312,10856
50,6,47,California,Merced County,2,3,22116,11388,10728
50,6,47,California,Merced County,2,4,24451,12722,11729
50,6,47,California,Merced County,2,5,20193,10511,9682
50,6,47,California,Merced County,2,6,18191,9413,8778
50,6,47,California,Merced County,2,7,16870,8580,8290
50,6,47,California,Merced County,2,8,16242,8129,8113
50,6,47,California,Merced County,2,9,15724,7975,7749
50,6,47,California,Merced County,2,10,16148,8020,8128
50,6,47,California,Merced County,2,11,14862,7452,7410
50,6,47,California,Merced County,2,12,12363,6132,6231
50,6,47,California,Merced County,2,13,10282,5093,5189
50,6,47,California,Merced County,2,14,7606,3606,4000
50,6,47,California,Merced County,2,15,5599,2589,3010
50,6,47,California,Merced County,2,16,4470,1993,2477
50,6,47,California,Merced County,2,17,3247,1334,1913
50,6,47,California,Merced County,2,18,3038,1081,1957
50,6,47,California,Merced County,3,0,256709,129159,127550
50,6,47,California,Merced County,3,1,22232,11398,10834
50,6,47,California,Merced County,3,2,22223,11336,10887
50,6,47,California,Merced County,3,3,22080,11357,10723
50,6,47,California,Merced County,3,4,24398,12678,11720
50,6,47,California,Merced County,3,5,20520,10669,9851
50,6,47,California,Merced County,3,6,18308,9485,8823
50,6,47,California,Merced County,3,7,17002,8648,8354
50,6,47,California,Merced County,3,8,16238,8130,8108
50,6,47,California,Merced County,3,9,15728,7977,7751
50,6,47,California,Merced County,3,10,16137,8034,8103
50,6,47,California,Merced County,3,11,14929,7469,7460
50,6,47,California,Merced County,3,12,12445,6169,6276
50,6,47,California,Merced County,3,13,10369,5126,5243
50,6,47,California,Merced County,3,14,7645,3633,4012
50,6,47,California,Merced County,3,15,5644,2611,3033
50,6,47,California,Merced County,3,16,4504,2013,2491
50,6,47,California,Merced County,3,17,3256,1341,1915
50,6,47,California,Merced County,3,18,3051,1085,1966
50,6,47,California,Merced County,4,0,259249,130530,128719
50,6,47,California,Merced County,4,1,21946,11278,10668
50,6,47,California,Merced County,4,2,22238,11356,10882
50,6,47,California,Merced County,4,3,22097,11353,10744
50,6,47,California,Merced County,4,4,23882,12400,11482
50,6,47,California,Merced County,4,5,21589,11243,10346
50,6,47,California,Merced County,4,6,18463,9569,8894
50,6,47,California,Merced County,4,7,17279,8780,8499
50,6,47,California,Merced County,4,8,16111,8084,8027
50,6,47,California,Merced County,4,9,15844,8002,7842
50,6,47,California,Merced County,4,10,16052,8090,7962
50,6,47,California,Merced County,4,11,15190,7561,7629
50,6,47,California,Merced County,4,12,12845,6384,6461
50,6,47,California,Merced County,4,13,10846,5364,5482
50,6,47,California,Merced County,4,14,7918,3799,4119
50,6,47,California,Merced County,4,15,5843,2710,3133
50,6,47,California,Merced County,4,16,4625,2059,2566
50,6,47,California,Merced County,4,17,3301,1369,1932
50,6,47,California,Merced County,4,18,3180,1129,2051
50,6,47,California,Merced County,5,0,260776,131490,129286
50,6,47,California,Merced County,5,1,21629,11142,10487
50,6,47,California,Merced County,5,2,22550,11483,11067
50,6,47,California,Merced County,5,3,22063,11273,10790
50,6,47,California,Merced County,5,4,23113,12063,11050
50,6,47,California,Merced County,5,5,21990,11430,10560
50,6,47,California,Merced County,5,6,18648,9720,8928
50,6,47,California,Merced County,5,7,17624,9070,8554
50,6,47,California,Merced County,5,8,15965,8022,7943
50,6,47,California,Merced County,5,9,15938,8050,7888
50,6,47,California,Merced County,5,10,15736,7997,7739
50,6,47,California,Merced County,5,11,15380,7632,7748
50,6,47,California,Merced County,5,12,13277,6613,6664
50,6,47,California,Merced County,5,13,10973,5408,5565
50,6,47,California,Merced County,5,14,8504,4096,4408
50,6,47,California,Merced County,5,15,6106,2860,3246
50,6,47,California,Merced County,5,16,4623,2061,2562
50,6,47,California,Merced County,5,17,3378,1420,1958
50,6,47,California,Merced County,5,18,3279,1150,2129
50,6,47,California,Merced County,6,0,261888,132097,129791
50,6,47,California,Merced County,6,1,21478,10981,10497
50,6,47,California,Merced County,6,2,22564,11593,10971
50,6,47,California,Merced County,6,3,22151,11313,10838
50,6,47,California,Merced County,6,4,22670,11828,10842
50,6,47,California,Merced County,6,5,21912,11352,10560
50,6,47,California,Merced County,6,6,18884,9955,8929
50,6,47,California,Merced County,6,7,17820,9213,8607
50,6,47,California,Merced County,6,8,16008,8019,7989
50,6,47,California,Merced County,6,9,15919,7958,7961
50,6,47,California,Merced County,6,10,15561,7923,7638
50,6,47,California,Merced County,6,11,15387,7661,7726
50,6,47,California,Merced County,6,12,13696,6826,6870
50,6,47,California,Merced County,6,13,11115,5475,5640
50,6,47,California,Merced County,6,14,8865,4252,4613
50,6,47,California,Merced County,6,15,6365,3009,3356
50,6,47,California,Merced County,6,16,4749,2132,2617
50,6,47,California,Merced County,6,17,3381,1416,1965
50,6,47,California,Merced County,6,18,3363,1191,2172
50,6,47,California,Merced County,7,0,264241,133367,130874
50,6,47,California,Merced County,7,1,21538,11036,10502
50,6,47,California,Merced County,7,2,22570,11571,10999
50,6,47,California,Merced County,7,3,22299,11329,10970
50,6,47,California,Merced County,7,4,22763,11786,10977
50,6,47,California,Merced County,7,5,21926,11484,10442
50,6,47,California,Merced County,7,6,19246,10067,9179
50,6,47,California,Merced County,7,7,17985,9394,8591
50,6,47,California,Merced County,7,8,16351,8255,8096
50,6,47,California,Merced County,7,9,15817,7901,7916
50,6,47,California,Merced County,7,10,15429,7842,7587
50,6,47,California,Merced County,7,11,15459,7687,7772
50,6,47,California,Merced County,7,12,13936,6996,6940
50,6,47,California,Merced County,7,13,11292,5530,5762
50,6,47,California,Merced County,7,14,9262,4495,4767
50,6,47,California,Merced County,7,15,6684,3143,3541
50,6,47,California,Merced County,7,16,4800,2155,2645
50,6,47,California,Merced County,7,17,3444,1460,1984
50,6,47,California,Merced County,7,18,3440,1236,2204
50,6,47,California,Merced County,8,0,266133,134277,131856
50,6,47,California,Merced County,8,1,21479,11054,10425
50,6,47,California,Merced County,8,2,22644,11654,10990
50,6,47,California,Merced County,8,3,22363,11298,11065
50,6,47,California,Merced County,8,4,22888,11818,11070
50,6,47,California,Merced County,8,5,21260,11124,10136
50,6,47,California,Merced County,8,6,19970,10437,9533
50,6,47,California,Merced County,8,7,18088,9441,8647
50,6,47,California,Merced County,8,8,16714,8465,8249
50,6,47,California,Merced County,8,9,15724,7808,7916
50,6,47,California,Merced County,8,10,15298,7818,7480
50,6,47,California,Merced County,8,11,15408,7672,7736
50,6,47,California,Merced County,8,12,14209,7065,7144
50,6,47,California,Merced County,8,13,11658,5728,5930
50,6,47,California,Merced County,8,14,9567,4658,4909
50,6,47,California,Merced County,8,15,6933,3274,3659
50,6,47,California,Merced County,8,16,4908,2219,2689
50,6,47,California,Merced County,8,17,3505,1481,2024
50,6,47,California,Merced County,8,18,3517,1263,2254
50,6,47,California,Merced County,9,0,267370,134621,132749
50,6,47,California,Merced County,9,1,21256,10854,10402
50,6,47,California,Merced County,9,2,22704,11715,10989
50,6,47,California,Merced County,9,3,22554,11445,11109
50,6,47,California,Merced County,9,4,22878,11761,11117
50,6,47,California,Merced County,9,5,20622,10703,9919
50,6,47,California,Merced County,9,6,20588,10752,9836
50,6,47,California,Merced County,9,7,18184,9518,8666
50,6,47,California,Merced County,9,8,16824,8466,8358
50,6,47,California,Merced County,9,9,15619,7759,7860
50,6,47,California,Merced County,9,10,15358,7755,7603
50,6,47,California,Merced County,9,11,15152,7600,7552
50,6,47,California,Merced County,9,12,14423,7151,7272
50,6,47,California,Merced County,9,13,11937,5864,6073
50,6,47,California,Merced County,9,14,9851,4796,5055
50,6,47,California,Merced County,9,15,7173,3352,3821
50,6,47,California,Merced County,9,16,5090,2308,2782
50,6,47,California,Merced County,9,17,3570,1516,2054
50,6,47,California,Merced County,9,18,3587,1306,2281
50,6,47,California,Merced County,10,0,270837,136684,134153
50,6,47,California,Merced County,10,1,21491,11038,10453
50,6,47,California,Merced County,10,2,22639,11617,11022
50,6,47,California,Merced County,10,3,23005,11757,11248
50,6,47,California,Merced County,10,4,23455,12038,11417
50,6,47,California,Merced County,10,5,20549,10756,9793
50,6,47,California,Merced County,10,6,20895,10939,9956
50,6,47,California,Merced County,10,7,18594,9788,8806
50,6,47,California,Merced County,10,8,17223,8706,8517
50,6,47,California,Merced County,10,9,15618,7804,7814
50,6,47,California,Merced County,10,10,15515,7756,7759
50,6,47,California,Merced County,10,11,14891,7548,7343
50,6,47,California,Merced County,10,12,14583,7233,7350
50,6,47,California,Merced County,10,13,12479,6116,6363
50,6,47,California,Merced County,10,14,9914,4809,5105
50,6,47,California,Merced County,10,15,7576,3545,4031
50,6,47,California,Merced County,10,16,5236,2399,2837
50,6,47,California,Merced County,10,17,3564,1519,2045
50,6,47,California,Merced County,10,18,3610,1316,2294
50,6,47,California,Merced County,11,0,273733,138182,135551
50,6,47,California,Merced County,11,1,21266,10968,10298
50,6,47,California,Merced County,11,2,22604,11562,11042
50,6,47,California,Merced County,11,3,23206,11888,11318
50,6,47,California,Merced County,11,4,23820,12162,11658
50,6,47,California,Merced County,11,5,20509,10752,9757
50,6,47,California,Merced County,11,6,21227,11044,10183
50,6,47,California,Merced County,11,7,19004,10063,8941
50,6,47,California,Merced County,11,8,17832,9037,8795
50,6,47,California,Merced County,11,9,15691,7847,7844
50,6,47,California,Merced County,11,10,15568,7687,7881
50,6,47,California,Merced County,11,11,14869,7548,7321
50,6,47,California,Merced County,11,12,14669,7333,7336
50,6,47,California,Merced County,11,13,12805,6294,6511
50,6,47,California,Merced County,11,14,10083,4882,5201
50,6,47,California,Merced County,11,15,7935,3728,4207
50,6,47,California,Merced County,11,16,5378,2485,2893
50,6,47,California,Merced County,11,17,3640,1553,2087
50,6,47,California,Merced County,11,18,3627,1349,2278
50,6,47,California,Merced County,12,0,277114,140006,137108
50,6,47,California,Merced County,12,1,21056,10845,10211
50,6,47,California,Merced County,12,2,22937,11760,11177
50,6,47,California,Merced County,12,3,23351,11953,11398
50,6,47,California,Merced County,12,4,24466,12451,12015
50,6,47,California,Merced County,12,5,20309,10600,9709
50,6,47,California,Merced County,12,6,21565,11322,10243
50,6,47,California,Merced County,12,7,19297,10147,9150
50,6,47,California,Merced County,12,8,18128,9302,8826
50,6,47,California,Merced County,12,9,16049,8085,7964
50,6,47,California,Merced County,12,10,15598,7663,7935
50,6,47,California,Merced County,12,11,14836,7527,7309
50,6,47,California,Merced County,12,12,14729,7385,7344
50,6,47,California,Merced County,12,13,13133,6504,6629
50,6,47,California,Merced County,12,14,10394,4987,5407
50,6,47,California,Merced County,12,15,8183,3895,4288
50,6,47,California,Merced County,12,16,5694,2615,3079
50,6,47,California,Merced County,12,17,3700,1567,2133
50,6,47,California,Merced County,12,18,3689,1398,2291
50,6,47,California,Merced County,13,0,278938,140944,137994
50,6,47,California,Merced County,13,1,20869,10775,10094
50,6,47,California,Merced County,13,2,22851,11706,11145
50,6,47,California,Merced County,13,3,23462,12010,11452
50,6,47,California,Merced County,13,4,24620,12485,12135
50,6,47,California,Merced County,13,5,20356,10583,9773
50,6,47,California,Merced County,13,6,21287,11220,10067
50,6,47,California,Merced County,13,7,19752,10372,9380
50,6,47,California,Merced County,13,8,18328,9399,8929
50,6,47,California,Merced County,13,9,16335,8282,8053
50,6,47,California,Merced County,13,10,15549,7610,7939
50,6,47,California,Merced County,13,11,14830,7542,7288
50,6,47,California,Merced County,13,12,14766,7385,7381
50,6,47,California,Merced County,13,13,13378,6653,6725
50,6,47,California,Merced County,13,14,10708,5162,5546
50,6,47,California,Merced County,13,15,8460,4005,4455
50,6,47,California,Merced County,13,16,5850,2687,3163
50,6,47,California,Merced County,13,17,3775,1632,2143
50,6,47,California,Merced County,13,18,3762,1436,2326
50,6,47,California,Merced County,14,0,279252,141102,138150
50,6,47,California,Merced County,14,1,20799,10746,10053
50,6,47,California,Merced County,14,2,22785,11670,11115
50,6,47,California,Merced County,14,3,23467,12012,11455
50,6,47,California,Merced County,14,4,24643,12483,12160
50,6,47,California,Merced County,14,5,20336,10557,9779
50,6,47,California,Merced County,14,6,21149,11167,9982
50,6,47,California,Merced County,14,7,19900,10438,9462
50,6,47,California,Merced County,14,8,18398,9435,8963
50,6,47,California,Merced County,14,9,16417,8340,8077
50,6,47,California,Merced County,14,10,15537,7594,7943
50,6,47,California,Merced County,14,11,14835,7553,7282
50,6,47,California,Merced County,14,12,14759,7376,7383
50,6,47,California,Merced County,14,13,13448,6694,6754
50,6,47,California,Merced County,14,14,10810,5216,5594
50,6,47,California,Merced County,14,15,8532,4029,4503
50,6,47,California,Merced County,14,16,5885,2703,3182
50,6,47,California,Merced County,14,17,3794,1651,2143
50,6,47,California,Merced County,14,18,3758,1438,2320
50,6,49,California,Modoc County,1,0,9686,4878,4808
50,6,49,California,Modoc County,1,1,545,271,274
50,6,49,California,Modoc County,1,2,564,297,267
50,6,49,California,Modoc County,1,3,602,298,304
50,6,49,California,Modoc County,1,4,604,311,293
50,6,49,California,Modoc County,1,5,422,215,207
50,6,49,California,Modoc County,1,6,446,242,204
50,6,49,California,Modoc County,1,7,458,219,239
50,6,49,California,Modoc County,1,8,506,295,211
50,6,49,California,Modoc County,1,9,556,275,281
50,6,49,California,Modoc County,1,10,708,344,364
50,6,49,California,Modoc County,1,11,736,351,385
50,6,49,California,Modoc County,1,12,807,396,411
50,6,49,California,Modoc County,1,13,827,418,409
50,6,49,California,Modoc County,1,14,634,329,305
50,6,49,California,Modoc County,1,15,474,243,231
50,6,49,California,Modoc County,1,16,351,175,176
50,6,49,California,Modoc County,1,17,219,98,121
50,6,49,California,Modoc County,1,18,227,101,126
50,6,49,California,Modoc County,2,0,9686,4878,4808
50,6,49,California,Modoc County,2,1,545,271,274
50,6,49,California,Modoc County,2,2,564,297,267
50,6,49,California,Modoc County,2,3,602,298,304
50,6,49,California,Modoc County,2,4,604,311,293
50,6,49,California,Modoc County,2,5,422,215,207
50,6,49,California,Modoc County,2,6,446,242,204
50,6,49,California,Modoc County,2,7,458,219,239
50,6,49,California,Modoc County,2,8,506,295,211
50,6,49,California,Modoc County,2,9,556,275,281
50,6,49,California,Modoc County,2,10,708,344,364
50,6,49,California,Modoc County,2,11,736,351,385
50,6,49,California,Modoc County,2,12,807,396,411
50,6,49,California,Modoc County,2,13,827,418,409
50,6,49,California,Modoc County,2,14,634,329,305
50,6,49,California,Modoc County,2,15,474,243,231
50,6,49,California,Modoc County,2,16,351,175,176
50,6,49,California,Modoc County,2,17,219,98,121
50,6,49,California,Modoc County,2,18,227,101,126
50,6,49,California,Modoc County,3,0,9698,4884,4814
50,6,49,California,Modoc County,3,1,549,274,275
50,6,49,California,Modoc County,3,2,561,296,265
50,6,49,California,Modoc County,3,3,596,296,300
50,6,49,California,Modoc County,3,4,609,316,293
50,6,49,California,Modoc County,3,5,421,212,209
50,6,49,California,Modoc County,3,6,453,243,210
50,6,49,California,Modoc County,3,7,461,221,240
50,6,49,California,Modoc County,3,8,501,291,210
50,6,49,California,Modoc County,3,9,556,278,278
50,6,49,California,Modoc County,3,10,697,338,359
50,6,49,California,Modoc County,3,11,739,351,388
50,6,49,California,Modoc County,3,12,804,396,408
50,6,49,California,Modoc County,3,13,834,419,415
50,6,49,California,Modoc County,3,14,632,325,307
50,6,49,California,Modoc County,3,15,484,251,233
50,6,49,California,Modoc County,3,16,348,168,180
50,6,49,California,Modoc County,3,17,229,108,121
50,6,49,California,Modoc County,3,18,224,101,123
50,6,49,California,Modoc County,4,0,9513,4806,4707
50,6,49,California,Modoc County,4,1,491,251,240
50,6,49,California,Modoc County,4,2,541,287,254
50,6,49,California,Modoc County,4,3,569,282,287
50,6,49,California,Modoc County,4,4,624,337,287
50,6,49,California,Modoc County,4,5,390,202,188
50,6,49,California,Modoc County,4,6,442,237,205
50,6,49,California,Modoc County,4,7,465,219,246
50,6,49,California,Modoc County,4,8,475,272,203
50,6,49,California,Modoc County,4,9,550,285,265
50,6,49,California,Modoc County,4,10,634,293,341
50,6,49,California,Modoc County,4,11,741,351,390
50,6,49,California,Modoc County,4,12,781,392,389
50,6,49,California,Modoc County,4,13,858,432,426
50,6,49,California,Modoc County,4,14,619,307,312
50,6,49,California,Modoc County,4,15,513,278,235
50,6,49,California,Modoc County,4,16,332,156,176
50,6,49,California,Modoc County,4,17,260,126,134
50,6,49,California,Modoc County,4,18,228,99,129
50,6,49,California,Modoc County,5,0,9358,4739,4619
50,6,49,California,Modoc County,5,1,464,239,225
50,6,49,California,Modoc County,5,2,525,276,249
50,6,49,California,Modoc County,5,3,566,296,270
50,6,49,California,Modoc County,5,4,612,319,293
50,6,49,California,Modoc County,5,5,404,215,189
50,6,49,California,Modoc County,5,6,419,216,203
50,6,49,California,Modoc County,5,7,448,221,227
50,6,49,California,Modoc County,5,8,469,248,221
50,6,49,California,Modoc County,5,9,545,291,254
50,6,49,California,Modoc County,5,10,565,260,305
50,6,49,California,Modoc County,5,11,725,352,373
50,6,49,California,Modoc County,5,12,773,388,385
50,6,49,California,Modoc County,5,13,816,415,401
50,6,49,California,Modoc County,5,14,681,337,344
50,6,49,California,Modoc County,5,15,528,282,246
50,6,49,California,Modoc County,5,16,326,157,169
50,6,49,California,Modoc County,5,17,256,122,134
50,6,49,California,Modoc County,5,18,236,105,131
50,6,49,California,Modoc County,6,0,9154,4643,4511
50,6,49,California,Modoc County,6,1,454,235,219
50,6,49,California,Modoc County,6,2,501,266,235
50,6,49,California,Modoc County,6,3,530,290,240
50,6,49,California,Modoc County,6,4,561,295,266
50,6,49,California,Modoc County,6,5,400,212,188
50,6,49,California,Modoc County,6,6,402,206,196
50,6,49,California,Modoc County,6,7,463,236,227
50,6,49,California,Modoc County,6,8,457,234,223
50,6,49,California,Modoc County,6,9,507,278,229
50,6,49,California,Modoc County,6,10,525,245,280
50,6,49,California,Modoc County,6,11,684,332,352
50,6,49,California,Modoc County,6,12,755,370,385
50,6,49,California,Modoc County,6,13,801,396,405
50,6,49,California,Modoc County,6,14,722,363,359
50,6,49,California,Modoc County,6,15,564,296,268
50,6,49,California,Modoc County,6,16,328,162,166
50,6,49,California,Modoc County,6,17,254,120,134
50,6,49,California,Modoc County,6,18,246,107,139
50,6,49,California,Modoc County,7,0,9078,4585,4493
50,6,49,California,Modoc County,7,1,453,229,224
50,6,49,California,Modoc County,7,2,492,253,239
50,6,49,California,Modoc County,7,3,535,295,240
50,6,49,California,Modoc County,7,4,508,258,250
50,6,49,California,Modoc County,7,5,415,227,188
50,6,49,California,Modoc County,7,6,411,203,208
50,6,49,California,Modoc County,7,7,456,244,212
50,6,49,California,Modoc County,7,8,453,222,231
50,6,49,California,Modoc County,7,9,490,269,221
50,6,49,California,Modoc County,7,10,508,245,263
50,6,49,California,Modoc County,7,11,679,337,342
50,6,49,California,Modoc County,7,12,719,335,384
50,6,49,California,Modoc County,7,13,785,388,397
50,6,49,California,Modoc County,7,14,737,371,366
50,6,49,California,Modoc County,7,15,591,314,277
50,6,49,California,Modoc County,7,16,342,170,172
50,6,49,California,Modoc County,7,17,262,122,140
50,6,49,California,Modoc County,7,18,242,103,139
50,6,49,California,Modoc County,8,0,9064,4592,4472
50,6,49,California,Modoc County,8,1,453,227,226
50,6,49,California,Modoc County,8,2,492,254,238
50,6,49,California,Modoc County,8,3,529,297,232
50,6,49,California,Modoc County,8,4,498,255,243
50,6,49,California,Modoc County,8,5,431,230,201
50,6,49,California,Modoc County,8,6,404,208,196
50,6,49,California,Modoc County,8,7,456,237,219
50,6,49,California,Modoc County,8,8,478,236,242
50,6,49,California,Modoc County,8,9,462,252,210
50,6,49,California,Modoc County,8,10,504,253,251
50,6,49,California,Modoc County,8,11,668,316,352
50,6,49,California,Modoc County,8,12,676,318,358
50,6,49,California,Modoc County,8,13,771,391,380
50,6,49,California,Modoc County,8,14,769,392,377
50,6,49,California,Modoc County,8,15,590,313,277
50,6,49,California,Modoc County,8,16,370,180,190
50,6,49,California,Modoc County,8,17,268,118,150
50,6,49,California,Modoc County,8,18,245,115,130
50,6,49,California,Modoc County,9,0,8957,4528,4429
50,6,49,California,Modoc County,9,1,462,222,240
50,6,49,California,Modoc County,9,2,515,273,242
50,6,49,California,Modoc County,9,3,508,276,232
50,6,49,California,Modoc County,9,4,455,233,222
50,6,49,California,Modoc County,9,5,417,226,191
50,6,49,California,Modoc County,9,6,437,220,217
50,6,49,California,Modoc County,9,7,455,229,226
50,6,49,California,Modoc County,9,8,477,245,232
50,6,49,California,Modoc County,9,9,443,229,214
50,6,49,California,Modoc County,9,10,490,251,239
50,6,49,California,Modoc County,9,11,597,277,320
50,6,49,California,Modoc County,9,12,680,322,358
50,6,49,California,Modoc County,9,13,743,382,361
50,6,49,California,Modoc County,9,14,790,403,387
50,6,49,California,Modoc County,9,15,570,289,281
50,6,49,California,Modoc County,9,16,414,217,197
50,6,49,California,Modoc County,9,17,247,110,137
50,6,49,California,Modoc County,9,18,257,124,133
50,6,49,California,Modoc County,10,0,8864,4445,4419
50,6,49,California,Modoc County,10,1,455,232,223
50,6,49,California,Modoc County,10,2,506,257,249
50,6,49,California,Modoc County,10,3,498,262,236
50,6,49,California,Modoc County,10,4,432,225,207
50,6,49,California,Modoc County,10,5,405,213,192
50,6,49,California,Modoc County,10,6,463,240,223
50,6,49,California,Modoc County,10,7,440,205,235
50,6,49,California,Modoc County,10,8,437,216,221
50,6,49,California,Modoc County,10,9,438,209,229
50,6,49,California,Modoc County,10,10,488,263,225
50,6,49,California,Modoc County,10,11,548,256,292
50,6,49,California,Modoc County,10,12,705,335,370
50,6,49,California,Modoc County,10,13,739,364,375
50,6,49,California,Modoc County,10,14,751,389,362
50,6,49,California,Modoc County,10,15,612,318,294
50,6,49,California,Modoc County,10,16,432,230,202
50,6,49,California,Modoc County,10,17,254,116,138
50,6,49,California,Modoc County,10,18,261,115,146
50,6,49,California,Modoc County,11,0,8816,4416,4400
50,6,49,California,Modoc County,11,1,462,222,240
50,6,49,California,Modoc County,11,2,502,258,244
50,6,49,California,Modoc County,11,3,480,248,232
50,6,49,California,Modoc County,11,4,441,240,201
50,6,49,California,Modoc County,11,5,396,207,189
50,6,49,California,Modoc County,11,6,450,236,214
50,6,49,California,Modoc County,11,7,437,200,237
50,6,49,California,Modoc County,11,8,456,230,226
50,6,49,California,Modoc County,11,9,434,199,235
50,6,49,California,Modoc County,11,10,465,256,209
50,6,49,California,Modoc County,11,11,506,234,272
50,6,49,California,Modoc County,11,12,667,330,337
50,6,49,California,Modoc County,11,13,745,358,387
50,6,49,California,Modoc County,11,14,761,377,384
50,6,49,California,Modoc County,11,15,630,332,298
50,6,49,California,Modoc County,11,16,474,255,219
50,6,49,California,Modoc County,11,17,245,115,130
50,6,49,California,Modoc County,11,18,265,119,146
50,6,49,California,Modoc County,12,0,8866,4476,4390
50,6,49,California,Modoc County,12,1,451,234,217
50,6,49,California,Modoc County,12,2,502,245,257
50,6,49,California,Modoc County,12,3,477,240,237
50,6,49,California,Modoc County,12,4,473,259,214
50,6,49,California,Modoc County,12,5,378,205,173
50,6,49,California,Modoc County,12,6,468,253,215
50,6,49,California,Modoc County,12,7,445,207,238
50,6,49,California,Modoc County,12,8,470,253,217
50,6,49,California,Modoc County,12,9,431,202,229
50,6,49,California,Modoc County,12,10,472,269,203
50,6,49,California,Modoc County,12,11,496,228,268
50,6,49,California,Modoc County,12,12,659,318,341
50,6,49,California,Modoc County,12,13,708,341,367
50,6,49,California,Modoc County,12,14,757,374,383
50,6,49,California,Modoc County,12,15,641,339,302
50,6,49,California,Modoc County,12,16,498,263,235
50,6,49,California,Modoc County,12,17,265,124,141
50,6,49,California,Modoc County,12,18,275,122,153
50,6,49,California,Modoc County,13,0,8798,4425,4373
50,6,49,California,Modoc County,13,1,421,219,202
50,6,49,California,Modoc County,13,2,499,243,256
50,6,49,California,Modoc County,13,3,491,248,243
50,6,49,California,Modoc County,13,4,449,252,197
50,6,49,California,Modoc County,13,5,360,189,171
50,6,49,California,Modoc County,13,6,462,245,217
50,6,49,California,Modoc County,13,7,429,210,219
50,6,49,California,Modoc County,13,8,473,249,224
50,6,49,California,Modoc County,13,9,438,208,230
50,6,49,California,Modoc County,13,10,434,241,193
50,6,49,California,Modoc County,13,11,491,227,264
50,6,49,California,Modoc County,13,12,656,310,346
50,6,49,California,Modoc County,13,13,700,324,376
50,6,49,California,Modoc County,13,14,761,394,367
50,6,49,California,Modoc County,13,15,677,353,324
50,6,49,California,Modoc County,13,16,489,250,239
50,6,49,California,Modoc County,13,17,292,139,153
50,6,49,California,Modoc County,13,18,276,124,152
50,6,49,California,Modoc County,14,0,8763,4400,4363
50,6,49,California,Modoc County,14,1,408,214,194
50,6,49,California,Modoc County,14,2,495,239,256
50,6,49,California,Modoc County,14,3,491,246,245
50,6,49,California,Modoc County,14,4,444,253,191
50,6,49,California,Modoc County,14,5,349,182,167
50,6,49,California,Modoc County,14,6,462,244,218
50,6,49,California,Modoc County,14,7,426,213,213
50,6,49,California,Modoc County,14,8,474,247,227
50,6,49,California,Modoc County,14,9,439,209,230
50,6,49,California,Modoc County,14,10,428,234,194
50,6,49,California,Modoc County,14,11,487,226,261
50,6,49,California,Modoc County,14,12,654,306,348
50,6,49,California,Modoc County,14,13,692,318,374
50,6,49,California,Modoc County,14,14,766,401,365
50,6,49,California,Modoc County,14,15,689,356,333
50,6,49,California,Modoc County,14,16,484,244,240
50,6,49,California,Modoc County,14,17,302,145,157
50,6,49,California,Modoc County,14,18,273,123,150
50,6,51,California,Mono County,1,0,14202,7548,6654
50,6,51,California,Mono County,1,1,893,439,454
50,6,51,California,Mono County,1,2,828,427,401
50,6,51,California,Mono County,1,3,770,380,390
50,6,51,California,Mono County,1,4,820,425,395
50,6,51,California,Mono County,1,5,1118,628,490
50,6,51,California,Mono County,1,6,1277,706,571
50,6,51,California,Mono County,1,7,976,546,430
50,6,51,California,Mono County,1,8,967,538,429
50,6,51,California,Mono County,1,9,942,510,432
50,6,51,California,Mono County,1,10,1130,560,570
50,6,51,California,Mono County,1,11,1212,652,560
50,6,51,California,Mono County,1,12,1079,570,509
50,6,51,California,Mono County,1,13,813,441,372
50,6,51,California,Mono County,1,14,534,293,241
50,6,51,California,Mono County,1,15,388,178,210
50,6,51,California,Mono County,1,16,236,143,93
50,6,51,California,Mono County,1,17,140,82,58
50,6,51,California,Mono County,1,18,79,30,49
50,6,51,California,Mono County,2,0,14204,7551,6653
50,6,51,California,Mono County,2,1,892,439,453
50,6,51,California,Mono County,2,2,829,427,402
50,6,51,California,Mono County,2,3,770,381,389
50,6,51,California,Mono County,2,4,820,425,395
50,6,51,California,Mono County,2,5,1118,628,490
50,6,51,California,Mono County,2,6,1277,706,571
50,6,51,California,Mono County,2,7,978,547,431
50,6,51,California,Mono County,2,8,965,537,428
50,6,51,California,Mono County,2,9,942,510,432
50,6,51,California,Mono County,2,10,1130,560,570
50,6,51,California,Mono County,2,11,1212,652,560
50,6,51,California,Mono County,2,12,1080,571,509
50,6,51,California,Mono County,2,13,813,441,372
50,6,51,California,Mono County,2,14,534,293,241
50,6,51,California,Mono County,2,15,389,179,210
50,6,51,California,Mono County,2,16,236,143,93
50,6,51,California,Mono County,2,17,140,82,58
50,6,51,California,Mono County,2,18,79,30,49
50,6,51,California,Mono County,3,0,14256,7595,6661
50,6,51,California,Mono County,3,1,867,423,444
50,6,51,California,Mono County,3,2,831,428,403
50,6,51,California,Mono County,3,3,770,382,388
50,6,51,California,Mono County,3,4,827,435,392
50,6,51,California,Mono County,3,5,1130,638,492
50,6,51,California,Mono County,3,6,1293,718,575
50,6,51,California,Mono County,3,7,985,552,433
50,6,51,California,Mono County,3,8,957,532,425
50,6,51,California,Mono County,3,9,946,516,430
50,6,51,California,Mono County,3,10,1124,559,565
50,6,51,California,Mono County,3,11,1223,658,565
50,6,51,California,Mono County,3,12,1081,567,514
50,6,51,California,Mono County,3,13,826,451,375
50,6,51,California,Mono County,3,14,545,300,245
50,6,51,California,Mono County,3,15,393,184,209
50,6,51,California,Mono County,3,16,232,137,95
50,6,51,California,Mono County,3,17,144,85,59
50,6,51,California,Mono County,3,18,82,30,52
50,6,51,California,Mono County,4,0,14424,7683,6741
50,6,51,California,Mono County,4,1,849,413,436
50,6,51,California,Mono County,4,2,843,417,426
50,6,51,California,Mono County,4,3,793,402,391
50,6,51,California,Mono County,4,4,840,447,393
50,6,51,California,Mono County,4,5,1073,608,465
50,6,51,California,Mono County,4,6,1313,743,570
50,6,51,California,Mono County,4,7,1035,544,491
50,6,51,California,Mono County,4,8,940,525,415
50,6,51,California,Mono County,4,9,954,530,424
50,6,51,California,Mono County,4,10,1088,561,527
50,6,51,California,Mono County,4,11,1230,654,576
50,6,51,California,Mono County,4,12,1106,573,533
50,6,51,California,Mono County,4,13,898,491,407
50,6,51,California,Mono County,4,14,591,328,263
50,6,51,California,Mono County,4,15,389,188,201
50,6,51,California,Mono County,4,16,228,125,103
50,6,51,California,Mono County,4,17,161,98,63
50,6,51,California,Mono County,4,18,93,36,57
50,6,51,California,Mono County,5,0,14328,7676,6652
50,6,51,California,Mono County,5,1,803,377,426
50,6,51,California,Mono County,5,2,838,428,410
50,6,51,California,Mono County,5,3,768,396,372
50,6,51,California,Mono County,5,4,833,445,388
50,6,51,California,Mono County,5,5,1012,581,431
50,6,51,California,Mono County,5,6,1296,744,552
50,6,51,California,Mono County,5,7,1080,569,511
50,6,51,California,Mono County,5,8,908,513,395
50,6,51,California,Mono County,5,9,940,507,433
50,6,51,California,Mono County,5,10,1024,545,479
50,6,51,California,Mono County,5,11,1229,653,576
50,6,51,California,Mono County,5,12,1099,593,506
50,6,51,California,Mono County,5,13,942,497,445
50,6,51,California,Mono County,5,14,634,358,276
50,6,51,California,Mono County,5,15,390,185,205
50,6,51,California,Mono County,5,16,251,133,118
50,6,51,California,Mono County,5,17,181,112,69
50,6,51,California,Mono County,5,18,100,40,60
50,6,51,California,Mono County,6,0,14064,7494,6570
50,6,51,California,Mono County,6,1,752,359,393
50,6,51,California,Mono County,6,2,829,404,425
50,6,51,California,Mono County,6,3,736,376,360
50,6,51,California,Mono County,6,4,793,429,364
50,6,51,California,Mono County,6,5,995,571,424
50,6,51,California,Mono County,6,6,1177,651,526
50,6,51,California,Mono County,6,7,1120,573,547
50,6,51,California,Mono County,6,8,851,490,361
50,6,51,California,Mono County,6,9,941,515,426
50,6,51,California,Mono County,6,10,940,512,428
50,6,51,California,Mono County,6,11,1195,621,574
50,6,51,California,Mono County,6,12,1102,604,498
50,6,51,California,Mono County,6,13,1001,527,474
50,6,51,California,Mono County,6,14,635,343,292
50,6,51,California,Mono County,6,15,430,224,206
50,6,51,California,Mono County,6,16,258,125,133
50,6,51,California,Mono County,6,17,192,119,73
50,6,51,California,Mono County,6,18,117,51,66
50,6,51,California,Mono County,7,0,14130,7519,6611
50,6,51,California,Mono County,7,1,747,355,392
50,6,51,California,Mono County,7,2,822,392,430
50,6,51,California,Mono County,7,3,751,371,380
50,6,51,California,Mono County,7,4,767,406,361
50,6,51,California,Mono County,7,5,1051,602,449
50,6,51,California,Mono County,7,6,1149,651,498
50,6,51,California,Mono County,7,7,1155,601,554
50,6,51,California,Mono County,7,8,843,461,382
50,6,51,California,Mono County,7,9,919,508,411
50,6,51,California,Mono County,7,10,906,497,409
50,6,51,California,Mono County,7,11,1145,583,562
50,6,51,California,Mono County,7,12,1123,635,488
50,6,51,California,Mono County,7,13,1004,533,471
50,6,51,California,Mono County,7,14,678,357,321
50,6,51,California,Mono County,7,15,465,250,215
50,6,51,California,Mono County,7,16,286,139,147
50,6,51,California,Mono County,7,17,189,111,78
50,6,51,California,Mono County,7,18,130,67,63
50,6,51,California,Mono County,8,0,14074,7489,6585
50,6,51,California,Mono County,8,1,722,363,359
50,6,51,California,Mono County,8,2,793,381,412
50,6,51,California,Mono County,8,3,758,377,381
50,6,51,California,Mono County,8,4,731,375,356
50,6,51,California,Mono County,8,5,1002,565,437
50,6,51,California,Mono County,8,6,1113,618,495
50,6,51,California,Mono County,8,7,1139,584,555
50,6,51,California,Mono County,8,8,879,480,399
50,6,51,California,Mono County,8,9,853,463,390
50,6,51,California,Mono County,8,10,885,491,394
50,6,51,California,Mono County,8,11,1104,580,524
50,6,51,California,Mono County,8,12,1157,639,518
50,6,51,California,Mono County,8,13,1029,544,485
50,6,51,California,Mono County,8,14,773,422,351
50,6,51,California,Mono County,8,15,502,279,223
50,6,51,California,Mono County,8,16,302,144,158
50,6,51,California,Mono County,8,17,180,103,77
50,6,51,California,Mono County,8,18,152,81,71
50,6,51,California,Mono County,9,0,14256,7543,6713
50,6,51,California,Mono County,9,1,705,358,347
50,6,51,California,Mono County,9,2,762,363,399
50,6,51,California,Mono County,9,3,785,380,405
50,6,51,California,Mono County,9,4,753,400,353
50,6,51,California,Mono County,9,5,982,527,455
50,6,51,California,Mono County,9,6,1075,612,463
50,6,51,California,Mono County,9,7,1135,564,571
50,6,51,California,Mono County,9,8,916,488,428
50,6,51,California,Mono County,9,9,877,469,408
50,6,51,California,Mono County,9,10,922,516,406
50,6,51,California,Mono County,9,11,1068,571,497
50,6,51,California,Mono County,9,12,1164,635,529
50,6,51,California,Mono County,9,13,1071,567,504
50,6,51,California,Mono County,9,14,837,449,388
50,6,51,California,Mono County,9,15,551,308,243
50,6,51,California,Mono County,9,16,310,153,157
50,6,51,California,Mono County,9,17,172,96,76
50,6,51,California,Mono County,9,18,171,87,84
50,6,51,California,Mono County,10,0,14333,7586,6747
50,6,51,California,Mono County,10,1,726,370,356
50,6,51,California,Mono County,10,2,716,338,378
50,6,51,California,Mono County,10,3,772,393,379
50,6,51,California,Mono County,10,4,753,386,367
50,6,51,California,Mono County,10,5,1043,562,481
50,6,51,California,Mono County,10,6,1034,594,440
50,6,51,California,Mono County,10,7,1155,578,577
50,6,51,California,Mono County,10,8,966,510,456
50,6,51,California,Mono County,10,9,865,472,393
50,6,51,California,Mono County,10,10,914,485,429
50,6,51,California,Mono County,10,11,993,544,449
50,6,51,California,Mono County,10,12,1165,631,534
50,6,51,California,Mono County,10,13,1090,577,513
50,6,51,California,Mono County,10,14,859,454,405
50,6,51,California,Mono County,10,15,578,334,244
50,6,51,California,Mono County,10,16,330,166,164
50,6,51,California,Mono County,10,17,183,93,90
50,6,51,California,Mono County,10,18,191,99,92
50,6,51,California,Mono County,11,0,14400,7618,6782
50,6,51,California,Mono County,11,1,723,368,355
50,6,51,California,Mono County,11,2,700,331,369
50,6,51,California,Mono County,11,3,777,395,382
50,6,51,California,Mono County,11,4,753,389,364
50,6,51,California,Mono County,11,5,1024,568,456
50,6,51,California,Mono County,11,6,1038,587,451
50,6,51,California,Mono County,11,7,1118,537,581
50,6,51,California,Mono County,11,8,984,512,472
50,6,51,California,Mono County,11,9,874,485,389
50,6,51,California,Mono County,11,10,943,513,430
50,6,51,California,Mono County,11,11,943,531,412
50,6,51,California,Mono County,11,12,1146,590,556
50,6,51,California,Mono County,11,13,1118,606,512
50,6,51,California,Mono County,11,14,917,494,423
50,6,51,California,Mono County,11,15,576,324,252
50,6,51,California,Mono County,11,16,372,192,180
50,6,51,California,Mono County,11,17,192,92,100
50,6,51,California,Mono County,11,18,202,104,98
50,6,51,California,Mono County,12,0,14450,7651,6799
50,6,51,California,Mono County,12,1,693,376,317
50,6,51,California,Mono County,12,2,676,326,350
50,6,51,California,Mono County,12,3,740,362,378
50,6,51,California,Mono County,12,4,775,396,379
50,6,51,California,Mono County,12,5,979,554,425
50,6,51,California,Mono County,12,6,1093,603,490
50,6,51,California,Mono County,12,7,1131,550,581
50,6,51,California,Mono County,12,8,984,510,474
50,6,51,California,Mono County,12,9,874,451,423
50,6,51,California,Mono County,12,10,952,529,423
50,6,51,California,Mono County,12,11,895,495,400
50,6,51,California,Mono County,12,12,1108,583,525
50,6,51,California,Mono County,12,13,1178,664,514
50,6,51,California,Mono County,12,14,926,498,428
50,6,51,California,Mono County,12,15,618,330,288
50,6,51,California,Mono County,12,16,390,211,179
50,6,51,California,Mono County,12,17,225,108,117
50,6,51,California,Mono County,12,18,213,105,108
50,6,51,California,Mono County,13,0,14512,7713,6799
50,6,51,California,Mono County,13,1,661,356,305
50,6,51,California,Mono County,13,2,689,343,346
50,6,51,California,Mono County,13,3,734,352,382
50,6,51,California,Mono County,13,4,758,390,368
50,6,51,California,Mono County,13,5,958,539,419
50,6,51,California,Mono County,13,6,1081,626,455
50,6,51,California,Mono County,13,7,1162,567,595
50,6,51,California,Mono County,13,8,1008,512,496
50,6,51,California,Mono County,13,9,889,469,420
50,6,51,California,Mono County,13,10,905,497,408
50,6,51,California,Mono County,13,11,944,524,420
50,6,51,California,Mono County,13,12,1091,586,505
50,6,51,California,Mono County,13,13,1157,647,510
50,6,51,California,Mono County,13,14,944,494,450
50,6,51,California,Mono County,13,15,669,366,303
50,6,51,California,Mono County,13,16,409,226,183
50,6,51,California,Mono County,13,17,225,103,122
50,6,51,California,Mono County,13,18,228,116,112
50,6,51,California,Mono County,14,0,14534,7729,6805
50,6,51,California,Mono County,14,1,648,348,300
50,6,51,California,Mono County,14,2,696,346,350
50,6,51,California,Mono County,14,3,733,348,385
50,6,51,California,Mono County,14,4,757,391,366
50,6,51,California,Mono County,14,5,950,537,413
50,6,51,California,Mono County,14,6,1073,630,443
50,6,51,California,Mono County,14,7,1174,572,602
50,6,51,California,Mono County,14,8,1017,514,503
50,6,51,California,Mono County,14,9,897,475,422
50,6,51,California,Mono County,14,10,899,491,408
50,6,51,California,Mono County,14,11,958,532,426
50,6,51,California,Mono County,14,12,1087,586,501
50,6,51,California,Mono County,14,13,1149,640,509
50,6,51,California,Mono County,14,14,950,493,457
50,6,51,California,Mono County,14,15,680,375,305
50,6,51,California,Mono County,14,16,413,232,181
50,6,51,California,Mono County,14,17,222,101,121
50,6,51,California,Mono County,14,18,231,118,113
50,6,53,California,Monterey County,1,0,415057,213431,201626
50,6,53,California,Monterey County,1,1,32547,16723,15824
50,6,53,California,Monterey County,1,2,30577,15797,14780
50,6,53,California,Monterey County,1,3,29037,14861,14176
50,6,53,California,Monterey County,1,4,32624,16940,15684
50,6,53,California,Monterey County,1,5,32481,17714,14767
50,6,53,California,Monterey County,1,6,32063,17292,14771
50,6,53,California,Monterey County,1,7,30014,16248,13766
50,6,53,California,Monterey County,1,8,27767,14862,12905
50,6,53,California,Monterey County,1,9,27053,14550,12503
50,6,53,California,Monterey County,1,10,26678,13946,12732
50,6,53,California,Monterey County,1,11,26576,13483,13093
50,6,53,California,Monterey County,1,12,23558,11799,11759
50,6,53,California,Monterey County,1,13,19660,9784,9876
50,6,53,California,Monterey County,1,14,13390,6413,6977
50,6,53,California,Monterey County,1,15,9531,4447,5084
50,6,53,California,Monterey County,1,16,8090,3499,4591
50,6,53,California,Monterey County,1,17,6654,2725,3929
50,6,53,California,Monterey County,1,18,6757,2348,4409
50,6,53,California,Monterey County,2,0,415058,213431,201627
50,6,53,California,Monterey County,2,1,32548,16723,15825
50,6,53,California,Monterey County,2,2,30579,15797,14782
50,6,53,California,Monterey County,2,3,29038,14862,14176
50,6,53,California,Monterey County,2,4,32625,16940,15685
50,6,53,California,Monterey County,2,5,32482,17715,14767
50,6,53,California,Monterey County,2,6,32062,17292,14770
50,6,53,California,Monterey County,2,7,30014,16248,13766
50,6,53,California,Monterey County,2,8,27769,14862,12907
50,6,53,California,Monterey County,2,9,27053,14551,12502
50,6,53,California,Monterey County,2,10,26677,13946,12731
50,6,53,California,Monterey County,2,11,26575,13482,13093
50,6,53,California,Monterey County,2,12,23556,11798,11758
50,6,53,California,Monterey County,2,13,19660,9784,9876
50,6,53,California,Monterey County,2,14,13390,6413,6977
50,6,53,California,Monterey County,2,15,9530,4447,5083
50,6,53,California,Monterey County,2,16,8090,3499,4591
50,6,53,California,Monterey County,2,17,6654,2725,3929
50,6,53,California,Monterey County,2,18,6756,2347,4409
50,6,53,California,Monterey County,3,0,416358,214183,202175
50,6,53,California,Monterey County,3,1,32697,16804,15893
50,6,53,California,Monterey County,3,2,30685,15835,14850
50,6,53,California,Monterey County,3,3,28994,14847,14147
50,6,53,California,Monterey County,3,4,32470,16846,15624
50,6,53,California,Monterey County,3,5,32598,17786,14812
50,6,53,California,Monterey County,3,6,32147,17347,14800
50,6,53,California,Monterey County,3,7,30266,16389,13877
50,6,53,California,Monterey County,3,8,27778,14879,12899
50,6,53,California,Monterey County,3,9,27131,14621,12510
50,6,53,California,Monterey County,3,10,26700,13984,12716
50,6,53,California,Monterey County,3,11,26616,13486,13130
50,6,53,California,Monterey County,3,12,23660,11885,11775
50,6,53,California,Monterey County,3,13,19925,9893,10032
50,6,53,California,Monterey County,3,14,13539,6496,7043
50,6,53,California,Monterey County,3,15,9608,4484,5124
50,6,53,California,Monterey County,3,16,8034,3483,4551
50,6,53,California,Monterey County,3,17,6692,2751,3941
50,6,53,California,Monterey County,3,18,6818,2367,4451
50,6,53,California,Monterey County,4,0,420379,215960,204419
50,6,53,California,Monterey County,4,1,33414,17144,16270
50,6,53,California,Monterey County,4,2,31378,16104,15274
50,6,53,California,Monterey County,4,3,28994,14849,14145
50,6,53,California,Monterey County,4,4,31695,16399,15296
50,6,53,California,Monterey County,4,5,32965,17878,15087
50,6,53,California,Monterey County,4,6,32320,17341,14979
50,6,53,California,Monterey County,4,7,30968,16696,14272
50,6,53,California,Monterey County,4,8,27620,14804,12816
50,6,53,California,Monterey County,4,9,27392,14747,12645
50,6,53,California,Monterey County,4,10,26401,13890,12511
50,6,53,California,Monterey County,4,11,26667,13468,13199
50,6,53,California,Monterey County,4,12,23964,12080,11884
50,6,53,California,Monterey County,4,13,20803,10293,10510
50,6,53,California,Monterey County,4,14,14157,6845,7312
50,6,53,California,Monterey County,4,15,9916,4653,5263
50,6,53,California,Monterey County,4,16,7906,3470,4436
50,6,53,California,Monterey County,4,17,6805,2851,3954
50,6,53,California,Monterey County,4,18,7014,2448,4566
50,6,53,California,Monterey County,5,0,424222,217577,206645
50,6,53,California,Monterey County,5,1,33491,17186,16305
50,6,53,California,Monterey County,5,2,32185,16564,15621
50,6,53,California,Monterey County,5,3,29321,14943,14378
50,6,53,California,Monterey County,5,4,30983,15915,15068
50,6,53,California,Monterey County,5,5,33214,17999,15215
50,6,53,California,Monterey County,5,6,32278,17211,15067
50,6,53,California,Monterey County,5,7,31502,16906,14596
50,6,53,California,Monterey County,5,8,27830,14906,12924
50,6,53,California,Monterey County,5,9,27509,14759,12750
50,6,53,California,Monterey County,5,10,26094,13833,12261
50,6,53,California,Monterey County,5,11,26609,13464,13145
50,6,53,California,Monterey County,5,12,24496,12268,12228
50,6,53,California,Monterey County,5,13,20911,10353,10558
50,6,53,California,Monterey County,5,14,15563,7529,8034
50,6,53,California,Monterey County,5,15,10336,4856,5480
50,6,53,California,Monterey County,5,16,7919,3486,4433
50,6,53,California,Monterey County,5,17,6746,2859,3887
50,6,53,California,Monterey County,5,18,7235,2540,4695
50,6,53,California,Monterey County,6,0,426163,218032,208131
50,6,53,California,Monterey County,6,1,33344,17029,16315
50,6,53,California,Monterey County,6,2,32884,16895,15989
50,6,53,California,Monterey County,6,3,29617,15116,14501
50,6,53,California,Monterey County,6,4,30402,15569,14833
50,6,53,California,Monterey County,6,5,33055,17719,15336
50,6,53,California,Monterey County,6,6,32012,17051,14961
50,6,53,California,Monterey County,6,7,31746,17022,14724
50,6,53,California,Monterey County,6,8,27991,14975,13016
50,6,53,California,Monterey County,6,9,27300,14584,12716
50,6,53,California,Monterey County,6,10,25968,13825,12143
50,6,53,California,Monterey County,6,11,26263,13287,12976
50,6,53,California,Monterey County,6,12,24793,12251,12542
50,6,53,California,Monterey County,6,13,21293,10590,10703
50,6,53,California,Monterey County,6,14,16404,7884,8520
50,6,53,California,Monterey County,6,15,10959,5172,5787
50,6,53,California,Monterey County,6,16,7977,3547,4430
50,6,53,California,Monterey County,6,17,6682,2838,3844
50,6,53,California,Monterey County,6,18,7473,2678,4795
50,6,53,California,Monterey County,7,0,427985,218311,209674
50,6,53,California,Monterey County,7,1,33283,16995,16288
50,6,53,California,Monterey County,7,2,33127,16923,16204
50,6,53,California,Monterey County,7,3,30008,15306,14702
50,6,53,California,Monterey County,7,4,29960,15325,14635
50,6,53,California,Monterey County,7,5,33014,17475,15539
50,6,53,California,Monterey County,7,6,31690,16807,14883
50,6,53,California,Monterey County,7,7,31841,17005,14836
50,6,53,California,Monterey County,7,8,28005,14941,13064
50,6,53,California,Monterey County,7,9,27110,14469,12641
50,6,53,California,Monterey County,7,10,25732,13687,12045
50,6,53,California,Monterey County,7,11,25976,13150,12826
50,6,53,California,Monterey County,7,12,25023,12325,12698
50,6,53,California,Monterey County,7,13,21791,10757,11034
50,6,53,California,Monterey County,7,14,17349,8383,8966
50,6,53,California,Monterey County,7,15,11610,5473,6137
50,6,53,California,Monterey County,7,16,8116,3681,4435
50,6,53,California,Monterey County,7,17,6610,2797,3813
50,6,53,California,Monterey County,7,18,7740,2812,4928
50,6,53,California,Monterey County,8,0,430178,219288,210890
50,6,53,California,Monterey County,8,1,33057,16803,16254
50,6,53,California,Monterey County,8,2,33155,16971,16184
50,6,53,California,Monterey County,8,3,30469,15651,14818
50,6,53,California,Monterey County,8,4,30125,15306,14819
50,6,53,California,Monterey County,8,5,32639,17240,15399
50,6,53,California,Monterey County,8,6,31513,16708,14805
50,6,53,California,Monterey County,8,7,31615,16865,14750
50,6,53,California,Monterey County,8,8,28661,15249,13412
50,6,53,California,Monterey County,8,9,26581,14202,12379
50,6,53,California,Monterey County,8,10,25987,13767,12220
50,6,53,California,Monterey County,8,11,25472,12961,12511
50,6,53,California,Monterey County,8,12,25270,12424,12846
50,6,53,California,Monterey County,8,13,22244,10986,11258
50,6,53,California,Monterey County,8,14,18227,8831,9396
50,6,53,California,Monterey County,8,15,12282,5785,6497
50,6,53,California,Monterey County,8,16,8372,3841,4531
50,6,53,California,Monterey County,8,17,6599,2810,3789
50,6,53,California,Monterey County,8,18,7910,2888,5022
50,6,53,California,Monterey County,9,0,433436,221191,212245
50,6,53,California,Monterey County,9,1,32390,16580,15810
50,6,53,California,Monterey County,9,2,33400,17065,16335
50,6,53,California,Monterey County,9,3,31038,15891,15147
50,6,53,California,Monterey County,9,4,30420,15383,15037
50,6,53,California,Monterey County,9,5,32020,16890,15130
50,6,53,California,Monterey County,9,6,31652,16783,14869
50,6,53,California,Monterey County,9,7,31749,17054,14695
50,6,53,California,Monterey County,9,8,29141,15449,13692
50,6,53,California,Monterey County,9,9,26516,14244,12272
50,6,53,California,Monterey County,9,10,26302,13972,12330
50,6,53,California,Monterey County,9,11,25280,12983,12297
50,6,53,California,Monterey County,9,12,25453,12469,12984
50,6,53,California,Monterey County,9,13,22650,11248,11402
50,6,53,California,Monterey County,9,14,19184,9271,9913
50,6,53,California,Monterey County,9,15,12921,6123,6798
50,6,53,California,Monterey County,9,16,8701,3999,4702
50,6,53,California,Monterey County,9,17,6486,2765,3721
50,6,53,California,Monterey County,9,18,8133,3022,5111
50,6,53,California,Monterey County,10,0,433803,221112,212691
50,6,53,California,Monterey County,10,1,31459,16019,15440
50,6,53,California,Monterey County,10,2,33240,17042,16198
50,6,53,California,Monterey County,10,3,31731,16232,15499
50,6,53,California,Monterey County,10,4,30420,15235,15185
50,6,53,California,Monterey County,10,5,31010,16233,14777
50,6,53,California,Monterey County,10,6,31633,16730,14903
50,6,53,California,Monterey County,10,7,31231,16715,14516
50,6,53,California,Monterey County,10,8,29522,15662,13860
50,6,53,California,Monterey County,10,9,26668,14348,12320
50,6,53,California,Monterey County,10,10,26319,13973,12346
50,6,53,California,Monterey County,10,11,24998,12971,12027
50,6,53,California,Monterey County,10,12,25338,12480,12858
50,6,53,California,Monterey County,10,13,23188,11448,11740
50,6,53,California,Monterey County,10,14,19281,9330,9951
50,6,53,California,Monterey County,10,15,14059,6658,7401
50,6,53,California,Monterey County,10,16,9003,4197,4806
50,6,53,California,Monterey County,10,17,6427,2735,3692
50,6,53,California,Monterey County,10,18,8276,3104,5172
50,6,53,California,Monterey County,11,0,433359,220408,212951
50,6,53,California,Monterey County,11,1,30622,15588,15034
50,6,53,California,Monterey County,11,2,32733,16768,15965
50,6,53,California,Monterey County,11,3,32166,16436,15730
50,6,53,California,Monterey County,11,4,30698,15370,15328
50,6,53,California,Monterey County,11,5,30301,15694,14607
50,6,53,California,Monterey County,11,6,31204,16414,14790
50,6,53,California,Monterey County,11,7,30802,16523,14279
50,6,53,California,Monterey County,11,8,29652,15684,13968
50,6,53,California,Monterey County,11,9,26873,14434,12439
50,6,53,California,Monterey County,11,10,26037,13790,12247
50,6,53,California,Monterey County,11,11,24823,12968,11855
50,6,53,California,Monterey County,11,12,25060,12393,12667
50,6,53,California,Monterey County,11,13,23445,11403,12042
50,6,53,California,Monterey County,11,14,19597,9533,10064
50,6,53,California,Monterey County,11,15,14880,6998,7882
50,6,53,California,Monterey County,11,16,9578,4436,5142
50,6,53,California,Monterey County,11,17,6570,2867,3703
50,6,53,California,Monterey County,11,18,8318,3109,5209
50,6,53,California,Monterey County,12,0,433380,220502,212878
50,6,53,California,Monterey County,12,1,29985,15303,14682
50,6,53,California,Monterey County,12,2,32427,16635,15792
50,6,53,California,Monterey County,12,3,32053,16337,15716
50,6,53,California,Monterey County,12,4,31140,15623,15517
50,6,53,California,Monterey County,12,5,29887,15475,14412
50,6,53,California,Monterey County,12,6,31333,16467,14866
50,6,53,California,Monterey County,12,7,30446,16389,14057
50,6,53,California,Monterey County,12,8,29766,15854,13912
50,6,53,California,Monterey County,12,9,26786,14273,12513
50,6,53,California,Monterey County,12,10,26011,13798,12213
50,6,53,California,Monterey County,12,11,24494,12772,11722
50,6,53,California,Monterey County,12,12,24710,12294,12416
50,6,53,California,Monterey County,12,13,23547,11459,12088
50,6,53,California,Monterey County,12,14,19860,9600,10260
50,6,53,California,Monterey County,12,15,15696,7459,8237
50,6,53,California,Monterey County,12,16,10135,4654,5481
50,6,53,California,Monterey County,12,17,6714,2978,3736
50,6,53,California,Monterey County,12,18,8390,3132,5258
50,6,53,California,Monterey County,13,0,431854,219545,212309
50,6,53,California,Monterey County,13,1,29359,14946,14413
50,6,53,California,Monterey County,13,2,32193,16458,15735
50,6,53,California,Monterey County,13,3,31855,16264,15591
50,6,53,California,Monterey County,13,4,31187,15717,15470
50,6,53,California,Monterey County,13,5,29516,15257,14259
50,6,53,California,Monterey County,13,6,30793,16150,14643
50,6,53,California,Monterey County,13,7,30238,16256,13982
50,6,53,California,Monterey County,13,8,29439,15654,13785
50,6,53,California,Monterey County,13,9,27137,14444,12693
50,6,53,California,Monterey County,13,10,25533,13503,12030
50,6,53,California,Monterey County,13,11,24547,12823,11724
50,6,53,California,Monterey County,13,12,24130,12067,12063
50,6,53,California,Monterey County,13,13,23627,11465,12162
50,6,53,California,Monterey County,13,14,20172,9747,10425
50,6,53,California,Monterey County,13,15,16265,7720,8545
50,6,53,California,Monterey County,13,16,10550,4877,5673
50,6,53,California,Monterey County,13,17,6836,3041,3795
50,6,53,California,Monterey County,13,18,8477,3156,5321
50,6,53,California,Monterey County,14,0,430906,219005,211901
50,6,53,California,Monterey County,14,1,29141,14818,14323
50,6,53,California,Monterey County,14,2,32072,16374,15698
50,6,53,California,Monterey County,14,3,31749,16221,15528
50,6,53,California,Monterey County,14,4,31170,15730,15440
50,6,53,California,Monterey County,14,5,29344,15159,14185
50,6,53,California,Monterey County,14,6,30566,16025,14541
50,6,53,California,Monterey County,14,7,30167,16205,13962
50,6,53,California,Monterey County,14,8,29341,15600,13741
50,6,53,California,Monterey County,14,9,27226,14491,12735
50,6,53,California,Monterey County,14,10,25380,13408,11972
50,6,53,California,Monterey County,14,11,24574,12842,11732
50,6,53,California,Monterey County,14,12,23910,11983,11927
50,6,53,California,Monterey County,14,13,23632,11451,12181
50,6,53,California,Monterey County,14,14,20267,9792,10475
50,6,53,California,Monterey County,14,15,16416,7787,8629
50,6,53,California,Monterey County,14,16,10649,4928,5721
50,6,53,California,Monterey County,14,17,6860,3054,3806
50,6,53,California,Monterey County,14,18,8442,3137,5305
50,6,55,California,Napa County,1,0,136484,68159,68325
50,6,55,California,Napa County,1,1,8131,4196,3935
50,6,55,California,Napa County,1,2,8576,4411,4165
50,6,55,California,Napa County,1,3,9040,4639,4401
50,6,55,California,Napa County,1,4,9473,4836,4637
50,6,55,California,Napa County,1,5,8289,4461,3828
50,6,55,California,Napa County,1,6,8519,4511,4008
50,6,55,California,Napa County,1,7,8236,4255,3981
50,6,55,California,Napa County,1,8,8526,4363,4163
50,6,55,California,Napa County,1,9,9325,4614,4711
50,6,55,California,Napa County,1,10,9937,4960,4977
50,6,55,California,Napa County,1,11,9995,4995,5000
50,6,55,California,Napa County,1,12,9423,4544,4879
50,6,55,California,Napa County,1,13,8420,4144,4276
50,6,55,California,Napa County,1,14,6161,2976,3185
50,6,55,California,Napa County,1,15,4361,2065,2296
50,6,55,California,Napa County,1,16,3628,1671,1957
50,6,55,California,Napa County,1,17,2948,1252,1696
50,6,55,California,Napa County,1,18,3496,1266,2230
50,6,55,California,Napa County,2,0,136535,68199,68336
50,6,55,California,Napa County,2,1,8131,4196,3935
50,6,55,California,Napa County,2,2,8576,4411,4165
50,6,55,California,Napa County,2,3,9040,4639,4401
50,6,55,California,Napa County,2,4,9473,4836,4637
50,6,55,California,Napa County,2,5,8291,4463,3828
50,6,55,California,Napa County,2,6,8526,4517,4009
50,6,55,California,Napa County,2,7,8238,4256,3982
50,6,55,California,Napa County,2,8,8532,4369,4163
50,6,55,California,Napa County,2,9,9335,4622,4713
50,6,55,California,Napa County,2,10,9947,4968,4979
50,6,55,California,Napa County,2,11,10001,4999,5002
50,6,55,California,Napa County,2,12,9427,4548,4879
50,6,55,California,Napa County,2,13,8419,4143,4276
50,6,55,California,Napa County,2,14,6163,2977,3186
50,6,55,California,Napa County,2,15,4363,2065,2298
50,6,55,California,Napa County,2,16,3628,1671,1957
50,6,55,California,Napa County,2,17,2948,1252,1696
50,6,55,California,Napa County,2,18,3497,1267,2230
50,6,55,California,Napa County,3,0,136752,68283,68469
50,6,55,California,Napa County,3,1,8129,4197,3932
50,6,55,California,Napa County,3,2,8594,4425,4169
50,6,55,California,Napa County,3,3,9052,4641,4411
50,6,55,California,Napa County,3,4,9444,4816,4628
50,6,55,California,Napa County,3,5,8345,4488,3857
50,6,55,California,Napa County,3,6,8545,4526,4019
50,6,55,California,Napa County,3,7,8253,4260,3993
50,6,55,California,Napa County,3,8,8518,4357,4161
50,6,55,California,Napa County,3,9,9306,4616,4690
50,6,55,California,Napa County,3,10,9923,4956,4967
50,6,55,California,Napa County,3,11,10025,4998,5027
50,6,55,California,Napa County,3,12,9441,4549,4892
50,6,55,California,Napa County,3,13,8489,4186,4303
50,6,55,California,Napa County,3,14,6214,2996,3218
50,6,55,California,Napa County,3,15,4404,2084,2320
50,6,55,California,Napa County,3,16,3635,1680,1955
50,6,55,California,Napa County,3,17,2937,1252,1685
50,6,55,California,Napa County,3,18,3498,1256,2242
50,6,55,California,Napa County,4,0,137668,68670,68998
50,6,55,California,Napa County,4,1,8043,4134,3909
50,6,55,California,Napa County,4,2,8642,4472,4170
50,6,55,California,Napa County,4,3,9052,4620,4432
50,6,55,California,Napa County,4,4,9357,4773,4584
50,6,55,California,Napa County,4,5,8465,4550,3915
50,6,55,California,Napa County,4,6,8531,4464,4067
50,6,55,California,Napa County,4,7,8470,4353,4117
50,6,55,California,Napa County,4,8,8448,4288,4160
50,6,55,California,Napa County,4,9,9252,4615,4637
50,6,55,California,Napa County,4,10,9771,4912,4859
50,6,55,California,Napa County,4,11,10096,5019,5077
50,6,55,California,Napa County,4,12,9490,4565,4925
50,6,55,California,Napa County,4,13,8832,4367,4465
50,6,55,California,Napa County,4,14,6436,3100,3336
50,6,55,California,Napa County,4,15,4597,2184,2413
50,6,55,California,Napa County,4,16,3687,1709,1978
50,6,55,California,Napa County,4,17,2926,1263,1663
50,6,55,California,Napa County,4,18,3573,1282,2291
50,6,55,California,Napa County,5,0,138504,69087,69417
50,6,55,California,Napa County,5,1,7925,4098,3827
50,6,55,California,Napa County,5,2,8668,4484,4184
50,6,55,California,Napa County,5,3,8921,4517,4404
50,6,55,California,Napa County,5,4,9250,4732,4518
50,6,55,California,Napa County,5,5,8703,4645,4058
50,6,55,California,Napa County,5,6,8484,4435,4049
50,6,55,California,Napa County,5,7,8573,4405,4168
50,6,55,California,Napa County,5,8,8488,4316,4172
50,6,55,California,Napa County,5,9,9206,4578,4628
50,6,55,California,Napa County,5,10,9609,4827,4782
50,6,55,California,Napa County,5,11,10002,4987,5015
50,6,55,California,Napa County,5,12,9681,4662,5019
50,6,55,California,Napa County,5,13,8797,4335,4462
50,6,55,California,Napa County,5,14,7074,3402,3672
50,6,55,California,Napa County,5,15,4839,2326,2513
50,6,55,California,Napa County,5,16,3725,1710,2015
50,6,55,California,Napa County,5,17,2976,1336,1640
50,6,55,California,Napa County,5,18,3583,1292,2291
50,6,55,California,Napa County,6,0,139522,69510,70012
50,6,55,California,Napa County,6,1,7796,4030,3766
50,6,55,California,Napa County,6,2,8644,4476,4168
50,6,55,California,Napa County,6,3,8904,4448,4456
50,6,55,California,Napa County,6,4,9264,4739,4525
50,6,55,California,Napa County,6,5,8953,4693,4260
50,6,55,California,Napa County,6,6,8345,4381,3964
50,6,55,California,Napa County,6,7,8764,4490,4274
50,6,55,California,Napa County,6,8,8516,4350,4166
50,6,55,California,Napa County,6,9,9233,4584,4649
50,6,55,California,Napa County,6,10,9438,4721,4717
50,6,55,California,Napa County,6,11,9939,5017,4922
50,6,55,California,Napa County,6,12,9751,4710,5041
50,6,55,California,Napa County,6,13,8960,4352,4608
50,6,55,California,Napa County,6,14,7418,3600,3818
50,6,55,California,Napa County,6,15,5174,2443,2731
50,6,55,California,Napa County,6,16,3869,1812,2057
50,6,55,California,Napa County,6,17,2960,1360,1600
50,6,55,California,Napa County,6,18,3594,1304,2290
50,6,55,California,Napa County,7,0,140331,69978,70353
50,6,55,California,Napa County,7,1,7610,3965,3645
50,6,55,California,Napa County,7,2,8592,4431,4161
50,6,55,California,Napa County,7,3,8937,4478,4459
50,6,55,California,Napa County,7,4,9194,4704,4490
50,6,55,California,Napa County,7,5,9059,4710,4349
50,6,55,California,Napa County,7,6,8424,4394,4030
50,6,55,California,Napa County,7,7,8862,4551,4311
50,6,55,California,Napa County,7,8,8611,4390,4221
50,6,55,California,Napa County,7,9,9159,4598,4561
50,6,55,California,Napa County,7,10,9361,4670,4691
50,6,55,California,Napa County,7,11,10012,5055,4957
50,6,55,California,Napa County,7,12,9682,4777,4905
50,6,55,California,Napa County,7,13,9095,4323,4772
50,6,55,California,Napa County,7,14,7669,3757,3912
50,6,55,California,Napa County,7,15,5499,2600,2899
50,6,55,California,Napa County,7,16,3975,1860,2115
50,6,55,California,Napa County,7,17,2980,1399,1581
50,6,55,California,Napa County,7,18,3610,1316,2294
50,6,55,California,Napa County,8,0,140766,70201,70565
50,6,55,California,Napa County,8,1,7509,3939,3570
50,6,55,California,Napa County,8,2,8463,4335,4128
50,6,55,California,Napa County,8,3,8930,4539,4391
50,6,55,California,Napa County,8,4,9100,4647,4453
50,6,55,California,Napa County,8,5,9026,4563,4463
50,6,55,California,Napa County,8,6,8512,4465,4047
50,6,55,California,Napa County,8,7,8727,4481,4246
50,6,55,California,Napa County,8,8,8811,4468,4343
50,6,55,California,Napa County,8,9,8919,4577,4342
50,6,55,California,Napa County,8,10,9415,4621,4794
50,6,55,California,Napa County,8,11,9850,5003,4847
50,6,55,California,Napa County,8,12,9737,4803,4934
50,6,55,California,Napa County,8,13,9194,4384,4810
50,6,55,California,Napa County,8,14,8012,3930,4082
50,6,55,California,Napa County,8,15,5776,2731,3045
50,6,55,California,Napa County,8,16,4104,1947,2157
50,6,55,California,Napa County,8,17,2996,1404,1592
50,6,55,California,Napa County,8,18,3685,1364,2321
50,6,55,California,Napa County,9,0,140778,70105,70673
50,6,55,California,Napa County,9,1,7372,3845,3527
50,6,55,California,Napa County,9,2,8248,4249,3999
50,6,55,California,Napa County,9,3,8886,4563,4323
50,6,55,California,Napa County,9,4,9010,4569,4441
50,6,55,California,Napa County,9,5,8799,4449,4350
50,6,55,California,Napa County,9,6,8596,4415,4181
50,6,55,California,Napa County,9,7,8726,4498,4228
50,6,55,California,Napa County,9,8,8912,4503,4409
50,6,55,California,Napa County,9,9,8781,4462,4319
50,6,55,California,Napa County,9,10,9389,4661,4728
50,6,55,California,Napa County,9,11,9637,4885,4752
50,6,55,California,Napa County,9,12,9754,4778,4976
50,6,55,California,Napa County,9,13,9285,4428,4857
50,6,55,California,Napa County,9,14,8405,4125,4280
50,6,55,California,Napa County,9,15,5900,2793,3107
50,6,55,California,Napa County,9,16,4312,2046,2266
50,6,55,California,Napa County,9,17,3114,1467,1647
50,6,55,California,Napa County,9,18,3652,1369,2283
50,6,55,California,Napa County,10,0,139818,69695,70123
50,6,55,California,Napa County,10,1,7040,3639,3401
50,6,55,California,Napa County,10,2,8016,4147,3869
50,6,55,California,Napa County,10,3,8811,4564,4247
50,6,55,California,Napa County,10,4,8876,4527,4349
50,6,55,California,Napa County,10,5,8655,4413,4242
50,6,55,California,Napa County,10,6,8593,4368,4225
50,6,55,California,Napa County,10,7,8631,4414,4217
50,6,55,California,Napa County,10,8,8880,4508,4372
50,6,55,California,Napa County,10,9,8685,4432,4253
50,6,55,California,Napa County,10,10,9314,4636,4678
50,6,55,California,Napa County,10,11,9442,4755,4687
50,6,55,California,Napa County,10,12,9637,4776,4861
50,6,55,California,Napa County,10,13,9245,4427,4818
50,6,55,California,Napa County,10,14,8305,4032,4273
50,6,55,California,Napa County,10,15,6427,3042,3385
50,6,55,California,Napa County,10,16,4456,2142,2314
50,6,55,California,Napa County,10,17,3158,1490,1668
50,6,55,California,Napa County,10,18,3647,1383,2264
50,6,55,California,Napa County,11,0,138620,69073,69547
50,6,55,California,Napa County,11,1,6884,3524,3360
50,6,55,California,Napa County,11,2,7746,4023,3723
50,6,55,California,Napa County,11,3,8595,4458,4137
50,6,55,California,Napa County,11,4,8735,4417,4318
50,6,55,California,Napa County,11,5,8450,4307,4143
50,6,55,California,Napa County,11,6,8670,4419,4251
50,6,55,California,Napa County,11,7,8425,4273,4152
50,6,55,California,Napa County,11,8,8891,4567,4324
50,6,55,California,Napa County,11,9,8640,4401,4239
50,6,55,California,Napa County,11,10,9086,4529,4557
50,6,55,California,Napa County,11,11,9175,4557,4618
50,6,55,California,Napa County,11,12,9623,4818,4805
50,6,55,California,Napa County,11,13,9165,4439,4726
50,6,55,California,Napa County,11,14,8314,3986,4328
50,6,55,California,Napa County,11,15,6684,3199,3485
50,6,55,California,Napa County,11,16,4715,2237,2478
50,6,55,California,Napa County,11,17,3246,1554,1692
50,6,55,California,Napa County,11,18,3576,1365,2211
50,6,55,California,Napa County,12,0,137678,68572,69106
50,6,55,California,Napa County,12,1,6625,3425,3200
50,6,55,California,Napa County,12,2,7503,3844,3659
50,6,55,California,Napa County,12,3,8380,4335,4045
50,6,55,California,Napa County,12,4,8686,4400,4286
50,6,55,California,Napa County,12,5,8291,4265,4026
50,6,55,California,Napa County,12,6,8655,4376,4279
50,6,55,California,Napa County,12,7,8397,4263,4134
50,6,55,California,Napa County,12,8,8843,4555,4288
50,6,55,California,Napa County,12,9,8501,4294,4207
50,6,55,California,Napa County,12,10,8873,4441,4432
50,6,55,California,Napa County,12,11,8968,4459,4509
50,6,55,California,Napa County,12,12,9621,4804,4817
50,6,55,California,Napa County,12,13,9148,4494,4654
50,6,55,California,Napa County,12,14,8390,3930,4460
50,6,55,California,Napa County,12,15,6907,3361,3546
50,6,55,California,Napa County,12,16,4919,2324,2595
50,6,55,California,Napa County,12,17,3351,1594,1757
50,6,55,California,Napa County,12,18,3620,1408,2212
50,6,55,California,Napa County,13,0,136493,67955,68538
50,6,55,California,Napa County,13,1,6382,3266,3116
50,6,55,California,Napa County,13,2,7336,3790,3546
50,6,55,California,Napa County,13,3,8244,4212,4032
50,6,55,California,Napa County,13,4,8641,4414,4227
50,6,55,California,Napa County,13,5,8108,4215,3893
50,6,55,California,Napa County,13,6,8540,4313,4227
50,6,55,California,Napa County,13,7,8226,4137,4089
50,6,55,California,Napa County,13,8,8723,4506,4217
50,6,55,California,Napa County,13,9,8570,4332,4238
50,6,55,California,Napa County,13,10,8613,4406,4207
50,6,55,California,Napa County,13,11,8956,4399,4557
50,6,55,California,Napa County,13,12,9435,4733,4702
50,6,55,California,Napa County,13,13,9165,4483,4682
50,6,55,California,Napa County,13,14,8308,3900,4408
50,6,55,California,Napa County,13,15,7134,3434,3700
50,6,55,California,Napa County,13,16,5059,2376,2683
50,6,55,California,Napa County,13,17,3397,1616,1781
50,6,55,California,Napa County,13,18,3656,1423,2233
50,6,55,California,Napa County,14,0,135965,67678,68287
50,6,55,California,Napa County,14,1,6295,3206,3089
50,6,55,California,Napa County,14,2,7269,3768,3501
50,6,55,California,Napa County,14,3,8191,4168,4023
50,6,55,California,Napa County,14,4,8617,4412,4205
50,6,55,California,Napa County,14,5,8034,4189,3845
50,6,55,California,Napa County,14,6,8489,4284,4205
50,6,55,California,Napa County,14,7,8168,4092,4076
50,6,55,California,Napa County,14,8,8675,4489,4186
50,6,55,California,Napa County,14,9,8596,4348,4248
50,6,55,California,Napa County,14,10,8528,4395,4133
50,6,55,California,Napa County,14,11,8966,4384,4582
50,6,55,California,Napa County,14,12,9368,4710,4658
50,6,55,California,Napa County,14,13,9163,4472,4691
50,6,55,California,Napa County,14,14,8284,3893,4391
50,6,55,California,Napa County,14,15,7192,3448,3744
50,6,55,California,Napa County,14,16,5086,2384,2702
50,6,55,California,Napa County,14,17,3405,1621,1784
50,6,55,California,Napa County,14,18,3639,1415,2224
50,6,57,California,Nevada County,1,0,98764,48835,49929
50,6,57,California,Nevada County,1,1,4365,2260,2105
50,6,57,California,Nevada County,1,2,4950,2510,2440
50,6,57,California,Nevada County,1,3,5798,3016,2782
50,6,57,California,Nevada County,1,4,6091,3134,2957
50,6,57,California,Nevada County,1,5,4439,2375,2064
50,6,57,California,Nevada County,1,6,4839,2589,2250
50,6,57,California,Nevada County,1,7,4815,2474,2341
50,6,57,California,Nevada County,1,8,4830,2517,2313
50,6,57,California,Nevada County,1,9,5655,2820,2835
50,6,57,California,Nevada County,1,10,7257,3455,3802
50,6,57,California,Nevada County,1,11,8569,4033,4536
50,6,57,California,Nevada County,1,12,9156,4329,4827
50,6,57,California,Nevada County,1,13,8826,4472,4354
50,6,57,California,Nevada County,1,14,6243,3043,3200
50,6,57,California,Nevada County,1,15,4355,2171,2184
50,6,57,California,Nevada County,1,16,3170,1508,1662
50,6,57,California,Nevada County,1,17,2647,1147,1500
50,6,57,California,Nevada County,1,18,2759,982,1777
50,6,57,California,Nevada County,2,0,98749,48827,49922
50,6,57,California,Nevada County,2,1,4362,2259,2103
50,6,57,California,Nevada County,2,2,4948,2508,2440
50,6,57,California,Nevada County,2,3,5798,3016,2782
50,6,57,California,Nevada County,2,4,6091,3134,2957
50,6,57,California,Nevada County,2,5,4435,2373,2062
50,6,57,California,Nevada County,2,6,4839,2589,2250
50,6,57,California,Nevada County,2,7,4815,2474,2341
50,6,57,California,Nevada County,2,8,4826,2515,2311
50,6,57,California,Nevada County,2,9,5653,2819,2834
50,6,57,California,Nevada County,2,10,7257,3455,3802
50,6,57,California,Nevada County,2,11,8569,4033,4536
50,6,57,California,Nevada County,2,12,9154,4328,4826
50,6,57,California,Nevada County,2,13,8826,4471,4355
50,6,57,California,Nevada County,2,14,6244,3044,3200
50,6,57,California,Nevada County,2,15,4356,2172,2184
50,6,57,California,Nevada County,2,16,3170,1508,1662
50,6,57,California,Nevada County,2,17,2647,1147,1500
50,6,57,California,Nevada County,2,18,2759,982,1777
50,6,57,California,Nevada County,3,0,98795,48846,49949
50,6,57,California,Nevada County,3,1,4356,2246,2110
50,6,57,California,Nevada County,3,2,4917,2494,2423
50,6,57,California,Nevada County,3,3,5764,2999,2765
50,6,57,California,Nevada County,3,4,6070,3121,2949
50,6,57,California,Nevada County,3,5,4483,2389,2094
50,6,57,California,Nevada County,3,6,4841,2586,2255
50,6,57,California,Nevada County,3,7,4836,2497,2339
50,6,57,California,Nevada County,3,8,4789,2498,2291
50,6,57,California,Nevada County,3,9,5653,2820,2833
50,6,57,California,Nevada County,3,10,7144,3407,3737
50,6,57,California,Nevada County,3,11,8530,4009,4521
50,6,57,California,Nevada County,3,12,9144,4321,4823
50,6,57,California,Nevada County,3,13,8932,4515,4417
50,6,57,California,Nevada County,3,14,6314,3079,3235
50,6,57,California,Nevada County,3,15,4417,2198,2219
50,6,57,California,Nevada County,3,16,3173,1523,1650
50,6,57,California,Nevada County,3,17,2633,1144,1489
50,6,57,California,Nevada County,3,18,2799,1000,1799
50,6,57,California,Nevada County,4,0,98716,48772,49944
50,6,57,California,Nevada County,4,1,4298,2192,2106
50,6,57,California,Nevada County,4,2,4834,2475,2359
50,6,57,California,Nevada County,4,3,5609,2894,2715
50,6,57,California,Nevada County,4,4,5931,3088,2843
50,6,57,California,Nevada County,4,5,4620,2442,2178
50,6,57,California,Nevada County,4,6,4783,2544,2239
50,6,57,California,Nevada County,4,7,4912,2567,2345
50,6,57,California,Nevada County,4,8,4658,2425,2233
50,6,57,California,Nevada County,4,9,5634,2802,2832
50,6,57,California,Nevada County,4,10,6683,3221,3462
50,6,57,California,Nevada County,4,11,8338,3885,4453
50,6,57,California,Nevada County,4,12,9066,4280,4786
50,6,57,California,Nevada County,4,13,9390,4696,4694
50,6,57,California,Nevada County,4,14,6597,3241,3356
50,6,57,California,Nevada County,4,15,4694,2300,2394
50,6,57,California,Nevada County,4,16,3193,1561,1632
50,6,57,California,Nevada County,4,17,2587,1137,1450
50,6,57,California,Nevada County,4,18,2889,1022,1867
50,6,57,California,Nevada County,5,0,98165,48455,49710
50,6,57,California,Nevada County,5,1,4205,2143,2062
50,6,57,California,Nevada County,5,2,4779,2424,2355
50,6,57,California,Nevada County,5,3,5387,2770,2617
50,6,57,California,Nevada County,5,4,5699,2996,2703
50,6,57,California,Nevada County,5,5,4628,2443,2185
50,6,57,California,Nevada County,5,6,4692,2477,2215
50,6,57,California,Nevada County,5,7,5009,2632,2377
50,6,57,California,Nevada County,5,8,4736,2435,2301
50,6,57,California,Nevada County,5,9,5406,2722,2684
50,6,57,California,Nevada County,5,10,6336,3099,3237
50,6,57,California,Nevada County,5,11,7914,3633,4281
50,6,57,California,Nevada County,5,12,9109,4308,4801
50,6,57,California,Nevada County,5,13,9216,4547,4669
50,6,57,California,Nevada County,5,14,7333,3630,3703
50,6,57,California,Nevada County,5,15,4974,2419,2555
50,6,57,California,Nevada County,5,16,3213,1582,1631
50,6,57,California,Nevada County,5,17,2567,1158,1409
50,6,57,California,Nevada County,5,18,2962,1037,1925
50,6,57,California,Nevada County,6,0,97969,48364,49605
50,6,57,California,Nevada County,6,1,4217,2178,2039
50,6,57,California,Nevada County,6,2,4771,2421,2350
50,6,57,California,Nevada County,6,3,5230,2671,2559
50,6,57,California,Nevada County,6,4,5423,2861,2562
50,6,57,California,Nevada County,6,5,4707,2453,2254
50,6,57,California,Nevada County,6,6,4590,2429,2161
50,6,57,California,Nevada County,6,7,5108,2662,2446
50,6,57,California,Nevada County,6,8,4880,2507,2373
50,6,57,California,Nevada County,6,9,5258,2679,2579
50,6,57,California,Nevada County,6,10,5913,2893,3020
50,6,57,California,Nevada County,6,11,7647,3571,4076
50,6,57,California,Nevada County,6,12,8970,4212,4758
50,6,57,California,Nevada County,6,13,9291,4501,4790
50,6,57,California,Nevada County,6,14,7824,3895,3929
50,6,57,California,Nevada County,6,15,5261,2533,2728
50,6,57,California,Nevada County,6,16,3445,1714,1731
50,6,57,California,Nevada County,6,17,2494,1135,1359
50,6,57,California,Nevada County,6,18,2940,1049,1891
50,6,57,California,Nevada County,7,0,98605,48563,50042
50,6,57,California,Nevada County,7,1,4242,2200,2042
50,6,57,California,Nevada County,7,2,4786,2393,2393
50,6,57,California,Nevada County,7,3,5179,2639,2540
50,6,57,California,Nevada County,7,4,5326,2824,2502
50,6,57,California,Nevada County,7,5,4774,2457,2317
50,6,57,California,Nevada County,7,6,4619,2434,2185
50,6,57,California,Nevada County,7,7,5169,2629,2540
50,6,57,California,Nevada County,7,8,5096,2624,2472
50,6,57,California,Nevada County,7,9,5121,2650,2471
50,6,57,California,Nevada County,7,10,5628,2784,2844
50,6,57,California,Nevada County,7,11,7417,3480,3937
50,6,57,California,Nevada County,7,12,8788,4060,4728
50,6,57,California,Nevada County,7,13,9377,4478,4899
50,6,57,California,Nevada County,7,14,8367,4165,4202
50,6,57,California,Nevada County,7,15,5577,2709,2868
50,6,57,California,Nevada County,7,16,3673,1823,1850
50,6,57,California,Nevada County,7,17,2465,1134,1331
50,6,57,California,Nevada County,7,18,3001,1080,1921
50,6,57,California,Nevada County,8,0,98716,48614,50102
50,6,57,California,Nevada County,8,1,4224,2189,2035
50,6,57,California,Nevada County,8,2,4747,2412,2335
50,6,57,California,Nevada County,8,3,5080,2594,2486
50,6,57,California,Nevada County,8,4,5213,2749,2464
50,6,57,California,Nevada County,8,5,4599,2375,2224
50,6,57,California,Nevada County,8,6,4595,2404,2191
50,6,57,California,Nevada County,8,7,5164,2624,2540
50,6,57,California,Nevada County,8,8,5425,2780,2645
50,6,57,California,Nevada County,8,9,4923,2534,2389
50,6,57,California,Nevada County,8,10,5582,2821,2761
50,6,57,California,Nevada County,8,11,7061,3318,3743
50,6,57,California,Nevada County,8,12,8526,3946,4580
50,6,57,California,Nevada County,8,13,9382,4372,5010
50,6,57,California,Nevada County,8,14,8946,4436,4510
50,6,57,California,Nevada County,8,15,5877,2868,3009
50,6,57,California,Nevada County,8,16,3829,1893,1936
50,6,57,California,Nevada County,8,17,2535,1193,1342
50,6,57,California,Nevada County,8,18,3008,1106,1902
50,6,57,California,Nevada County,9,0,98939,48636,50303
50,6,57,California,Nevada County,9,1,4211,2129,2082
50,6,57,California,Nevada County,9,2,4715,2427,2288
50,6,57,California,Nevada County,9,3,5065,2578,2487
50,6,57,California,Nevada County,9,4,5047,2655,2392
50,6,57,California,Nevada County,9,5,4455,2361,2094
50,6,57,California,Nevada County,9,6,4581,2345,2236
50,6,57,California,Nevada County,9,7,5176,2593,2583
50,6,57,California,Nevada County,9,8,5512,2858,2654
50,6,57,California,Nevada County,9,9,4886,2525,2361
50,6,57,California,Nevada County,9,10,5600,2824,2776
50,6,57,California,Nevada County,9,11,6657,3182,3475
50,6,57,California,Nevada County,9,12,8453,3834,4619
50,6,57,California,Nevada County,9,13,9334,4353,4981
50,6,57,California,Nevada County,9,14,9427,4629,4798
50,6,57,California,Nevada County,9,15,6211,3026,3185
50,6,57,California,Nevada County,9,16,4054,1974,2080
50,6,57,California,Nevada County,9,17,2530,1214,1316
50,6,57,California,Nevada County,9,18,3025,1129,1896
50,6,57,California,Nevada County,10,0,99421,48847,50574
50,6,57,California,Nevada County,10,1,4299,2152,2147
50,6,57,California,Nevada County,10,2,4632,2406,2226
50,6,57,California,Nevada County,10,3,5029,2536,2493
50,6,57,California,Nevada County,10,4,4970,2596,2374
50,6,57,California,Nevada County,10,5,4377,2323,2054
50,6,57,California,Nevada County,10,6,4634,2355,2279
50,6,57,California,Nevada County,10,7,5095,2590,2505
50,6,57,California,Nevada County,10,8,5696,2922,2774
50,6,57,California,Nevada County,10,9,5062,2620,2442
50,6,57,California,Nevada County,10,10,5503,2754,2749
50,6,57,California,Nevada County,10,11,6404,3111,3293
50,6,57,California,Nevada County,10,12,8102,3654,4448
50,6,57,California,Nevada County,10,13,9397,4386,5011
50,6,57,California,Nevada County,10,14,9322,4508,4814
50,6,57,California,Nevada County,10,15,6998,3464,3534
50,6,57,California,Nevada County,10,16,4289,2076,2213
50,6,57,California,Nevada County,10,17,2578,1252,1326
50,6,57,California,Nevada County,10,18,3034,1142,1892
50,6,57,California,Nevada County,11,0,99472,48804,50668
50,6,57,California,Nevada County,11,1,4330,2206,2124
50,6,57,California,Nevada County,11,2,4627,2391,2236
50,6,57,California,Nevada County,11,3,5001,2549,2452
50,6,57,California,Nevada County,11,4,4844,2508,2336
50,6,57,California,Nevada County,11,5,4232,2208,2024
50,6,57,California,Nevada County,11,6,4593,2341,2252
50,6,57,California,Nevada County,11,7,5053,2553,2500
50,6,57,California,Nevada County,11,8,5746,2928,2818
50,6,57,California,Nevada County,11,9,5251,2689,2562
50,6,57,California,Nevada County,11,10,5457,2766,2691
50,6,57,California,Nevada County,11,11,5951,2873,3078
50,6,57,California,Nevada County,11,12,7957,3642,4315
50,6,57,California,Nevada County,11,13,9253,4308,4945
50,6,57,California,Nevada County,11,14,9352,4472,4880
50,6,57,California,Nevada County,11,15,7424,3646,3778
50,6,57,California,Nevada County,11,16,4620,2227,2393
50,6,57,California,Nevada County,11,17,2797,1376,1421
50,6,57,California,Nevada County,11,18,2984,1121,1863
50,6,57,California,Nevada County,12,0,99648,48910,50738
50,6,57,California,Nevada County,12,1,4226,2183,2043
50,6,57,California,Nevada County,12,2,4643,2442,2201
50,6,57,California,Nevada County,12,3,4970,2493,2477
50,6,57,California,Nevada County,12,4,4760,2475,2285
50,6,57,California,Nevada County,12,5,4124,2152,1972
50,6,57,California,Nevada County,12,6,4635,2363,2272
50,6,57,California,Nevada County,12,7,5069,2538,2531
50,6,57,California,Nevada County,12,8,5685,2853,2832
50,6,57,California,Nevada County,12,9,5536,2822,2714
50,6,57,California,Nevada County,12,10,5352,2781,2571
50,6,57,California,Nevada County,12,11,5732,2787,2945
50,6,57,California,Nevada County,12,12,7715,3551,4164
50,6,57,California,Nevada County,12,13,9038,4152,4886
50,6,57,California,Nevada County,12,14,9444,4477,4967
50,6,57,California,Nevada County,12,15,7875,3903,3972
50,6,57,California,Nevada County,12,16,4877,2339,2538
50,6,57,California,Nevada County,12,17,2982,1435,1547
50,6,57,California,Nevada County,12,18,2985,1164,1821
50,6,57,California,Nevada County,13,0,99675,48959,50716
50,6,57,California,Nevada County,13,1,4181,2184,1997
50,6,57,California,Nevada County,13,2,4643,2435,2208
50,6,57,California,Nevada County,13,3,4936,2523,2413
50,6,57,California,Nevada County,13,4,4699,2412,2287
50,6,57,California,Nevada County,13,5,4083,2121,1962
50,6,57,California,Nevada County,13,6,4596,2354,2242
50,6,57,California,Nevada County,13,7,5124,2556,2568
50,6,57,California,Nevada County,13,8,5649,2812,2837
50,6,57,California,Nevada County,13,9,5780,2952,2828
50,6,57,California,Nevada County,13,10,5262,2735,2527
50,6,57,California,Nevada County,13,11,5700,2796,2904
50,6,57,California,Nevada County,13,12,7470,3457,4013
50,6,57,California,Nevada County,13,13,8884,4083,4801
50,6,57,California,Nevada County,13,14,9383,4401,4982
50,6,57,California,Nevada County,13,15,8167,4045,4122
50,6,57,California,Nevada County,13,16,5041,2442,2599
50,6,57,California,Nevada County,13,17,3039,1456,1583
50,6,57,California,Nevada County,13,18,3038,1195,1843
50,6,57,California,Nevada County,14,0,99606,48939,50667
50,6,57,California,Nevada County,14,1,4162,2178,1984
50,6,57,California,Nevada County,14,2,4637,2431,2206
50,6,57,California,Nevada County,14,3,4932,2539,2393
50,6,57,California,Nevada County,14,4,4679,2392,2287
50,6,57,California,Nevada County,14,5,4069,2113,1956
50,6,57,California,Nevada County,14,6,4576,2348,2228
50,6,57,California,Nevada County,14,7,5141,2561,2580
50,6,57,California,Nevada County,14,8,5644,2801,2843
50,6,57,California,Nevada County,14,9,5862,2997,2865
50,6,57,California,Nevada County,14,10,5232,2722,2510
50,6,57,California,Nevada County,14,11,5704,2802,2902
50,6,57,California,Nevada County,14,12,7384,3427,3957
50,6,57,California,Nevada County,14,13,8819,4047,4772
50,6,57,California,Nevada County,14,14,9365,4377,4988
50,6,57,California,Nevada County,14,15,8233,4077,4156
50,6,57,California,Nevada County,14,16,5080,2469,2611
50,6,57,California,Nevada County,14,17,3055,1464,1591
50,6,57,California,Nevada County,14,18,3032,1194,1838
50,6,59,California,Orange County,1,0,3010232,1488780,1521452
50,6,59,California,Orange County,1,1,191691,98332,93359
50,6,59,California,Orange County,1,2,198769,101577,97192
50,6,59,California,Orange County,1,3,210195,107446,102749
50,6,59,California,Orange County,1,4,227689,117278,110411
50,6,59,California,Orange County,1,5,213601,110168,103433
50,6,59,California,Orange County,1,6,215362,110805,104557
50,6,59,California,Orange County,1,7,198166,100050,98116
50,6,59,California,Orange County,1,8,213605,105316,108289
50,6,59,California,Orange County,1,9,225438,111325,114113
50,6,59,California,Orange County,1,10,230596,114473,116123
50,6,59,California,Orange County,1,11,213589,105810,107779
50,6,59,California,Orange County,1,12,175127,84699,90428
50,6,59,California,Orange County,1,13,146727,70010,76717
50,6,59,California,Orange County,1,14,107421,50153,57268
50,6,59,California,Orange County,1,15,80033,36704,43329
50,6,59,California,Orange County,1,16,63133,27713,35420
50,6,59,California,Orange County,1,17,49570,19952,29618
50,6,59,California,Orange County,1,18,49520,16969,32551
50,6,59,California,Orange County,2,0,3010258,1488785,1521473
50,6,59,California,Orange County,2,1,191688,98330,93358
50,6,59,California,Orange County,2,2,198765,101575,97190
50,6,59,California,Orange County,2,3,210197,107446,102751
50,6,59,California,Orange County,2,4,227688,117277,110411
50,6,59,California,Orange County,2,5,213600,110167,103433
50,6,59,California,Orange County,2,6,215362,110805,104557
50,6,59,California,Orange County,2,7,198167,100049,98118
50,6,59,California,Orange County,2,8,213607,105317,108290
50,6,59,California,Orange County,2,9,225437,111324,114113
50,6,59,California,Orange County,2,10,230599,114475,116124
50,6,59,California,Orange County,2,11,213594,105812,107782
50,6,59,California,Orange County,2,12,175123,84696,90427
50,6,59,California,Orange County,2,13,146733,70013,76720
50,6,59,California,Orange County,2,14,107432,50155,57277
50,6,59,California,Orange County,2,15,80036,36707,43329
50,6,59,California,Orange County,2,16,63140,27715,35425
50,6,59,California,Orange County,2,17,49570,19952,29618
50,6,59,California,Orange County,2,18,49520,16970,32550
50,6,59,California,Orange County,3,0,3016376,1491524,1524852
50,6,59,California,Orange County,3,1,191513,98218,93295
50,6,59,California,Orange County,3,2,198407,101386,97021
50,6,59,California,Orange County,3,3,209756,107142,102614
50,6,59,California,Orange County,3,4,226098,116361,109737
50,6,59,California,Orange County,3,5,215768,111197,104571
50,6,59,California,Orange County,3,6,215536,110944,104592
50,6,59,California,Orange County,3,7,198929,100453,98476
50,6,59,California,Orange County,3,8,212088,104507,107581
50,6,59,California,Orange County,3,9,226020,111616,114404
50,6,59,California,Orange County,3,10,230262,114293,115969
50,6,59,California,Orange County,3,11,214997,106549,108448
50,6,59,California,Orange County,3,12,176944,85652,91292
50,6,59,California,Orange County,3,13,148011,70592,77419
50,6,59,California,Orange County,3,14,108383,50627,57756
50,6,59,California,Orange County,3,15,80650,37001,43649
50,6,59,California,Orange County,3,16,63172,27712,35460
50,6,59,California,Orange County,3,17,49795,20120,29675
50,6,59,California,Orange County,3,18,50047,17154,32893
50,6,59,California,Orange County,4,0,3050199,1507287,1542912
50,6,59,California,Orange County,4,1,191983,98373,93610
50,6,59,California,Orange County,4,2,198577,101522,97055
50,6,59,California,Orange County,4,3,209023,106620,102403
50,6,59,California,Orange County,4,4,220741,113395,107346
50,6,59,California,Orange County,4,5,223612,114646,108966
50,6,59,California,Orange County,4,6,217057,112000,105057
50,6,59,California,Orange County,4,7,203537,102760,100777
50,6,59,California,Orange County,4,8,206398,101687,104711
50,6,59,California,Orange County,4,9,228849,112706,116143
50,6,59,California,Orange County,4,10,229087,113707,115380
50,6,59,California,Orange County,4,11,220012,109079,110933
50,6,59,California,Orange County,4,12,184215,89474,94741
50,6,59,California,Orange County,4,13,154283,73450,80833
50,6,59,California,Orange County,4,14,112587,52660,59927
50,6,59,California,Orange County,4,15,83590,38334,45256
50,6,59,California,Orange County,4,16,64176,28197,35979
50,6,59,California,Orange County,4,17,50541,20686,29855
50,6,59,California,Orange County,4,18,51931,17991,33940
50,6,59,California,Orange County,5,0,3078710,1520771,1557939
50,6,59,California,Orange County,5,1,190996,97671,93325
50,6,59,California,Orange County,5,2,199839,102286,97553
50,6,59,California,Orange County,5,3,206796,105563,101233
50,6,59,California,Orange County,5,4,218098,111690,106408
50,6,59,California,Orange County,5,5,228703,116917,111786
50,6,59,California,Orange County,5,6,217604,112511,105093
50,6,59,California,Orange County,5,7,207788,105043,102745
50,6,59,California,Orange County,5,8,202878,99963,102915
50,6,59,California,Orange County,5,9,228792,112608,116184
50,6,59,California,Orange County,5,10,227840,112860,114980
50,6,59,California,Orange County,5,11,222850,110396,112454
50,6,59,California,Orange County,5,12,191477,93338,98139
50,6,59,California,Orange County,5,13,154760,73750,81010
50,6,59,California,Orange County,5,14,122177,57096,65081
50,6,59,California,Orange County,5,15,87235,40008,47227
50,6,59,California,Orange County,5,16,65932,29058,36874
50,6,59,California,Orange County,5,17,51123,21175,29948
50,6,59,California,Orange County,5,18,53822,18838,34984
50,6,59,California,Orange County,6,0,3105262,1533875,1571387
50,6,59,California,Orange County,6,1,189434,96845,92589
50,6,59,California,Orange County,6,2,200549,102743,97806
50,6,59,California,Orange County,6,3,206074,105203,100871
50,6,59,California,Orange County,6,4,215177,109951,105226
50,6,59,California,Orange County,6,5,229742,117248,112494
50,6,59,California,Orange County,6,6,220537,114113,106424
50,6,59,California,Orange County,6,7,212088,107422,104666
50,6,59,California,Orange County,6,8,202095,99933,102162
50,6,59,California,Orange County,6,9,225834,110880,114954
50,6,59,California,Orange County,6,10,226667,112118,114549
50,6,59,California,Orange County,6,11,225784,111862,113922
50,6,59,California,Orange County,6,12,197888,96825,101063
50,6,59,California,Orange County,6,13,158726,75723,83003
50,6,59,California,Orange County,6,14,127348,59420,67928
50,6,59,California,Orange County,6,15,92381,42373,50008
50,6,59,California,Orange County,6,16,68139,30235,37904
50,6,59,California,Orange County,6,17,51497,21424,30073
50,6,59,California,Orange County,6,18,55302,19557,35745
50,6,59,California,Orange County,7,0,3126523,1543973,1582550
50,6,59,California,Orange County,7,1,189486,97084,92402
50,6,59,California,Orange County,7,2,198517,101663,96854
50,6,59,California,Orange County,7,3,205056,104563,100493
50,6,59,California,Orange County,7,4,211889,107941,103948
50,6,59,California,Orange County,7,5,228695,116872,111823
50,6,59,California,Orange County,7,6,225232,116403,108829
50,6,59,California,Orange County,7,7,214759,109011,105748
50,6,59,California,Orange County,7,8,200881,99569,101312
50,6,59,California,Orange County,7,9,221364,108320,113044
50,6,59,California,Orange County,7,10,225537,111397,114140
50,6,59,California,Orange County,7,11,228172,112958,115214
50,6,59,California,Orange County,7,12,203213,99794,103419
50,6,59,California,Orange County,7,13,163983,78242,85741
50,6,59,California,Orange County,7,14,133113,62181,70932
50,6,59,California,Orange County,7,15,97142,44391,52751
50,6,59,California,Orange County,7,16,70327,31362,38965
50,6,59,California,Orange County,7,17,52288,21837,30451
50,6,59,California,Orange County,7,18,56869,20385,36484
50,6,59,California,Orange County,8,0,3148952,1555144,1593808
50,6,59,California,Orange County,8,1,190162,97559,92603
50,6,59,California,Orange County,8,2,196356,100599,95757
50,6,59,California,Orange County,8,3,203320,103568,99752
50,6,59,California,Orange County,8,4,210962,107429,103533
50,6,59,California,Orange County,8,5,223542,114233,109309
50,6,59,California,Orange County,8,6,232297,119923,112374
50,6,59,California,Orange County,8,7,215458,109544,105914
50,6,59,California,Orange County,8,8,201956,100430,101526
50,6,59,California,Orange County,8,9,215366,105259,110107
50,6,59,California,Orange County,8,10,227088,111822,115266
50,6,59,California,Orange County,8,11,228031,112858,115173
50,6,59,California,Orange County,8,12,209201,103182,106019
50,6,59,California,Orange County,8,13,169628,81084,88544
50,6,59,California,Orange County,8,14,139130,64972,74158
50,6,59,California,Orange County,8,15,101424,46280,55144
50,6,59,California,Orange County,8,16,72803,32590,40213
50,6,59,California,Orange County,8,17,53171,22318,30853
50,6,59,California,Orange County,8,18,59057,21494,37563
50,6,59,California,Orange County,9,0,3164277,1561998,1602279
50,6,59,California,Orange County,9,1,188989,96639,92350
50,6,59,California,Orange County,9,2,194433,99680,94753
50,6,59,California,Orange County,9,3,201589,102722,98867
50,6,59,California,Orange County,9,4,209398,106467,102931
50,6,59,California,Orange County,9,5,217446,110814,106632
50,6,59,California,Orange County,9,6,239166,123429,115737
50,6,59,California,Orange County,9,7,216722,110610,106112
50,6,59,California,Orange County,9,8,204069,101813,102256
50,6,59,California,Orange County,9,9,208277,101522,106755
50,6,59,California,Orange County,9,10,229054,112500,116554
50,6,59,California,Orange County,9,11,226109,111935,114174
50,6,59,California,Orange County,9,12,213414,105319,108095
50,6,59,California,Orange County,9,13,175806,84380,91426
50,6,59,California,Orange County,9,14,144490,67425,77065
50,6,59,California,Orange County,9,15,105084,47868,57216
50,6,59,California,Orange County,9,16,75560,33785,41775
50,6,59,California,Orange County,9,17,54052,22835,31217
50,6,59,California,Orange County,9,18,60619,22255,38364
50,6,59,California,Orange County,10,0,3174159,1567052,1607107
50,6,59,California,Orange County,10,1,188871,96834,92037
50,6,59,California,Orange County,10,2,191207,97696,93511
50,6,59,California,Orange County,10,3,201061,102800,98261
50,6,59,California,Orange County,10,4,206875,105172,101703
50,6,59,California,Orange County,10,5,213434,108368,105066
50,6,59,California,Orange County,10,6,243467,125554,117913
50,6,59,California,Orange County,10,7,215749,110480,105269
50,6,59,California,Orange County,10,8,206781,103272,103509
50,6,59,California,Orange County,10,9,203652,99378,104274
50,6,59,California,Orange County,10,10,228017,111899,116118
50,6,59,California,Orange County,10,11,223744,110517,113227
50,6,59,California,Orange County,10,12,215428,106506,108922
50,6,59,California,Orange County,10,13,181736,87548,94188
50,6,59,California,Orange County,10,14,144633,67605,77028
50,6,59,California,Orange County,10,15,113142,51484,61658
50,6,59,California,Orange County,10,16,79076,35299,43777
50,6,59,California,Orange County,10,17,55499,23681,31818
50,6,59,California,Orange County,10,18,61787,22959,38828
50,6,59,California,Orange County,11,0,3175579,1567264,1608315
50,6,59,California,Orange County,11,1,187160,96023,91137
50,6,59,California,Orange County,11,2,188363,96162,92201
50,6,59,California,Orange County,11,3,199873,102289,97584
50,6,59,California,Orange County,11,4,204799,104075,100724
50,6,59,California,Orange County,11,5,208795,105672,103123
50,6,59,California,Orange County,11,6,243057,125243,117814
50,6,59,California,Orange County,11,7,216189,110709,105480
50,6,59,California,Orange County,11,8,209955,105369,104586
50,6,59,California,Orange County,11,9,200755,98153,102602
50,6,59,California,Orange County,11,10,223446,109314,114132
50,6,59,California,Orange County,11,11,221065,109086,111979
50,6,59,California,Orange County,11,12,216722,107059,109663
50,6,59,California,Orange County,11,13,186661,90369,96292
50,6,59,California,Orange County,11,14,147433,69066,78367
50,6,59,California,Orange County,11,15,117303,53230,64073
50,6,59,California,Orange County,11,16,83531,37235,46296
50,6,59,California,Orange County,11,17,57561,24762,32799
50,6,59,California,Orange County,11,18,62911,23448,39463
50,6,59,California,Orange County,12,0,3170851,1564353,1606498
50,6,59,California,Orange County,12,1,183910,94159,89751
50,6,59,California,Orange County,12,2,187361,95860,91501
50,6,59,California,Orange County,12,3,196791,100642,96149
50,6,59,California,Orange County,12,4,201858,102507,99351
50,6,59,California,Orange County,12,5,203845,102909,100936
50,6,59,California,Orange County,12,6,240804,123996,116808
50,6,59,California,Orange County,12,7,218466,111838,106628
50,6,59,California,Orange County,12,8,211198,106304,104894
50,6,59,California,Orange County,12,9,198533,97339,101194
50,6,59,California,Orange County,12,10,217219,106023,111196
50,6,59,California,Orange County,12,11,219046,108009,111037
50,6,59,California,Orange County,12,12,217520,107428,110092
50,6,59,California,Orange County,12,13,190530,92671,97859
50,6,59,California,Orange County,12,14,150973,70669,80304
50,6,59,California,Orange County,12,15,122010,55466,66544
50,6,59,California,Orange County,12,16,87397,38810,48587
50,6,59,California,Orange County,12,17,59316,25728,33588
50,6,59,California,Orange County,12,18,64074,23995,40079
50,6,59,California,Orange County,13,0,3170769,1564173,1606596
50,6,59,California,Orange County,13,1,181171,92862,88309
50,6,59,California,Orange County,13,2,187429,95978,91451
50,6,59,California,Orange County,13,3,194565,99507,95058
50,6,59,California,Orange County,13,4,200456,101653,98803
50,6,59,California,Orange County,13,5,202083,101897,100186
50,6,59,California,Orange County,13,6,237099,122079,115020
50,6,59,California,Orange County,13,7,222172,113846,108326
50,6,59,California,Orange County,13,8,210827,106264,104563
50,6,59,California,Orange County,13,9,198314,97499,100815
50,6,59,California,Orange County,13,10,211939,103217,108722
50,6,59,California,Orange County,13,11,218971,107735,111236
50,6,59,California,Orange County,13,12,216644,106916,109728
50,6,59,California,Orange County,13,13,193846,94607,99239
50,6,59,California,Orange County,13,14,153992,72151,81841
50,6,59,California,Orange County,13,15,125385,57072,68313
50,6,59,California,Orange County,13,16,90018,39966,50052
50,6,59,California,Orange County,13,17,60606,26265,34341
50,6,59,California,Orange County,13,18,65252,24659,40593
50,6,59,California,Orange County,14,0,3166857,1562202,1604655
50,6,59,California,Orange County,14,1,180048,92300,87748
50,6,59,California,Orange County,14,2,187059,95825,91234
50,6,59,California,Orange County,14,3,193713,99074,94639
50,6,59,California,Orange County,14,4,199526,101133,98393
50,6,59,California,Orange County,14,5,201052,101330,99722
50,6,59,California,Orange County,14,6,235372,121218,114154
50,6,59,California,Orange County,14,7,223252,114424,108828
50,6,59,California,Orange County,14,8,210760,106316,104444
50,6,59,California,Orange County,14,9,198130,97498,100632
50,6,59,California,Orange County,14,10,210137,102275,107862
50,6,59,California,Orange County,14,11,219192,107755,111437
50,6,59,California,Orange County,14,12,216137,106673,109464
50,6,59,California,Orange County,14,13,194734,95091,99643
50,6,59,California,Orange County,14,14,154911,72611,82300
50,6,59,California,Orange County,14,15,126145,57413,68732
50,6,59,California,Orange County,14,16,90635,40220,50415
50,6,59,California,Orange County,14,17,60894,26370,34524
50,6,59,California,Orange County,14,18,65160,24676,40484
50,6,61,California,Placer County,1,0,348432,170151,178281
50,6,61,California,Placer County,1,1,20851,10613,10238
50,6,61,California,Placer County,1,2,23604,12077,11527
50,6,61,California,Placer County,1,3,24986,12686,12300
50,6,61,California,Placer County,1,4,24298,12512,11786
50,6,61,California,Placer County,1,5,17936,9326,8610
50,6,61,California,Placer County,1,6,19560,9849,9711
50,6,61,California,Placer County,1,7,19613,9737,9876
50,6,61,California,Placer County,1,8,21871,10623,11248
50,6,61,California,Placer County,1,9,24694,11977,12717
50,6,61,California,Placer County,1,10,27232,13344,13888
50,6,61,California,Placer County,1,11,26107,12712,13395
50,6,61,California,Placer County,1,12,22972,11047,11925
50,6,61,California,Placer County,1,13,21146,9985,11161
50,6,61,California,Placer County,1,14,16459,7605,8854
50,6,61,California,Placer County,1,15,12531,5837,6694
50,6,61,California,Placer County,1,16,10019,4551,5468
50,6,61,California,Placer County,1,17,7299,3116,4183
50,6,61,California,Placer County,1,18,7254,2554,4700
50,6,61,California,Placer County,2,0,348481,170179,178302
50,6,61,California,Placer County,2,1,20853,10614,10239
50,6,61,California,Placer County,2,2,23611,12082,11529
50,6,61,California,Placer County,2,3,24995,12689,12306
50,6,61,California,Placer County,2,4,24306,12519,11787
50,6,61,California,Placer County,2,5,17940,9330,8610
50,6,61,California,Placer County,2,6,19559,9848,9711
50,6,61,California,Placer County,2,7,19614,9737,9877
50,6,61,California,Placer County,2,8,21879,10627,11252
50,6,61,California,Placer County,2,9,24703,11980,12723
50,6,61,California,Placer County,2,10,27238,13349,13889
50,6,61,California,Placer County,2,11,26109,12715,13394
50,6,61,California,Placer County,2,12,22968,11044,11924
50,6,61,California,Placer County,2,13,21146,9986,11160
50,6,61,California,Placer County,2,14,16457,7604,8853
50,6,61,California,Placer County,2,15,12529,5835,6694
50,6,61,California,Placer County,2,16,10019,4551,5468
50,6,61,California,Placer County,2,17,7300,3116,4184
50,6,61,California,Placer County,2,18,7255,2553,4702
50,6,61,California,Placer County,3,0,350007,170913,179094
50,6,61,California,Placer County,3,1,20860,10616,10244
50,6,61,California,Placer County,3,2,23632,12081,11551
50,6,61,California,Placer County,3,3,25037,12726,12311
50,6,61,California,Placer County,3,4,24270,12492,11778
50,6,61,California,Placer County,3,5,18230,9479,8751
50,6,61,California,Placer County,3,6,19624,9871,9753
50,6,61,California,Placer County,3,7,19818,9841,9977
50,6,61,California,Placer County,3,8,21786,10599,11187
50,6,61,California,Placer County,3,9,24763,11993,12770
50,6,61,California,Placer County,3,10,27161,13306,13855
50,6,61,California,Placer County,3,11,26332,12822,13510
50,6,61,California,Placer County,3,12,23138,11128,12010
50,6,61,California,Placer County,3,13,21391,10109,11282
50,6,61,California,Placer County,3,14,16616,7686,8930
50,6,61,California,Placer County,3,15,12657,5877,6780
50,6,61,California,Placer County,3,16,10017,4553,5464
50,6,61,California,Placer County,3,17,7365,3159,4206
50,6,61,California,Placer County,3,18,7310,2575,4735
50,6,61,California,Placer County,4,0,356323,174044,182279
50,6,61,California,Placer County,4,1,20861,10569,10292
50,6,61,California,Placer County,4,2,23865,12204,11661
50,6,61,California,Placer County,4,3,25320,12978,12342
50,6,61,California,Placer County,4,4,24367,12487,11880
50,6,61,California,Placer County,4,5,19203,9975,9228
50,6,61,California,Placer County,4,6,19557,9801,9756
50,6,61,California,Placer County,4,7,20680,10323,10357
50,6,61,California,Placer County,4,8,21389,10450,10939
50,6,61,California,Placer County,4,9,25137,12139,12998
50,6,61,California,Placer County,4,10,26600,13010,13590
50,6,61,California,Placer County,4,11,27042,13188,13854
50,6,61,California,Placer County,4,12,23714,11402,12312
50,6,61,California,Placer County,4,13,22570,10688,11882
50,6,61,California,Placer County,4,14,17369,8063,9306
50,6,61,California,Placer County,4,15,13280,6135,7145
50,6,61,California,Placer County,4,16,10256,4687,5569
50,6,61,California,Placer County,4,17,7578,3306,4272
50,6,61,California,Placer County,4,18,7535,2639,4896
50,6,61,California,Placer County,5,0,360269,176232,184037
50,6,61,California,Placer County,5,1,20467,10368,10099
50,6,61,California,Placer County,5,2,23872,12261,11611
50,6,61,California,Placer County,5,3,25343,12954,12389
50,6,61,California,Placer County,5,4,24345,12474,11871
50,6,61,California,Placer County,5,5,19802,10332,9470
50,6,61,California,Placer County,5,6,19152,9690,9462
50,6,61,California,Placer County,5,7,21093,10527,10566
50,6,61,California,Placer County,5,8,21420,10518,10902
50,6,61,California,Placer County,5,9,25206,12175,13031
50,6,61,California,Placer County,5,10,26210,12888,13322
50,6,61,California,Placer County,5,11,27141,13281,13860
50,6,61,California,Placer County,5,12,24506,11698,12808
50,6,61,California,Placer County,5,13,22366,10549,11817
50,6,61,California,Placer County,5,14,19148,8938,10210
50,6,61,California,Placer County,5,15,13921,6462,7459
50,6,61,California,Placer County,5,16,10589,4865,5724
50,6,61,California,Placer County,5,17,7817,3434,4383
50,6,61,California,Placer County,5,18,7871,2818,5053
50,6,61,California,Placer County,6,0,365415,178537,186878
50,6,61,California,Placer County,6,1,20344,10292,10052
50,6,61,California,Placer County,6,2,23850,12219,11631
50,6,61,California,Placer County,6,3,25386,12987,12399
50,6,61,California,Placer County,6,4,24220,12437,11783
50,6,61,California,Placer County,6,5,20306,10539,9767
50,6,61,California,Placer County,6,6,19126,9734,9392
50,6,61,California,Placer County,6,7,21779,10822,10957
50,6,61,California,Placer County,6,8,21889,10788,11101
50,6,61,California,Placer County,6,9,25216,12207,13009
50,6,61,California,Placer County,6,10,25631,12516,13115
50,6,61,California,Placer County,6,11,27453,13438,14015
50,6,61,California,Placer County,6,12,25261,12063,13198
50,6,61,California,Placer County,6,13,22545,10625,11920
50,6,61,California,Placer County,6,14,20286,9475,10811
50,6,61,California,Placer County,6,15,14929,6870,8059
50,6,61,California,Placer County,6,16,11003,5084,5919
50,6,61,California,Placer County,6,17,8070,3524,4546
50,6,61,California,Placer County,6,18,8121,2917,5204
50,6,61,California,Placer County,7,0,369241,180355,188886
50,6,61,California,Placer County,7,1,20068,10189,9879
50,6,61,California,Placer County,7,2,23713,12067,11646
50,6,61,California,Placer County,7,3,25399,13046,12353
50,6,61,California,Placer County,7,4,24187,12493,11694
50,6,61,California,Placer County,7,5,20529,10532,9997
50,6,61,California,Placer County,7,6,19187,9791,9396
50,6,61,California,Placer County,7,7,21804,10828,10976
50,6,61,California,Placer County,7,8,22496,11128,11368
50,6,61,California,Placer County,7,9,24662,12021,12641
50,6,61,California,Placer County,7,10,25428,12404,13024
50,6,61,California,Placer County,7,11,27620,13463,14157
50,6,61,California,Placer County,7,12,25712,12352,13360
50,6,61,California,Placer County,7,13,23212,10903,12309
50,6,61,California,Placer County,7,14,21270,9946,11324
50,6,61,California,Placer County,7,15,15751,7216,8535
50,6,61,California,Placer County,7,16,11444,5253,6191
50,6,61,California,Placer County,7,17,8259,3623,4636
50,6,61,California,Placer County,7,18,8500,3100,5400
50,6,61,California,Placer County,8,0,372870,181947,190923
50,6,61,California,Placer County,8,1,19967,10240,9727
50,6,61,California,Placer County,8,2,23577,11851,11726
50,6,61,California,Placer County,8,3,25491,13047,12444
50,6,61,California,Placer County,8,4,24062,12396,11666
50,6,61,California,Placer County,8,5,20522,10467,10055
50,6,61,California,Placer County,8,6,19291,9953,9338
50,6,61,California,Placer County,8,7,21721,10696,11025
50,6,61,California,Placer County,8,8,23221,11546,11675
50,6,61,California,Placer County,8,9,23938,11696,12242
50,6,61,California,Placer County,8,10,25789,12545,13244
50,6,61,California,Placer County,8,11,27245,13318,13927
50,6,61,California,Placer County,8,12,26176,12592,13584
50,6,61,California,Placer County,8,13,23715,11149,12566
50,6,61,California,Placer County,8,14,22208,10373,11835
50,6,61,California,Placer County,8,15,16667,7603,9064
50,6,61,California,Placer County,8,16,11894,5434,6460
50,6,61,California,Placer County,8,17,8586,3797,4789
50,6,61,California,Placer County,8,18,8800,3244,5556
50,6,61,California,Placer County,9,0,379046,184848,194198
50,6,61,California,Placer County,9,1,20246,10362,9884
50,6,61,California,Placer County,9,2,23720,11989,11731
50,6,61,California,Placer County,9,3,25664,13102,12562
50,6,61,California,Placer County,9,4,24175,12493,11682
50,6,61,California,Placer County,9,5,20145,10294,9851
50,6,61,California,Placer County,9,6,19987,10222,9765
50,6,61,California,Placer County,9,7,21839,10727,11112
50,6,61,California,Placer County,9,8,24272,12078,12194
50,6,61,California,Placer County,9,9,23705,11642,12063
50,6,61,California,Placer County,9,10,26441,12817,13624
50,6,61,California,Placer County,9,11,26764,13036,13728
50,6,61,California,Placer County,9,12,26789,12961,13828
50,6,61,California,Placer County,9,13,24288,11415,12873
50,6,61,California,Placer County,9,14,23272,10882,12390
50,6,61,California,Placer County,9,15,17385,7894,9491
50,6,61,California,Placer County,9,16,12496,5678,6818
50,6,61,California,Placer County,9,17,8723,3869,4854
50,6,61,California,Placer County,9,18,9135,3387,5748
50,6,61,California,Placer County,10,0,385348,188061,197287
50,6,61,California,Placer County,10,1,20708,10605,10103
50,6,61,California,Placer County,10,2,23752,11993,11759
50,6,61,California,Placer County,10,3,25954,13236,12718
50,6,61,California,Placer County,10,4,24272,12548,11724
50,6,61,California,Placer County,10,5,20356,10402,9954
50,6,61,California,Placer County,10,6,20471,10474,9997
50,6,61,California,Placer County,10,7,21842,10799,11043
50,6,61,California,Placer County,10,8,25165,12479,12686
50,6,61,California,Placer County,10,9,24148,11912,12236
50,6,61,California,Placer County,10,10,26512,12939,13573
50,6,61,California,Placer County,10,11,26412,12974,13438
50,6,61,California,Placer County,10,12,27117,13103,14014
50,6,61,California,Placer County,10,13,24947,11662,13285
50,6,61,California,Placer County,10,14,22987,10662,12325
50,6,61,California,Placer County,10,15,19205,8783,10422
50,6,61,California,Placer County,10,16,13201,6009,7192
50,6,61,California,Placer County,10,17,8937,3961,4976
50,6,61,California,Placer County,10,18,9362,3520,5842
50,6,61,California,Placer County,11,0,392735,191933,200802
50,6,61,California,Placer County,11,1,20977,10820,10157
50,6,61,California,Placer County,11,2,24244,12266,11978
50,6,61,California,Placer County,11,3,26258,13425,12833
50,6,61,California,Placer County,11,4,24442,12666,11776
50,6,61,California,Placer County,11,5,20270,10421,9849
50,6,61,California,Placer County,11,6,21074,10877,10197
50,6,61,California,Placer County,11,7,22078,10922,11156
50,6,61,California,Placer County,11,8,26229,12931,13298
50,6,61,California,Placer County,11,9,25005,12387,12618
50,6,61,California,Placer County,11,10,26741,13156,13585
50,6,61,California,Placer County,11,11,25953,12688,13265
50,6,61,California,Placer County,11,12,27404,13287,14117
50,6,61,California,Placer County,11,13,25411,11897,13514
50,6,61,California,Placer County,11,14,23316,10795,12521
50,6,61,California,Placer County,11,15,20230,9258,10972
50,6,61,California,Placer County,11,16,14136,6338,7798
50,6,61,California,Placer County,11,17,9371,4136,5235
50,6,61,California,Placer County,11,18,9596,3663,5933
50,6,61,California,Placer County,12,0,398918,194726,204192
50,6,61,California,Placer County,12,1,21066,10846,10220
50,6,61,California,Placer County,12,2,24552,12425,12127
50,6,61,California,Placer County,12,3,26277,13302,12975
50,6,61,California,Placer County,12,4,24651,12799,11852
50,6,61,California,Placer County,12,5,20425,10460,9965
50,6,61,California,Placer County,12,6,21080,10768,10312
50,6,61,California,Placer County,12,7,22506,11252,11254
50,6,61,California,Placer County,12,8,26745,13112,13633
50,6,61,California,Placer County,12,9,25898,12938,12960
50,6,61,California,Placer County,12,10,26583,13082,13501
50,6,61,California,Placer County,12,11,25739,12610,13129
50,6,61,California,Placer County,12,12,27766,13452,14314
50,6,61,California,Placer County,12,13,25955,12203,13752
50,6,61,California,Placer County,12,14,23890,11011,12879
50,6,61,California,Placer County,12,15,21201,9677,11524
50,6,61,California,Placer County,12,16,14887,6627,8260
50,6,61,California,Placer County,12,17,9777,4293,5484
50,6,61,California,Placer County,12,18,9920,3869,6051
50,6,61,California,Placer County,13,0,402221,196375,205846
50,6,61,California,Placer County,13,1,20859,10722,10137
50,6,61,California,Placer County,13,2,24869,12646,12223
50,6,61,California,Placer County,13,3,26442,13364,13078
50,6,61,California,Placer County,13,4,24806,12863,11943
50,6,61,California,Placer County,13,5,20394,10433,9961
50,6,61,California,Placer County,13,6,20972,10712,10260
50,6,61,California,Placer County,13,7,22725,11402,11323
50,6,61,California,Placer County,13,8,26991,13253,13738
50,6,61,California,Placer County,13,9,26508,13268,13240
50,6,61,California,Placer County,13,10,26096,12844,13252
50,6,61,California,Placer County,13,11,26114,12792,13322
50,6,61,California,Placer County,13,12,27415,13340,14075
50,6,61,California,Placer County,13,13,26350,12436,13914
50,6,61,California,Placer County,13,14,24127,11074,13053
50,6,61,California,Placer County,13,15,21785,9962,11823
50,6,61,California,Placer County,13,16,15503,6881,8622
50,6,61,California,Placer County,13,17,10009,4365,5644
50,6,61,California,Placer County,13,18,10256,4018,6238
50,6,61,California,Placer County,14,0,402950,196738,206212
50,6,61,California,Placer County,14,1,20767,10670,10097
50,6,61,California,Placer County,14,2,24929,12698,12231
50,6,61,California,Placer County,14,3,26494,13380,13114
50,6,61,California,Placer County,14,4,24824,12870,11954
50,6,61,California,Placer County,14,5,20364,10409,9955
50,6,61,California,Placer County,14,6,20912,10680,10232
50,6,61,California,Placer County,14,7,22799,11450,11349
50,6,61,California,Placer County,14,8,27097,13318,13779
50,6,61,California,Placer County,14,9,26715,13379,13336
50,6,61,California,Placer County,14,10,25932,12766,13166
50,6,61,California,Placer County,14,11,26277,12869,13408
50,6,61,California,Placer County,14,12,27280,13298,13982
50,6,61,California,Placer County,14,13,26445,12492,13953
50,6,61,California,Placer County,14,14,24206,11096,13110
50,6,61,California,Placer County,14,15,21911,10016,11895
50,6,61,California,Placer County,14,16,15644,6936,8708
50,6,61,California,Placer County,14,17,10066,4378,5688
50,6,61,California,Placer County,14,18,10288,4033,6255
50,6,63,California,Plumas County,1,0,20007,10003,10004
50,6,63,California,Plumas County,1,1,883,463,420
50,6,63,California,Plumas County,1,2,968,473,495
50,6,63,California,Plumas County,1,3,1022,536,486
50,6,63,California,Plumas County,1,4,1293,666,627
50,6,63,California,Plumas County,1,5,930,500,430
50,6,63,California,Plumas County,1,6,847,445,402
50,6,63,California,Plumas County,1,7,851,420,431
50,6,63,California,Plumas County,1,8,863,449,414
50,6,63,California,Plumas County,1,9,1045,509,536
50,6,63,California,Plumas County,1,10,1433,693,740
50,6,63,California,Plumas County,1,11,1793,838,955
50,6,63,California,Plumas County,1,12,1995,977,1018
50,6,63,California,Plumas County,1,13,1930,992,938
50,6,63,California,Plumas County,1,14,1467,759,708
50,6,63,California,Plumas County,1,15,1067,559,508
50,6,63,California,Plumas County,1,16,676,333,343
50,6,63,California,Plumas County,1,17,520,241,279
50,6,63,California,Plumas County,1,18,424,150,274
50,6,63,California,Plumas County,2,0,20007,10003,10004
50,6,63,California,Plumas County,2,1,883,463,420
50,6,63,California,Plumas County,2,2,968,473,495
50,6,63,California,Plumas County,2,3,1022,536,486
50,6,63,California,Plumas County,2,4,1293,666,627
50,6,63,California,Plumas County,2,5,930,500,430
50,6,63,California,Plumas County,2,6,847,445,402
50,6,63,California,Plumas County,2,7,851,420,431
50,6,63,California,Plumas County,2,8,863,449,414
50,6,63,California,Plumas County,2,9,1045,509,536
50,6,63,California,Plumas County,2,10,1433,693,740
50,6,63,California,Plumas County,2,11,1793,838,955
50,6,63,California,Plumas County,2,12,1995,977,1018
50,6,63,California,Plumas County,2,13,1930,992,938
50,6,63,California,Plumas County,2,14,1467,759,708
50,6,63,California,Plumas County,2,15,1067,559,508
50,6,63,California,Plumas County,2,16,676,333,343
50,6,63,California,Plumas County,2,17,520,241,279
50,6,63,California,Plumas County,2,18,424,150,274
50,6,63,California,Plumas County,3,0,19915,9945,9970
50,6,63,California,Plumas County,3,1,888,465,423
50,6,63,California,Plumas County,3,2,957,468,489
50,6,63,California,Plumas County,3,3,1011,528,483
50,6,63,California,Plumas County,3,4,1265,653,612
50,6,63,California,Plumas County,3,5,942,498,444
50,6,63,California,Plumas County,3,6,845,443,402
50,6,63,California,Plumas County,3,7,853,421,432
50,6,63,California,Plumas County,3,8,855,445,410
50,6,63,California,Plumas County,3,9,1025,499,526
50,6,63,California,Plumas County,3,10,1402,677,725
50,6,63,California,Plumas County,3,11,1783,835,948
50,6,63,California,Plumas County,3,12,1982,974,1008
50,6,63,California,Plumas County,3,13,1935,990,945
50,6,63,California,Plumas County,3,14,1478,769,709
50,6,63,California,Plumas County,3,15,1070,554,516
50,6,63,California,Plumas County,3,16,675,332,343
50,6,63,California,Plumas County,3,17,518,243,275
50,6,63,California,Plumas County,3,18,431,151,280
50,6,63,California,Plumas County,4,0,19720,9883,9837
50,6,63,California,Plumas County,4,1,919,495,424
50,6,63,California,Plumas County,4,2,944,460,484
50,6,63,California,Plumas County,4,3,971,509,462
50,6,63,California,Plumas County,4,4,1181,620,561
50,6,63,California,Plumas County,4,5,981,517,464
50,6,63,California,Plumas County,4,6,819,434,385
50,6,63,California,Plumas County,4,7,916,460,456
50,6,63,California,Plumas County,4,8,812,418,394
50,6,63,California,Plumas County,4,9,958,468,490
50,6,63,California,Plumas County,4,10,1267,620,647
50,6,63,California,Plumas County,4,11,1760,830,930
50,6,63,California,Plumas County,4,12,1926,929,997
50,6,63,California,Plumas County,4,13,2001,1020,981
50,6,63,California,Plumas County,4,14,1539,802,737
50,6,63,California,Plumas County,4,15,1090,558,532
50,6,63,California,Plumas County,4,16,685,345,340
50,6,63,California,Plumas County,4,17,509,252,257
50,6,63,California,Plumas County,4,18,442,146,296
50,6,63,California,Plumas County,5,0,19380,9687,9693
50,6,63,California,Plumas County,5,1,873,472,401
50,6,63,California,Plumas County,5,2,978,493,485
50,6,63,California,Plumas County,5,3,923,469,454
50,6,63,California,Plumas County,5,4,1098,580,518
50,6,63,California,Plumas County,5,5,952,495,457
50,6,63,California,Plumas County,5,6,798,415,383
50,6,63,California,Plumas County,5,7,911,458,453
50,6,63,California,Plumas County,5,8,824,421,403
50,6,63,California,Plumas County,5,9,918,451,467
50,6,63,California,Plumas County,5,10,1167,572,595
50,6,63,California,Plumas County,5,11,1603,742,861
50,6,63,California,Plumas County,5,12,1884,907,977
50,6,63,California,Plumas County,5,13,1961,992,969
50,6,63,California,Plumas County,5,14,1661,846,815
50,6,63,California,Plumas County,5,15,1141,589,552
50,6,63,California,Plumas County,5,16,728,385,343
50,6,63,California,Plumas County,5,17,497,238,259
50,6,63,California,Plumas County,5,18,463,162,301
50,6,63,California,Plumas County,6,0,18901,9448,9453
50,6,63,California,Plumas County,6,1,809,444,365
50,6,63,California,Plumas County,6,2,940,470,470
50,6,63,California,Plumas County,6,3,913,459,454
50,6,63,California,Plumas County,6,4,1045,564,481
50,6,63,California,Plumas County,6,5,932,484,448
50,6,63,California,Plumas County,6,6,763,382,381
50,6,63,California,Plumas County,6,7,874,453,421
50,6,63,California,Plumas County,6,8,833,419,414
50,6,63,California,Plumas County,6,9,863,437,426
50,6,63,California,Plumas County,6,10,1060,529,531
50,6,63,California,Plumas County,6,11,1518,713,805
50,6,63,California,Plumas County,6,12,1844,859,985
50,6,63,California,Plumas County,6,13,1918,977,941
50,6,63,California,Plumas County,6,14,1686,842,844
50,6,63,California,Plumas County,6,15,1204,637,567
50,6,63,California,Plumas County,6,16,783,404,379
50,6,63,California,Plumas County,6,17,466,217,249
50,6,63,California,Plumas County,6,18,450,158,292
50,6,63,California,Plumas County,7,0,18631,9326,9305
50,6,63,California,Plumas County,7,1,798,428,370
50,6,63,California,Plumas County,7,2,906,470,436
50,6,63,California,Plumas County,7,3,906,447,459
50,6,63,California,Plumas County,7,4,960,515,445
50,6,63,California,Plumas County,7,5,918,487,431
50,6,63,California,Plumas County,7,6,821,421,400
50,6,63,California,Plumas County,7,7,835,414,421
50,6,63,California,Plumas County,7,8,856,431,425
50,6,63,California,Plumas County,7,9,828,425,403
50,6,63,California,Plumas County,7,10,975,489,486
50,6,63,California,Plumas County,7,11,1433,686,747
50,6,63,California,Plumas County,7,12,1767,803,964
50,6,63,California,Plumas County,7,13,1942,990,952
50,6,63,California,Plumas County,7,14,1686,855,831
50,6,63,California,Plumas County,7,15,1256,661,595
50,6,63,California,Plumas County,7,16,827,425,402
50,6,63,California,Plumas County,7,17,455,208,247
50,6,63,California,Plumas County,7,18,462,171,291
50,6,63,California,Plumas County,8,0,18435,9215,9220
50,6,63,California,Plumas County,8,1,769,400,369
50,6,63,California,Plumas County,8,2,853,459,394
50,6,63,California,Plumas County,8,3,922,441,481
50,6,63,California,Plumas County,8,4,931,506,425
50,6,63,California,Plumas County,8,5,839,444,395
50,6,63,California,Plumas County,8,6,860,443,417
50,6,63,California,Plumas County,8,7,835,409,426
50,6,63,California,Plumas County,8,8,869,426,443
50,6,63,California,Plumas County,8,9,780,405,375
50,6,63,California,Plumas County,8,10,977,486,491
50,6,63,California,Plumas County,8,11,1324,643,681
50,6,63,California,Plumas County,8,12,1710,787,923
50,6,63,California,Plumas County,8,13,1940,962,978
50,6,63,California,Plumas County,8,14,1746,893,853
50,6,63,California,Plumas County,8,15,1284,665,619
50,6,63,California,Plumas County,8,16,851,442,409
50,6,63,California,Plumas County,8,17,479,220,259
50,6,63,California,Plumas County,8,18,466,184,282
50,6,63,California,Plumas County,9,0,18691,9351,9340
50,6,63,California,Plumas County,9,1,820,401,419
50,6,63,California,Plumas County,9,2,910,490,420
50,6,63,California,Plumas County,9,3,919,453,466
50,6,63,California,Plumas County,9,4,934,482,452
50,6,63,California,Plumas County,9,5,810,429,381
50,6,63,California,Plumas County,9,6,918,460,458
50,6,63,California,Plumas County,9,7,868,450,418
50,6,63,California,Plumas County,9,8,921,433,488
50,6,63,California,Plumas County,9,9,795,409,386
50,6,63,California,Plumas County,9,10,928,480,448
50,6,63,California,Plumas County,9,11,1235,600,635
50,6,63,California,Plumas County,9,12,1709,812,897
50,6,63,California,Plumas County,9,13,1935,943,992
50,6,63,California,Plumas County,9,14,1831,939,892
50,6,63,California,Plumas County,9,15,1317,701,616
50,6,63,California,Plumas County,9,16,862,438,424
50,6,63,California,Plumas County,9,17,504,227,277
50,6,63,California,Plumas County,9,18,475,204,271
50,6,63,California,Plumas County,10,0,18680,9318,9362
50,6,63,California,Plumas County,10,1,839,399,440
50,6,63,California,Plumas County,10,2,872,473,399
50,6,63,California,Plumas County,10,3,959,473,486
50,6,63,California,Plumas County,10,4,918,461,457
50,6,63,California,Plumas County,10,5,743,393,350
50,6,63,California,Plumas County,10,6,947,484,463
50,6,63,California,Plumas County,10,7,913,467,446
50,6,63,California,Plumas County,10,8,886,425,461
50,6,63,California,Plumas County,10,9,842,428,414
50,6,63,California,Plumas County,10,10,867,449,418
50,6,63,California,Plumas County,10,11,1171,563,608
50,6,63,California,Plumas County,10,12,1614,766,848
50,6,63,California,Plumas County,10,13,1943,930,1013
50,6,63,California,Plumas County,10,14,1823,933,890
50,6,63,California,Plumas County,10,15,1429,746,683
50,6,63,California,Plumas County,10,16,924,482,442
50,6,63,California,Plumas County,10,17,517,255,262
50,6,63,California,Plumas County,10,18,473,191,282
50,6,63,California,Plumas County,11,0,18830,9399,9431
50,6,63,California,Plumas County,11,1,901,441,460
50,6,63,California,Plumas County,11,2,839,451,388
50,6,63,California,Plumas County,11,3,949,465,484
50,6,63,California,Plumas County,11,4,936,486,450
50,6,63,California,Plumas County,11,5,726,376,350
50,6,63,California,Plumas County,11,6,916,469,447
50,6,63,California,Plumas County,11,7,952,470,482
50,6,63,California,Plumas County,11,8,945,475,470
50,6,63,California,Plumas County,11,9,847,433,414
50,6,63,California,Plumas County,11,10,863,442,421
50,6,63,California,Plumas County,11,11,1112,547,565
50,6,63,California,Plumas County,11,12,1576,740,836
50,6,63,California,Plumas County,11,13,1896,888,1008
50,6,63,California,Plumas County,11,14,1887,990,897
50,6,63,California,Plumas County,11,15,1477,735,742
50,6,63,California,Plumas County,11,16,961,521,440
50,6,63,California,Plumas County,11,17,553,270,283
50,6,63,California,Plumas County,11,18,494,200,294
50,6,63,California,Plumas County,12,0,19052,9510,9542
50,6,63,California,Plumas County,12,1,914,454,460
50,6,63,California,Plumas County,12,2,868,467,401
50,6,63,California,Plumas County,12,3,961,491,470
50,6,63,California,Plumas County,12,4,947,479,468
50,6,63,California,Plumas County,12,5,693,361,332
50,6,63,California,Plumas County,12,6,907,462,445
50,6,63,California,Plumas County,12,7,1001,496,505
50,6,63,California,Plumas County,12,8,976,484,492
50,6,63,California,Plumas County,12,9,897,455,442
50,6,63,California,Plumas County,12,10,856,438,418
50,6,63,California,Plumas County,12,11,1015,488,527
50,6,63,California,Plumas County,12,12,1516,735,781
50,6,63,California,Plumas County,12,13,1858,852,1006
50,6,63,California,Plumas County,12,14,1957,1033,924
50,6,63,California,Plumas County,12,15,1533,765,768
50,6,63,California,Plumas County,12,16,1047,548,499
50,6,63,California,Plumas County,12,17,603,302,301
50,6,63,California,Plumas County,12,18,503,200,303
50,6,63,California,Plumas County,13,0,18991,9479,9512
50,6,63,California,Plumas County,13,1,903,456,447
50,6,63,California,Plumas County,13,2,877,450,427
50,6,63,California,Plumas County,13,3,947,508,439
50,6,63,California,Plumas County,13,4,951,479,472
50,6,63,California,Plumas County,13,5,695,371,324
50,6,63,California,Plumas County,13,6,858,423,435
50,6,63,California,Plumas County,13,7,985,489,496
50,6,63,California,Plumas County,13,8,994,482,512
50,6,63,California,Plumas County,13,9,925,467,458
50,6,63,California,Plumas County,13,10,851,444,407
50,6,63,California,Plumas County,13,11,996,485,511
50,6,63,California,Plumas County,13,12,1433,688,745
50,6,63,California,Plumas County,13,13,1830,845,985
50,6,63,California,Plumas County,13,14,1963,1001,962
50,6,63,California,Plumas County,13,15,1595,814,781
50,6,63,California,Plumas County,13,16,1070,564,506
50,6,63,California,Plumas County,13,17,610,310,300
50,6,63,California,Plumas County,13,18,508,203,305
50,6,63,California,Plumas County,14,0,18967,9450,9517
50,6,63,California,Plumas County,14,1,893,453,440
50,6,63,California,Plumas County,14,2,875,444,431
50,6,63,California,Plumas County,14,3,943,511,432
50,6,63,California,Plumas County,14,4,952,477,475
50,6,63,California,Plumas County,14,5,696,372,324
50,6,63,California,Plumas County,14,6,839,408,431
50,6,63,California,Plumas County,14,7,982,484,498
50,6,63,California,Plumas County,14,8,997,481,516
50,6,63,California,Plumas County,14,9,932,468,464
50,6,63,California,Plumas County,14,10,858,449,409
50,6,63,California,Plumas County,14,11,997,487,510
50,6,63,California,Plumas County,14,12,1409,675,734
50,6,63,California,Plumas County,14,13,1822,843,979
50,6,63,California,Plumas County,14,14,1970,991,979
50,6,63,California,Plumas County,14,15,1609,826,783
50,6,63,California,Plumas County,14,16,1076,566,510
50,6,63,California,Plumas County,14,17,612,313,299
50,6,63,California,Plumas County,14,18,505,202,303
50,6,65,California,Riverside County,1,0,2189641,1089576,1100065
50,6,65,California,Riverside County,1,1,162438,82754,79684
50,6,65,California,Riverside County,1,2,167065,85020,82045
50,6,65,California,Riverside County,1,3,177644,90683,86961
50,6,65,California,Riverside County,1,4,187125,96221,90904
50,6,65,California,Riverside County,1,5,154572,79533,75039
50,6,65,California,Riverside County,1,6,143992,72905,71087
50,6,65,California,Riverside County,1,7,138437,68750,69687
50,6,65,California,Riverside County,1,8,143926,71002,72924
50,6,65,California,Riverside County,1,9,149379,75432,73947
50,6,65,California,Riverside County,1,10,152722,77080,75642
50,6,65,California,Riverside County,1,11,140016,70586,69430
50,6,65,California,Riverside County,1,12,114765,55964,58801
50,6,65,California,Riverside County,1,13,98974,47377,51597
50,6,65,California,Riverside County,1,14,78495,36730,41765
50,6,65,California,Riverside County,1,15,62103,28958,33145
50,6,65,California,Riverside County,1,16,49003,22422,26581
50,6,65,California,Riverside County,1,17,36793,15918,20875
50,6,65,California,Riverside County,1,18,32192,12241,19951
50,6,65,California,Riverside County,2,0,2189785,1089630,1100155
50,6,65,California,Riverside County,2,1,162440,82755,79685
50,6,65,California,Riverside County,2,2,167068,85024,82044
50,6,65,California,Riverside County,2,3,177649,90688,86961
50,6,65,California,Riverside County,2,4,187127,96222,90905
50,6,65,California,Riverside County,2,5,154573,79534,75039
50,6,65,California,Riverside County,2,6,143994,72906,71088
50,6,65,California,Riverside County,2,7,138439,68751,69688
50,6,65,California,Riverside County,2,8,143927,71002,72925
50,6,65,California,Riverside County,2,9,149381,75433,73948
50,6,65,California,Riverside County,2,10,152728,77084,75644
50,6,65,California,Riverside County,2,11,140014,70585,69429
50,6,65,California,Riverside County,2,12,114774,55969,58805
50,6,65,California,Riverside County,2,13,98981,47381,51600
50,6,65,California,Riverside County,2,14,78499,36731,41768
50,6,65,California,Riverside County,2,15,62112,28962,33150
50,6,65,California,Riverside County,2,16,49021,22428,26593
50,6,65,California,Riverside County,2,17,36816,15925,20891
50,6,65,California,Riverside County,2,18,32242,12250,19992
50,6,65,California,Riverside County,3,0,2201562,1095277,1106285
50,6,65,California,Riverside County,3,1,162452,82837,79615
50,6,65,California,Riverside County,3,2,167370,85172,82198
50,6,65,California,Riverside County,3,3,177716,90634,87082
50,6,65,California,Riverside County,3,4,186554,95895,90659
50,6,65,California,Riverside County,3,5,157419,80889,76530
50,6,65,California,Riverside County,3,6,145425,73726,71699
50,6,65,California,Riverside County,3,7,139828,69482,70346
50,6,65,California,Riverside County,3,8,143914,70954,72960
50,6,65,California,Riverside County,3,9,149878,75578,74300
50,6,65,California,Riverside County,3,10,152823,77079,75744
50,6,65,California,Riverside County,3,11,141296,71187,70109
50,6,65,California,Riverside County,3,12,116208,56724,59484
50,6,65,California,Riverside County,3,13,100165,47923,52242
50,6,65,California,Riverside County,3,14,79162,37069,42093
50,6,65,California,Riverside County,3,15,62538,29145,33393
50,6,65,California,Riverside County,3,16,49138,22486,26652
50,6,65,California,Riverside County,3,17,37013,16093,20920
50,6,65,California,Riverside County,3,18,32663,12404,20259
50,6,65,California,Riverside County,4,0,2233840,1111413,1122427
50,6,65,California,Riverside County,4,1,161638,82720,78918
50,6,65,California,Riverside County,4,2,167891,85474,82417
50,6,65,California,Riverside County,4,3,177140,90140,87000
50,6,65,California,Riverside County,4,4,183513,94211,89302
50,6,65,California,Riverside County,4,5,165543,85006,80537
50,6,65,California,Riverside County,4,6,148357,75545,72812
50,6,65,California,Riverside County,4,7,144008,71738,72270
50,6,65,California,Riverside County,4,8,142254,69916,72338
50,6,65,California,Riverside County,4,9,151423,75997,75426
50,6,65,California,Riverside County,4,10,151991,76633,75358
50,6,65,California,Riverside County,4,11,145296,73188,72108
50,6,65,California,Riverside County,4,12,121322,59503,61819
50,6,65,California,Riverside County,4,13,105171,50267,54904
50,6,65,California,Riverside County,4,14,82194,38637,43557
50,6,65,California,Riverside County,4,15,64498,29912,34586
50,6,65,California,Riverside County,4,16,50072,23001,27071
50,6,65,California,Riverside County,4,17,37613,16591,21022
50,6,65,California,Riverside County,4,18,33916,12934,20982
50,6,65,California,Riverside County,5,0,2260763,1125076,1135687
50,6,65,California,Riverside County,5,1,159033,81305,77728
50,6,65,California,Riverside County,5,2,169929,86588,83341
50,6,65,California,Riverside County,5,3,175781,89301,86480
50,6,65,California,Riverside County,5,4,181411,92960,88451
50,6,65,California,Riverside County,5,5,170402,87334,83068
50,6,65,California,Riverside County,5,6,150437,76959,73478
50,6,65,California,Riverside County,5,7,147842,74151,73691
50,6,65,California,Riverside County,5,8,142333,69995,72338
50,6,65,California,Riverside County,5,9,152039,75871,76168
50,6,65,California,Riverside County,5,10,150700,76177,74523
50,6,65,California,Riverside County,5,11,147466,74241,73225
50,6,65,California,Riverside County,5,12,126946,62560,64386
50,6,65,California,Riverside County,5,13,105547,50424,55123
50,6,65,California,Riverside County,5,14,89027,42035,46992
50,6,65,California,Riverside County,5,15,67060,31164,35896
50,6,65,California,Riverside County,5,16,51313,23512,27801
50,6,65,California,Riverside County,5,17,38492,17176,21316
50,6,65,California,Riverside County,5,18,35005,13323,21682
50,6,65,California,Riverside County,6,0,2286087,1137630,1148457
50,6,65,California,Riverside County,6,1,156865,80255,76610
50,6,65,California,Riverside County,6,2,171415,87638,83777
50,6,65,California,Riverside County,6,3,175146,88970,86176
50,6,65,California,Riverside County,6,4,179791,92015,87776
50,6,65,California,Riverside County,6,5,172070,88183,83887
50,6,65,California,Riverside County,6,6,153380,78540,74840
50,6,65,California,Riverside County,6,7,151836,76202,75634
50,6,65,California,Riverside County,6,8,143060,70473,72587
50,6,65,California,Riverside County,6,9,151077,74925,76152
50,6,65,California,Riverside County,6,10,149468,75521,73947
50,6,65,California,Riverside County,6,11,149487,75126,74361
50,6,65,California,Riverside County,6,12,131974,65279,66695
50,6,65,California,Riverside County,6,13,107729,51541,56188
50,6,65,California,Riverside County,6,14,93081,44100,48981
50,6,65,California,Riverside County,6,15,71118,32922,38196
50,6,65,California,Riverside County,6,16,53216,24420,28796
50,6,65,California,Riverside County,6,17,39168,17560,21608
50,6,65,California,Riverside County,6,18,36206,13960,22246
50,6,65,California,Riverside County,7,0,2315238,1151232,1164006
50,6,65,California,Riverside County,7,1,157090,80153,76937
50,6,65,California,Riverside County,7,2,171316,87470,83846
50,6,65,California,Riverside County,7,3,175113,88998,86115
50,6,65,California,Riverside County,7,4,178424,90934,87490
50,6,65,California,Riverside County,7,5,172789,88468,84321
50,6,65,California,Riverside County,7,6,158212,81253,76959
50,6,65,California,Riverside County,7,7,155047,77824,77223
50,6,65,California,Riverside County,7,8,145647,71933,73714
50,6,65,California,Riverside County,7,9,149382,73866,75516
50,6,65,California,Riverside County,7,10,148915,75067,73848
50,6,65,California,Riverside County,7,11,151450,75955,75495
50,6,65,California,Riverside County,7,12,135850,67447,68403
50,6,65,California,Riverside County,7,13,111694,53461,58233
50,6,65,California,Riverside County,7,14,97313,46185,51128
50,6,65,California,Riverside County,7,15,74384,34328,40056
50,6,65,California,Riverside County,7,16,55336,25398,29938
50,6,65,California,Riverside County,7,17,39582,17792,21790
50,6,65,California,Riverside County,7,18,37694,14700,22994
50,6,65,California,Riverside County,8,0,2344648,1165974,1178674
50,6,65,California,Riverside County,8,1,157340,80304,77036
50,6,65,California,Riverside County,8,2,171378,87497,83881
50,6,65,California,Riverside County,8,3,174383,88717,85666
50,6,65,California,Riverside County,8,4,178132,90867,87265
50,6,65,California,Riverside County,8,5,171529,87678,83851
50,6,65,California,Riverside County,8,6,163811,84163,79648
50,6,65,California,Riverside County,8,7,157010,79110,77900
50,6,65,California,Riverside County,8,8,149163,74069,75094
50,6,65,California,Riverside County,8,9,147631,72602,75029
50,6,65,California,Riverside County,8,10,150155,75499,74656
50,6,65,California,Riverside County,8,11,151706,75969,75737
50,6,65,California,Riverside County,8,12,139948,69670,70278
50,6,65,California,Riverside County,8,13,116327,55886,60441
50,6,65,California,Riverside County,8,14,101644,48126,53518
50,6,65,California,Riverside County,8,15,77761,35970,41791
50,6,65,California,Riverside County,8,16,57323,26261,31062
50,6,65,California,Riverside County,8,17,40324,18147,22177
50,6,65,California,Riverside County,8,18,39083,15439,23644
50,6,65,California,Riverside County,9,0,2378282,1183777,1194505
50,6,65,California,Riverside County,9,1,157470,80275,77195
50,6,65,California,Riverside County,9,2,171524,87732,83792
50,6,65,California,Riverside County,9,3,175212,89287,85925
50,6,65,California,Riverside County,9,4,177785,90328,87457
50,6,65,California,Riverside County,9,5,169446,86536,82910
50,6,65,California,Riverside County,9,6,170665,87771,82894
50,6,65,California,Riverside County,9,7,159099,80882,78217
50,6,65,California,Riverside County,9,8,153692,76527,77165
50,6,65,California,Riverside County,9,9,146968,72514,74454
50,6,65,California,Riverside County,9,10,152175,76292,75883
50,6,65,California,Riverside County,9,11,150984,75706,75278
50,6,65,California,Riverside County,9,12,144071,71791,72280
50,6,65,California,Riverside County,9,13,121147,58556,62591
50,6,65,California,Riverside County,9,14,106067,50163,55904
50,6,65,California,Riverside County,9,15,80844,37551,43293
50,6,65,California,Riverside County,9,16,59171,26989,32182
50,6,65,California,Riverside County,9,17,41518,18677,22841
50,6,65,California,Riverside County,9,18,40444,16200,24244
50,6,65,California,Riverside County,10,0,2413058,1202068,1210990
50,6,65,California,Riverside County,10,1,158336,80964,77372
50,6,65,California,Riverside County,10,2,170370,87354,83016
50,6,65,California,Riverside County,10,3,178496,90895,87601
50,6,65,California,Riverside County,10,4,177354,90064,87290
50,6,65,California,Riverside County,10,5,168130,85737,82393
50,6,65,California,Riverside County,10,6,175258,90078,85180
50,6,65,California,Riverside County,10,7,161084,82211,78873
50,6,65,California,Riverside County,10,8,158640,79482,79158
50,6,65,California,Riverside County,10,9,148275,73200,75075
50,6,65,California,Riverside County,10,10,153406,76567,76839
50,6,65,California,Riverside County,10,11,150632,75707,74925
50,6,65,California,Riverside County,10,12,146265,72914,73351
50,6,65,California,Riverside County,10,13,126961,61790,65171
50,6,65,California,Riverside County,10,14,106227,50124,56103
50,6,65,California,Riverside County,10,15,87543,40805,46738
50,6,65,California,Riverside County,10,16,61522,28055,33467
50,6,65,California,Riverside County,10,17,42754,19196,23558
50,6,65,California,Riverside County,10,18,41805,16925,24880
50,6,65,California,Riverside County,11,0,2443221,1217951,1225270
50,6,65,California,Riverside County,11,1,157432,80478,76954
50,6,65,California,Riverside County,11,2,169382,86662,82720
50,6,65,California,Riverside County,11,3,180631,92184,88447
50,6,65,California,Riverside County,11,4,177267,90069,87198
50,6,65,California,Riverside County,11,5,167433,85378,82055
50,6,65,California,Riverside County,11,6,177371,91485,85886
50,6,65,California,Riverside County,11,7,164275,84003,80272
50,6,65,California,Riverside County,11,8,163739,82216,81523
50,6,65,California,Riverside County,11,9,150606,74721,75885
50,6,65,California,Riverside County,11,10,153291,76177,77114
50,6,65,California,Riverside County,11,11,150131,75693,74438
50,6,65,California,Riverside County,11,12,148214,73857,74357
50,6,65,California,Riverside County,11,13,131771,64443,67328
50,6,65,California,Riverside County,11,14,108573,51172,57401
50,6,65,California,Riverside County,11,15,91048,42544,48504
50,6,65,California,Riverside County,11,16,65152,29617,35535
50,6,65,California,Riverside County,11,17,43994,19783,24211
50,6,65,California,Riverside County,11,18,42911,17469,25442
50,6,65,California,Riverside County,12,0,2465569,1229809,1235760
50,6,65,California,Riverside County,12,1,154955,79469,75486
50,6,65,California,Riverside County,12,2,169825,86724,83101
50,6,65,California,Riverside County,12,3,180596,92275,88321
50,6,65,California,Riverside County,12,4,177099,90000,87099
50,6,65,California,Riverside County,12,5,165910,84374,81536
50,6,65,California,Riverside County,12,6,178252,92060,86192
50,6,65,California,Riverside County,12,7,167173,85644,81529
50,6,65,California,Riverside County,12,8,166917,84175,82742
50,6,65,California,Riverside County,12,9,153178,76117,77061
50,6,65,California,Riverside County,12,10,152021,75471,76550
50,6,65,California,Riverside County,12,11,149349,75296,74053
50,6,65,California,Riverside County,12,12,150365,74944,75421
50,6,65,California,Riverside County,12,13,135151,66487,68664
50,6,65,California,Riverside County,12,14,112036,52906,59130
50,6,65,California,Riverside County,12,15,94917,44358,50559
50,6,65,California,Riverside County,12,16,68091,30874,37217
50,6,65,California,Riverside County,12,17,45676,20619,25057
50,6,65,California,Riverside County,12,18,44058,18016,26042
50,6,65,California,Riverside County,13,0,2485219,1240684,1244535
50,6,65,California,Riverside County,13,1,153072,78486,74586
50,6,65,California,Riverside County,13,2,170337,86906,83431
50,6,65,California,Riverside County,13,3,180550,92269,88281
50,6,65,California,Riverside County,13,4,177049,90031,87018
50,6,65,California,Riverside County,13,5,166034,84450,81584
50,6,65,California,Riverside County,13,6,177458,91807,85651
50,6,65,California,Riverside County,13,7,170703,87559,83144
50,6,65,California,Riverside County,13,8,168401,85235,83166
50,6,65,California,Riverside County,13,9,156189,77906,78283
50,6,65,California,Riverside County,13,10,151275,75070,76205
50,6,65,California,Riverside County,13,11,150347,75798,74549
50,6,65,California,Riverside County,13,12,150613,75044,75569
50,6,65,California,Riverside County,13,13,138012,68212,69800
50,6,65,California,Riverside County,13,14,115192,54630,60562
50,6,65,California,Riverside County,13,15,97881,45763,52118
50,6,65,California,Riverside County,13,16,70291,31905,38386
50,6,65,California,Riverside County,13,17,46790,21071,25719
50,6,65,California,Riverside County,13,18,45025,18542,26483
50,6,65,California,Riverside County,14,0,2489188,1243027,1246161
50,6,65,California,Riverside County,14,1,152384,78111,74273
50,6,65,California,Riverside County,14,2,170239,86836,83403
50,6,65,California,Riverside County,14,3,180349,92187,88162
50,6,65,California,Riverside County,14,4,176825,89926,86899
50,6,65,California,Riverside County,14,5,165804,84323,81481
50,6,65,California,Riverside County,14,6,176899,91592,85307
50,6,65,California,Riverside County,14,7,171835,88153,83682
50,6,65,California,Riverside County,14,8,168973,85658,83315
50,6,65,California,Riverside County,14,9,157128,78476,78652
50,6,65,California,Riverside County,14,10,151041,74953,76088
50,6,65,California,Riverside County,14,11,150794,76013,74781
50,6,65,California,Riverside County,14,12,150565,75030,75535
50,6,65,California,Riverside County,14,13,138770,68655,70115
50,6,65,California,Riverside County,14,14,116166,55182,60984
50,6,65,California,Riverside County,14,15,98600,46087,52513
50,6,65,California,Riverside County,14,16,70760,32117,38643
50,6,65,California,Riverside County,14,17,47070,21176,25894
50,6,65,California,Riverside County,14,18,44986,18552,26434
50,6,67,California,Sacramento County,1,0,1418788,694793,723995
50,6,67,California,Sacramento County,1,1,101063,51669,49394
50,6,67,California,Sacramento County,1,2,98112,50022,48090
50,6,67,California,Sacramento County,1,3,99820,51128,48692
50,6,67,California,Sacramento County,1,4,105680,54270,51410
50,6,67,California,Sacramento County,1,5,101908,51147,50761
50,6,67,California,Sacramento County,1,6,107922,53768,54154
50,6,67,California,Sacramento County,1,7,98724,49407,49317
50,6,67,California,Sacramento County,1,8,95195,47276,47919
50,6,67,California,Sacramento County,1,9,95640,47744,47896
50,6,67,California,Sacramento County,1,10,102072,50392,51680
50,6,67,California,Sacramento County,1,11,98464,47467,50997
50,6,67,California,Sacramento County,1,12,85332,40354,44978
50,6,67,California,Sacramento County,1,13,70305,33113,37192
50,6,67,California,Sacramento County,1,14,47404,21567,25837
50,6,67,California,Sacramento County,1,15,35891,15718,20173
50,6,67,California,Sacramento County,1,16,29328,12821,16507
50,6,67,California,Sacramento County,1,17,22865,9060,13805
50,6,67,California,Sacramento County,1,18,23063,7870,15193
50,6,67,California,Sacramento County,2,0,1418736,694764,723972
50,6,67,California,Sacramento County,2,1,101062,51668,49394
50,6,67,California,Sacramento County,2,2,98108,50019,48089
50,6,67,California,Sacramento County,2,3,99811,51125,48686
50,6,67,California,Sacramento County,2,4,105673,54264,51409
50,6,67,California,Sacramento County,2,5,101906,51145,50761
50,6,67,California,Sacramento County,2,6,107921,53767,54154
50,6,67,California,Sacramento County,2,7,98723,49407,49316
50,6,67,California,Sacramento County,2,8,95191,47274,47917
50,6,67,California,Sacramento County,2,9,95635,47743,47892
50,6,67,California,Sacramento County,2,10,102066,50387,51679
50,6,67,California,Sacramento County,2,11,98459,47463,50996
50,6,67,California,Sacramento County,2,12,85333,40355,44978
50,6,67,California,Sacramento County,2,13,70302,33112,37190
50,6,67,California,Sacramento County,2,14,47402,21566,25836
50,6,67,California,Sacramento County,2,15,35891,15718,20173
50,6,67,California,Sacramento County,2,16,29328,12821,16507
50,6,67,California,Sacramento County,2,17,22864,9060,13804
50,6,67,California,Sacramento County,2,18,23061,7870,15191
50,6,67,California,Sacramento County,3,0,1421381,695965,725416
50,6,67,California,Sacramento County,3,1,100989,51640,49349
50,6,67,California,Sacramento County,3,2,98296,50154,48142
50,6,67,California,Sacramento County,3,3,99591,50998,48593
50,6,67,California,Sacramento County,3,4,104619,53797,50822
50,6,67,California,Sacramento County,3,5,102671,51468,51203
50,6,67,California,Sacramento County,3,6,108162,53837,54325
50,6,67,California,Sacramento County,3,7,99306,49677,49629
50,6,67,California,Sacramento County,3,8,94833,47100,47733
50,6,67,California,Sacramento County,3,9,95821,47760,48061
50,6,67,California,Sacramento County,3,10,101574,50169,51405
50,6,67,California,Sacramento County,3,11,98971,47726,51245
50,6,67,California,Sacramento County,3,12,85933,40641,45292
50,6,67,California,Sacramento County,3,13,71209,33526,37683
50,6,67,California,Sacramento County,3,14,47872,21805,26067
50,6,67,California,Sacramento County,3,15,36087,15826,20261
50,6,67,California,Sacramento County,3,16,29279,12770,16509
50,6,67,California,Sacramento County,3,17,22927,9133,13794
50,6,67,California,Sacramento County,3,18,23241,7938,15303
50,6,67,California,Sacramento County,4,0,1433712,701689,732023
50,6,67,California,Sacramento County,4,1,100560,51469,49091
50,6,67,California,Sacramento County,4,2,99222,50600,48622
50,6,67,California,Sacramento County,4,3,98846,50533,48313
50,6,67,California,Sacramento County,4,4,100901,52127,48774
50,6,67,California,Sacramento County,4,5,105870,53011,52859
50,6,67,California,Sacramento County,4,6,109172,54417,54755
50,6,67,California,Sacramento County,4,7,101611,50735,50876
50,6,67,California,Sacramento County,4,8,93309,46433,46876
50,6,67,California,Sacramento County,4,9,96940,48088,48852
50,6,67,California,Sacramento County,4,10,99133,48963,50170
50,6,67,California,Sacramento County,4,11,100732,48626,52106
50,6,67,California,Sacramento County,4,12,88449,41872,46577
50,6,67,California,Sacramento County,4,13,75159,35293,39866
50,6,67,California,Sacramento County,4,14,50010,22900,27110
50,6,67,California,Sacramento County,4,15,37050,16245,20805
50,6,67,California,Sacramento County,4,16,29498,12716,16782
50,6,67,California,Sacramento County,4,17,23144,9422,13722
50,6,67,California,Sacramento County,4,18,24106,8239,15867
50,6,67,California,Sacramento County,5,0,1444819,706804,738015
50,6,67,California,Sacramento County,5,1,99482,51055,48427
50,6,67,California,Sacramento County,5,2,100582,51237,49345
50,6,67,California,Sacramento County,5,3,98341,50255,48086
50,6,67,California,Sacramento County,5,4,98397,50781,47616
50,6,67,California,Sacramento County,5,5,106807,53778,53029
50,6,67,California,Sacramento County,5,6,109916,54806,55110
50,6,67,California,Sacramento County,5,7,104111,51916,52195
50,6,67,California,Sacramento County,5,8,93299,46325,46974
50,6,67,California,Sacramento County,5,9,96738,47812,48926
50,6,67,California,Sacramento County,5,10,97091,47828,49263
50,6,67,California,Sacramento County,5,11,101214,49020,52194
50,6,67,California,Sacramento County,5,12,91267,43281,47986
50,6,67,California,Sacramento County,5,13,75932,35538,40394
50,6,67,California,Sacramento County,5,14,55449,25541,29908
50,6,67,California,Sacramento County,5,15,38335,16775,21560
50,6,67,California,Sacramento County,5,16,29997,12808,17189
50,6,67,California,Sacramento County,5,17,23286,9640,13646
50,6,67,California,Sacramento County,5,18,24575,8408,16167
50,6,67,California,Sacramento County,6,0,1457283,711955,745328
50,6,67,California,Sacramento County,6,1,98719,50484,48235
50,6,67,California,Sacramento County,6,2,101937,52129,49808
50,6,67,California,Sacramento County,6,3,98258,50006,48252
50,6,67,California,Sacramento County,6,4,96802,49964,46838
50,6,67,California,Sacramento County,6,5,106085,53237,52848
50,6,67,California,Sacramento County,6,6,111439,55574,55865
50,6,67,California,Sacramento County,6,7,106678,53095,53583
50,6,67,California,Sacramento County,6,8,93895,46558,47337
50,6,67,California,Sacramento County,6,9,96353,47415,48938
50,6,67,California,Sacramento County,6,10,95471,47101,48370
50,6,67,California,Sacramento County,6,11,101466,49231,52235
50,6,67,California,Sacramento County,6,12,93195,44277,48918
50,6,67,California,Sacramento County,6,13,77837,36257,41580
50,6,67,California,Sacramento County,6,14,59360,27387,31973
50,6,67,California,Sacramento County,6,15,40606,17807,22799
50,6,67,California,Sacramento County,6,16,30422,12941,17481
50,6,67,California,Sacramento County,6,17,23591,9862,13729
50,6,67,California,Sacramento County,6,18,25169,8630,16539
50,6,67,California,Sacramento County,7,0,1474828,720498,754330
50,6,67,California,Sacramento County,7,1,99408,50808,48600
50,6,67,California,Sacramento County,7,2,102176,52247,49929
50,6,67,California,Sacramento County,7,3,99077,50354,48723
50,6,67,California,Sacramento County,7,4,95408,48974,46434
50,6,67,California,Sacramento County,7,5,104944,52931,52013
50,6,67,California,Sacramento County,7,6,114570,57217,57353
50,6,67,California,Sacramento County,7,7,109214,54426,54788
50,6,67,California,Sacramento County,7,8,96249,47854,48395
50,6,67,California,Sacramento County,7,9,95633,46928,48705
50,6,67,California,Sacramento County,7,10,94615,46783,47832
50,6,67,California,Sacramento County,7,11,101872,49493,52379
50,6,67,California,Sacramento County,7,12,94860,45146,49714
50,6,67,California,Sacramento County,7,13,79942,37203,42739
50,6,67,California,Sacramento County,7,14,63587,29233,34354
50,6,67,California,Sacramento County,7,15,42631,18750,23881
50,6,67,California,Sacramento County,7,16,31318,13342,17976
50,6,67,California,Sacramento County,7,17,23465,9802,13663
50,6,67,California,Sacramento County,7,18,25859,9007,16852
50,6,67,California,Sacramento County,8,0,1493547,729552,763995
50,6,67,California,Sacramento County,8,1,99902,50886,49016
50,6,67,California,Sacramento County,8,2,102077,52340,49737
50,6,67,California,Sacramento County,8,3,99958,50693,49265
50,6,67,California,Sacramento County,8,4,94846,48697,46149
50,6,67,California,Sacramento County,8,5,102356,51654,50702
50,6,67,California,Sacramento County,8,6,118222,59043,59179
50,6,67,California,Sacramento County,8,7,111790,55706,56084
50,6,67,California,Sacramento County,8,8,99322,49531,49791
50,6,67,California,Sacramento County,8,9,94261,46145,48116
50,6,67,California,Sacramento County,8,10,95364,47111,48253
50,6,67,California,Sacramento County,8,11,100966,49071,51895
50,6,67,California,Sacramento County,8,12,97003,46346,50657
50,6,67,California,Sacramento County,8,13,82903,38451,44452
50,6,67,California,Sacramento County,8,14,67646,31180,36466
50,6,67,California,Sacramento County,8,15,44786,19777,25009
50,6,67,California,Sacramento County,8,16,32107,13723,18384
50,6,67,California,Sacramento County,8,17,23668,9850,13818
50,6,67,California,Sacramento County,8,18,26370,9348,17022
50,6,67,California,Sacramento County,9,0,1511401,738433,772968
50,6,67,California,Sacramento County,9,1,99866,50860,49006
50,6,67,California,Sacramento County,9,2,102502,52513,49989
50,6,67,California,Sacramento County,9,3,101163,51401,49762
50,6,67,California,Sacramento County,9,4,94641,48554,46087
50,6,67,California,Sacramento County,9,5,99794,50549,49245
50,6,67,California,Sacramento County,9,6,121802,60940,60862
50,6,67,California,Sacramento County,9,7,114050,56765,57285
50,6,67,California,Sacramento County,9,8,102799,51204,51595
50,6,67,California,Sacramento County,9,9,93504,45863,47641
50,6,67,California,Sacramento County,9,10,96585,47600,48985
50,6,67,California,Sacramento County,9,11,98616,47988,50628
50,6,67,California,Sacramento County,9,12,98845,47212,51633
50,6,67,California,Sacramento County,9,13,85134,39650,45484
50,6,67,California,Sacramento County,9,14,71295,32754,38541
50,6,67,California,Sacramento County,9,15,46815,20814,26001
50,6,67,California,Sacramento County,9,16,33138,14150,18988
50,6,67,California,Sacramento County,9,17,23954,9864,14090
50,6,67,California,Sacramento County,9,18,26898,9752,17146
50,6,67,California,Sacramento County,10,0,1527984,746749,781235
50,6,67,California,Sacramento County,10,1,99780,50825,48955
50,6,67,California,Sacramento County,10,2,101997,52306,49691
50,6,67,California,Sacramento County,10,3,102784,52165,50619
50,6,67,California,Sacramento County,10,4,94472,48492,45980
50,6,67,California,Sacramento County,10,5,97610,49506,48104
50,6,67,California,Sacramento County,10,6,124455,62289,62166
50,6,67,California,Sacramento County,10,7,116164,57915,58249
50,6,67,California,Sacramento County,10,8,106785,53345,53440
50,6,67,California,Sacramento County,10,9,93958,46114,47844
50,6,67,California,Sacramento County,10,10,97284,47817,49467
50,6,67,California,Sacramento County,10,11,96759,46998,49761
50,6,67,California,Sacramento County,10,12,99090,47601,51489
50,6,67,California,Sacramento County,10,13,87442,40738,46704
50,6,67,California,Sacramento County,10,14,71904,32957,38947
50,6,67,California,Sacramento County,10,15,51590,23080,28510
50,6,67,California,Sacramento County,10,16,34346,14629,19717
50,6,67,California,Sacramento County,10,17,24300,9940,14360
50,6,67,California,Sacramento County,10,18,27264,10032,17232
50,6,67,California,Sacramento County,11,0,1539550,752855,786695
50,6,67,California,Sacramento County,11,1,99228,50687,48541
50,6,67,California,Sacramento County,11,2,101405,51950,49455
50,6,67,California,Sacramento County,11,3,103720,53038,50682
50,6,67,California,Sacramento County,11,4,94681,48503,46178
50,6,67,California,Sacramento County,11,5,96186,48653,47533
50,6,67,California,Sacramento County,11,6,124652,62333,62319
50,6,67,California,Sacramento County,11,7,118553,59425,59128
50,6,67,California,Sacramento County,11,8,110020,54989,55031
50,6,67,California,Sacramento County,11,9,95029,46655,48374
50,6,67,California,Sacramento County,11,10,96897,47348,49549
50,6,67,California,Sacramento County,11,11,94880,46299,48581
50,6,67,California,Sacramento County,11,12,98956,47476,51480
50,6,67,California,Sacramento County,11,13,89015,41612,47403
50,6,67,California,Sacramento County,11,14,73115,33385,39730
50,6,67,California,Sacramento County,11,15,54835,24708,30127
50,6,67,California,Sacramento County,11,16,36225,15444,20781
50,6,67,California,Sacramento County,11,17,24571,10128,14443
50,6,67,California,Sacramento County,11,18,27582,10222,17360
50,6,67,California,Sacramento County,12,0,1551660,759249,792411
50,6,67,California,Sacramento County,12,1,98448,50514,47934
50,6,67,California,Sacramento County,12,2,101641,51895,49746
50,6,67,California,Sacramento County,12,3,103531,53090,50441
50,6,67,California,Sacramento County,12,4,95073,48520,46553
50,6,67,California,Sacramento County,12,5,94704,47823,46881
50,6,67,California,Sacramento County,12,6,123829,62210,61619
50,6,67,California,Sacramento County,12,7,121876,61263,60613
50,6,67,California,Sacramento County,12,8,112582,56320,56262
50,6,67,California,Sacramento County,12,9,97200,47833,49367
50,6,67,California,Sacramento County,12,10,96091,46841,49250
50,6,67,California,Sacramento County,12,11,93939,45976,47963
50,6,67,California,Sacramento County,12,12,98778,47432,51346
50,6,67,California,Sacramento County,12,13,90014,42189,47825
50,6,67,California,Sacramento County,12,14,74909,34190,40719
50,6,67,California,Sacramento County,12,15,58368,26240,32128
50,6,67,California,Sacramento County,12,16,37763,16192,21571
50,6,67,California,Sacramento County,12,17,25156,10396,14760
50,6,67,California,Sacramento County,12,18,27758,10325,17433
50,6,67,California,Sacramento County,13,0,1558550,762837,795713
50,6,67,California,Sacramento County,13,1,97586,50149,47437
50,6,67,California,Sacramento County,13,2,101819,51942,49877
50,6,67,California,Sacramento County,13,3,103107,52919,50188
50,6,67,California,Sacramento County,13,4,95313,48566,46747
50,6,67,California,Sacramento County,13,5,94142,47592,46550
50,6,67,California,Sacramento County,13,6,122023,61330,60693
50,6,67,California,Sacramento County,13,7,124117,62498,61619
50,6,67,California,Sacramento County,13,8,113937,56921,57016
50,6,67,California,Sacramento County,13,9,99364,49117,50247
50,6,67,California,Sacramento County,13,10,95083,46283,48800
50,6,67,California,Sacramento County,13,11,94027,45973,48054
50,6,67,California,Sacramento County,13,12,97476,46870,50606
50,6,67,California,Sacramento County,13,13,90943,42792,48151
50,6,67,California,Sacramento County,13,14,76279,34711,41568
50,6,67,California,Sacramento County,13,15,60839,27385,33454
50,6,67,California,Sacramento County,13,16,38936,16778,22158
50,6,67,California,Sacramento County,13,17,25562,10549,15013
50,6,67,California,Sacramento County,13,18,27997,10462,17535
50,6,67,California,Sacramento County,14,0,1559146,763199,795947
50,6,67,California,Sacramento County,14,1,97235,49983,47252
50,6,67,California,Sacramento County,14,2,101679,51855,49824
50,6,67,California,Sacramento County,14,3,102923,52846,50077
50,6,67,California,Sacramento County,14,4,95204,48486,46718
50,6,67,California,Sacramento County,14,5,93782,47423,46359
50,6,67,California,Sacramento County,14,6,121181,60929,60252
50,6,67,California,Sacramento County,14,7,124789,62866,61923
50,6,67,California,Sacramento County,14,8,114443,57166,57277
50,6,67,California,Sacramento County,14,9,100035,49516,50519
50,6,67,California,Sacramento County,14,10,94743,46101,48642
50,6,67,California,Sacramento County,14,11,94173,46019,48154
50,6,67,California,Sacramento County,14,12,96965,46655,50310
50,6,67,California,Sacramento County,14,13,91128,42915,48213
50,6,67,California,Sacramento County,14,14,76692,34866,41826
50,6,67,California,Sacramento County,14,15,61466,27664,33802
50,6,67,California,Sacramento County,14,16,39203,16917,22286
50,6,67,California,Sacramento County,14,17,25639,10572,15067
50,6,67,California,Sacramento County,14,18,27866,10420,17446
50,6,69,California,San Benito County,1,0,55269,27629,27640
50,6,69,California,San Benito County,1,1,4092,2068,2024
50,6,69,California,San Benito County,1,2,4326,2202,2124
50,6,69,California,San Benito County,1,3,4709,2462,2247
50,6,69,California,San Benito County,1,4,4534,2346,2188
50,6,69,California,San Benito County,1,5,3507,1804,1703
50,6,69,California,San Benito County,1,6,3409,1718,1691
50,6,69,California,San Benito County,1,7,3522,1745,1777
50,6,69,California,San Benito County,1,8,3585,1775,1810
50,6,69,California,San Benito County,1,9,4036,1981,2055
50,6,69,California,San Benito County,1,10,4279,2141,2138
50,6,69,California,San Benito County,1,11,3970,1969,2001
50,6,69,California,San Benito County,1,12,3367,1669,1698
50,6,69,California,San Benito County,1,13,2573,1295,1278
50,6,69,California,San Benito County,1,14,1810,877,933
50,6,69,California,San Benito County,1,15,1168,588,580
50,6,69,California,San Benito County,1,16,935,432,503
50,6,69,California,San Benito County,1,17,749,287,462
50,6,69,California,San Benito County,1,18,698,270,428
50,6,69,California,San Benito County,2,0,55265,27627,27638
50,6,69,California,San Benito County,2,1,4092,2068,2024
50,6,69,California,San Benito County,2,2,4325,2201,2124
50,6,69,California,San Benito County,2,3,4709,2462,2247
50,6,69,California,San Benito County,2,4,4533,2346,2187
50,6,69,California,San Benito County,2,5,3507,1804,1703
50,6,69,California,San Benito County,2,6,3409,1718,1691
50,6,69,California,San Benito County,2,7,3520,1744,1776
50,6,69,California,San Benito County,2,8,3585,1775,1810
50,6,69,California,San Benito County,2,9,4036,1981,2055
50,6,69,California,San Benito County,2,10,4279,2141,2138
50,6,69,California,San Benito County,2,11,3970,1969,2001
50,6,69,California,San Benito County,2,12,3367,1669,1698
50,6,69,California,San Benito County,2,13,2573,1295,1278
50,6,69,California,San Benito County,2,14,1810,877,933
50,6,69,California,San Benito County,2,15,1168,588,580
50,6,69,California,San Benito County,2,16,935,432,503
50,6,69,California,San Benito County,2,17,749,287,462
50,6,69,California,San Benito County,2,18,698,270,428
50,6,69,California,San Benito County,3,0,55544,27796,27748
50,6,69,California,San Benito County,3,1,4089,2076,2013
50,6,69,California,San Benito County,3,2,4338,2199,2139
50,6,69,California,San Benito County,3,3,4692,2457,2235
50,6,69,California,San Benito County,3,4,4546,2343,2203
50,6,69,California,San Benito County,3,5,3538,1833,1705
50,6,69,California,San Benito County,3,6,3471,1756,1715
50,6,69,California,San Benito County,3,7,3550,1761,1789
50,6,69,California,San Benito County,3,8,3576,1774,1802
50,6,69,California,San Benito County,3,9,4037,1982,2055
50,6,69,California,San Benito County,3,10,4274,2141,2133
50,6,69,California,San Benito County,3,11,3992,1984,2008
50,6,69,California,San Benito County,3,12,3391,1677,1714
50,6,69,California,San Benito County,3,13,2622,1323,1299
50,6,69,California,San Benito County,3,14,1828,885,943
50,6,69,California,San Benito County,3,15,1200,603,597
50,6,69,California,San Benito County,3,16,928,432,496
50,6,69,California,San Benito County,3,17,762,295,467
50,6,69,California,San Benito County,3,18,710,275,435
50,6,69,California,San Benito County,4,0,56094,28088,28006
50,6,69,California,San Benito County,4,1,4050,2052,1998
50,6,69,California,San Benito County,4,2,4328,2185,2143
50,6,69,California,San Benito County,4,3,4640,2427,2213
50,6,69,California,San Benito County,4,4,4583,2336,2247
50,6,69,California,San Benito County,4,5,3645,1923,1722
50,6,69,California,San Benito County,4,6,3505,1788,1717
50,6,69,California,San Benito County,4,7,3594,1787,1807
50,6,69,California,San Benito County,4,8,3467,1737,1730
50,6,69,California,San Benito County,4,9,4031,1976,2055
50,6,69,California,San Benito County,4,10,4242,2111,2131
50,6,69,California,San Benito County,4,11,4076,2046,2030
50,6,69,California,San Benito County,4,12,3510,1744,1766
50,6,69,California,San Benito County,4,13,2807,1406,1401
50,6,69,California,San Benito County,4,14,1888,896,992
50,6,69,California,San Benito County,4,15,1285,639,646
50,6,69,California,San Benito County,4,16,908,441,467
50,6,69,California,San Benito County,4,17,791,312,479
50,6,69,California,San Benito County,4,18,744,282,462
50,6,69,California,San Benito County,5,0,56704,28361,28343
50,6,69,California,San Benito County,5,1,3999,2029,1970
50,6,69,California,San Benito County,5,2,4363,2178,2185
50,6,69,California,San Benito County,5,3,4608,2417,2191
50,6,69,California,San Benito County,5,4,4557,2284,2273
50,6,69,California,San Benito County,5,5,3766,1993,1773
50,6,69,California,San Benito County,5,6,3634,1886,1748
50,6,69,California,San Benito County,5,7,3663,1830,1833
50,6,69,California,San Benito County,5,8,3474,1733,1741
50,6,69,California,San Benito County,5,9,3899,1935,1964
50,6,69,California,San Benito County,5,10,4169,2055,2114
50,6,69,California,San Benito County,5,11,4100,2060,2040
50,6,69,California,San Benito County,5,12,3637,1808,1829
50,6,69,California,San Benito County,5,13,2904,1421,1483
50,6,69,California,San Benito County,5,14,2029,970,1059
50,6,69,California,San Benito County,5,15,1368,671,697
50,6,69,California,San Benito County,5,16,949,480,469
50,6,69,California,San Benito County,5,17,796,315,481
50,6,69,California,San Benito County,5,18,789,296,493
50,6,69,California,San Benito County,6,0,57320,28653,28667
50,6,69,California,San Benito County,6,1,3938,2024,1914
50,6,69,California,San Benito County,6,2,4389,2179,2210
50,6,69,California,San Benito County,6,3,4535,2370,2165
50,6,69,California,San Benito County,6,4,4517,2283,2234
50,6,69,California,San Benito County,6,5,3953,2050,1903
50,6,69,California,San Benito County,6,6,3651,1906,1745
50,6,69,California,San Benito County,6,7,3735,1874,1861
50,6,69,California,San Benito County,6,8,3598,1801,1797
50,6,69,California,San Benito County,6,9,3817,1912,1905
50,6,69,California,San Benito County,6,10,4051,1993,2058
50,6,69,California,San Benito County,6,11,4139,2067,2072
50,6,69,California,San Benito County,6,12,3711,1850,1861
50,6,69,California,San Benito County,6,13,3023,1474,1549
50,6,69,California,San Benito County,6,14,2192,1070,1122
50,6,69,California,San Benito County,6,15,1487,710,777
50,6,69,California,San Benito County,6,16,968,474,494
50,6,69,California,San Benito County,6,17,787,324,463
50,6,69,California,San Benito County,6,18,829,292,537
50,6,69,California,San Benito County,7,0,57891,29003,28888
50,6,69,California,San Benito County,7,1,3931,2005,1926
50,6,69,California,San Benito County,7,2,4375,2170,2205
50,6,69,California,San Benito County,7,3,4487,2313,2174
50,6,69,California,San Benito County,7,4,4472,2310,2162
50,6,69,California,San Benito County,7,5,4012,2060,1952
50,6,69,California,San Benito County,7,6,3664,1909,1755
50,6,69,California,San Benito County,7,7,3891,2010,1881
50,6,69,California,San Benito County,7,8,3693,1847,1846
50,6,69,California,San Benito County,7,9,3707,1867,1840
50,6,69,California,San Benito County,7,10,4002,1972,2030
50,6,69,California,San Benito County,7,11,4184,2070,2114
50,6,69,California,San Benito County,7,12,3712,1865,1847
50,6,69,California,San Benito County,7,13,3153,1554,1599
50,6,69,California,San Benito County,7,14,2325,1160,1165
50,6,69,California,San Benito County,7,15,1598,746,852
50,6,69,California,San Benito County,7,16,1002,494,508
50,6,69,California,San Benito County,7,17,836,357,479
50,6,69,California,San Benito County,7,18,847,294,553
50,6,69,California,San Benito County,8,0,58276,29190,29086
50,6,69,California,San Benito County,8,1,3856,1949,1907
50,6,69,California,San Benito County,8,2,4322,2156,2166
50,6,69,California,San Benito County,8,3,4476,2263,2213
50,6,69,California,San Benito County,8,4,4441,2321,2120
50,6,69,California,San Benito County,8,5,3996,2071,1925
50,6,69,California,San Benito County,8,6,3750,1925,1825
50,6,69,California,San Benito County,8,7,3939,2043,1896
50,6,69,California,San Benito County,8,8,3730,1866,1864
50,6,69,California,San Benito County,8,9,3689,1896,1793
50,6,69,California,San Benito County,8,10,3932,1910,2022
50,6,69,California,San Benito County,8,11,4152,2064,2088
50,6,69,California,San Benito County,8,12,3799,1898,1901
50,6,69,California,San Benito County,8,13,3234,1615,1619
50,6,69,California,San Benito County,8,14,2488,1228,1260
50,6,69,California,San Benito County,8,15,1689,786,903
50,6,69,California,San Benito County,8,16,1069,516,553
50,6,69,California,San Benito County,8,17,813,368,445
50,6,69,California,San Benito County,8,18,901,315,586
50,6,69,California,San Benito County,9,0,59270,29759,29511
50,6,69,California,San Benito County,9,1,3894,1973,1921
50,6,69,California,San Benito County,9,2,4294,2169,2125
50,6,69,California,San Benito County,9,3,4504,2281,2223
50,6,69,California,San Benito County,9,4,4475,2329,2146
50,6,69,California,San Benito County,9,5,4049,2052,1997
50,6,69,California,San Benito County,9,6,3825,2029,1796
50,6,69,California,San Benito County,9,7,4093,2141,1952
50,6,69,California,San Benito County,9,8,3835,1914,1921
50,6,69,California,San Benito County,9,9,3678,1907,1771
50,6,69,California,San Benito County,9,10,3934,1920,2014
50,6,69,California,San Benito County,9,11,4186,2076,2110
50,6,69,California,San Benito County,9,12,3886,1951,1935
50,6,69,California,San Benito County,9,13,3328,1673,1655
50,6,69,California,San Benito County,9,14,2637,1298,1339
50,6,69,California,San Benito County,9,15,1779,819,960
50,6,69,California,San Benito County,9,16,1153,539,614
50,6,69,California,San Benito County,9,17,778,357,421
50,6,69,California,San Benito County,9,18,942,331,611
50,6,69,California,San Benito County,10,0,60190,30213,29977
50,6,69,California,San Benito County,10,1,3924,1956,1968
50,6,69,California,San Benito County,10,2,4273,2153,2120
50,6,69,California,San Benito County,10,3,4606,2299,2307
50,6,69,California,San Benito County,10,4,4449,2338,2111
50,6,69,California,San Benito County,10,5,4059,2049,2010
50,6,69,California,San Benito County,10,6,3972,2079,1893
50,6,69,California,San Benito County,10,7,4185,2209,1976
50,6,69,California,San Benito County,10,8,4001,2028,1973
50,6,69,California,San Benito County,10,9,3766,1943,1823
50,6,69,California,San Benito County,10,10,3902,1941,1961
50,6,69,California,San Benito County,10,11,4090,1997,2093
50,6,69,California,San Benito County,10,12,4003,2012,1991
50,6,69,California,San Benito County,10,13,3421,1737,1684
50,6,69,California,San Benito County,10,14,2679,1286,1393
50,6,69,California,San Benito County,10,15,1883,888,995
50,6,69,California,San Benito County,10,16,1245,582,663
50,6,69,California,San Benito County,10,17,793,373,420
50,6,69,California,San Benito County,10,18,939,343,596
50,6,69,California,San Benito County,11,0,61415,30831,30584
50,6,69,California,San Benito County,11,1,3999,1986,2013
50,6,69,California,San Benito County,11,2,4299,2207,2092
50,6,69,California,San Benito County,11,3,4743,2323,2420
50,6,69,California,San Benito County,11,4,4468,2329,2139
50,6,69,California,San Benito County,11,5,4074,2052,2022
50,6,69,California,San Benito County,11,6,4149,2175,1974
50,6,69,California,San Benito County,11,7,4281,2246,2035
50,6,69,California,San Benito County,11,8,4175,2161,2014
50,6,69,California,San Benito County,11,9,3950,2045,1905
50,6,69,California,San Benito County,11,10,3887,1950,1937
50,6,69,California,San Benito County,11,11,4074,2020,2054
50,6,69,California,San Benito County,11,12,4071,2024,2047
50,6,69,California,San Benito County,11,13,3444,1712,1732
50,6,69,California,San Benito County,11,14,2740,1326,1414
50,6,69,California,San Benito County,11,15,1973,956,1017
50,6,69,California,San Benito County,11,16,1319,596,723
50,6,69,California,San Benito County,11,17,839,374,465
50,6,69,California,San Benito County,11,18,930,349,581
50,6,69,California,San Benito County,12,0,62803,31493,31310
50,6,69,California,San Benito County,12,1,4100,2032,2068
50,6,69,California,San Benito County,12,2,4354,2221,2133
50,6,69,California,San Benito County,12,3,4811,2366,2445
50,6,69,California,San Benito County,12,4,4434,2308,2126
50,6,69,California,San Benito County,12,5,4095,2099,1996
50,6,69,California,San Benito County,12,6,4224,2173,2051
50,6,69,California,San Benito County,12,7,4401,2286,2115
50,6,69,California,San Benito County,12,8,4523,2381,2142
50,6,69,California,San Benito County,12,9,4113,2125,1988
50,6,69,California,San Benito County,12,10,3859,1945,1914
50,6,69,California,San Benito County,12,11,4081,2034,2047
50,6,69,California,San Benito County,12,12,4036,1969,2067
50,6,69,California,San Benito County,12,13,3552,1758,1794
50,6,69,California,San Benito County,12,14,2870,1389,1481
50,6,69,California,San Benito County,12,15,2089,1040,1049
50,6,69,California,San Benito County,12,16,1413,628,785
50,6,69,California,San Benito County,12,17,883,381,502
50,6,69,California,San Benito County,12,18,965,358,607
50,6,69,California,San Benito County,13,0,63808,32054,31754
50,6,69,California,San Benito County,13,1,4153,2074,2079
50,6,69,California,San Benito County,13,2,4463,2284,2179
50,6,69,California,San Benito County,13,3,4837,2399,2438
50,6,69,California,San Benito County,13,4,4439,2284,2155
50,6,69,California,San Benito County,13,5,4106,2104,2002
50,6,69,California,San Benito County,13,6,4285,2219,2066
50,6,69,California,San Benito County,13,7,4444,2278,2166
50,6,69,California,San Benito County,13,8,4637,2468,2169
50,6,69,California,San Benito County,13,9,4241,2178,2063
50,6,69,California,San Benito County,13,10,3889,1994,1895
50,6,69,California,San Benito County,13,11,4045,2001,2044
50,6,69,California,San Benito County,13,12,4088,2018,2070
50,6,69,California,San Benito County,13,13,3604,1789,1815
50,6,69,California,San Benito County,13,14,2974,1447,1527
50,6,69,California,San Benito County,13,15,2204,1088,1116
50,6,69,California,San Benito County,13,16,1468,657,811
50,6,69,California,San Benito County,13,17,952,399,553
50,6,69,California,San Benito County,13,18,979,373,606
50,6,69,California,San Benito County,14,0,64055,32203,31852
50,6,69,California,San Benito County,14,1,4170,2090,2080
50,6,69,California,San Benito County,14,2,4490,2299,2191
50,6,69,California,San Benito County,14,3,4838,2409,2429
50,6,69,California,San Benito County,14,4,4433,2272,2161
50,6,69,California,San Benito County,14,5,4100,2102,1998
50,6,69,California,San Benito County,14,6,4299,2231,2068
50,6,69,California,San Benito County,14,7,4458,2274,2184
50,6,69,California,San Benito County,14,8,4680,2500,2180
50,6,69,California,San Benito County,14,9,4282,2195,2087
50,6,69,California,San Benito County,14,10,3894,2007,1887
50,6,69,California,San Benito County,14,11,4035,1992,2043
50,6,69,California,San Benito County,14,12,4098,2032,2066
50,6,69,California,San Benito County,14,13,3619,1798,1821
50,6,69,California,San Benito County,14,14,3007,1467,1540
50,6,69,California,San Benito County,14,15,2232,1098,1134
50,6,69,California,San Benito County,14,16,1477,660,817
50,6,69,California,San Benito County,14,17,968,403,565
50,6,69,California,San Benito County,14,18,975,374,601
50,6,71,California,San Bernardino County,1,0,2035210,1011507,1023703
50,6,71,California,San Bernardino County,1,1,158790,81204,77586
50,6,71,California,San Bernardino County,1,2,157368,80826,76542
50,6,71,California,San Bernardino County,1,3,168792,86488,82304
50,6,71,California,San Bernardino County,1,4,179627,92559,87068
50,6,71,California,San Bernardino County,1,5,159908,82686,77222
50,6,71,California,San Bernardino County,1,6,146477,74035,72442
50,6,71,California,San Bernardino County,1,7,135614,67251,68363
50,6,71,California,San Bernardino County,1,8,135711,66568,69143
50,6,71,California,San Bernardino County,1,9,137238,68259,68979
50,6,71,California,San Bernardino County,1,10,142691,70145,72546
50,6,71,California,San Bernardino County,1,11,134603,65998,68605
50,6,71,California,San Bernardino County,1,12,110620,53760,56860
50,6,71,California,San Bernardino County,1,13,86423,42112,44311
50,6,71,California,San Bernardino County,1,14,60089,28481,31608
50,6,71,California,San Bernardino County,1,15,43406,19885,23521
50,6,71,California,San Bernardino County,1,16,33065,14482,18583
50,6,71,California,San Bernardino County,1,17,23914,9643,14271
50,6,71,California,San Bernardino County,1,18,20874,7125,13749
50,6,71,California,San Bernardino County,2,0,2035172,1011485,1023687
50,6,71,California,San Bernardino County,2,1,158788,81203,77585
50,6,71,California,San Bernardino County,2,2,157361,80821,76540
50,6,71,California,San Bernardino County,2,3,168784,86481,82303
50,6,71,California,San Bernardino County,2,4,179625,92557,87068
50,6,71,California,San Bernardino County,2,5,159908,82686,77222
50,6,71,California,San Bernardino County,2,6,146475,74035,72440
50,6,71,California,San Bernardino County,2,7,135612,67250,68362
50,6,71,California,San Bernardino County,2,8,135711,66568,69143
50,6,71,California,San Bernardino County,2,9,137238,68261,68977
50,6,71,California,San Bernardino County,2,10,142686,70142,72544
50,6,71,California,San Bernardino County,2,11,134606,66000,68606
50,6,71,California,San Bernardino County,2,12,110612,53756,56856
50,6,71,California,San Bernardino County,2,13,86422,42112,44310
50,6,71,California,San Bernardino County,2,14,60090,28482,31608
50,6,71,California,San Bernardino County,2,15,43405,19884,23521
50,6,71,California,San Bernardino County,2,16,33066,14482,18584
50,6,71,California,San Bernardino County,2,17,23910,9640,14270
50,6,71,California,San Bernardino County,2,18,20873,7125,13748
50,6,71,California,San Bernardino County,3,0,2040803,1014353,1026450
50,6,71,California,San Bernardino County,3,1,158533,81092,77441
50,6,71,California,San Bernardino County,3,2,157499,80850,76649
50,6,71,California,San Bernardino County,3,3,168272,86258,82014
50,6,71,California,San Bernardino County,3,4,178639,92102,86537
50,6,71,California,San Bernardino County,3,5,161698,83538,78160
50,6,71,California,San Bernardino County,3,6,147251,74469,72782
50,6,71,California,San Bernardino County,3,7,136586,67828,68758
50,6,71,California,San Bernardino County,3,8,135442,66457,68985
50,6,71,California,San Bernardino County,3,9,137508,68302,69206
50,6,71,California,San Bernardino County,3,10,142366,70038,72328
50,6,71,California,San Bernardino County,3,11,135211,66315,68896
50,6,71,California,San Bernardino County,3,12,111623,54230,57393
50,6,71,California,San Bernardino County,3,13,87575,42635,44940
50,6,71,California,San Bernardino County,3,14,60685,28776,31909
50,6,71,California,San Bernardino County,3,15,43715,20061,23654
50,6,71,California,San Bernardino County,3,16,33099,14487,18612
50,6,71,California,San Bernardino County,3,17,24028,9720,14308
50,6,71,California,San Bernardino County,3,18,21073,7195,13878
50,6,71,California,San Bernardino County,4,0,2060596,1024113,1036483
50,6,71,California,San Bernardino County,4,1,158456,80983,77473
50,6,71,California,San Bernardino County,4,2,158291,81064,77227
50,6,71,California,San Bernardino County,4,3,166020,85118,80902
50,6,71,California,San Bernardino County,4,4,175053,90294,84759
50,6,71,California,San Bernardino County,4,5,167970,86658,81312
50,6,71,California,San Bernardino County,4,6,149704,75927,73777
50,6,71,California,San Bernardino County,4,7,139718,69833,69885
50,6,71,California,San Bernardino County,4,8,133691,65734,67957
50,6,71,California,San Bernardino County,4,9,138376,68414,69962
50,6,71,California,San Bernardino County,4,10,140074,69007,71067
50,6,71,California,San Bernardino County,4,11,137012,67196,69816
50,6,71,California,San Bernardino County,4,12,115355,55769,59586
50,6,71,California,San Bernardino County,4,13,92383,44919,47464
50,6,71,California,San Bernardino County,4,14,63324,30181,33143
50,6,71,California,San Bernardino County,4,15,45139,20771,24368
50,6,71,California,San Bernardino County,4,16,33702,14713,18989
50,6,71,California,San Bernardino County,4,17,24556,10102,14454
50,6,71,California,San Bernardino County,4,18,21772,7430,14342
50,6,71,California,San Bernardino County,5,0,2073088,1031405,1041683
50,6,71,California,San Bernardino County,5,1,156085,79837,76248
50,6,71,California,San Bernardino County,5,2,159642,81729,77913
50,6,71,California,San Bernardino County,5,3,162948,83578,79370
50,6,71,California,San Bernardino County,5,4,171167,88274,82893
50,6,71,California,San Bernardino County,5,5,172760,89596,83164
50,6,71,California,San Bernardino County,5,6,151620,77372,74248
50,6,71,California,San Bernardino County,5,7,142383,71528,70855
50,6,71,California,San Bernardino County,5,8,133415,65695,67720
50,6,71,California,San Bernardino County,5,9,137575,67990,69585
50,6,71,California,San Bernardino County,5,10,136928,67616,69312
50,6,71,California,San Bernardino County,5,11,137524,67350,70174
50,6,71,California,San Bernardino County,5,12,119459,57718,61741
50,6,71,California,San Bernardino County,5,13,93525,45219,48306
50,6,71,California,San Bernardino County,5,14,68916,33039,35877
50,6,71,California,San Bernardino County,5,15,47165,21689,25476
50,6,71,California,San Bernardino County,5,16,34451,15058,19393
50,6,71,California,San Bernardino County,5,17,24948,10361,14587
50,6,71,California,San Bernardino County,5,18,22577,7756,14821
50,6,71,California,San Bernardino County,6,0,2082101,1035311,1046790
50,6,71,California,San Bernardino County,6,1,153628,78170,75458
50,6,71,California,San Bernardino County,6,2,160406,82250,78156
50,6,71,California,San Bernardino County,6,3,160961,82516,78445
50,6,71,California,San Bernardino County,6,4,167334,86208,81126
50,6,71,California,San Bernardino County,6,5,174341,90688,83653
50,6,71,California,San Bernardino County,6,6,153703,78460,75243
50,6,71,California,San Bernardino County,6,7,144587,72692,71895
50,6,71,California,San Bernardino County,6,8,133560,65904,67656
50,6,71,California,San Bernardino County,6,9,136294,67068,69226
50,6,71,California,San Bernardino County,6,10,134629,66529,68100
50,6,71,California,San Bernardino County,6,11,137231,67192,70039
50,6,71,California,San Bernardino County,6,12,122569,59287,63282
50,6,71,California,San Bernardino County,6,13,96238,46344,49894
50,6,71,California,San Bernardino County,6,14,72532,34612,37920
50,6,71,California,San Bernardino County,6,15,50018,23077,26941
50,6,71,California,San Bernardino County,6,16,35515,15638,19877
50,6,71,California,San Bernardino County,6,17,25216,10529,14687
50,6,71,California,San Bernardino County,6,18,23339,8147,15192
50,6,71,California,San Bernardino County,7,0,2098346,1044094,1054252
50,6,71,California,San Bernardino County,7,1,153661,78233,75428
50,6,71,California,San Bernardino County,7,2,160374,82175,78199
50,6,71,California,San Bernardino County,7,3,159899,81965,77934
50,6,71,California,San Bernardino County,7,4,163641,84327,79314
50,6,71,California,San Bernardino County,7,5,175192,91444,83748
50,6,71,California,San Bernardino County,7,6,158381,80803,77578
50,6,71,California,San Bernardino County,7,7,147291,74387,72904
50,6,71,California,San Bernardino County,7,8,134415,66733,67682
50,6,71,California,San Bernardino County,7,9,134927,66211,68716
50,6,71,California,San Bernardino County,7,10,133184,66081,67103
50,6,71,California,San Bernardino County,7,11,137351,67275,70076
50,6,71,California,San Bernardino County,7,12,124829,60494,64335
50,6,71,California,San Bernardino County,7,13,100007,47914,52093
50,6,71,California,San Bernardino County,7,14,76253,36284,39969
50,6,71,California,San Bernardino County,7,15,52660,24351,28309
50,6,71,California,San Bernardino County,7,16,36549,16211,20338
50,6,71,California,San Bernardino County,7,17,25535,10634,14901
50,6,71,California,San Bernardino County,7,18,24197,8572,15625
50,6,71,California,San Bernardino County,8,0,2114352,1052246,1062106
50,6,71,California,San Bernardino County,8,1,154495,78786,75709
50,6,71,California,San Bernardino County,8,2,159790,81727,78063
50,6,71,California,San Bernardino County,8,3,158890,81305,77585
50,6,71,California,San Bernardino County,8,4,161561,83411,78150
50,6,71,California,San Bernardino County,8,5,172453,89888,82565
50,6,71,California,San Bernardino County,8,6,163753,83796,79957
50,6,71,California,San Bernardino County,8,7,148447,75193,73254
50,6,71,California,San Bernardino County,8,8,136803,68139,68664
50,6,71,California,San Bernardino County,8,9,133122,65285,67837
50,6,71,California,San Bernardino County,8,10,133178,66105,67073
50,6,71,California,San Bernardino County,8,11,135914,66499,69415
50,6,71,California,San Bernardino County,8,12,127423,61851,65572
50,6,71,California,San Bernardino County,8,13,104005,49789,54216
50,6,71,California,San Bernardino County,8,14,80575,38364,42211
50,6,71,California,San Bernardino County,8,15,55383,25662,29721
50,6,71,California,San Bernardino County,8,16,37613,16715,20898
50,6,71,California,San Bernardino County,8,17,25888,10783,15105
50,6,71,California,San Bernardino County,8,18,25059,8948,16111
50,6,71,California,San Bernardino County,9,0,2130726,1060292,1070434
50,6,71,California,San Bernardino County,9,1,154043,78726,75317
50,6,71,California,San Bernardino County,9,2,159901,81609,78292
50,6,71,California,San Bernardino County,9,3,159585,81693,77892
50,6,71,California,San Bernardino County,9,4,160012,82715,77297
50,6,71,California,San Bernardino County,9,5,168728,87928,80800
50,6,71,California,San Bernardino County,9,6,169423,86624,82799
50,6,71,California,San Bernardino County,9,7,150229,76267,73962
50,6,71,California,San Bernardino County,9,8,139315,69509,69806
50,6,71,California,San Bernardino County,9,9,131996,64932,67064
50,6,71,California,San Bernardino County,9,10,134084,66170,67914
50,6,71,California,San Bernardino County,9,11,133542,65407,68135
50,6,71,California,San Bernardino County,9,12,129373,62874,66499
50,6,71,California,San Bernardino County,9,13,107365,51243,56122
50,6,71,California,San Bernardino County,9,14,84737,40267,44470
50,6,71,California,San Bernardino County,9,15,57434,26650,30784
50,6,71,California,San Bernardino County,9,16,38868,17342,21526
50,6,71,California,San Bernardino County,9,17,26384,11000,15384
50,6,71,California,San Bernardino County,9,18,25707,9336,16371
50,6,71,California,San Bernardino County,10,0,2149847,1070072,1079775
50,6,71,California,San Bernardino County,10,1,154525,78871,75654
50,6,71,California,San Bernardino County,10,2,158669,80889,77780
50,6,71,California,San Bernardino County,10,3,161570,82610,78960
50,6,71,California,San Bernardino County,10,4,157962,81615,76347
50,6,71,California,San Bernardino County,10,5,166394,86761,79633
50,6,71,California,San Bernardino County,10,6,174099,89280,84819
50,6,71,California,San Bernardino County,10,7,152334,77599,74735
50,6,71,California,San Bernardino County,10,8,142870,71608,71262
50,6,71,California,San Bernardino County,10,9,132628,65415,67213
50,6,71,California,San Bernardino County,10,10,134269,66148,68121
50,6,71,California,San Bernardino County,10,11,131478,64622,66856
50,6,71,California,San Bernardino County,10,12,130295,63173,67122
50,6,71,California,San Bernardino County,10,13,111471,53246,58225
50,6,71,California,San Bernardino County,10,14,85568,40337,45231
50,6,71,California,San Bernardino County,10,15,62007,28936,33071
50,6,71,California,San Bernardino County,10,16,40483,18092,22391
50,6,71,California,San Bernardino County,10,17,26985,11232,15753
50,6,71,California,San Bernardino County,10,18,26240,9638,16602
50,6,71,California,San Bernardino County,11,0,2165627,1078174,1087453
50,6,71,California,San Bernardino County,11,1,153858,78558,75300
50,6,71,California,San Bernardino County,11,2,157862,80305,77557
50,6,71,California,San Bernardino County,11,3,163084,83665,79419
50,6,71,California,San Bernardino County,11,4,156892,81219,75673
50,6,71,California,San Bernardino County,11,5,163343,84748,78595
50,6,71,California,San Bernardino County,11,6,176568,90808,85760
50,6,71,California,San Bernardino County,11,7,155744,79615,76129
50,6,71,California,San Bernardino County,11,8,146168,73404,72764
50,6,71,California,San Bernardino County,11,9,133272,65954,67318
50,6,71,California,San Bernardino County,11,10,133842,65642,68200
50,6,71,California,San Bernardino County,11,11,130190,64126,66064
50,6,71,California,San Bernardino County,11,12,130820,63433,67387
50,6,71,California,San Bernardino County,11,13,114214,54642,59572
50,6,71,California,San Bernardino County,11,14,87602,41247,46355
50,6,71,California,San Bernardino County,11,15,64879,30168,34711
50,6,71,California,San Bernardino County,11,16,42737,19080,23657
50,6,71,California,San Bernardino County,11,17,27825,11715,16110
50,6,71,California,San Bernardino County,11,18,26727,9845,16882
50,6,71,California,San Bernardino County,12,0,2177279,1083953,1093326
50,6,71,California,San Bernardino County,12,1,151925,77847,74078
50,6,71,California,San Bernardino County,12,2,157803,80151,77652
50,6,71,California,San Bernardino County,12,3,163771,83964,79807
50,6,71,California,San Bernardino County,12,4,156021,80688,75333
50,6,71,California,San Bernardino County,12,5,159252,82452,76800
50,6,71,California,San Bernardino County,12,6,176916,91002,85914
50,6,71,California,San Bernardino County,12,7,160345,81800,78545
50,6,71,California,San Bernardino County,12,8,148842,75156,73686
50,6,71,California,San Bernardino County,12,9,134812,66957,67855
50,6,71,California,San Bernardino County,12,10,132872,65044,67828
50,6,71,California,San Bernardino County,12,11,128712,63593,65119
50,6,71,California,San Bernardino County,12,12,130794,63519,67275
50,6,71,California,San Bernardino County,12,13,115985,55459,60526
50,6,71,California,San Bernardino County,12,14,90823,42630,48193
50,6,71,California,San Bernardino County,12,15,68052,31633,36419
50,6,71,California,San Bernardino County,12,16,44611,19957,24654
50,6,71,California,San Bernardino County,12,17,28431,11975,16456
50,6,71,California,San Bernardino County,12,18,27312,10126,17186
50,6,71,California,San Bernardino County,13,0,2187894,1089749,1098145
50,6,71,California,San Bernardino County,13,1,149933,76736,73197
50,6,71,California,San Bernardino County,13,2,158826,80825,78001
50,6,71,California,San Bernardino County,13,3,163756,83865,79891
50,6,71,California,San Bernardino County,13,4,155782,80581,75201
50,6,71,California,San Bernardino County,13,5,158675,82491,76184
50,6,71,California,San Bernardino County,13,6,174879,89926,84953
50,6,71,California,San Bernardino County,13,7,164351,83858,80493
50,6,71,California,San Bernardino County,13,8,150154,76097,74057
50,6,71,California,San Bernardino County,13,9,137111,68282,68829
50,6,71,California,San Bernardino County,13,10,131669,64504,67165
50,6,71,California,San Bernardino County,13,11,129139,63880,65259
50,6,71,California,San Bernardino County,13,12,129749,62945,66804
50,6,71,California,San Bernardino County,13,13,117589,56415,61174
50,6,71,California,San Bernardino County,13,14,93112,43633,49479
50,6,71,California,San Bernardino County,13,15,70454,32604,37850
50,6,71,California,San Bernardino County,13,16,46009,20654,25355
50,6,71,California,San Bernardino County,13,17,28851,12157,16694
50,6,71,California,San Bernardino County,13,18,27855,10296,17559
50,6,71,California,San Bernardino County,14,0,2189183,1090578,1098605
50,6,71,California,San Bernardino County,14,1,149211,76318,72893
50,6,71,California,San Bernardino County,14,2,158917,80929,77988
50,6,71,California,San Bernardino County,14,3,163561,83747,79814
50,6,71,California,San Bernardino County,14,4,155519,80447,75072
50,6,71,California,San Bernardino County,14,5,158227,82359,75868
50,6,71,California,San Bernardino County,14,6,173893,89433,84460
50,6,71,California,San Bernardino County,14,7,165620,84492,81128
50,6,71,California,San Bernardino County,14,8,150648,76467,74181
50,6,71,California,San Bernardino County,14,9,137789,68686,69103
50,6,71,California,San Bernardino County,14,10,131282,64333,66949
50,6,71,California,San Bernardino County,14,11,129358,64006,65352
50,6,71,California,San Bernardino County,14,12,129286,62720,66566
50,6,71,California,San Bernardino County,14,13,117961,56627,61334
50,6,71,California,San Bernardino County,14,14,93800,43939,49861
50,6,71,California,San Bernardino County,14,15,71046,32813,38233
50,6,71,California,San Bernardino County,14,16,46317,20809,25508
50,6,71,California,San Bernardino County,14,17,28925,12187,16738
50,6,71,California,San Bernardino County,14,18,27823,10266,17557
50,6,73,California,San Diego County,1,0,3095313,1553679,1541634
50,6,73,California,San Diego County,1,1,203423,103833,99590
50,6,73,California,San Diego County,1,2,194029,99321,94708
50,6,73,California,San Diego County,1,3,198716,101903,96813
50,6,73,California,San Diego County,1,4,225095,118308,106787
50,6,73,California,San Diego County,1,5,270750,148641,122109
50,6,73,California,San Diego County,1,6,250737,131078,119659
50,6,73,California,San Diego County,1,7,220185,112648,107537
50,6,73,California,San Diego County,1,8,211012,106391,104621
50,6,73,California,San Diego County,1,9,209551,105283,104268
50,6,73,California,San Diego County,1,10,219795,110118,109677
50,6,73,California,San Diego County,1,11,210979,104346,106633
50,6,73,California,San Diego County,1,12,180305,87501,92804
50,6,73,California,San Diego County,1,13,149311,71683,77628
50,6,73,California,San Diego County,1,14,103241,48409,54832
50,6,73,California,San Diego County,1,15,77313,34739,42574
50,6,73,California,San Diego County,1,16,64347,28190,36157
50,6,73,California,San Diego County,1,17,52564,21706,30858
50,6,73,California,San Diego County,1,18,53960,19581,34379
50,6,73,California,San Diego County,2,0,3095352,1553695,1541657
50,6,73,California,San Diego County,2,1,203425,103833,99592
50,6,73,California,San Diego County,2,2,194032,99321,94711
50,6,73,California,San Diego County,2,3,198718,101905,96813
50,6,73,California,San Diego County,2,4,225099,118310,106789
50,6,73,California,San Diego County,2,5,270753,148642,122111
50,6,73,California,San Diego County,2,6,250739,131079,119660
50,6,73,California,San Diego County,2,7,220189,112649,107540
50,6,73,California,San Diego County,2,8,211013,106392,104621
50,6,73,California,San Diego County,2,9,209552,105283,104269
50,6,73,California,San Diego County,2,10,219798,110120,109678
50,6,73,California,San Diego County,2,11,210984,104347,106637
50,6,73,California,San Diego County,2,12,180306,87501,92805
50,6,73,California,San Diego County,2,13,149315,71685,77630
50,6,73,California,San Diego County,2,14,103243,48411,54832
50,6,73,California,San Diego County,2,15,77314,34740,42574
50,6,73,California,San Diego County,2,16,64347,28190,36157
50,6,73,California,San Diego County,2,17,52564,21706,30858
50,6,73,California,San Diego County,2,18,53961,19581,34380
50,6,73,California,San Diego County,3,0,3103260,1557324,1545936
50,6,73,California,San Diego County,3,1,204076,104106,99970
50,6,73,California,San Diego County,3,2,194238,99408,94830
50,6,73,California,San Diego County,3,3,198050,101515,96535
50,6,73,California,San Diego County,3,4,224356,117985,106371
50,6,73,California,San Diego County,3,5,271370,148547,122823
50,6,73,California,San Diego County,3,6,251700,131615,120085
50,6,73,California,San Diego County,3,7,222011,113669,108342
50,6,73,California,San Diego County,3,8,210534,106176,104358
50,6,73,California,San Diego County,3,9,210110,105534,104576
50,6,73,California,San Diego County,3,10,218989,109706,109283
50,6,73,California,San Diego County,3,11,211732,104760,106972
50,6,73,California,San Diego County,3,12,181786,88245,93541
50,6,73,California,San Diego County,3,13,150948,72456,78492
50,6,73,California,San Diego County,3,14,104414,49011,55403
50,6,73,California,San Diego County,3,15,77757,34958,42799
50,6,73,California,San Diego County,3,16,64158,28077,36081
50,6,73,California,San Diego County,3,17,52643,21832,30811
50,6,73,California,San Diego County,3,18,54388,19724,34664
50,6,73,California,San Diego County,4,0,3137236,1573485,1563751
50,6,73,California,San Diego County,4,1,207550,105752,101798
50,6,73,California,San Diego County,4,2,196091,100320,95771
50,6,73,California,San Diego County,4,3,196579,100674,95905
50,6,73,California,San Diego County,4,4,219542,115781,103761
50,6,73,California,San Diego County,4,5,274560,149431,125129
50,6,73,California,San Diego County,4,6,256244,134091,122153
50,6,73,California,San Diego County,4,7,229133,117390,111743
50,6,73,California,San Diego County,4,8,207621,104819,102802
50,6,73,California,San Diego County,4,9,212634,106530,106104
50,6,73,California,San Diego County,4,10,214847,107492,107355
50,6,73,California,San Diego County,4,11,214444,106293,108151
50,6,73,California,San Diego County,4,12,187427,90950,96477
50,6,73,California,San Diego County,4,13,158186,75878,82308
50,6,73,California,San Diego County,4,14,109428,51474,57954
50,6,73,California,San Diego County,4,15,79975,36047,43928
50,6,73,California,San Diego County,4,16,64340,28090,36250
50,6,73,California,San Diego County,4,17,52689,22134,30555
50,6,73,California,San Diego County,4,18,55946,20339,35607
50,6,73,California,San Diego County,5,0,3175148,1595040,1580108
50,6,73,California,San Diego County,5,1,208724,106660,102064
50,6,73,California,San Diego County,5,2,198916,101567,97349
50,6,73,California,San Diego County,5,3,194968,99710,95258
50,6,73,California,San Diego County,5,4,217307,114499,102808
50,6,73,California,San Diego County,5,5,276782,151509,125273
50,6,73,California,San Diego County,5,6,261063,137364,123699
50,6,73,California,San Diego County,5,7,236440,121470,114970
50,6,73,California,San Diego County,5,8,209044,105779,103265
50,6,73,California,San Diego County,5,9,213446,107099,106347
50,6,73,California,San Diego County,5,10,211238,105645,105593
50,6,73,California,San Diego County,5,11,215504,107104,108400
50,6,73,California,San Diego County,5,12,193725,94026,99699
50,6,73,California,San Diego County,5,13,159367,76527,82840
50,6,73,California,San Diego County,5,14,120463,56793,63670
50,6,73,California,San Diego County,5,15,83137,37683,45454
50,6,73,California,San Diego County,5,16,64927,28356,36571
50,6,73,California,San Diego County,5,17,52759,22352,30407
50,6,73,California,San Diego County,5,18,57338,20897,36441
50,6,73,California,San Diego County,6,0,3210788,1612489,1598299
50,6,73,California,San Diego County,6,1,210473,107614,102859
50,6,73,California,San Diego County,6,2,201085,102610,98475
50,6,73,California,San Diego County,6,3,194344,99313,95031
50,6,73,California,San Diego County,6,4,214432,112212,102220
50,6,73,California,San Diego County,6,5,274041,150344,123697
50,6,73,California,San Diego County,6,6,267829,140833,126996
50,6,73,California,San Diego County,6,7,243968,125772,118196
50,6,73,California,San Diego County,6,8,212080,107502,104578
50,6,73,California,San Diego County,6,9,212753,106465,106288
50,6,73,California,San Diego County,6,10,208628,104343,104285
50,6,73,California,San Diego County,6,11,216256,107451,108805
50,6,73,California,San Diego County,6,12,198449,96677,101772
50,6,73,California,San Diego County,6,13,163200,78352,84848
50,6,73,California,San Diego County,6,14,127772,60148,67624
50,6,73,California,San Diego County,6,15,88340,40257,48083
50,6,73,California,San Diego County,6,16,66123,28982,37141
50,6,73,California,San Diego County,6,17,52699,22357,30342
50,6,73,California,San Diego County,6,18,58316,21257,37059
50,6,73,California,San Diego County,7,0,3249307,1633854,1615453
50,6,73,California,San Diego County,7,1,213330,109215,104115
50,6,73,California,San Diego County,7,2,200938,102434,98504
50,6,73,California,San Diego County,7,3,194203,99142,95061
50,6,73,California,San Diego County,7,4,212246,111086,101160
50,6,73,California,San Diego County,7,5,272612,151554,121058
50,6,73,California,San Diego County,7,6,276118,144854,131264
50,6,73,California,San Diego County,7,7,249961,129119,120842
50,6,73,California,San Diego County,7,8,216013,109888,106125
50,6,73,California,San Diego County,7,9,211372,105921,105451
50,6,73,California,San Diego County,7,10,206599,103184,103415
50,6,73,California,San Diego County,7,11,216849,107826,109023
50,6,73,California,San Diego County,7,12,201477,98313,103164
50,6,73,California,San Diego County,7,13,168687,80944,87743
50,6,73,California,San Diego County,7,14,135841,64071,71770
50,6,73,California,San Diego County,7,15,92679,42409,50270
50,6,73,California,San Diego County,7,16,68012,29823,38189
50,6,73,California,San Diego County,7,17,52676,22254,30422
50,6,73,California,San Diego County,7,18,59694,21817,37877
50,6,73,California,San Diego County,8,0,3280825,1651891,1628934
50,6,73,California,San Diego County,8,1,214864,110189,104675
50,6,73,California,San Diego County,8,2,199996,101966,98030
50,6,73,California,San Diego County,8,3,193818,99021,94797
50,6,73,California,San Diego County,8,4,211321,110559,100762
50,6,73,California,San Diego County,8,5,268360,150560,117800
50,6,73,California,San Diego County,8,6,282767,148097,134670
50,6,73,California,San Diego County,8,7,253355,131206,122149
50,6,73,California,San Diego County,8,8,221590,113159,108431
50,6,73,California,San Diego County,8,9,208621,104698,103923
50,6,73,California,San Diego County,8,10,207607,103553,104054
50,6,73,California,San Diego County,8,11,214848,106872,107976
50,6,73,California,San Diego County,8,12,205000,100578,104422
50,6,73,California,San Diego County,8,13,174162,83468,90694
50,6,73,California,San Diego County,8,14,143201,67644,75557
50,6,73,California,San Diego County,8,15,97598,44809,52789
50,6,73,California,San Diego County,8,16,69582,30508,39074
50,6,73,California,San Diego County,8,17,52683,22175,30508
50,6,73,California,San Diego County,8,18,61452,22829,38623
50,6,73,California,San Diego County,9,0,3305462,1664812,1640650
50,6,73,California,San Diego County,9,1,213079,109406,103673
50,6,73,California,San Diego County,9,2,200671,102216,98455
50,6,73,California,San Diego County,9,3,194428,99443,94985
50,6,73,California,San Diego County,9,4,209467,109535,99932
50,6,73,California,San Diego County,9,5,262829,147661,115168
50,6,73,California,San Diego County,9,6,287647,150610,137037
50,6,73,California,San Diego County,9,7,257122,133685,123437
50,6,73,California,San Diego County,9,8,228349,116775,111574
50,6,73,California,San Diego County,9,9,206065,103569,102496
50,6,73,California,San Diego County,9,10,209855,104529,105326
50,6,73,California,San Diego County,9,11,210374,104547,105827
50,6,73,California,San Diego County,9,12,207301,102046,105255
50,6,73,California,San Diego County,9,13,179293,85828,93465
50,6,73,California,San Diego County,9,14,149829,70774,79055
50,6,73,California,San Diego County,9,15,102271,47102,55169
50,6,73,California,San Diego County,9,16,71394,31392,40002
50,6,73,California,San Diego County,9,17,52858,22271,30587
50,6,73,California,San Diego County,9,18,62630,23423,39207
50,6,73,California,San Diego County,10,0,3319019,1671454,1647565
50,6,73,California,San Diego County,10,1,210548,107902,102646
50,6,73,California,San Diego County,10,2,200472,102493,97979
50,6,73,California,San Diego County,10,3,196198,100013,96185
50,6,73,California,San Diego County,10,4,206772,108116,98656
50,6,73,California,San Diego County,10,5,254797,142525,112272
50,6,73,California,San Diego County,10,6,288414,151302,137112
50,6,73,California,San Diego County,10,7,260511,135743,124768
50,6,73,California,San Diego County,10,8,234068,120108,113960
50,6,73,California,San Diego County,10,9,206551,103932,102619
50,6,73,California,San Diego County,10,10,209707,104627,105080
50,6,73,California,San Diego County,10,11,206489,102561,103928
50,6,73,California,San Diego County,10,12,207543,102254,105289
50,6,73,California,San Diego County,10,13,183927,88138,95789
50,6,73,California,San Diego County,10,14,150211,70904,79307
50,6,73,California,San Diego County,10,15,111949,51672,60277
50,6,73,California,San Diego County,10,16,74176,32877,41299
50,6,73,California,San Diego County,10,17,53391,22462,30929
50,6,73,California,San Diego County,10,18,63295,23825,39470
50,6,73,California,San Diego County,11,0,3332483,1679402,1653081
50,6,73,California,San Diego County,11,1,206865,105970,100895
50,6,73,California,San Diego County,11,2,200274,102560,97714
50,6,73,California,San Diego County,11,3,196608,100318,96290
50,6,73,California,San Diego County,11,4,206499,107916,98583
50,6,73,California,San Diego County,11,5,250919,140159,110760
50,6,73,California,San Diego County,11,6,285998,150450,135548
50,6,73,California,San Diego County,11,7,264217,137863,126354
50,6,73,California,San Diego County,11,8,240009,123717,116292
50,6,73,California,San Diego County,11,9,207831,104735,103096
50,6,73,California,San Diego County,11,10,207908,103616,104292
50,6,73,California,San Diego County,11,11,202982,100910,102072
50,6,73,California,San Diego County,11,12,207641,102345,105296
50,6,73,California,San Diego County,11,13,187053,90083,96970
50,6,73,California,San Diego County,11,14,152768,72094,80674
50,6,73,California,San Diego County,11,15,118258,54690,63568
50,6,73,California,San Diego County,11,16,78713,35076,43637
50,6,73,California,San Diego County,11,17,54247,22981,31266
50,6,73,California,San Diego County,11,18,63693,23919,39774
50,6,73,California,San Diego County,12,0,3330459,1677056,1653403
50,6,73,California,San Diego County,12,1,201541,103113,98428
50,6,73,California,San Diego County,12,2,201244,103073,98171
50,6,73,California,San Diego County,12,3,194923,99586,95337
50,6,73,California,San Diego County,12,4,205710,107033,98677
50,6,73,California,San Diego County,12,5,243757,135133,108624
50,6,73,California,San Diego County,12,6,280473,148232,132241
50,6,73,California,San Diego County,12,7,268102,139516,128586
50,6,73,California,San Diego County,12,8,242821,125228,117593
50,6,73,California,San Diego County,12,9,209609,106081,103528
50,6,73,California,San Diego County,12,10,204945,102358,102587
50,6,73,California,San Diego County,12,11,199442,98928,100514
50,6,73,California,San Diego County,12,12,206683,101939,104744
50,6,73,California,San Diego County,12,13,188590,91120,97470
50,6,73,California,San Diego County,12,14,156391,73807,82584
50,6,73,California,San Diego County,12,15,124487,57566,66921
50,6,73,California,San Diego County,12,16,81985,36653,45332
50,6,73,California,San Diego County,12,17,55574,23561,32013
50,6,73,California,San Diego County,12,18,64182,24129,40053
50,6,73,California,San Diego County,13,0,3334413,1680372,1654041
50,6,73,California,San Diego County,13,1,198021,101179,96842
50,6,73,California,San Diego County,13,2,202193,103839,98354
50,6,73,California,San Diego County,13,3,193614,98901,94713
50,6,73,California,San Diego County,13,4,204929,106780,98149
50,6,73,California,San Diego County,13,5,242285,134616,107669
50,6,73,California,San Diego County,13,6,275821,146275,129546
50,6,73,California,San Diego County,13,7,272061,141373,130688
50,6,73,California,San Diego County,13,8,244021,126267,117754
50,6,73,California,San Diego County,13,9,212266,107759,104507
50,6,73,California,San Diego County,13,10,202168,100955,101213
50,6,73,California,San Diego County,13,11,199130,98781,100349
50,6,73,California,San Diego County,13,12,203899,100592,103307
50,6,73,California,San Diego County,13,13,190045,92127,97918
50,6,73,California,San Diego County,13,14,159025,74903,84122
50,6,73,California,San Diego County,13,15,128764,59629,69135
50,6,73,California,San Diego County,13,16,85060,38134,46926
50,6,73,California,San Diego County,13,17,56412,23957,32455
50,6,73,California,San Diego County,13,18,64699,24305,40394
50,6,73,California,San Diego County,14,0,3332427,1679841,1652586
50,6,73,California,San Diego County,14,1,196730,100454,96276
50,6,73,California,San Diego County,14,2,202172,103925,98247
50,6,73,California,San Diego County,14,3,193047,98613,94434
50,6,73,California,San Diego County,14,4,204370,106541,97829
50,6,73,California,San Diego County,14,5,241436,134245,107191
50,6,73,California,San Diego County,14,6,273798,145406,128392
50,6,73,California,San Diego County,14,7,273291,141922,131369
50,6,73,California,San Diego County,14,8,244551,126725,117826
50,6,73,California,San Diego County,14,9,213068,108281,104787
50,6,73,California,San Diego County,14,10,201243,100502,100741
50,6,73,California,San Diego County,14,11,199250,98827,100423
50,6,73,California,San Diego County,14,12,202794,100084,102710
50,6,73,California,San Diego County,14,13,190284,92297,97987
50,6,73,California,San Diego County,14,14,159824,75247,84577
50,6,73,California,San Diego County,14,15,129825,60111,69714
50,6,73,California,San Diego County,14,16,85790,38476,47314
50,6,73,California,San Diego County,14,17,56573,24027,32546
50,6,73,California,San Diego County,14,18,64381,24158,40223
50,6,75,California,San Francisco County,1,0,805235,408462,396773
50,6,75,California,San Francisco County,1,1,35203,17963,17240
50,6,75,California,San Francisco County,1,2,28462,14466,13996
50,6,75,California,San Francisco County,1,3,26299,13467,12832
50,6,75,California,San Francisco County,1,4,34606,16888,17718
50,6,75,California,San Francisco County,1,5,60618,29269,31349
50,6,75,California,San Francisco County,1,6,88156,44178,43978
50,6,75,California,San Francisco County,1,7,79964,41351,38613
50,6,75,California,San Francisco County,1,8,70813,38264,32549
50,6,75,California,San Francisco County,1,9,62869,34906,27963
50,6,75,California,San Francisco County,1,10,57577,31783,25794
50,6,75,California,San Francisco County,1,11,54230,28957,25273
50,6,75,California,San Francisco County,1,12,51708,26777,24931
50,6,75,California,San Francisco County,1,13,44888,22455,22433
50,6,75,California,San Francisco County,1,14,29780,14318,15462
50,6,75,California,San Francisco County,1,15,24542,11274,13268
50,6,75,California,San Francisco County,1,16,20839,9294,11545
50,6,75,California,San Francisco County,1,17,17190,6878,10312
50,6,75,California,San Francisco County,1,18,17491,5974,11517
50,6,75,California,San Francisco County,2,0,805184,408436,396748
50,6,75,California,San Francisco County,2,1,35198,17958,17240
50,6,75,California,San Francisco County,2,2,28462,14466,13996
50,6,75,California,San Francisco County,2,3,26301,13468,12833
50,6,75,California,San Francisco County,2,4,34603,16888,17715
50,6,75,California,San Francisco County,2,5,60614,29267,31347
50,6,75,California,San Francisco County,2,6,88148,44176,43972
50,6,75,California,San Francisco County,2,7,79959,41347,38612
50,6,75,California,San Francisco County,2,8,70808,38260,32548
50,6,75,California,San Francisco County,2,9,62865,34903,27962
50,6,75,California,San Francisco County,2,10,57579,31783,25796
50,6,75,California,San Francisco County,2,11,54226,28956,25270
50,6,75,California,San Francisco County,2,12,51707,26776,24931
50,6,75,California,San Francisco County,2,13,44887,22456,22431
50,6,75,California,San Francisco County,2,14,29779,14319,15460
50,6,75,California,San Francisco County,2,15,24536,11272,13264
50,6,75,California,San Francisco County,2,16,20833,9291,11542
50,6,75,California,San Francisco County,2,17,17189,6877,10312
50,6,75,California,San Francisco County,2,18,17490,5973,11517
50,6,75,California,San Francisco County,3,0,805519,408607,396912
50,6,75,California,San Francisco County,3,1,35388,18097,17291
50,6,75,California,San Francisco County,3,2,28501,14439,14062
50,6,75,California,San Francisco County,3,3,26307,13469,12838
50,6,75,California,San Francisco County,3,4,33988,16623,17365
50,6,75,California,San Francisco County,3,5,59806,28903,30903
50,6,75,California,San Francisco County,3,6,88156,44118,44038
50,6,75,California,San Francisco County,3,7,80364,41522,38842
50,6,75,California,San Francisco County,3,8,70440,37986,32454
50,6,75,California,San Francisco County,3,9,63195,35031,28164
50,6,75,California,San Francisco County,3,10,57695,31874,25821
50,6,75,California,San Francisco County,3,11,54216,29027,25189
50,6,75,California,San Francisco County,3,12,51721,26757,24964
50,6,75,California,San Francisco County,3,13,45440,22755,22685
50,6,75,California,San Francisco County,3,14,30034,14452,15582
50,6,75,California,San Francisco County,3,15,24628,11322,13306
50,6,75,California,San Francisco County,3,16,20760,9267,11493
50,6,75,California,San Francisco County,3,17,17229,6938,10291
50,6,75,California,San Francisco County,3,18,17651,6027,11624
50,6,75,California,San Francisco County,4,0,815694,413972,401722
50,6,75,California,San Francisco County,4,1,36593,18790,17803
50,6,75,California,San Francisco County,4,2,29024,14634,14390
50,6,75,California,San Francisco County,4,3,26643,13499,13144
50,6,75,California,San Francisco County,4,4,32137,15790,16347
50,6,75,California,San Francisco County,4,5,57507,27892,29615
50,6,75,California,San Francisco County,4,6,91239,45813,45426
50,6,75,California,San Francisco County,4,7,83347,43064,40283
50,6,75,California,San Francisco County,4,8,69502,37182,32320
50,6,75,California,San Francisco County,4,9,64995,35785,29210
50,6,75,California,San Francisco County,4,10,58207,32208,25999
50,6,75,California,San Francisco County,4,11,54167,29232,24935
50,6,75,California,San Francisco County,4,12,52277,26999,25278
50,6,75,California,San Francisco County,4,13,47868,23941,23927
50,6,75,California,San Francisco County,4,14,31149,15063,16086
50,6,75,California,San Francisco County,4,15,24814,11455,13359
50,6,75,California,San Francisco County,4,16,20755,9296,11459
50,6,75,California,San Francisco County,4,17,17317,7095,10222
50,6,75,California,San Francisco County,4,18,18153,6234,11919
50,6,75,California,San Francisco County,5,0,828963,421351,407612
50,6,75,California,San Francisco County,5,1,37625,19323,18302
50,6,75,California,San Francisco County,5,2,29962,15222,14740
50,6,75,California,San Francisco County,5,3,26721,13473,13248
50,6,75,California,San Francisco County,5,4,31315,15311,16004
50,6,75,California,San Francisco County,5,5,55578,27009,28569
50,6,75,California,San Francisco County,5,6,94006,47590,46416
50,6,75,California,San Francisco County,5,7,87099,45108,41991
50,6,75,California,San Francisco County,5,8,70386,37449,32937
50,6,75,California,San Francisco County,5,9,65980,36187,29793
50,6,75,California,San Francisco County,5,10,58569,32517,26052
50,6,75,California,San Francisco County,5,11,54387,29335,25052
50,6,75,California,San Francisco County,5,12,52925,27529,25396
50,6,75,California,San Francisco County,5,13,48420,24234,24186
50,6,75,California,San Francisco County,5,14,34045,16502,17543
50,6,75,California,San Francisco County,5,15,25024,11546,13478
50,6,75,California,San Francisco County,5,16,20905,9376,11529
50,6,75,California,San Francisco County,5,17,17174,7094,10080
50,6,75,California,San Francisco County,5,18,18842,6546,12296
50,6,75,California,San Francisco County,6,0,839695,427517,412178
50,6,75,California,San Francisco County,6,1,38553,19796,18757
50,6,75,California,San Francisco County,6,2,30559,15519,15040
50,6,75,California,San Francisco County,6,3,27203,13758,13445
50,6,75,California,San Francisco County,6,4,30744,15023,15721
50,6,75,California,San Francisco County,6,5,53190,25862,27328
50,6,75,California,San Francisco County,6,6,96735,49183,47552
50,6,75,California,San Francisco County,6,7,90795,47352,43443
50,6,75,California,San Francisco County,6,8,70611,37502,33109
50,6,75,California,San Francisco County,6,9,65883,35891,29992
50,6,75,California,San Francisco County,6,10,58639,32498,26141
50,6,75,California,San Francisco County,6,11,54957,29772,25185
50,6,75,California,San Francisco County,6,12,53230,27789,25441
50,6,75,California,San Francisco County,6,13,48874,24492,24382
50,6,75,California,San Francisco County,6,14,36561,17767,18794
50,6,75,California,San Francisco County,6,15,25437,11835,13602
50,6,75,California,San Francisco County,6,16,21121,9427,11694
50,6,75,California,San Francisco County,6,17,17060,7174,9886
50,6,75,California,San Francisco County,6,18,19543,6877,12666
50,6,75,California,San Francisco County,7,0,850918,433889,417029
50,6,75,California,San Francisco County,7,1,39146,20145,19001
50,6,75,California,San Francisco County,7,2,30958,15761,15197
50,6,75,California,San Francisco County,7,3,27843,14188,13655
50,6,75,California,San Francisco County,7,4,30453,14828,15625
50,6,75,California,San Francisco County,7,5,51572,25176,26396
50,6,75,California,San Francisco County,7,6,99669,51010,48659
50,6,75,California,San Francisco County,7,7,94442,49415,45027
50,6,75,California,San Francisco County,7,8,71141,37668,33473
50,6,75,California,San Francisco County,7,9,65113,35322,29791
50,6,75,California,San Francisco County,7,10,58988,32513,26475
50,6,75,California,San Francisco County,7,11,55660,30259,25401
50,6,75,California,San Francisco County,7,12,52980,27713,25267
50,6,75,California,San Francisco County,7,13,49266,24766,24500
50,6,75,California,San Francisco County,7,14,39091,19038,20053
50,6,75,California,San Francisco County,7,15,26006,12126,13880
50,6,75,California,San Francisco County,7,16,21284,9495,11789
50,6,75,California,San Francisco County,7,17,17093,7275,9818
50,6,75,California,San Francisco County,7,18,20213,7191,13022
50,6,75,California,San Francisco County,8,0,863237,440483,422754
50,6,75,California,San Francisco County,8,1,40231,20766,19465
50,6,75,California,San Francisco County,8,2,31053,15834,15219
50,6,75,California,San Francisco County,8,3,28217,14238,13979
50,6,75,California,San Francisco County,8,4,30090,14726,15364
50,6,75,California,San Francisco County,8,5,50553,24847,25706
50,6,75,California,San Francisco County,8,6,102644,52827,49817
50,6,75,California,San Francisco County,8,7,97927,51187,46740
50,6,75,California,San Francisco County,8,8,72635,38326,34309
50,6,75,California,San Francisco County,8,9,63673,34290,29383
50,6,75,California,San Francisco County,8,10,60215,33065,27150
50,6,75,California,San Francisco County,8,11,55987,30547,25440
50,6,75,California,San Francisco County,8,12,52889,27801,25088
50,6,75,California,San Francisco County,8,13,49080,24715,24365
50,6,75,California,San Francisco County,8,14,41771,20337,21434
50,6,75,California,San Francisco County,8,15,26847,12581,14266
50,6,75,California,San Francisco County,8,16,21526,9603,11923
50,6,75,California,San Francisco County,8,17,17007,7247,9760
50,6,75,California,San Francisco County,8,18,20892,7546,13346
50,6,75,California,San Francisco County,9,0,871343,444435,426908
50,6,75,California,San Francisco County,9,1,40107,20527,19580
50,6,75,California,San Francisco County,9,2,31702,16246,15456
50,6,75,California,San Francisco County,9,3,28523,14363,14160
50,6,75,California,San Francisco County,9,4,30101,14643,15458
50,6,75,California,San Francisco County,9,5,49113,24310,24803
50,6,75,California,San Francisco County,9,6,104892,53948,50944
50,6,75,California,San Francisco County,9,7,100882,52701,48181
50,6,75,California,San Francisco County,9,8,74093,39235,34858
50,6,75,California,San Francisco County,9,9,61950,33080,28870
50,6,75,California,San Francisco County,9,10,60782,33072,27710
50,6,75,California,San Francisco County,9,11,55950,30613,25337
50,6,75,California,San Francisco County,9,12,52480,27764,24716
50,6,75,California,San Francisco County,9,13,49294,24872,24422
50,6,75,California,San Francisco County,9,14,43536,21188,22348
50,6,75,California,San Francisco County,9,15,27738,13046,14692
50,6,75,California,San Francisco County,9,16,21765,9756,12009
50,6,75,California,San Francisco County,9,17,16996,7279,9717
50,6,75,California,San Francisco County,9,18,21439,7792,13647
50,6,75,California,San Francisco County,10,0,877471,447894,429577
50,6,75,California,San Francisco County,10,1,40176,20588,19588
50,6,75,California,San Francisco County,10,2,31933,16446,15487
50,6,75,California,San Francisco County,10,3,29102,14726,14376
50,6,75,California,San Francisco County,10,4,30219,14677,15542
50,6,75,California,San Francisco County,10,5,47981,23640,24341
50,6,75,California,San Francisco County,10,6,105135,54269,50866
50,6,75,California,San Francisco County,10,7,102958,53999,48959
50,6,75,California,San Francisco County,10,8,76189,40470,35719
50,6,75,California,San Francisco County,10,9,61033,32327,28706
50,6,75,California,San Francisco County,10,10,60739,32982,27757
50,6,75,California,San Francisco County,10,11,55553,30364,25189
50,6,75,California,San Francisco County,10,12,52082,27513,24569
50,6,75,California,San Francisco County,10,13,49386,25016,24370
50,6,75,California,San Francisco County,10,14,43879,21357,22522
50,6,75,California,San Francisco County,10,15,30260,14333,15927
50,6,75,California,San Francisco County,10,16,21743,9736,12007
50,6,75,California,San Francisco County,10,17,17308,7420,9888
50,6,75,California,San Francisco County,10,18,21795,8031,13764
50,6,75,California,San Francisco County,11,0,879676,448829,430847
50,6,75,California,San Francisco County,11,1,39606,20246,19360
50,6,75,California,San Francisco County,11,2,32213,16538,15675
50,6,75,California,San Francisco County,11,3,29233,14849,14384
50,6,75,California,San Francisco County,11,4,30584,14833,15751
50,6,75,California,San Francisco County,11,5,46913,23056,23857
50,6,75,California,San Francisco County,11,6,103141,53275,49866
50,6,75,California,San Francisco County,11,7,104879,55037,49842
50,6,75,California,San Francisco County,11,8,78272,41683,36589
50,6,75,California,San Francisco County,11,9,60347,31913,28434
50,6,75,California,San Francisco County,11,10,59709,32197,27512
50,6,75,California,San Francisco County,11,11,55035,30013,25022
50,6,75,California,San Francisco County,11,12,52203,27599,24604
50,6,75,California,San Francisco County,11,13,49378,25161,24217
50,6,75,California,San Francisco County,11,14,44046,21432,22614
50,6,75,California,San Francisco County,11,15,32476,15363,17113
50,6,75,California,San Francisco County,11,16,22083,9970,12113
50,6,75,California,San Francisco County,11,17,17435,7406,10029
50,6,75,California,San Francisco County,11,18,22123,8258,13865
50,6,75,California,San Francisco County,12,0,878826,448152,430674
50,6,75,California,San Francisco County,12,1,39057,19970,19087
50,6,75,California,San Francisco County,12,2,32161,16418,15743
50,6,75,California,San Francisco County,12,3,29306,14959,14347
50,6,75,California,San Francisco County,12,4,30751,14920,15831
50,6,75,California,San Francisco County,12,5,45842,22446,23396
50,6,75,California,San Francisco County,12,6,100422,51818,48604
50,6,75,California,San Francisco County,12,7,106170,55902,50268
50,6,75,California,San Francisco County,12,8,79694,42534,37160
50,6,75,California,San Francisco County,12,9,59828,31467,28361
50,6,75,California,San Francisco County,12,10,58087,31072,27015
50,6,75,California,San Francisco County,12,11,54812,29744,25068
50,6,75,California,San Francisco County,12,12,52282,27878,24404
50,6,75,California,San Francisco County,12,13,48795,24833,23962
50,6,75,California,San Francisco County,12,14,44133,21557,22576
50,6,75,California,San Francisco County,12,15,34759,16472,18287
50,6,75,California,San Francisco County,12,16,22588,10212,12376
50,6,75,California,San Francisco County,12,17,17543,7427,10116
50,6,75,California,San Francisco County,12,18,22596,8523,14073
50,6,75,California,San Francisco County,13,0,870561,443688,426873
50,6,75,California,San Francisco County,13,1,38196,19482,18714
50,6,75,California,San Francisco County,13,2,32387,16552,15835
50,6,75,California,San Francisco County,13,3,29100,14894,14206
50,6,75,California,San Francisco County,13,4,31457,15161,16296
50,6,75,California,San Francisco County,13,5,44841,21957,22884
50,6,75,California,San Francisco County,13,6,95857,49491,46366
50,6,75,California,San Francisco County,13,7,104808,55419,49389
50,6,75,California,San Francisco County,13,8,79449,42270,37179
50,6,75,California,San Francisco County,13,9,59537,31291,28246
50,6,75,California,San Francisco County,13,10,56318,29989,26329
50,6,75,California,San Francisco County,13,11,54682,29566,25116
50,6,75,California,San Francisco County,13,12,51879,27719,24160
50,6,75,California,San Francisco County,13,13,48238,24637,23601
50,6,75,California,San Francisco County,13,14,43778,21384,22394
50,6,75,California,San Francisco County,13,15,36475,17288,19187
50,6,75,California,San Francisco County,13,16,23165,10468,12697
50,6,75,California,San Francisco County,13,17,17634,7459,10175
50,6,75,California,San Francisco County,13,18,22760,8661,14099
50,6,75,California,San Francisco County,14,0,866606,441638,424968
50,6,75,California,San Francisco County,14,1,37865,19292,18573
50,6,75,California,San Francisco County,14,2,32379,16553,15826
50,6,75,California,San Francisco County,14,3,29030,14868,14162
50,6,75,California,San Francisco County,14,4,31584,15193,16391
50,6,75,California,San Francisco County,14,5,44364,21726,22638
50,6,75,California,San Francisco County,14,6,94083,48597,45486
50,6,75,California,San Francisco County,14,7,104260,55211,49049
50,6,75,California,San Francisco County,14,8,79376,42206,37170
50,6,75,California,San Francisco County,14,9,59395,31210,28185
50,6,75,California,San Francisco County,14,10,55715,29622,26093
50,6,75,California,San Francisco County,14,11,54694,29537,25157
50,6,75,California,San Francisco County,14,12,51692,27647,24045
50,6,75,California,San Francisco County,14,13,48017,24544,23473
50,6,75,California,San Francisco County,14,14,43643,21322,22321
50,6,75,California,San Francisco County,14,15,36922,17490,19432
50,6,75,California,San Francisco County,14,16,23315,10530,12785
50,6,75,California,San Francisco County,14,17,17617,7449,10168
50,6,75,California,San Francisco County,14,18,22655,8641,14014
50,6,77,California,San Joaquin County,1,0,685306,341230,344076
50,6,77,California,San Joaquin County,1,1,54228,27820,26408
50,6,77,California,San Joaquin County,1,2,54810,27980,26830
50,6,77,California,San Joaquin County,1,3,56165,28769,27396
50,6,77,California,San Joaquin County,1,4,58382,30397,27985
50,6,77,California,San Joaquin County,1,5,48451,25280,23171
50,6,77,California,San Joaquin County,1,6,46230,23660,22570
50,6,77,California,San Joaquin County,1,7,44585,22160,22425
50,6,77,California,San Joaquin County,1,8,44909,22159,22750
50,6,77,California,San Joaquin County,1,9,45829,23110,22719
50,6,77,California,San Joaquin County,1,10,47474,23753,23721
50,6,77,California,San Joaquin County,1,11,44365,22143,22222
50,6,77,California,San Joaquin County,1,12,37649,18270,19379
50,6,77,California,San Joaquin County,1,13,31048,15023,16025
50,6,77,California,San Joaquin County,1,14,22389,10432,11957
50,6,77,California,San Joaquin County,1,15,16141,7361,8780
50,6,77,California,San Joaquin County,1,16,12575,5435,7140
50,6,77,California,San Joaquin County,1,17,10134,4051,6083
50,6,77,California,San Joaquin County,1,18,9942,3427,6515
50,6,77,California,San Joaquin County,2,0,685298,341229,344069
50,6,77,California,San Joaquin County,2,1,54228,27820,26408
50,6,77,California,San Joaquin County,2,2,54810,27980,26830
50,6,77,California,San Joaquin County,2,3,56163,28768,27395
50,6,77,California,San Joaquin County,2,4,58381,30397,27984
50,6,77,California,San Joaquin County,2,5,48451,25280,23171
50,6,77,California,San Joaquin County,2,6,46230,23660,22570
50,6,77,California,San Joaquin County,2,7,44585,22160,22425
50,6,77,California,San Joaquin County,2,8,44909,22159,22750
50,6,77,California,San Joaquin County,2,9,45827,23110,22717
50,6,77,California,San Joaquin County,2,10,47474,23753,23721
50,6,77,California,San Joaquin County,2,11,44364,22142,22222
50,6,77,California,San Joaquin County,2,12,37651,18272,19379
50,6,77,California,San Joaquin County,2,13,31048,15023,16025
50,6,77,California,San Joaquin County,2,14,22386,10431,11955
50,6,77,California,San Joaquin County,2,15,16141,7361,8780
50,6,77,California,San Joaquin County,2,16,12575,5435,7140
50,6,77,California,San Joaquin County,2,17,10134,4051,6083
50,6,77,California,San Joaquin County,2,18,9941,3427,6514
50,6,77,California,San Joaquin County,3,0,687115,342065,345050
50,6,77,California,San Joaquin County,3,1,54171,27758,26413
50,6,77,California,San Joaquin County,3,2,54842,27994,26848
50,6,77,California,San Joaquin County,3,3,56153,28775,27378
50,6,77,California,San Joaquin County,3,4,58003,30200,27803
50,6,77,California,San Joaquin County,3,5,49040,25559,23481
50,6,77,California,San Joaquin County,3,6,46307,23692,22615
50,6,77,California,San Joaquin County,3,7,44808,22284,22524
50,6,77,California,San Joaquin County,3,8,44837,22118,22719
50,6,77,California,San Joaquin County,3,9,45911,23101,22810
50,6,77,California,San Joaquin County,3,10,47386,23719,23667
50,6,77,California,San Joaquin County,3,11,44647,22291,22356
50,6,77,California,San Joaquin County,3,12,37957,18438,19519
50,6,77,California,San Joaquin County,3,13,31429,15169,16260
50,6,77,California,San Joaquin County,3,14,22583,10557,12026
50,6,77,California,San Joaquin County,3,15,16285,7426,8859
50,6,77,California,San Joaquin County,3,16,12590,5451,7139
50,6,77,California,San Joaquin County,3,17,10133,4059,6074
50,6,77,California,San Joaquin County,3,18,10033,3474,6559
50,6,77,California,San Joaquin County,4,0,694265,345432,348833
50,6,77,California,San Joaquin County,4,1,53816,27469,26347
50,6,77,California,San Joaquin County,4,2,55135,28182,26953
50,6,77,California,San Joaquin County,4,3,56138,28815,27323
50,6,77,California,San Joaquin County,4,4,56714,29448,27266
50,6,77,California,San Joaquin County,4,5,51044,26500,24544
50,6,77,California,San Joaquin County,4,6,46791,24076,22715
50,6,77,California,San Joaquin County,4,7,45629,22685,22944
50,6,77,California,San Joaquin County,4,8,44323,21898,22425
50,6,77,California,San Joaquin County,4,9,46263,23035,23228
50,6,77,California,San Joaquin County,4,10,46876,23577,23299
50,6,77,California,San Joaquin County,4,11,45466,22693,22773
50,6,77,California,San Joaquin County,4,12,39116,19111,20005
50,6,77,California,San Joaquin County,4,13,33103,15811,17292
50,6,77,California,San Joaquin County,4,14,23504,11097,12407
50,6,77,California,San Joaquin County,4,15,16937,7710,9227
50,6,77,California,San Joaquin County,4,16,12840,5582,7258
50,6,77,California,San Joaquin County,4,17,10094,4069,6025
50,6,77,California,San Joaquin County,4,18,10476,3674,6802
50,6,77,California,San Joaquin County,5,0,699444,347751,351693
50,6,77,California,San Joaquin County,5,1,53164,27262,25902
50,6,77,California,San Joaquin County,5,2,55757,28440,27317
50,6,77,California,San Joaquin County,5,3,55894,28770,27124
50,6,77,California,San Joaquin County,5,4,55732,28903,26829
50,6,77,California,San Joaquin County,5,5,52233,26965,25268
50,6,77,California,San Joaquin County,5,6,46953,24020,22933
50,6,77,California,San Joaquin County,5,7,46599,23187,23412
50,6,77,California,San Joaquin County,5,8,43995,21774,22221
50,6,77,California,San Joaquin County,5,9,46201,22902,23299
50,6,77,California,San Joaquin County,5,10,46160,23321,22839
50,6,77,California,San Joaquin County,5,11,45836,22668,23168
50,6,77,California,San Joaquin County,5,12,40335,19853,20482
50,6,77,California,San Joaquin County,5,13,33365,15898,17467
50,6,77,California,San Joaquin County,5,14,25672,12127,13545
50,6,77,California,San Joaquin County,5,15,17769,8097,9672
50,6,77,California,San Joaquin County,5,16,13085,5732,7353
50,6,77,California,San Joaquin County,5,17,9917,4036,5881
50,6,77,California,San Joaquin County,5,18,10777,3796,6981
50,6,77,California,San Joaquin County,6,0,701831,348465,353366
50,6,77,California,San Joaquin County,6,1,52464,27051,25413
50,6,77,California,San Joaquin County,6,2,56035,28563,27472
50,6,77,California,San Joaquin County,6,3,55437,28439,26998
50,6,77,California,San Joaquin County,6,4,54893,28317,26576
50,6,77,California,San Joaquin County,6,5,52226,26831,25395
50,6,77,California,San Joaquin County,6,6,46982,23943,23039
50,6,77,California,San Joaquin County,6,7,46934,23468,23466
50,6,77,California,San Joaquin County,6,8,44108,21743,22365
50,6,77,California,San Joaquin County,6,9,45833,22545,23288
50,6,77,California,San Joaquin County,6,10,45359,22941,22418
50,6,77,California,San Joaquin County,6,11,46008,22783,23225
50,6,77,California,San Joaquin County,6,12,41284,20358,20926
50,6,77,California,San Joaquin County,6,13,34022,16252,17770
50,6,77,California,San Joaquin County,6,14,26986,12755,14231
50,6,77,California,San Joaquin County,6,15,18842,8585,10257
50,6,77,California,San Joaquin County,6,16,13420,5912,7508
50,6,77,California,San Joaquin County,6,17,9991,4111,5880
50,6,77,California,San Joaquin County,6,18,11007,3868,7139
50,6,77,California,San Joaquin County,7,0,711296,353671,357625
50,6,77,California,San Joaquin County,7,1,52542,26997,25545
50,6,77,California,San Joaquin County,7,2,56358,28877,27481
50,6,77,California,San Joaquin County,7,3,55885,28521,27364
50,6,77,California,San Joaquin County,7,4,54429,28068,26361
50,6,77,California,San Joaquin County,7,5,52678,27122,25556
50,6,77,California,San Joaquin County,7,6,48289,24732,23557
50,6,77,California,San Joaquin County,7,7,48133,24267,23866
50,6,77,California,San Joaquin County,7,8,45346,22531,22815
50,6,77,California,San Joaquin County,7,9,45494,22419,23075
50,6,77,California,San Joaquin County,7,10,45324,22859,22465
50,6,77,California,San Joaquin County,7,11,46333,23058,23275
50,6,77,California,San Joaquin County,7,12,42115,20840,21275
50,6,77,California,San Joaquin County,7,13,35110,16853,18257
50,6,77,California,San Joaquin County,7,14,28347,13332,15015
50,6,77,California,San Joaquin County,7,15,19922,9030,10892
50,6,77,California,San Joaquin County,7,16,13807,6105,7702
50,6,77,California,San Joaquin County,7,17,10014,4131,5883
50,6,77,California,San Joaquin County,7,18,11170,3929,7241
50,6,77,California,San Joaquin County,8,0,721919,359477,362442
50,6,77,California,San Joaquin County,8,1,52489,27041,25448
50,6,77,California,San Joaquin County,8,2,56919,29221,27698
50,6,77,California,San Joaquin County,8,3,56449,28782,27667
50,6,77,California,San Joaquin County,8,4,54697,28265,26432
50,6,77,California,San Joaquin County,8,5,52183,26912,25271
50,6,77,California,San Joaquin County,8,6,50314,25901,24413
50,6,77,California,San Joaquin County,8,7,48841,24724,24117
50,6,77,California,San Joaquin County,8,8,46748,23189,23559
50,6,77,California,San Joaquin County,8,9,45461,22509,22952
50,6,77,California,San Joaquin County,8,10,45598,22959,22639
50,6,77,California,San Joaquin County,8,11,46246,23106,23140
50,6,77,California,San Joaquin County,8,12,43158,21398,21760
50,6,77,California,San Joaquin County,8,13,36248,17406,18842
50,6,77,California,San Joaquin County,8,14,29903,14048,15855
50,6,77,California,San Joaquin County,8,15,20808,9475,11333
50,6,77,California,San Joaquin County,8,16,14255,6304,7951
50,6,77,California,San Joaquin County,8,17,10179,4217,5962
50,6,77,California,San Joaquin County,8,18,11423,4020,7403
50,6,77,California,San Joaquin County,9,0,732662,365208,367454
50,6,77,California,San Joaquin County,9,1,52521,27120,25401
50,6,77,California,San Joaquin County,9,2,57319,29338,27981
50,6,77,California,San Joaquin County,9,3,57165,29223,27942
50,6,77,California,San Joaquin County,9,4,55105,28508,26597
50,6,77,California,San Joaquin County,9,5,51761,26659,25102
50,6,77,California,San Joaquin County,9,6,52342,27118,25224
50,6,77,California,San Joaquin County,9,7,49521,25090,24431
50,6,77,California,San Joaquin County,9,8,48364,24105,24259
50,6,77,California,San Joaquin County,9,9,45208,22503,22705
50,6,77,California,San Joaquin County,9,10,46238,23167,23071
50,6,77,California,San Joaquin County,9,11,45972,23099,22873
50,6,77,California,San Joaquin County,9,12,43925,21722,22203
50,6,77,California,San Joaquin County,9,13,37443,18013,19430
50,6,77,California,San Joaquin County,9,14,31221,14603,16618
50,6,77,California,San Joaquin County,9,15,21677,9964,11713
50,6,77,California,San Joaquin County,9,16,14988,6592,8396
50,6,77,California,San Joaquin County,9,17,10277,4259,6018
50,6,77,California,San Joaquin County,9,18,11615,4125,7490
50,6,77,California,San Joaquin County,10,0,743286,370409,372877
50,6,77,California,San Joaquin County,10,1,52949,27280,25669
50,6,77,California,San Joaquin County,10,2,57328,29353,27975
50,6,77,California,San Joaquin County,10,3,58473,29836,28637
50,6,77,California,San Joaquin County,10,4,55344,28693,26651
50,6,77,California,San Joaquin County,10,5,51150,26337,24813
50,6,77,California,San Joaquin County,10,6,54136,27937,26199
50,6,77,California,San Joaquin County,10,7,50081,25321,24760
50,6,77,California,San Joaquin County,10,8,50126,25170,24956
50,6,77,California,San Joaquin County,10,9,45624,22668,22956
50,6,77,California,San Joaquin County,10,10,46629,23378,23251
50,6,77,California,San Joaquin County,10,11,45447,22939,22508
50,6,77,California,San Joaquin County,10,12,44487,21782,22705
50,6,77,California,San Joaquin County,10,13,38757,18808,19949
50,6,77,California,San Joaquin County,10,14,31199,14527,16672
50,6,77,California,San Joaquin County,10,15,23639,10895,12744
50,6,77,California,San Joaquin County,10,16,15782,6985,8797
50,6,77,California,San Joaquin County,10,17,10480,4366,6114
50,6,77,California,San Joaquin County,10,18,11655,4134,7521
50,6,77,California,San Joaquin County,11,0,752590,374880,377710
50,6,77,California,San Joaquin County,11,1,52908,27134,25774
50,6,77,California,San Joaquin County,11,2,57300,29439,27861
50,6,77,California,San Joaquin County,11,3,59323,30359,28964
50,6,77,California,San Joaquin County,11,4,55619,28731,26888
50,6,77,California,San Joaquin County,11,5,51227,26273,24954
50,6,77,California,San Joaquin County,11,6,55152,28429,26723
50,6,77,California,San Joaquin County,11,7,50850,25757,25093
50,6,77,California,San Joaquin County,11,8,51416,25984,25432
50,6,77,California,San Joaquin County,11,9,46423,23130,23293
50,6,77,California,San Joaquin County,11,10,46843,23267,23576
50,6,77,California,San Joaquin County,11,11,45180,22863,22317
50,6,77,California,San Joaquin County,11,12,44763,21948,22815
50,6,77,California,San Joaquin County,11,13,39653,19280,20373
50,6,77,California,San Joaquin County,11,14,31898,14838,17060
50,6,77,California,San Joaquin County,11,15,24709,11348,13361
50,6,77,California,San Joaquin County,11,16,16714,7370,9344
50,6,77,California,San Joaquin County,11,17,10770,4520,6250
50,6,77,California,San Joaquin County,11,18,11842,4210,7632
50,6,77,California,San Joaquin County,12,0,761571,379588,381983
50,6,77,California,San Joaquin County,12,1,52621,27089,25532
50,6,77,California,San Joaquin County,12,2,57662,29530,28132
50,6,77,California,San Joaquin County,12,3,59574,30650,28924
50,6,77,California,San Joaquin County,12,4,56101,28848,27253
50,6,77,California,San Joaquin County,12,5,51416,26434,24982
50,6,77,California,San Joaquin County,12,6,55458,28569,26889
50,6,77,California,San Joaquin County,12,7,52058,26515,25543
50,6,77,California,San Joaquin County,12,8,52484,26542,25942
50,6,77,California,San Joaquin County,12,9,48021,24098,23923
50,6,77,California,San Joaquin County,12,10,46467,23143,23324
50,6,77,California,San Joaquin County,12,11,45027,22626,22401
50,6,77,California,San Joaquin County,12,12,45177,22197,22980
50,6,77,California,San Joaquin County,12,13,40285,19651,20634
50,6,77,California,San Joaquin County,12,14,32823,15259,17564
50,6,77,California,San Joaquin County,12,15,25792,11814,13978
50,6,77,California,San Joaquin County,12,16,17499,7695,9804
50,6,77,California,San Joaquin County,12,17,11089,4679,6410
50,6,77,California,San Joaquin County,12,18,12017,4249,7768
50,6,77,California,San Joaquin County,13,0,767048,382512,384536
50,6,77,California,San Joaquin County,13,1,52329,26769,25560
50,6,77,California,San Joaquin County,13,2,57630,29654,27976
50,6,77,California,San Joaquin County,13,3,59775,30710,29065
50,6,77,California,San Joaquin County,13,4,56416,29003,27413
50,6,77,California,San Joaquin County,13,5,51458,26490,24968
50,6,77,California,San Joaquin County,13,6,55210,28437,26773
50,6,77,California,San Joaquin County,13,7,53104,27155,25949
50,6,77,California,San Joaquin County,13,8,52879,26782,26097
50,6,77,California,San Joaquin County,13,9,49179,24642,24537
50,6,77,California,San Joaquin County,13,10,46269,23092,23177
50,6,77,California,San Joaquin County,13,11,45228,22740,22488
50,6,77,California,San Joaquin County,13,12,44975,22204,22771
50,6,77,California,San Joaquin County,13,13,40813,19918,20895
50,6,77,California,San Joaquin County,13,14,33451,15601,17850
50,6,77,California,San Joaquin County,13,15,26707,12208,14499
50,6,77,California,San Joaquin County,13,16,17986,7951,10035
50,6,77,California,San Joaquin County,13,17,11405,4815,6590
50,6,77,California,San Joaquin County,13,18,12234,4341,7893
50,6,77,California,San Joaquin County,14,0,767967,383049,384918
50,6,77,California,San Joaquin County,14,1,52204,26648,25556
50,6,77,California,San Joaquin County,14,2,57514,29638,27876
50,6,77,California,San Joaquin County,14,3,59792,30707,29085
50,6,77,California,San Joaquin County,14,4,56415,29000,27415
50,6,77,California,San Joaquin County,14,5,51369,26454,24915
50,6,77,California,San Joaquin County,14,6,55007,28343,26664
50,6,77,California,San Joaquin County,14,7,53421,27351,26070
50,6,77,California,San Joaquin County,14,8,53022,26876,26146
50,6,77,California,San Joaquin County,14,9,49535,24808,24727
50,6,77,California,San Joaquin County,14,10,46202,23076,23126
50,6,77,California,San Joaquin County,14,11,45334,22792,22542
50,6,77,California,San Joaquin County,14,12,44858,22187,22671
50,6,77,California,San Joaquin County,14,13,40932,19967,20965
50,6,77,California,San Joaquin County,14,14,33634,15707,17927
50,6,77,California,San Joaquin County,14,15,26929,12299,14630
50,6,77,California,San Joaquin County,14,16,18095,8010,10085
50,6,77,California,San Joaquin County,14,17,11486,4850,6636
50,6,77,California,San Joaquin County,14,18,12218,4336,7882
50,6,79,California,San Luis Obispo County,1,0,269637,137999,131638
50,6,79,California,San Luis Obispo County,1,1,13343,6829,6514
50,6,79,California,San Luis Obispo County,1,2,13773,6945,6828
50,6,79,California,San Luis Obispo County,1,3,14201,7259,6942
50,6,79,California,San Luis Obispo County,1,4,21727,11465,10262
50,6,79,California,San Luis Obispo County,1,5,27342,15455,11887
50,6,79,California,San Luis Obispo County,1,6,17368,9510,7858
50,6,79,California,San Luis Obispo County,1,7,14740,8029,6711
50,6,79,California,San Luis Obispo County,1,8,14140,7568,6572
50,6,79,California,San Luis Obispo County,1,9,15612,8398,7214
50,6,79,California,San Luis Obispo County,1,10,18583,9571,9012
50,6,79,California,San Luis Obispo County,1,11,20670,10169,10501
50,6,79,California,San Luis Obispo County,1,12,20045,9885,10160
50,6,79,California,San Luis Obispo County,1,13,17071,8543,8528
50,6,79,California,San Luis Obispo County,1,14,12364,5923,6441
50,6,79,California,San Luis Obispo County,1,15,8823,4131,4692
50,6,79,California,San Luis Obispo County,1,16,7334,3346,3988
50,6,79,California,San Luis Obispo County,1,17,6197,2647,3550
50,6,79,California,San Luis Obispo County,1,18,6304,2326,3978
50,6,79,California,San Luis Obispo County,2,0,269599,137980,131619
50,6,79,California,San Luis Obispo County,2,1,13341,6827,6514
50,6,79,California,San Luis Obispo County,2,2,13768,6943,6825
50,6,79,California,San Luis Obispo County,2,3,14198,7258,6940
50,6,79,California,San Luis Obispo County,2,4,21721,11463,10258
50,6,79,California,San Luis Obispo County,2,5,27337,15450,11887
50,6,79,California,San Luis Obispo County,2,6,17366,9509,7857
50,6,79,California,San Luis Obispo County,2,7,14741,8030,6711
50,6,79,California,San Luis Obispo County,2,8,14137,7567,6570
50,6,79,California,San Luis Obispo County,2,9,15612,8398,7214
50,6,79,California,San Luis Obispo County,2,10,18575,9567,9008
50,6,79,California,San Luis Obispo County,2,11,20669,10169,10500
50,6,79,California,San Luis Obispo County,2,12,20045,9886,10159
50,6,79,California,San Luis Obispo County,2,13,17072,8543,8529
50,6,79,California,San Luis Obispo County,2,14,12360,5921,6439
50,6,79,California,San Luis Obispo County,2,15,8824,4131,4693
50,6,79,California,San Luis Obispo County,2,16,7333,3346,3987
50,6,79,California,San Luis Obispo County,2,17,6195,2645,3550
50,6,79,California,San Luis Obispo County,2,18,6305,2327,3978
50,6,79,California,San Luis Obispo County,3,0,269800,137917,131883
50,6,79,California,San Luis Obispo County,3,1,13391,6837,6554
50,6,79,California,San Luis Obispo County,3,2,13766,6961,6805
50,6,79,California,San Luis Obispo County,3,3,14179,7241,6938
50,6,79,California,San Luis Obispo County,3,4,21937,11508,10429
50,6,79,California,San Luis Obispo County,3,5,27729,15623,12106
50,6,79,California,San Luis Obispo County,3,6,17149,9387,7762
50,6,79,California,San Luis Obispo County,3,7,14813,8058,6755
50,6,79,California,San Luis Obispo County,3,8,14017,7505,6512
50,6,79,California,San Luis Obispo County,3,9,15528,8337,7191
50,6,79,California,San Luis Obispo County,3,10,18299,9435,8864
50,6,79,California,San Luis Obispo County,3,11,20463,10058,10405
50,6,79,California,San Luis Obispo County,3,12,20048,9855,10193
50,6,79,California,San Luis Obispo County,3,13,17223,8614,8609
50,6,79,California,San Luis Obispo County,3,14,12476,5981,6495
50,6,79,California,San Luis Obispo County,3,15,8923,4192,4731
50,6,79,California,San Luis Obispo County,3,16,7309,3336,3973
50,6,79,California,San Luis Obispo County,3,17,6194,2641,3553
50,6,79,California,San Luis Obispo County,3,18,6356,2348,4008
50,6,79,California,San Luis Obispo County,4,0,271056,138467,132589
50,6,79,California,San Luis Obispo County,4,1,13455,6920,6535
50,6,79,California,San Luis Obispo County,4,2,13821,7021,6800
50,6,79,California,San Luis Obispo County,4,3,14098,7188,6910
50,6,79,California,San Luis Obispo County,4,4,22060,11477,10583
50,6,79,California,San Luis Obispo County,4,5,28494,16057,12437
50,6,79,California,San Luis Obispo County,4,6,16383,8926,7457
50,6,79,California,San Luis Obispo County,4,7,15283,8225,7058
50,6,79,California,San Luis Obispo County,4,8,13790,7425,6365
50,6,79,California,San Luis Obispo County,4,9,15507,8300,7207
50,6,79,California,San Luis Obispo County,4,10,17315,8989,8326
50,6,79,California,San Luis Obispo County,4,11,20009,9877,10132
50,6,79,California,San Luis Obispo County,4,12,20273,9855,10418
50,6,79,California,San Luis Obispo County,4,13,18271,9117,9154
50,6,79,California,San Luis Obispo County,4,14,12983,6260,6723
50,6,79,California,San Luis Obispo County,4,15,9321,4421,4900
50,6,79,California,San Luis Obispo County,4,16,7373,3364,4009
50,6,79,California,San Luis Obispo County,4,17,6117,2621,3496
50,6,79,California,San Luis Obispo County,4,18,6503,2424,4079
50,6,79,California,San Luis Obispo County,5,0,274174,140061,134113
50,6,79,California,San Luis Obispo County,5,1,13415,6871,6544
50,6,79,California,San Luis Obispo County,5,2,14119,7196,6923
50,6,79,California,San Luis Obispo County,5,3,14013,7110,6903
50,6,79,California,San Luis Obispo County,5,4,22209,11488,10721
50,6,79,California,San Luis Obispo County,5,5,29996,16994,13002
50,6,79,California,San Luis Obispo County,5,6,15732,8514,7218
50,6,79,California,San Luis Obispo County,5,7,15848,8545,7303
50,6,79,California,San Luis Obispo County,5,8,14020,7563,6457
50,6,79,California,San Luis Obispo County,5,9,15374,8234,7140
50,6,79,California,San Luis Obispo County,5,10,16629,8708,7921
50,6,79,California,San Luis Obispo County,5,11,19556,9744,9812
50,6,79,California,San Luis Obispo County,5,12,20338,9759,10579
50,6,79,California,San Luis Obispo County,5,13,18517,9164,9353
50,6,79,California,San Luis Obispo County,5,14,14327,6976,7351
50,6,79,California,San Luis Obispo County,5,15,9858,4683,5175
50,6,79,California,San Luis Obispo County,5,16,7494,3388,4106
50,6,79,California,San Luis Obispo County,5,17,6058,2631,3427
50,6,79,California,San Luis Obispo County,5,18,6671,2493,4178
50,6,79,California,San Luis Obispo County,6,0,275713,140445,135268
50,6,79,California,San Luis Obispo County,6,1,13499,6954,6545
50,6,79,California,San Luis Obispo County,6,2,14203,7195,7008
50,6,79,California,San Luis Obispo County,6,3,13957,7071,6886
50,6,79,California,San Luis Obispo County,6,4,21813,11247,10566
50,6,79,California,San Luis Obispo County,6,5,30423,17138,13285
50,6,79,California,San Luis Obispo County,6,6,15439,8378,7061
50,6,79,California,San Luis Obispo County,6,7,16324,8683,7641
50,6,79,California,San Luis Obispo County,6,8,14296,7723,6573
50,6,79,California,San Luis Obispo County,6,9,15133,8055,7078
50,6,79,California,San Luis Obispo County,6,10,15959,8359,7600
50,6,79,California,San Luis Obispo County,6,11,18997,9497,9500
50,6,79,California,San Luis Obispo County,6,12,20245,9653,10592
50,6,79,California,San Luis Obispo County,6,13,19007,9277,9730
50,6,79,California,San Luis Obispo County,6,14,15254,7483,7771
50,6,79,California,San Luis Obispo County,6,15,10721,5107,5614
50,6,79,California,San Luis Obispo County,6,16,7670,3445,4225
50,6,79,California,San Luis Obispo County,6,17,5988,2642,3346
50,6,79,California,San Luis Obispo County,6,18,6785,2538,4247
50,6,79,California,San Luis Obispo County,7,0,278271,141426,136845
50,6,79,California,San Luis Obispo County,7,1,13634,6913,6721
50,6,79,California,San Luis Obispo County,7,2,14132,7198,6934
50,6,79,California,San Luis Obispo County,7,3,14005,7115,6890
50,6,79,California,San Luis Obispo County,7,4,21869,11264,10605
50,6,79,California,San Luis Obispo County,7,5,30806,17188,13618
50,6,79,California,San Luis Obispo County,7,6,15708,8573,7135
50,6,79,California,San Luis Obispo County,7,7,16752,8870,7882
50,6,79,California,San Luis Obispo County,7,8,14706,7909,6797
50,6,79,California,San Luis Obispo County,7,9,14708,7851,6857
50,6,79,California,San Luis Obispo County,7,10,15461,8163,7298
50,6,79,California,San Luis Obispo County,7,11,18497,9223,9274
50,6,79,California,San Luis Obispo County,7,12,19965,9472,10493
50,6,79,California,San Luis Obispo County,7,13,19442,9426,10016
50,6,79,California,San Luis Obispo County,7,14,16341,8010,8331
50,6,79,California,San Luis Obispo County,7,15,11437,5419,6018
50,6,79,California,San Luis Obispo County,7,16,7890,3594,4296
50,6,79,California,San Luis Obispo County,7,17,5987,2668,3319
50,6,79,California,San Luis Obispo County,7,18,6931,2570,4361
50,6,79,California,San Luis Obispo County,8,0,280138,142041,138097
50,6,79,California,San Luis Obispo County,8,1,13524,6939,6585
50,6,79,California,San Luis Obispo County,8,2,14318,7377,6941
50,6,79,California,San Luis Obispo County,8,3,14140,7120,7020
50,6,79,California,San Luis Obispo County,8,4,21585,11054,10531
50,6,79,California,San Luis Obispo County,8,5,30826,17106,13720
50,6,79,California,San Luis Obispo County,8,6,15832,8713,7119
50,6,79,California,San Luis Obispo County,8,7,16749,8745,8004
50,6,79,California,San Luis Obispo County,8,8,15243,8139,7104
50,6,79,California,San Luis Obispo County,8,9,14299,7577,6722
50,6,79,California,San Luis Obispo County,8,10,15468,8153,7315
50,6,79,California,San Luis Obispo County,8,11,17751,8865,8886
50,6,79,California,San Luis Obispo County,8,12,19872,9396,10476
50,6,79,California,San Luis Obispo County,8,13,19811,9501,10310
50,6,79,California,San Luis Obispo County,8,14,17458,8533,8925
50,6,79,California,San Luis Obispo County,8,15,12129,5793,6336
50,6,79,California,San Luis Obispo County,8,16,8109,3717,4392
50,6,79,California,San Luis Obispo County,8,17,5993,2665,3328
50,6,79,California,San Luis Obispo County,8,18,7031,2648,4383
50,6,79,California,San Luis Obispo County,9,0,281884,142917,138967
50,6,79,California,San Luis Obispo County,9,1,13470,6833,6637
50,6,79,California,San Luis Obispo County,9,2,14243,7380,6863
50,6,79,California,San Luis Obispo County,9,3,14273,7249,7024
50,6,79,California,San Luis Obispo County,9,4,21585,11114,10471
50,6,79,California,San Luis Obispo County,9,5,30720,16973,13747
50,6,79,California,San Luis Obispo County,9,6,16254,8927,7327
50,6,79,California,San Luis Obispo County,9,7,16492,8675,7817
50,6,79,California,San Luis Obispo County,9,8,15807,8375,7432
50,6,79,California,San Luis Obispo County,9,9,14188,7533,6655
50,6,79,California,San Luis Obispo County,9,10,15438,8086,7352
50,6,79,California,San Luis Obispo County,9,11,16977,8498,8479
50,6,79,California,San Luis Obispo County,9,12,19577,9329,10248
50,6,79,California,San Luis Obispo County,9,13,20055,9485,10570
50,6,79,California,San Luis Obispo County,9,14,18539,9072,9467
50,6,79,California,San Luis Obispo County,9,15,12577,6022,6555
50,6,79,California,San Luis Obispo County,9,16,8497,3940,4557
50,6,79,California,San Luis Obispo County,9,17,6090,2716,3374
50,6,79,California,San Luis Obispo County,9,18,7102,2710,4392
50,6,79,California,San Luis Obispo County,10,0,282473,143222,139251
50,6,79,California,San Luis Obispo County,10,1,13195,6714,6481
50,6,79,California,San Luis Obispo County,10,2,14033,7249,6784
50,6,79,California,San Luis Obispo County,10,3,14427,7374,7053
50,6,79,California,San Luis Obispo County,10,4,21157,10865,10292
50,6,79,California,San Luis Obispo County,10,5,30273,16599,13674
50,6,79,California,San Luis Obispo County,10,6,16591,9119,7472
50,6,79,California,San Luis Obispo County,10,7,16242,8519,7723
50,6,79,California,San Luis Obispo County,10,8,16397,8745,7652
50,6,79,California,San Luis Obispo County,10,9,14307,7605,6702
50,6,79,California,San Luis Obispo County,10,10,15309,8053,7256
50,6,79,California,San Luis Obispo County,10,11,16392,8271,8121
50,6,79,California,San Luis Obispo County,10,12,19165,9225,9940
50,6,79,California,San Luis Obispo County,10,13,20230,9421,10809
50,6,79,California,San Luis Obispo County,10,14,18624,9102,9522
50,6,79,California,San Luis Obispo County,10,15,13914,6695,7219
50,6,79,California,San Luis Obispo County,10,16,8997,4217,4780
50,6,79,California,San Luis Obispo County,10,17,6169,2716,3453
50,6,79,California,San Luis Obispo County,10,18,7051,2733,4318
50,6,79,California,San Luis Obispo County,11,0,283250,143536,139714
50,6,79,California,San Luis Obispo County,11,1,12964,6592,6372
50,6,79,California,San Luis Obispo County,11,2,13906,7201,6705
50,6,79,California,San Luis Obispo County,11,3,14465,7348,7117
50,6,79,California,San Luis Obispo County,11,4,21479,11053,10426
50,6,79,California,San Luis Obispo County,11,5,30016,16411,13605
50,6,79,California,San Luis Obispo County,11,6,16642,9090,7552
50,6,79,California,San Luis Obispo County,11,7,15914,8451,7463
50,6,79,California,San Luis Obispo County,11,8,16815,8878,7937
50,6,79,California,San Luis Obispo County,11,9,14623,7850,6773
50,6,79,California,San Luis Obispo County,11,10,15082,7972,7110
50,6,79,California,San Luis Obispo County,11,11,15666,7945,7721
50,6,79,California,San Luis Obispo County,11,12,18756,9049,9707
50,6,79,California,San Luis Obispo County,11,13,20125,9333,10792
50,6,79,California,San Luis Obispo County,11,14,18967,9118,9849
50,6,79,California,San Luis Obispo County,11,15,14839,7178,7661
50,6,79,California,San Luis Obispo County,11,16,9728,4577,5151
50,6,79,California,San Luis Obispo County,11,17,6226,2739,3487
50,6,79,California,San Luis Obispo County,11,18,7037,2751,4286
50,6,79,California,San Luis Obispo County,12,0,282728,143008,139720
50,6,79,California,San Luis Obispo County,12,1,12668,6412,6256
50,6,79,California,San Luis Obispo County,12,2,13985,7198,6787
50,6,79,California,San Luis Obispo County,12,3,14282,7297,6985
50,6,79,California,San Luis Obispo County,12,4,21494,11110,10384
50,6,79,California,San Luis Obispo County,12,5,29456,16077,13379
50,6,79,California,San Luis Obispo County,12,6,16536,8954,7582
50,6,79,California,San Luis Obispo County,12,7,15793,8390,7403
50,6,79,California,San Luis Obispo County,12,8,16939,8897,8042
50,6,79,California,San Luis Obispo County,12,9,14984,8050,6934
50,6,79,California,San Luis Obispo County,12,10,14681,7731,6950
50,6,79,California,San Luis Obispo County,12,11,15155,7721,7434
50,6,79,California,San Luis Obispo County,12,12,18208,8793,9415
50,6,79,California,San Luis Obispo County,12,13,19753,9153,10600
50,6,79,California,San Luis Obispo County,12,14,19373,9196,10177
50,6,79,California,San Luis Obispo County,12,15,15646,7565,8081
50,6,79,California,San Luis Obispo County,12,16,10372,4888,5484
50,6,79,California,San Luis Obispo County,12,17,6346,2828,3518
50,6,79,California,San Luis Obispo County,12,18,7057,2748,4309
50,6,79,California,San Luis Obispo County,13,0,282577,142798,139779
50,6,79,California,San Luis Obispo County,13,1,12565,6349,6216
50,6,79,California,San Luis Obispo County,13,2,13825,7104,6721
50,6,79,California,San Luis Obispo County,13,3,14218,7283,6935
50,6,79,California,San Luis Obispo County,13,4,21606,11108,10498
50,6,79,California,San Luis Obispo County,13,5,29096,15870,13226
50,6,79,California,San Luis Obispo County,13,6,16326,8786,7540
50,6,79,California,San Luis Obispo County,13,7,15709,8411,7298
50,6,79,California,San Luis Obispo County,13,8,16853,8829,8024
50,6,79,California,San Luis Obispo County,13,9,15436,8229,7207
50,6,79,California,San Luis Obispo County,13,10,14316,7552,6764
50,6,79,California,San Luis Obispo County,13,11,15175,7789,7386
50,6,79,California,San Luis Obispo County,13,12,17629,8547,9082
50,6,79,California,San Luis Obispo County,13,13,19649,9091,10558
50,6,79,California,San Luis Obispo County,13,14,19475,9200,10275
50,6,79,California,San Luis Obispo County,13,15,16302,7859,8443
50,6,79,California,San Luis Obispo County,13,16,10767,5097,5670
50,6,79,California,San Luis Obispo County,13,17,6457,2883,3574
50,6,79,California,San Luis Obispo County,13,18,7173,2811,4362
50,6,79,California,San Luis Obispo County,14,0,282249,142577,139672
50,6,79,California,San Luis Obispo County,14,1,12522,6320,6202
50,6,79,California,San Luis Obispo County,14,2,13740,7057,6683
50,6,79,California,San Luis Obispo County,14,3,14192,7272,6920
50,6,79,California,San Luis Obispo County,14,4,21620,11094,10526
50,6,79,California,San Luis Obispo County,14,5,28943,15784,13159
50,6,79,California,San Luis Obispo County,14,6,16246,8727,7519
50,6,79,California,San Luis Obispo County,14,7,15687,8420,7267
50,6,79,California,San Luis Obispo County,14,8,16847,8822,8025
50,6,79,California,San Luis Obispo County,14,9,15583,8288,7295
50,6,79,California,San Luis Obispo County,14,10,14188,7483,6705
50,6,79,California,San Luis Obispo County,14,11,15199,7820,7379
50,6,79,California,San Luis Obispo County,14,12,17432,8461,8971
50,6,79,California,San Luis Obispo County,14,13,19590,9055,10535
50,6,79,California,San Luis Obispo County,14,14,19503,9203,10300
50,6,79,California,San Luis Obispo County,14,15,16467,7927,8540
50,6,79,California,San Luis Obispo County,14,16,10853,5142,5711
50,6,79,California,San Luis Obispo County,14,17,6481,2894,3587
50,6,79,California,San Luis Obispo County,14,18,7156,2808,4348
50,6,81,California,San Mateo County,1,0,718451,353168,365283
50,6,81,California,San Mateo County,1,1,46360,23652,22708
50,6,81,California,San Mateo County,1,2,44729,22820,21909
50,6,81,California,San Mateo County,1,3,42463,21750,20713
50,6,81,California,San Mateo County,1,4,41249,21346,19903
50,6,81,California,San Mateo County,1,5,40098,21328,18770
50,6,81,California,San Mateo County,1,6,48320,24734,23586
50,6,81,California,San Mateo County,1,7,51014,25735,25279
50,6,81,California,San Mateo County,1,8,53358,26799,26559
50,6,81,California,San Mateo County,1,9,54742,26912,27830
50,6,81,California,San Mateo County,1,10,56424,27732,28692
50,6,81,California,San Mateo County,1,11,54245,26604,27641
50,6,81,California,San Mateo County,1,12,47865,23192,24673
50,6,81,California,San Mateo County,1,13,41322,19651,21671
50,6,81,California,San Mateo County,1,14,28485,13045,15440
50,6,81,California,San Mateo County,1,15,21500,9647,11853
50,6,81,California,San Mateo County,1,16,16888,7340,9548
50,6,81,California,San Mateo County,1,17,14085,5643,8442
50,6,81,California,San Mateo County,1,18,15304,5238,10066
50,6,81,California,San Mateo County,2,0,718528,353210,365318
50,6,81,California,San Mateo County,2,1,46365,23657,22708
50,6,81,California,San Mateo County,2,2,44729,22820,21909
50,6,81,California,San Mateo County,2,3,42461,21749,20712
50,6,81,California,San Mateo County,2,4,41253,21347,19906
50,6,81,California,San Mateo County,2,5,40103,21331,18772
50,6,81,California,San Mateo County,2,6,48333,24738,23595
50,6,81,California,San Mateo County,2,7,51023,25742,25281
50,6,81,California,San Mateo County,2,8,53363,26803,26560
50,6,81,California,San Mateo County,2,9,54746,26915,27831
50,6,81,California,San Mateo County,2,10,56423,27732,28691
50,6,81,California,San Mateo County,2,11,54250,26606,27644
50,6,81,California,San Mateo County,2,12,47872,23197,24675
50,6,81,California,San Mateo County,2,13,41326,19652,21674
50,6,81,California,San Mateo County,2,14,28490,13046,15444
50,6,81,California,San Mateo County,2,15,21506,9649,11857
50,6,81,California,San Mateo County,2,16,16894,7343,9551
50,6,81,California,San Mateo County,2,17,14086,5644,8442
50,6,81,California,San Mateo County,2,18,15305,5239,10066
50,6,81,California,San Mateo County,3,0,719948,353920,366028
50,6,81,California,San Mateo County,3,1,46289,23630,22659
50,6,81,California,San Mateo County,3,2,44842,22873,21969
50,6,81,California,San Mateo County,3,3,42556,21788,20768
50,6,81,California,San Mateo County,3,4,41305,21363,19942
50,6,81,California,San Mateo County,3,5,40088,21345,18743
50,6,81,California,San Mateo County,3,6,48379,24766,23613
50,6,81,California,San Mateo County,3,7,51116,25772,25344
50,6,81,California,San Mateo County,3,8,53154,26673,26481
50,6,81,California,San Mateo County,3,9,54826,26989,27837
50,6,81,California,San Mateo County,3,10,56264,27662,28602
50,6,81,California,San Mateo County,3,11,54462,26734,27728
50,6,81,California,San Mateo County,3,12,48106,23291,24815
50,6,81,California,San Mateo County,3,13,41745,19865,21880
50,6,81,California,San Mateo County,3,14,28742,13149,15593
50,6,81,California,San Mateo County,3,15,21689,9755,11934
50,6,81,California,San Mateo County,3,16,16836,7309,9527
50,6,81,California,San Mateo County,3,17,14126,5674,8452
50,6,81,California,San Mateo County,3,18,15423,5282,10141
50,6,81,California,San Mateo County,4,0,728945,358279,370666
50,6,81,California,San Mateo County,4,1,46319,23602,22717
50,6,81,California,San Mateo County,4,2,45617,23288,22329
50,6,81,California,San Mateo County,4,3,42911,22016,20895
50,6,81,California,San Mateo County,4,4,41236,21184,20052
50,6,81,California,San Mateo County,4,5,40338,21413,18925
50,6,81,California,San Mateo County,4,6,48865,25100,23765
50,6,81,California,San Mateo County,4,7,52142,26205,25937
50,6,81,California,San Mateo County,4,8,52581,26298,26283
50,6,81,California,San Mateo County,4,9,55639,27541,28098
50,6,81,California,San Mateo County,4,10,55773,27508,28265
50,6,81,California,San Mateo County,4,11,54979,27030,27949
50,6,81,California,San Mateo County,4,12,49314,23804,25510
50,6,81,California,San Mateo County,4,13,43636,20777,22859
50,6,81,California,San Mateo County,4,14,29987,13719,16268
50,6,81,California,San Mateo County,4,15,22455,10123,12332
50,6,81,California,San Mateo County,4,16,16971,7398,9573
50,6,81,California,San Mateo County,4,17,14264,5825,8439
50,6,81,California,San Mateo County,4,18,15918,5448,10470
50,6,81,California,San Mateo County,5,0,739700,363577,376123
50,6,81,California,San Mateo County,5,1,46395,23581,22814
50,6,81,California,San Mateo County,5,2,46445,23640,22805
50,6,81,California,San Mateo County,5,3,43469,22296,21173
50,6,81,California,San Mateo County,5,4,41039,20986,20053
50,6,81,California,San Mateo County,5,5,40976,21466,19510
50,6,81,California,San Mateo County,5,6,49592,25629,23963
50,6,81,California,San Mateo County,5,7,53725,27121,26604
50,6,81,California,San Mateo County,5,8,52842,26391,26451
50,6,81,California,San Mateo County,5,9,56291,27873,28418
50,6,81,California,San Mateo County,5,10,55310,27403,27907
50,6,81,California,San Mateo County,5,11,55437,27151,28286
50,6,81,California,San Mateo County,5,12,50796,24610,26186
50,6,81,California,San Mateo County,5,13,43607,20815,22792
50,6,81,California,San Mateo County,5,14,32746,15069,17677
50,6,81,California,San Mateo County,5,15,23194,10417,12777
50,6,81,California,San Mateo County,5,16,17343,7630,9713
50,6,81,California,San Mateo County,5,17,14155,5895,8260
50,6,81,California,San Mateo County,5,18,16338,5604,10734
50,6,81,California,San Mateo County,6,0,749131,368603,380528
50,6,81,California,San Mateo County,6,1,46268,23463,22805
50,6,81,California,San Mateo County,6,2,46654,23871,22783
50,6,81,California,San Mateo County,6,3,44046,22500,21546
50,6,81,California,San Mateo County,6,4,40843,20904,19939
50,6,81,California,San Mateo County,6,5,41984,21890,20094
50,6,81,California,San Mateo County,6,6,49989,26030,23959
50,6,81,California,San Mateo County,6,7,55626,28091,27535
50,6,81,California,San Mateo County,6,8,53556,26910,26646
50,6,81,California,San Mateo County,6,9,56305,27996,28309
50,6,81,California,San Mateo County,6,10,54648,27078,27570
50,6,81,California,San Mateo County,6,11,55836,27300,28536
50,6,81,California,San Mateo County,6,12,51613,25073,26540
50,6,81,California,San Mateo County,6,13,44372,21195,23177
50,6,81,California,San Mateo County,6,14,34482,15920,18562
50,6,81,California,San Mateo County,6,15,24240,10767,13473
50,6,81,California,San Mateo County,6,16,17852,7878,9974
50,6,81,California,San Mateo County,6,17,14154,5969,8185
50,6,81,California,San Mateo County,6,18,16663,5768,10895
50,6,81,California,San Mateo County,7,0,757653,372969,384684
50,6,81,California,San Mateo County,7,1,46169,23518,22651
50,6,81,California,San Mateo County,7,2,46422,23694,22728
50,6,81,California,San Mateo County,7,3,44655,22805,21850
50,6,81,California,San Mateo County,7,4,40579,20804,19775
50,6,81,California,San Mateo County,7,5,42888,22229,20659
50,6,81,California,San Mateo County,7,6,51032,26741,24291
50,6,81,California,San Mateo County,7,7,56788,28777,28011
50,6,81,California,San Mateo County,7,8,54590,27244,27346
50,6,81,California,San Mateo County,7,9,55672,27906,27766
50,6,81,California,San Mateo County,7,10,54274,26781,27493
50,6,81,California,San Mateo County,7,11,55994,27325,28669
50,6,81,California,San Mateo County,7,12,52405,25487,26918
50,6,81,California,San Mateo County,7,13,44866,21539,23327
50,6,81,California,San Mateo County,7,14,36280,16790,19490
50,6,81,California,San Mateo County,7,15,25255,11238,14017
50,6,81,California,San Mateo County,7,16,18478,8088,10390
50,6,81,California,San Mateo County,7,17,14229,5991,8238
50,6,81,California,San Mateo County,7,18,17077,6012,11065
50,6,81,California,San Mateo County,8,0,765479,377328,388151
50,6,81,California,San Mateo County,8,1,45979,23477,22502
50,6,81,California,San Mateo County,8,2,46207,23606,22601
50,6,81,California,San Mateo County,8,3,44863,22764,22099
50,6,81,California,San Mateo County,8,4,40754,21031,19723
50,6,81,California,San Mateo County,8,5,43066,22201,20865
50,6,81,California,San Mateo County,8,6,52261,27549,24712
50,6,81,California,San Mateo County,8,7,57816,29359,28457
50,6,81,California,San Mateo County,8,8,56021,28042,27979
50,6,81,California,San Mateo County,8,9,54613,27501,27112
50,6,81,California,San Mateo County,8,10,54623,26892,27731
50,6,81,California,San Mateo County,8,11,55821,27287,28534
50,6,81,California,San Mateo County,8,12,52931,25877,27054
50,6,81,California,San Mateo County,8,13,45674,21914,23760
50,6,81,California,San Mateo County,8,14,37957,17708,20249
50,6,81,California,San Mateo County,8,15,26093,11618,14475
50,6,81,California,San Mateo County,8,16,19234,8324,10910
50,6,81,California,San Mateo County,8,17,14072,5903,8169
50,6,81,California,San Mateo County,8,18,17494,6275,11219
50,6,81,California,San Mateo County,9,0,767928,379302,388626
50,6,81,California,San Mateo County,9,1,44836,23090,21746
50,6,81,California,San Mateo County,9,2,45519,23248,22271
50,6,81,California,San Mateo County,9,3,44897,22743,22154
50,6,81,California,San Mateo County,9,4,40825,21137,19688
50,6,81,California,San Mateo County,9,5,42809,21997,20812
50,6,81,California,San Mateo County,9,6,54366,28829,25537
50,6,81,California,San Mateo County,9,7,58334,29844,28490
50,6,81,California,San Mateo County,9,8,56453,28224,28229
50,6,81,California,San Mateo County,9,9,53320,26810,26510
50,6,81,California,San Mateo County,9,10,54946,27242,27704
50,6,81,California,San Mateo County,9,11,54482,26702,27780
50,6,81,California,San Mateo County,9,12,53016,25965,27051
50,6,81,California,San Mateo County,9,13,46233,22143,24090
50,6,81,California,San Mateo County,9,14,39159,18291,20868
50,6,81,California,San Mateo County,9,15,26967,12010,14957
50,6,81,California,San Mateo County,9,16,19772,8577,11195
50,6,81,California,San Mateo County,9,17,14133,5953,8180
50,6,81,California,San Mateo County,9,18,17861,6497,11364
50,6,81,California,San Mateo County,10,0,768658,380058,388600
50,6,81,California,San Mateo County,10,1,44028,22700,21328
50,6,81,California,San Mateo County,10,2,44598,22883,21715
50,6,81,California,San Mateo County,10,3,44630,22684,21946
50,6,81,California,San Mateo County,10,4,40773,21080,19693
50,6,81,California,San Mateo County,10,5,42115,21574,20541
50,6,81,California,San Mateo County,10,6,55693,29388,26305
50,6,81,California,San Mateo County,10,7,59013,30372,28641
50,6,81,California,San Mateo County,10,8,56750,28472,28278
50,6,81,California,San Mateo County,10,9,52830,26589,26241
50,6,81,California,San Mateo County,10,10,54653,27151,27502
50,6,81,California,San Mateo County,10,11,53168,26179,26989
50,6,81,California,San Mateo County,10,12,52773,25800,26973
50,6,81,California,San Mateo County,10,13,46823,22449,24374
50,6,81,California,San Mateo County,10,14,39008,18226,20782
50,6,81,California,San Mateo County,10,15,29023,13021,16002
50,6,81,California,San Mateo County,10,16,20454,8854,11600
50,6,81,California,San Mateo County,10,17,14355,6103,8252
50,6,81,California,San Mateo County,10,18,17971,6533,11438
50,6,81,California,San Mateo County,11,0,768410,380605,387805
50,6,81,California,San Mateo County,11,1,43198,22335,20863
50,6,81,California,San Mateo County,11,2,43544,22264,21280
50,6,81,California,San Mateo County,11,3,44301,22579,21722
50,6,81,California,San Mateo County,11,4,40975,21139,19836
50,6,81,California,San Mateo County,11,5,41538,21482,20056
50,6,81,California,San Mateo County,11,6,56017,29522,26495
50,6,81,California,San Mateo County,11,7,59090,30799,28291
50,6,81,California,San Mateo County,11,8,57461,28913,28548
50,6,81,California,San Mateo County,11,9,52644,26512,26132
50,6,81,California,San Mateo County,11,10,54201,26981,27220
50,6,81,California,San Mateo County,11,11,51832,25532,26300
50,6,81,California,San Mateo County,11,12,52534,25638,26896
50,6,81,California,San Mateo County,11,13,47139,22696,24443
50,6,81,California,San Mateo County,11,14,39185,18372,20813
50,6,81,California,San Mateo County,11,15,30425,13673,16752
50,6,81,California,San Mateo County,11,16,21303,9168,12135
50,6,81,California,San Mateo County,11,17,14832,6268,8564
50,6,81,California,San Mateo County,11,18,18191,6732,11459
50,6,81,California,San Mateo County,12,0,764810,378926,385884
50,6,81,California,San Mateo County,12,1,42409,21904,20505
50,6,81,California,San Mateo County,12,2,42537,21808,20729
50,6,81,California,San Mateo County,12,3,43269,22040,21229
50,6,81,California,San Mateo County,12,4,40837,21102,19735
50,6,81,California,San Mateo County,12,5,40727,21077,19650
50,6,81,California,San Mateo County,12,6,55676,29263,26413
50,6,81,California,San Mateo County,12,7,59744,31230,28514
50,6,81,California,San Mateo County,12,8,57622,29249,28373
50,6,81,California,San Mateo County,12,9,52321,26139,26182
50,6,81,California,San Mateo County,12,10,52786,26474,26312
50,6,81,California,San Mateo County,12,11,50818,24926,25892
50,6,81,California,San Mateo County,12,12,52060,25287,26773
50,6,81,California,San Mateo County,12,13,47210,22817,24393
50,6,81,California,San Mateo County,12,14,39250,18499,20751
50,6,81,California,San Mateo County,12,15,31763,14407,17356
50,6,81,California,San Mateo County,12,16,22054,9521,12533
50,6,81,California,San Mateo County,12,17,15296,6404,8892
50,6,81,California,San Mateo County,12,18,18431,6779,11652
50,6,81,California,San Mateo County,13,0,760706,376988,383718
50,6,81,California,San Mateo County,13,1,41519,21361,20158
50,6,81,California,San Mateo County,13,2,41853,21466,20387
50,6,81,California,San Mateo County,13,3,42587,21769,20818
50,6,81,California,San Mateo County,13,4,40638,20905,19733
50,6,81,California,San Mateo County,13,5,39981,20739,19242
50,6,81,California,San Mateo County,13,6,54509,28555,25954
50,6,81,California,San Mateo County,13,7,60045,31533,28512
50,6,81,California,San Mateo County,13,8,57572,29171,28401
50,6,81,California,San Mateo County,13,9,52179,26152,26027
50,6,81,California,San Mateo County,13,10,51473,25798,25675
50,6,81,California,San Mateo County,13,11,50680,24889,25791
50,6,81,California,San Mateo County,13,12,51429,25013,26416
50,6,81,California,San Mateo County,13,13,47188,22879,24309
50,6,81,California,San Mateo County,13,14,39606,18756,20850
50,6,81,California,San Mateo County,13,15,32666,14900,17766
50,6,81,California,San Mateo County,13,16,22478,9725,12753
50,6,81,California,San Mateo County,13,17,15723,6540,9183
50,6,81,California,San Mateo County,13,18,18580,6837,11743
50,6,81,California,San Mateo County,14,0,758308,375847,382461
50,6,81,California,San Mateo County,14,1,41177,21150,20027
50,6,81,California,San Mateo County,14,2,41530,21307,20223
50,6,81,California,San Mateo County,14,3,42351,21676,20675
50,6,81,California,San Mateo County,14,4,40460,20783,19677
50,6,81,California,San Mateo County,14,5,39624,20569,19055
50,6,81,California,San Mateo County,14,6,53976,28251,25725
50,6,81,California,San Mateo County,14,7,60071,31597,28474
50,6,81,California,San Mateo County,14,8,57558,29157,28401
50,6,81,California,San Mateo County,14,9,52088,26131,25957
50,6,81,California,San Mateo County,14,10,51015,25569,25446
50,6,81,California,San Mateo County,14,11,50689,24903,25786
50,6,81,California,San Mateo County,14,12,51156,24900,26256
50,6,81,California,San Mateo County,14,13,47133,22865,24268
50,6,81,California,San Mateo County,14,14,39712,18838,20874
50,6,81,California,San Mateo County,14,15,32868,15008,17860
50,6,81,California,San Mateo County,14,16,22565,9768,12797
50,6,81,California,San Mateo County,14,17,15840,6573,9267
50,6,81,California,San Mateo County,14,18,18495,6802,11693
50,6,83,California,Santa Barbara County,1,0,423895,212786,211109
50,6,83,California,Santa Barbara County,1,1,27350,13873,13477
50,6,83,California,Santa Barbara County,1,2,26303,13397,12906
50,6,83,California,Santa Barbara County,1,3,26626,13717,12909
50,6,83,California,Santa Barbara County,1,4,38009,19284,18725
50,6,83,California,Santa Barbara County,1,5,43026,22782,20244
50,6,83,California,Santa Barbara County,1,6,31100,16572,14528
50,6,83,California,Santa Barbara County,1,7,26592,14006,12586
50,6,83,California,Santa Barbara County,1,8,25092,13105,11987
50,6,83,California,Santa Barbara County,1,9,25386,12935,12451
50,6,83,California,Santa Barbara County,1,10,27577,13807,13770
50,6,83,California,Santa Barbara County,1,11,27421,13618,13803
50,6,83,California,Santa Barbara County,1,12,24418,11960,12458
50,6,83,California,Santa Barbara County,1,13,20597,10055,10542
50,6,83,California,Santa Barbara County,1,14,15014,7040,7974
50,6,83,California,Santa Barbara County,1,15,11762,5400,6362
50,6,83,California,Santa Barbara County,1,16,10052,4518,5534
50,6,83,California,Santa Barbara County,1,17,8480,3478,5002
50,6,83,California,Santa Barbara County,1,18,9090,3239,5851
50,6,83,California,Santa Barbara County,2,0,423947,212812,211135
50,6,83,California,Santa Barbara County,2,1,27353,13875,13478
50,6,83,California,Santa Barbara County,2,2,26309,13400,12909
50,6,83,California,Santa Barbara County,2,3,26629,13718,12911
50,6,83,California,Santa Barbara County,2,4,38015,19286,18729
50,6,83,California,Santa Barbara County,2,5,43031,22787,20244
50,6,83,California,Santa Barbara County,2,6,31102,16573,14529
50,6,83,California,Santa Barbara County,2,7,26593,14006,12587
50,6,83,California,Santa Barbara County,2,8,25096,13107,11989
50,6,83,California,Santa Barbara County,2,9,25387,12935,12452
50,6,83,California,Santa Barbara County,2,10,27585,13811,13774
50,6,83,California,Santa Barbara County,2,11,27422,13618,13804
50,6,83,California,Santa Barbara County,2,12,24420,11960,12460
50,6,83,California,Santa Barbara County,2,13,20597,10055,10542
50,6,83,California,Santa Barbara County,2,14,15020,7043,7977
50,6,83,California,Santa Barbara County,2,15,11763,5401,6362
50,6,83,California,Santa Barbara County,2,16,10053,4518,5535
50,6,83,California,Santa Barbara County,2,17,8482,3480,5002
50,6,83,California,Santa Barbara County,2,18,9090,3239,5851
50,6,83,California,Santa Barbara County,3,0,424218,212784,211434
50,6,83,California,Santa Barbara County,3,1,27529,13977,13552
50,6,83,California,Santa Barbara County,3,2,26331,13384,12947
50,6,83,California,Santa Barbara County,3,3,26547,13660,12887
50,6,83,California,Santa Barbara County,3,4,37860,19173,18687
50,6,83,California,Santa Barbara County,3,5,43545,22988,20557
50,6,83,California,Santa Barbara County,3,6,30884,16482,14402
50,6,83,California,Santa Barbara County,3,7,26645,14041,12604
50,6,83,California,Santa Barbara County,3,8,24951,12998,11953
50,6,83,California,Santa Barbara County,3,9,25286,12890,12396
50,6,83,California,Santa Barbara County,3,10,27353,13673,13680
50,6,83,California,Santa Barbara County,3,11,27405,13593,13812
50,6,83,California,Santa Barbara County,3,12,24558,12033,12525
50,6,83,California,Santa Barbara County,3,13,20751,10122,10629
50,6,83,California,Santa Barbara County,3,14,15130,7109,8021
50,6,83,California,Santa Barbara County,3,15,11798,5423,6375
50,6,83,California,Santa Barbara County,3,16,10021,4491,5530
50,6,83,California,Santa Barbara County,3,17,8473,3492,4981
50,6,83,California,Santa Barbara County,3,18,9151,3255,5896
50,6,83,California,Santa Barbara County,4,0,425404,213033,212371
50,6,83,California,Santa Barbara County,4,1,27834,14177,13657
50,6,83,California,Santa Barbara County,4,2,26510,13365,13145
50,6,83,California,Santa Barbara County,4,3,26197,13447,12750
50,6,83,California,Santa Barbara County,4,4,37118,18737,18381
50,6,83,California,Santa Barbara County,4,5,45671,23884,21787
50,6,83,California,Santa Barbara County,4,6,29771,15966,13805
50,6,83,California,Santa Barbara County,4,7,26941,14219,12722
50,6,83,California,Santa Barbara County,4,8,24279,12584,11695
50,6,83,California,Santa Barbara County,4,9,25117,12844,12273
50,6,83,California,Santa Barbara County,4,10,26471,13215,13256
50,6,83,California,Santa Barbara County,4,11,27386,13543,13843
50,6,83,California,Santa Barbara County,4,12,25006,12264,12742
50,6,83,California,Santa Barbara County,4,13,21657,10540,11117
50,6,83,California,Santa Barbara County,4,14,15569,7386,8183
50,6,83,California,Santa Barbara County,4,15,12072,5574,6498
50,6,83,California,Santa Barbara County,4,16,9965,4405,5560
50,6,83,California,Santa Barbara County,4,17,8451,3544,4907
50,6,83,California,Santa Barbara County,4,18,9389,3339,6050
50,6,83,California,Santa Barbara County,5,0,429635,215423,214212
50,6,83,California,Santa Barbara County,5,1,27982,14232,13750
50,6,83,California,Santa Barbara County,5,2,27120,13682,13438
50,6,83,California,Santa Barbara County,5,3,25905,13270,12635
50,6,83,California,Santa Barbara County,5,4,36599,18463,18136
50,6,83,California,Santa Barbara County,5,5,48083,25094,22989
50,6,83,California,Santa Barbara County,5,6,28885,15573,13312
50,6,83,California,Santa Barbara County,5,7,27874,14741,13133
50,6,83,California,Santa Barbara County,5,8,24302,12621,11681
50,6,83,California,Santa Barbara County,5,9,25068,12910,12158
50,6,83,California,Santa Barbara County,5,10,25715,12910,12805
50,6,83,California,Santa Barbara County,5,11,27401,13566,13835
50,6,83,California,Santa Barbara County,5,12,25530,12548,12982
50,6,83,California,Santa Barbara County,5,13,21742,10460,11282
50,6,83,California,Santa Barbara County,5,14,16963,8156,8807
50,6,83,California,Santa Barbara County,5,15,12402,5701,6701
50,6,83,California,Santa Barbara County,5,16,9946,4406,5540
50,6,83,California,Santa Barbara County,5,17,8487,3604,4883
50,6,83,California,Santa Barbara County,5,18,9631,3486,6145
50,6,83,California,Santa Barbara County,6,0,434503,217844,216659
50,6,83,California,Santa Barbara County,6,1,28214,14410,13804
50,6,83,California,Santa Barbara County,6,2,27725,13956,13769
50,6,83,California,Santa Barbara County,6,3,25961,13287,12674
50,6,83,California,Santa Barbara County,6,4,36415,18289,18126
50,6,83,California,Santa Barbara County,6,5,50161,26147,24014
50,6,83,California,Santa Barbara County,6,6,28677,15379,13298
50,6,83,California,Santa Barbara County,6,7,28473,15100,13373
50,6,83,California,Santa Barbara County,6,8,24641,12830,11811
50,6,83,California,Santa Barbara County,6,9,24831,12768,12063
50,6,83,California,Santa Barbara County,6,10,24941,12594,12347
50,6,83,California,Santa Barbara County,6,11,27181,13407,13774
50,6,83,California,Santa Barbara County,6,12,25746,12705,13041
50,6,83,California,Santa Barbara County,6,13,22369,10745,11624
50,6,83,California,Santa Barbara County,6,14,17801,8563,9238
50,6,83,California,Santa Barbara County,6,15,12986,5969,7017
50,6,83,California,Santa Barbara County,6,16,10159,4495,5664
50,6,83,California,Santa Barbara County,6,17,8425,3629,4796
50,6,83,California,Santa Barbara County,6,18,9797,3571,6226
50,6,83,California,Santa Barbara County,7,0,438921,220021,218900
50,6,83,California,Santa Barbara County,7,1,28603,14676,13927
50,6,83,California,Santa Barbara County,7,2,27896,14085,13811
50,6,83,California,Santa Barbara County,7,3,26078,13228,12850
50,6,83,California,Santa Barbara County,7,4,36348,18173,18175
50,6,83,California,Santa Barbara County,7,5,51005,26511,24494
50,6,83,California,Santa Barbara County,7,6,28985,15636,13349
50,6,83,California,Santa Barbara County,7,7,28905,15312,13593
50,6,83,California,Santa Barbara County,7,8,25021,13083,11938
50,6,83,California,Santa Barbara County,7,9,24557,12603,11954
50,6,83,California,Santa Barbara County,7,10,24522,12418,12104
50,6,83,California,Santa Barbara County,7,11,27078,13343,13735
50,6,83,California,Santa Barbara County,7,12,26077,12849,13228
50,6,83,California,Santa Barbara County,7,13,22800,10999,11801
50,6,83,California,Santa Barbara County,7,14,18713,8994,9719
50,6,83,California,Santa Barbara County,7,15,13549,6190,7359
50,6,83,California,Santa Barbara County,7,16,10399,4646,5753
50,6,83,California,Santa Barbara County,7,17,8403,3631,4772
50,6,83,California,Santa Barbara County,7,18,9982,3644,6338
50,6,83,California,Santa Barbara County,8,0,442051,221538,220513
50,6,83,California,Santa Barbara County,8,1,28927,14875,14052
50,6,83,California,Santa Barbara County,8,2,27903,14056,13847
50,6,83,California,Santa Barbara County,8,3,26373,13344,13029
50,6,83,California,Santa Barbara County,8,4,36308,18082,18226
50,6,83,California,Santa Barbara County,8,5,51395,26577,24818
50,6,83,California,Santa Barbara County,8,6,29714,16051,13663
50,6,83,California,Santa Barbara County,8,7,28512,15132,13380
50,6,83,California,Santa Barbara County,8,8,25508,13279,12229
50,6,83,California,Santa Barbara County,8,9,24185,12465,11720
50,6,83,California,Santa Barbara County,8,10,24443,12387,12056
50,6,83,California,Santa Barbara County,8,11,26257,13022,13235
50,6,83,California,Santa Barbara County,8,12,26285,12925,13360
50,6,83,California,Santa Barbara County,8,13,23316,11244,12072
50,6,83,California,Santa Barbara County,8,14,19644,9498,10146
50,6,83,California,Santa Barbara County,8,15,14077,6453,7624
50,6,83,California,Santa Barbara County,8,16,10644,4769,5875
50,6,83,California,Santa Barbara County,8,17,8326,3620,4706
50,6,83,California,Santa Barbara County,8,18,10234,3759,6475
50,6,83,California,Santa Barbara County,9,0,444112,222300,221812
50,6,83,California,Santa Barbara County,9,1,28619,14734,13885
50,6,83,California,Santa Barbara County,9,2,28119,14168,13951
50,6,83,California,Santa Barbara County,9,3,26664,13482,13182
50,6,83,California,Santa Barbara County,9,4,36376,18024,18352
50,6,83,California,Santa Barbara County,9,5,50892,26277,24615
50,6,83,California,Santa Barbara County,9,6,31088,16637,14451
50,6,83,California,Santa Barbara County,9,7,28154,14990,13164
50,6,83,California,Santa Barbara County,9,8,25938,13501,12437
50,6,83,California,Santa Barbara County,9,9,23632,12121,11511
50,6,83,California,Santa Barbara County,9,10,24504,12426,12078
50,6,83,California,Santa Barbara County,9,11,25502,12685,12817
50,6,83,California,Santa Barbara County,9,12,26326,12912,13414
50,6,83,California,Santa Barbara County,9,13,23741,11452,12289
50,6,83,California,Santa Barbara County,9,14,20499,9829,10670
50,6,83,California,Santa Barbara County,9,15,14543,6790,7753
50,6,83,California,Santa Barbara County,9,16,10824,4836,5988
50,6,83,California,Santa Barbara County,9,17,8349,3584,4765
50,6,83,California,Santa Barbara County,9,18,10342,3852,6490
50,6,83,California,Santa Barbara County,10,0,444998,222707,222291
50,6,83,California,Santa Barbara County,10,1,28162,14508,13654
50,6,83,California,Santa Barbara County,10,2,28062,14231,13831
50,6,83,California,Santa Barbara County,10,3,27103,13695,13408
50,6,83,California,Santa Barbara County,10,4,36348,17884,18464
50,6,83,California,Santa Barbara County,10,5,50312,25857,24455
50,6,83,California,Santa Barbara County,10,6,32360,17320,15040
50,6,83,California,Santa Barbara County,10,7,27177,14538,12639
50,6,83,California,Santa Barbara County,10,8,26458,13816,12642
50,6,83,California,Santa Barbara County,10,9,23474,12015,11459
50,6,83,California,Santa Barbara County,10,10,24284,12358,11926
50,6,83,California,Santa Barbara County,10,11,24598,12268,12330
50,6,83,California,Santa Barbara County,10,12,26203,12787,13416
50,6,83,California,Santa Barbara County,10,13,24157,11719,12438
50,6,83,California,Santa Barbara County,10,14,20555,9764,10791
50,6,83,California,Santa Barbara County,10,15,15878,7478,8400
50,6,83,California,Santa Barbara County,10,16,11138,4998,6140
50,6,83,California,Santa Barbara County,10,17,8341,3528,4813
50,6,83,California,Santa Barbara County,10,18,10388,3943,6445
50,6,83,California,Santa Barbara County,11,0,445137,222566,222571
50,6,83,California,Santa Barbara County,11,1,27759,14163,13596
50,6,83,California,Santa Barbara County,11,2,27897,14229,13668
50,6,83,California,Santa Barbara County,11,3,27475,13821,13654
50,6,83,California,Santa Barbara County,11,4,36520,17995,18525
50,6,83,California,Santa Barbara County,11,5,49498,25324,24174
50,6,83,California,Santa Barbara County,11,6,32649,17473,15176
50,6,83,California,Santa Barbara County,11,7,26827,14226,12601
50,6,83,California,Santa Barbara County,11,8,26783,13996,12787
50,6,83,California,Santa Barbara County,11,9,23636,12150,11486
50,6,83,California,Santa Barbara County,11,10,23784,12062,11722
50,6,83,California,Santa Barbara County,11,11,23906,11990,11916
50,6,83,California,Santa Barbara County,11,12,26052,12704,13348
50,6,83,California,Santa Barbara County,11,13,24338,11857,12481
50,6,83,California,Santa Barbara County,11,14,20988,9893,11095
50,6,83,California,Santa Barbara County,11,15,16568,7867,8701
50,6,83,California,Santa Barbara County,11,16,11680,5265,6415
50,6,83,California,Santa Barbara County,11,17,8431,3576,4855
50,6,83,California,Santa Barbara County,11,18,10346,3975,6371
50,6,83,California,Santa Barbara County,12,0,445464,222783,222681
50,6,83,California,Santa Barbara County,12,1,27406,13956,13450
50,6,83,California,Santa Barbara County,12,2,28000,14345,13655
50,6,83,California,Santa Barbara County,12,3,27450,13844,13606
50,6,83,California,Santa Barbara County,12,4,36422,17871,18551
50,6,83,California,Santa Barbara County,12,5,48761,24883,23878
50,6,83,California,Santa Barbara County,12,6,33029,17546,15483
50,6,83,California,Santa Barbara County,12,7,27002,14418,12584
50,6,83,California,Santa Barbara County,12,8,27096,14147,12949
50,6,83,California,Santa Barbara County,12,9,23666,12220,11446
50,6,83,California,Santa Barbara County,12,10,23298,11870,11428
50,6,83,California,Santa Barbara County,12,11,23402,11814,11588
50,6,83,California,Santa Barbara County,12,12,25692,12492,13200
50,6,83,California,Santa Barbara County,12,13,24497,11900,12597
50,6,83,California,Santa Barbara County,12,14,21265,10089,11176
50,6,83,California,Santa Barbara County,12,15,17361,8256,9105
50,6,83,California,Santa Barbara County,12,16,12091,5414,6677
50,6,83,California,Santa Barbara County,12,17,8648,3709,4939
50,6,83,California,Santa Barbara County,12,18,10378,4009,6369
50,6,83,California,Santa Barbara County,13,0,445285,222757,222528
50,6,83,California,Santa Barbara County,13,1,27072,13780,13292
50,6,83,California,Santa Barbara County,13,2,28039,14420,13619
50,6,83,California,Santa Barbara County,13,3,27319,13841,13478
50,6,83,California,Santa Barbara County,13,4,36396,17874,18522
50,6,83,California,Santa Barbara County,13,5,48517,24726,23791
50,6,83,California,Santa Barbara County,13,6,32799,17340,15459
50,6,83,California,Santa Barbara County,13,7,27201,14503,12698
50,6,83,California,Santa Barbara County,13,8,26968,14113,12855
50,6,83,California,Santa Barbara County,13,9,23930,12364,11566
50,6,83,California,Santa Barbara County,13,10,22948,11687,11261
50,6,83,California,Santa Barbara County,13,11,23258,11715,11543
50,6,83,California,Santa Barbara County,13,12,25099,12284,12815
50,6,83,California,Santa Barbara County,13,13,24573,11942,12631
50,6,83,California,Santa Barbara County,13,14,21524,10213,11311
50,6,83,California,Santa Barbara County,13,15,17952,8531,9421
50,6,83,California,Santa Barbara County,13,16,12484,5588,6896
50,6,83,California,Santa Barbara County,13,17,8727,3789,4938
50,6,83,California,Santa Barbara County,13,18,10479,4047,6432
50,6,83,California,Santa Barbara County,14,0,444766,222520,222246
50,6,83,California,Santa Barbara County,14,1,26956,13719,13237
50,6,83,California,Santa Barbara County,14,2,28014,14424,13590
50,6,83,California,Santa Barbara County,14,3,27244,13831,13413
50,6,83,California,Santa Barbara County,14,4,36340,17853,18487
50,6,83,California,Santa Barbara County,14,5,48350,24629,23721
50,6,83,California,Santa Barbara County,14,6,32684,17255,15429
50,6,83,California,Santa Barbara County,14,7,27264,14531,12733
50,6,83,California,Santa Barbara County,14,8,26947,14116,12831
50,6,83,California,Santa Barbara County,14,9,24003,12404,11599
50,6,83,California,Santa Barbara County,14,10,22830,11626,11204
50,6,83,California,Santa Barbara County,14,11,23238,11689,11549
50,6,83,California,Santa Barbara County,14,12,24881,12203,12678
50,6,83,California,Santa Barbara County,14,13,24573,11937,12636
50,6,83,California,Santa Barbara County,14,14,21598,10251,11347
50,6,83,California,Santa Barbara County,14,15,18104,8596,9508
50,6,83,California,Santa Barbara County,14,16,12570,5622,6948
50,6,83,California,Santa Barbara County,14,17,8738,3810,4928
50,6,83,California,Santa Barbara County,14,18,10432,4024,6408
50,6,85,California,Santa Clara County,1,0,1781642,893851,887791
50,6,85,California,Santa Clara County,1,1,124464,63660,60804
50,6,85,California,Santa Clara County,1,2,121928,62320,59608
50,6,85,California,Santa Clara County,1,3,113570,58180,55390
50,6,85,California,Santa Clara County,1,4,114544,59564,54980
50,6,85,California,Santa Clara County,1,5,113117,60070,53047
50,6,85,California,Santa Clara County,1,6,133544,68924,64620
50,6,85,California,Santa Clara County,1,7,136022,69295,66727
50,6,85,California,Santa Clara County,1,8,140750,71298,69452
50,6,85,California,Santa Clara County,1,9,137619,69926,67693
50,6,85,California,Santa Clara County,1,10,138118,70721,67397
50,6,85,California,Santa Clara County,1,11,125476,63598,61878
50,6,85,California,Santa Clara County,1,12,102413,50394,52019
50,6,85,California,Santa Clara County,1,13,83133,39897,43236
50,6,85,California,Santa Clara County,1,14,60577,28245,32332
50,6,85,California,Santa Clara County,1,15,45944,20889,25055
50,6,85,California,Santa Clara County,1,16,35666,15797,19869
50,6,85,California,Santa Clara County,1,17,27282,11270,16012
50,6,85,California,Santa Clara County,1,18,27475,9803,17672
50,6,85,California,Santa Clara County,2,0,1781680,893865,887815
50,6,85,California,Santa Clara County,2,1,124467,63661,60806
50,6,85,California,Santa Clara County,2,2,121931,62323,59608
50,6,85,California,Santa Clara County,2,3,113572,58181,55391
50,6,85,California,Santa Clara County,2,4,114546,59564,54982
50,6,85,California,Santa Clara County,2,5,113119,60070,53049
50,6,85,California,Santa Clara County,2,6,133545,68923,64622
50,6,85,California,Santa Clara County,2,7,136022,69292,66730
50,6,85,California,Santa Clara County,2,8,140751,71299,69452
50,6,85,California,Santa Clara County,2,9,137620,69927,67693
50,6,85,California,Santa Clara County,2,10,138125,70724,67401
50,6,85,California,Santa Clara County,2,11,125490,63606,61884
50,6,85,California,Santa Clara County,2,12,102414,50394,52020
50,6,85,California,Santa Clara County,2,13,83135,39897,43238
50,6,85,California,Santa Clara County,2,14,60576,28245,32331
50,6,85,California,Santa Clara County,2,15,45944,20889,25055
50,6,85,California,Santa Clara County,2,16,35666,15797,19869
50,6,85,California,Santa Clara County,2,17,27282,11270,16012
50,6,85,California,Santa Clara County,2,18,27475,9803,17672
50,6,85,California,Santa Clara County,3,0,1786001,895833,890168
50,6,85,California,Santa Clara County,3,1,124326,63591,60735
50,6,85,California,Santa Clara County,3,2,122188,62425,59763
50,6,85,California,Santa Clara County,3,3,114039,58390,55649
50,6,85,California,Santa Clara County,3,4,114346,59372,54974
50,6,85,California,Santa Clara County,3,5,113095,59949,53146
50,6,85,California,Santa Clara County,3,6,133582,69077,64505
50,6,85,California,Santa Clara County,3,7,136006,69202,66804
50,6,85,California,Santa Clara County,3,8,140516,71204,69312
50,6,85,California,Santa Clara County,3,9,137964,70040,67924
50,6,85,California,Santa Clara County,3,10,137966,70646,67320
50,6,85,California,Santa Clara County,3,11,126227,63993,62234
50,6,85,California,Santa Clara County,3,12,103319,50897,52422
50,6,85,California,Santa Clara County,3,13,83990,40256,43734
50,6,85,California,Santa Clara County,3,14,61162,28592,32570
50,6,85,California,Santa Clara County,3,15,46281,21020,25261
50,6,85,California,Santa Clara County,3,16,35728,15840,19888
50,6,85,California,Santa Clara County,3,17,27427,11377,16050
50,6,85,California,Santa Clara County,3,18,27839,9962,17877
50,6,85,California,Santa Clara County,4,0,1811891,909115,902776
50,6,85,California,Santa Clara County,4,1,124136,63664,60472
50,6,85,California,Santa Clara County,4,2,123735,63140,60595
50,6,85,California,Santa Clara County,4,3,116021,59382,56639
50,6,85,California,Santa Clara County,4,4,113730,58742,54988
50,6,85,California,Santa Clara County,4,5,114740,60644,54096
50,6,85,California,Santa Clara County,4,6,135098,70398,64700
50,6,85,California,Santa Clara County,4,7,137948,70152,67796
50,6,85,California,Santa Clara County,4,8,139715,71057,68658
50,6,85,California,Santa Clara County,4,9,140016,70819,69197
50,6,85,California,Santa Clara County,4,10,137210,70274,66936
50,6,85,California,Santa Clara County,4,11,129187,65581,63606
50,6,85,California,Santa Clara County,4,12,107362,53154,54208
50,6,85,California,Santa Clara County,4,13,87902,42053,45849
50,6,85,California,Santa Clara County,4,14,63633,29883,33750
50,6,85,California,Santa Clara County,4,15,47852,21640,26212
50,6,85,California,Santa Clara County,4,16,36448,16232,20216
50,6,85,California,Santa Clara County,4,17,27920,11764,16156
50,6,85,California,Santa Clara County,4,18,29238,10536,18702
50,6,85,California,Santa Clara County,5,0,1837605,922963,914642
50,6,85,California,Santa Clara County,5,1,122621,62727,59894
50,6,85,California,Santa Clara County,5,2,125719,64282,61437
50,6,85,California,Santa Clara County,5,3,117136,59975,57161
50,6,85,California,Santa Clara County,5,4,113555,58438,55117
50,6,85,California,Santa Clara County,5,5,116915,61810,55105
50,6,85,California,Santa Clara County,5,6,136679,71863,64816
50,6,85,California,Santa Clara County,5,7,140727,71729,68998
50,6,85,California,Santa Clara County,5,8,139552,71340,68212
50,6,85,California,Santa Clara County,5,9,142181,71843,70338
50,6,85,California,Santa Clara County,5,10,136022,69468,66554
50,6,85,California,Santa Clara County,5,11,131374,66840,64534
50,6,85,California,Santa Clara County,5,12,111663,55480,56183
50,6,85,California,Santa Clara County,5,13,88710,42564,46146
50,6,85,California,Santa Clara County,5,14,68390,32118,36272
50,6,85,California,Santa Clara County,5,15,49886,22620,27266
50,6,85,California,Santa Clara County,5,16,37561,16743,20818
50,6,85,California,Santa Clara County,5,17,28464,12077,16387
50,6,85,California,Santa Clara County,5,18,30450,11046,19404
50,6,85,California,Santa Clara County,6,0,1866050,937941,928109
50,6,85,California,Santa Clara County,6,1,122001,62535,59466
50,6,85,California,Santa Clara County,6,2,127058,64975,62083
50,6,85,California,Santa Clara County,6,3,119279,61058,58221
50,6,85,California,Santa Clara County,6,4,113225,58090,55135
50,6,85,California,Santa Clara County,6,5,119602,63282,56320
50,6,85,California,Santa Clara County,6,6,138639,73208,65431
50,6,85,California,Santa Clara County,6,7,144692,74425,70267
50,6,85,California,Santa Clara County,6,8,139733,71276,68457
50,6,85,California,Santa Clara County,6,9,143002,72319,70683
50,6,85,California,Santa Clara County,6,10,135494,68960,66534
50,6,85,California,Santa Clara County,6,11,133485,67796,65689
50,6,85,California,Santa Clara County,6,12,115431,57711,57720
50,6,85,California,Santa Clara County,6,13,91171,43777,47394
50,6,85,California,Santa Clara County,6,14,71325,33486,37839
50,6,85,California,Santa Clara County,6,15,52305,23810,28495
50,6,85,California,Santa Clara County,6,16,38930,17326,21604
50,6,85,California,Santa Clara County,6,17,29116,12449,16667
50,6,85,California,Santa Clara County,6,18,31562,11458,20104
50,6,85,California,Santa Clara County,7,0,1891286,952164,939122
50,6,85,California,Santa Clara County,7,1,121259,62206,59053
50,6,85,California,Santa Clara County,7,2,126387,64740,61647
50,6,85,California,Santa Clara County,7,3,121150,61961,59189
50,6,85,California,Santa Clara County,7,4,113036,58035,55001
50,6,85,California,Santa Clara County,7,5,122231,64761,57470
50,6,85,California,Santa Clara County,7,6,142131,75388,66743
50,6,85,California,Santa Clara County,7,7,148814,77100,71714
50,6,85,California,Santa Clara County,7,8,140137,71751,68386
50,6,85,California,Santa Clara County,7,9,142081,71820,70261
50,6,85,California,Santa Clara County,7,10,135404,68649,66755
50,6,85,California,Santa Clara County,7,11,135002,68722,66280
50,6,85,California,Santa Clara County,7,12,118171,59417,58754
50,6,85,California,Santa Clara County,7,13,94049,45244,48805
50,6,85,California,Santa Clara County,7,14,74344,34853,39491
50,6,85,California,Santa Clara County,7,15,54326,24747,29579
50,6,85,California,Santa Clara County,7,16,40605,18101,22504
50,6,85,California,Santa Clara County,7,17,29588,12744,16844
50,6,85,California,Santa Clara County,7,18,32571,11925,20646
50,6,85,California,Santa Clara County,8,0,1915736,965904,949832
50,6,85,California,Santa Clara County,8,1,121205,62192,59013
50,6,85,California,Santa Clara County,8,2,125129,64077,61052
50,6,85,California,Santa Clara County,8,3,122042,62437,59605
50,6,85,California,Santa Clara County,8,4,113380,58176,55204
50,6,85,California,Santa Clara County,8,5,123243,65115,58128
50,6,85,California,Santa Clara County,8,6,147506,78837,68669
50,6,85,California,Santa Clara County,8,7,152554,79470,73084
50,6,85,California,Santa Clara County,8,8,141356,72687,68669
50,6,85,California,Santa Clara County,8,9,140343,70870,69473
50,6,85,California,Santa Clara County,8,10,136661,69176,67485
50,6,85,California,Santa Clara County,8,11,134463,68643,65820
50,6,85,California,Santa Clara County,8,12,121155,61008,60147
50,6,85,California,Santa Clara County,8,13,96942,46890,50052
50,6,85,California,Santa Clara County,8,14,77636,36396,41240
50,6,85,California,Santa Clara County,8,15,56384,25755,30629
50,6,85,California,Santa Clara County,8,16,41901,18702,23199
50,6,85,California,Santa Clara County,8,17,30068,12879,17189
50,6,85,California,Santa Clara County,8,18,33768,12594,21174
50,6,85,California,Santa Clara County,9,0,1928144,973172,954972
50,6,85,California,Santa Clara County,9,1,119646,61242,58404
50,6,85,California,Santa Clara County,9,2,122938,62974,59964
50,6,85,California,Santa Clara County,9,3,122226,62476,59750
50,6,85,California,Santa Clara County,9,4,113932,58481,55451
50,6,85,California,Santa Clara County,9,5,121900,64122,57778
50,6,85,California,Santa Clara County,9,6,152549,82100,70449
50,6,85,California,Santa Clara County,9,7,155430,81776,73654
50,6,85,California,Santa Clara County,9,8,142288,73158,69130
50,6,85,California,Santa Clara County,9,9,137995,69928,68067
50,6,85,California,Santa Clara County,9,10,137255,69237,68018
50,6,85,California,Santa Clara County,9,11,132725,67756,64969
50,6,85,California,Santa Clara County,9,12,122823,61984,60839
50,6,85,California,Santa Clara County,9,13,99460,48316,51144
50,6,85,California,Santa Clara County,9,14,80376,37658,42718
50,6,85,California,Santa Clara County,9,15,58058,26606,31452
50,6,85,California,Santa Clara County,9,16,42958,19026,23932
50,6,85,California,Santa Clara County,9,17,30698,13226,17472
50,6,85,California,Santa Clara County,9,18,34887,13106,21781
50,6,85,California,Santa Clara County,10,0,1932251,977237,955014
50,6,85,California,Santa Clara County,10,1,117948,60686,57262
50,6,85,California,Santa Clara County,10,2,119653,61218,58435
50,6,85,California,Santa Clara County,10,3,122359,62658,59701
50,6,85,California,Santa Clara County,10,4,113941,58516,55425
50,6,85,California,Santa Clara County,10,5,120029,63157,56872
50,6,85,California,Santa Clara County,10,6,156408,84678,71730
50,6,85,California,Santa Clara County,10,7,155807,82734,73073
50,6,85,California,Santa Clara County,10,8,143477,74074,69403
50,6,85,California,Santa Clara County,10,9,135587,68727,66860
50,6,85,California,Santa Clara County,10,10,137537,69396,68141
50,6,85,California,Santa Clara County,10,11,130189,66197,63992
50,6,85,California,Santa Clara County,10,12,123329,62434,60895
50,6,85,California,Santa Clara County,10,13,102175,49883,52292
50,6,85,California,Santa Clara County,10,14,80366,37791,42575
50,6,85,California,Santa Clara County,10,15,61717,28220,33497
50,6,85,California,Santa Clara County,10,16,44435,19698,24737
50,6,85,California,Santa Clara County,10,17,31481,13566,17915
50,6,85,California,Santa Clara County,10,18,35813,13604,22209
50,6,85,California,Santa Clara County,11,0,1931985,978478,953507
50,6,85,California,Santa Clara County,11,1,114771,59010,55761
50,6,85,California,Santa Clara County,11,2,116749,59714,57035
50,6,85,California,Santa Clara County,11,3,121751,62472,59279
50,6,85,California,Santa Clara County,11,4,114576,58756,55820
50,6,85,California,Santa Clara County,11,5,118106,62006,56100
50,6,85,California,Santa Clara County,11,6,158510,86218,72292
50,6,85,California,Santa Clara County,11,7,156585,83645,72940
50,6,85,California,Santa Clara County,11,8,145557,75676,69881
50,6,85,California,Santa Clara County,11,9,133140,67605,65535
50,6,85,California,Santa Clara County,11,10,135806,68430,67376
50,6,85,California,Santa Clara County,11,11,128007,64988,63019
50,6,85,California,Santa Clara County,11,12,123847,62623,61224
50,6,85,California,Santa Clara County,11,13,104248,51327,52921
50,6,85,California,Santa Clara County,11,14,81472,38421,43051
50,6,85,California,Santa Clara County,11,15,63408,28921,34487
50,6,85,California,Santa Clara County,11,16,46250,20588,25662
50,6,85,California,Santa Clara County,11,17,32490,14014,18476
50,6,85,California,Santa Clara County,11,18,36712,14064,22648
50,6,85,California,Santa Clara County,12,0,1922411,974693,947718
50,6,85,California,Santa Clara County,12,1,111443,57194,54249
50,6,85,California,Santa Clara County,12,2,114032,58355,55677
50,6,85,California,Santa Clara County,12,3,119019,61104,57915
50,6,85,California,Santa Clara County,12,4,114904,58926,55978
50,6,85,California,Santa Clara County,12,5,115389,60371,55018
50,6,85,California,Santa Clara County,12,6,158429,86522,71907
50,6,85,California,Santa Clara County,12,7,156919,84202,72717
50,6,85,California,Santa Clara County,12,8,146482,76667,69815
50,6,85,California,Santa Clara County,12,9,130649,66387,64262
50,6,85,California,Santa Clara County,12,10,133066,67011,66055
50,6,85,California,Santa Clara County,12,11,126168,63801,62367
50,6,85,California,Santa Clara County,12,12,123673,62685,60988
50,6,85,California,Santa Clara County,12,13,105368,52297,53071
50,6,85,California,Santa Clara County,12,14,82681,39113,43568
50,6,85,California,Santa Clara County,12,15,65313,29767,35546
50,6,85,California,Santa Clara County,12,16,47721,21224,26497
50,6,85,California,Santa Clara County,12,17,33630,14531,19099
50,6,85,California,Santa Clara County,12,18,37525,14536,22989
50,6,85,California,Santa Clara County,13,0,1913192,970630,942562
50,6,85,California,Santa Clara County,13,1,108885,55881,53004
50,6,85,California,Santa Clara County,13,2,112582,57662,54920
50,6,85,California,Santa Clara County,13,3,116753,59903,56850
50,6,85,California,Santa Clara County,13,4,115058,58944,56114
50,6,85,California,Santa Clara County,13,5,113644,59347,54297
50,6,85,California,Santa Clara County,13,6,155414,84849,70565
50,6,85,California,Santa Clara County,13,7,158473,85436,73037
50,6,85,California,Santa Clara County,13,8,146331,76725,69606
50,6,85,California,Santa Clara County,13,9,129621,66096,63525
50,6,85,California,Santa Clara County,13,10,130428,65569,64859
50,6,85,California,Santa Clara County,13,11,125715,63482,62233
50,6,85,California,Santa Clara County,13,12,122459,62224,60235
50,6,85,California,Santa Clara County,13,13,106628,53098,53530
50,6,85,California,Santa Clara County,13,14,83241,39524,43717
50,6,85,California,Santa Clara County,13,15,67007,30610,36397
50,6,85,California,Santa Clara County,13,16,48562,21634,26928
50,6,85,California,Santa Clara County,13,17,34312,14829,19483
50,6,85,California,Santa Clara County,13,18,38079,14817,23262
50,6,85,California,Santa Clara County,14,0,1907105,967756,939349
50,6,85,California,Santa Clara County,14,1,107868,55339,52529
50,6,85,California,Santa Clara County,14,2,111805,57285,54520
50,6,85,California,Santa Clara County,14,3,115980,59490,56490
50,6,85,California,Santa Clara County,14,4,114697,58742,55955
50,6,85,California,Santa Clara County,14,5,112721,58826,53895
50,6,85,California,Santa Clara County,14,6,153916,84044,69872
50,6,85,California,Santa Clara County,14,7,158755,85722,73033
50,6,85,California,Santa Clara County,14,8,146237,76742,69495
50,6,85,California,Santa Clara County,14,9,129149,65923,63226
50,6,85,California,Santa Clara County,14,10,129495,65064,64431
50,6,85,California,Santa Clara County,14,11,125692,63441,62251
50,6,85,California,Santa Clara County,14,12,121922,62024,59898
50,6,85,California,Santa Clara County,14,13,106957,53292,53665
50,6,85,California,Santa Clara County,14,14,83390,39654,43736
50,6,85,California,Santa Clara County,14,15,67362,30781,36581
50,6,85,California,Santa Clara County,14,16,48731,21710,27021
50,6,85,California,Santa Clara County,14,17,34447,14887,19560
50,6,85,California,Santa Clara County,14,18,37981,14790,23191
50,6,87,California,Santa Cruz County,1,0,262382,130913,131469
50,6,87,California,Santa Cruz County,1,1,15045,7744,7301
50,6,87,California,Santa Cruz County,1,2,15071,7700,7371
50,6,87,California,Santa Cruz County,1,3,15347,7916,7431
50,6,87,California,Santa Cruz County,1,4,21834,10966,10868
50,6,87,California,Santa Cruz County,1,5,24391,12735,11656
50,6,87,California,Santa Cruz County,1,6,17597,9155,8442
50,6,87,California,Santa Cruz County,1,7,16152,8228,7924
50,6,87,California,Santa Cruz County,1,8,15918,8161,7757
50,6,87,California,Santa Cruz County,1,9,17157,8598,8559
50,6,87,California,Santa Cruz County,1,10,18712,9244,9468
50,6,87,California,Santa Cruz County,1,11,20065,9840,10225
50,6,87,California,Santa Cruz County,1,12,19781,9800,9981
50,6,87,California,Santa Cruz County,1,13,16154,8155,7999
50,6,87,California,Santa Cruz County,1,14,9699,4713,4986
50,6,87,California,Santa Cruz County,1,15,6175,2882,3293
50,6,87,California,Santa Cruz County,1,16,4591,1933,2658
50,6,87,California,Santa Cruz County,1,17,4077,1586,2491
50,6,87,California,Santa Cruz County,1,18,4616,1557,3059
50,6,87,California,Santa Cruz County,2,0,262345,130899,131446
50,6,87,California,Santa Cruz County,2,1,15041,7743,7298
50,6,87,California,Santa Cruz County,2,2,15067,7698,7369
50,6,87,California,Santa Cruz County,2,3,15345,7915,7430
50,6,87,California,Santa Cruz County,2,4,21832,10966,10866
50,6,87,California,Santa Cruz County,2,5,24389,12734,11655
50,6,87,California,Santa Cruz County,2,6,17595,9155,8440
50,6,87,California,Santa Cruz County,2,7,16150,8229,7921
50,6,87,California,Santa Cruz County,2,8,15917,8161,7756
50,6,87,California,Santa Cruz County,2,9,17155,8596,8559
50,6,87,California,Santa Cruz County,2,10,18707,9241,9466
50,6,87,California,Santa Cruz County,2,11,20057,9836,10221
50,6,87,California,Santa Cruz County,2,12,19779,9799,9980
50,6,87,California,Santa Cruz County,2,13,16152,8155,7997
50,6,87,California,Santa Cruz County,2,14,9700,4713,4987
50,6,87,California,Santa Cruz County,2,15,6175,2882,3293
50,6,87,California,Santa Cruz County,2,16,4591,1933,2658
50,6,87,California,Santa Cruz County,2,17,4077,1586,2491
50,6,87,California,Santa Cruz County,2,18,4616,1557,3059
50,6,87,California,Santa Cruz County,3,0,263174,131242,131932
50,6,87,California,Santa Cruz County,3,1,15139,7793,7346
50,6,87,California,Santa Cruz County,3,2,15046,7691,7355
50,6,87,California,Santa Cruz County,3,3,15306,7888,7418
50,6,87,California,Santa Cruz County,3,4,22240,11117,11123
50,6,87,California,Santa Cruz County,3,5,24825,12924,11901
50,6,87,California,Santa Cruz County,3,6,17375,9058,8317
50,6,87,California,Santa Cruz County,3,7,16197,8246,7951
50,6,87,California,Santa Cruz County,3,8,15836,8127,7709
50,6,87,California,Santa Cruz County,3,9,17124,8585,8539
50,6,87,California,Santa Cruz County,3,10,18544,9179,9365
50,6,87,California,Santa Cruz County,3,11,19956,9781,10175
50,6,87,California,Santa Cruz County,3,12,19807,9787,10020
50,6,87,California,Santa Cruz County,3,13,16380,8284,8096
50,6,87,California,Santa Cruz County,3,14,9872,4789,5083
50,6,87,California,Santa Cruz County,3,15,6213,2895,3318
50,6,87,California,Santa Cruz County,3,16,4625,1954,2671
50,6,87,California,Santa Cruz County,3,17,4048,1576,2472
50,6,87,California,Santa Cruz County,3,18,4641,1568,3073
50,6,87,California,Santa Cruz County,4,0,264927,131932,132995
50,6,87,California,Santa Cruz County,4,1,15256,7820,7436
50,6,87,California,Santa Cruz County,4,2,15080,7668,7412
50,6,87,California,Santa Cruz County,4,3,15198,7865,7333
50,6,87,California,Santa Cruz County,4,4,22442,11131,11311
50,6,87,California,Santa Cruz County,4,5,26062,13545,12517
50,6,87,California,Santa Cruz County,4,6,16643,8750,7893
50,6,87,California,Santa Cruz County,4,7,16305,8191,8114
50,6,87,California,Santa Cruz County,4,8,15456,7892,7564
50,6,87,California,Santa Cruz County,4,9,17089,8602,8487
50,6,87,California,Santa Cruz County,4,10,17896,8869,9027
50,6,87,California,Santa Cruz County,4,11,19651,9636,10015
50,6,87,California,Santa Cruz County,4,12,19862,9747,10115
50,6,87,California,Santa Cruz County,4,13,17434,8813,8621
50,6,87,California,Santa Cruz County,4,14,10586,5122,5464
50,6,87,California,Santa Cruz County,4,15,6526,3057,3469
50,6,87,California,Santa Cruz County,4,16,4774,2069,2705
50,6,87,California,Santa Cruz County,4,17,3978,1549,2429
50,6,87,California,Santa Cruz County,4,18,4689,1606,3083
50,6,87,California,Santa Cruz County,5,0,266391,132529,133862
50,6,87,California,Santa Cruz County,5,1,15227,7742,7485
50,6,87,California,Santa Cruz County,5,2,15207,7741,7466
50,6,87,California,Santa Cruz County,5,3,15012,7799,7213
50,6,87,California,Santa Cruz County,5,4,22306,10959,11347
50,6,87,California,Santa Cruz County,5,5,27153,14002,13151
50,6,87,California,Santa Cruz County,5,6,15889,8373,7516
50,6,87,California,Santa Cruz County,5,7,16314,8262,8052
50,6,87,California,Santa Cruz County,5,8,15505,7839,7666
50,6,87,California,Santa Cruz County,5,9,16858,8561,8297
50,6,87,California,Santa Cruz County,5,10,17470,8638,8832
50,6,87,California,Santa Cruz County,5,11,19195,9494,9701
50,6,87,California,Santa Cruz County,5,12,19889,9647,10242
50,6,87,California,Santa Cruz County,5,13,17636,8884,8752
50,6,87,California,Santa Cruz County,5,14,12032,5899,6133
50,6,87,California,Santa Cruz County,5,15,7084,3333,3751
50,6,87,California,Santa Cruz County,5,16,4852,2146,2706
50,6,87,California,Santa Cruz County,5,17,3949,1568,2381
50,6,87,California,Santa Cruz County,5,18,4813,1642,3171
50,6,87,California,Santa Cruz County,6,0,268836,133627,135209
50,6,87,California,Santa Cruz County,6,1,15103,7716,7387
50,6,87,California,Santa Cruz County,6,2,15370,7856,7514
50,6,87,California,Santa Cruz County,6,3,14880,7638,7242
50,6,87,California,Santa Cruz County,6,4,22382,11009,11373
50,6,87,California,Santa Cruz County,6,5,28151,14413,13738
50,6,87,California,Santa Cruz County,6,6,15694,8241,7453
50,6,87,California,Santa Cruz County,6,7,16415,8352,8063
50,6,87,California,Santa Cruz County,6,8,15702,7939,7763
50,6,87,California,Santa Cruz County,6,9,16563,8378,8185
50,6,87,California,Santa Cruz County,6,10,17158,8503,8655
50,6,87,California,Santa Cruz County,6,11,18825,9329,9496
50,6,87,California,Santa Cruz County,6,12,19688,9520,10168
50,6,87,California,Santa Cruz County,6,13,18197,9143,9054
50,6,87,California,Santa Cruz County,6,14,13047,6405,6642
50,6,87,California,Santa Cruz County,6,15,7826,3687,4139
50,6,87,California,Santa Cruz County,6,16,5003,2279,2724
50,6,87,California,Santa Cruz County,6,17,3931,1562,2369
50,6,87,California,Santa Cruz County,6,18,4901,1657,3244
50,6,87,California,Santa Cruz County,7,0,270863,134520,136343
50,6,87,California,Santa Cruz County,7,1,15013,7673,7340
50,6,87,California,Santa Cruz County,7,2,15140,7720,7420
50,6,87,California,Santa Cruz County,7,3,15016,7717,7299
50,6,87,California,Santa Cruz County,7,4,22214,10897,11317
50,6,87,California,Santa Cruz County,7,5,28382,14497,13885
50,6,87,California,Santa Cruz County,7,6,16163,8531,7632
50,6,87,California,Santa Cruz County,7,7,16439,8339,8100
50,6,87,California,Santa Cruz County,7,8,15844,7949,7895
50,6,87,California,Santa Cruz County,7,9,16221,8265,7956
50,6,87,California,Santa Cruz County,7,10,16922,8400,8522
50,6,87,California,Santa Cruz County,7,11,18654,9215,9439
50,6,87,California,Santa Cruz County,7,12,19479,9452,10027
50,6,87,California,Santa Cruz County,7,13,18591,9189,9402
50,6,87,California,Santa Cruz County,7,14,14156,7019,7137
50,6,87,California,Santa Cruz County,7,15,8476,4024,4452
50,6,87,California,Santa Cruz County,7,16,5281,2412,2869
50,6,87,California,Santa Cruz County,7,17,3886,1552,2334
50,6,87,California,Santa Cruz County,7,18,4986,1669,3317
50,6,87,California,Santa Cruz County,8,0,273495,135778,137717
50,6,87,California,Santa Cruz County,8,1,14963,7716,7247
50,6,87,California,Santa Cruz County,8,2,15048,7703,7345
50,6,87,California,Santa Cruz County,8,3,15055,7641,7414
50,6,87,California,Santa Cruz County,8,4,22441,11063,11378
50,6,87,California,Santa Cruz County,8,5,28611,14372,14239
50,6,87,California,Santa Cruz County,8,6,16682,8871,7811
50,6,87,California,Santa Cruz County,8,7,16241,8198,8043
50,6,87,California,Santa Cruz County,8,8,16072,8094,7978
50,6,87,California,Santa Cruz County,8,9,15790,7974,7816
50,6,87,California,Santa Cruz County,8,10,17101,8579,8522
50,6,87,California,Santa Cruz County,8,11,18371,9062,9309
50,6,87,California,Santa Cruz County,8,12,19300,9407,9893
50,6,87,California,Santa Cruz County,8,13,18878,9283,9595
50,6,87,California,Santa Cruz County,8,14,15226,7589,7637
50,6,87,California,Santa Cruz County,8,15,9140,4319,4821
50,6,87,California,Santa Cruz County,8,16,5604,2584,3020
50,6,87,California,Santa Cruz County,8,17,3885,1573,2312
50,6,87,California,Santa Cruz County,8,18,5087,1750,3337
50,6,87,California,Santa Cruz County,9,0,274476,136157,138319
50,6,87,California,Santa Cruz County,9,1,14665,7558,7107
50,6,87,California,Santa Cruz County,9,2,15029,7697,7332
50,6,87,California,Santa Cruz County,9,3,15063,7588,7475
50,6,87,California,Santa Cruz County,9,4,22423,11074,11349
50,6,87,California,Santa Cruz County,9,5,28399,14203,14196
50,6,87,California,Santa Cruz County,9,6,17299,9159,8140
50,6,87,California,Santa Cruz County,9,7,15985,8143,7842
50,6,87,California,Santa Cruz County,9,8,16288,8146,8142
50,6,87,California,Santa Cruz County,9,9,15502,7784,7718
50,6,87,California,Santa Cruz County,9,10,17221,8707,8514
50,6,87,California,Santa Cruz County,9,11,17692,8742,8950
50,6,87,California,Santa Cruz County,9,12,18986,9260,9726
50,6,87,California,Santa Cruz County,9,13,18880,9237,9643
50,6,87,California,Santa Cruz County,9,14,16307,8133,8174
50,6,87,California,Santa Cruz County,9,15,9818,4632,5186
50,6,87,California,Santa Cruz County,9,16,5835,2661,3174
50,6,87,California,Santa Cruz County,9,17,4032,1700,2332
50,6,87,California,Santa Cruz County,9,18,5052,1733,3319
50,6,87,California,Santa Cruz County,10,0,274865,136219,138646
50,6,87,California,Santa Cruz County,10,1,14220,7285,6935
50,6,87,California,Santa Cruz County,10,2,14832,7534,7298
50,6,87,California,Santa Cruz County,10,3,15165,7690,7475
50,6,87,California,Santa Cruz County,10,4,22525,11167,11358
50,6,87,California,Santa Cruz County,10,5,28040,13897,14143
50,6,87,California,Santa Cruz County,10,6,17742,9452,8290
50,6,87,California,Santa Cruz County,10,7,15652,7983,7669
50,6,87,California,Santa Cruz County,10,8,16373,8194,8179
50,6,87,California,Santa Cruz County,10,9,15637,7776,7861
50,6,87,California,Santa Cruz County,10,10,16983,8618,8365
50,6,87,California,Santa Cruz County,10,11,17211,8531,8680
50,6,87,California,Santa Cruz County,10,12,18579,9081,9498
50,6,87,California,Santa Cruz County,10,13,18791,9090,9701
50,6,87,California,Santa Cruz County,10,14,16431,8165,8266
50,6,87,California,Santa Cruz County,10,15,11197,5352,5845
50,6,87,California,Santa Cruz County,10,16,6369,2914,3455
50,6,87,California,Santa Cruz County,10,17,4099,1748,2351
50,6,87,California,Santa Cruz County,10,18,5019,1742,3277
50,6,87,California,Santa Cruz County,11,0,273713,135441,138272
50,6,87,California,Santa Cruz County,11,1,13701,7028,6673
50,6,87,California,Santa Cruz County,11,2,14650,7457,7193
50,6,87,California,Santa Cruz County,11,3,15092,7709,7383
50,6,87,California,Santa Cruz County,11,4,22403,11027,11376
50,6,87,California,Santa Cruz County,11,5,27547,13653,13894
50,6,87,California,Santa Cruz County,11,6,17877,9414,8463
50,6,87,California,Santa Cruz County,11,7,15495,7905,7590
50,6,87,California,Santa Cruz County,11,8,16238,8118,8120
50,6,87,California,Santa Cruz County,11,9,15635,7774,7861
50,6,87,California,Santa Cruz County,11,10,16569,8388,8181
50,6,87,California,Santa Cruz County,11,11,16874,8378,8496
50,6,87,California,Santa Cruz County,11,12,18092,8814,9278
50,6,87,California,Santa Cruz County,11,13,18477,8947,9530
50,6,87,California,Santa Cruz County,11,14,16718,8270,8448
50,6,87,California,Santa Cruz County,11,15,12045,5760,6285
50,6,87,California,Santa Cruz County,11,16,6997,3204,3793
50,6,87,California,Santa Cruz County,11,17,4230,1854,2376
50,6,87,California,Santa Cruz County,11,18,5073,1741,3332
50,6,87,California,Santa Cruz County,12,0,272870,134954,137916
50,6,87,California,Santa Cruz County,12,1,13288,6733,6555
50,6,87,California,Santa Cruz County,12,2,14410,7411,6999
50,6,87,California,Santa Cruz County,12,3,14822,7569,7253
50,6,87,California,Santa Cruz County,12,4,22716,11177,11539
50,6,87,California,Santa Cruz County,12,5,27139,13474,13665
50,6,87,California,Santa Cruz County,12,6,17587,9289,8298
50,6,87,California,Santa Cruz County,12,7,15649,7964,7685
50,6,87,California,Santa Cruz County,12,8,16156,8093,8063
50,6,87,California,Santa Cruz County,12,9,15563,7716,7847
50,6,87,California,Santa Cruz County,12,10,16109,8186,7923
50,6,87,California,Santa Cruz County,12,11,16470,8194,8276
50,6,87,California,Santa Cruz County,12,12,17801,8653,9148
50,6,87,California,Santa Cruz County,12,13,18199,8796,9403
50,6,87,California,Santa Cruz County,12,14,16942,8259,8683
50,6,87,California,Santa Cruz County,12,15,12877,6215,6662
50,6,87,California,Santa Cruz County,12,16,7515,3471,4044
50,6,87,California,Santa Cruz County,12,17,4459,1971,2488
50,6,87,California,Santa Cruz County,12,18,5168,1783,3385
50,6,87,California,Santa Cruz County,13,0,270819,133853,136966
50,6,87,California,Santa Cruz County,13,1,12755,6446,6309
50,6,87,California,Santa Cruz County,13,2,14342,7379,6963
50,6,87,California,Santa Cruz County,13,3,14647,7531,7116
50,6,87,California,Santa Cruz County,13,4,22187,10868,11319
50,6,87,California,Santa Cruz County,13,5,26768,13321,13447
50,6,87,California,Santa Cruz County,13,6,17233,8994,8239
50,6,87,California,Santa Cruz County,13,7,15498,7981,7517
50,6,87,California,Santa Cruz County,13,8,15994,7997,7997
50,6,87,California,Santa Cruz County,13,9,15649,7774,7875
50,6,87,California,Santa Cruz County,13,10,15612,7900,7712
50,6,87,California,Santa Cruz County,13,11,16435,8201,8234
50,6,87,California,Santa Cruz County,13,12,17353,8444,8909
50,6,87,California,Santa Cruz County,13,13,17989,8663,9326
50,6,87,California,Santa Cruz County,13,14,17013,8240,8773
50,6,87,California,Santa Cruz County,13,15,13557,6595,6962
50,6,87,California,Santa Cruz County,13,16,7940,3644,4296
50,6,87,California,Santa Cruz County,13,17,4630,2067,2563
50,6,87,California,Santa Cruz County,13,18,5217,1808,3409
50,6,87,California,Santa Cruz County,14,0,269925,133360,136565
50,6,87,California,Santa Cruz County,14,1,12575,6345,6230
50,6,87,California,Santa Cruz County,14,2,14298,7357,6941
50,6,87,California,Santa Cruz County,14,3,14582,7511,7071
50,6,87,California,Santa Cruz County,14,4,21987,10752,11235
50,6,87,California,Santa Cruz County,14,5,26613,13254,13359
50,6,87,California,Santa Cruz County,14,6,17094,8881,8213
50,6,87,California,Santa Cruz County,14,7,15454,7989,7465
50,6,87,California,Santa Cruz County,14,8,15960,7979,7981
50,6,87,California,Santa Cruz County,14,9,15682,7793,7889
50,6,87,California,Santa Cruz County,14,10,15448,7804,7644
50,6,87,California,Santa Cruz County,14,11,16452,8214,8238
50,6,87,California,Santa Cruz County,14,12,17190,8370,8820
50,6,87,California,Santa Cruz County,14,13,17894,8601,9293
50,6,87,California,Santa Cruz County,14,14,17034,8234,8800
50,6,87,California,Santa Cruz County,14,15,13737,6695,7042
50,6,87,California,Santa Cruz County,14,16,8054,3691,4363
50,6,87,California,Santa Cruz County,14,17,4678,2091,2587
50,6,87,California,Santa Cruz County,14,18,5193,1799,3394
50,6,89,California,Shasta County,1,0,177223,87130,90093
50,6,89,California,Shasta County,1,1,10268,5307,4961
50,6,89,California,Shasta County,1,2,10537,5375,5162
50,6,89,California,Shasta County,1,3,11394,5967,5427
50,6,89,California,Shasta County,1,4,12439,6403,6036
50,6,89,California,Shasta County,1,5,11003,5667,5336
50,6,89,California,Shasta County,1,6,10526,5303,5223
50,6,89,California,Shasta County,1,7,9431,4788,4643
50,6,89,California,Shasta County,1,8,9198,4528,4670
50,6,89,California,Shasta County,1,9,10369,5106,5263
50,6,89,California,Shasta County,1,10,12895,6175,6720
50,6,89,California,Shasta County,1,11,13690,6627,7063
50,6,89,California,Shasta County,1,12,13367,6434,6933
50,6,89,California,Shasta County,1,13,12139,5929,6210
50,6,89,California,Shasta County,1,14,9576,4619,4957
50,6,89,California,Shasta County,1,15,6975,3332,3643
50,6,89,California,Shasta County,1,16,5333,2433,2900
50,6,89,California,Shasta County,1,17,4113,1719,2394
50,6,89,California,Shasta County,1,18,3970,1418,2552
50,6,89,California,Shasta County,2,0,177222,87129,90093
50,6,89,California,Shasta County,2,1,10268,5307,4961
50,6,89,California,Shasta County,2,2,10537,5375,5162
50,6,89,California,Shasta County,2,3,11394,5967,5427
50,6,89,California,Shasta County,2,4,12439,6403,6036
50,6,89,California,Shasta County,2,5,11003,5667,5336
50,6,89,California,Shasta County,2,6,10526,5303,5223
50,6,89,California,Shasta County,2,7,9431,4788,4643
50,6,89,California,Shasta County,2,8,9198,4528,4670
50,6,89,California,Shasta County,2,9,10369,5106,5263
50,6,89,California,Shasta County,2,10,12895,6175,6720
50,6,89,California,Shasta County,2,11,13690,6627,7063
50,6,89,California,Shasta County,2,12,13367,6434,6933
50,6,89,California,Shasta County,2,13,12138,5929,6209
50,6,89,California,Shasta County,2,14,9575,4618,4957
50,6,89,California,Shasta County,2,15,6975,3332,3643
50,6,89,California,Shasta County,2,16,5333,2433,2900
50,6,89,California,Shasta County,2,17,4113,1719,2394
50,6,89,California,Shasta County,2,18,3971,1418,2553
50,6,89,California,Shasta County,3,0,177277,87141,90136
50,6,89,California,Shasta County,3,1,10277,5297,4980
50,6,89,California,Shasta County,3,2,10521,5363,5158
50,6,89,California,Shasta County,3,3,11325,5932,5393
50,6,89,California,Shasta County,3,4,12261,6328,5933
50,6,89,California,Shasta County,3,5,11132,5722,5410
50,6,89,California,Shasta County,3,6,10566,5334,5232
50,6,89,California,Shasta County,3,7,9527,4831,4696
50,6,89,California,Shasta County,3,8,9118,4499,4619
50,6,89,California,Shasta County,3,9,10363,5091,5272
50,6,89,California,Shasta County,3,10,12780,6122,6658
50,6,89,California,Shasta County,3,11,13658,6610,7048
50,6,89,California,Shasta County,3,12,13410,6448,6962
50,6,89,California,Shasta County,3,13,12258,5980,6278
50,6,89,California,Shasta County,3,14,9604,4641,4963
50,6,89,California,Shasta County,3,15,7057,3379,3678
50,6,89,California,Shasta County,3,16,5320,2427,2893
50,6,89,California,Shasta County,3,17,4109,1721,2388
50,6,89,California,Shasta County,3,18,3991,1416,2575
50,6,89,California,Shasta County,4,0,177613,87226,90387
50,6,89,California,Shasta County,4,1,10301,5260,5041
50,6,89,California,Shasta County,4,2,10535,5364,5171
50,6,89,California,Shasta County,4,3,11155,5832,5323
50,6,89,California,Shasta County,4,4,11645,6048,5597
50,6,89,California,Shasta County,4,5,11609,5917,5692
50,6,89,California,Shasta County,4,6,10671,5450,5221
50,6,89,California,Shasta County,4,7,9869,4961,4908
50,6,89,California,Shasta County,4,8,8840,4410,4430
50,6,89,California,Shasta County,4,9,10309,5051,5258
50,6,89,California,Shasta County,4,10,12133,5807,6326
50,6,89,California,Shasta County,4,11,13555,6513,7042
50,6,89,California,Shasta County,4,12,13556,6523,7033
50,6,89,California,Shasta County,4,13,12821,6219,6602
50,6,89,California,Shasta County,4,14,9762,4738,5024
50,6,89,California,Shasta County,4,15,7323,3514,3809
50,6,89,California,Shasta County,4,16,5373,2465,2908
50,6,89,California,Shasta County,4,17,4095,1734,2361
50,6,89,California,Shasta County,4,18,4061,1420,2641
50,6,89,California,Shasta County,5,0,177908,87315,90593
50,6,89,California,Shasta County,5,1,10380,5307,5073
50,6,89,California,Shasta County,5,2,10457,5279,5178
50,6,89,California,Shasta County,5,3,11080,5828,5252
50,6,89,California,Shasta County,5,4,11284,5876,5408
50,6,89,California,Shasta County,5,5,11641,5928,5713
50,6,89,California,Shasta County,5,6,10841,5490,5351
50,6,89,California,Shasta County,5,7,10190,5107,5083
50,6,89,California,Shasta County,5,8,8830,4417,4413
50,6,89,California,Shasta County,5,9,10060,4931,5129
50,6,89,California,Shasta County,5,10,11459,5464,5995
50,6,89,California,Shasta County,5,11,13529,6549,6980
50,6,89,California,Shasta County,5,12,13624,6539,7085
50,6,89,California,Shasta County,5,13,12621,6071,6550
50,6,89,California,Shasta County,5,14,10473,5053,5420
50,6,89,California,Shasta County,5,15,7638,3681,3957
50,6,89,California,Shasta County,5,16,5516,2547,2969
50,6,89,California,Shasta County,5,17,4139,1765,2374
50,6,89,California,Shasta County,5,18,4146,1483,2663
50,6,89,California,Shasta County,6,0,178447,87562,90885
50,6,89,California,Shasta County,6,1,10411,5339,5072
50,6,89,California,Shasta County,6,2,10591,5364,5227
50,6,89,California,Shasta County,6,3,11075,5749,5326
50,6,89,California,Shasta County,6,4,11015,5757,5258
50,6,89,California,Shasta County,6,5,11480,5905,5575
50,6,89,California,Shasta County,6,6,11034,5614,5420
50,6,89,California,Shasta County,6,7,10598,5278,5320
50,6,89,California,Shasta County,6,8,9016,4476,4540
50,6,89,California,Shasta County,6,9,9802,4844,4958
50,6,89,California,Shasta County,6,10,10932,5258,5674
50,6,89,California,Shasta County,6,11,13299,6410,6889
50,6,89,California,Shasta County,6,12,13543,6459,7084
50,6,89,California,Shasta County,6,13,12718,6085,6633
50,6,89,California,Shasta County,6,14,10857,5225,5632
50,6,89,California,Shasta County,6,15,8150,3913,4237
50,6,89,California,Shasta County,6,16,5635,2588,3047
50,6,89,California,Shasta County,6,17,4182,1816,2366
50,6,89,California,Shasta County,6,18,4109,1482,2627
50,6,89,California,Shasta County,7,0,178904,87831,91073
50,6,89,California,Shasta County,7,1,10549,5364,5185
50,6,89,California,Shasta County,7,2,10573,5382,5191
50,6,89,California,Shasta County,7,3,10934,5637,5297
50,6,89,California,Shasta County,7,4,10893,5715,5178
50,6,89,California,Shasta County,7,5,11208,5779,5429
50,6,89,California,Shasta County,7,6,11302,5739,5563
50,6,89,California,Shasta County,7,7,10832,5383,5449
50,6,89,California,Shasta County,7,8,9272,4647,4625
50,6,89,California,Shasta County,7,9,9627,4701,4926
50,6,89,California,Shasta County,7,10,10482,5145,5337
50,6,89,California,Shasta County,7,11,13109,6322,6787
50,6,89,California,Shasta County,7,12,13366,6371,6995
50,6,89,California,Shasta County,7,13,12963,6191,6772
50,6,89,California,Shasta County,7,14,11186,5370,5816
50,6,89,California,Shasta County,7,15,8434,4014,4420
50,6,89,California,Shasta County,7,16,5857,2694,3163
50,6,89,California,Shasta County,7,17,4150,1841,2309
50,6,89,California,Shasta County,7,18,4167,1536,2631
50,6,89,California,Shasta County,8,0,178386,87614,90772
50,6,89,California,Shasta County,8,1,10553,5421,5132
50,6,89,California,Shasta County,8,2,10498,5341,5157
50,6,89,California,Shasta County,8,3,10731,5474,5257
50,6,89,California,Shasta County,8,4,10728,5651,5077
50,6,89,California,Shasta County,8,5,10707,5471,5236
50,6,89,California,Shasta County,8,6,11539,5911,5628
50,6,89,California,Shasta County,8,7,10917,5422,5495
50,6,89,California,Shasta County,8,8,9599,4845,4754
50,6,89,California,Shasta County,8,9,9158,4503,4655
50,6,89,California,Shasta County,8,10,10296,5034,5262
50,6,89,California,Shasta County,8,11,12517,6001,6516
50,6,89,California,Shasta County,8,12,13422,6435,6987
50,6,89,California,Shasta County,8,13,13054,6181,6873
50,6,89,California,Shasta County,8,14,11597,5571,6026
50,6,89,California,Shasta County,8,15,8713,4151,4562
50,6,89,California,Shasta County,8,16,6038,2816,3222
50,6,89,California,Shasta County,8,17,4004,1753,2251
50,6,89,California,Shasta County,8,18,4315,1633,2682
50,6,89,California,Shasta County,9,0,178592,87709,90883
50,6,89,California,Shasta County,9,1,10556,5456,5100
50,6,89,California,Shasta County,9,2,10608,5380,5228
50,6,89,California,Shasta County,9,3,10675,5437,5238
50,6,89,California,Shasta County,9,4,10649,5575,5074
50,6,89,California,Shasta County,9,5,10248,5304,4944
50,6,89,California,Shasta County,9,6,11780,6003,5777
50,6,89,California,Shasta County,9,7,11075,5539,5536
50,6,89,California,Shasta County,9,8,10099,5056,5043
50,6,89,California,Shasta County,9,9,8844,4412,4432
50,6,89,California,Shasta County,9,10,10210,4961,5249
50,6,89,California,Shasta County,9,11,11824,5648,6176
50,6,89,California,Shasta County,9,12,13279,6324,6955
50,6,89,California,Shasta County,9,13,13194,6292,6902
50,6,89,California,Shasta County,9,14,12109,5789,6320
50,6,89,California,Shasta County,9,15,8858,4231,4627
50,6,89,California,Shasta County,9,16,6225,2905,3320
50,6,89,California,Shasta County,9,17,4048,1791,2257
50,6,89,California,Shasta County,9,18,4311,1606,2705
50,6,89,California,Shasta County,10,0,179403,88140,91263
50,6,89,California,Shasta County,10,1,10562,5396,5166
50,6,89,California,Shasta County,10,2,10796,5530,5266
50,6,89,California,Shasta County,10,3,10702,5420,5282
50,6,89,California,Shasta County,10,4,10532,5526,5006
50,6,89,California,Shasta County,10,5,9991,5188,4803
50,6,89,California,Shasta County,10,6,11947,6077,5870
50,6,89,California,Shasta County,10,7,11246,5618,5628
50,6,89,California,Shasta County,10,8,10490,5269,5221
50,6,89,California,Shasta County,10,9,8936,4474,4462
50,6,89,California,Shasta County,10,10,10079,4904,5175
50,6,89,California,Shasta County,10,11,11263,5323,5940
50,6,89,California,Shasta County,10,12,13357,6449,6908
50,6,89,California,Shasta County,10,13,13198,6277,6921
50,6,89,California,Shasta County,10,14,11978,5689,6289
50,6,89,California,Shasta County,10,15,9462,4495,4967
50,6,89,California,Shasta County,10,16,6443,3042,3401
50,6,89,California,Shasta County,10,17,4183,1844,2339
50,6,89,California,Shasta County,10,18,4238,1619,2619
50,6,89,California,Shasta County,11,0,179666,88276,91390
50,6,89,California,Shasta County,11,1,10579,5445,5134
50,6,89,California,Shasta County,11,2,10656,5469,5187
50,6,89,California,Shasta County,11,3,10760,5432,5328
50,6,89,California,Shasta County,11,4,10485,5493,4992
50,6,89,California,Shasta County,11,5,9784,5080,4704
50,6,89,California,Shasta County,11,6,11823,6000,5823
50,6,89,California,Shasta County,11,7,11419,5754,5665
50,6,89,California,Shasta County,11,8,10962,5461,5501
50,6,89,California,Shasta County,11,9,9164,4611,4553
50,6,89,California,Shasta County,11,10,9834,4808,5026
50,6,89,California,Shasta County,11,11,10761,5108,5653
50,6,89,California,Shasta County,11,12,13118,6324,6794
50,6,89,California,Shasta County,11,13,13210,6210,7000
50,6,89,California,Shasta County,11,14,11943,5668,6275
50,6,89,California,Shasta County,11,15,9802,4636,5166
50,6,89,California,Shasta County,11,16,6868,3248,3620
50,6,89,California,Shasta County,11,17,4281,1896,2385
50,6,89,California,Shasta County,11,18,4217,1633,2584
50,6,89,California,Shasta County,12,0,179645,88206,91439
50,6,89,California,Shasta County,12,1,10401,5415,4986
50,6,89,California,Shasta County,12,2,11030,5617,5413
50,6,89,California,Shasta County,12,3,10750,5463,5287
50,6,89,California,Shasta County,12,4,10376,5386,4990
50,6,89,California,Shasta County,12,5,9621,4981,4640
50,6,89,California,Shasta County,12,6,11555,5865,5690
50,6,89,California,Shasta County,12,7,11576,5818,5758
50,6,89,California,Shasta County,12,8,11250,5592,5658
50,6,89,California,Shasta County,12,9,9478,4786,4692
50,6,89,California,Shasta County,12,10,9646,4719,4927
50,6,89,California,Shasta County,12,11,10333,4942,5391
50,6,89,California,Shasta County,12,12,12913,6199,6714
50,6,89,California,Shasta County,12,13,12913,6058,6855
50,6,89,California,Shasta County,12,14,12115,5756,6359
50,6,89,California,Shasta County,12,15,10049,4734,5315
50,6,89,California,Shasta County,12,16,7083,3304,3779
50,6,89,California,Shasta County,12,17,4432,1966,2466
50,6,89,California,Shasta County,12,18,4124,1605,2519
50,6,89,California,Shasta County,13,0,179278,88034,91244
50,6,89,California,Shasta County,13,1,10246,5292,4954
50,6,89,California,Shasta County,13,2,11046,5702,5344
50,6,89,California,Shasta County,13,3,10824,5511,5313
50,6,89,California,Shasta County,13,4,10245,5277,4968
50,6,89,California,Shasta County,13,5,9616,4999,4617
50,6,89,California,Shasta County,13,6,11285,5717,5568
50,6,89,California,Shasta County,13,7,11778,5950,5828
50,6,89,California,Shasta County,13,8,11313,5603,5710
50,6,89,California,Shasta County,13,9,9800,4991,4809
50,6,89,California,Shasta County,13,10,9331,4573,4758
50,6,89,California,Shasta County,13,11,10312,4958,5354
50,6,89,California,Shasta County,13,12,12483,5933,6550
50,6,89,California,Shasta County,13,13,12862,6080,6782
50,6,89,California,Shasta County,13,14,12020,5672,6348
50,6,89,California,Shasta County,13,15,10276,4845,5431
50,6,89,California,Shasta County,13,16,7214,3342,3872
50,6,89,California,Shasta County,13,17,4524,2023,2501
50,6,89,California,Shasta County,13,18,4103,1566,2537
50,6,89,California,Shasta County,14,0,179027,87918,91109
50,6,89,California,Shasta County,14,1,10185,5245,4940
50,6,89,California,Shasta County,14,2,11044,5725,5319
50,6,89,California,Shasta County,14,3,10849,5531,5318
50,6,89,California,Shasta County,14,4,10195,5235,4960
50,6,89,California,Shasta County,14,5,9606,5001,4605
50,6,89,California,Shasta County,14,6,11180,5665,5515
50,6,89,California,Shasta County,14,7,11847,5995,5852
50,6,89,California,Shasta County,14,8,11341,5614,5727
50,6,89,California,Shasta County,14,9,9914,5062,4852
50,6,89,California,Shasta County,14,10,9228,4526,4702
50,6,89,California,Shasta County,14,11,10328,4970,5358
50,6,89,California,Shasta County,14,12,12336,5845,6491
50,6,89,California,Shasta County,14,13,12828,6076,6752
50,6,89,California,Shasta County,14,14,11993,5648,6345
50,6,89,California,Shasta County,14,15,10320,4862,5458
50,6,89,California,Shasta County,14,16,7228,3341,3887
50,6,89,California,Shasta County,14,17,4541,2037,2504
50,6,89,California,Shasta County,14,18,4064,1540,2524
50,6,91,California,Sierra County,1,0,3240,1646,1594
50,6,91,California,Sierra County,1,1,147,69,78
50,6,91,California,Sierra County,1,2,131,69,62
50,6,91,California,Sierra County,1,3,156,92,64
50,6,91,California,Sierra County,1,4,170,91,79
50,6,91,California,Sierra County,1,5,118,64,54
50,6,91,California,Sierra County,1,6,126,66,60
50,6,91,California,Sierra County,1,7,117,58,59
50,6,91,California,Sierra County,1,8,151,75,76
50,6,91,California,Sierra County,1,9,184,91,93
50,6,91,California,Sierra County,1,10,259,128,131
50,6,91,California,Sierra County,1,11,312,155,157
50,6,91,California,Sierra County,1,12,347,171,176
50,6,91,California,Sierra County,1,13,346,177,169
50,6,91,California,Sierra County,1,14,230,126,104
50,6,91,California,Sierra County,1,15,166,76,90
50,6,91,California,Sierra County,1,16,139,70,69
50,6,91,California,Sierra County,1,17,68,33,35
50,6,91,California,Sierra County,1,18,73,35,38
50,6,91,California,Sierra County,2,0,3239,1645,1594
50,6,91,California,Sierra County,2,1,147,69,78
50,6,91,California,Sierra County,2,2,131,69,62
50,6,91,California,Sierra County,2,3,156,92,64
50,6,91,California,Sierra County,2,4,170,91,79
50,6,91,California,Sierra County,2,5,118,64,54
50,6,91,California,Sierra County,2,6,126,66,60
50,6,91,California,Sierra County,2,7,117,58,59
50,6,91,California,Sierra County,2,8,151,75,76
50,6,91,California,Sierra County,2,9,184,91,93
50,6,91,California,Sierra County,2,10,259,128,131
50,6,91,California,Sierra County,2,11,312,155,157
50,6,91,California,Sierra County,2,12,347,171,176
50,6,91,California,Sierra County,2,13,345,176,169
50,6,91,California,Sierra County,2,14,230,126,104
50,6,91,California,Sierra County,2,15,166,76,90
50,6,91,California,Sierra County,2,16,139,70,69
50,6,91,California,Sierra County,2,17,68,33,35
50,6,91,California,Sierra County,2,18,73,35,38
50,6,91,California,Sierra County,3,0,3220,1633,1587
50,6,91,California,Sierra County,3,1,146,69,77
50,6,91,California,Sierra County,3,2,129,67,62
50,6,91,California,Sierra County,3,3,156,92,64
50,6,91,California,Sierra County,3,4,170,91,79
50,6,91,California,Sierra County,3,5,124,67,57
50,6,91,California,Sierra County,3,6,124,64,60
50,6,91,California,Sierra County,3,7,117,58,59
50,6,91,California,Sierra County,3,8,150,74,76
50,6,91,California,Sierra County,3,9,182,90,92
50,6,91,California,Sierra County,3,10,256,126,130
50,6,91,California,Sierra County,3,11,305,153,152
50,6,91,California,Sierra County,3,12,343,166,177
50,6,91,California,Sierra County,3,13,342,177,165
50,6,91,California,Sierra County,3,14,231,124,107
50,6,91,California,Sierra County,3,15,167,78,89
50,6,91,California,Sierra County,3,16,136,71,65
50,6,91,California,Sierra County,3,17,70,33,37
50,6,91,California,Sierra County,3,18,72,33,39
50,6,91,California,Sierra County,4,0,3100,1564,1536
50,6,91,California,Sierra County,4,1,128,60,68
50,6,91,California,Sierra County,4,2,127,65,62
50,6,91,California,Sierra County,4,3,142,75,67
50,6,91,California,Sierra County,4,4,178,98,80
50,6,91,California,Sierra County,4,5,106,63,43
50,6,91,California,Sierra County,4,6,115,59,56
50,6,91,California,Sierra County,4,7,127,59,68
50,6,91,California,Sierra County,4,8,134,63,71
50,6,91,California,Sierra County,4,9,170,87,83
50,6,91,California,Sierra County,4,10,223,106,117
50,6,91,California,Sierra County,4,11,298,151,147
50,6,91,California,Sierra County,4,12,316,148,168
50,6,91,California,Sierra County,4,13,352,187,165
50,6,91,California,Sierra County,4,14,235,121,114
50,6,91,California,Sierra County,4,15,178,91,87
50,6,91,California,Sierra County,4,16,127,63,64
50,6,91,California,Sierra County,4,17,83,39,44
50,6,91,California,Sierra County,4,18,61,29,32
50,6,91,California,Sierra County,5,0,3068,1544,1524
50,6,91,California,Sierra County,5,1,135,58,77
50,6,91,California,Sierra County,5,2,123,60,63
50,6,91,California,Sierra County,5,3,141,76,65
50,6,91,California,Sierra County,5,4,166,93,73
50,6,91,California,Sierra County,5,5,106,65,41
50,6,91,California,Sierra County,5,6,107,53,54
50,6,91,California,Sierra County,5,7,133,60,73
50,6,91,California,Sierra County,5,8,128,55,73
50,6,91,California,Sierra County,5,9,163,85,78
50,6,91,California,Sierra County,5,10,201,98,103
50,6,91,California,Sierra County,5,11,291,147,144
50,6,91,California,Sierra County,5,12,299,141,158
50,6,91,California,Sierra County,5,13,350,184,166
50,6,91,California,Sierra County,5,14,263,139,124
50,6,91,California,Sierra County,5,15,181,95,86
50,6,91,California,Sierra County,5,16,126,60,66
50,6,91,California,Sierra County,5,17,93,47,46
50,6,91,California,Sierra County,5,18,62,28,34
50,6,91,California,Sierra County,6,0,3031,1518,1513
50,6,91,California,Sierra County,6,1,123,60,63
50,6,91,California,Sierra County,6,2,130,57,73
50,6,91,California,Sierra County,6,3,146,76,70
50,6,91,California,Sierra County,6,4,157,89,68
50,6,91,California,Sierra County,6,5,106,68,38
50,6,91,California,Sierra County,6,6,105,49,56
50,6,91,California,Sierra County,6,7,134,67,67
50,6,91,California,Sierra County,6,8,125,56,69
50,6,91,California,Sierra County,6,9,154,73,81
50,6,91,California,Sierra County,6,10,176,87,89
50,6,91,California,Sierra County,6,11,273,142,131
50,6,91,California,Sierra County,6,12,287,127,160
50,6,91,California,Sierra County,6,13,355,181,174
50,6,91,California,Sierra County,6,14,278,147,131
50,6,91,California,Sierra County,6,15,194,99,95
50,6,91,California,Sierra County,6,16,124,58,66
50,6,91,California,Sierra County,6,17,99,51,48
50,6,91,California,Sierra County,6,18,65,31,34
50,6,91,California,Sierra County,7,0,2976,1496,1480
50,6,91,California,Sierra County,7,1,111,53,58
50,6,91,California,Sierra County,7,2,143,70,73
50,6,91,California,Sierra County,7,3,135,72,63
50,6,91,California,Sierra County,7,4,148,85,63
50,6,91,California,Sierra County,7,5,121,73,48
50,6,91,California,Sierra County,7,6,85,46,39
50,6,91,California,Sierra County,7,7,129,60,69
50,6,91,California,Sierra County,7,8,128,66,62
50,6,91,California,Sierra County,7,9,139,61,78
50,6,91,California,Sierra County,7,10,165,78,87
50,6,91,California,Sierra County,7,11,257,128,129
50,6,91,California,Sierra County,7,12,280,128,152
50,6,91,California,Sierra County,7,13,334,171,163
50,6,91,California,Sierra County,7,14,305,163,142
50,6,91,California,Sierra County,7,15,196,98,98
50,6,91,California,Sierra County,7,16,126,63,63
50,6,91,California,Sierra County,7,17,106,49,57
50,6,91,California,Sierra County,7,18,68,32,36
50,6,91,California,Sierra County,8,0,2990,1515,1475
50,6,91,California,Sierra County,8,1,113,53,60
50,6,91,California,Sierra County,8,2,148,71,77
50,6,91,California,Sierra County,8,3,143,80,63
50,6,91,California,Sierra County,8,4,136,78,58
50,6,91,California,Sierra County,8,5,131,76,55
50,6,91,California,Sierra County,8,6,100,62,38
50,6,91,California,Sierra County,8,7,114,51,63
50,6,91,California,Sierra County,8,8,135,71,64
50,6,91,California,Sierra County,8,9,143,66,77
50,6,91,California,Sierra County,8,10,163,76,87
50,6,91,California,Sierra County,8,11,230,111,119
50,6,91,California,Sierra County,8,12,296,146,150
50,6,91,California,Sierra County,8,13,302,159,143
50,6,91,California,Sierra County,8,14,327,172,155
50,6,91,California,Sierra County,8,15,200,99,101
50,6,91,California,Sierra County,8,16,129,61,68
50,6,91,California,Sierra County,8,17,107,51,56
50,6,91,California,Sierra County,8,18,73,32,41
50,6,91,California,Sierra County,9,0,2956,1490,1466
50,6,91,California,Sierra County,9,1,124,62,62
50,6,91,California,Sierra County,9,2,133,64,69
50,6,91,California,Sierra County,9,3,134,72,62
50,6,91,California,Sierra County,9,4,124,71,53
50,6,91,California,Sierra County,9,5,130,75,55
50,6,91,California,Sierra County,9,6,105,62,43
50,6,91,California,Sierra County,9,7,101,48,53
50,6,91,California,Sierra County,9,8,139,72,67
50,6,91,California,Sierra County,9,9,142,66,76
50,6,91,California,Sierra County,9,10,152,75,77
50,6,91,California,Sierra County,9,11,214,98,116
50,6,91,California,Sierra County,9,12,304,155,149
50,6,91,California,Sierra County,9,13,288,145,143
50,6,91,California,Sierra County,9,14,338,179,159
50,6,91,California,Sierra County,9,15,204,96,108
50,6,91,California,Sierra County,9,16,146,77,69
50,6,91,California,Sierra County,9,17,99,41,58
50,6,91,California,Sierra County,9,18,79,32,47
50,6,91,California,Sierra County,10,0,3008,1513,1495
50,6,91,California,Sierra County,10,1,151,74,77
50,6,91,California,Sierra County,10,2,126,64,62
50,6,91,California,Sierra County,10,3,136,67,69
50,6,91,California,Sierra County,10,4,121,69,52
50,6,91,California,Sierra County,10,5,141,78,63
50,6,91,California,Sierra County,10,6,101,62,39
50,6,91,California,Sierra County,10,7,119,58,61
50,6,91,California,Sierra County,10,8,124,64,60
50,6,91,California,Sierra County,10,9,154,71,83
50,6,91,California,Sierra County,10,10,160,79,81
50,6,91,California,Sierra County,10,11,194,93,101
50,6,91,California,Sierra County,10,12,304,156,148
50,6,91,California,Sierra County,10,13,278,143,135
50,6,91,California,Sierra County,10,14,331,170,161
50,6,91,California,Sierra County,10,15,231,112,119
50,6,91,California,Sierra County,10,16,151,82,69
50,6,91,California,Sierra County,10,17,96,35,61
50,6,91,California,Sierra County,10,18,90,36,54
50,6,91,California,Sierra County,11,0,2961,1489,1472
50,6,91,California,Sierra County,11,1,146,69,77
50,6,91,California,Sierra County,11,2,135,74,61
50,6,91,California,Sierra County,11,3,130,60,70
50,6,91,California,Sierra County,11,4,116,69,47
50,6,91,California,Sierra County,11,5,111,68,43
50,6,91,California,Sierra County,11,6,128,78,50
50,6,91,California,Sierra County,11,7,118,52,66
50,6,91,California,Sierra County,11,8,142,75,67
50,6,91,California,Sierra County,11,9,144,70,74
50,6,91,California,Sierra County,11,10,153,70,83
50,6,91,California,Sierra County,11,11,167,82,85
50,6,91,California,Sierra County,11,12,276,147,129
50,6,91,California,Sierra County,11,13,279,131,148
50,6,91,California,Sierra County,11,14,336,172,164
50,6,91,California,Sierra County,11,15,241,117,124
50,6,91,California,Sierra County,11,16,164,86,78
50,6,91,California,Sierra County,11,17,88,33,55
50,6,91,California,Sierra County,11,18,87,36,51
50,6,91,California,Sierra County,12,0,2959,1487,1472
50,6,91,California,Sierra County,12,1,139,70,69
50,6,91,California,Sierra County,12,2,127,69,58
50,6,91,California,Sierra County,12,3,151,73,78
50,6,91,California,Sierra County,12,4,122,75,47
50,6,91,California,Sierra County,12,5,98,56,42
50,6,91,California,Sierra County,12,6,122,74,48
50,6,91,California,Sierra County,12,7,111,53,58
50,6,91,California,Sierra County,12,8,149,68,81
50,6,91,California,Sierra County,12,9,167,85,82
50,6,91,California,Sierra County,12,10,144,66,78
50,6,91,California,Sierra County,12,11,169,83,86
50,6,91,California,Sierra County,12,12,260,139,121
50,6,91,California,Sierra County,12,13,283,136,147
50,6,91,California,Sierra County,12,14,303,150,153
50,6,91,California,Sierra County,12,15,260,132,128
50,6,91,California,Sierra County,12,16,167,80,87
50,6,91,California,Sierra County,12,17,91,39,52
50,6,91,California,Sierra County,12,18,96,39,57
50,6,91,California,Sierra County,13,0,2933,1487,1446
50,6,91,California,Sierra County,13,1,135,66,69
50,6,91,California,Sierra County,13,2,125,71,54
50,6,91,California,Sierra County,13,3,152,71,81
50,6,91,California,Sierra County,13,4,126,76,50
50,6,91,California,Sierra County,13,5,86,52,34
50,6,91,California,Sierra County,13,6,122,73,49
50,6,91,California,Sierra County,13,7,112,57,55
50,6,91,California,Sierra County,13,8,153,68,85
50,6,91,California,Sierra County,13,9,169,90,79
50,6,91,California,Sierra County,13,10,149,68,81
50,6,91,California,Sierra County,13,11,168,89,79
50,6,91,California,Sierra County,13,12,235,116,119
50,6,91,California,Sierra County,13,13,289,141,148
50,6,91,California,Sierra County,13,14,293,152,141
50,6,91,California,Sierra County,13,15,270,134,136
50,6,91,California,Sierra County,13,16,168,84,84
50,6,91,California,Sierra County,13,17,91,40,51
50,6,91,California,Sierra County,13,18,90,39,51
50,6,91,California,Sierra County,14,0,2920,1483,1437
50,6,91,California,Sierra County,14,1,136,67,69
50,6,91,California,Sierra County,14,2,122,71,51
50,6,91,California,Sierra County,14,3,153,69,84
50,6,91,California,Sierra County,14,4,126,76,50
50,6,91,California,Sierra County,14,5,82,50,32
50,6,91,California,Sierra County,14,6,124,73,51
50,6,91,California,Sierra County,14,7,111,57,54
50,6,91,California,Sierra County,14,8,155,68,87
50,6,91,California,Sierra County,14,9,168,90,78
50,6,91,California,Sierra County,14,10,151,69,82
50,6,91,California,Sierra County,14,11,167,91,76
50,6,91,California,Sierra County,14,12,227,108,119
50,6,91,California,Sierra County,14,13,290,143,147
50,6,91,California,Sierra County,14,14,286,150,136
50,6,91,California,Sierra County,14,15,274,134,140
50,6,91,California,Sierra County,14,16,170,87,83
50,6,91,California,Sierra County,14,17,91,41,50
50,6,91,California,Sierra County,14,18,87,39,48
50,6,93,California,Siskiyou County,1,0,44900,22395,22505
50,6,93,California,Siskiyou County,1,1,2473,1291,1182
50,6,93,California,Siskiyou County,1,2,2410,1204,1206
50,6,93,California,Siskiyou County,1,3,2726,1408,1318
50,6,93,California,Siskiyou County,1,4,2757,1496,1261
50,6,93,California,Siskiyou County,1,5,2178,1151,1027
50,6,93,California,Siskiyou County,1,6,2274,1173,1101
50,6,93,California,Siskiyou County,1,7,2003,1028,975
50,6,93,California,Siskiyou County,1,8,2139,1093,1046
50,6,93,California,Siskiyou County,1,9,2397,1192,1205
50,6,93,California,Siskiyou County,1,10,3088,1501,1587
50,6,93,California,Siskiyou County,1,11,3822,1793,2029
50,6,93,California,Siskiyou County,1,12,4029,1948,2081
50,6,93,California,Siskiyou County,1,13,3822,1942,1880
50,6,93,California,Siskiyou County,1,14,2930,1505,1425
50,6,93,California,Siskiyou County,1,15,2011,996,1015
50,6,93,California,Siskiyou County,1,16,1510,719,791
50,6,93,California,Siskiyou County,1,17,1179,515,664
50,6,93,California,Siskiyou County,1,18,1152,440,712
50,6,93,California,Siskiyou County,2,0,44899,22394,22505
50,6,93,California,Siskiyou County,2,1,2473,1291,1182
50,6,93,California,Siskiyou County,2,2,2410,1204,1206
50,6,93,California,Siskiyou County,2,3,2726,1408,1318
50,6,93,California,Siskiyou County,2,4,2757,1496,1261
50,6,93,California,Siskiyou County,2,5,2178,1151,1027
50,6,93,California,Siskiyou County,2,6,2274,1173,1101
50,6,93,California,Siskiyou County,2,7,2003,1028,975
50,6,93,California,Siskiyou County,2,8,2139,1093,1046
50,6,93,California,Siskiyou County,2,9,2397,1192,1205
50,6,93,California,Siskiyou County,2,10,3088,1501,1587
50,6,93,California,Siskiyou County,2,11,3821,1792,2029
50,6,93,California,Siskiyou County,2,12,4029,1948,2081
50,6,93,California,Siskiyou County,2,13,3822,1942,1880
50,6,93,California,Siskiyou County,2,14,2930,1505,1425
50,6,93,California,Siskiyou County,2,15,2011,996,1015
50,6,93,California,Siskiyou County,2,16,1510,719,791
50,6,93,California,Siskiyou County,2,17,1179,515,664
50,6,93,California,Siskiyou County,2,18,1152,440,712
50,6,93,California,Siskiyou County,3,0,44941,22445,22496
50,6,93,California,Siskiyou County,3,1,2463,1287,1176
50,6,93,California,Siskiyou County,3,2,2417,1216,1201
50,6,93,California,Siskiyou County,3,3,2715,1398,1317
50,6,93,California,Siskiyou County,3,4,2749,1505,1244
50,6,93,California,Siskiyou County,3,5,2214,1170,1044
50,6,93,California,Siskiyou County,3,6,2300,1192,1108
50,6,93,California,Siskiyou County,3,7,2026,1043,983
50,6,93,California,Siskiyou County,3,8,2122,1085,1037
50,6,93,California,Siskiyou County,3,9,2398,1193,1205
50,6,93,California,Siskiyou County,3,10,3044,1487,1557
50,6,93,California,Siskiyou County,3,11,3793,1772,2021
50,6,93,California,Siskiyou County,3,12,4031,1947,2084
50,6,93,California,Siskiyou County,3,13,3860,1956,1904
50,6,93,California,Siskiyou County,3,14,2948,1511,1437
50,6,93,California,Siskiyou County,3,15,2017,1006,1011
50,6,93,California,Siskiyou County,3,16,1508,718,790
50,6,93,California,Siskiyou County,3,17,1181,516,665
50,6,93,California,Siskiyou County,3,18,1155,443,712
50,6,93,California,Siskiyou County,4,0,44622,22217,22405
50,6,93,California,Siskiyou County,4,1,2393,1229,1164
50,6,93,California,Siskiyou County,4,2,2425,1217,1208
50,6,93,California,Siskiyou County,4,3,2645,1321,1324
50,6,93,California,Siskiyou County,4,4,2687,1487,1200
50,6,93,California,Siskiyou County,4,5,2266,1185,1081
50,6,93,California,Siskiyou County,4,6,2249,1159,1090
50,6,93,California,Siskiyou County,4,7,2096,1092,1004
50,6,93,California,Siskiyou County,4,8,2033,1051,982
50,6,93,California,Siskiyou County,4,9,2396,1196,1200
50,6,93,California,Siskiyou County,4,10,2795,1380,1415
50,6,93,California,Siskiyou County,4,11,3631,1687,1944
50,6,93,California,Siskiyou County,4,12,4063,1965,2098
50,6,93,California,Siskiyou County,4,13,4037,2001,2036
50,6,93,California,Siskiyou County,4,14,3001,1533,1468
50,6,93,California,Siskiyou County,4,15,2065,1041,1024
50,6,93,California,Siskiyou County,4,16,1529,735,794
50,6,93,California,Siskiyou County,4,17,1167,511,656
50,6,93,California,Siskiyou County,4,18,1144,427,717
50,6,93,California,Siskiyou County,5,0,44091,21909,22182
50,6,93,California,Siskiyou County,5,1,2377,1203,1174
50,6,93,California,Siskiyou County,5,2,2464,1263,1201
50,6,93,California,Siskiyou County,5,3,2554,1237,1317
50,6,93,California,Siskiyou County,5,4,2617,1440,1177
50,6,93,California,Siskiyou County,5,5,2209,1158,1051
50,6,93,California,Siskiyou County,5,6,2192,1130,1062
50,6,93,California,Siskiyou County,5,7,2169,1121,1048
50,6,93,California,Siskiyou County,5,8,1959,1014,945
50,6,93,California,Siskiyou County,5,9,2357,1222,1135
50,6,93,California,Siskiyou County,5,10,2592,1253,1339
50,6,93,California,Siskiyou County,5,11,3371,1579,1792
50,6,93,California,Siskiyou County,5,12,4034,1922,2112
50,6,93,California,Siskiyou County,5,13,3944,1932,2012
50,6,93,California,Siskiyou County,5,14,3245,1656,1589
50,6,93,California,Siskiyou County,5,15,2156,1098,1058
50,6,93,California,Siskiyou County,5,16,1544,748,796
50,6,93,California,Siskiyou County,5,17,1144,518,626
50,6,93,California,Siskiyou County,5,18,1163,415,748
50,6,93,California,Siskiyou County,6,0,43550,21656,21894
50,6,93,California,Siskiyou County,6,1,2360,1167,1193
50,6,93,California,Siskiyou County,6,2,2448,1262,1186
50,6,93,California,Siskiyou County,6,3,2498,1235,1263
50,6,93,California,Siskiyou County,6,4,2547,1371,1176
50,6,93,California,Siskiyou County,6,5,2175,1165,1010
50,6,93,California,Siskiyou County,6,6,2134,1108,1026
50,6,93,California,Siskiyou County,6,7,2176,1125,1051
50,6,93,California,Siskiyou County,6,8,1942,993,949
50,6,93,California,Siskiyou County,6,9,2294,1184,1110
50,6,93,California,Siskiyou County,6,10,2384,1146,1238
50,6,93,California,Siskiyou County,6,11,3197,1513,1684
50,6,93,California,Siskiyou County,6,12,3914,1878,2036
50,6,93,California,Siskiyou County,6,13,3935,1919,2016
50,6,93,California,Siskiyou County,6,14,3381,1691,1690
50,6,93,California,Siskiyou County,6,15,2313,1201,1112
50,6,93,California,Siskiyou County,6,16,1565,764,801
50,6,93,California,Siskiyou County,6,17,1126,505,621
50,6,93,California,Siskiyou County,6,18,1161,429,732
50,6,93,California,Siskiyou County,7,0,43357,21582,21775
50,6,93,California,Siskiyou County,7,1,2334,1152,1182
50,6,93,California,Siskiyou County,7,2,2454,1269,1185
50,6,93,California,Siskiyou County,7,3,2422,1209,1213
50,6,93,California,Siskiyou County,7,4,2491,1312,1179
50,6,93,California,Siskiyou County,7,5,2179,1173,1006
50,6,93,California,Siskiyou County,7,6,2152,1135,1017
50,6,93,California,Siskiyou County,7,7,2263,1151,1112
50,6,93,California,Siskiyou County,7,8,1985,1025,960
50,6,93,California,Siskiyou County,7,9,2183,1122,1061
50,6,93,California,Siskiyou County,7,10,2293,1105,1188
50,6,93,California,Siskiyou County,7,11,3094,1504,1590
50,6,93,California,Siskiyou County,7,12,3770,1788,1982
50,6,93,California,Siskiyou County,7,13,3933,1878,2055
50,6,93,California,Siskiyou County,7,14,3487,1757,1730
50,6,93,California,Siskiyou County,7,15,2484,1284,1200
50,6,93,California,Siskiyou County,7,16,1568,768,800
50,6,93,California,Siskiyou County,7,17,1101,506,595
50,6,93,California,Siskiyou County,7,18,1164,444,720
50,6,93,California,Siskiyou County,8,0,43275,21563,21712
50,6,93,California,Siskiyou County,8,1,2344,1161,1183
50,6,93,California,Siskiyou County,8,2,2494,1300,1194
50,6,93,California,Siskiyou County,8,3,2368,1200,1168
50,6,93,California,Siskiyou County,8,4,2500,1305,1195
50,6,93,California,Siskiyou County,8,5,2097,1110,987
50,6,93,California,Siskiyou County,8,6,2131,1127,1004
50,6,93,California,Siskiyou County,8,7,2303,1169,1134
50,6,93,California,Siskiyou County,8,8,2087,1075,1012
50,6,93,California,Siskiyou County,8,9,2100,1086,1014
50,6,93,California,Siskiyou County,8,10,2335,1126,1209
50,6,93,California,Siskiyou County,8,11,2882,1407,1475
50,6,93,California,Siskiyou County,8,12,3665,1694,1971
50,6,93,California,Siskiyou County,8,13,3897,1864,2033
50,6,93,California,Siskiyou County,8,14,3618,1862,1756
50,6,93,California,Siskiyou County,8,15,2591,1303,1288
50,6,93,California,Siskiyou County,8,16,1613,810,803
50,6,93,California,Siskiyou County,8,17,1087,497,590
50,6,93,California,Siskiyou County,8,18,1163,467,696
50,6,93,California,Siskiyou County,9,0,43402,21626,21776
50,6,93,California,Siskiyou County,9,1,2377,1232,1145
50,6,93,California,Siskiyou County,9,2,2533,1311,1222
50,6,93,California,Siskiyou County,9,3,2399,1225,1174
50,6,93,California,Siskiyou County,9,4,2478,1284,1194
50,6,93,California,Siskiyou County,9,5,2093,1142,951
50,6,93,California,Siskiyou County,9,6,2188,1137,1051
50,6,93,California,Siskiyou County,9,7,2296,1168,1128
50,6,93,California,Siskiyou County,9,8,2173,1115,1058
50,6,93,California,Siskiyou County,9,9,2023,1047,976
50,6,93,California,Siskiyou County,9,10,2374,1158,1216
50,6,93,California,Siskiyou County,9,11,2628,1285,1343
50,6,93,California,Siskiyou County,9,12,3566,1631,1935
50,6,93,California,Siskiyou County,9,13,3901,1852,2049
50,6,93,California,Siskiyou County,9,14,3782,1891,1891
50,6,93,California,Siskiyou County,9,15,2671,1337,1334
50,6,93,California,Siskiyou County,9,16,1670,854,816
50,6,93,California,Siskiyou County,9,17,1109,512,597
50,6,93,California,Siskiyou County,9,18,1141,445,696
50,6,93,California,Siskiyou County,10,0,43647,21724,21923
50,6,93,California,Siskiyou County,10,1,2335,1208,1127
50,6,93,California,Siskiyou County,10,2,2580,1321,1259
50,6,93,California,Siskiyou County,10,3,2505,1297,1208
50,6,93,California,Siskiyou County,10,4,2420,1238,1182
50,6,93,California,Siskiyou County,10,5,2113,1152,961
50,6,93,California,Siskiyou County,10,6,2266,1184,1082
50,6,93,California,Siskiyou County,10,7,2301,1164,1137
50,6,93,California,Siskiyou County,10,8,2282,1159,1123
50,6,93,California,Siskiyou County,10,9,2035,1056,979
50,6,93,California,Siskiyou County,10,10,2364,1189,1175
50,6,93,California,Siskiyou County,10,11,2498,1180,1318
50,6,93,California,Siskiyou County,10,12,3341,1562,1779
50,6,93,California,Siskiyou County,10,13,3928,1826,2102
50,6,93,California,Siskiyou County,10,14,3759,1862,1897
50,6,93,California,Siskiyou County,10,15,2904,1454,1450
50,6,93,California,Siskiyou County,10,16,1778,921,857
50,6,93,California,Siskiyou County,10,17,1134,520,614
50,6,93,California,Siskiyou County,10,18,1104,431,673
50,6,93,California,Siskiyou County,11,0,43624,21708,21916
50,6,93,California,Siskiyou County,11,1,2308,1211,1097
50,6,93,California,Siskiyou County,11,2,2512,1227,1285
50,6,93,California,Siskiyou County,11,3,2609,1379,1230
50,6,93,California,Siskiyou County,11,4,2364,1236,1128
50,6,93,California,Siskiyou County,11,5,2004,1070,934
50,6,93,California,Siskiyou County,11,6,2274,1197,1077
50,6,93,California,Siskiyou County,11,7,2281,1176,1105
50,6,93,California,Siskiyou County,11,8,2389,1192,1197
50,6,93,California,Siskiyou County,11,9,2025,1040,985
50,6,93,California,Siskiyou County,11,10,2328,1184,1144
50,6,93,California,Siskiyou County,11,11,2359,1108,1251
50,6,93,California,Siskiyou County,11,12,3230,1514,1716
50,6,93,California,Siskiyou County,11,13,3887,1830,2057
50,6,93,California,Siskiyou County,11,14,3814,1874,1940
50,6,93,California,Siskiyou County,11,15,3056,1503,1553
50,6,93,California,Siskiyou County,11,16,1948,1018,930
50,6,93,California,Siskiyou County,11,17,1127,523,604
50,6,93,California,Siskiyou County,11,18,1109,426,683
50,6,93,California,Siskiyou County,12,0,43663,21740,21923
50,6,93,California,Siskiyou County,12,1,2215,1151,1064
50,6,93,California,Siskiyou County,12,2,2463,1180,1283
50,6,93,California,Siskiyou County,12,3,2654,1412,1242
50,6,93,California,Siskiyou County,12,4,2370,1255,1115
50,6,93,California,Siskiyou County,12,5,2044,1106,938
50,6,93,California,Siskiyou County,12,6,2218,1178,1040
50,6,93,California,Siskiyou County,12,7,2301,1187,1114
50,6,93,California,Siskiyou County,12,8,2466,1221,1245
50,6,93,California,Siskiyou County,12,9,2041,1045,996
50,6,93,California,Siskiyou County,12,10,2265,1152,1113
50,6,93,California,Siskiyou County,12,11,2275,1065,1210
50,6,93,California,Siskiyou County,12,12,3130,1488,1642
50,6,93,California,Siskiyou County,12,13,3792,1784,2008
50,6,93,California,Siskiyou County,12,14,3875,1846,2029
50,6,93,California,Siskiyou County,12,15,3167,1593,1574
50,6,93,California,Siskiyou County,12,16,2127,1087,1040
50,6,93,California,Siskiyou County,12,17,1134,529,605
50,6,93,California,Siskiyou County,12,18,1126,461,665
50,6,93,California,Siskiyou County,13,0,43381,21582,21799
50,6,93,California,Siskiyou County,13,1,2184,1142,1042
50,6,93,California,Siskiyou County,13,2,2455,1204,1251
50,6,93,California,Siskiyou County,13,3,2635,1393,1242
50,6,93,California,Siskiyou County,13,4,2341,1237,1104
50,6,93,California,Siskiyou County,13,5,2004,1088,916
50,6,93,California,Siskiyou County,13,6,2130,1096,1034
50,6,93,California,Siskiyou County,13,7,2248,1167,1081
50,6,93,California,Siskiyou County,13,8,2461,1223,1238
50,6,93,California,Siskiyou County,13,9,2119,1080,1039
50,6,93,California,Siskiyou County,13,10,2164,1110,1054
50,6,93,California,Siskiyou County,13,11,2336,1111,1225
50,6,93,California,Siskiyou County,13,12,2987,1418,1569
50,6,93,California,Siskiyou County,13,13,3726,1711,2015
50,6,93,California,Siskiyou County,13,14,3846,1835,2011
50,6,93,California,Siskiyou County,13,15,3250,1648,1602
50,6,93,California,Siskiyou County,13,16,2207,1104,1103
50,6,93,California,Siskiyou County,13,17,1153,552,601
50,6,93,California,Siskiyou County,13,18,1135,463,672
50,6,93,California,Siskiyou County,14,0,43245,21509,21736
50,6,93,California,Siskiyou County,14,1,2168,1135,1033
50,6,93,California,Siskiyou County,14,2,2447,1210,1237
50,6,93,California,Siskiyou County,14,3,2626,1385,1241
50,6,93,California,Siskiyou County,14,4,2328,1228,1100
50,6,93,California,Siskiyou County,14,5,1991,1082,909
50,6,93,California,Siskiyou County,14,6,2103,1069,1034
50,6,93,California,Siskiyou County,14,7,2236,1164,1072
50,6,93,California,Siskiyou County,14,8,2458,1225,1233
50,6,93,California,Siskiyou County,14,9,2146,1091,1055
50,6,93,California,Siskiyou County,14,10,2136,1101,1035
50,6,93,California,Siskiyou County,14,11,2358,1126,1232
50,6,93,California,Siskiyou County,14,12,2941,1396,1545
50,6,93,California,Siskiyou County,14,13,3696,1682,2014
50,6,93,California,Siskiyou County,14,14,3829,1830,1999
50,6,93,California,Siskiyou County,14,15,3271,1662,1609
50,6,93,California,Siskiyou County,14,16,2225,1105,1120
50,6,93,California,Siskiyou County,14,17,1158,558,600
50,6,93,California,Siskiyou County,14,18,1128,460,668
50,6,95,California,Solano County,1,0,413344,206195,207149
50,6,95,California,Solano County,1,1,26852,13819,13033
50,6,95,California,Solano County,1,2,27311,13951,13360
50,6,95,California,Solano County,1,3,28575,14652,13923
50,6,95,California,Solano County,1,4,30484,15711,14773
50,6,95,California,Solano County,1,5,28761,15140,13621
50,6,95,California,Solano County,1,6,28596,14825,13771
50,6,95,California,Solano County,1,7,26318,13399,12919
50,6,95,California,Solano County,1,8,26355,13182,13173
50,6,95,California,Solano County,1,9,28068,14220,13848
50,6,95,California,Solano County,1,10,31946,16021,15925
50,6,95,California,Solano County,1,11,32004,15814,16190
50,6,95,California,Solano County,1,12,28009,13630,14379
50,6,95,California,Solano County,1,13,23218,11373,11845
50,6,95,California,Solano County,1,14,15031,7119,7912
50,6,95,California,Solano County,1,15,10966,4989,5977
50,6,95,California,Solano County,1,16,8584,3804,4780
50,6,95,California,Solano County,1,17,6254,2431,3823
50,6,95,California,Solano County,1,18,6012,2115,3897
50,6,95,California,Solano County,2,0,413343,206195,207148
50,6,95,California,Solano County,2,1,26852,13819,13033
50,6,95,California,Solano County,2,2,27311,13951,13360
50,6,95,California,Solano County,2,3,28575,14652,13923
50,6,95,California,Solano County,2,4,30484,15711,14773
50,6,95,California,Solano County,2,5,28761,15140,13621
50,6,95,California,Solano County,2,6,28596,14825,13771
50,6,95,California,Solano County,2,7,26318,13399,12919
50,6,95,California,Solano County,2,8,26355,13182,13173
50,6,95,California,Solano County,2,9,28068,14220,13848
50,6,95,California,Solano County,2,10,31946,16021,15925
50,6,95,California,Solano County,2,11,32004,15814,16190
50,6,95,California,Solano County,2,12,28009,13630,14379
50,6,95,California,Solano County,2,13,23218,11373,11845
50,6,95,California,Solano County,2,14,15031,7119,7912
50,6,95,California,Solano County,2,15,10965,4989,5976
50,6,95,California,Solano County,2,16,8584,3804,4780
50,6,95,California,Solano County,2,17,6254,2431,3823
50,6,95,California,Solano County,2,18,6012,2115,3897
50,6,95,California,Solano County,3,0,413963,206417,207546
50,6,95,California,Solano County,3,1,26755,13773,12982
50,6,95,California,Solano County,3,2,27201,13877,13324
50,6,95,California,Solano County,3,3,28511,14594,13917
50,6,95,California,Solano County,3,4,30266,15633,14633
50,6,95,California,Solano County,3,5,29136,15304,13832
50,6,95,California,Solano County,3,6,28663,14855,13808
50,6,95,California,Solano County,3,7,26476,13486,12990
50,6,95,California,Solano County,3,8,26129,13068,13061
50,6,95,California,Solano County,3,9,28018,14185,13833
50,6,95,California,Solano County,3,10,31811,15947,15864
50,6,95,California,Solano County,3,11,31993,15809,16184
50,6,95,California,Solano County,3,12,28242,13716,14526
50,6,95,California,Solano County,3,13,23487,11494,11993
50,6,95,California,Solano County,3,14,15280,7235,8045
50,6,95,California,Solano County,3,15,11040,5037,6003
50,6,95,California,Solano County,3,16,8603,3813,4790
50,6,95,California,Solano County,3,17,6311,2466,3845
50,6,95,California,Solano County,3,18,6041,2125,3916
50,6,95,California,Solano County,4,0,416325,207649,208676
50,6,95,California,Solano County,4,1,26604,13680,12924
50,6,95,California,Solano County,4,2,27064,13860,13204
50,6,95,California,Solano County,4,3,28242,14391,13851
50,6,95,California,Solano County,4,4,29209,15134,14075
50,6,95,California,Solano County,4,5,30234,16000,14234
50,6,95,California,Solano County,4,6,29065,15021,14044
50,6,95,California,Solano County,4,7,27101,13852,13249
50,6,95,California,Solano County,4,8,25262,12668,12594
50,6,95,California,Solano County,4,9,27819,14074,13745
50,6,95,California,Solano County,4,10,30933,15515,15418
50,6,95,California,Solano County,4,11,31961,15845,16116
50,6,95,California,Solano County,4,12,29014,14037,14977
50,6,95,California,Solano County,4,13,24613,12009,12604
50,6,95,California,Solano County,4,14,16363,7730,8633
50,6,95,California,Solano County,4,15,11396,5248,6148
50,6,95,California,Solano County,4,16,8751,3847,4904
50,6,95,California,Solano County,4,17,6508,2601,3907
50,6,95,California,Solano County,4,18,6186,2137,4049
50,6,95,California,Solano County,5,0,419645,208984,210661
50,6,95,California,Solano County,5,1,26329,13473,12856
50,6,95,California,Solano County,5,2,27044,13947,13097
50,6,95,California,Solano County,5,3,27878,14121,13757
50,6,95,California,Solano County,5,4,28448,14765,13683
50,6,95,California,Solano County,5,5,31169,16409,14760
50,6,95,California,Solano County,5,6,29495,15331,14164
50,6,95,California,Solano County,5,7,27899,14294,13605
50,6,95,California,Solano County,5,8,25175,12690,12485
50,6,95,California,Solano County,5,9,27502,13807,13695
50,6,95,California,Solano County,5,10,30011,15047,14964
50,6,95,California,Solano County,5,11,31908,15783,16125
50,6,95,California,Solano County,5,12,29768,14327,15441
50,6,95,California,Solano County,5,13,24780,12081,12699
50,6,95,California,Solano County,5,14,18381,8650,9731
50,6,95,California,Solano County,5,15,11985,5489,6496
50,6,95,California,Solano County,5,16,8914,3914,5000
50,6,95,California,Solano County,5,17,6559,2660,3899
50,6,95,California,Solano County,5,18,6400,2196,4204
50,6,95,California,Solano County,6,0,423634,210725,212909
50,6,95,California,Solano County,6,1,26258,13374,12884
50,6,95,California,Solano County,6,2,27332,14107,13225
50,6,95,California,Solano County,6,3,27603,13974,13629
50,6,95,California,Solano County,6,4,27925,14521,13404
50,6,95,California,Solano County,6,5,31436,16655,14781
50,6,95,California,Solano County,6,6,30328,15699,14629
50,6,95,California,Solano County,6,7,28598,14676,13922
50,6,95,California,Solano County,6,8,25456,12794,12662
50,6,95,California,Solano County,6,9,26961,13493,13468
50,6,95,California,Solano County,6,10,28956,14522,14434
50,6,95,California,Solano County,6,11,31989,15817,16172
50,6,95,California,Solano County,6,12,30039,14495,15544
50,6,95,California,Solano County,6,13,25528,12326,13202
50,6,95,California,Solano County,6,14,19814,9356,10458
50,6,95,California,Solano County,6,15,12772,5811,6961
50,6,95,California,Solano County,6,16,9190,4040,5150
50,6,95,California,Solano County,6,17,6757,2781,3976
50,6,95,California,Solano County,6,18,6692,2284,4408
50,6,95,California,Solano County,7,0,428971,213177,215794
50,6,95,California,Solano County,7,1,26439,13388,13051
50,6,95,California,Solano County,7,2,27567,14226,13341
50,6,95,California,Solano County,7,3,27503,13991,13512
50,6,95,California,Solano County,7,4,27392,14230,13162
50,6,95,California,Solano County,7,5,31367,16689,14678
50,6,95,California,Solano County,7,6,31223,16147,15076
50,6,95,California,Solano County,7,7,29548,15190,14358
50,6,95,California,Solano County,7,8,25959,13003,12956
50,6,95,California,Solano County,7,9,26704,13379,13325
50,6,95,California,Solano County,7,10,28092,14103,13989
50,6,95,California,Solano County,7,11,31929,15710,16219
50,6,95,California,Solano County,7,12,30679,14848,15831
50,6,95,California,Solano County,7,13,26225,12515,13710
50,6,95,California,Solano County,7,14,21209,10008,11201
50,6,95,California,Solano County,7,15,13623,6234,7389
50,6,95,California,Solano County,7,16,9575,4212,5363
50,6,95,California,Solano County,7,17,6946,2883,4063
50,6,95,California,Solano County,7,18,6991,2421,4570
50,6,95,California,Solano County,8,0,433378,215284,218094
50,6,95,California,Solano County,8,1,26813,13612,13201
50,6,95,California,Solano County,8,2,27525,14188,13337
50,6,95,California,Solano County,8,3,27485,14061,13424
50,6,95,California,Solano County,8,4,27121,14074,13047
50,6,95,California,Solano County,8,5,30486,16234,14252
50,6,95,California,Solano County,8,6,32054,16573,15481
50,6,95,California,Solano County,8,7,30258,15480,14778
50,6,95,California,Solano County,8,8,27100,13619,13481
50,6,95,California,Solano County,8,9,25996,12951,13045
50,6,95,California,Solano County,8,10,27713,13941,13772
50,6,95,California,Solano County,8,11,31218,15404,15814
50,6,95,California,Solano County,8,12,31082,15041,16041
50,6,95,California,Solano County,8,13,27114,12891,14223
50,6,95,California,Solano County,8,14,22580,10695,11885
50,6,95,California,Solano County,8,15,14477,6579,7898
50,6,95,California,Solano County,8,16,9925,4410,5515
50,6,95,California,Solano County,8,17,7081,2961,4120
50,6,95,California,Solano County,8,18,7350,2570,4780
50,6,95,California,Solano County,9,0,438834,218186,220648
50,6,95,California,Solano County,9,1,27019,13830,13189
50,6,95,California,Solano County,9,2,27627,14093,13534
50,6,95,California,Solano County,9,3,27612,14201,13411
50,6,95,California,Solano County,9,4,26894,13870,13024
50,6,95,California,Solano County,9,5,29774,15942,13832
50,6,95,California,Solano County,9,6,33067,17140,15927
50,6,95,California,Solano County,9,7,31340,16048,15292
50,6,95,California,Solano County,9,8,28029,14208,13821
50,6,95,California,Solano County,9,9,25453,12802,12651
50,6,95,California,Solano County,9,10,27860,13977,13883
50,6,95,California,Solano County,9,11,30500,15046,15454
50,6,95,California,Solano County,9,12,31341,15171,16170
50,6,95,California,Solano County,9,13,27957,13224,14733
50,6,95,California,Solano County,9,14,23622,11241,12381
50,6,95,California,Solano County,9,15,15633,7136,8497
50,6,95,California,Solano County,9,16,10302,4544,5758
50,6,95,California,Solano County,9,17,7215,3035,4180
50,6,95,California,Solano County,9,18,7589,2678,4911
50,6,95,California,Solano County,10,0,443554,220835,222719
50,6,95,California,Solano County,10,1,27147,13910,13237
50,6,95,California,Solano County,10,2,27631,14057,13574
50,6,95,California,Solano County,10,3,27640,14273,13367
50,6,95,California,Solano County,10,4,26719,13710,13009
50,6,95,California,Solano County,10,5,29160,15587,13573
50,6,95,California,Solano County,10,6,33784,17661,16123
50,6,95,California,Solano County,10,7,31679,16290,15389
50,6,95,California,Solano County,10,8,29272,14936,14336
50,6,95,California,Solano County,10,9,25678,13018,12660
50,6,95,California,Solano County,10,10,27695,13878,13817
50,6,95,California,Solano County,10,11,29770,14757,15013
50,6,95,California,Solano County,10,12,31280,15180,16100
50,6,95,California,Solano County,10,13,28828,13580,15248
50,6,95,California,Solano County,10,14,23754,11285,12469
50,6,95,California,Solano County,10,15,17477,8057,9420
50,6,95,California,Solano County,10,16,10869,4769,6100
50,6,95,California,Solano County,10,17,7432,3110,4322
50,6,95,California,Solano County,10,18,7739,2777,4962
50,6,95,California,Solano County,11,0,445931,221953,223978
50,6,95,California,Solano County,11,1,27056,13935,13121
50,6,95,California,Solano County,11,2,27514,13996,13518
50,6,95,California,Solano County,11,3,27678,14312,13366
50,6,95,California,Solano County,11,4,26527,13718,12809
50,6,95,California,Solano County,11,5,28644,15244,13400
50,6,95,California,Solano County,11,6,33854,17731,16123
50,6,95,California,Solano County,11,7,31941,16373,15568
50,6,95,California,Solano County,11,8,30108,15428,14680
50,6,95,California,Solano County,11,9,26235,13217,13018
50,6,95,California,Solano County,11,10,27199,13708,13491
50,6,95,California,Solano County,11,11,28805,14255,14550
50,6,95,California,Solano County,11,12,31145,15226,15919
50,6,95,California,Solano County,11,13,29028,13617,15411
50,6,95,California,Solano County,11,14,24377,11486,12891
50,6,95,California,Solano County,11,15,18641,8545,10096
50,6,95,California,Solano County,11,16,11578,5064,6514
50,6,95,California,Solano County,11,17,7622,3173,4449
50,6,95,California,Solano County,11,18,7979,2925,5054
50,6,95,California,Solano County,12,0,447434,222702,224732
50,6,95,California,Solano County,12,1,26808,13738,13070
50,6,95,California,Solano County,12,2,27508,14070,13438
50,6,95,California,Solano County,12,3,27639,14275,13364
50,6,95,California,Solano County,12,4,26337,13590,12747
50,6,95,California,Solano County,12,5,28100,15010,13090
50,6,95,California,Solano County,12,6,33305,17449,15856
50,6,95,California,Solano County,12,7,32517,16683,15834
50,6,95,California,Solano County,12,8,30986,15971,15015
50,6,95,California,Solano County,12,9,26696,13434,13262
50,6,95,California,Solano County,12,10,26897,13631,13266
50,6,95,California,Solano County,12,11,27796,13812,13984
50,6,95,California,Solano County,12,12,30819,14968,15851
50,6,95,California,Solano County,12,13,29197,13832,15365
50,6,95,California,Solano County,12,14,24729,11475,13254
50,6,95,California,Solano County,12,15,19810,9100,10710
50,6,95,California,Solano County,12,16,12258,5400,6858
50,6,95,California,Solano County,12,17,7796,3235,4561
50,6,95,California,Solano County,12,18,8236,3029,5207
50,6,95,California,Solano County,13,0,447406,222733,224673
50,6,95,California,Solano County,13,1,26415,13527,12888
50,6,95,California,Solano County,13,2,27673,14145,13528
50,6,95,California,Solano County,13,3,27422,14135,13287
50,6,95,California,Solano County,13,4,26261,13606,12655
50,6,95,California,Solano County,13,5,27807,14841,12966
50,6,95,California,Solano County,13,6,32443,16958,15485
50,6,95,California,Solano County,13,7,32870,16935,15935
50,6,95,California,Solano County,13,8,31112,16019,15093
50,6,95,California,Solano County,13,9,27428,13884,13544
50,6,95,California,Solano County,13,10,26232,13296,12936
50,6,95,California,Solano County,13,11,27526,13760,13766
50,6,95,California,Solano County,13,12,30245,14689,15556
50,6,95,California,Solano County,13,13,29239,13847,15392
50,6,95,California,Solano County,13,14,25102,11621,13481
50,6,95,California,Solano County,13,15,20517,9443,11074
50,6,95,California,Solano County,13,16,12748,5574,7174
50,6,95,California,Solano County,13,17,7998,3364,4634
50,6,95,California,Solano County,13,18,8368,3089,5279
50,6,95,California,Solano County,14,0,446935,222532,224403
50,6,95,California,Solano County,14,1,26267,13447,12820
50,6,95,California,Solano County,14,2,27685,14149,13536
50,6,95,California,Solano County,14,3,27324,14074,13250
50,6,95,California,Solano County,14,4,26192,13591,12601
50,6,95,California,Solano County,14,5,27662,14760,12902
50,6,95,California,Solano County,14,6,32101,16771,15330
50,6,95,California,Solano County,14,7,32977,17013,15964
50,6,95,California,Solano County,14,8,31168,16050,15118
50,6,95,California,Solano County,14,9,27658,14028,13630
50,6,95,California,Solano County,14,10,26014,13191,12823
50,6,95,California,Solano County,14,11,27465,13754,13711
50,6,95,California,Solano County,14,12,30033,14593,15440
50,6,95,California,Solano County,14,13,29216,13833,15383
50,6,95,California,Solano County,14,14,25213,11664,13549
50,6,95,California,Solano County,14,15,20693,9524,11169
50,6,95,California,Solano County,14,16,12871,5609,7262
50,6,95,California,Solano County,14,17,8046,3397,4649
50,6,95,California,Solano County,14,18,8350,3084,5266
50,6,97,California,Sonoma County,1,0,483878,237902,245976
50,6,97,California,Sonoma County,1,1,28199,14419,13780
50,6,97,California,Sonoma County,1,2,29263,14967,14296
50,6,97,California,Sonoma County,1,3,29724,15176,14548
50,6,97,California,Sonoma County,1,4,33298,17210,16088
50,6,97,California,Sonoma County,1,5,32068,16797,15271
50,6,97,California,Sonoma County,1,6,31730,16536,15194
50,6,97,California,Sonoma County,1,7,29567,15252,14315
50,6,97,California,Sonoma County,1,8,28968,14601,14367
50,6,97,California,Sonoma County,1,9,31635,15937,15698
50,6,97,California,Sonoma County,1,10,36096,17391,18705
50,6,97,California,Sonoma County,1,11,37422,18095,19327
50,6,97,California,Sonoma County,1,12,36355,17311,19044
50,6,97,California,Sonoma County,1,13,32189,15323,16866
50,6,97,California,Sonoma County,1,14,21407,10122,11285
50,6,97,California,Sonoma County,1,15,14137,6470,7667
50,6,97,California,Sonoma County,1,16,10975,4780,6195
50,6,97,California,Sonoma County,1,17,9639,3805,5834
50,6,97,California,Sonoma County,1,18,11206,3710,7496
50,6,97,California,Sonoma County,2,0,483866,237893,245973
50,6,97,California,Sonoma County,2,1,28199,14419,13780
50,6,97,California,Sonoma County,2,2,29265,14968,14297
50,6,97,California,Sonoma County,2,3,29725,15176,14549
50,6,97,California,Sonoma County,2,4,33300,17210,16090
50,6,97,California,Sonoma County,2,5,32066,16795,15271
50,6,97,California,Sonoma County,2,6,31729,16536,15193
50,6,97,California,Sonoma County,2,7,29566,15251,14315
50,6,97,California,Sonoma County,2,8,28968,14601,14367
50,6,97,California,Sonoma County,2,9,31635,15937,15698
50,6,97,California,Sonoma County,2,10,36095,17391,18704
50,6,97,California,Sonoma County,2,11,37419,18092,19327
50,6,97,California,Sonoma County,2,12,36355,17311,19044
50,6,97,California,Sonoma County,2,13,32186,15322,16864
50,6,97,California,Sonoma County,2,14,21408,10123,11285
50,6,97,California,Sonoma County,2,15,14135,6470,7665
50,6,97,California,Sonoma County,2,16,10973,4779,6194
50,6,97,California,Sonoma County,2,17,9638,3804,5834
50,6,97,California,Sonoma County,2,18,11204,3708,7496
50,6,97,California,Sonoma County,3,0,484675,238190,246485
50,6,97,California,Sonoma County,3,1,28212,14445,13767
50,6,97,California,Sonoma County,3,2,29207,14928,14279
50,6,97,California,Sonoma County,3,3,29690,15160,14530
50,6,97,California,Sonoma County,3,4,33054,17004,16050
50,6,97,California,Sonoma County,3,5,32242,16847,15395
50,6,97,California,Sonoma County,3,6,31761,16562,15199
50,6,97,California,Sonoma County,3,7,29775,15324,14451
50,6,97,California,Sonoma County,3,8,28830,14557,14273
50,6,97,California,Sonoma County,3,9,31655,15920,15735
50,6,97,California,Sonoma County,3,10,35876,17328,18548
50,6,97,California,Sonoma County,3,11,37449,18082,19367
50,6,97,California,Sonoma County,3,12,36446,17343,19103
50,6,97,California,Sonoma County,3,13,32585,15531,17054
50,6,97,California,Sonoma County,3,14,21748,10274,11474
50,6,97,California,Sonoma County,3,15,14303,6556,7747
50,6,97,California,Sonoma County,3,16,10979,4790,6189
50,6,97,California,Sonoma County,3,17,9630,3817,5813
50,6,97,California,Sonoma County,3,18,11233,3722,7511
50,6,97,California,Sonoma County,4,0,487231,239068,248163
50,6,97,California,Sonoma County,4,1,27851,14203,13648
50,6,97,California,Sonoma County,4,2,29271,14942,14329
50,6,97,California,Sonoma County,4,3,29553,15081,14472
50,6,97,California,Sonoma County,4,4,32000,16298,15702
50,6,97,California,Sonoma County,4,5,32596,16972,15624
50,6,97,California,Sonoma County,4,6,31687,16582,15105
50,6,97,California,Sonoma County,4,7,30528,15545,14983
50,6,97,California,Sonoma County,4,8,28214,14371,13843
50,6,97,California,Sonoma County,4,9,31628,15839,15789
50,6,97,California,Sonoma County,4,10,34805,16924,17881
50,6,97,California,Sonoma County,4,11,37501,18073,19428
50,6,97,California,Sonoma County,4,12,36761,17480,19281
50,6,97,California,Sonoma County,4,13,34562,16452,18110
50,6,97,California,Sonoma County,4,14,23156,10930,12226
50,6,97,California,Sonoma County,4,15,15130,6946,8184
50,6,97,California,Sonoma County,4,16,11035,4830,6205
50,6,97,California,Sonoma County,4,17,9478,3778,5700
50,6,97,California,Sonoma County,4,18,11475,3822,7653
50,6,97,California,Sonoma County,5,0,489784,240104,249680
50,6,97,California,Sonoma County,5,1,27091,13801,13290
50,6,97,California,Sonoma County,5,2,29324,14998,14326
50,6,97,California,Sonoma County,5,3,29285,14959,14326
50,6,97,California,Sonoma County,5,4,31486,15884,15602
50,6,97,California,Sonoma County,5,5,32951,17126,15825
50,6,97,California,Sonoma County,5,6,31492,16423,15069
50,6,97,California,Sonoma County,5,7,31190,15885,15305
50,6,97,California,Sonoma County,5,8,28339,14452,13887
50,6,97,California,Sonoma County,5,9,31464,15666,15798
50,6,97,California,Sonoma County,5,10,33778,16589,17189
50,6,97,California,Sonoma County,5,11,37120,17837,19283
50,6,97,California,Sonoma County,5,12,37009,17678,19331
50,6,97,California,Sonoma County,5,13,34517,16274,18243
50,6,97,California,Sonoma County,5,14,26084,12366,13718
50,6,97,California,Sonoma County,5,15,16282,7468,8814
50,6,97,California,Sonoma County,5,16,11270,4965,6305
50,6,97,California,Sonoma County,5,17,9426,3829,5597
50,6,97,California,Sonoma County,5,18,11676,3904,7772
50,6,97,California,Sonoma County,6,0,493870,242079,251791
50,6,97,California,Sonoma County,6,1,26898,13715,13183
50,6,97,California,Sonoma County,6,2,29224,14974,14250
50,6,97,California,Sonoma County,6,3,29283,14965,14318
50,6,97,California,Sonoma County,6,4,30848,15464,15384
50,6,97,California,Sonoma County,6,5,32776,17062,15714
50,6,97,California,Sonoma County,6,6,31669,16444,15225
50,6,97,California,Sonoma County,6,7,32137,16389,15748
50,6,97,California,Sonoma County,6,8,28903,14687,14216
50,6,97,California,Sonoma County,6,9,31020,15472,15548
50,6,97,California,Sonoma County,6,10,32848,16264,16584
50,6,97,California,Sonoma County,6,11,36965,17733,19232
50,6,97,California,Sonoma County,6,12,37293,17838,19455
50,6,97,California,Sonoma County,6,13,35151,16528,18623
50,6,97,California,Sonoma County,6,14,28136,13355,14781
50,6,97,California,Sonoma County,6,15,17801,8204,9597
50,6,97,California,Sonoma County,6,16,11876,5255,6621
50,6,97,California,Sonoma County,6,17,9205,3746,5459
50,6,97,California,Sonoma County,6,18,11837,3984,7853
50,6,97,California,Sonoma County,7,0,498317,244016,254301
50,6,97,California,Sonoma County,7,1,26616,13562,13054
50,6,97,California,Sonoma County,7,2,28971,14767,14204
50,6,97,California,Sonoma County,7,3,29350,15102,14248
50,6,97,California,Sonoma County,7,4,30484,15208,15276
50,6,97,California,Sonoma County,7,5,32168,16764,15404
50,6,97,California,Sonoma County,7,6,32250,16745,15505
50,6,97,California,Sonoma County,7,7,32863,16605,16258
50,6,97,California,Sonoma County,7,8,29897,15207,14690
50,6,97,California,Sonoma County,7,9,30419,15188,15231
50,6,97,California,Sonoma County,7,10,32259,16071,16188
50,6,97,California,Sonoma County,7,11,36809,17601,19208
50,6,97,California,Sonoma County,7,12,37306,17810,19496
50,6,97,California,Sonoma County,7,13,35873,16847,19026
50,6,97,California,Sonoma County,7,14,30165,14172,15993
50,6,97,California,Sonoma County,7,15,19346,8988,10358
50,6,97,California,Sonoma County,7,16,12531,5584,6947
50,6,97,California,Sonoma County,7,17,9129,3765,5364
50,6,97,California,Sonoma County,7,18,11881,4030,7851
50,6,97,California,Sonoma County,8,0,500598,244835,255763
50,6,97,California,Sonoma County,8,1,26143,13206,12937
50,6,97,California,Sonoma County,8,2,28788,14739,14049
50,6,97,California,Sonoma County,8,3,29389,15057,14332
50,6,97,California,Sonoma County,8,4,30069,15044,15025
50,6,97,California,Sonoma County,8,5,30885,15952,14933
50,6,97,California,Sonoma County,8,6,32872,17098,15774
50,6,97,California,Sonoma County,8,7,32752,16628,16124
50,6,97,California,Sonoma County,8,8,31025,15683,15342
50,6,97,California,Sonoma County,8,9,29640,14877,14763
50,6,97,California,Sonoma County,8,10,32111,16011,16100
50,6,97,California,Sonoma County,8,11,36108,17279,18829
50,6,97,California,Sonoma County,8,12,37193,17732,19461
50,6,97,California,Sonoma County,8,13,36214,17019,19195
50,6,97,California,Sonoma County,8,14,32056,15010,17046
50,6,97,California,Sonoma County,8,15,20940,9700,11240
50,6,97,California,Sonoma County,8,16,13126,5829,7297
50,6,97,California,Sonoma County,8,17,9184,3827,5357
50,6,97,California,Sonoma County,8,18,12103,4144,7959
50,6,97,California,Sonoma County,9,0,502445,245613,256832
50,6,97,California,Sonoma County,9,1,25772,13047,12725
50,6,97,California,Sonoma County,9,2,28452,14606,13846
50,6,97,California,Sonoma County,9,3,29257,15012,14245
50,6,97,California,Sonoma County,9,4,29793,14903,14890
50,6,97,California,Sonoma County,9,5,30006,15251,14755
50,6,97,California,Sonoma County,9,6,33239,17256,15983
50,6,97,California,Sonoma County,9,7,32703,16662,16041
50,6,97,California,Sonoma County,9,8,31991,16126,15865
50,6,97,California,Sonoma County,9,9,29171,14751,14420
50,6,97,California,Sonoma County,9,10,32120,15961,16159
50,6,97,California,Sonoma County,9,11,34976,16851,18125
50,6,97,California,Sonoma County,9,12,37189,17756,19433
50,6,97,California,Sonoma County,9,13,36447,17049,19398
50,6,97,California,Sonoma County,9,14,33757,15820,17937
50,6,97,California,Sonoma County,9,15,22255,10282,11973
50,6,97,California,Sonoma County,9,16,13876,6172,7704
50,6,97,California,Sonoma County,9,17,9315,3905,5410
50,6,97,California,Sonoma County,9,18,12126,4203,7923
50,6,97,California,Sonoma County,10,0,502203,245498,256705
50,6,97,California,Sonoma County,10,1,25318,12911,12407
50,6,97,California,Sonoma County,10,2,27639,14098,13541
50,6,97,California,Sonoma County,10,3,29157,14953,14204
50,6,97,California,Sonoma County,10,4,29592,14887,14705
50,6,97,California,Sonoma County,10,5,29120,14763,14357
50,6,97,California,Sonoma County,10,6,33026,17198,15828
50,6,97,California,Sonoma County,10,7,32527,16642,15885
50,6,97,California,Sonoma County,10,8,32522,16326,16196
50,6,97,California,Sonoma County,10,9,29334,14810,14524
50,6,97,California,Sonoma County,10,10,31850,15816,16034
50,6,97,California,Sonoma County,10,11,33799,16447,17352
50,6,97,California,Sonoma County,10,12,36855,17551,19304
50,6,97,California,Sonoma County,10,13,36528,17083,19445
50,6,97,California,Sonoma County,10,14,33563,15560,18003
50,6,97,California,Sonoma County,10,15,24939,11580,13359
50,6,97,California,Sonoma County,10,16,14766,6603,8163
50,6,97,California,Sonoma County,10,17,9550,4013,5537
50,6,97,California,Sonoma County,10,18,12118,4257,7861
50,6,97,California,Sonoma County,11,0,497221,242767,254454
50,6,97,California,Sonoma County,11,1,24469,12460,12009
50,6,97,California,Sonoma County,11,2,26913,13713,13200
50,6,97,California,Sonoma County,11,3,28831,14741,14090
50,6,97,California,Sonoma County,11,4,29503,14830,14673
50,6,97,California,Sonoma County,11,5,27775,13972,13803
50,6,97,California,Sonoma County,11,6,32501,16835,15666
50,6,97,California,Sonoma County,11,7,31815,16315,15500
50,6,97,California,Sonoma County,11,8,32809,16420,16389
50,6,97,California,Sonoma County,11,9,29475,14894,14581
50,6,97,California,Sonoma County,11,10,31023,15376,15647
50,6,97,California,Sonoma County,11,11,32461,15923,16538
50,6,97,California,Sonoma County,11,12,36101,17190,18911
50,6,97,California,Sonoma County,11,13,36003,16933,19070
50,6,97,California,Sonoma County,11,14,33461,15391,18070
50,6,97,California,Sonoma County,11,15,26395,12266,14129
50,6,97,California,Sonoma County,11,16,15933,7137,8796
50,6,97,California,Sonoma County,11,17,9833,4140,5693
50,6,97,California,Sonoma County,11,18,11920,4231,7689
50,6,97,California,Sonoma County,12,0,492318,240376,251942
50,6,97,California,Sonoma County,12,1,23769,12140,11629
50,6,97,California,Sonoma County,12,2,26210,13304,12906
50,6,97,California,Sonoma County,12,3,28160,14387,13773
50,6,97,California,Sonoma County,12,4,29314,14807,14507
50,6,97,California,Sonoma County,12,5,27076,13609,13467
50,6,97,California,Sonoma County,12,6,31350,16212,15138
50,6,97,California,Sonoma County,12,7,31347,16082,15265
50,6,97,California,Sonoma County,12,8,32672,16324,16348
50,6,97,California,Sonoma County,12,9,29764,15028,14736
50,6,97,California,Sonoma County,12,10,29910,14941,14969
50,6,97,California,Sonoma County,12,11,31360,15513,15847
50,6,97,California,Sonoma County,12,12,35375,16740,18635
50,6,97,California,Sonoma County,12,13,35306,16606,18700
50,6,97,California,Sonoma County,12,14,33467,15470,17997
50,6,97,California,Sonoma County,12,15,27825,12763,15062
50,6,97,California,Sonoma County,12,16,17202,7805,9397
50,6,97,California,Sonoma County,12,17,10322,4371,5951
50,6,97,California,Sonoma County,12,18,11889,4274,7615
50,6,97,California,Sonoma County,13,0,490747,239694,251053
50,6,97,California,Sonoma County,13,1,23289,11976,11313
50,6,97,California,Sonoma County,13,2,25729,12998,12731
50,6,97,California,Sonoma County,13,3,27983,14329,13654
50,6,97,California,Sonoma County,13,4,29142,14678,14464
50,6,97,California,Sonoma County,13,5,26784,13513,13271
50,6,97,California,Sonoma County,13,6,30648,15859,14789
50,6,97,California,Sonoma County,13,7,31497,16169,15328
50,6,97,California,Sonoma County,13,8,32466,16282,16184
50,6,97,California,Sonoma County,13,9,30285,15262,15023
50,6,97,California,Sonoma County,13,10,29158,14548,14610
50,6,97,California,Sonoma County,13,11,31137,15472,15665
50,6,97,California,Sonoma County,13,12,34621,16417,18204
50,6,97,California,Sonoma County,13,13,35037,16470,18567
50,6,97,California,Sonoma County,13,14,33481,15487,17994
50,6,97,California,Sonoma County,13,15,28829,13218,15611
50,6,97,California,Sonoma County,13,16,18146,8223,9923
50,6,97,California,Sonoma County,13,17,10557,4478,6079
50,6,97,California,Sonoma County,13,18,11958,4315,7643
50,6,97,California,Sonoma County,14,0,489819,239269,250550
50,6,97,California,Sonoma County,14,1,23122,11914,11208
50,6,97,California,Sonoma County,14,2,25530,12875,12655
50,6,97,California,Sonoma County,14,3,27904,14301,13603
50,6,97,California,Sonoma County,14,4,29061,14621,14440
50,6,97,California,Sonoma County,14,5,26658,13466,13192
50,6,97,California,Sonoma County,14,6,30376,15720,14656
50,6,97,California,Sonoma County,14,7,31559,16202,15357
50,6,97,California,Sonoma County,14,8,32422,16285,16137
50,6,97,California,Sonoma County,14,9,30456,15342,15114
50,6,97,California,Sonoma County,14,10,28904,14420,14484
50,6,97,California,Sonoma County,14,11,31113,15479,15634
50,6,97,California,Sonoma County,14,12,34350,16301,18049
50,6,97,California,Sonoma County,14,13,34902,16397,18505
50,6,97,California,Sonoma County,14,14,33482,15491,17991
50,6,97,California,Sonoma County,14,15,29079,13323,15756
50,6,97,California,Sonoma County,14,16,18389,8332,10057
50,6,97,California,Sonoma County,14,17,10621,4508,6113
50,6,97,California,Sonoma County,14,18,11891,4292,7599
50,6,99,California,Stanislaus County,1,0,514453,254489,259964
50,6,99,California,Stanislaus County,1,1,39779,20327,19452
50,6,99,California,Stanislaus County,1,2,40013,20402,19611
50,6,99,California,Stanislaus County,1,3,41276,21399,19877
50,6,99,California,Stanislaus County,1,4,42807,22193,20614
50,6,99,California,Stanislaus County,1,5,37119,18792,18327
50,6,99,California,Stanislaus County,1,6,36474,18326,18148
50,6,99,California,Stanislaus County,1,7,33720,16883,16837
50,6,99,California,Stanislaus County,1,8,33125,16465,16660
50,6,99,California,Stanislaus County,1,9,33601,16678,16923
50,6,99,California,Stanislaus County,1,10,35785,17703,18082
50,6,99,California,Stanislaus County,1,11,33773,16605,17168
50,6,99,California,Stanislaus County,1,12,28545,13854,14691
50,6,99,California,Stanislaus County,1,13,23605,11236,12369
50,6,99,California,Stanislaus County,1,14,16929,7868,9061
50,6,99,California,Stanislaus County,1,15,12708,5756,6952
50,6,99,California,Stanislaus County,1,16,9963,4308,5655
50,6,99,California,Stanislaus County,1,17,7822,3112,4710
50,6,99,California,Stanislaus County,1,18,7409,2582,4827
50,6,99,California,Stanislaus County,2,0,514451,254486,259965
50,6,99,California,Stanislaus County,2,1,39778,20326,19452
50,6,99,California,Stanislaus County,2,2,40012,20402,19610
50,6,99,California,Stanislaus County,2,3,41278,21400,19878
50,6,99,California,Stanislaus County,2,4,42808,22193,20615
50,6,99,California,Stanislaus County,2,5,37119,18792,18327
50,6,99,California,Stanislaus County,2,6,36472,18325,18147
50,6,99,California,Stanislaus County,2,7,33720,16883,16837
50,6,99,California,Stanislaus County,2,8,33125,16465,16660
50,6,99,California,Stanislaus County,2,9,33602,16678,16924
50,6,99,California,Stanislaus County,2,10,35785,17703,18082
50,6,99,California,Stanislaus County,2,11,33773,16605,17168
50,6,99,California,Stanislaus County,2,12,28543,13852,14691
50,6,99,California,Stanislaus County,2,13,23605,11236,12369
50,6,99,California,Stanislaus County,2,14,16929,7868,9061
50,6,99,California,Stanislaus County,2,15,12708,5756,6952
50,6,99,California,Stanislaus County,2,16,9963,4308,5655
50,6,99,California,Stanislaus County,2,17,7822,3112,4710
50,6,99,California,Stanislaus County,2,18,7409,2582,4827
50,6,99,California,Stanislaus County,3,0,515137,254794,260343
50,6,99,California,Stanislaus County,3,1,39728,20305,19423
50,6,99,California,Stanislaus County,3,2,40014,20412,19602
50,6,99,California,Stanislaus County,3,3,41111,21279,19832
50,6,99,California,Stanislaus County,3,4,42469,22058,20411
50,6,99,California,Stanislaus County,3,5,37530,18986,18544
50,6,99,California,Stanislaus County,3,6,36521,18361,18160
50,6,99,California,Stanislaus County,3,7,33864,16939,16925
50,6,99,California,Stanislaus County,3,8,33009,16404,16605
50,6,99,California,Stanislaus County,3,9,33614,16667,16947
50,6,99,California,Stanislaus County,3,10,35562,17573,17989
50,6,99,California,Stanislaus County,3,11,33957,16720,17237
50,6,99,California,Stanislaus County,3,12,28813,13986,14827
50,6,99,California,Stanislaus County,3,13,23852,11370,12482
50,6,99,California,Stanislaus County,3,14,17096,7948,9148
50,6,99,California,Stanislaus County,3,15,12746,5772,6974
50,6,99,California,Stanislaus County,3,16,9989,4315,5674
50,6,99,California,Stanislaus County,3,17,7808,3107,4701
50,6,99,California,Stanislaus County,3,18,7454,2592,4862
50,6,99,California,Stanislaus County,4,0,517515,255890,261625
50,6,99,California,Stanislaus County,4,1,39622,20258,19364
50,6,99,California,Stanislaus County,4,2,40041,20480,19561
50,6,99,California,Stanislaus County,4,3,40527,20812,19715
50,6,99,California,Stanislaus County,4,4,41317,21624,19693
50,6,99,California,Stanislaus County,4,5,38825,19504,19321
50,6,99,California,Stanislaus County,4,6,36452,18319,18133
50,6,99,California,Stanislaus County,4,7,34577,17360,17217
50,6,99,California,Stanislaus County,4,8,32320,16064,16256
50,6,99,California,Stanislaus County,4,9,33754,16715,17039
50,6,99,California,Stanislaus County,4,10,34476,16958,17518
50,6,99,California,Stanislaus County,4,11,34447,16998,17449
50,6,99,California,Stanislaus County,4,12,29761,14448,15313
50,6,99,California,Stanislaus County,4,13,24900,11916,12984
50,6,99,California,Stanislaus County,4,14,17871,8368,9503
50,6,99,California,Stanislaus County,4,15,13000,5870,7130
50,6,99,California,Stanislaus County,4,16,10211,4421,5790
50,6,99,California,Stanislaus County,4,17,7724,3097,4627
50,6,99,California,Stanislaus County,4,18,7690,2678,5012
50,6,99,California,Stanislaus County,5,0,520336,257186,263150
50,6,99,California,Stanislaus County,5,1,39338,20160,19178
50,6,99,California,Stanislaus County,5,2,40382,20587,19795
50,6,99,California,Stanislaus County,5,3,40245,20612,19633
50,6,99,California,Stanislaus County,5,4,40598,21144,19454
50,6,99,California,Stanislaus County,5,5,39284,19730,19554
50,6,99,California,Stanislaus County,5,6,36794,18529,18265
50,6,99,California,Stanislaus County,5,7,34966,17479,17487
50,6,99,California,Stanislaus County,5,8,32352,16122,16230
50,6,99,California,Stanislaus County,5,9,33641,16674,16967
50,6,99,California,Stanislaus County,5,10,33607,16521,17086
50,6,99,California,Stanislaus County,5,11,34540,17067,17473
50,6,99,California,Stanislaus County,5,12,30583,14885,15698
50,6,99,California,Stanislaus County,5,13,25035,12004,13031
50,6,99,California,Stanislaus County,5,14,19409,9136,10273
50,6,99,California,Stanislaus County,5,15,13596,6163,7433
50,6,99,California,Stanislaus County,5,16,10451,4523,5928
50,6,99,California,Stanislaus County,5,17,7672,3093,4579
50,6,99,California,Stanislaus County,5,18,7843,2757,5086
50,6,99,California,Stanislaus County,6,0,523313,258737,264576
50,6,99,California,Stanislaus County,6,1,38774,19814,18960
50,6,99,California,Stanislaus County,6,2,40586,20605,19981
50,6,99,California,Stanislaus County,6,3,40387,20738,19649
50,6,99,California,Stanislaus County,6,4,40007,20716,19291
50,6,99,California,Stanislaus County,6,5,39139,19863,19276
50,6,99,California,Stanislaus County,6,6,37125,18764,18361
50,6,99,California,Stanislaus County,6,7,35676,17919,17757
50,6,99,California,Stanislaus County,6,8,32752,16343,16409
50,6,99,California,Stanislaus County,6,9,33353,16563,16790
50,6,99,California,Stanislaus County,6,10,33013,16249,16764
50,6,99,California,Stanislaus County,6,11,34629,17072,17557
50,6,99,California,Stanislaus County,6,12,30994,15061,15933
50,6,99,California,Stanislaus County,6,13,25670,12330,13340
50,6,99,California,Stanislaus County,6,14,20397,9585,10812
50,6,99,California,Stanislaus County,6,15,14363,6527,7836
50,6,99,California,Stanislaus County,6,16,10701,4607,6094
50,6,99,California,Stanislaus County,6,17,7745,3177,4568
50,6,99,California,Stanislaus County,6,18,8002,2804,5198
50,6,99,California,Stanislaus County,7,0,527814,261010,266804
50,6,99,California,Stanislaus County,7,1,38951,19890,19061
50,6,99,California,Stanislaus County,7,2,40965,20805,20160
50,6,99,California,Stanislaus County,7,3,40412,20723,19689
50,6,99,California,Stanislaus County,7,4,39480,20362,19118
50,6,99,California,Stanislaus County,7,5,39132,19997,19135
50,6,99,California,Stanislaus County,7,6,37835,19075,18760
50,6,99,California,Stanislaus County,7,7,36309,18288,18021
50,6,99,California,Stanislaus County,7,8,33184,16623,16561
50,6,99,California,Stanislaus County,7,9,32854,16323,16531
50,6,99,California,Stanislaus County,7,10,32695,16145,16550
50,6,99,California,Stanislaus County,7,11,34707,17022,17685
50,6,99,California,Stanislaus County,7,12,31500,15296,16204
50,6,99,California,Stanislaus County,7,13,26395,12680,13715
50,6,99,California,Stanislaus County,7,14,21390,10061,11329
50,6,99,California,Stanislaus County,7,15,15020,6829,8191
50,6,99,California,Stanislaus County,7,16,10974,4786,6188
50,6,99,California,Stanislaus County,7,17,7865,3246,4619
50,6,99,California,Stanislaus County,7,18,8146,2859,5287
50,6,99,California,Stanislaus County,8,0,532954,263691,269263
50,6,99,California,Stanislaus County,8,1,39085,19930,19155
50,6,99,California,Stanislaus County,8,2,41342,21016,20326
50,6,99,California,Stanislaus County,8,3,40695,20833,19862
50,6,99,California,Stanislaus County,8,4,39304,20241,19063
50,6,99,California,Stanislaus County,8,5,38418,19657,18761
50,6,99,California,Stanislaus County,8,6,38955,19662,19293
50,6,99,California,Stanislaus County,8,7,36918,18634,18284
50,6,99,California,Stanislaus County,8,8,34046,17096,16950
50,6,99,California,Stanislaus County,8,9,32486,16216,16270
50,6,99,California,Stanislaus County,8,10,32729,16187,16542
50,6,99,California,Stanislaus County,8,11,34173,16720,17453
50,6,99,California,Stanislaus County,8,12,32156,15712,16444
50,6,99,California,Stanislaus County,8,13,26977,13002,13975
50,6,99,California,Stanislaus County,8,14,22333,10380,11953
50,6,99,California,Stanislaus County,8,15,15734,7193,8541
50,6,99,California,Stanislaus County,8,16,11187,4905,6282
50,6,99,California,Stanislaus County,8,17,8045,3322,4723
50,6,99,California,Stanislaus County,8,18,8371,2985,5386
50,6,99,California,Stanislaus County,9,0,538986,266614,272372
50,6,99,California,Stanislaus County,9,1,39409,20069,19340
50,6,99,California,Stanislaus County,9,2,41742,21162,20580
50,6,99,California,Stanislaus County,9,3,41455,21292,20163
50,6,99,California,Stanislaus County,9,4,39245,20178,19067
50,6,99,California,Stanislaus County,9,5,37481,19246,18235
50,6,99,California,Stanislaus County,9,6,40733,20514,20219
50,6,99,California,Stanislaus County,9,7,37516,18960,18556
50,6,99,California,Stanislaus County,9,8,35021,17511,17510
50,6,99,California,Stanislaus County,9,9,32180,16066,16114
50,6,99,California,Stanislaus County,9,10,33027,16334,16693
50,6,99,California,Stanislaus County,9,11,33369,16332,17037
50,6,99,California,Stanislaus County,9,12,32601,15913,16688
50,6,99,California,Stanislaus County,9,13,27788,13359,14429
50,6,99,California,Stanislaus County,9,14,23107,10800,12307
50,6,99,California,Stanislaus County,9,15,16346,7496,8850
50,6,99,California,Stanislaus County,9,16,11344,4985,6359
50,6,99,California,Stanislaus County,9,17,8196,3363,4833
50,6,99,California,Stanislaus County,9,18,8426,3034,5392
50,6,99,California,Stanislaus County,10,0,544494,269527,274967
50,6,99,California,Stanislaus County,10,1,39733,20287,19446
50,6,99,California,Stanislaus County,10,2,41656,21107,20549
50,6,99,California,Stanislaus County,10,3,42323,21546,20777
50,6,99,California,Stanislaus County,10,4,39316,20267,19049
50,6,99,California,Stanislaus County,10,5,37441,19197,18244
50,6,99,California,Stanislaus County,10,6,41262,20789,20473
50,6,99,California,Stanislaus County,10,7,37993,19351,18642
50,6,99,California,Stanislaus County,10,8,35840,17912,17928
50,6,99,California,Stanislaus County,10,9,32427,16265,16162
50,6,99,California,Stanislaus County,10,10,33137,16390,16747
50,6,99,California,Stanislaus County,10,11,32785,16092,16693
50,6,99,California,Stanislaus County,10,12,32802,16042,16760
50,6,99,California,Stanislaus County,10,13,28467,13701,14766
50,6,99,California,Stanislaus County,10,14,23211,10805,12406
50,6,99,California,Stanislaus County,10,15,17659,8124,9535
50,6,99,California,Stanislaus County,10,16,11695,5160,6535
50,6,99,California,Stanislaus County,10,17,8344,3446,4898
50,6,99,California,Stanislaus County,10,18,8403,3046,5357
50,6,99,California,Stanislaus County,11,0,547855,271373,276482
50,6,99,California,Stanislaus County,11,1,39446,20105,19341
50,6,99,California,Stanislaus County,11,2,41538,21088,20450
50,6,99,California,Stanislaus County,11,3,42852,21780,21072
50,6,99,California,Stanislaus County,11,4,39513,20383,19130
50,6,99,California,Stanislaus County,11,5,37072,18899,18173
50,6,99,California,Stanislaus County,11,6,41202,20847,20355
50,6,99,California,Stanislaus County,11,7,38491,19592,18899
50,6,99,California,Stanislaus County,11,8,36575,18438,18137
50,6,99,California,Stanislaus County,11,9,32948,16550,16398
50,6,99,California,Stanislaus County,11,10,32908,16349,16559
50,6,99,California,Stanislaus County,11,11,32205,15830,16375
50,6,99,California,Stanislaus County,11,12,32843,16034,16809
50,6,99,California,Stanislaus County,11,13,28956,13976,14980
50,6,99,California,Stanislaus County,11,14,23554,10964,12590
50,6,99,California,Stanislaus County,11,15,18460,8490,9970
50,6,99,California,Stanislaus County,11,16,12314,5447,6867
50,6,99,California,Stanislaus County,11,17,8433,3469,4964
50,6,99,California,Stanislaus County,11,18,8545,3132,5413
50,6,99,California,Stanislaus County,12,0,549761,272561,277200
50,6,99,California,Stanislaus County,12,1,39138,19964,19174
50,6,99,California,Stanislaus County,12,2,41269,21053,20216
50,6,99,California,Stanislaus County,12,3,43123,21925,21198
50,6,99,California,Stanislaus County,12,4,39707,20428,19279
50,6,99,California,Stanislaus County,12,5,36585,18601,17984
50,6,99,California,Stanislaus County,12,6,41168,21040,20128
50,6,99,California,Stanislaus County,12,7,38983,19739,19244
50,6,99,California,Stanislaus County,12,8,37223,18832,18391
50,6,99,California,Stanislaus County,12,9,33282,16782,16500
50,6,99,California,Stanislaus County,12,10,32344,16117,16227
50,6,99,California,Stanislaus County,12,11,31663,15625,16038
50,6,99,California,Stanislaus County,12,12,32804,15973,16831
50,6,99,California,Stanislaus County,12,13,29246,14076,15170
50,6,99,California,Stanislaus County,12,14,23945,11160,12785
50,6,99,California,Stanislaus County,12,15,19183,8770,10413
50,6,99,California,Stanislaus County,12,16,12888,5682,7206
50,6,99,California,Stanislaus County,12,17,8614,3597,5017
50,6,99,California,Stanislaus County,12,18,8596,3197,5399
50,6,99,California,Stanislaus County,13,0,550391,272971,277420
50,6,99,California,Stanislaus County,13,1,38585,19684,18901
50,6,99,California,Stanislaus County,13,2,41223,20986,20237
50,6,99,California,Stanislaus County,13,3,43119,21963,21156
50,6,99,California,Stanislaus County,13,4,39877,20493,19384
50,6,99,California,Stanislaus County,13,5,36587,18603,17984
50,6,99,California,Stanislaus County,13,6,40426,20659,19767
50,6,99,California,Stanislaus County,13,7,39570,20077,19493
50,6,99,California,Stanislaus County,13,8,37151,18800,18351
50,6,99,California,Stanislaus County,13,9,33888,17098,16790
50,6,99,California,Stanislaus County,13,10,31923,15967,15956
50,6,99,California,Stanislaus County,13,11,31571,15636,15935
50,6,99,California,Stanislaus County,13,12,32230,15657,16573
50,6,99,California,Stanislaus County,13,13,29611,14273,15338
50,6,99,California,Stanislaus County,13,14,24324,11376,12948
50,6,99,California,Stanislaus County,13,15,19602,8900,10702
50,6,99,California,Stanislaus County,13,16,13269,5891,7378
50,6,99,California,Stanislaus County,13,17,8674,3635,5039
50,6,99,California,Stanislaus County,13,18,8761,3273,5488
50,6,99,California,Stanislaus County,14,0,550081,272830,277251
50,6,99,California,Stanislaus County,14,1,38384,19574,18810
50,6,99,California,Stanislaus County,14,2,41143,20933,20210
50,6,99,California,Stanislaus County,14,3,43076,21958,21118
50,6,99,California,Stanislaus County,14,4,39894,20490,19404
50,6,99,California,Stanislaus County,14,5,36531,18574,17957
50,6,99,California,Stanislaus County,14,6,40113,20503,19610
50,6,99,California,Stanislaus County,14,7,39766,20185,19581
50,6,99,California,Stanislaus County,14,8,37144,18805,18339
50,6,99,California,Stanislaus County,14,9,34067,17190,16877
50,6,99,California,Stanislaus County,14,10,31783,15919,15864
50,6,99,California,Stanislaus County,14,11,31568,15647,15921
50,6,99,California,Stanislaus County,14,12,32012,15541,16471
50,6,99,California,Stanislaus County,14,13,29684,14306,15378
50,6,99,California,Stanislaus County,14,14,24441,11444,12997
50,6,99,California,Stanislaus County,14,15,19691,8916,10775
50,6,99,California,Stanislaus County,14,16,13350,5935,7415
50,6,99,California,Stanislaus County,14,17,8683,3640,5043
50,6,99,California,Stanislaus County,14,18,8751,3270,5481
50,6,101,California,Sutter County,1,0,94737,47001,47736
50,6,101,California,Sutter County,1,1,7153,3621,3532
50,6,101,California,Sutter County,1,2,7292,3763,3529
50,6,101,California,Sutter County,1,3,7146,3615,3531
50,6,101,California,Sutter County,1,4,7377,3916,3461
50,6,101,California,Sutter County,1,5,6286,3307,2979
50,6,101,California,Sutter County,1,6,6528,3218,3310
50,6,101,California,Sutter County,1,7,6138,3116,3022
50,6,101,California,Sutter County,1,8,5879,2950,2929
50,6,101,California,Sutter County,1,9,6101,3002,3099
50,6,101,California,Sutter County,1,10,6548,3273,3275
50,6,101,California,Sutter County,1,11,6194,3054,3140
50,6,101,California,Sutter County,1,12,5412,2659,2753
50,6,101,California,Sutter County,1,13,4693,2254,2439
50,6,101,California,Sutter County,1,14,3612,1654,1958
50,6,101,California,Sutter County,1,15,2878,1345,1533
50,6,101,California,Sutter County,1,16,2346,1089,1257
50,6,101,California,Sutter County,1,17,1633,660,973
50,6,101,California,Sutter County,1,18,1521,505,1016
50,6,101,California,Sutter County,2,0,94751,47008,47743
50,6,101,California,Sutter County,2,1,7153,3621,3532
50,6,101,California,Sutter County,2,2,7291,3763,3528
50,6,101,California,Sutter County,2,3,7148,3615,3533
50,6,101,California,Sutter County,2,4,7376,3914,3462
50,6,101,California,Sutter County,2,5,6287,3307,2980
50,6,101,California,Sutter County,2,6,6528,3218,3310
50,6,101,California,Sutter County,2,7,6138,3116,3022
50,6,101,California,Sutter County,2,8,5880,2951,2929
50,6,101,California,Sutter County,2,9,6100,3001,3099
50,6,101,California,Sutter County,2,10,6550,3275,3275
50,6,101,California,Sutter County,2,11,6196,3055,3141
50,6,101,California,Sutter County,2,12,5414,2661,2753
50,6,101,California,Sutter County,2,13,4696,2256,2440
50,6,101,California,Sutter County,2,14,3615,1655,1960
50,6,101,California,Sutter County,2,15,2879,1346,1533
50,6,101,California,Sutter County,2,16,2346,1089,1257
50,6,101,California,Sutter County,2,17,1633,660,973
50,6,101,California,Sutter County,2,18,1521,505,1016
50,6,101,California,Sutter County,3,0,94742,47014,47728
50,6,101,California,Sutter County,3,1,7124,3611,3513
50,6,101,California,Sutter County,3,2,7263,3738,3525
50,6,101,California,Sutter County,3,3,7163,3625,3538
50,6,101,California,Sutter County,3,4,7283,3863,3420
50,6,101,California,Sutter County,3,5,6355,3331,3024
50,6,101,California,Sutter County,3,6,6530,3241,3289
50,6,101,California,Sutter County,3,7,6136,3115,3021
50,6,101,California,Sutter County,3,8,5855,2921,2934
50,6,101,California,Sutter County,3,9,6068,2991,3077
50,6,101,California,Sutter County,3,10,6536,3273,3263
50,6,101,California,Sutter County,3,11,6224,3070,3154
50,6,101,California,Sutter County,3,12,5430,2669,2761
50,6,101,California,Sutter County,3,13,4737,2281,2456
50,6,101,California,Sutter County,3,14,3633,1659,1974
50,6,101,California,Sutter County,3,15,2878,1347,1531
50,6,101,California,Sutter County,3,16,2355,1096,1259
50,6,101,California,Sutter County,3,17,1649,678,971
50,6,101,California,Sutter County,3,18,1523,505,1018
50,6,101,California,Sutter County,4,0,94466,46855,47611
50,6,101,California,Sutter County,4,1,6919,3541,3378
50,6,101,California,Sutter County,4,2,7245,3718,3527
50,6,101,California,Sutter County,4,3,7048,3558,3490
50,6,101,California,Sutter County,4,4,6993,3705,3288
50,6,101,California,Sutter County,4,5,6613,3416,3197
50,6,101,California,Sutter County,4,6,6539,3267,3272
50,6,101,California,Sutter County,4,7,6119,3113,3006
50,6,101,California,Sutter County,4,8,5672,2767,2905
50,6,101,California,Sutter County,4,9,5942,2958,2984
50,6,101,California,Sutter County,4,10,6433,3251,3182
50,6,101,California,Sutter County,4,11,6268,3085,3183
50,6,101,California,Sutter County,4,12,5536,2700,2836
50,6,101,California,Sutter County,4,13,4882,2373,2509
50,6,101,California,Sutter County,4,14,3701,1671,2030
50,6,101,California,Sutter County,4,15,2886,1343,1543
50,6,101,California,Sutter County,4,16,2393,1113,1280
50,6,101,California,Sutter County,4,17,1719,756,963
50,6,101,California,Sutter County,4,18,1558,520,1038
50,6,101,California,Sutter County,5,0,94153,46788,47365
50,6,101,California,Sutter County,5,1,6709,3436,3273
50,6,101,California,Sutter County,5,2,7280,3745,3535
50,6,101,California,Sutter County,5,3,7083,3590,3493
50,6,101,California,Sutter County,5,4,6729,3532,3197
50,6,101,California,Sutter County,5,5,6710,3482,3228
50,6,101,California,Sutter County,5,6,6460,3301,3159
50,6,101,California,Sutter County,5,7,6058,3019,3039
50,6,101,California,Sutter County,5,8,5637,2797,2840
50,6,101,California,Sutter County,5,9,5851,2913,2938
50,6,101,California,Sutter County,5,10,6144,3093,3051
50,6,101,California,Sutter County,5,11,6296,3108,3188
50,6,101,California,Sutter County,5,12,5689,2758,2931
50,6,101,California,Sutter County,5,13,4801,2361,2440
50,6,101,California,Sutter County,5,14,3908,1794,2114
50,6,101,California,Sutter County,5,15,2969,1387,1582
50,6,101,California,Sutter County,5,16,2439,1087,1352
50,6,101,California,Sutter County,5,17,1764,807,957
50,6,101,California,Sutter County,5,18,1626,578,1048
50,6,101,California,Sutter County,6,0,94457,46969,47488
50,6,101,California,Sutter County,6,1,6565,3361,3204
50,6,101,California,Sutter County,6,2,7241,3748,3493
50,6,101,California,Sutter County,6,3,7052,3573,3479
50,6,101,California,Sutter County,6,4,6626,3449,3177
50,6,101,California,Sutter County,6,5,6726,3482,3244
50,6,101,California,Sutter County,6,6,6530,3334,3196
50,6,101,California,Sutter County,6,7,6077,3044,3033
50,6,101,California,Sutter County,6,8,5642,2822,2820
50,6,101,California,Sutter County,6,9,5854,2906,2948
50,6,101,California,Sutter County,6,10,5987,2989,2998
50,6,101,California,Sutter County,6,11,6355,3139,3216
50,6,101,California,Sutter County,6,12,5833,2877,2956
50,6,101,California,Sutter County,6,13,4779,2331,2448
50,6,101,California,Sutter County,6,14,4094,1926,2168
50,6,101,California,Sutter County,6,15,3095,1414,1681
50,6,101,California,Sutter County,6,16,2480,1128,1352
50,6,101,California,Sutter County,6,17,1843,839,1004
50,6,101,California,Sutter County,6,18,1678,607,1071
50,6,101,California,Sutter County,7,0,94721,47049,47672
50,6,101,California,Sutter County,7,1,6500,3390,3110
50,6,101,California,Sutter County,7,2,7187,3671,3516
50,6,101,California,Sutter County,7,3,7166,3675,3491
50,6,101,California,Sutter County,7,4,6561,3371,3190
50,6,101,California,Sutter County,7,5,6610,3426,3184
50,6,101,California,Sutter County,7,6,6527,3342,3185
50,6,101,California,Sutter County,7,7,6229,3059,3170
50,6,101,California,Sutter County,7,8,5678,2870,2808
50,6,101,California,Sutter County,7,9,5731,2862,2869
50,6,101,California,Sutter County,7,10,5773,2843,2930
50,6,101,California,Sutter County,7,11,6326,3130,3196
50,6,101,California,Sutter County,7,12,5933,2907,3026
50,6,101,California,Sutter County,7,13,4913,2391,2522
50,6,101,California,Sutter County,7,14,4253,2020,2233
50,6,101,California,Sutter County,7,15,3211,1450,1761
50,6,101,California,Sutter County,7,16,2482,1125,1357
50,6,101,California,Sutter County,7,17,1904,878,1026
50,6,101,California,Sutter County,7,18,1737,639,1098
50,6,101,California,Sutter County,8,0,95224,47277,47947
50,6,101,California,Sutter County,8,1,6571,3386,3185
50,6,101,California,Sutter County,8,2,7062,3622,3440
50,6,101,California,Sutter County,8,3,7187,3732,3455
50,6,101,California,Sutter County,8,4,6514,3339,3175
50,6,101,California,Sutter County,8,5,6527,3397,3130
50,6,101,California,Sutter County,8,6,6629,3356,3273
50,6,101,California,Sutter County,8,7,6241,3069,3172
50,6,101,California,Sutter County,8,8,5837,2955,2882
50,6,101,California,Sutter County,8,9,5600,2767,2833
50,6,101,California,Sutter County,8,10,5748,2827,2921
50,6,101,California,Sutter County,8,11,6229,3094,3135
50,6,101,California,Sutter County,8,12,5987,2943,3044
50,6,101,California,Sutter County,8,13,5135,2501,2634
50,6,101,California,Sutter County,8,14,4385,2123,2262
50,6,101,California,Sutter County,8,15,3315,1471,1844
50,6,101,California,Sutter County,8,16,2482,1118,1364
50,6,101,California,Sutter County,8,17,1963,902,1061
50,6,101,California,Sutter County,8,18,1812,675,1137
50,6,101,California,Sutter County,9,0,95769,47685,48084
50,6,101,California,Sutter County,9,1,6715,3470,3245
50,6,101,California,Sutter County,9,2,7118,3650,3468
50,6,101,California,Sutter County,9,3,7201,3736,3465
50,6,101,California,Sutter County,9,4,6545,3372,3173
50,6,101,California,Sutter County,9,5,6279,3319,2960
50,6,101,California,Sutter County,9,6,6872,3519,3353
50,6,101,California,Sutter County,9,7,6295,3127,3168
50,6,101,California,Sutter County,9,8,5933,2989,2944
50,6,101,California,Sutter County,9,9,5560,2723,2837
50,6,101,California,Sutter County,9,10,5632,2784,2848
50,6,101,California,Sutter County,9,11,6110,3085,3025
50,6,101,California,Sutter County,9,12,5998,2918,3080
50,6,101,California,Sutter County,9,13,5292,2574,2718
50,6,101,California,Sutter County,9,14,4442,2155,2287
50,6,101,California,Sutter County,9,15,3405,1493,1912
50,6,101,California,Sutter County,9,16,2499,1147,1352
50,6,101,California,Sutter County,9,17,1932,868,1064
50,6,101,California,Sutter County,9,18,1941,756,1185
50,6,101,California,Sutter County,10,0,96161,47862,48299
50,6,101,California,Sutter County,10,1,6645,3460,3185
50,6,101,California,Sutter County,10,2,6970,3591,3379
50,6,101,California,Sutter County,10,3,7293,3764,3529
50,6,101,California,Sutter County,10,4,6507,3341,3166
50,6,101,California,Sutter County,10,5,6135,3191,2944
50,6,101,California,Sutter County,10,6,7124,3684,3440
50,6,101,California,Sutter County,10,7,6379,3224,3155
50,6,101,California,Sutter County,10,8,6056,3015,3041
50,6,101,California,Sutter County,10,9,5521,2731,2790
50,6,101,California,Sutter County,10,10,5631,2767,2864
50,6,101,California,Sutter County,10,11,5915,2959,2956
50,6,101,California,Sutter County,10,12,6079,2946,3133
50,6,101,California,Sutter County,10,13,5474,2674,2800
50,6,101,California,Sutter County,10,14,4356,2097,2259
50,6,101,California,Sutter County,10,15,3562,1613,1949
50,6,101,California,Sutter County,10,16,2615,1192,1423
50,6,101,California,Sutter County,10,17,1928,825,1103
50,6,101,California,Sutter County,10,18,1971,788,1183
50,6,101,California,Sutter County,11,0,96348,47985,48363
50,6,101,California,Sutter County,11,1,6640,3472,3168
50,6,101,California,Sutter County,11,2,6765,3486,3279
50,6,101,California,Sutter County,11,3,7279,3747,3532
50,6,101,California,Sutter County,11,4,6539,3376,3163
50,6,101,California,Sutter County,11,5,6051,3148,2903
50,6,101,California,Sutter County,11,6,7121,3657,3464
50,6,101,California,Sutter County,11,7,6547,3355,3192
50,6,101,California,Sutter County,11,8,6102,3017,3085
50,6,101,California,Sutter County,11,9,5571,2794,2777
50,6,101,California,Sutter County,11,10,5557,2720,2837
50,6,101,California,Sutter County,11,11,5789,2884,2905
50,6,101,California,Sutter County,11,12,6028,2944,3084
50,6,101,California,Sutter County,11,13,5594,2727,2867
50,6,101,California,Sutter County,11,14,4341,2078,2263
50,6,101,California,Sutter County,11,15,3719,1713,2006
50,6,101,California,Sutter County,11,16,2743,1206,1537
50,6,101,California,Sutter County,11,17,1911,841,1070
50,6,101,California,Sutter County,11,18,2051,820,1231
50,6,101,California,Sutter County,12,0,96910,48271,48639
50,6,101,California,Sutter County,12,1,6628,3418,3210
50,6,101,California,Sutter County,12,2,6777,3535,3242
50,6,101,California,Sutter County,12,3,7232,3734,3498
50,6,101,California,Sutter County,12,4,6599,3390,3209
50,6,101,California,Sutter County,12,5,5973,3074,2899
50,6,101,California,Sutter County,12,6,7141,3704,3437
50,6,101,California,Sutter County,12,7,6570,3372,3198
50,6,101,California,Sutter County,12,8,6238,3082,3156
50,6,101,California,Sutter County,12,9,5725,2887,2838
50,6,101,California,Sutter County,12,10,5509,2709,2800
50,6,101,California,Sutter County,12,11,5631,2795,2836
50,6,101,California,Sutter County,12,12,6093,2992,3101
50,6,101,California,Sutter County,12,13,5579,2714,2865
50,6,101,California,Sutter County,12,14,4493,2145,2348
50,6,101,California,Sutter County,12,15,3866,1813,2053
50,6,101,California,Sutter County,12,16,2883,1260,1623
50,6,101,California,Sutter County,12,17,1884,811,1073
50,6,101,California,Sutter County,12,18,2089,836,1253
50,6,101,California,Sutter County,13,0,96593,48079,48514
50,6,101,California,Sutter County,13,1,6471,3362,3109
50,6,101,California,Sutter County,13,2,6770,3517,3253
50,6,101,California,Sutter County,13,3,7090,3624,3466
50,6,101,California,Sutter County,13,4,6673,3451,3222
50,6,101,California,Sutter County,13,5,5889,3003,2886
50,6,101,California,Sutter County,13,6,7045,3658,3387
50,6,101,California,Sutter County,13,7,6510,3318,3192
50,6,101,California,Sutter County,13,8,6273,3120,3153
50,6,101,California,Sutter County,13,9,5822,2936,2886
50,6,101,California,Sutter County,13,10,5390,2649,2741
50,6,101,California,Sutter County,13,11,5537,2745,2792
50,6,101,California,Sutter County,13,12,5955,2948,3007
50,6,101,California,Sutter County,13,13,5634,2720,2914
50,6,101,California,Sutter County,13,14,4689,2254,2435
50,6,101,California,Sutter County,13,15,3957,1876,2081
50,6,101,California,Sutter County,13,16,2910,1262,1648
50,6,101,California,Sutter County,13,17,1899,813,1086
50,6,101,California,Sutter County,13,18,2079,823,1256
50,6,101,California,Sutter County,14,0,96385,47957,48428
50,6,101,California,Sutter County,14,1,6411,3335,3076
50,6,101,California,Sutter County,14,2,6758,3505,3253
50,6,101,California,Sutter County,14,3,7045,3591,3454
50,6,101,California,Sutter County,14,4,6680,3458,3222
50,6,101,California,Sutter County,14,5,5853,2976,2877
50,6,101,California,Sutter County,14,6,6998,3634,3364
50,6,101,California,Sutter County,14,7,6488,3297,3191
50,6,101,California,Sutter County,14,8,6292,3138,3154
50,6,101,California,Sutter County,14,9,5851,2949,2902
50,6,101,California,Sutter County,14,10,5343,2625,2718
50,6,101,California,Sutter County,14,11,5520,2735,2785
50,6,101,California,Sutter County,14,12,5908,2934,2974
50,6,101,California,Sutter County,14,13,5641,2718,2923
50,6,101,California,Sutter County,14,14,4749,2287,2462
50,6,101,California,Sutter County,14,15,3983,1892,2091
50,6,101,California,Sutter County,14,16,2910,1261,1649
50,6,101,California,Sutter County,14,17,1899,813,1086
50,6,101,California,Sutter County,14,18,2056,809,1247
50,6,103,California,Tehama County,1,0,63463,31610,31853
50,6,103,California,Tehama County,1,1,4409,2263,2146
50,6,103,California,Tehama County,1,2,4326,2217,2109
50,6,103,California,Tehama County,1,3,4431,2242,2189
50,6,103,California,Tehama County,1,4,4654,2429,2225
50,6,103,California,Tehama County,1,5,3656,1841,1815
50,6,103,California,Tehama County,1,6,3652,1922,1730
50,6,103,California,Tehama County,1,7,3436,1779,1657
50,6,103,California,Tehama County,1,8,3551,1792,1759
50,6,103,California,Tehama County,1,9,3765,1888,1877
50,6,103,California,Tehama County,1,10,4641,2270,2371
50,6,103,California,Tehama County,1,11,4613,2268,2345
50,6,103,California,Tehama County,1,12,4197,2023,2174
50,6,103,California,Tehama County,1,13,4061,2023,2038
50,6,103,California,Tehama County,1,14,3224,1514,1710
50,6,103,California,Tehama County,1,15,2496,1197,1299
50,6,103,California,Tehama County,1,16,1899,923,976
50,6,103,California,Tehama County,1,17,1273,577,696
50,6,103,California,Tehama County,1,18,1179,442,737
50,6,103,California,Tehama County,2,0,63441,31600,31841
50,6,103,California,Tehama County,2,1,4407,2262,2145
50,6,103,California,Tehama County,2,2,4323,2216,2107
50,6,103,California,Tehama County,2,3,4430,2242,2188
50,6,103,California,Tehama County,2,4,4654,2429,2225
50,6,103,California,Tehama County,2,5,3655,1841,1814
50,6,103,California,Tehama County,2,6,3650,1920,1730
50,6,103,California,Tehama County,2,7,3431,1778,1653
50,6,103,California,Tehama County,2,8,3550,1791,1759
50,6,103,California,Tehama County,2,9,3765,1888,1877
50,6,103,California,Tehama County,2,10,4639,2269,2370
50,6,103,California,Tehama County,2,11,4612,2268,2344
50,6,103,California,Tehama County,2,12,4196,2022,2174
50,6,103,California,Tehama County,2,13,4059,2022,2037
50,6,103,California,Tehama County,2,14,3226,1514,1712
50,6,103,California,Tehama County,2,15,2495,1197,1298
50,6,103,California,Tehama County,2,16,1897,922,975
50,6,103,California,Tehama County,2,17,1273,577,696
50,6,103,California,Tehama County,2,18,1179,442,737
50,6,103,California,Tehama County,3,0,63562,31642,31920
50,6,103,California,Tehama County,3,1,4387,2248,2139
50,6,103,California,Tehama County,3,2,4322,2222,2100
50,6,103,California,Tehama County,3,3,4433,2234,2199
50,6,103,California,Tehama County,3,4,4642,2413,2229
50,6,103,California,Tehama County,3,5,3689,1861,1828
50,6,103,California,Tehama County,3,6,3652,1908,1744
50,6,103,California,Tehama County,3,7,3464,1794,1670
50,6,103,California,Tehama County,3,8,3548,1793,1755
50,6,103,California,Tehama County,3,9,3752,1886,1866
50,6,103,California,Tehama County,3,10,4609,2253,2356
50,6,103,California,Tehama County,3,11,4638,2286,2352
50,6,103,California,Tehama County,3,12,4207,2019,2188
50,6,103,California,Tehama County,3,13,4101,2044,2057
50,6,103,California,Tehama County,3,14,3229,1520,1709
50,6,103,California,Tehama County,3,15,2512,1205,1307
50,6,103,California,Tehama County,3,16,1897,924,973
50,6,103,California,Tehama County,3,17,1295,587,708
50,6,103,California,Tehama County,3,18,1185,445,740
50,6,103,California,Tehama County,4,0,63337,31564,31773
50,6,103,California,Tehama County,4,1,4210,2171,2039
50,6,103,California,Tehama County,4,2,4274,2231,2043
50,6,103,California,Tehama County,4,3,4362,2197,2165
50,6,103,California,Tehama County,4,4,4520,2339,2181
50,6,103,California,Tehama County,4,5,3718,1920,1798
50,6,103,California,Tehama County,4,6,3622,1868,1754
50,6,103,California,Tehama County,4,7,3567,1835,1732
50,6,103,California,Tehama County,4,8,3445,1767,1678
50,6,103,California,Tehama County,4,9,3664,1827,1837
50,6,103,California,Tehama County,4,10,4395,2169,2226
50,6,103,California,Tehama County,4,11,4709,2333,2376
50,6,103,California,Tehama County,4,12,4246,2002,2244
50,6,103,California,Tehama County,4,13,4290,2140,2150
50,6,103,California,Tehama County,4,14,3240,1528,1712
50,6,103,California,Tehama County,4,15,2601,1258,1343
50,6,103,California,Tehama County,4,16,1941,935,1006
50,6,103,California,Tehama County,4,17,1343,601,742
50,6,103,California,Tehama County,4,18,1190,443,747
50,6,103,California,Tehama County,5,0,63213,31512,31701
50,6,103,California,Tehama County,5,1,3997,2087,1910
50,6,103,California,Tehama County,5,2,4363,2264,2099
50,6,103,California,Tehama County,5,3,4294,2189,2105
50,6,103,California,Tehama County,5,4,4301,2198,2103
50,6,103,California,Tehama County,5,5,3734,1933,1801
50,6,103,California,Tehama County,5,6,3687,1905,1782
50,6,103,California,Tehama County,5,7,3523,1805,1718
50,6,103,California,Tehama County,5,8,3442,1795,1647
50,6,103,California,Tehama County,5,9,3637,1805,1832
50,6,103,California,Tehama County,5,10,4171,2066,2105
50,6,103,California,Tehama County,5,11,4732,2322,2410
50,6,103,California,Tehama County,5,12,4332,2069,2263
50,6,103,California,Tehama County,5,13,4204,2068,2136
50,6,103,California,Tehama County,5,14,3536,1703,1833
50,6,103,California,Tehama County,5,15,2689,1295,1394
50,6,103,California,Tehama County,5,16,1960,921,1039
50,6,103,California,Tehama County,5,17,1361,616,745
50,6,103,California,Tehama County,5,18,1250,471,779
50,6,103,California,Tehama County,6,0,62878,31297,31581
50,6,103,California,Tehama County,6,1,3892,2001,1891
50,6,103,California,Tehama County,6,2,4328,2204,2124
50,6,103,California,Tehama County,6,3,4176,2144,2032
50,6,103,California,Tehama County,6,4,4186,2137,2049
50,6,103,California,Tehama County,6,5,3839,1980,1859
50,6,103,California,Tehama County,6,6,3636,1858,1778
50,6,103,California,Tehama County,6,7,3535,1813,1722
50,6,103,California,Tehama County,6,8,3381,1783,1598
50,6,103,California,Tehama County,6,9,3567,1777,1790
50,6,103,California,Tehama County,6,10,3917,1944,1973
50,6,103,California,Tehama County,6,11,4814,2363,2451
50,6,103,California,Tehama County,6,12,4391,2124,2267
50,6,103,California,Tehama County,6,13,4113,1987,2126
50,6,103,California,Tehama County,6,14,3683,1791,1892
50,6,103,California,Tehama County,6,15,2812,1350,1462
50,6,103,California,Tehama County,6,16,2022,932,1090
50,6,103,California,Tehama County,6,17,1335,632,703
50,6,103,California,Tehama County,6,18,1251,477,774
50,6,103,California,Tehama County,7,0,62797,31194,31603
50,6,103,California,Tehama County,7,1,3902,1990,1912
50,6,103,California,Tehama County,7,2,4325,2207,2118
50,6,103,California,Tehama County,7,3,4165,2147,2018
50,6,103,California,Tehama County,7,4,4102,2112,1990
50,6,103,California,Tehama County,7,5,3867,2024,1843
50,6,103,California,Tehama County,7,6,3575,1778,1797
50,6,103,California,Tehama County,7,7,3568,1844,1724
50,6,103,California,Tehama County,7,8,3383,1751,1632
50,6,103,California,Tehama County,7,9,3497,1757,1740
50,6,103,California,Tehama County,7,10,3742,1855,1887
50,6,103,California,Tehama County,7,11,4780,2315,2465
50,6,103,California,Tehama County,7,12,4429,2164,2265
50,6,103,California,Tehama County,7,13,4094,1953,2141
50,6,103,California,Tehama County,7,14,3796,1867,1929
50,6,103,California,Tehama County,7,15,2867,1339,1528
50,6,103,California,Tehama County,7,16,2085,969,1116
50,6,103,California,Tehama County,7,17,1370,650,720
50,6,103,California,Tehama County,7,18,1250,472,778
50,6,103,California,Tehama County,8,0,63150,31393,31757
50,6,103,California,Tehama County,8,1,3923,1981,1942
50,6,103,California,Tehama County,8,2,4383,2268,2115
50,6,103,California,Tehama County,8,3,4243,2214,2029
50,6,103,California,Tehama County,8,4,3976,2018,1958
50,6,103,California,Tehama County,8,5,3817,1973,1844
50,6,103,California,Tehama County,8,6,3701,1845,1856
50,6,103,California,Tehama County,8,7,3590,1851,1739
50,6,103,California,Tehama County,8,8,3468,1790,1678
50,6,103,California,Tehama County,8,9,3452,1757,1695
50,6,103,California,Tehama County,8,10,3625,1808,1817
50,6,103,California,Tehama County,8,11,4538,2183,2355
50,6,103,California,Tehama County,8,12,4622,2261,2361
50,6,103,California,Tehama County,8,13,4133,1970,2163
50,6,103,California,Tehama County,8,14,3898,1936,1962
50,6,103,California,Tehama County,8,15,2874,1324,1550
50,6,103,California,Tehama County,8,16,2144,1033,1111
50,6,103,California,Tehama County,8,17,1436,676,760
50,6,103,California,Tehama County,8,18,1327,505,822
50,6,103,California,Tehama County,9,0,63468,31524,31944
50,6,103,California,Tehama County,9,1,4054,2022,2032
50,6,103,California,Tehama County,9,2,4358,2262,2096
50,6,103,California,Tehama County,9,3,4288,2231,2057
50,6,103,California,Tehama County,9,4,3942,2005,1937
50,6,103,California,Tehama County,9,5,3599,1889,1710
50,6,103,California,Tehama County,9,6,3849,1933,1916
50,6,103,California,Tehama County,9,7,3642,1875,1767
50,6,103,California,Tehama County,9,8,3555,1800,1755
50,6,103,California,Tehama County,9,9,3379,1741,1638
50,6,103,California,Tehama County,9,10,3596,1786,1810
50,6,103,California,Tehama County,9,11,4376,2118,2258
50,6,103,California,Tehama County,9,12,4674,2293,2381
50,6,103,California,Tehama County,9,13,4116,1938,2178
50,6,103,California,Tehama County,9,14,4099,2004,2095
50,6,103,California,Tehama County,9,15,2860,1340,1520
50,6,103,California,Tehama County,9,16,2216,1046,1170
50,6,103,California,Tehama County,9,17,1475,696,779
50,6,103,California,Tehama County,9,18,1390,545,845
50,6,103,California,Tehama County,10,0,63827,31661,32166
50,6,103,California,Tehama County,10,1,4112,2049,2063
50,6,103,California,Tehama County,10,2,4235,2195,2040
50,6,103,California,Tehama County,10,3,4415,2275,2140
50,6,103,California,Tehama County,10,4,3942,2003,1939
50,6,103,California,Tehama County,10,5,3602,1877,1725
50,6,103,California,Tehama County,10,6,3876,1971,1905
50,6,103,California,Tehama County,10,7,3692,1889,1803
50,6,103,California,Tehama County,10,8,3565,1791,1774
50,6,103,California,Tehama County,10,9,3415,1783,1632
50,6,103,California,Tehama County,10,10,3536,1742,1794
50,6,103,California,Tehama County,10,11,4181,2056,2125
50,6,103,California,Tehama County,10,12,4740,2259,2481
50,6,103,California,Tehama County,10,13,4240,2030,2210
50,6,103,California,Tehama County,10,14,3940,1908,2032
50,6,103,California,Tehama County,10,15,3108,1479,1629
50,6,103,California,Tehama County,10,16,2333,1098,1235
50,6,103,California,Tehama County,10,17,1470,681,789
50,6,103,California,Tehama County,10,18,1425,575,850
50,6,103,California,Tehama County,11,0,63904,31730,32174
50,6,103,California,Tehama County,11,1,4049,2044,2005
50,6,103,California,Tehama County,11,2,4206,2167,2039
50,6,103,California,Tehama County,11,3,4511,2316,2195
50,6,103,California,Tehama County,11,4,3903,1990,1913
50,6,103,California,Tehama County,11,5,3506,1831,1675
50,6,103,California,Tehama County,11,6,4020,2064,1956
50,6,103,California,Tehama County,11,7,3676,1869,1807
50,6,103,California,Tehama County,11,8,3665,1880,1785
50,6,103,California,Tehama County,11,9,3402,1736,1666
50,6,103,California,Tehama County,11,10,3532,1788,1744
50,6,103,California,Tehama County,11,11,3935,1933,2002
50,6,103,California,Tehama County,11,12,4790,2261,2529
50,6,103,California,Tehama County,11,13,4249,2056,2193
50,6,103,California,Tehama County,11,14,3856,1826,2030
50,6,103,California,Tehama County,11,15,3250,1569,1681
50,6,103,California,Tehama County,11,16,2420,1135,1285
50,6,103,California,Tehama County,11,17,1516,690,826
50,6,103,California,Tehama County,11,18,1418,575,843
50,6,103,California,Tehama County,12,0,65186,32383,32803
50,6,103,California,Tehama County,12,1,3990,1990,2000
50,6,103,California,Tehama County,12,2,4305,2226,2079
50,6,103,California,Tehama County,12,3,4600,2332,2268
50,6,103,California,Tehama County,12,4,4006,2095,1911
50,6,103,California,Tehama County,12,5,3465,1798,1667
50,6,103,California,Tehama County,12,6,4148,2147,2001
50,6,103,California,Tehama County,12,7,3831,1907,1924
50,6,103,California,Tehama County,12,8,3874,2026,1848
50,6,103,California,Tehama County,12,9,3489,1769,1720
50,6,103,California,Tehama County,12,10,3514,1770,1744
50,6,103,California,Tehama County,12,11,3824,1916,1908
50,6,103,California,Tehama County,12,12,4844,2281,2563
50,6,103,California,Tehama County,12,13,4376,2148,2228
50,6,103,California,Tehama County,12,14,3935,1837,2098
50,6,103,California,Tehama County,12,15,3405,1652,1753
50,6,103,California,Tehama County,12,16,2496,1148,1348
50,6,103,California,Tehama County,12,17,1630,741,889
50,6,103,California,Tehama County,12,18,1454,600,854
50,6,103,California,Tehama County,13,0,64698,32123,32575
50,6,103,California,Tehama County,13,1,3902,1952,1950
50,6,103,California,Tehama County,13,2,4272,2171,2101
50,6,103,California,Tehama County,13,3,4572,2356,2216
50,6,103,California,Tehama County,13,4,4014,2110,1904
50,6,103,California,Tehama County,13,5,3381,1720,1661
50,6,103,California,Tehama County,13,6,4054,2089,1965
50,6,103,California,Tehama County,13,7,3822,1924,1898
50,6,103,California,Tehama County,13,8,3820,1964,1856
50,6,103,California,Tehama County,13,9,3549,1789,1760
50,6,103,California,Tehama County,13,10,3440,1761,1679
50,6,103,California,Tehama County,13,11,3664,1836,1828
50,6,103,California,Tehama County,13,12,4636,2185,2451
50,6,103,California,Tehama County,13,13,4504,2204,2300
50,6,103,California,Tehama County,13,14,3936,1845,2091
50,6,103,California,Tehama County,13,15,3503,1692,1811
50,6,103,California,Tehama County,13,16,2502,1161,1341
50,6,103,California,Tehama County,13,17,1633,753,880
50,6,103,California,Tehama County,13,18,1494,611,883
50,6,103,California,Tehama County,14,0,64494,32014,32480
50,6,103,California,Tehama County,14,1,3867,1937,1930
50,6,103,California,Tehama County,14,2,4259,2151,2108
50,6,103,California,Tehama County,14,3,4567,2366,2201
50,6,103,California,Tehama County,14,4,4019,2118,1901
50,6,103,California,Tehama County,14,5,3350,1691,1659
50,6,103,California,Tehama County,14,6,4019,2070,1949
50,6,103,California,Tehama County,14,7,3822,1929,1893
50,6,103,California,Tehama County,14,8,3808,1945,1863
50,6,103,California,Tehama County,14,9,3570,1800,1770
50,6,103,California,Tehama County,14,10,3412,1758,1654
50,6,103,California,Tehama County,14,11,3622,1814,1808
50,6,103,California,Tehama County,14,12,4568,2156,2412
50,6,103,California,Tehama County,14,13,4535,2215,2320
50,6,103,California,Tehama County,14,14,3937,1847,2090
50,6,103,California,Tehama County,14,15,3526,1700,1826
50,6,103,California,Tehama County,14,16,2490,1157,1333
50,6,103,California,Tehama County,14,17,1629,752,877
50,6,103,California,Tehama County,14,18,1494,608,886
50,6,105,California,Trinity County,1,0,13786,7113,6673
50,6,105,California,Trinity County,1,1,618,333,285
50,6,105,California,Trinity County,1,2,640,333,307
50,6,105,California,Trinity County,1,3,744,353,391
50,6,105,California,Trinity County,1,4,789,404,385
50,6,105,California,Trinity County,1,5,544,304,240
50,6,105,California,Trinity County,1,6,641,360,281
50,6,105,California,Trinity County,1,7,630,333,297
50,6,105,California,Trinity County,1,8,664,345,319
50,6,105,California,Trinity County,1,9,724,373,351
50,6,105,California,Trinity County,1,10,1072,527,545
50,6,105,California,Trinity County,1,11,1254,613,641
50,6,105,California,Trinity County,1,12,1401,721,680
50,6,105,California,Trinity County,1,13,1296,687,609
50,6,105,California,Trinity County,1,14,1003,547,456
50,6,105,California,Trinity County,1,15,671,365,306
50,6,105,California,Trinity County,1,16,505,243,262
50,6,105,California,Trinity County,1,17,332,170,162
50,6,105,California,Trinity County,1,18,258,102,156
50,6,105,California,Trinity County,2,0,13782,7111,6671
50,6,105,California,Trinity County,2,1,618,333,285
50,6,105,California,Trinity County,2,2,640,333,307
50,6,105,California,Trinity County,2,3,744,353,391
50,6,105,California,Trinity County,2,4,789,404,385
50,6,105,California,Trinity County,2,5,544,304,240
50,6,105,California,Trinity County,2,6,641,360,281
50,6,105,California,Trinity County,2,7,630,333,297
50,6,105,California,Trinity County,2,8,664,345,319
50,6,105,California,Trinity County,2,9,724,373,351
50,6,105,California,Trinity County,2,10,1072,527,545
50,6,105,California,Trinity County,2,11,1254,613,641
50,6,105,California,Trinity County,2,12,1399,720,679
50,6,105,California,Trinity County,2,13,1296,687,609
50,6,105,California,Trinity County,2,14,1001,546,455
50,6,105,California,Trinity County,2,15,671,365,306
50,6,105,California,Trinity County,2,16,505,243,262
50,6,105,California,Trinity County,2,17,332,170,162
50,6,105,California,Trinity County,2,18,258,102,156
50,6,105,California,Trinity County,3,0,13755,7088,6667
50,6,105,California,Trinity County,3,1,611,323,288
50,6,105,California,Trinity County,3,2,652,342,310
50,6,105,California,Trinity County,3,3,730,346,384
50,6,105,California,Trinity County,3,4,784,401,383
50,6,105,California,Trinity County,3,5,548,308,240
50,6,105,California,Trinity County,3,6,637,356,281
50,6,105,California,Trinity County,3,7,631,334,297
50,6,105,California,Trinity County,3,8,663,340,323
50,6,105,California,Trinity County,3,9,723,374,349
50,6,105,California,Trinity County,3,10,1054,519,535
50,6,105,California,Trinity County,3,11,1251,605,646
50,6,105,California,Trinity County,3,12,1396,717,679
50,6,105,California,Trinity County,3,13,1308,689,619
50,6,105,California,Trinity County,3,14,997,550,447
50,6,105,California,Trinity County,3,15,675,368,307
50,6,105,California,Trinity County,3,16,502,242,260
50,6,105,California,Trinity County,3,17,336,171,165
50,6,105,California,Trinity County,3,18,257,103,154
50,6,105,California,Trinity County,4,0,13685,7051,6634
50,6,105,California,Trinity County,4,1,600,310,290
50,6,105,California,Trinity County,4,2,688,371,317
50,6,105,California,Trinity County,4,3,670,316,354
50,6,105,California,Trinity County,4,4,776,405,371
50,6,105,California,Trinity County,4,5,540,300,240
50,6,105,California,Trinity County,4,6,617,332,285
50,6,105,California,Trinity County,4,7,641,337,304
50,6,105,California,Trinity County,4,8,651,338,313
50,6,105,California,Trinity County,4,9,728,393,335
50,6,105,California,Trinity County,4,10,959,470,489
50,6,105,California,Trinity County,4,11,1245,600,645
50,6,105,California,Trinity County,4,12,1389,710,679
50,6,105,California,Trinity County,4,13,1354,700,654
50,6,105,California,Trinity County,4,14,1001,553,448
50,6,105,California,Trinity County,4,15,717,387,330
50,6,105,California,Trinity County,4,16,505,249,256
50,6,105,California,Trinity County,4,17,331,160,171
50,6,105,California,Trinity County,4,18,273,120,153
50,6,105,California,Trinity County,5,0,13494,6935,6559
50,6,105,California,Trinity County,5,1,585,288,297
50,6,105,California,Trinity County,5,2,652,366,286
50,6,105,California,Trinity County,5,3,621,293,328
50,6,105,California,Trinity County,5,4,739,380,359
50,6,105,California,Trinity County,5,5,550,316,234
50,6,105,California,Trinity County,5,6,566,305,261
50,6,105,California,Trinity County,5,7,663,347,316
50,6,105,California,Trinity County,5,8,643,324,319
50,6,105,California,Trinity County,5,9,706,376,330
50,6,105,California,Trinity County,5,10,882,448,434
50,6,105,California,Trinity County,5,11,1192,575,617
50,6,105,California,Trinity County,5,12,1386,696,690
50,6,105,California,Trinity County,5,13,1344,689,655
50,6,105,California,Trinity County,5,14,1084,592,492
50,6,105,California,Trinity County,5,15,741,391,350
50,6,105,California,Trinity County,5,16,519,268,251
50,6,105,California,Trinity County,5,17,337,160,177
50,6,105,California,Trinity County,5,18,284,121,163
50,6,105,California,Trinity County,6,0,13427,6881,6546
50,6,105,California,Trinity County,6,1,607,305,302
50,6,105,California,Trinity County,6,2,649,350,299
50,6,105,California,Trinity County,6,3,609,299,310
50,6,105,California,Trinity County,6,4,707,354,353
50,6,105,California,Trinity County,6,5,577,324,253
50,6,105,California,Trinity County,6,6,551,287,264
50,6,105,California,Trinity County,6,7,665,350,315
50,6,105,California,Trinity County,6,8,635,317,318
50,6,105,California,Trinity County,6,9,687,373,314
50,6,105,California,Trinity County,6,10,785,406,379
50,6,105,California,Trinity County,6,11,1136,551,585
50,6,105,California,Trinity County,6,12,1366,648,718
50,6,105,California,Trinity County,6,13,1346,701,645
50,6,105,California,Trinity County,6,14,1142,617,525
50,6,105,California,Trinity County,6,15,796,429,367
50,6,105,California,Trinity County,6,16,516,273,243
50,6,105,California,Trinity County,6,17,354,168,186
50,6,105,California,Trinity County,6,18,299,129,170
50,6,105,California,Trinity County,7,0,13126,6702,6424
50,6,105,California,Trinity County,7,1,585,292,293
50,6,105,California,Trinity County,7,2,606,310,296
50,6,105,California,Trinity County,7,3,603,320,283
50,6,105,California,Trinity County,7,4,674,324,350
50,6,105,California,Trinity County,7,5,578,299,279
50,6,105,California,Trinity County,7,6,525,278,247
50,6,105,California,Trinity County,7,7,664,361,303
50,6,105,California,Trinity County,7,8,613,301,312
50,6,105,California,Trinity County,7,9,646,338,308
50,6,105,California,Trinity County,7,10,721,383,338
50,6,105,California,Trinity County,7,11,1074,532,542
50,6,105,California,Trinity County,7,12,1290,606,684
50,6,105,California,Trinity County,7,13,1371,707,664
50,6,105,California,Trinity County,7,14,1162,619,543
50,6,105,California,Trinity County,7,15,827,443,384
50,6,105,California,Trinity County,7,16,519,289,230
50,6,105,California,Trinity County,7,17,372,167,205
50,6,105,California,Trinity County,7,18,296,133,163
50,6,105,California,Trinity County,8,0,13094,6742,6352
50,6,105,California,Trinity County,8,1,590,321,269
50,6,105,California,Trinity County,8,2,607,303,304
50,6,105,California,Trinity County,8,3,629,345,284
50,6,105,California,Trinity County,8,4,633,306,327
50,6,105,California,Trinity County,8,5,572,308,264
50,6,105,California,Trinity County,8,6,497,256,241
50,6,105,California,Trinity County,8,7,696,384,312
50,6,105,California,Trinity County,8,8,654,326,328
50,6,105,California,Trinity County,8,9,648,333,315
50,6,105,California,Trinity County,8,10,688,371,317
50,6,105,California,Trinity County,8,11,1018,498,520
50,6,105,California,Trinity County,8,12,1199,572,627
50,6,105,California,Trinity County,8,13,1406,711,695
50,6,105,California,Trinity County,8,14,1189,627,562
50,6,105,California,Trinity County,8,15,853,476,377
50,6,105,California,Trinity County,8,16,522,287,235
50,6,105,California,Trinity County,8,17,380,177,203
50,6,105,California,Trinity County,8,18,313,141,172
50,6,105,California,Trinity County,9,0,12827,6584,6243
50,6,105,California,Trinity County,9,1,562,300,262
50,6,105,California,Trinity County,9,2,570,288,282
50,6,105,California,Trinity County,9,3,655,366,289
50,6,105,California,Trinity County,9,4,585,290,295
50,6,105,California,Trinity County,9,5,566,296,270
50,6,105,California,Trinity County,9,6,504,254,250
50,6,105,California,Trinity County,9,7,629,329,300
50,6,105,California,Trinity County,9,8,654,333,321
50,6,105,California,Trinity County,9,9,659,342,317
50,6,105,California,Trinity County,9,10,670,357,313
50,6,105,California,Trinity County,9,11,928,455,473
50,6,105,California,Trinity County,9,12,1160,561,599
50,6,105,California,Trinity County,9,13,1375,679,696
50,6,105,California,Trinity County,9,14,1236,640,596
50,6,105,California,Trinity County,9,15,825,465,360
50,6,105,California,Trinity County,9,16,562,295,267
50,6,105,California,Trinity County,9,17,368,180,188
50,6,105,California,Trinity County,9,18,319,154,165
50,6,105,California,Trinity County,10,0,12727,6551,6176
50,6,105,California,Trinity County,10,1,549,298,251
50,6,105,California,Trinity County,10,2,598,305,293
50,6,105,California,Trinity County,10,3,652,359,293
50,6,105,California,Trinity County,10,4,584,299,285
50,6,105,California,Trinity County,10,5,527,271,256
50,6,105,California,Trinity County,10,6,508,273,235
50,6,105,California,Trinity County,10,7,600,313,287
50,6,105,California,Trinity County,10,8,681,344,337
50,6,105,California,Trinity County,10,9,647,330,317
50,6,105,California,Trinity County,10,10,663,350,313
50,6,105,California,Trinity County,10,11,882,444,438
50,6,105,California,Trinity County,10,12,1112,548,564
50,6,105,California,Trinity County,10,13,1365,672,693
50,6,105,California,Trinity County,10,14,1216,629,587
50,6,105,California,Trinity County,10,15,891,496,395
50,6,105,California,Trinity County,10,16,570,289,281
50,6,105,California,Trinity County,10,17,369,189,180
50,6,105,California,Trinity County,10,18,313,142,171
50,6,105,California,Trinity County,11,0,12598,6462,6136
50,6,105,California,Trinity County,11,1,560,295,265
50,6,105,California,Trinity County,11,2,586,302,284
50,6,105,California,Trinity County,11,3,653,361,292
50,6,105,California,Trinity County,11,4,562,289,273
50,6,105,California,Trinity County,11,5,497,258,239
50,6,105,California,Trinity County,11,6,540,270,270
50,6,105,California,Trinity County,11,7,581,300,281
50,6,105,California,Trinity County,11,8,666,339,327
50,6,105,California,Trinity County,11,9,644,315,329
50,6,105,California,Trinity County,11,10,662,360,302
50,6,105,California,Trinity County,11,11,807,416,391
50,6,105,California,Trinity County,11,12,1075,536,539
50,6,105,California,Trinity County,11,13,1293,622,671
50,6,105,California,Trinity County,11,14,1241,639,602
50,6,105,California,Trinity County,11,15,948,514,434
50,6,105,California,Trinity County,11,16,600,314,286
50,6,105,California,Trinity County,11,17,360,186,174
50,6,105,California,Trinity County,11,18,323,146,177
50,6,105,California,Trinity County,12,0,12337,6340,5997
50,6,105,California,Trinity County,12,1,546,285,261
50,6,105,California,Trinity County,12,2,578,295,283
50,6,105,California,Trinity County,12,3,624,336,288
50,6,105,California,Trinity County,12,4,536,299,237
50,6,105,California,Trinity County,12,5,488,251,237
50,6,105,California,Trinity County,12,6,560,286,274
50,6,105,California,Trinity County,12,7,512,261,251
50,6,105,California,Trinity County,12,8,658,353,305
50,6,105,California,Trinity County,12,9,662,326,336
50,6,105,California,Trinity County,12,10,645,338,307
50,6,105,California,Trinity County,12,11,742,393,349
50,6,105,California,Trinity County,12,12,1021,510,511
50,6,105,California,Trinity County,12,13,1217,574,643
50,6,105,California,Trinity County,12,14,1278,663,615
50,6,105,California,Trinity County,12,15,965,514,451
50,6,105,California,Trinity County,12,16,595,311,284
50,6,105,California,Trinity County,12,17,377,200,177
50,6,105,California,Trinity County,12,18,333,145,188
50,6,105,California,Trinity County,13,0,12252,6286,5966
50,6,105,California,Trinity County,13,1,553,282,271
50,6,105,California,Trinity County,13,2,586,301,285
50,6,105,California,Trinity County,13,3,608,323,285
50,6,105,California,Trinity County,13,4,573,326,247
50,6,105,California,Trinity County,13,5,447,229,218
50,6,105,California,Trinity County,13,6,554,286,268
50,6,105,California,Trinity County,13,7,524,255,269
50,6,105,California,Trinity County,13,8,644,345,299
50,6,105,California,Trinity County,13,9,673,330,343
50,6,105,California,Trinity County,13,10,660,339,321
50,6,105,California,Trinity County,13,11,712,396,316
50,6,105,California,Trinity County,13,12,986,488,498
50,6,105,California,Trinity County,13,13,1152,547,605
50,6,105,California,Trinity County,13,14,1275,653,622
50,6,105,California,Trinity County,13,15,983,506,477
50,6,105,California,Trinity County,13,16,627,341,286
50,6,105,California,Trinity County,13,17,376,195,181
50,6,105,California,Trinity County,13,18,319,144,175
50,6,105,California,Trinity County,14,0,12216,6258,5958
50,6,105,California,Trinity County,14,1,555,280,275
50,6,105,California,Trinity County,14,2,587,302,285
50,6,105,California,Trinity County,14,3,604,320,284
50,6,105,California,Trinity County,14,4,583,334,249
50,6,105,California,Trinity County,14,5,432,218,214
50,6,105,California,Trinity County,14,6,550,284,266
50,6,105,California,Trinity County,14,7,532,253,279
50,6,105,California,Trinity County,14,8,644,345,299
50,6,105,California,Trinity County,14,9,674,329,345
50,6,105,California,Trinity County,14,10,663,341,322
50,6,105,California,Trinity County,14,11,704,395,309
50,6,105,California,Trinity County,14,12,973,477,496
50,6,105,California,Trinity County,14,13,1131,539,592
50,6,105,California,Trinity County,14,14,1276,652,624
50,6,105,California,Trinity County,14,15,987,504,483
50,6,105,California,Trinity County,14,16,636,352,284
50,6,105,California,Trinity County,14,17,373,191,182
50,6,105,California,Trinity County,14,18,312,142,170
50,6,107,California,Tulare County,1,0,442179,221442,220737
50,6,107,California,Tulare County,1,1,41074,21004,20070
50,6,107,California,Tulare County,1,2,39950,20388,19562
50,6,107,California,Tulare County,1,3,38926,19801,19125
50,6,107,California,Tulare County,1,4,39043,20239,18804
50,6,107,California,Tulare County,1,5,32457,16866,15591
50,6,107,California,Tulare County,1,6,32256,16425,15831
50,6,107,California,Tulare County,1,7,29603,15023,14580
50,6,107,California,Tulare County,1,8,27770,14032,13738
50,6,107,California,Tulare County,1,9,26915,13552,13363
50,6,107,California,Tulare County,1,10,27039,13423,13616
50,6,107,California,Tulare County,1,11,25312,12615,12697
50,6,107,California,Tulare County,1,12,21657,10583,11074
50,6,107,California,Tulare County,1,13,18398,8971,9427
50,6,107,California,Tulare County,1,14,13103,6280,6823
50,6,107,California,Tulare County,1,15,9843,4549,5294
50,6,107,California,Tulare County,1,16,7682,3345,4337
50,6,107,California,Tulare County,1,17,5792,2392,3400
50,6,107,California,Tulare County,1,18,5359,1954,3405
50,6,107,California,Tulare County,2,0,442176,221439,220737
50,6,107,California,Tulare County,2,1,41075,21004,20071
50,6,107,California,Tulare County,2,2,39949,20387,19562
50,6,107,California,Tulare County,2,3,38925,19800,19125
50,6,107,California,Tulare County,2,4,39039,20236,18803
50,6,107,California,Tulare County,2,5,32456,16865,15591
50,6,107,California,Tulare County,2,6,32256,16425,15831
50,6,107,California,Tulare County,2,7,29605,15024,14581
50,6,107,California,Tulare County,2,8,27767,14031,13736
50,6,107,California,Tulare County,2,9,26917,13553,13364
50,6,107,California,Tulare County,2,10,27040,13424,13616
50,6,107,California,Tulare County,2,11,25312,12615,12697
50,6,107,California,Tulare County,2,12,21657,10583,11074
50,6,107,California,Tulare County,2,13,18398,8971,9427
50,6,107,California,Tulare County,2,14,13104,6281,6823
50,6,107,California,Tulare County,2,15,9843,4549,5294
50,6,107,California,Tulare County,2,16,7682,3345,4337
50,6,107,California,Tulare County,2,17,5792,2392,3400
50,6,107,California,Tulare County,2,18,5359,1954,3405
50,6,107,California,Tulare County,3,0,442953,221783,221170
50,6,107,California,Tulare County,3,1,40985,20966,20019
50,6,107,California,Tulare County,3,2,40012,20418,19594
50,6,107,California,Tulare County,3,3,38943,19790,19153
50,6,107,California,Tulare County,3,4,38812,20106,18706
50,6,107,California,Tulare County,3,5,32713,16994,15719
50,6,107,California,Tulare County,3,6,32224,16361,15863
50,6,107,California,Tulare County,3,7,29804,15145,14659
50,6,107,California,Tulare County,3,8,27737,13996,13741
50,6,107,California,Tulare County,3,9,26980,13596,13384
50,6,107,California,Tulare County,3,10,27007,13414,13593
50,6,107,California,Tulare County,3,11,25378,12649,12729
50,6,107,California,Tulare County,3,12,21802,10681,11121
50,6,107,California,Tulare County,3,13,18541,9018,9523
50,6,107,California,Tulare County,3,14,13241,6343,6898
50,6,107,California,Tulare County,3,15,9879,4579,5300
50,6,107,California,Tulare County,3,16,7684,3351,4333
50,6,107,California,Tulare County,3,17,5818,2411,3407
50,6,107,California,Tulare County,3,18,5393,1965,3428
50,6,107,California,Tulare County,4,0,446709,223644,223065
50,6,107,California,Tulare County,4,1,41129,21014,20115
50,6,107,California,Tulare County,4,2,40373,20628,19745
50,6,107,California,Tulare County,4,3,39058,19847,19211
50,6,107,California,Tulare County,4,4,38205,19718,18487
50,6,107,California,Tulare County,4,5,33784,17558,16226
50,6,107,California,Tulare County,4,6,32104,16204,15900
50,6,107,California,Tulare County,4,7,30483,15537,14946
50,6,107,California,Tulare County,4,8,27676,13920,13756
50,6,107,California,Tulare County,4,9,27291,13756,13535
50,6,107,California,Tulare County,4,10,26681,13325,13356
50,6,107,California,Tulare County,4,11,25628,12772,12856
50,6,107,California,Tulare County,4,12,22341,11003,11338
50,6,107,California,Tulare County,4,13,19077,9237,9840
50,6,107,California,Tulare County,4,14,13778,6612,7166
50,6,107,California,Tulare County,4,15,10120,4751,5369
50,6,107,California,Tulare County,4,16,7663,3326,4337
50,6,107,California,Tulare County,4,17,5819,2428,3391
50,6,107,California,Tulare County,4,18,5499,2008,3491
50,6,107,California,Tulare County,5,0,449625,224962,224663
50,6,107,California,Tulare County,5,1,40904,20966,19938
50,6,107,California,Tulare County,5,2,40873,20900,19973
50,6,107,California,Tulare County,5,3,39065,19775,19290
50,6,107,California,Tulare County,5,4,37625,19383,18242
50,6,107,California,Tulare County,5,5,34592,17869,16723
50,6,107,California,Tulare County,5,6,31870,16130,15740
50,6,107,California,Tulare County,5,7,31168,15855,15313
50,6,107,California,Tulare County,5,8,27772,13998,13774
50,6,107,California,Tulare County,5,9,27241,13729,13512
50,6,107,California,Tulare County,5,10,26226,13152,13074
50,6,107,California,Tulare County,5,11,25742,12809,12933
50,6,107,California,Tulare County,5,12,22992,11277,11715
50,6,107,California,Tulare County,5,13,19057,9269,9788
50,6,107,California,Tulare County,5,14,14715,7052,7663
50,6,107,California,Tulare County,5,15,10544,4946,5598
50,6,107,California,Tulare County,5,16,7764,3394,4370
50,6,107,California,Tulare County,5,17,5820,2419,3401
50,6,107,California,Tulare County,5,18,5655,2039,3616
50,6,107,California,Tulare County,6,0,452259,226215,226044
50,6,107,California,Tulare County,6,1,40347,20711,19636
50,6,107,California,Tulare County,6,2,41305,21170,20135
50,6,107,California,Tulare County,6,3,39239,19897,19342
50,6,107,California,Tulare County,6,4,36973,18933,18040
50,6,107,California,Tulare County,6,5,35143,18012,17131
50,6,107,California,Tulare County,6,6,31848,16188,15660
50,6,107,California,Tulare County,6,7,31587,16091,15496
50,6,107,California,Tulare County,6,8,28151,14100,14051
50,6,107,California,Tulare County,6,9,27175,13801,13374
50,6,107,California,Tulare County,6,10,26150,13105,13045
50,6,107,California,Tulare County,6,11,25697,12781,12916
50,6,107,California,Tulare County,6,12,23394,11471,11923
50,6,107,California,Tulare County,6,13,19398,9429,9969
50,6,107,California,Tulare County,6,14,15351,7388,7963
50,6,107,California,Tulare County,6,15,10989,5138,5851
50,6,107,California,Tulare County,6,16,8006,3530,4476
50,6,107,California,Tulare County,6,17,5763,2420,3343
50,6,107,California,Tulare County,6,18,5743,2050,3693
50,6,107,California,Tulare County,7,0,454858,227403,227455
50,6,107,California,Tulare County,7,1,39997,20530,19467
50,6,107,California,Tulare County,7,2,41485,21184,20301
50,6,107,California,Tulare County,7,3,39519,20131,19388
50,6,107,California,Tulare County,7,4,36747,18733,18014
50,6,107,California,Tulare County,7,5,35200,18047,17153
50,6,107,California,Tulare County,7,6,32136,16408,15728
50,6,107,California,Tulare County,7,7,31857,16152,15705
50,6,107,California,Tulare County,7,8,28542,14290,14252
50,6,107,California,Tulare County,7,9,26961,13673,13288
50,6,107,California,Tulare County,7,10,25908,12999,12909
50,6,107,California,Tulare County,7,11,25685,12752,12933
50,6,107,California,Tulare County,7,12,23677,11638,12039
50,6,107,California,Tulare County,7,13,19804,9511,10293
50,6,107,California,Tulare County,7,14,16102,7840,8262
50,6,107,California,Tulare County,7,15,11344,5325,6019
50,6,107,California,Tulare County,7,16,8265,3632,4633
50,6,107,California,Tulare County,7,17,5804,2451,3353
50,6,107,California,Tulare County,7,18,5825,2107,3718
50,6,107,California,Tulare County,8,0,456794,228295,228499
50,6,107,California,Tulare County,8,1,39288,20122,19166
50,6,107,California,Tulare County,8,2,41425,21193,20232
50,6,107,California,Tulare County,8,3,39775,20269,19506
50,6,107,California,Tulare County,8,4,36838,18840,17998
50,6,107,California,Tulare County,8,5,34709,17715,16994
50,6,107,California,Tulare County,8,6,32489,16569,15920
50,6,107,California,Tulare County,8,7,31955,16088,15867
50,6,107,California,Tulare County,8,8,29055,14697,14358
50,6,107,California,Tulare County,8,9,26840,13524,13316
50,6,107,California,Tulare County,8,10,25860,13042,12818
50,6,107,California,Tulare County,8,11,25606,12706,12900
50,6,107,California,Tulare County,8,12,24007,11797,12210
50,6,107,California,Tulare County,8,13,20164,9748,10416
50,6,107,California,Tulare County,8,14,16710,8051,8659
50,6,107,California,Tulare County,8,15,11779,5497,6282
50,6,107,California,Tulare County,8,16,8486,3805,4681
50,6,107,California,Tulare County,8,17,5837,2439,3398
50,6,107,California,Tulare County,8,18,5971,2193,3778
50,6,107,California,Tulare County,9,0,458991,229423,229568
50,6,107,California,Tulare County,9,1,38622,19789,18833
50,6,107,California,Tulare County,9,2,41567,21268,20299
50,6,107,California,Tulare County,9,3,39868,20355,19513
50,6,107,California,Tulare County,9,4,37076,18958,18118
50,6,107,California,Tulare County,9,5,33896,17248,16648
50,6,107,California,Tulare County,9,6,33357,17104,16253
50,6,107,California,Tulare County,9,7,31645,15915,15730
50,6,107,California,Tulare County,9,8,29897,15115,14782
50,6,107,California,Tulare County,9,9,26719,13399,13320
50,6,107,California,Tulare County,9,10,26066,13156,12910
50,6,107,California,Tulare County,9,11,25309,12627,12682
50,6,107,California,Tulare County,9,12,24173,11865,12308
50,6,107,California,Tulare County,9,13,20693,10034,10659
50,6,107,California,Tulare County,9,14,17310,8274,9036
50,6,107,California,Tulare County,9,15,12211,5687,6524
50,6,107,California,Tulare County,9,16,8637,3911,4726
50,6,107,California,Tulare County,9,17,5896,2460,3436
50,6,107,California,Tulare County,9,18,6049,2258,3791
50,6,107,California,Tulare County,10,0,462072,231094,230978
50,6,107,California,Tulare County,10,1,37678,19353,18325
50,6,107,California,Tulare County,10,2,41520,21248,20272
50,6,107,California,Tulare County,10,3,40774,20768,20006
50,6,107,California,Tulare County,10,4,37144,18967,18177
50,6,107,California,Tulare County,10,5,33569,17069,16500
50,6,107,California,Tulare County,10,6,33934,17417,16517
50,6,107,California,Tulare County,10,7,31562,15960,15602
50,6,107,California,Tulare County,10,8,30656,15538,15118
50,6,107,California,Tulare County,10,9,27015,13546,13469
50,6,107,California,Tulare County,10,10,26322,13269,13053
50,6,107,California,Tulare County,10,11,25004,12481,12523
50,6,107,California,Tulare County,10,12,24259,11947,12312
50,6,107,California,Tulare County,10,13,21314,10282,11032
50,6,107,California,Tulare County,10,14,17165,8233,8932
50,6,107,California,Tulare County,10,15,13123,6156,6967
50,6,107,California,Tulare County,10,16,8935,4040,4895
50,6,107,California,Tulare County,10,17,5987,2514,3473
50,6,107,California,Tulare County,10,18,6111,2306,3805
50,6,107,California,Tulare County,11,0,464279,232031,232248
50,6,107,California,Tulare County,11,1,36774,18781,17993
50,6,107,California,Tulare County,11,2,41233,21170,20063
50,6,107,California,Tulare County,11,3,41342,21060,20282
50,6,107,California,Tulare County,11,4,37364,19086,18278
50,6,107,California,Tulare County,11,5,33123,16707,16416
50,6,107,California,Tulare County,11,6,34564,17715,16849
50,6,107,California,Tulare County,11,7,31531,16012,15519
50,6,107,California,Tulare County,11,8,31211,15883,15328
50,6,107,California,Tulare County,11,9,27527,13710,13817
50,6,107,California,Tulare County,11,10,26098,13235,12863
50,6,107,California,Tulare County,11,11,24910,12405,12505
50,6,107,California,Tulare County,11,12,24310,12000,12310
50,6,107,California,Tulare County,11,13,21556,10422,11134
50,6,107,California,Tulare County,11,14,17498,8320,9178
50,6,107,California,Tulare County,11,15,13677,6424,7253
50,6,107,California,Tulare County,11,16,9261,4137,5124
50,6,107,California,Tulare County,11,17,6148,2620,3528
50,6,107,California,Tulare County,11,18,6152,2344,3808
50,6,107,California,Tulare County,12,0,465751,232511,233240
50,6,107,California,Tulare County,12,1,36099,18379,17720
50,6,107,California,Tulare County,12,2,40895,20898,19997
50,6,107,California,Tulare County,12,3,41440,21143,20297
50,6,107,California,Tulare County,12,4,37613,19196,18417
50,6,107,California,Tulare County,12,5,32774,16475,16299
50,6,107,California,Tulare County,12,6,34735,17760,16975
50,6,107,California,Tulare County,12,7,31789,16250,15539
50,6,107,California,Tulare County,12,8,31598,16023,15575
50,6,107,California,Tulare County,12,9,27914,13945,13969
50,6,107,California,Tulare County,12,10,25875,13064,12811
50,6,107,California,Tulare County,12,11,24701,12336,12365
50,6,107,California,Tulare County,12,12,24293,11937,12356
50,6,107,California,Tulare County,12,13,21756,10565,11191
50,6,107,California,Tulare County,12,14,17894,8446,9448
50,6,107,California,Tulare County,12,15,14228,6750,7478
50,6,107,California,Tulare County,12,16,9572,4287,5285
50,6,107,California,Tulare County,12,17,6402,2717,3685
50,6,107,California,Tulare County,12,18,6173,2340,3833
50,6,107,California,Tulare County,13,0,468274,233705,234569
50,6,107,California,Tulare County,13,1,35630,18153,17477
50,6,107,California,Tulare County,13,2,40663,20797,19866
50,6,107,California,Tulare County,13,3,41674,21248,20426
50,6,107,California,Tulare County,13,4,37876,19320,18556
50,6,107,California,Tulare County,13,5,33035,16658,16377
50,6,107,California,Tulare County,13,6,34507,17538,16969
50,6,107,California,Tulare County,13,7,32322,16502,15820
50,6,107,California,Tulare County,13,8,31668,15999,15669
50,6,107,California,Tulare County,13,9,28552,14363,14189
50,6,107,California,Tulare County,13,10,25889,13010,12879
50,6,107,California,Tulare County,13,11,24726,12414,12312
50,6,107,California,Tulare County,13,12,24260,11895,12365
50,6,107,California,Tulare County,13,13,22112,10770,11342
50,6,107,California,Tulare County,13,14,18147,8581,9566
50,6,107,California,Tulare County,13,15,14596,6887,7709
50,6,107,California,Tulare County,13,16,9847,4400,5447
50,6,107,California,Tulare County,13,17,6509,2796,3713
50,6,107,California,Tulare County,13,18,6261,2374,3887
50,6,107,California,Tulare County,14,0,468680,233884,234796
50,6,107,California,Tulare County,14,1,35461,18070,17391
50,6,107,California,Tulare County,14,2,40520,20732,19788
50,6,107,California,Tulare County,14,3,41697,21259,20438
50,6,107,California,Tulare County,14,4,37928,19339,18589
50,6,107,California,Tulare County,14,5,33064,16689,16375
50,6,107,California,Tulare County,14,6,34382,17445,16937
50,6,107,California,Tulare County,14,7,32494,16581,15913
50,6,107,California,Tulare County,14,8,31713,16007,15706
50,6,107,California,Tulare County,14,9,28750,14496,14254
50,6,107,California,Tulare County,14,10,25891,12994,12897
50,6,107,California,Tulare County,14,11,24745,12439,12306
50,6,107,California,Tulare County,14,12,24230,11874,12356
50,6,107,California,Tulare County,14,13,22210,10821,11389
50,6,107,California,Tulare County,14,14,18224,8623,9601
50,6,107,California,Tulare County,14,15,14687,6914,7773
50,6,107,California,Tulare County,14,16,9905,4421,5484
50,6,107,California,Tulare County,14,17,6535,2816,3719
50,6,107,California,Tulare County,14,18,6244,2364,3880
50,6,109,California,Tuolumne County,1,0,55365,29245,26120
50,6,109,California,Tuolumne County,1,1,2328,1195,1133
50,6,109,California,Tuolumne County,1,2,2501,1300,1201
50,6,109,California,Tuolumne County,1,3,2920,1505,1415
50,6,109,California,Tuolumne County,1,4,3210,1724,1486
50,6,109,California,Tuolumne County,1,5,2951,1689,1262
50,6,109,California,Tuolumne County,1,6,3185,1994,1191
50,6,109,California,Tuolumne County,1,7,2892,1758,1134
50,6,109,California,Tuolumne County,1,8,2780,1668,1112
50,6,109,California,Tuolumne County,1,9,3238,1873,1365
50,6,109,California,Tuolumne County,1,10,3912,2096,1816
50,6,109,California,Tuolumne County,1,11,4685,2377,2308
50,6,109,California,Tuolumne County,1,12,4887,2450,2437
50,6,109,California,Tuolumne County,1,13,4582,2322,2260
50,6,109,California,Tuolumne County,1,14,3487,1735,1752
50,6,109,California,Tuolumne County,1,15,2700,1310,1390
50,6,109,California,Tuolumne County,1,16,2055,997,1058
50,6,109,California,Tuolumne County,1,17,1577,687,890
50,6,109,California,Tuolumne County,1,18,1475,565,910
50,6,109,California,Tuolumne County,2,0,55344,29235,26109
50,6,109,California,Tuolumne County,2,1,2327,1195,1132
50,6,109,California,Tuolumne County,2,2,2498,1299,1199
50,6,109,California,Tuolumne County,2,3,2919,1504,1415
50,6,109,California,Tuolumne County,2,4,3210,1724,1486
50,6,109,California,Tuolumne County,2,5,2951,1689,1262
50,6,109,California,Tuolumne County,2,6,3183,1993,1190
50,6,109,California,Tuolumne County,2,7,2892,1759,1133
50,6,109,California,Tuolumne County,2,8,2778,1666,1112
50,6,109,California,Tuolumne County,2,9,3238,1873,1365
50,6,109,California,Tuolumne County,2,10,3912,2096,1816
50,6,109,California,Tuolumne County,2,11,4682,2376,2306
50,6,109,California,Tuolumne County,2,12,4882,2447,2435
50,6,109,California,Tuolumne County,2,13,4580,2322,2258
50,6,109,California,Tuolumne County,2,14,3485,1733,1752
50,6,109,California,Tuolumne County,2,15,2700,1310,1390
50,6,109,California,Tuolumne County,2,16,2055,997,1058
50,6,109,California,Tuolumne County,2,17,1577,687,890
50,6,109,California,Tuolumne County,2,18,1475,565,910
50,6,109,California,Tuolumne County,3,0,55164,29107,26057
50,6,109,California,Tuolumne County,3,1,2326,1185,1141
50,6,109,California,Tuolumne County,3,2,2495,1290,1205
50,6,109,California,Tuolumne County,3,3,2885,1486,1399
50,6,109,California,Tuolumne County,3,4,3163,1692,1471
50,6,109,California,Tuolumne County,3,5,2968,1707,1261
50,6,109,California,Tuolumne County,3,6,3174,1978,1196
50,6,109,California,Tuolumne County,3,7,2896,1751,1145
50,6,109,California,Tuolumne County,3,8,2728,1634,1094
50,6,109,California,Tuolumne County,3,9,3223,1871,1352
50,6,109,California,Tuolumne County,3,10,3848,2068,1780
50,6,109,California,Tuolumne County,3,11,4625,2349,2276
50,6,109,California,Tuolumne County,3,12,4882,2433,2449
50,6,109,California,Tuolumne County,3,13,4595,2331,2264
50,6,109,California,Tuolumne County,3,14,3524,1755,1769
50,6,109,California,Tuolumne County,3,15,2720,1325,1395
50,6,109,California,Tuolumne County,3,16,2057,991,1066
50,6,109,California,Tuolumne County,3,17,1577,689,888
50,6,109,California,Tuolumne County,3,18,1478,572,906
50,6,109,California,Tuolumne County,4,0,54808,28824,25984
50,6,109,California,Tuolumne County,4,1,2276,1156,1120
50,6,109,California,Tuolumne County,4,2,2484,1274,1210
50,6,109,California,Tuolumne County,4,3,2757,1426,1331
50,6,109,California,Tuolumne County,4,4,3016,1595,1421
50,6,109,California,Tuolumne County,4,5,3052,1763,1289
50,6,109,California,Tuolumne County,4,6,3165,1933,1232
50,6,109,California,Tuolumne County,4,7,3022,1816,1206
50,6,109,California,Tuolumne County,4,8,2595,1543,1052
50,6,109,California,Tuolumne County,4,9,3183,1849,1334
50,6,109,California,Tuolumne County,4,10,3596,1963,1633
50,6,109,California,Tuolumne County,4,11,4467,2279,2188
50,6,109,California,Tuolumne County,4,12,4868,2384,2484
50,6,109,California,Tuolumne County,4,13,4747,2403,2344
50,6,109,California,Tuolumne County,4,14,3674,1834,1840
50,6,109,California,Tuolumne County,4,15,2792,1359,1433
50,6,109,California,Tuolumne County,4,16,2043,978,1065
50,6,109,California,Tuolumne County,4,17,1563,683,880
50,6,109,California,Tuolumne County,4,18,1508,586,922
50,6,109,California,Tuolumne County,5,0,54201,28421,25780
50,6,109,California,Tuolumne County,5,1,2272,1142,1130
50,6,109,California,Tuolumne County,5,2,2506,1302,1204
50,6,109,California,Tuolumne County,5,3,2629,1356,1273
50,6,109,California,Tuolumne County,5,4,2922,1540,1382
50,6,109,California,Tuolumne County,5,5,3113,1804,1309
50,6,109,California,Tuolumne County,5,6,3104,1871,1233
50,6,109,California,Tuolumne County,5,7,3017,1805,1212
50,6,109,California,Tuolumne County,5,8,2567,1517,1050
50,6,109,California,Tuolumne County,5,9,3071,1772,1299
50,6,109,California,Tuolumne County,5,10,3359,1846,1513
50,6,109,California,Tuolumne County,5,11,4222,2152,2070
50,6,109,California,Tuolumne County,5,12,4775,2307,2468
50,6,109,California,Tuolumne County,5,13,4639,2357,2282
50,6,109,California,Tuolumne County,5,14,3983,1971,2012
50,6,109,California,Tuolumne County,5,15,2872,1400,1472
50,6,109,California,Tuolumne County,5,16,2070,1000,1070
50,6,109,California,Tuolumne County,5,17,1541,693,848
50,6,109,California,Tuolumne County,5,18,1539,586,953
50,6,109,California,Tuolumne County,6,0,53975,28173,25802
50,6,109,California,Tuolumne County,6,1,2321,1168,1153
50,6,109,California,Tuolumne County,6,2,2486,1275,1211
50,6,109,California,Tuolumne County,6,3,2549,1343,1206
50,6,109,California,Tuolumne County,6,4,2832,1475,1357
50,6,109,California,Tuolumne County,6,5,3123,1779,1344
50,6,109,California,Tuolumne County,6,6,2973,1783,1190
50,6,109,California,Tuolumne County,6,7,3114,1835,1279
50,6,109,California,Tuolumne County,6,8,2590,1502,1088
50,6,109,California,Tuolumne County,6,9,2953,1689,1264
50,6,109,California,Tuolumne County,6,10,3196,1778,1418
50,6,109,California,Tuolumne County,6,11,4042,2022,2020
50,6,109,California,Tuolumne County,6,12,4705,2287,2418
50,6,109,California,Tuolumne County,6,13,4738,2370,2368
50,6,109,California,Tuolumne County,6,14,4130,2052,2078
50,6,109,California,Tuolumne County,6,15,2981,1459,1522
50,6,109,California,Tuolumne County,6,16,2142,1029,1113
50,6,109,California,Tuolumne County,6,17,1562,741,821
50,6,109,California,Tuolumne County,6,18,1538,586,952
50,6,109,California,Tuolumne County,7,0,53830,28095,25735
50,6,109,California,Tuolumne County,7,1,2350,1185,1165
50,6,109,California,Tuolumne County,7,2,2455,1273,1182
50,6,109,California,Tuolumne County,7,3,2525,1334,1191
50,6,109,California,Tuolumne County,7,4,2750,1451,1299
50,6,109,California,Tuolumne County,7,5,3002,1737,1265
50,6,109,California,Tuolumne County,7,6,3064,1810,1254
50,6,109,California,Tuolumne County,7,7,3123,1838,1285
50,6,109,California,Tuolumne County,7,8,2729,1575,1154
50,6,109,California,Tuolumne County,7,9,2848,1655,1193
50,6,109,California,Tuolumne County,7,10,3102,1689,1413
50,6,109,California,Tuolumne County,7,11,3835,1928,1907
50,6,109,California,Tuolumne County,7,12,4607,2269,2338
50,6,109,California,Tuolumne County,7,13,4764,2332,2432
50,6,109,California,Tuolumne County,7,14,4256,2125,2131
50,6,109,California,Tuolumne County,7,15,3103,1496,1607
50,6,109,California,Tuolumne County,7,16,2217,1071,1146
50,6,109,California,Tuolumne County,7,17,1538,715,823
50,6,109,California,Tuolumne County,7,18,1562,612,950
50,6,109,California,Tuolumne County,8,0,53599,27845,25754
50,6,109,California,Tuolumne County,8,1,2406,1228,1178
50,6,109,California,Tuolumne County,8,2,2391,1243,1148
50,6,109,California,Tuolumne County,8,3,2491,1284,1207
50,6,109,California,Tuolumne County,8,4,2649,1404,1245
50,6,109,California,Tuolumne County,8,5,2933,1655,1278
50,6,109,California,Tuolumne County,8,6,3111,1825,1286
50,6,109,California,Tuolumne County,8,7,3108,1827,1281
50,6,109,California,Tuolumne County,8,8,2765,1557,1208
50,6,109,California,Tuolumne County,8,9,2743,1580,1163
50,6,109,California,Tuolumne County,8,10,2992,1642,1350
50,6,109,California,Tuolumne County,8,11,3657,1829,1828
50,6,109,California,Tuolumne County,8,12,4479,2206,2273
50,6,109,California,Tuolumne County,8,13,4849,2370,2479
50,6,109,California,Tuolumne County,8,14,4386,2198,2188
50,6,109,California,Tuolumne County,8,15,3226,1567,1659
50,6,109,California,Tuolumne County,8,16,2334,1122,1212
50,6,109,California,Tuolumne County,8,17,1527,689,838
50,6,109,California,Tuolumne County,8,18,1552,619,933
50,6,109,California,Tuolumne County,9,0,53729,27860,25869
50,6,109,California,Tuolumne County,9,1,2356,1145,1211
50,6,109,California,Tuolumne County,9,2,2432,1267,1165
50,6,109,California,Tuolumne County,9,3,2517,1298,1219
50,6,109,California,Tuolumne County,9,4,2572,1356,1216
50,6,109,California,Tuolumne County,9,5,2863,1613,1250
50,6,109,California,Tuolumne County,9,6,3228,1915,1313
50,6,109,California,Tuolumne County,9,7,3089,1775,1314
50,6,109,California,Tuolumne County,9,8,2901,1653,1248
50,6,109,California,Tuolumne County,9,9,2667,1549,1118
50,6,109,California,Tuolumne County,9,10,3013,1652,1361
50,6,109,California,Tuolumne County,9,11,3498,1766,1732
50,6,109,California,Tuolumne County,9,12,4341,2133,2208
50,6,109,California,Tuolumne County,9,13,4888,2362,2526
50,6,109,California,Tuolumne County,9,14,4543,2278,2265
50,6,109,California,Tuolumne County,9,15,3344,1651,1693
50,6,109,California,Tuolumne County,9,16,2405,1150,1255
50,6,109,California,Tuolumne County,9,17,1541,704,837
50,6,109,California,Tuolumne County,9,18,1531,593,938
50,6,109,California,Tuolumne County,10,0,53953,27990,25963
50,6,109,California,Tuolumne County,10,1,2347,1142,1205
50,6,109,California,Tuolumne County,10,2,2476,1275,1201
50,6,109,California,Tuolumne County,10,3,2583,1364,1219
50,6,109,California,Tuolumne County,10,4,2520,1328,1192
50,6,109,California,Tuolumne County,10,5,2742,1544,1198
50,6,109,California,Tuolumne County,10,6,3349,1973,1376
50,6,109,California,Tuolumne County,10,7,3116,1796,1320
50,6,109,California,Tuolumne County,10,8,3043,1745,1298
50,6,109,California,Tuolumne County,10,9,2711,1569,1142
50,6,109,California,Tuolumne County,10,10,2941,1607,1334
50,6,109,California,Tuolumne County,10,11,3352,1725,1627
50,6,109,California,Tuolumne County,10,12,4177,2040,2137
50,6,109,California,Tuolumne County,10,13,4803,2280,2523
50,6,109,California,Tuolumne County,10,14,4527,2289,2238
50,6,109,California,Tuolumne County,10,15,3692,1787,1905
50,6,109,California,Tuolumne County,10,16,2431,1166,1265
50,6,109,California,Tuolumne County,10,17,1589,747,842
50,6,109,California,Tuolumne County,10,18,1554,613,941
50,6,109,California,Tuolumne County,11,0,54250,28151,26099
50,6,109,California,Tuolumne County,11,1,2387,1179,1208
50,6,109,California,Tuolumne County,11,2,2522,1276,1246
50,6,109,California,Tuolumne County,11,3,2633,1377,1256
50,6,109,California,Tuolumne County,11,4,2498,1306,1192
50,6,109,California,Tuolumne County,11,5,2691,1534,1157
50,6,109,California,Tuolumne County,11,6,3362,1956,1406
50,6,109,California,Tuolumne County,11,7,3118,1807,1311
50,6,109,California,Tuolumne County,11,8,3198,1810,1388
50,6,109,California,Tuolumne County,11,9,2817,1628,1189
50,6,109,California,Tuolumne County,11,10,2889,1586,1303
50,6,109,California,Tuolumne County,11,11,3168,1656,1512
50,6,109,California,Tuolumne County,11,12,4046,1936,2110
50,6,109,California,Tuolumne County,11,13,4761,2313,2448
50,6,109,California,Tuolumne County,11,14,4601,2280,2321
50,6,109,California,Tuolumne County,11,15,3807,1875,1932
50,6,109,California,Tuolumne County,11,16,2523,1205,1318
50,6,109,California,Tuolumne County,11,17,1645,780,865
50,6,109,California,Tuolumne County,11,18,1584,647,937
50,6,109,California,Tuolumne County,12,0,54290,28131,26159
50,6,109,California,Tuolumne County,12,1,2385,1181,1204
50,6,109,California,Tuolumne County,12,2,2540,1269,1271
50,6,109,California,Tuolumne County,12,3,2658,1375,1283
50,6,109,California,Tuolumne County,12,4,2481,1286,1195
50,6,109,California,Tuolumne County,12,5,2613,1506,1107
50,6,109,California,Tuolumne County,12,6,3318,1957,1361
50,6,109,California,Tuolumne County,12,7,3195,1813,1382
50,6,109,California,Tuolumne County,12,8,3196,1814,1382
50,6,109,California,Tuolumne County,12,9,2902,1671,1231
50,6,109,California,Tuolumne County,12,10,2812,1562,1250
50,6,109,California,Tuolumne County,12,11,3036,1574,1462
50,6,109,California,Tuolumne County,12,12,3859,1840,2019
50,6,109,California,Tuolumne County,12,13,4699,2308,2391
50,6,109,California,Tuolumne County,12,14,4710,2308,2402
50,6,109,California,Tuolumne County,12,15,3917,1941,1976
50,6,109,California,Tuolumne County,12,16,2674,1273,1401
50,6,109,California,Tuolumne County,12,17,1701,803,898
50,6,109,California,Tuolumne County,12,18,1594,650,944
50,6,109,California,Tuolumne County,13,0,54501,28356,26145
50,6,109,California,Tuolumne County,13,1,2394,1193,1201
50,6,109,California,Tuolumne County,13,2,2545,1271,1274
50,6,109,California,Tuolumne County,13,3,2657,1360,1297
50,6,109,California,Tuolumne County,13,4,2483,1280,1203
50,6,109,California,Tuolumne County,13,5,2589,1483,1106
50,6,109,California,Tuolumne County,13,6,3313,1974,1339
50,6,109,California,Tuolumne County,13,7,3313,1903,1410
50,6,109,California,Tuolumne County,13,8,3225,1869,1356
50,6,109,California,Tuolumne County,13,9,3000,1725,1275
50,6,109,California,Tuolumne County,13,10,2801,1588,1213
50,6,109,California,Tuolumne County,13,11,2969,1569,1400
50,6,109,California,Tuolumne County,13,12,3717,1787,1930
50,6,109,California,Tuolumne County,13,13,4632,2250,2382
50,6,109,California,Tuolumne County,13,14,4770,2329,2441
50,6,109,California,Tuolumne County,13,15,4021,2000,2021
50,6,109,California,Tuolumne County,13,16,2741,1313,1428
50,6,109,California,Tuolumne County,13,17,1749,817,932
50,6,109,California,Tuolumne County,13,18,1582,645,937
50,6,109,California,Tuolumne County,14,0,54515,28402,26113
50,6,109,California,Tuolumne County,14,1,2398,1196,1202
50,6,109,California,Tuolumne County,14,2,2541,1271,1270
50,6,109,California,Tuolumne County,14,3,2655,1354,1301
50,6,109,California,Tuolumne County,14,4,2476,1279,1197
50,6,109,California,Tuolumne County,14,5,2575,1472,1103
50,6,109,California,Tuolumne County,14,6,3307,1977,1330
50,6,109,California,Tuolumne County,14,7,3358,1936,1422
50,6,109,California,Tuolumne County,14,8,3237,1888,1349
50,6,109,California,Tuolumne County,14,9,3030,1742,1288
50,6,109,California,Tuolumne County,14,10,2797,1595,1202
50,6,109,California,Tuolumne County,14,11,2957,1571,1386
50,6,109,California,Tuolumne County,14,12,3671,1768,1903
50,6,109,California,Tuolumne County,14,13,4604,2225,2379
50,6,109,California,Tuolumne County,14,14,4787,2337,2450
50,6,109,California,Tuolumne County,14,15,4042,2013,2029
50,6,109,California,Tuolumne County,14,16,2749,1319,1430
50,6,109,California,Tuolumne County,14,17,1763,819,944
50,6,109,California,Tuolumne County,14,18,1568,640,928
50,6,111,California,Ventura County,1,0,823318,408969,414349
50,6,111,California,Ventura County,1,1,55336,28201,27135
50,6,111,California,Ventura County,1,2,56970,28896,28074
50,6,111,California,Ventura County,1,3,60390,31030,29360
50,6,111,California,Ventura County,1,4,64407,33362,31045
50,6,111,California,Ventura County,1,5,56183,29798,26385
50,6,111,California,Ventura County,1,6,54253,28199,26054
50,6,111,California,Ventura County,1,7,51207,25967,25240
50,6,111,California,Ventura County,1,8,53448,26440,27008
50,6,111,California,Ventura County,1,9,57635,28773,28862
50,6,111,California,Ventura County,1,10,62731,30836,31895
50,6,111,California,Ventura County,1,11,60973,29911,31062
50,6,111,California,Ventura County,1,12,51164,24996,26168
50,6,111,California,Ventura County,1,13,42312,20493,21819
50,6,111,California,Ventura County,1,14,29834,14162,15672
50,6,111,California,Ventura County,1,15,21562,9808,11754
50,6,111,California,Ventura County,1,16,17443,7765,9678
50,6,111,California,Ventura County,1,17,13427,5477,7950
50,6,111,California,Ventura County,1,18,14043,4855,9188
50,6,111,California,Ventura County,2,0,823446,409069,414377
50,6,111,California,Ventura County,2,1,55338,28202,27136
50,6,111,California,Ventura County,2,2,56970,28898,28072
50,6,111,California,Ventura County,2,3,60393,31031,29362
50,6,111,California,Ventura County,2,4,64407,33363,31044
50,6,111,California,Ventura County,2,5,56198,29807,26391
50,6,111,California,Ventura County,2,6,54270,28211,26059
50,6,111,California,Ventura County,2,7,51215,25973,25242
50,6,111,California,Ventura County,2,8,53467,26453,27014
50,6,111,California,Ventura County,2,9,57652,28789,28863
50,6,111,California,Ventura County,2,10,62743,30841,31902
50,6,111,California,Ventura County,2,11,60989,29921,31068
50,6,111,California,Ventura County,2,12,51178,25011,26167
50,6,111,California,Ventura County,2,13,42324,20504,21820
50,6,111,California,Ventura County,2,14,29826,14160,15666
50,6,111,California,Ventura County,2,15,21562,9808,11754
50,6,111,California,Ventura County,2,16,17445,7765,9680
50,6,111,California,Ventura County,2,17,13426,5477,7949
50,6,111,California,Ventura County,2,18,14043,4855,9188
50,6,111,California,Ventura County,3,0,825144,409803,415341
50,6,111,California,Ventura County,3,1,55406,28242,27164
50,6,111,California,Ventura County,3,2,56994,28939,28055
50,6,111,California,Ventura County,3,3,60158,30863,29295
50,6,111,California,Ventura County,3,4,64091,33149,30942
50,6,111,California,Ventura County,3,5,56606,29963,26643
50,6,111,California,Ventura County,3,6,54431,28288,26143
50,6,111,California,Ventura County,3,7,51560,26193,25367
50,6,111,California,Ventura County,3,8,53135,26253,26882
50,6,111,California,Ventura County,3,9,57670,28819,28851
50,6,111,California,Ventura County,3,10,62495,30734,31761
50,6,111,California,Ventura County,3,11,61177,29996,31181
50,6,111,California,Ventura County,3,12,51622,25230,26392
50,6,111,California,Ventura County,3,13,42762,20700,22062
50,6,111,California,Ventura County,3,14,30167,14334,15833
50,6,111,California,Ventura County,3,15,21746,9909,11837
50,6,111,California,Ventura County,3,16,17477,7780,9697
50,6,111,California,Ventura County,3,17,13478,5514,7964
50,6,111,California,Ventura County,3,18,14169,4897,9272
50,6,111,California,Ventura County,4,0,829908,411667,418241
50,6,111,California,Ventura County,4,1,55098,28029,27069
50,6,111,California,Ventura County,4,2,57302,29153,28149
50,6,111,California,Ventura County,4,3,59222,30214,29008
50,6,111,California,Ventura County,4,4,62698,32303,30395
50,6,111,California,Ventura County,4,5,58066,30494,27572
50,6,111,California,Ventura County,4,6,54640,28397,26243
50,6,111,California,Ventura County,4,7,52355,26697,25658
50,6,111,California,Ventura County,4,8,51529,25421,26108
50,6,111,California,Ventura County,4,9,57701,28852,28849
50,6,111,California,Ventura County,4,10,60963,30014,30949
50,6,111,California,Ventura County,4,11,62028,30384,31644
50,6,111,California,Ventura County,4,12,53257,25998,27259
50,6,111,California,Ventura County,4,13,44772,21658,23114
50,6,111,California,Ventura County,4,14,31562,15014,16548
50,6,111,California,Ventura County,4,15,22651,10395,12256
50,6,111,California,Ventura County,4,16,17734,7873,9861
50,6,111,California,Ventura County,4,17,13609,5623,7986
50,6,111,California,Ventura County,4,18,14721,5148,9573
50,6,111,California,Ventura County,5,0,833287,412891,420396
50,6,111,California,Ventura County,5,1,54518,27716,26802
50,6,111,California,Ventura County,5,2,57529,29252,28277
50,6,111,California,Ventura County,5,3,58340,29701,28639
50,6,111,California,Ventura County,5,4,61335,31541,29794
50,6,111,California,Ventura County,5,5,59458,30768,28690
50,6,111,California,Ventura County,5,6,54466,28414,26052
50,6,111,California,Ventura County,5,7,52845,27011,25834
50,6,111,California,Ventura County,5,8,51155,25277,25878
50,6,111,California,Ventura County,5,9,56894,28354,28540
50,6,111,California,Ventura County,5,10,59598,29429,30169
50,6,111,California,Ventura County,5,11,62018,30371,31647
50,6,111,California,Ventura County,5,12,55035,26961,28074
50,6,111,California,Ventura County,5,13,44655,21458,23197
50,6,111,California,Ventura County,5,14,34532,16487,18045
50,6,111,California,Ventura County,5,15,23916,11096,12820
50,6,111,California,Ventura County,5,16,17981,7892,10089
50,6,111,California,Ventura County,5,17,13878,5843,8035
50,6,111,California,Ventura County,5,18,15134,5320,9814
50,6,111,California,Ventura County,6,0,837729,414673,423056
50,6,111,California,Ventura County,6,1,53791,27373,26418
50,6,111,California,Ventura County,6,2,57521,29255,28266
50,6,111,California,Ventura County,6,3,58023,29445,28578
50,6,111,California,Ventura County,6,4,60184,30827,29357
50,6,111,California,Ventura County,6,5,60598,31259,29339
50,6,111,California,Ventura County,6,6,54470,28406,26064
50,6,111,California,Ventura County,6,7,53623,27438,26185
50,6,111,California,Ventura County,6,8,50907,25177,25730
50,6,111,California,Ventura County,6,9,56110,27821,28289
50,6,111,California,Ventura County,6,10,58382,28852,29530
50,6,111,California,Ventura County,6,11,61890,30264,31626
50,6,111,California,Ventura County,6,12,56569,27825,28744
50,6,111,California,Ventura County,6,13,45772,21912,23860
50,6,111,California,Ventura County,6,14,36277,17365,18912
50,6,111,California,Ventura County,6,15,25552,11830,13722
50,6,111,California,Ventura County,6,16,18466,8116,10350
50,6,111,California,Ventura County,6,17,14118,5999,8119
50,6,111,California,Ventura County,6,18,15476,5509,9967
50,6,111,California,Ventura County,7,0,842113,416628,425485
50,6,111,California,Ventura County,7,1,53378,27249,26129
50,6,111,California,Ventura County,7,2,56958,28875,28083
50,6,111,California,Ventura County,7,3,57768,29213,28555
50,6,111,California,Ventura County,7,4,59230,30387,28843
50,6,111,California,Ventura County,7,5,61226,31410,29816
50,6,111,California,Ventura County,7,6,55264,28774,26490
50,6,111,California,Ventura County,7,7,54059,27735,26324
50,6,111,California,Ventura County,7,8,51432,25471,25961
50,6,111,California,Ventura County,7,9,54657,27091,27566
50,6,111,California,Ventura County,7,10,57252,28331,28921
50,6,111,California,Ventura County,7,11,61811,30298,31513
50,6,111,California,Ventura County,7,12,57625,28252,29373
50,6,111,California,Ventura County,7,13,47201,22655,24546
50,6,111,California,Ventura County,7,14,38180,18214,19966
50,6,111,California,Ventura County,7,15,26945,12506,14439
50,6,111,California,Ventura County,7,16,19019,8362,10657
50,6,111,California,Ventura County,7,17,14326,6146,8180
50,6,111,California,Ventura County,7,18,15782,5659,10123
50,6,111,California,Ventura County,8,0,845599,418585,427014
50,6,111,California,Ventura County,8,1,52854,27034,25820
50,6,111,California,Ventura County,8,2,56213,28457,27756
50,6,111,California,Ventura County,8,3,57322,28994,28328
50,6,111,California,Ventura County,8,4,58428,29922,28506
50,6,111,California,Ventura County,8,5,60655,31119,29536
50,6,111,California,Ventura County,8,6,56702,29563,27139
50,6,111,California,Ventura County,8,7,54112,27854,26258
50,6,111,California,Ventura County,8,8,52207,26099,26108
50,6,111,California,Ventura County,8,9,53029,26079,26950
50,6,111,California,Ventura County,8,10,57055,28365,28690
50,6,111,California,Ventura County,8,11,60827,29862,30965
50,6,111,California,Ventura County,8,12,58516,28625,29891
50,6,111,California,Ventura County,8,13,48831,23521,25310
50,6,111,California,Ventura County,8,14,40153,19167,20986
50,6,111,California,Ventura County,8,15,28291,13107,15184
50,6,111,California,Ventura County,8,16,19673,8673,11000
50,6,111,California,Ventura County,8,17,14575,6261,8314
50,6,111,California,Ventura County,8,18,16156,5883,10273
50,6,111,California,Ventura County,9,0,846921,419398,427523
50,6,111,California,Ventura County,9,1,51779,26574,25205
50,6,111,California,Ventura County,9,2,55431,28170,27261
50,6,111,California,Ventura County,9,3,57344,29084,28260
50,6,111,California,Ventura County,9,4,57528,29369,28159
50,6,111,California,Ventura County,9,5,59207,30293,28914
50,6,111,California,Ventura County,9,6,58026,30291,27735
50,6,111,California,Ventura County,9,7,54243,27962,26281
50,6,111,California,Ventura County,9,8,52830,26577,26253
50,6,111,California,Ventura County,9,9,51606,25359,26247
50,6,111,California,Ventura County,9,10,57002,28221,28781
50,6,111,California,Ventura County,9,11,59220,29208,30012
50,6,111,California,Ventura County,9,12,59301,28937,30364
50,6,111,California,Ventura County,9,13,50210,24226,25984
50,6,111,California,Ventura County,9,14,41916,19933,21983
50,6,111,California,Ventura County,9,15,29405,13669,15736
50,6,111,California,Ventura County,9,16,20500,9088,11412
50,6,111,California,Ventura County,9,17,14877,6362,8515
50,6,111,California,Ventura County,9,18,16496,6075,10421
50,6,111,California,Ventura County,10,0,848264,419901,428363
50,6,111,California,Ventura County,10,1,50795,25991,24804
50,6,111,California,Ventura County,10,2,54475,27626,26849
50,6,111,California,Ventura County,10,3,57168,29027,28141
50,6,111,California,Ventura County,10,4,56906,28939,27967
50,6,111,California,Ventura County,10,5,57891,29521,28370
50,6,111,California,Ventura County,10,6,59068,30682,28386
50,6,111,California,Ventura County,10,7,54480,28155,26325
50,6,111,California,Ventura County,10,8,53470,27085,26385
50,6,111,California,Ventura County,10,9,51295,25284,26011
50,6,111,California,Ventura County,10,10,56324,27836,28488
50,6,111,California,Ventura County,10,11,57878,28591,29287
50,6,111,California,Ventura County,10,12,59366,28981,30385
50,6,111,California,Ventura County,10,13,51788,25149,26639
50,6,111,California,Ventura County,10,14,41780,19732,22048
50,6,111,California,Ventura County,10,15,31976,14935,17041
50,6,111,California,Ventura County,10,16,21592,9670,11922
50,6,111,California,Ventura County,10,17,15109,6348,8761
50,6,111,California,Ventura County,10,18,16903,6349,10554
50,6,111,California,Ventura County,11,0,847222,419381,427841
50,6,111,California,Ventura County,11,1,49449,25353,24096
50,6,111,California,Ventura County,11,2,53707,27185,26522
50,6,111,California,Ventura County,11,3,56812,28895,27917
50,6,111,California,Ventura County,11,4,56163,28563,27600
50,6,111,California,Ventura County,11,5,56660,28843,27817
50,6,111,California,Ventura County,11,6,59500,30810,28690
50,6,111,California,Ventura County,11,7,54455,28207,26248
50,6,111,California,Ventura County,11,8,54143,27449,26694
50,6,111,California,Ventura County,11,9,51008,25116,25892
50,6,111,California,Ventura County,11,10,55260,27284,27976
50,6,111,California,Ventura County,11,11,56573,28012,28561
50,6,111,California,Ventura County,11,12,58880,28761,30119
50,6,111,California,Ventura County,11,13,52936,25860,27076
50,6,111,California,Ventura County,11,14,42491,20012,22479
50,6,111,California,Ventura County,11,15,33495,15739,17756
50,6,111,California,Ventura County,11,16,22980,10245,12735
50,6,111,California,Ventura County,11,17,15454,6514,8940
50,6,111,California,Ventura County,11,18,17256,6533,10723
50,6,111,California,Ventura County,12,0,844203,417856,426347
50,6,111,California,Ventura County,12,1,47985,24546,23439
50,6,111,California,Ventura County,12,2,52872,26933,25939
50,6,111,California,Ventura County,12,3,55759,28293,27466
50,6,111,California,Ventura County,12,4,55568,28175,27393
50,6,111,California,Ventura County,12,5,55490,28200,27290
50,6,111,California,Ventura County,12,6,59452,30701,28751
50,6,111,California,Ventura County,12,7,54546,28301,26245
50,6,111,California,Ventura County,12,8,54042,27457,26585
50,6,111,California,Ventura County,12,9,51057,25289,25768
50,6,111,California,Ventura County,12,10,53640,26432,27208
50,6,111,California,Ventura County,12,11,55437,27450,27987
50,6,111,California,Ventura County,12,12,58444,28607,29837
50,6,111,California,Ventura County,12,13,53587,26124,27463
50,6,111,California,Ventura County,12,14,43516,20615,22901
50,6,111,California,Ventura County,12,15,35120,16440,18680
50,6,111,California,Ventura County,12,16,24075,10807,13268
50,6,111,California,Ventura County,12,17,15902,6731,9171
50,6,111,California,Ventura County,12,18,17711,6755,10956
50,6,111,California,Ventura County,13,0,842692,417109,425583
50,6,111,California,Ventura County,13,1,46731,23801,22930
50,6,111,California,Ventura County,13,2,52627,26933,25694
50,6,111,California,Ventura County,13,3,55209,27988,27221
50,6,111,California,Ventura County,13,4,55172,27973,27199
50,6,111,California,Ventura County,13,5,54860,27847,27013
50,6,111,California,Ventura County,13,6,58780,30338,28442
50,6,111,California,Ventura County,13,7,55042,28522,26520
50,6,111,California,Ventura County,13,8,53909,27390,26519
50,6,111,California,Ventura County,13,9,51278,25529,25749
50,6,111,California,Ventura County,13,10,52408,25741,26667
50,6,111,California,Ventura County,13,11,55187,27427,27760
50,6,111,California,Ventura County,13,12,57661,28225,29436
50,6,111,California,Ventura County,13,13,54194,26421,27773
50,6,111,California,Ventura County,13,14,44264,21032,23232
50,6,111,California,Ventura County,13,15,36259,16974,19285
50,6,111,California,Ventura County,13,16,24804,11155,13649
50,6,111,California,Ventura County,13,17,16248,6913,9335
50,6,111,California,Ventura County,13,18,18059,6900,11159
50,6,111,California,Ventura County,14,0,841387,416460,424927
50,6,111,California,Ventura County,14,1,46293,23536,22757
50,6,111,California,Ventura County,14,2,52456,26890,25566
50,6,111,California,Ventura County,14,3,54981,27866,27115
50,6,111,California,Ventura County,14,4,54975,27870,27105
50,6,111,California,Ventura County,14,5,54569,27683,26886
50,6,111,California,Ventura County,14,6,58466,30176,28290
50,6,111,California,Ventura County,14,7,55205,28591,26614
50,6,111,California,Ventura County,14,8,53899,27397,26502
50,6,111,California,Ventura County,14,9,51331,25598,25733
50,6,111,California,Ventura County,14,10,51992,25511,26481
50,6,111,California,Ventura County,14,11,55177,27449,27728
50,6,111,California,Ventura County,14,12,57354,28081,29273
50,6,111,California,Ventura County,14,13,54328,26472,27856
50,6,111,California,Ventura County,14,14,44486,21165,23321
50,6,111,California,Ventura County,14,15,36545,17101,19444
50,6,111,California,Ventura County,14,16,24967,11230,13737
50,6,111,California,Ventura County,14,17,16330,6956,9374
50,6,111,California,Ventura County,14,18,18033,6888,11145
50,6,113,California,Yolo County,1,0,200849,97935,102914
50,6,113,California,Yolo County,1,1,12577,6429,6148
50,6,113,California,Yolo County,1,2,12235,6195,6040
50,6,113,California,Yolo County,1,3,12693,6545,6148
50,6,113,California,Yolo County,1,4,19318,9330,9988
50,6,113,California,Yolo County,1,5,27185,13212,13973
50,6,113,California,Yolo County,1,6,15141,7577,7564
50,6,113,California,Yolo County,1,7,13027,6523,6504
50,6,113,California,Yolo County,1,8,11827,5918,5909
50,6,113,California,Yolo County,1,9,12086,5936,6150
50,6,113,California,Yolo County,1,10,12524,6056,6468
50,6,113,California,Yolo County,1,11,12306,5897,6409
50,6,113,California,Yolo County,1,12,11193,5408,5785
50,6,113,California,Yolo County,1,13,8966,4310,4656
50,6,113,California,Yolo County,1,14,6163,2892,3271
50,6,113,California,Yolo County,1,15,4407,1988,2419
50,6,113,California,Yolo County,1,16,3485,1559,1926
50,6,113,California,Yolo County,1,17,2742,1127,1615
50,6,113,California,Yolo County,1,18,2974,1033,1941
50,6,113,California,Yolo County,2,0,200855,97939,102916
50,6,113,California,Yolo County,2,1,12578,6430,6148
50,6,113,California,Yolo County,2,2,12235,6195,6040
50,6,113,California,Yolo County,2,3,12695,6547,6148
50,6,113,California,Yolo County,2,4,19318,9330,9988
50,6,113,California,Yolo County,2,5,27185,13212,13973
50,6,113,California,Yolo County,2,6,15141,7577,7564
50,6,113,California,Yolo County,2,7,13029,6524,6505
50,6,113,California,Yolo County,2,8,11827,5918,5909
50,6,113,California,Yolo County,2,9,12086,5936,6150
50,6,113,California,Yolo County,2,10,12525,6056,6469
50,6,113,California,Yolo County,2,11,12306,5897,6409
50,6,113,California,Yolo County,2,12,11193,5408,5785
50,6,113,California,Yolo County,2,13,8966,4310,4656
50,6,113,California,Yolo County,2,14,6163,2892,3271
50,6,113,California,Yolo County,2,15,4407,1988,2419
50,6,113,California,Yolo County,2,16,3485,1559,1926
50,6,113,California,Yolo County,2,17,2742,1127,1615
50,6,113,California,Yolo County,2,18,2974,1033,1941
50,6,113,California,Yolo County,3,0,201061,97993,103068
50,6,113,California,Yolo County,3,1,12512,6399,6113
50,6,113,California,Yolo County,3,2,12256,6195,6061
50,6,113,California,Yolo County,3,3,12644,6523,6121
50,6,113,California,Yolo County,3,4,19152,9239,9913
50,6,113,California,Yolo County,3,5,27682,13414,14268
50,6,113,California,Yolo County,3,6,14971,7509,7462
50,6,113,California,Yolo County,3,7,13047,6535,6512
50,6,113,California,Yolo County,3,8,11796,5891,5905
50,6,113,California,Yolo County,3,9,12017,5907,6110
50,6,113,California,Yolo County,3,10,12453,6029,6424
50,6,113,California,Yolo County,3,11,12322,5910,6412
50,6,113,California,Yolo County,3,12,11213,5402,5811
50,6,113,California,Yolo County,3,13,9063,4357,4706
50,6,113,California,Yolo County,3,14,6207,2910,3297
50,6,113,California,Yolo County,3,15,4488,2040,2448
50,6,113,California,Yolo County,3,16,3487,1545,1942
50,6,113,California,Yolo County,3,17,2755,1136,1619
50,6,113,California,Yolo County,3,18,2996,1052,1944
50,6,113,California,Yolo County,4,0,201931,98332,103599
50,6,113,California,Yolo County,4,1,12363,6314,6049
50,6,113,California,Yolo County,4,2,12393,6257,6136
50,6,113,California,Yolo County,4,3,12482,6427,6055
50,6,113,California,Yolo County,4,4,18705,8989,9716
50,6,113,California,Yolo County,4,5,29114,13952,15162
50,6,113,California,Yolo County,4,6,14272,7300,6972
50,6,113,California,Yolo County,4,7,13255,6622,6633
50,6,113,California,Yolo County,4,8,11683,5832,5851
50,6,113,California,Yolo County,4,9,11898,5850,6048
50,6,113,California,Yolo County,4,10,12240,5950,6290
50,6,113,California,Yolo County,4,11,12359,5971,6388
50,6,113,California,Yolo County,4,12,11256,5398,5858
50,6,113,California,Yolo County,4,13,9459,4521,4938
50,6,113,California,Yolo County,4,14,6425,3001,3424
50,6,113,California,Yolo County,4,15,4671,2167,2504
50,6,113,California,Yolo County,4,16,3509,1517,1992
50,6,113,California,Yolo County,4,17,2788,1184,1604
50,6,113,California,Yolo County,4,18,3059,1080,1979
50,6,113,California,Yolo County,5,0,204558,99592,104966
50,6,113,California,Yolo County,5,1,12146,6205,5941
50,6,113,California,Yolo County,5,2,12769,6487,6282
50,6,113,California,Yolo County,5,3,12375,6322,6053
50,6,113,California,Yolo County,5,4,19403,9255,10148
50,6,113,California,Yolo County,5,5,30089,14366,15723
50,6,113,California,Yolo County,5,6,13775,7104,6671
50,6,113,California,Yolo County,5,7,13647,6821,6826
50,6,113,California,Yolo County,5,8,11729,5887,5842
50,6,113,California,Yolo County,5,9,11934,5860,6074
50,6,113,California,Yolo County,5,10,11948,5845,6103
50,6,113,California,Yolo County,5,11,12309,5971,6338
50,6,113,California,Yolo County,5,12,11488,5518,5970
50,6,113,California,Yolo County,5,13,9434,4493,4941
50,6,113,California,Yolo County,5,14,7028,3278,3750
50,6,113,California,Yolo County,5,15,4892,2296,2596
50,6,113,California,Yolo County,5,16,3586,1547,2039
50,6,113,California,Yolo County,5,17,2851,1218,1633
50,6,113,California,Yolo County,5,18,3155,1119,2036
50,6,113,California,Yolo County,6,0,206267,100580,105687
50,6,113,California,Yolo County,6,1,12253,6274,5979
50,6,113,California,Yolo County,6,2,12712,6453,6259
50,6,113,California,Yolo County,6,3,12330,6288,6042
50,6,113,California,Yolo County,6,4,19453,9254,10199
50,6,113,California,Yolo County,6,5,30297,14570,15727
50,6,113,California,Yolo County,6,6,13967,7227,6740
50,6,113,California,Yolo County,6,7,13843,6966,6877
50,6,113,California,Yolo County,6,8,11911,5958,5953
50,6,113,California,Yolo County,6,9,11805,5847,5958
50,6,113,California,Yolo County,6,10,11813,5803,6010
50,6,113,California,Yolo County,6,11,12150,5872,6278
50,6,113,California,Yolo County,6,12,11599,5542,6057
50,6,113,California,Yolo County,6,13,9642,4592,5050
50,6,113,California,Yolo County,6,14,7462,3481,3981
50,6,113,California,Yolo County,6,15,5243,2475,2768
50,6,113,California,Yolo County,6,16,3685,1593,2092
50,6,113,California,Yolo County,6,17,2877,1236,1641
50,6,113,California,Yolo County,6,18,3225,1149,2076
50,6,113,California,Yolo County,7,0,208368,101607,106761
50,6,113,California,Yolo County,7,1,12352,6359,5993
50,6,113,California,Yolo County,7,2,12811,6526,6285
50,6,113,California,Yolo County,7,3,12533,6322,6211
50,6,113,California,Yolo County,7,4,18821,9006,9815
50,6,113,California,Yolo County,7,5,30223,14493,15730
50,6,113,California,Yolo County,7,6,14538,7520,7018
50,6,113,California,Yolo County,7,7,13933,6977,6956
50,6,113,California,Yolo County,7,8,12328,6155,6173
50,6,113,California,Yolo County,7,9,11717,5805,5912
50,6,113,California,Yolo County,7,10,11807,5821,5986
50,6,113,California,Yolo County,7,11,12160,5877,6283
50,6,113,California,Yolo County,7,12,11634,5552,6082
50,6,113,California,Yolo County,7,13,10049,4795,5254
50,6,113,California,Yolo County,7,14,7881,3685,4196
50,6,113,California,Yolo County,7,15,5506,2589,2917
50,6,113,California,Yolo County,7,16,3877,1685,2192
50,6,113,California,Yolo County,7,17,2869,1237,1632
50,6,113,California,Yolo County,7,18,3329,1203,2126
50,6,113,California,Yolo County,8,0,211998,103285,108713
50,6,113,California,Yolo County,8,1,12421,6366,6055
50,6,113,California,Yolo County,8,2,12945,6579,6366
50,6,113,California,Yolo County,8,3,12566,6371,6195
50,6,113,California,Yolo County,8,4,19514,9346,10168
50,6,113,California,Yolo County,8,5,30464,14575,15889
50,6,113,California,Yolo County,8,6,15323,7907,7416
50,6,113,California,Yolo County,8,7,13769,6856,6913
50,6,113,California,Yolo County,8,8,12834,6385,6449
50,6,113,California,Yolo County,8,9,11604,5826,5778
50,6,113,California,Yolo County,8,10,11898,5816,6082
50,6,113,California,Yolo County,8,11,12103,5882,6221
50,6,113,California,Yolo County,8,12,11782,5632,6150
50,6,113,California,Yolo County,8,13,10295,4866,5429
50,6,113,California,Yolo County,8,14,8343,3935,4408
50,6,113,California,Yolo County,8,15,5789,2652,3137
50,6,113,California,Yolo County,8,16,4018,1793,2225
50,6,113,California,Yolo County,8,17,2895,1244,1651
50,6,113,California,Yolo County,8,18,3435,1254,2181
50,6,113,California,Yolo County,9,0,215569,104828,110741
50,6,113,California,Yolo County,9,1,12394,6342,6052
50,6,113,California,Yolo County,9,2,12908,6574,6334
50,6,113,California,Yolo County,9,3,12936,6522,6414
50,6,113,California,Yolo County,9,4,20722,9857,10865
50,6,113,California,Yolo County,9,5,30547,14561,15986
50,6,113,California,Yolo County,9,6,16043,8208,7835
50,6,113,California,Yolo County,9,7,13609,6887,6722
50,6,113,California,Yolo County,9,8,13356,6593,6763
50,6,113,California,Yolo County,9,9,11639,5796,5843
50,6,113,California,Yolo County,9,10,11838,5795,6043
50,6,113,California,Yolo County,9,11,11857,5775,6082
50,6,113,California,Yolo County,9,12,11829,5684,6145
50,6,113,California,Yolo County,9,13,10494,4932,5562
50,6,113,California,Yolo County,9,14,8793,4118,4675
50,6,113,California,Yolo County,9,15,5987,2727,3260
50,6,113,California,Yolo County,9,16,4142,1905,2237
50,6,113,California,Yolo County,9,17,2962,1239,1723
50,6,113,California,Yolo County,9,18,3513,1313,2200
50,6,113,California,Yolo County,10,0,218470,105979,112491
50,6,113,California,Yolo County,10,1,12344,6301,6043
50,6,113,California,Yolo County,10,2,12762,6453,6309
50,6,113,California,Yolo County,10,3,13216,6704,6512
50,6,113,California,Yolo County,10,4,21442,10152,11290
50,6,113,California,Yolo County,10,5,30844,14557,16287
50,6,113,California,Yolo County,10,6,16407,8384,8023
50,6,113,California,Yolo County,10,7,13578,6922,6656
50,6,113,California,Yolo County,10,8,13547,6642,6905
50,6,113,California,Yolo County,10,9,11868,5947,5921
50,6,113,California,Yolo County,10,10,11807,5734,6073
50,6,113,California,Yolo County,10,11,11715,5727,5988
50,6,113,California,Yolo County,10,12,11885,5749,6136
50,6,113,California,Yolo County,10,13,10691,5031,5660
50,6,113,California,Yolo County,10,14,8869,4120,4749
50,6,113,California,Yolo County,10,15,6532,2981,3551
50,6,113,California,Yolo County,10,16,4372,2006,2366
50,6,113,California,Yolo County,10,17,3021,1263,1758
50,6,113,California,Yolo County,10,18,3570,1306,2264
50,6,113,California,Yolo County,11,0,220082,106665,113417
50,6,113,California,Yolo County,11,1,12172,6216,5956
50,6,113,California,Yolo County,11,2,12818,6474,6344
50,6,113,California,Yolo County,11,3,13259,6734,6525
50,6,113,California,Yolo County,11,4,21754,10248,11506
50,6,113,California,Yolo County,11,5,30728,14501,16227
50,6,113,California,Yolo County,11,6,16481,8312,8169
50,6,113,California,Yolo County,11,7,13606,6962,6644
50,6,113,California,Yolo County,11,8,13865,6817,7048
50,6,113,California,Yolo County,11,9,12057,6063,5994
50,6,113,California,Yolo County,11,10,11732,5756,5976
50,6,113,California,Yolo County,11,11,11601,5669,5932
50,6,113,California,Yolo County,11,12,11785,5694,6091
50,6,113,California,Yolo County,11,13,10909,5123,5786
50,6,113,California,Yolo County,11,14,9044,4180,4864
50,6,113,California,Yolo County,11,15,6955,3175,3780
50,6,113,California,Yolo County,11,16,4670,2150,2520
50,6,113,California,Yolo County,11,17,3102,1281,1821
50,6,113,California,Yolo County,11,18,3544,1310,2234
50,6,113,California,Yolo County,12,0,220019,106598,113421
50,6,113,California,Yolo County,12,1,11639,5865,5774
50,6,113,California,Yolo County,12,2,12812,6520,6292
50,6,113,California,Yolo County,12,3,13206,6687,6519
50,6,113,California,Yolo County,12,4,22126,10421,11705
50,6,113,California,Yolo County,12,5,30407,14303,16104
50,6,113,California,Yolo County,12,6,16220,8247,7973
50,6,113,California,Yolo County,12,7,13504,6947,6557
50,6,113,California,Yolo County,12,8,13964,6847,7117
50,6,113,California,Yolo County,12,9,12240,6117,6123
50,6,113,California,Yolo County,12,10,11595,5740,5855
50,6,113,California,Yolo County,12,11,11449,5625,5824
50,6,113,California,Yolo County,12,12,11573,5569,6004
50,6,113,California,Yolo County,12,13,10943,5158,5785
50,6,113,California,Yolo County,12,14,9346,4326,5020
50,6,113,California,Yolo County,12,15,7304,3320,3984
50,6,113,California,Yolo County,12,16,4893,2245,2648
50,6,113,California,Yolo County,12,17,3200,1323,1877
50,6,113,California,Yolo County,12,18,3598,1338,2260
50,6,113,California,Yolo County,13,0,220010,106590,113420
50,6,113,California,Yolo County,13,1,11393,5772,5621
50,6,113,California,Yolo County,13,2,12733,6459,6274
50,6,113,California,Yolo County,13,3,13146,6676,6470
50,6,113,California,Yolo County,13,4,21860,10282,11578
50,6,113,California,Yolo County,13,5,30335,14296,16039
50,6,113,California,Yolo County,13,6,16029,8115,7914
50,6,113,California,Yolo County,13,7,13731,7094,6637
50,6,113,California,Yolo County,13,8,13835,6786,7049
50,6,113,California,Yolo County,13,9,12515,6208,6307
50,6,113,California,Yolo County,13,10,11442,5719,5723
50,6,113,California,Yolo County,13,11,11485,5584,5901
50,6,113,California,Yolo County,13,12,11497,5559,5938
50,6,113,California,Yolo County,13,13,10977,5194,5783
50,6,113,California,Yolo County,13,14,9450,4353,5097
50,6,113,California,Yolo County,13,15,7620,3482,4138
50,6,113,California,Yolo County,13,16,5018,2264,2754
50,6,113,California,Yolo County,13,17,3284,1360,1924
50,6,113,California,Yolo County,13,18,3660,1387,2273
50,6,113,California,Yolo County,14,0,219728,106447,113281
50,6,113,California,Yolo County,14,1,11297,5733,5564
50,6,113,California,Yolo County,14,2,12683,6427,6256
50,6,113,California,Yolo County,14,3,13119,6670,6449
50,6,113,California,Yolo County,14,4,21726,10214,11512
50,6,113,California,Yolo County,14,5,30246,14260,15986
50,6,113,California,Yolo County,14,6,15930,8054,7876
50,6,113,California,Yolo County,14,7,13802,7138,6664
50,6,113,California,Yolo County,14,8,13805,6774,7031
50,6,113,California,Yolo County,14,9,12607,6237,6370
50,6,113,California,Yolo County,14,10,11390,5713,5677
50,6,113,California,Yolo County,14,11,11507,5572,5935
50,6,113,California,Yolo County,14,12,11465,5551,5914
50,6,113,California,Yolo County,14,13,10971,5198,5773
50,6,113,California,Yolo County,14,14,9481,4360,5121
50,6,113,California,Yolo County,14,15,7704,3525,4179
50,6,113,California,Yolo County,14,16,5043,2263,2780
50,6,113,California,Yolo County,14,17,3302,1368,1934
50,6,113,California,Yolo County,14,18,3650,1390,2260
50,6,115,California,Yuba County,1,0,72155,36352,35803
50,6,115,California,Yuba County,1,1,6217,3216,3001
50,6,115,California,Yuba County,1,2,5872,3086,2786
50,6,115,California,Yuba County,1,3,5547,2823,2724
50,6,115,California,Yuba County,1,4,5466,2820,2646
50,6,115,California,Yuba County,1,5,5395,2780,2615
50,6,115,California,Yuba County,1,6,5380,2704,2676
50,6,115,California,Yuba County,1,7,5033,2543,2490
50,6,115,California,Yuba County,1,8,4389,2202,2187
50,6,115,California,Yuba County,1,9,4486,2303,2183
50,6,115,California,Yuba County,1,10,4770,2432,2338
50,6,115,California,Yuba County,1,11,4778,2350,2428
50,6,115,California,Yuba County,1,12,4120,2069,2051
50,6,115,California,Yuba County,1,13,3447,1695,1752
50,6,115,California,Yuba County,1,14,2349,1118,1231
50,6,115,California,Yuba County,1,15,1832,848,984
50,6,115,California,Yuba County,1,16,1366,695,671
50,6,115,California,Yuba County,1,17,945,364,581
50,6,115,California,Yuba County,1,18,763,304,459
50,6,115,California,Yuba County,2,0,72142,36347,35795
50,6,115,California,Yuba County,2,1,6216,3216,3000
50,6,115,California,Yuba County,2,2,5872,3086,2786
50,6,115,California,Yuba County,2,3,5545,2823,2722
50,6,115,California,Yuba County,2,4,5465,2820,2645
50,6,115,California,Yuba County,2,5,5393,2780,2613
50,6,115,California,Yuba County,2,6,5380,2704,2676
50,6,115,California,Yuba County,2,7,5033,2543,2490
50,6,115,California,Yuba County,2,8,4389,2202,2187
50,6,115,California,Yuba County,2,9,4486,2303,2183
50,6,115,California,Yuba County,2,10,4768,2430,2338
50,6,115,California,Yuba County,2,11,4774,2348,2426
50,6,115,California,Yuba County,2,12,4120,2069,2051
50,6,115,California,Yuba County,2,13,3446,1694,1752
50,6,115,California,Yuba County,2,14,2349,1118,1231
50,6,115,California,Yuba County,2,15,1832,848,984
50,6,115,California,Yuba County,2,16,1366,695,671
50,6,115,California,Yuba County,2,17,945,364,581
50,6,115,California,Yuba County,2,18,763,304,459
50,6,115,California,Yuba County,3,0,72345,36457,35888
50,6,115,California,Yuba County,3,1,6192,3203,2989
50,6,115,California,Yuba County,3,2,5883,3079,2804
50,6,115,California,Yuba County,3,3,5538,2833,2705
50,6,115,California,Yuba County,3,4,5427,2807,2620
50,6,115,California,Yuba County,3,5,5434,2805,2629
50,6,115,California,Yuba County,3,6,5424,2726,2698
50,6,115,California,Yuba County,3,7,5054,2560,2494
50,6,115,California,Yuba County,3,8,4399,2208,2191
50,6,115,California,Yuba County,3,9,4469,2294,2175
50,6,115,California,Yuba County,3,10,4755,2427,2328
50,6,115,California,Yuba County,3,11,4791,2354,2437
50,6,115,California,Yuba County,3,12,4163,2085,2078
50,6,115,California,Yuba County,3,13,3511,1731,1780
50,6,115,California,Yuba County,3,14,2361,1118,1243
50,6,115,California,Yuba County,3,15,1847,857,990
50,6,115,California,Yuba County,3,16,1364,689,675
50,6,115,California,Yuba County,3,17,959,378,581
50,6,115,California,Yuba County,3,18,774,303,471
50,6,115,California,Yuba County,4,0,72480,36529,35951
50,6,115,California,Yuba County,4,1,6123,3194,2929
50,6,115,California,Yuba County,4,2,5917,3050,2867
50,6,115,California,Yuba County,4,3,5525,2894,2631
50,6,115,California,Yuba County,4,4,5266,2699,2567
50,6,115,California,Yuba County,4,5,5512,2840,2672
50,6,115,California,Yuba County,4,6,5524,2802,2722
50,6,115,California,Yuba County,4,7,5149,2570,2579
50,6,115,California,Yuba County,4,8,4317,2179,2138
50,6,115,California,Yuba County,4,9,4328,2221,2107
50,6,115,California,Yuba County,4,10,4578,2339,2239
50,6,115,California,Yuba County,4,11,4787,2335,2452
50,6,115,California,Yuba County,4,12,4310,2138,2172
50,6,115,California,Yuba County,4,13,3713,1846,1867
50,6,115,California,Yuba County,4,14,2400,1133,1267
50,6,115,California,Yuba County,4,15,1895,900,995
50,6,115,California,Yuba County,4,16,1372,668,704
50,6,115,California,Yuba County,4,17,962,408,554
50,6,115,California,Yuba County,4,18,802,313,489
50,6,115,California,Yuba County,5,0,72770,36745,36025
50,6,115,California,Yuba County,5,1,6161,3187,2974
50,6,115,California,Yuba County,5,2,5901,3047,2854
50,6,115,California,Yuba County,5,3,5466,2829,2637
50,6,115,California,Yuba County,5,4,5134,2662,2472
50,6,115,California,Yuba County,5,5,5694,2998,2696
50,6,115,California,Yuba County,5,6,5720,2932,2788
50,6,115,California,Yuba County,5,7,5161,2559,2602
50,6,115,California,Yuba County,5,8,4345,2194,2151
50,6,115,California,Yuba County,5,9,4244,2185,2059
50,6,115,California,Yuba County,5,10,4370,2210,2160
50,6,115,California,Yuba County,5,11,4716,2301,2415
50,6,115,California,Yuba County,5,12,4434,2199,2235
50,6,115,California,Yuba County,5,13,3672,1834,1838
50,6,115,California,Yuba County,5,14,2659,1265,1394
50,6,115,California,Yuba County,5,15,1929,944,985
50,6,115,California,Yuba County,5,16,1380,656,724
50,6,115,California,Yuba County,5,17,930,411,519
50,6,115,California,Yuba County,5,18,854,332,522
50,6,115,California,Yuba County,6,0,73082,36916,36166
50,6,115,California,Yuba County,6,1,6137,3158,2979
50,6,115,California,Yuba County,6,2,5895,3019,2876
50,6,115,California,Yuba County,6,3,5406,2830,2576
50,6,115,California,Yuba County,6,4,5064,2597,2467
50,6,115,California,Yuba County,6,5,5742,3087,2655
50,6,115,California,Yuba County,6,6,5821,2965,2856
50,6,115,California,Yuba County,6,7,5312,2647,2665
50,6,115,California,Yuba County,6,8,4448,2234,2214
50,6,115,California,Yuba County,6,9,4219,2126,2093
50,6,115,California,Yuba County,6,10,4209,2171,2038
50,6,115,California,Yuba County,6,11,4627,2265,2362
50,6,115,California,Yuba County,6,12,4463,2181,2282
50,6,115,California,Yuba County,6,13,3705,1879,1826
50,6,115,California,Yuba County,6,14,2846,1364,1482
50,6,115,California,Yuba County,6,15,2013,991,1022
50,6,115,California,Yuba County,6,16,1408,639,769
50,6,115,California,Yuba County,6,17,929,430,499
50,6,115,California,Yuba County,6,18,838,333,505
50,6,115,California,Yuba County,7,0,73527,37253,36274
50,6,115,California,Yuba County,7,1,6115,3104,3011
50,6,115,California,Yuba County,7,2,5919,3044,2875
50,6,115,California,Yuba County,7,3,5363,2820,2543
50,6,115,California,Yuba County,7,4,4966,2551,2415
50,6,115,California,Yuba County,7,5,5818,3205,2613
50,6,115,California,Yuba County,7,6,6007,3047,2960
50,6,115,California,Yuba County,7,7,5372,2713,2659
50,6,115,California,Yuba County,7,8,4574,2331,2243
50,6,115,California,Yuba County,7,9,4076,2056,2020
50,6,115,California,Yuba County,7,10,4115,2084,2031
50,6,115,California,Yuba County,7,11,4550,2264,2286
50,6,115,California,Yuba County,7,12,4454,2199,2255
50,6,115,California,Yuba County,7,13,3857,1943,1914
50,6,115,California,Yuba County,7,14,3034,1460,1574
50,6,115,California,Yuba County,7,15,2085,1006,1079
50,6,115,California,Yuba County,7,16,1435,659,776
50,6,115,California,Yuba County,7,17,942,444,498
50,6,115,California,Yuba County,7,18,845,323,522
50,6,115,California,Yuba County,8,0,74039,37513,36526
50,6,115,California,Yuba County,8,1,6128,3115,3013
50,6,115,California,Yuba County,8,2,5909,3017,2892
50,6,115,California,Yuba County,8,3,5443,2821,2622
50,6,115,California,Yuba County,8,4,4892,2564,2328
50,6,115,California,Yuba County,8,5,5720,3161,2559
50,6,115,California,Yuba County,8,6,6025,3090,2935
50,6,115,California,Yuba County,8,7,5448,2771,2677
50,6,115,California,Yuba County,8,8,4765,2422,2343
50,6,115,California,Yuba County,8,9,4078,2033,2045
50,6,115,California,Yuba County,8,10,4029,2025,2004
50,6,115,California,Yuba County,8,11,4420,2241,2179
50,6,115,California,Yuba County,8,12,4460,2169,2291
50,6,115,California,Yuba County,8,13,4011,2000,2011
50,6,115,California,Yuba County,8,14,3261,1606,1655
50,6,115,California,Yuba County,8,15,2137,998,1139
50,6,115,California,Yuba County,8,16,1497,702,795
50,6,115,California,Yuba County,8,17,957,455,502
50,6,115,California,Yuba County,8,18,859,323,536
50,6,115,California,Yuba County,9,0,74920,37951,36969
50,6,115,California,Yuba County,9,1,6011,3054,2957
50,6,115,California,Yuba County,9,2,5896,2995,2901
50,6,115,California,Yuba County,9,3,5543,2858,2685
50,6,115,California,Yuba County,9,4,4968,2663,2305
50,6,115,California,Yuba County,9,5,5728,3179,2549
50,6,115,California,Yuba County,9,6,6051,3104,2947
50,6,115,California,Yuba County,9,7,5618,2857,2761
50,6,115,California,Yuba County,9,8,4913,2499,2414
50,6,115,California,Yuba County,9,9,4095,2037,2058
50,6,115,California,Yuba County,9,10,4093,2018,2075
50,6,115,California,Yuba County,9,11,4308,2197,2111
50,6,115,California,Yuba County,9,12,4463,2194,2269
50,6,115,California,Yuba County,9,13,4132,2027,2105
50,6,115,California,Yuba County,9,14,3509,1734,1775
50,6,115,California,Yuba County,9,15,2152,1001,1151
50,6,115,California,Yuba County,9,16,1549,727,822
50,6,115,California,Yuba County,9,17,1015,475,540
50,6,115,California,Yuba County,9,18,876,332,544
50,6,115,California,Yuba County,10,0,76575,38781,37794
50,6,115,California,Yuba County,10,1,6139,3149,2990
50,6,115,California,Yuba County,10,2,6106,3071,3035
50,6,115,California,Yuba County,10,3,5730,2986,2744
50,6,115,California,Yuba County,10,4,5057,2686,2371
50,6,115,California,Yuba County,10,5,5603,3146,2457
50,6,115,California,Yuba County,10,6,6188,3146,3042
50,6,115,California,Yuba County,10,7,5839,2973,2866
50,6,115,California,Yuba County,10,8,5199,2600,2599
50,6,115,California,Yuba County,10,9,4169,2118,2051
50,6,115,California,Yuba County,10,10,4096,2027,2069
50,6,115,California,Yuba County,10,11,4251,2157,2094
50,6,115,California,Yuba County,10,12,4526,2205,2321
50,6,115,California,Yuba County,10,13,4201,2075,2126
50,6,115,California,Yuba County,10,14,3513,1727,1786
50,6,115,California,Yuba County,10,15,2406,1099,1307
50,6,115,California,Yuba County,10,16,1628,790,838
50,6,115,California,Yuba County,10,17,1019,460,559
50,6,115,California,Yuba County,10,18,905,366,539
50,6,115,California,Yuba County,11,0,77418,39213,38205
50,6,115,California,Yuba County,11,1,6081,3179,2902
50,6,115,California,Yuba County,11,2,6262,3150,3112
50,6,115,California,Yuba County,11,3,5887,3031,2856
50,6,115,California,Yuba County,11,4,5096,2711,2385
50,6,115,California,Yuba County,11,5,5465,3038,2427
50,6,115,California,Yuba County,11,6,6197,3191,3006
50,6,115,California,Yuba County,11,7,5968,3010,2958
50,6,115,California,Yuba County,11,8,5382,2689,2693
50,6,115,California,Yuba County,11,9,4342,2199,2143
50,6,115,California,Yuba County,11,10,4052,1962,2090
50,6,115,California,Yuba County,11,11,4169,2161,2008
50,6,115,California,Yuba County,11,12,4545,2232,2313
50,6,115,California,Yuba County,11,13,4246,2072,2174
50,6,115,California,Yuba County,11,14,3565,1750,1815
50,6,115,California,Yuba County,11,15,2537,1195,1342
50,6,115,California,Yuba County,11,16,1681,814,867
50,6,115,California,Yuba County,11,17,1030,441,589
50,6,115,California,Yuba County,11,18,913,388,525
50,6,115,California,Yuba County,12,0,78549,39782,38767
50,6,115,California,Yuba County,12,1,6093,3164,2929
50,6,115,California,Yuba County,12,2,6256,3132,3124
50,6,115,California,Yuba County,12,3,5955,3046,2909
50,6,115,California,Yuba County,12,4,5183,2760,2423
50,6,115,California,Yuba County,12,5,5429,2997,2432
50,6,115,California,Yuba County,12,6,6218,3257,2961
50,6,115,California,Yuba County,12,7,6048,3033,3015
50,6,115,California,Yuba County,12,8,5571,2834,2737
50,6,115,California,Yuba County,12,9,4519,2296,2223
50,6,115,California,Yuba County,12,10,3995,1953,2042
50,6,115,California,Yuba County,12,11,4155,2113,2042
50,6,115,California,Yuba County,12,12,4534,2248,2286
50,6,115,California,Yuba County,12,13,4365,2116,2249
50,6,115,California,Yuba County,12,14,3692,1827,1865
50,6,115,California,Yuba County,12,15,2758,1298,1460
50,6,115,California,Yuba County,12,16,1759,829,930
50,6,115,California,Yuba County,12,17,1069,468,601
50,6,115,California,Yuba County,12,18,950,411,539
50,6,115,California,Yuba County,13,0,79800,40393,39407
50,6,115,California,Yuba County,13,1,6145,3159,2986
50,6,115,California,Yuba County,13,2,6388,3255,3133
50,6,115,California,Yuba County,13,3,5998,3054,2944
50,6,115,California,Yuba County,13,4,5235,2776,2459
50,6,115,California,Yuba County,13,5,5436,2998,2438
50,6,115,California,Yuba County,13,6,6267,3281,2986
50,6,115,California,Yuba County,13,7,6308,3159,3149
50,6,115,California,Yuba County,13,8,5581,2863,2718
50,6,115,California,Yuba County,13,9,4802,2415,2387
50,6,115,California,Yuba County,13,10,4012,1962,2050
50,6,115,California,Yuba County,13,11,4157,2109,2048
50,6,115,California,Yuba County,13,12,4503,2253,2250
50,6,115,California,Yuba County,13,13,4404,2106,2298
50,6,115,California,Yuba County,13,14,3766,1852,1914
50,6,115,California,Yuba County,13,15,2896,1394,1502
50,6,115,California,Yuba County,13,16,1806,830,976
50,6,115,California,Yuba County,13,17,1112,486,626
50,6,115,California,Yuba County,13,18,984,441,543
50,6,115,California,Yuba County,14,0,80160,40569,39591
50,6,115,California,Yuba County,14,1,6163,3158,3005
50,6,115,California,Yuba County,14,2,6421,3291,3130
50,6,115,California,Yuba County,14,3,6013,3058,2955
50,6,115,California,Yuba County,14,4,5242,2776,2466
50,6,115,California,Yuba County,14,5,5435,2989,2446
50,6,115,California,Yuba County,14,6,6278,3287,2991
50,6,115,California,Yuba County,14,7,6389,3196,3193
50,6,115,California,Yuba County,14,8,5590,2877,2713
50,6,115,California,Yuba County,14,9,4897,2454,2443
50,6,115,California,Yuba County,14,10,4014,1963,2051
50,6,115,California,Yuba County,14,11,4170,2116,2054
50,6,115,California,Yuba County,14,12,4492,2256,2236
50,6,115,California,Yuba County,14,13,4410,2100,2310
50,6,115,California,Yuba County,14,14,3784,1860,1924
50,6,115,California,Yuba County,14,15,2940,1424,1516
50,6,115,California,Yuba County,14,16,1813,826,987
50,6,115,California,Yuba County,14,17,1124,492,632
50,6,115,California,Yuba County,14,18,985,446,539
