SUMLEV,STATE,COUNTY,STNAME,CTYNAME,YEAR,AGEGRP,TOT_POP,TOT_MALE,TOT_FEMALE
50,12,1,Florida,Alachua County,1,0,217955,106405,111550
50,12,1,Florida,Alachua County,1,1,11161,5686,5475
50,12,1,Florida,Alachua County,1,2,12089,6281,5808
50,12,1,Florida,Alachua County,1,3,12937,6533,6404
50,12,1,Florida,Alachua County,1,4,22354,10635,11719
50,12,1,Florida,Alachua County,1,5,36011,18015,17996
50,12,1,Florida,Alachua County,1,6,17651,9493,8158
50,12,1,Florida,Alachua County,1,7,13756,7029,6727
50,12,1,Florida,Alachua County,1,8,14299,6982,7317
50,12,1,Florida,Alachua County,1,9,14704,6967,7737
50,12,1,Florida,Alachua County,1,10,14297,6813,7484
50,12,1,Florida,Alachua County,1,11,12384,6110,6274
50,12,1,Florida,Alachua County,1,12,8749,4227,4522
50,12,1,Florida,Alachua County,1,13,6645,3039,3606
50,12,1,Florida,Alachua County,1,14,5646,2641,3005
50,12,1,Florida,Alachua County,1,15,5223,2242,2981
50,12,1,Florida,Alachua County,1,16,4490,1800,2690
50,12,1,Florida,Alachua County,1,17,3059,1200,1859
50,12,1,Florida,Alachua County,1,18,2500,712,1788
50,12,1,Florida,Alachua County,2,0,217955,106405,111550
50,12,1,Florida,Alachua County,2,1,11161,5686,5475
50,12,1,Florida,Alachua County,2,2,12089,6281,5808
50,12,1,Florida,Alachua County,2,3,12937,6533,6404
50,12,1,Florida,Alachua County,2,4,22354,10635,11719
50,12,1,Florida,Alachua County,2,5,36011,18015,17996
50,12,1,Florida,Alachua County,2,6,17651,9493,8158
50,12,1,Florida,Alachua County,2,7,13756,7029,6727
50,12,1,Florida,Alachua County,2,8,14299,6982,7317
50,12,1,Florida,Alachua County,2,9,14704,6967,7737
50,12,1,Florida,Alachua County,2,10,14297,6813,7484
50,12,1,Florida,Alachua County,2,11,12384,6110,6274
50,12,1,Florida,Alachua County,2,12,8749,4227,4522
50,12,1,Florida,Alachua County,2,13,6645,3039,3606
50,12,1,Florida,Alachua County,2,14,5646,2641,3005
50,12,1,Florida,Alachua County,2,15,5223,2242,2981
50,12,1,Florida,Alachua County,2,16,4490,1800,2690
50,12,1,Florida,Alachua County,2,17,3059,1200,1859
50,12,1,Florida,Alachua County,2,18,2500,712,1788
50,12,1,Florida,Alachua County,3,0,218602,106702,111900
50,12,1,Florida,Alachua County,3,1,11128,5667,5461
50,12,1,Florida,Alachua County,3,2,11996,6233,5763
50,12,1,Florida,Alachua County,3,3,12955,6540,6415
50,12,1,Florida,Alachua County,3,4,22553,10719,11834
50,12,1,Florida,Alachua County,3,5,36595,18302,18293
50,12,1,Florida,Alachua County,3,6,17515,9421,8094
50,12,1,Florida,Alachua County,3,7,13727,7015,6712
50,12,1,Florida,Alachua County,3,8,14211,6942,7269
50,12,1,Florida,Alachua County,3,9,14701,6965,7736
50,12,1,Florida,Alachua County,3,10,14337,6833,7504
50,12,1,Florida,Alachua County,3,11,12466,6152,6314
50,12,1,Florida,Alachua County,3,12,8771,4238,4533
50,12,1,Florida,Alachua County,3,13,6647,3041,3606
50,12,1,Florida,Alachua County,3,14,5645,2640,3005
50,12,1,Florida,Alachua County,3,15,5229,2248,2981
50,12,1,Florida,Alachua County,3,16,4515,1812,2703
50,12,1,Florida,Alachua County,3,17,3089,1214,1875
50,12,1,Florida,Alachua County,3,18,2522,720,1802
50,12,1,Florida,Alachua County,4,0,221394,108095,113299
50,12,1,Florida,Alachua County,4,1,11349,5827,5522
50,12,1,Florida,Alachua County,4,2,11514,5960,5554
50,12,1,Florida,Alachua County,4,3,12962,6566,6396
50,12,1,Florida,Alachua County,4,4,23807,11313,12494
50,12,1,Florida,Alachua County,4,5,39220,19414,19806
50,12,1,Florida,Alachua County,4,6,15961,8691,7270
50,12,1,Florida,Alachua County,4,7,13997,7303,6694
50,12,1,Florida,Alachua County,4,8,13584,6670,6914
50,12,1,Florida,Alachua County,4,9,14607,7006,7601
50,12,1,Florida,Alachua County,4,10,14222,6704,7518
50,12,1,Florida,Alachua County,4,11,13060,6364,6696
50,12,1,Florida,Alachua County,4,12,9129,4440,4689
50,12,1,Florida,Alachua County,4,13,6824,3131,3693
50,12,1,Florida,Alachua County,4,14,5639,2607,3032
50,12,1,Florida,Alachua County,4,15,5200,2280,2920
50,12,1,Florida,Alachua County,4,16,4489,1806,2683
50,12,1,Florida,Alachua County,4,17,3234,1242,1992
50,12,1,Florida,Alachua County,4,18,2596,771,1825
50,12,1,Florida,Alachua County,5,0,223994,109336,114658
50,12,1,Florida,Alachua County,5,1,11607,5940,5667
50,12,1,Florida,Alachua County,5,2,11271,5840,5431
50,12,1,Florida,Alachua County,5,3,12813,6513,6300
50,12,1,Florida,Alachua County,5,4,24477,11691,12786
50,12,1,Florida,Alachua County,5,5,41368,20340,21028
50,12,1,Florida,Alachua County,5,6,14645,8011,6634
50,12,1,Florida,Alachua County,5,7,14257,7516,6741
50,12,1,Florida,Alachua County,5,8,13026,6372,6654
50,12,1,Florida,Alachua County,5,9,14433,6998,7435
50,12,1,Florida,Alachua County,5,10,14372,6720,7652
50,12,1,Florida,Alachua County,5,11,13273,6399,6874
50,12,1,Florida,Alachua County,5,12,9933,4880,5053
50,12,1,Florida,Alachua County,5,13,7082,3265,3817
50,12,1,Florida,Alachua County,5,14,5647,2635,3012
50,12,1,Florida,Alachua County,5,15,5105,2238,2867
50,12,1,Florida,Alachua County,5,16,4559,1826,2733
50,12,1,Florida,Alachua County,5,17,3369,1308,2061
50,12,1,Florida,Alachua County,5,18,2757,844,1913
50,12,1,Florida,Alachua County,6,0,225862,110390,115472
50,12,1,Florida,Alachua County,6,1,11740,6077,5663
50,12,1,Florida,Alachua County,6,2,11060,5689,5371
50,12,1,Florida,Alachua County,6,3,12604,6492,6112
50,12,1,Florida,Alachua County,6,4,24421,11579,12842
50,12,1,Florida,Alachua County,6,5,43829,21757,22072
50,12,1,Florida,Alachua County,6,6,13262,7182,6080
50,12,1,Florida,Alachua County,6,7,14238,7533,6705
50,12,1,Florida,Alachua County,6,8,12737,6321,6416
50,12,1,Florida,Alachua County,6,9,14061,6829,7232
50,12,1,Florida,Alachua County,6,10,14469,6789,7680
50,12,1,Florida,Alachua County,6,11,13600,6480,7120
50,12,1,Florida,Alachua County,6,12,10476,5132,5344
50,12,1,Florida,Alachua County,6,13,7577,3546,4031
50,12,1,Florida,Alachua County,6,14,5656,2615,3041
50,12,1,Florida,Alachua County,6,15,5116,2304,2812
50,12,1,Florida,Alachua County,6,16,4605,1843,2762
50,12,1,Florida,Alachua County,6,17,3488,1317,2171
50,12,1,Florida,Alachua County,6,18,2923,905,2018
50,12,1,Florida,Alachua County,7,0,228346,111702,116644
50,12,1,Florida,Alachua County,7,1,12158,6270,5888
50,12,1,Florida,Alachua County,7,2,10896,5651,5245
50,12,1,Florida,Alachua County,7,3,12204,6300,5904
50,12,1,Florida,Alachua County,7,4,24655,11690,12965
50,12,1,Florida,Alachua County,7,5,46528,23185,23343
50,12,1,Florida,Alachua County,7,6,11311,6045,5266
50,12,1,Florida,Alachua County,7,7,14589,7867,6722
50,12,1,Florida,Alachua County,7,8,12517,6267,6250
50,12,1,Florida,Alachua County,7,9,14019,6821,7198
50,12,1,Florida,Alachua County,7,10,14420,6789,7631
50,12,1,Florida,Alachua County,7,11,13791,6462,7329
50,12,1,Florida,Alachua County,7,12,11149,5483,5666
50,12,1,Florida,Alachua County,7,13,7887,3706,4181
50,12,1,Florida,Alachua County,7,14,5904,2691,3213
50,12,1,Florida,Alachua County,7,15,5009,2273,2736
50,12,1,Florida,Alachua County,7,16,4646,1904,2742
50,12,1,Florida,Alachua County,7,17,3594,1319,2275
50,12,1,Florida,Alachua County,7,18,3069,979,2090
50,12,1,Florida,Alachua County,8,0,231849,113493,118356
50,12,1,Florida,Alachua County,8,1,12693,6538,6155
50,12,1,Florida,Alachua County,8,2,11096,5671,5425
50,12,1,Florida,Alachua County,8,3,11888,6201,5687
50,12,1,Florida,Alachua County,8,4,24858,11786,13072
50,12,1,Florida,Alachua County,8,5,48797,24228,24569
50,12,1,Florida,Alachua County,8,6,9569,5141,4428
50,12,1,Florida,Alachua County,8,7,15127,8236,6891
50,12,1,Florida,Alachua County,8,8,12511,6349,6162
50,12,1,Florida,Alachua County,8,9,13808,6722,7086
50,12,1,Florida,Alachua County,8,10,14426,6782,7644
50,12,1,Florida,Alachua County,8,11,14050,6611,7439
50,12,1,Florida,Alachua County,8,12,11960,5836,6124
50,12,1,Florida,Alachua County,8,13,8196,3902,4294
50,12,1,Florida,Alachua County,8,14,6127,2776,3351
50,12,1,Florida,Alachua County,8,15,5040,2301,2739
50,12,1,Florida,Alachua County,8,16,4664,1929,2735
50,12,1,Florida,Alachua County,8,17,3744,1404,2340
50,12,1,Florida,Alachua County,8,18,3295,1080,2215
50,12,1,Florida,Alachua County,9,0,237199,116171,121028
50,12,1,Florida,Alachua County,9,1,13031,6671,6360
50,12,1,Florida,Alachua County,9,2,11606,5973,5633
50,12,1,Florida,Alachua County,9,3,11668,6065,5603
50,12,1,Florida,Alachua County,9,4,25018,11903,13115
50,12,1,Florida,Alachua County,9,5,50964,25219,25745
50,12,1,Florida,Alachua County,9,6,10614,5557,5057
50,12,1,Florida,Alachua County,9,7,13856,7656,6200
50,12,1,Florida,Alachua County,9,8,13012,6759,6253
50,12,1,Florida,Alachua County,9,9,13413,6564,6849
50,12,1,Florida,Alachua County,9,10,14642,6967,7675
50,12,1,Florida,Alachua County,9,11,14183,6605,7578
50,12,1,Florida,Alachua County,9,12,12703,6127,6576
50,12,1,Florida,Alachua County,9,13,8677,4169,4508
50,12,1,Florida,Alachua County,9,14,6478,2932,3546
50,12,1,Florida,Alachua County,9,15,5210,2365,2845
50,12,1,Florida,Alachua County,9,16,4750,2007,2743
50,12,1,Florida,Alachua County,9,17,3776,1461,2315
50,12,1,Florida,Alachua County,9,18,3598,1171,2427
50,12,1,Florida,Alachua County,10,0,240196,117675,122521
50,12,1,Florida,Alachua County,10,1,13335,6792,6543
50,12,1,Florida,Alachua County,10,2,11829,6064,5765
50,12,1,Florida,Alachua County,10,3,11489,5978,5511
50,12,1,Florida,Alachua County,10,4,24894,11864,13030
50,12,1,Florida,Alachua County,10,5,51450,25577,25873
50,12,1,Florida,Alachua County,10,6,12772,6472,6300
50,12,1,Florida,Alachua County,10,7,12497,6977,5520
50,12,1,Florida,Alachua County,10,8,13342,7017,6325
50,12,1,Florida,Alachua County,10,9,12939,6329,6610
50,12,1,Florida,Alachua County,10,10,14515,6984,7531
50,12,1,Florida,Alachua County,10,11,14312,6608,7704
50,12,1,Florida,Alachua County,10,12,12974,6194,6780
50,12,1,Florida,Alachua County,10,13,9462,4597,4865
50,12,1,Florida,Alachua County,10,14,6689,3028,3661
50,12,1,Florida,Alachua County,10,15,5270,2418,2852
50,12,1,Florida,Alachua County,10,16,4683,1988,2695
50,12,1,Florida,Alachua County,10,17,3977,1546,2431
50,12,1,Florida,Alachua County,10,18,3767,1242,2525
50,12,1,Florida,Alachua County,11,0,242133,118557,123576
50,12,1,Florida,Alachua County,11,1,13608,6892,6716
50,12,1,Florida,Alachua County,11,2,11977,6205,5772
50,12,1,Florida,Alachua County,11,3,11209,5795,5414
50,12,1,Florida,Alachua County,11,4,24846,11892,12954
50,12,1,Florida,Alachua County,11,5,51186,25321,25865
50,12,1,Florida,Alachua County,11,6,15225,7816,7409
50,12,1,Florida,Alachua County,11,7,10877,6002,4875
50,12,1,Florida,Alachua County,11,8,13340,7031,6309
50,12,1,Florida,Alachua County,11,9,12653,6278,6375
50,12,1,Florida,Alachua County,11,10,14245,6870,7375
50,12,1,Florida,Alachua County,11,11,14404,6682,7722
50,12,1,Florida,Alachua County,11,12,13231,6246,6985
50,12,1,Florida,Alachua County,11,13,9995,4846,5149
50,12,1,Florida,Alachua County,11,14,7168,3293,3875
50,12,1,Florida,Alachua County,11,15,5340,2418,2922
50,12,1,Florida,Alachua County,11,16,4748,2071,2677
50,12,1,Florida,Alachua County,11,17,4095,1606,2489
50,12,1,Florida,Alachua County,11,18,3986,1293,2693
50,12,1,Florida,Alachua County,12,0,243574,119274,124300
50,12,1,Florida,Alachua County,12,1,13815,6969,6846
50,12,1,Florida,Alachua County,12,2,12160,6276,5884
50,12,1,Florida,Alachua County,12,3,11005,5733,5272
50,12,1,Florida,Alachua County,12,4,24584,11759,12825
50,12,1,Florida,Alachua County,12,5,51348,25384,25964
50,12,1,Florida,Alachua County,12,6,17822,9099,8723
50,12,1,Florida,Alachua County,12,7,8660,4750,3910
50,12,1,Florida,Alachua County,12,8,13440,7243,6197
50,12,1,Florida,Alachua County,12,9,12290,6167,6123
50,12,1,Florida,Alachua County,12,10,14065,6795,7270
50,12,1,Florida,Alachua County,12,11,14278,6662,7616
50,12,1,Florida,Alachua County,12,12,13394,6220,7174
50,12,1,Florida,Alachua County,12,13,10549,5140,5409
50,12,1,Florida,Alachua County,12,14,7542,3503,4039
50,12,1,Florida,Alachua County,12,15,5600,2506,3094
50,12,1,Florida,Alachua County,12,16,4681,2057,2624
50,12,1,Florida,Alachua County,12,17,4118,1641,2477
50,12,1,Florida,Alachua County,12,18,4223,1370,2853
50,12,3,Florida,Baker County,1,0,22259,11688,10571
50,12,3,Florida,Baker County,1,1,1561,768,793
50,12,3,Florida,Baker County,1,2,1615,858,757
50,12,3,Florida,Baker County,1,3,1834,929,905
50,12,3,Florida,Baker County,1,4,1824,951,873
50,12,3,Florida,Baker County,1,5,1490,874,616
50,12,3,Florida,Baker County,1,6,1511,833,678
50,12,3,Florida,Baker County,1,7,1635,930,705
50,12,3,Florida,Baker County,1,8,1887,1030,857
50,12,3,Florida,Baker County,1,9,1805,973,832
50,12,3,Florida,Baker County,1,10,1640,893,747
50,12,3,Florida,Baker County,1,11,1428,755,673
50,12,3,Florida,Baker County,1,12,1080,551,529
50,12,3,Florida,Baker County,1,13,899,462,437
50,12,3,Florida,Baker County,1,14,721,355,366
50,12,3,Florida,Baker County,1,15,567,267,300
50,12,3,Florida,Baker County,1,16,343,142,201
50,12,3,Florida,Baker County,1,17,236,64,172
50,12,3,Florida,Baker County,1,18,183,53,130
50,12,3,Florida,Baker County,2,0,22259,11688,10571
50,12,3,Florida,Baker County,2,1,1561,768,793
50,12,3,Florida,Baker County,2,2,1615,858,757
50,12,3,Florida,Baker County,2,3,1834,929,905
50,12,3,Florida,Baker County,2,4,1824,951,873
50,12,3,Florida,Baker County,2,5,1490,874,616
50,12,3,Florida,Baker County,2,6,1511,833,678
50,12,3,Florida,Baker County,2,7,1635,930,705
50,12,3,Florida,Baker County,2,8,1887,1030,857
50,12,3,Florida,Baker County,2,9,1805,973,832
50,12,3,Florida,Baker County,2,10,1640,893,747
50,12,3,Florida,Baker County,2,11,1428,755,673
50,12,3,Florida,Baker County,2,12,1080,551,529
50,12,3,Florida,Baker County,2,13,899,462,437
50,12,3,Florida,Baker County,2,14,721,355,366
50,12,3,Florida,Baker County,2,15,567,267,300
50,12,3,Florida,Baker County,2,16,343,142,201
50,12,3,Florida,Baker County,2,17,236,64,172
50,12,3,Florida,Baker County,2,18,183,53,130
50,12,3,Florida,Baker County,3,0,22373,11745,10628
50,12,3,Florida,Baker County,3,1,1569,772,797
50,12,3,Florida,Baker County,3,2,1615,858,757
50,12,3,Florida,Baker County,3,3,1848,937,911
50,12,3,Florida,Baker County,3,4,1837,959,878
50,12,3,Florida,Baker County,3,5,1508,885,623
50,12,3,Florida,Baker County,3,6,1505,830,675
50,12,3,Florida,Baker County,3,7,1638,931,707
50,12,3,Florida,Baker County,3,8,1888,1031,857
50,12,3,Florida,Baker County,3,9,1816,977,839
50,12,3,Florida,Baker County,3,10,1654,899,755
50,12,3,Florida,Baker County,3,11,1446,763,683
50,12,3,Florida,Baker County,3,12,1087,554,533
50,12,3,Florida,Baker County,3,13,906,466,440
50,12,3,Florida,Baker County,3,14,722,356,366
50,12,3,Florida,Baker County,3,15,567,267,300
50,12,3,Florida,Baker County,3,16,344,142,202
50,12,3,Florida,Baker County,3,17,238,64,174
50,12,3,Florida,Baker County,3,18,185,54,131
50,12,3,Florida,Baker County,4,0,22533,11812,10721
50,12,3,Florida,Baker County,4,1,1610,783,827
50,12,3,Florida,Baker County,4,2,1561,822,739
50,12,3,Florida,Baker County,4,3,1779,904,875
50,12,3,Florida,Baker County,4,4,1806,964,842
50,12,3,Florida,Baker County,4,5,1618,913,705
50,12,3,Florida,Baker County,4,6,1454,808,646
50,12,3,Florida,Baker County,4,7,1639,944,695
50,12,3,Florida,Baker County,4,8,1828,1001,827
50,12,3,Florida,Baker County,4,9,1880,1011,869
50,12,3,Florida,Baker County,4,10,1706,915,791
50,12,3,Florida,Baker County,4,11,1482,792,690
50,12,3,Florida,Baker County,4,12,1143,574,569
50,12,3,Florida,Baker County,4,13,922,468,454
50,12,3,Florida,Baker County,4,14,745,377,368
50,12,3,Florida,Baker County,4,15,540,245,295
50,12,3,Florida,Baker County,4,16,386,172,214
50,12,3,Florida,Baker County,4,17,246,64,182
50,12,3,Florida,Baker County,4,18,188,55,133
50,12,3,Florida,Baker County,5,0,23143,12137,11006
50,12,3,Florida,Baker County,5,1,1736,853,883
50,12,3,Florida,Baker County,5,2,1579,824,755
50,12,3,Florida,Baker County,5,3,1740,903,837
50,12,3,Florida,Baker County,5,4,1830,982,848
50,12,3,Florida,Baker County,5,5,1737,956,781
50,12,3,Florida,Baker County,5,6,1492,847,645
50,12,3,Florida,Baker County,5,7,1724,968,756
50,12,3,Florida,Baker County,5,8,1757,973,784
50,12,3,Florida,Baker County,5,9,1926,1044,882
50,12,3,Florida,Baker County,5,10,1728,919,809
50,12,3,Florida,Baker County,5,11,1539,810,729
50,12,3,Florida,Baker County,5,12,1224,638,586
50,12,3,Florida,Baker County,5,13,955,465,490
50,12,3,Florida,Baker County,5,14,767,377,390
50,12,3,Florida,Baker County,5,15,541,267,274
50,12,3,Florida,Baker County,5,16,430,183,247
50,12,3,Florida,Baker County,5,17,243,71,172
50,12,3,Florida,Baker County,5,18,195,57,138
50,12,3,Florida,Baker County,6,0,23285,12264,11021
50,12,3,Florida,Baker County,6,1,1757,883,874
50,12,3,Florida,Baker County,6,2,1505,786,719
50,12,3,Florida,Baker County,6,3,1775,924,851
50,12,3,Florida,Baker County,6,4,1755,938,817
50,12,3,Florida,Baker County,6,5,1708,971,737
50,12,3,Florida,Baker County,6,6,1540,858,682
50,12,3,Florida,Baker County,6,7,1706,953,753
50,12,3,Florida,Baker County,6,8,1766,1003,763
50,12,3,Florida,Baker County,6,9,1931,1039,892
50,12,3,Florida,Baker County,6,10,1763,956,807
50,12,3,Florida,Baker County,6,11,1562,808,754
50,12,3,Florida,Baker County,6,12,1304,684,620
50,12,3,Florida,Baker County,6,13,974,472,502
50,12,3,Florida,Baker County,6,14,801,403,398
50,12,3,Florida,Baker County,6,15,531,265,266
50,12,3,Florida,Baker County,6,16,443,183,260
50,12,3,Florida,Baker County,6,17,255,80,175
50,12,3,Florida,Baker County,6,18,209,58,151
50,12,3,Florida,Baker County,7,0,23789,12536,11253
50,12,3,Florida,Baker County,7,1,1823,924,899
50,12,3,Florida,Baker County,7,2,1534,767,767
50,12,3,Florida,Baker County,7,3,1730,921,809
50,12,3,Florida,Baker County,7,4,1806,958,848
50,12,3,Florida,Baker County,7,5,1802,1025,777
50,12,3,Florida,Baker County,7,6,1543,870,673
50,12,3,Florida,Baker County,7,7,1745,984,761
50,12,3,Florida,Baker County,7,8,1782,1014,768
50,12,3,Florida,Baker County,7,9,1980,1066,914
50,12,3,Florida,Baker County,7,10,1759,963,796
50,12,3,Florida,Baker County,7,11,1625,830,795
50,12,3,Florida,Baker County,7,12,1329,688,641
50,12,3,Florida,Baker County,7,13,1025,499,526
50,12,3,Florida,Baker County,7,14,793,408,385
50,12,3,Florida,Baker County,7,15,599,289,310
50,12,3,Florida,Baker County,7,16,434,186,248
50,12,3,Florida,Baker County,7,17,274,90,184
50,12,3,Florida,Baker County,7,18,206,54,152
50,12,3,Florida,Baker County,8,0,24382,12834,11548
50,12,3,Florida,Baker County,8,1,1879,961,918
50,12,3,Florida,Baker County,8,2,1648,813,835
50,12,3,Florida,Baker County,8,3,1684,892,792
50,12,3,Florida,Baker County,8,4,1808,965,843
50,12,3,Florida,Baker County,8,5,1830,1019,811
50,12,3,Florida,Baker County,8,6,1688,973,715
50,12,3,Florida,Baker County,8,7,1704,967,737
50,12,3,Florida,Baker County,8,8,1789,1009,780
50,12,3,Florida,Baker County,8,9,1956,1066,890
50,12,3,Florida,Baker County,8,10,1894,1003,891
50,12,3,Florida,Baker County,8,11,1628,852,776
50,12,3,Florida,Baker County,8,12,1434,725,709
50,12,3,Florida,Baker County,8,13,1028,509,519
50,12,3,Florida,Baker County,8,14,833,431,402
50,12,3,Florida,Baker County,8,15,614,294,320
50,12,3,Florida,Baker County,8,16,454,194,260
50,12,3,Florida,Baker County,8,17,284,101,183
50,12,3,Florida,Baker County,8,18,227,60,167
50,12,3,Florida,Baker County,9,0,25021,13150,11871
50,12,3,Florida,Baker County,9,1,1853,970,883
50,12,3,Florida,Baker County,9,2,1749,855,894
50,12,3,Florida,Baker County,9,3,1753,919,834
50,12,3,Florida,Baker County,9,4,1847,989,858
50,12,3,Florida,Baker County,9,5,1842,1050,792
50,12,3,Florida,Baker County,9,6,1788,982,806
50,12,3,Florida,Baker County,9,7,1694,959,735
50,12,3,Florida,Baker County,9,8,1861,1055,806
50,12,3,Florida,Baker County,9,9,1881,1031,850
50,12,3,Florida,Baker County,9,10,1980,1053,927
50,12,3,Florida,Baker County,9,11,1679,869,810
50,12,3,Florida,Baker County,9,12,1469,755,714
50,12,3,Florida,Baker County,9,13,1075,523,552
50,12,3,Florida,Baker County,9,14,860,434,426
50,12,3,Florida,Baker County,9,15,655,318,337
50,12,3,Florida,Baker County,9,16,446,189,257
50,12,3,Florida,Baker County,9,17,327,127,200
50,12,3,Florida,Baker County,9,18,262,72,190
50,12,3,Florida,Baker County,10,0,25605,13483,12122
50,12,3,Florida,Baker County,10,1,1944,1019,925
50,12,3,Florida,Baker County,10,2,1859,918,941
50,12,3,Florida,Baker County,10,3,1686,876,810
50,12,3,Florida,Baker County,10,4,1790,979,811
50,12,3,Florida,Baker County,10,5,1870,1080,790
50,12,3,Florida,Baker County,10,6,1977,1066,911
50,12,3,Florida,Baker County,10,7,1672,975,697
50,12,3,Florida,Baker County,10,8,1955,1081,874
50,12,3,Florida,Baker County,10,9,1829,1013,816
50,12,3,Florida,Baker County,10,10,2013,1083,930
50,12,3,Florida,Baker County,10,11,1732,884,848
50,12,3,Florida,Baker County,10,12,1520,769,751
50,12,3,Florida,Baker County,10,13,1163,585,578
50,12,3,Florida,Baker County,10,14,884,433,451
50,12,3,Florida,Baker County,10,15,674,309,365
50,12,3,Florida,Baker County,10,16,419,201,218
50,12,3,Florida,Baker County,10,17,356,130,226
50,12,3,Florida,Baker County,10,18,262,82,180
50,12,3,Florida,Baker County,11,0,26048,13714,12334
50,12,3,Florida,Baker County,11,1,1998,1041,957
50,12,3,Florida,Baker County,11,2,1903,961,942
50,12,3,Florida,Baker County,11,3,1703,886,817
50,12,3,Florida,Baker County,11,4,1828,994,834
50,12,3,Florida,Baker County,11,5,1848,1059,789
50,12,3,Florida,Baker County,11,6,1980,1093,887
50,12,3,Florida,Baker County,11,7,1756,998,758
50,12,3,Florida,Baker County,11,8,1920,1053,867
50,12,3,Florida,Baker County,11,9,1888,1065,823
50,12,3,Florida,Baker County,11,10,1989,1061,928
50,12,3,Florida,Baker County,11,11,1769,912,857
50,12,3,Florida,Baker County,11,12,1509,754,755
50,12,3,Florida,Baker County,11,13,1237,626,611
50,12,3,Florida,Baker County,11,14,924,449,475
50,12,3,Florida,Baker County,11,15,711,335,376
50,12,3,Florida,Baker County,11,16,441,206,235
50,12,3,Florida,Baker County,11,17,368,134,234
50,12,3,Florida,Baker County,11,18,276,87,189
50,12,3,Florida,Baker County,12,0,26336,13857,12479
50,12,3,Florida,Baker County,12,1,2010,1057,953
50,12,3,Florida,Baker County,12,2,1986,1010,976
50,12,3,Florida,Baker County,12,3,1691,847,844
50,12,3,Florida,Baker County,12,4,1755,972,783
50,12,3,Florida,Baker County,12,5,1831,1047,784
50,12,3,Florida,Baker County,12,6,2043,1125,918
50,12,3,Florida,Baker County,12,7,1752,1004,748
50,12,3,Florida,Baker County,12,8,1954,1076,878
50,12,3,Florida,Baker County,12,9,1849,1039,810
50,12,3,Florida,Baker County,12,10,2040,1087,953
50,12,3,Florida,Baker County,12,11,1744,910,834
50,12,3,Florida,Baker County,12,12,1587,778,809
50,12,3,Florida,Baker County,12,13,1262,632,630
50,12,3,Florida,Baker County,12,14,959,465,494
50,12,3,Florida,Baker County,12,15,716,349,367
50,12,3,Florida,Baker County,12,16,498,226,272
50,12,3,Florida,Baker County,12,17,367,138,229
50,12,3,Florida,Baker County,12,18,292,95,197
50,12,5,Florida,Bay County,1,0,148217,73406,74811
50,12,5,Florida,Bay County,1,1,8979,4639,4340
50,12,5,Florida,Bay County,1,2,10103,5210,4893
50,12,5,Florida,Bay County,1,3,10331,5275,5056
50,12,5,Florida,Bay County,1,4,10117,5204,4913
50,12,5,Florida,Bay County,1,5,8955,4659,4296
50,12,5,Florida,Bay County,1,6,9661,4909,4752
50,12,5,Florida,Bay County,1,7,10078,5126,4952
50,12,5,Florida,Bay County,1,8,12604,6383,6221
50,12,5,Florida,Bay County,1,9,12394,6162,6232
50,12,5,Florida,Bay County,1,10,10626,5203,5423
50,12,5,Florida,Bay County,1,11,9738,4831,4907
50,12,5,Florida,Bay County,1,12,7895,3862,4033
50,12,5,Florida,Bay County,1,13,6919,3269,3650
50,12,5,Florida,Bay County,1,14,6188,2978,3210
50,12,5,Florida,Bay County,1,15,5554,2561,2993
50,12,5,Florida,Bay County,1,16,4044,1661,2383
50,12,5,Florida,Bay County,1,17,2280,924,1356
50,12,5,Florida,Bay County,1,18,1751,550,1201
50,12,5,Florida,Bay County,2,0,148218,73406,74812
50,12,5,Florida,Bay County,2,1,8979,4639,4340
50,12,5,Florida,Bay County,2,2,10103,5210,4893
50,12,5,Florida,Bay County,2,3,10331,5275,5056
50,12,5,Florida,Bay County,2,4,10117,5204,4913
50,12,5,Florida,Bay County,2,5,8955,4659,4296
50,12,5,Florida,Bay County,2,6,9661,4909,4752
50,12,5,Florida,Bay County,2,7,10078,5126,4952
50,12,5,Florida,Bay County,2,8,12604,6383,6221
50,12,5,Florida,Bay County,2,9,12394,6162,6232
50,12,5,Florida,Bay County,2,10,10626,5203,5423
50,12,5,Florida,Bay County,2,11,9738,4831,4907
50,12,5,Florida,Bay County,2,12,7895,3862,4033
50,12,5,Florida,Bay County,2,13,6919,3269,3650
50,12,5,Florida,Bay County,2,14,6189,2978,3211
50,12,5,Florida,Bay County,2,15,5554,2561,2993
50,12,5,Florida,Bay County,2,16,4044,1661,2383
50,12,5,Florida,Bay County,2,17,2280,924,1356
50,12,5,Florida,Bay County,2,18,1751,550,1201
50,12,5,Florida,Bay County,3,0,148258,73426,74832
50,12,5,Florida,Bay County,3,1,8958,4628,4330
50,12,5,Florida,Bay County,3,2,10030,5172,4858
50,12,5,Florida,Bay County,3,3,10344,5282,5062
50,12,5,Florida,Bay County,3,4,10111,5204,4907
50,12,5,Florida,Bay County,3,5,9021,4696,4325
50,12,5,Florida,Bay County,3,6,9577,4868,4709
50,12,5,Florida,Bay County,3,7,10051,5111,4940
50,12,5,Florida,Bay County,3,8,12528,6345,6183
50,12,5,Florida,Bay County,3,9,12396,6161,6235
50,12,5,Florida,Bay County,3,10,10663,5221,5442
50,12,5,Florida,Bay County,3,11,9814,4867,4947
50,12,5,Florida,Bay County,3,12,7924,3877,4047
50,12,5,Florida,Bay County,3,13,6925,3273,3652
50,12,5,Florida,Bay County,3,14,6197,2982,3215
50,12,5,Florida,Bay County,3,15,5572,2572,3000
50,12,5,Florida,Bay County,3,16,4068,1672,2396
50,12,5,Florida,Bay County,3,17,2309,938,1371
50,12,5,Florida,Bay County,3,18,1770,557,1213
50,12,5,Florida,Bay County,4,0,149807,74179,75628
50,12,5,Florida,Bay County,4,1,9178,4722,4456
50,12,5,Florida,Bay County,4,2,9815,5071,4744
50,12,5,Florida,Bay County,4,3,10449,5327,5122
50,12,5,Florida,Bay County,4,4,9914,5165,4749
50,12,5,Florida,Bay County,4,5,9538,4862,4676
50,12,5,Florida,Bay County,4,6,9346,4799,4547
50,12,5,Florida,Bay County,4,7,10118,5148,4970
50,12,5,Florida,Bay County,4,8,11981,6066,5915
50,12,5,Florida,Bay County,4,9,12657,6293,6364
50,12,5,Florida,Bay County,4,10,11106,5466,5640
50,12,5,Florida,Bay County,4,11,10196,5008,5188
50,12,5,Florida,Bay County,4,12,8097,3969,4128
50,12,5,Florida,Bay County,4,13,7025,3318,3707
50,12,5,Florida,Bay County,4,14,6176,2958,3218
50,12,5,Florida,Bay County,4,15,5608,2617,2991
50,12,5,Florida,Bay County,4,16,4255,1775,2480
50,12,5,Florida,Bay County,4,17,2527,1042,1485
50,12,5,Florida,Bay County,4,18,1821,573,1248
50,12,5,Florida,Bay County,5,0,152213,75191,77022
50,12,5,Florida,Bay County,5,1,9387,4843,4544
50,12,5,Florida,Bay County,5,2,9640,4950,4690
50,12,5,Florida,Bay County,5,3,10634,5451,5183
50,12,5,Florida,Bay County,5,4,9871,5112,4759
50,12,5,Florida,Bay County,5,5,10025,5050,4975
50,12,5,Florida,Bay County,5,6,9346,4801,4545
50,12,5,Florida,Bay County,5,7,10193,5144,5049
50,12,5,Florida,Bay County,5,8,11727,5934,5793
50,12,5,Florida,Bay County,5,9,12631,6312,6319
50,12,5,Florida,Bay County,5,10,11534,5625,5909
50,12,5,Florida,Bay County,5,11,10159,4956,5203
50,12,5,Florida,Bay County,5,12,8785,4278,4507
50,12,5,Florida,Bay County,5,13,7237,3476,3761
50,12,5,Florida,Bay County,5,14,6244,2936,3308
50,12,5,Florida,Bay County,5,15,5650,2688,2962
50,12,5,Florida,Bay County,5,16,4432,1882,2550
50,12,5,Florida,Bay County,5,17,2813,1136,1677
50,12,5,Florida,Bay County,5,18,1905,617,1288
50,12,5,Florida,Bay County,6,0,154726,76204,78522
50,12,5,Florida,Bay County,6,1,9857,5075,4782
50,12,5,Florida,Bay County,6,2,9477,4854,4623
50,12,5,Florida,Bay County,6,3,10724,5513,5211
50,12,5,Florida,Bay County,6,4,9951,5173,4778
50,12,5,Florida,Bay County,6,5,10330,5098,5232
50,12,5,Florida,Bay County,6,6,9729,4971,4758
50,12,5,Florida,Bay County,6,7,10178,5118,5060
50,12,5,Florida,Bay County,6,8,11092,5535,5557
50,12,5,Florida,Bay County,6,9,12738,6345,6393
50,12,5,Florida,Bay County,6,10,11963,5826,6137
50,12,5,Florida,Bay County,6,11,10341,5016,5325
50,12,5,Florida,Bay County,6,12,9220,4508,4712
50,12,5,Florida,Bay County,6,13,7613,3684,3929
50,12,5,Florida,Bay County,6,14,6347,3014,3333
50,12,5,Florida,Bay County,6,15,5573,2608,2965
50,12,5,Florida,Bay County,6,16,4576,1982,2594
50,12,5,Florida,Bay County,6,17,3018,1218,1800
50,12,5,Florida,Bay County,6,18,1999,666,1333
50,12,5,Florida,Bay County,7,0,157841,77847,79994
50,12,5,Florida,Bay County,7,1,10240,5252,4988
50,12,5,Florida,Bay County,7,2,9316,4812,4504
50,12,5,Florida,Bay County,7,3,10633,5453,5180
50,12,5,Florida,Bay County,7,4,10202,5288,4914
50,12,5,Florida,Bay County,7,5,11136,5553,5583
50,12,5,Florida,Bay County,7,6,10151,5202,4949
50,12,5,Florida,Bay County,7,7,10109,5126,4983
50,12,5,Florida,Bay County,7,8,10718,5393,5325
50,12,5,Florida,Bay County,7,9,12861,6402,6459
50,12,5,Florida,Bay County,7,10,12405,6006,6399
50,12,5,Florida,Bay County,7,11,10640,5137,5503
50,12,5,Florida,Bay County,7,12,9647,4708,4939
50,12,5,Florida,Bay County,7,13,7789,3768,4021
50,12,5,Florida,Bay County,7,14,6470,3039,3431
50,12,5,Florida,Bay County,7,15,5619,2630,2989
50,12,5,Florida,Bay County,7,16,4581,2073,2508
50,12,5,Florida,Bay County,7,17,3162,1264,1898
50,12,5,Florida,Bay County,7,18,2162,741,1421
50,12,5,Florida,Bay County,8,0,161586,79742,81844
50,12,5,Florida,Bay County,8,1,10828,5503,5325
50,12,5,Florida,Bay County,8,2,9597,4957,4640
50,12,5,Florida,Bay County,8,3,10496,5417,5079
50,12,5,Florida,Bay County,8,4,10443,5420,5023
50,12,5,Florida,Bay County,8,5,11572,5833,5739
50,12,5,Florida,Bay County,8,6,10947,5579,5368
50,12,5,Florida,Bay County,8,7,10201,5121,5080
50,12,5,Florida,Bay County,8,8,10534,5337,5197
50,12,5,Florida,Bay County,8,9,12903,6413,6490
50,12,5,Florida,Bay County,8,10,12689,6148,6541
50,12,5,Florida,Bay County,8,11,10940,5265,5675
50,12,5,Florida,Bay County,8,12,10117,4934,5183
50,12,5,Florida,Bay County,8,13,7969,3857,4112
50,12,5,Florida,Bay County,8,14,6450,3046,3404
50,12,5,Florida,Bay County,8,15,5528,2597,2931
50,12,5,Florida,Bay County,8,16,4784,2161,2623
50,12,5,Florida,Bay County,8,17,3274,1308,1966
50,12,5,Florida,Bay County,8,18,2314,846,1468
50,12,5,Florida,Bay County,9,0,163802,80930,82872
50,12,5,Florida,Bay County,9,1,11150,5700,5450
50,12,5,Florida,Bay County,9,2,9827,5054,4773
50,12,5,Florida,Bay County,9,3,10421,5380,5041
50,12,5,Florida,Bay County,9,4,10624,5512,5112
50,12,5,Florida,Bay County,9,5,11637,5978,5659
50,12,5,Florida,Bay County,9,6,11692,5839,5853
50,12,5,Florida,Bay County,9,7,9965,5063,4902
50,12,5,Florida,Bay County,9,8,10771,5469,5302
50,12,5,Florida,Bay County,9,9,12517,6228,6289
50,12,5,Florida,Bay County,9,10,12903,6261,6642
50,12,5,Florida,Bay County,9,11,11319,5459,5860
50,12,5,Florida,Bay County,9,12,10461,5067,5394
50,12,5,Florida,Bay County,9,13,7954,3847,4107
50,12,5,Florida,Bay County,9,14,6443,3039,3404
50,12,5,Florida,Bay County,9,15,5451,2557,2894
50,12,5,Florida,Bay County,9,16,4762,2177,2585
50,12,5,Florida,Bay County,9,17,3416,1377,2039
50,12,5,Florida,Bay County,9,18,2489,923,1566
50,12,5,Florida,Bay County,10,0,163300,80594,82706
50,12,5,Florida,Bay County,10,1,11328,5773,5555
50,12,5,Florida,Bay County,10,2,9813,5059,4754
50,12,5,Florida,Bay County,10,3,10010,5147,4863
50,12,5,Florida,Bay County,10,4,10562,5493,5069
50,12,5,Florida,Bay County,10,5,11161,5723,5438
50,12,5,Florida,Bay County,10,6,11929,5958,5971
50,12,5,Florida,Bay County,10,7,9640,4900,4740
50,12,5,Florida,Bay County,10,8,10693,5413,5280
50,12,5,Florida,Bay County,10,9,12029,6003,6026
50,12,5,Florida,Bay County,10,10,12836,6265,6571
50,12,5,Florida,Bay County,10,11,11611,5580,6031
50,12,5,Florida,Bay County,10,12,10271,4932,5339
50,12,5,Florida,Bay County,10,13,8487,4082,4405
50,12,5,Florida,Bay County,10,14,6563,3135,3428
50,12,5,Florida,Bay County,10,15,5455,2515,2940
50,12,5,Florida,Bay County,10,16,4747,2211,2536
50,12,5,Florida,Bay County,10,17,3461,1440,2021
50,12,5,Florida,Bay County,10,18,2704,965,1739
50,12,5,Florida,Bay County,11,0,163802,80855,82947
50,12,5,Florida,Bay County,11,1,11374,5796,5578
50,12,5,Florida,Bay County,11,2,9969,5126,4843
50,12,5,Florida,Bay County,11,3,9607,4933,4674
50,12,5,Florida,Bay County,11,4,10420,5433,4987
50,12,5,Florida,Bay County,11,5,11121,5762,5359
50,12,5,Florida,Bay County,11,6,12146,6031,6115
50,12,5,Florida,Bay County,11,7,9806,5002,4804
50,12,5,Florida,Bay County,11,8,10511,5346,5165
50,12,5,Florida,Bay County,11,9,11426,5665,5761
50,12,5,Florida,Bay County,11,10,12736,6234,6502
50,12,5,Florida,Bay County,11,11,11948,5737,6211
50,12,5,Florida,Bay County,11,12,10203,4877,5326
50,12,5,Florida,Bay County,11,13,8866,4281,4585
50,12,5,Florida,Bay County,11,14,6892,3314,3578
50,12,5,Florida,Bay County,11,15,5573,2608,2965
50,12,5,Florida,Bay County,11,16,4689,2143,2546
50,12,5,Florida,Bay County,11,17,3574,1501,2073
50,12,5,Florida,Bay County,11,18,2941,1066,1875
50,12,5,Florida,Bay County,12,0,164767,81313,83454
50,12,5,Florida,Bay County,12,1,11397,5796,5601
50,12,5,Florida,Bay County,12,2,10069,5163,4906
50,12,5,Florida,Bay County,12,3,9465,4903,4562
50,12,5,Florida,Bay County,12,4,10184,5308,4876
50,12,5,Florida,Bay County,12,5,11259,5800,5459
50,12,5,Florida,Bay County,12,6,12475,6220,6255
50,12,5,Florida,Bay County,12,7,10016,5107,4909
50,12,5,Florida,Bay County,12,8,10268,5249,5019
50,12,5,Florida,Bay County,12,9,10919,5446,5473
50,12,5,Florida,Bay County,12,10,12718,6212,6506
50,12,5,Florida,Bay County,12,11,12205,5829,6376
50,12,5,Florida,Bay County,12,12,10351,4924,5427
50,12,5,Florida,Bay County,12,13,9128,4403,4725
50,12,5,Florida,Bay County,12,14,7102,3410,3692
50,12,5,Florida,Bay County,12,15,5668,2635,3033
50,12,5,Florida,Bay County,12,16,4757,2158,2599
50,12,5,Florida,Bay County,12,17,3589,1585,2004
50,12,5,Florida,Bay County,12,18,3197,1165,2032
50,12,7,Florida,Bradford County,1,0,26088,14596,11492
50,12,7,Florida,Bradford County,1,1,1444,765,679
50,12,7,Florida,Bradford County,1,2,1540,798,742
50,12,7,Florida,Bradford County,1,3,1664,864,800
50,12,7,Florida,Bradford County,1,4,1767,930,837
50,12,7,Florida,Bradford County,1,5,1788,1132,656
50,12,7,Florida,Bradford County,1,6,1886,1238,648
50,12,7,Florida,Bradford County,1,7,1983,1315,668
50,12,7,Florida,Bradford County,1,8,2244,1465,779
50,12,7,Florida,Bradford County,1,9,2264,1341,923
50,12,7,Florida,Bradford County,1,10,1930,1115,815
50,12,7,Florida,Bradford County,1,11,1678,898,780
50,12,7,Florida,Bradford County,1,12,1372,708,664
50,12,7,Florida,Bradford County,1,13,1152,598,554
50,12,7,Florida,Bradford County,1,14,986,475,511
50,12,7,Florida,Bradford County,1,15,845,391,454
50,12,7,Florida,Bradford County,1,16,727,293,434
50,12,7,Florida,Bradford County,1,17,437,163,274
50,12,7,Florida,Bradford County,1,18,381,107,274
50,12,7,Florida,Bradford County,2,0,26088,14596,11492
50,12,7,Florida,Bradford County,2,1,1444,765,679
50,12,7,Florida,Bradford County,2,2,1540,798,742
50,12,7,Florida,Bradford County,2,3,1664,864,800
50,12,7,Florida,Bradford County,2,4,1767,930,837
50,12,7,Florida,Bradford County,2,5,1788,1132,656
50,12,7,Florida,Bradford County,2,6,1886,1238,648
50,12,7,Florida,Bradford County,2,7,1983,1315,668
50,12,7,Florida,Bradford County,2,8,2244,1465,779
50,12,7,Florida,Bradford County,2,9,2264,1341,923
50,12,7,Florida,Bradford County,2,10,1930,1115,815
50,12,7,Florida,Bradford County,2,11,1678,898,780
50,12,7,Florida,Bradford County,2,12,1372,708,664
50,12,7,Florida,Bradford County,2,13,1152,598,554
50,12,7,Florida,Bradford County,2,14,986,475,511
50,12,7,Florida,Bradford County,2,15,845,391,454
50,12,7,Florida,Bradford County,2,16,727,293,434
50,12,7,Florida,Bradford County,2,17,437,163,274
50,12,7,Florida,Bradford County,2,18,381,107,274
50,12,7,Florida,Bradford County,3,0,26078,14592,11486
50,12,7,Florida,Bradford County,3,1,1439,762,677
50,12,7,Florida,Bradford County,3,2,1531,793,738
50,12,7,Florida,Bradford County,3,3,1664,864,800
50,12,7,Florida,Bradford County,3,4,1767,930,837
50,12,7,Florida,Bradford County,3,5,1798,1139,659
50,12,7,Florida,Bradford County,3,6,1875,1233,642
50,12,7,Florida,Bradford County,3,7,1978,1311,667
50,12,7,Florida,Bradford County,3,8,2235,1461,774
50,12,7,Florida,Bradford County,3,9,2262,1340,922
50,12,7,Florida,Bradford County,3,10,1936,1118,818
50,12,7,Florida,Bradford County,3,11,1689,904,785
50,12,7,Florida,Bradford County,3,12,1375,709,666
50,12,7,Florida,Bradford County,3,13,1152,598,554
50,12,7,Florida,Bradford County,3,14,982,473,509
50,12,7,Florida,Bradford County,3,15,842,390,452
50,12,7,Florida,Bradford County,3,16,729,294,435
50,12,7,Florida,Bradford County,3,17,441,165,276
50,12,7,Florida,Bradford County,3,18,383,108,275
50,12,7,Florida,Bradford County,4,0,26094,14476,11618
50,12,7,Florida,Bradford County,4,1,1515,797,718
50,12,7,Florida,Bradford County,4,2,1522,781,741
50,12,7,Florida,Bradford County,4,3,1621,837,784
50,12,7,Florida,Bradford County,4,4,1688,914,774
50,12,7,Florida,Bradford County,4,5,1954,1191,763
50,12,7,Florida,Bradford County,4,6,1824,1173,651
50,12,7,Florida,Bradford County,4,7,1966,1297,669
50,12,7,Florida,Bradford County,4,8,2136,1390,746
50,12,7,Florida,Bradford County,4,9,2216,1325,891
50,12,7,Florida,Bradford County,4,10,1967,1104,863
50,12,7,Florida,Bradford County,4,11,1732,920,812
50,12,7,Florida,Bradford County,4,12,1385,708,677
50,12,7,Florida,Bradford County,4,13,1185,602,583
50,12,7,Florida,Bradford County,4,14,982,480,502
50,12,7,Florida,Bradford County,4,15,831,386,445
50,12,7,Florida,Bradford County,4,16,722,282,440
50,12,7,Florida,Bradford County,4,17,466,183,283
50,12,7,Florida,Bradford County,4,18,382,106,276
50,12,7,Florida,Bradford County,5,0,26343,14713,11630
50,12,7,Florida,Bradford County,5,1,1482,774,708
50,12,7,Florida,Bradford County,5,2,1500,781,719
50,12,7,Florida,Bradford County,5,3,1636,832,804
50,12,7,Florida,Bradford County,5,4,1645,895,750
50,12,7,Florida,Bradford County,5,5,2054,1255,799
50,12,7,Florida,Bradford County,5,6,1847,1216,631
50,12,7,Florida,Bradford County,5,7,2012,1338,674
50,12,7,Florida,Bradford County,5,8,2126,1403,723
50,12,7,Florida,Bradford County,5,9,2207,1345,862
50,12,7,Florida,Bradford County,5,10,2024,1116,908
50,12,7,Florida,Bradford County,5,11,1722,928,794
50,12,7,Florida,Bradford County,5,12,1464,754,710
50,12,7,Florida,Bradford County,5,13,1194,611,583
50,12,7,Florida,Bradford County,5,14,953,473,480
50,12,7,Florida,Bradford County,5,15,852,404,448
50,12,7,Florida,Bradford County,5,16,737,281,456
50,12,7,Florida,Bradford County,5,17,489,188,301
50,12,7,Florida,Bradford County,5,18,399,119,280
50,12,7,Florida,Bradford County,6,0,27097,15302,11795
50,12,7,Florida,Bradford County,6,1,1561,817,744
50,12,7,Florida,Bradford County,6,2,1491,776,715
50,12,7,Florida,Bradford County,6,3,1646,837,809
50,12,7,Florida,Bradford County,6,4,1617,879,738
50,12,7,Florida,Bradford County,6,5,2189,1366,823
50,12,7,Florida,Bradford County,6,6,2006,1341,665
50,12,7,Florida,Bradford County,6,7,2097,1404,693
50,12,7,Florida,Bradford County,6,8,2141,1448,693
50,12,7,Florida,Bradford County,6,9,2279,1412,867
50,12,7,Florida,Bradford County,6,10,2120,1188,932
50,12,7,Florida,Bradford County,6,11,1736,948,788
50,12,7,Florida,Bradford County,6,12,1516,781,735
50,12,7,Florida,Bradford County,6,13,1231,613,618
50,12,7,Florida,Bradford County,6,14,980,492,488
50,12,7,Florida,Bradford County,6,15,806,381,425
50,12,7,Florida,Bradford County,6,16,769,300,469
50,12,7,Florida,Bradford County,6,17,504,197,307
50,12,7,Florida,Bradford County,6,18,408,122,286
50,12,7,Florida,Bradford County,7,0,27791,15851,11940
50,12,7,Florida,Bradford County,7,1,1560,802,758
50,12,7,Florida,Bradford County,7,2,1490,789,701
50,12,7,Florida,Bradford County,7,3,1675,864,811
50,12,7,Florida,Bradford County,7,4,1618,861,757
50,12,7,Florida,Bradford County,7,5,2283,1448,835
50,12,7,Florida,Bradford County,7,6,2207,1479,728
50,12,7,Florida,Bradford County,7,7,2121,1457,664
50,12,7,Florida,Bradford County,7,8,2215,1521,694
50,12,7,Florida,Bradford County,7,9,2294,1447,847
50,12,7,Florida,Bradford County,7,10,2180,1248,932
50,12,7,Florida,Bradford County,7,11,1750,956,794
50,12,7,Florida,Bradford County,7,12,1588,814,774
50,12,7,Florida,Bradford County,7,13,1285,644,641
50,12,7,Florida,Bradford County,7,14,1037,519,518
50,12,7,Florida,Bradford County,7,15,807,375,432
50,12,7,Florida,Bradford County,7,16,741,308,433
50,12,7,Florida,Bradford County,7,17,520,192,328
50,12,7,Florida,Bradford County,7,18,420,127,293
50,12,7,Florida,Bradford County,8,0,28191,16062,12129
50,12,7,Florida,Bradford County,8,1,1627,831,796
50,12,7,Florida,Bradford County,8,2,1511,798,713
50,12,7,Florida,Bradford County,8,3,1588,817,771
50,12,7,Florida,Bradford County,8,4,1636,874,762
50,12,7,Florida,Bradford County,8,5,2285,1430,855
50,12,7,Florida,Bradford County,8,6,2417,1604,813
50,12,7,Florida,Bradford County,8,7,2108,1456,652
50,12,7,Florida,Bradford County,8,8,2169,1498,671
50,12,7,Florida,Bradford County,8,9,2266,1453,813
50,12,7,Florida,Bradford County,8,10,2237,1271,966
50,12,7,Florida,Bradford County,8,11,1803,969,834
50,12,7,Florida,Bradford County,8,12,1652,842,810
50,12,7,Florida,Bradford County,8,13,1300,659,641
50,12,7,Florida,Bradford County,8,14,1044,520,524
50,12,7,Florida,Bradford County,8,15,845,386,459
50,12,7,Florida,Bradford County,8,16,693,313,380
50,12,7,Florida,Bradford County,8,17,551,188,363
50,12,7,Florida,Bradford County,8,18,459,153,306
50,12,7,Florida,Bradford County,9,0,28610,16282,12328
50,12,7,Florida,Bradford County,9,1,1659,852,807
50,12,7,Florida,Bradford County,9,2,1606,843,763
50,12,7,Florida,Bradford County,9,3,1566,801,765
50,12,7,Florida,Bradford County,9,4,1602,848,754
50,12,7,Florida,Bradford County,9,5,2182,1418,764
50,12,7,Florida,Bradford County,9,6,2617,1688,929
50,12,7,Florida,Bradford County,9,7,2118,1449,669
50,12,7,Florida,Bradford County,9,8,2187,1523,664
50,12,7,Florida,Bradford County,9,9,2259,1457,802
50,12,7,Florida,Bradford County,9,10,2204,1274,930
50,12,7,Florida,Bradford County,9,11,1863,983,880
50,12,7,Florida,Bradford County,9,12,1694,863,831
50,12,7,Florida,Bradford County,9,13,1347,680,667
50,12,7,Florida,Bradford County,9,14,1070,525,545
50,12,7,Florida,Bradford County,9,15,874,397,477
50,12,7,Florida,Bradford County,9,16,697,312,385
50,12,7,Florida,Bradford County,9,17,571,196,375
50,12,7,Florida,Bradford County,9,18,494,173,321
50,12,7,Florida,Bradford County,10,0,28997,16532,12465
50,12,7,Florida,Bradford County,10,1,1692,871,821
50,12,7,Florida,Bradford County,10,2,1631,848,783
50,12,7,Florida,Bradford County,10,3,1548,805,743
50,12,7,Florida,Bradford County,10,4,1644,862,782
50,12,7,Florida,Bradford County,10,5,2107,1393,714
50,12,7,Florida,Bradford County,10,6,2731,1755,976
50,12,7,Florida,Bradford County,10,7,2188,1508,680
50,12,7,Florida,Bradford County,10,8,2236,1556,680
50,12,7,Florida,Bradford County,10,9,2228,1444,784
50,12,7,Florida,Bradford County,10,10,2145,1259,886
50,12,7,Florida,Bradford County,10,11,1952,1004,948
50,12,7,Florida,Bradford County,10,12,1699,880,819
50,12,7,Florida,Bradford County,10,13,1413,713,700
50,12,7,Florida,Bradford County,10,14,1095,543,552
50,12,7,Florida,Bradford County,10,15,860,393,467
50,12,7,Florida,Bradford County,10,16,747,334,413
50,12,7,Florida,Bradford County,10,17,569,191,378
50,12,7,Florida,Bradford County,10,18,512,173,339
50,12,7,Florida,Bradford County,11,0,29171,16560,12611
50,12,7,Florida,Bradford County,11,1,1739,888,851
50,12,7,Florida,Bradford County,11,2,1633,848,785
50,12,7,Florida,Bradford County,11,3,1525,795,730
50,12,7,Florida,Bradford County,11,4,1647,869,778
50,12,7,Florida,Bradford County,11,5,2084,1360,724
50,12,7,Florida,Bradford County,11,6,2768,1782,986
50,12,7,Florida,Bradford County,11,7,2203,1517,686
50,12,7,Florida,Bradford County,11,8,2239,1533,706
50,12,7,Florida,Bradford County,11,9,2174,1413,761
50,12,7,Florida,Bradford County,11,10,2188,1275,913
50,12,7,Florida,Bradford County,11,11,1976,1021,955
50,12,7,Florida,Bradford County,11,12,1695,879,816
50,12,7,Florida,Bradford County,11,13,1452,727,725
50,12,7,Florida,Bradford County,11,14,1112,532,580
50,12,7,Florida,Bradford County,11,15,887,417,470
50,12,7,Florida,Bradford County,11,16,728,318,410
50,12,7,Florida,Bradford County,11,17,591,208,383
50,12,7,Florida,Bradford County,11,18,530,178,352
50,12,7,Florida,Bradford County,12,0,29235,16662,12573
50,12,7,Florida,Bradford County,12,1,1760,904,856
50,12,7,Florida,Bradford County,12,2,1559,792,767
50,12,7,Florida,Bradford County,12,3,1535,814,721
50,12,7,Florida,Bradford County,12,4,1603,855,748
50,12,7,Florida,Bradford County,12,5,2012,1321,691
50,12,7,Florida,Bradford County,12,6,2818,1828,990
50,12,7,Florida,Bradford County,12,7,2343,1599,744
50,12,7,Florida,Bradford County,12,8,2199,1524,675
50,12,7,Florida,Bradford County,12,9,2152,1411,741
50,12,7,Florida,Bradford County,12,10,2161,1268,893
50,12,7,Florida,Bradford County,12,11,1983,1042,941
50,12,7,Florida,Bradford County,12,12,1683,865,818
50,12,7,Florida,Bradford County,12,13,1525,759,766
50,12,7,Florida,Bradford County,12,14,1178,568,610
50,12,7,Florida,Bradford County,12,15,902,420,482
50,12,7,Florida,Bradford County,12,16,706,297,409
50,12,7,Florida,Bradford County,12,17,584,228,356
50,12,7,Florida,Bradford County,12,18,532,167,365
50,12,9,Florida,Brevard County,1,0,476230,233186,243044
50,12,9,Florida,Brevard County,1,1,24707,12650,12057
50,12,9,Florida,Brevard County,1,2,29546,15048,14498
50,12,9,Florida,Brevard County,1,3,31999,16453,15546
50,12,9,Florida,Brevard County,1,4,29172,15345,13827
50,12,9,Florida,Brevard County,1,5,21502,11473,10029
50,12,9,Florida,Brevard County,1,6,22727,11331,11396
50,12,9,Florida,Brevard County,1,7,27918,13702,14216
50,12,9,Florida,Brevard County,1,8,38674,19143,19531
50,12,9,Florida,Brevard County,1,9,39753,19999,19754
50,12,9,Florida,Brevard County,1,10,33325,16676,16649
50,12,9,Florida,Brevard County,1,11,29913,14311,15602
50,12,9,Florida,Brevard County,1,12,26842,12643,14199
50,12,9,Florida,Brevard County,1,13,25471,11924,13547
50,12,9,Florida,Brevard County,1,14,26887,12944,13943
50,12,9,Florida,Brevard County,1,15,25059,11608,13451
50,12,9,Florida,Brevard County,1,16,21000,9296,11704
50,12,9,Florida,Brevard County,1,17,12775,5624,7151
50,12,9,Florida,Brevard County,1,18,8960,3016,5944
50,12,9,Florida,Brevard County,2,0,476230,233186,243044
50,12,9,Florida,Brevard County,2,1,24707,12650,12057
50,12,9,Florida,Brevard County,2,2,29546,15048,14498
50,12,9,Florida,Brevard County,2,3,31999,16453,15546
50,12,9,Florida,Brevard County,2,4,29172,15345,13827
50,12,9,Florida,Brevard County,2,5,21502,11473,10029
50,12,9,Florida,Brevard County,2,6,22727,11331,11396
50,12,9,Florida,Brevard County,2,7,27918,13702,14216
50,12,9,Florida,Brevard County,2,8,38674,19143,19531
50,12,9,Florida,Brevard County,2,9,39753,19999,19754
50,12,9,Florida,Brevard County,2,10,33325,16676,16649
50,12,9,Florida,Brevard County,2,11,29913,14311,15602
50,12,9,Florida,Brevard County,2,12,26842,12643,14199
50,12,9,Florida,Brevard County,2,13,25471,11924,13547
50,12,9,Florida,Brevard County,2,14,26887,12944,13943
50,12,9,Florida,Brevard County,2,15,25059,11608,13451
50,12,9,Florida,Brevard County,2,16,21000,9296,11704
50,12,9,Florida,Brevard County,2,17,12775,5624,7151
50,12,9,Florida,Brevard County,2,18,8960,3016,5944
50,12,9,Florida,Brevard County,3,0,477735,233945,243790
50,12,9,Florida,Brevard County,3,1,24733,12660,12073
50,12,9,Florida,Brevard County,3,2,29428,14989,14439
50,12,9,Florida,Brevard County,3,3,32133,16519,15614
50,12,9,Florida,Brevard County,3,4,29248,15391,13857
50,12,9,Florida,Brevard County,3,5,21722,11592,10130
50,12,9,Florida,Brevard County,3,6,22591,11263,11328
50,12,9,Florida,Brevard County,3,7,27921,13704,14217
50,12,9,Florida,Brevard County,3,8,38549,19082,19467
50,12,9,Florida,Brevard County,3,9,39872,20056,19816
50,12,9,Florida,Brevard County,3,10,33543,16787,16756
50,12,9,Florida,Brevard County,3,11,30246,14472,15774
50,12,9,Florida,Brevard County,3,12,27029,12730,14299
50,12,9,Florida,Brevard County,3,13,25583,11980,13603
50,12,9,Florida,Brevard County,3,14,26896,12950,13946
50,12,9,Florida,Brevard County,3,15,25125,11654,13471
50,12,9,Florida,Brevard County,3,16,21125,9359,11766
50,12,9,Florida,Brevard County,3,17,12931,5701,7230
50,12,9,Florida,Brevard County,3,18,9060,3056,6004
50,12,9,Florida,Brevard County,4,0,485810,238092,247718
50,12,9,Florida,Brevard County,4,1,25125,12918,12207
50,12,9,Florida,Brevard County,4,2,28995,14723,14272
50,12,9,Florida,Brevard County,4,3,32818,16864,15954
50,12,9,Florida,Brevard County,4,4,29822,15837,13985
50,12,9,Florida,Brevard County,4,5,23417,12388,11029
50,12,9,Florida,Brevard County,4,6,21799,10898,10901
50,12,9,Florida,Brevard County,4,7,27554,13550,14004
50,12,9,Florida,Brevard County,4,8,37129,18283,18846
50,12,9,Florida,Brevard County,4,9,41388,20796,20592
50,12,9,Florida,Brevard County,4,10,35407,17661,17746
50,12,9,Florida,Brevard County,4,11,31831,15362,16469
50,12,9,Florida,Brevard County,4,12,27497,13025,14472
50,12,9,Florida,Brevard County,4,13,25873,12104,13769
50,12,9,Florida,Brevard County,4,14,26704,12749,13955
50,12,9,Florida,Brevard County,4,15,25480,11958,13522
50,12,9,Florida,Brevard County,4,16,21457,9483,11974
50,12,9,Florida,Brevard County,4,17,13990,6192,7798
50,12,9,Florida,Brevard County,4,18,9524,3301,6223
50,12,9,Florida,Brevard County,5,0,494239,242201,252038
50,12,9,Florida,Brevard County,5,1,25255,13013,12242
50,12,9,Florida,Brevard County,5,2,28621,14567,14054
50,12,9,Florida,Brevard County,5,3,33396,17124,16272
50,12,9,Florida,Brevard County,5,4,30482,16245,14237
50,12,9,Florida,Brevard County,5,5,25011,13071,11940
50,12,9,Florida,Brevard County,5,6,21917,11035,10882
50,12,9,Florida,Brevard County,5,7,27199,13390,13809
50,12,9,Florida,Brevard County,5,8,35327,17344,17983
50,12,9,Florida,Brevard County,5,9,42129,21097,21032
50,12,9,Florida,Brevard County,5,10,37803,18815,18988
50,12,9,Florida,Brevard County,5,11,31927,15511,16416
50,12,9,Florida,Brevard County,5,12,29741,14124,15617
50,12,9,Florida,Brevard County,5,13,26517,12364,14153
50,12,9,Florida,Brevard County,5,14,26506,12598,13908
50,12,9,Florida,Brevard County,5,15,25640,12095,13545
50,12,9,Florida,Brevard County,5,16,21676,9578,12098
50,12,9,Florida,Brevard County,5,17,14949,6640,8309
50,12,9,Florida,Brevard County,5,18,10143,3590,6553
50,12,9,Florida,Brevard County,6,0,502985,246542,256443
50,12,9,Florida,Brevard County,6,1,25617,13134,12483
50,12,9,Florida,Brevard County,6,2,28183,14407,13776
50,12,9,Florida,Brevard County,6,3,33598,17218,16380
50,12,9,Florida,Brevard County,6,4,31402,16678,14724
50,12,9,Florida,Brevard County,6,5,26150,13755,12395
50,12,9,Florida,Brevard County,6,6,22633,11447,11186
50,12,9,Florida,Brevard County,6,7,26958,13267,13691
50,12,9,Florida,Brevard County,6,8,33730,16553,17177
50,12,9,Florida,Brevard County,6,9,42371,21166,21205
50,12,9,Florida,Brevard County,6,10,39693,19670,20023
50,12,9,Florida,Brevard County,6,11,32975,16154,16821
50,12,9,Florida,Brevard County,6,12,30459,14471,15988
50,12,9,Florida,Brevard County,6,13,27936,12982,14954
50,12,9,Florida,Brevard County,6,14,26554,12570,13984
50,12,9,Florida,Brevard County,6,15,25977,12424,13553
50,12,9,Florida,Brevard County,6,16,22021,9740,12281
50,12,9,Florida,Brevard County,6,17,15720,6901,8819
50,12,9,Florida,Brevard County,6,18,11008,4005,7003
50,12,9,Florida,Brevard County,7,0,515890,252990,262900
50,12,9,Florida,Brevard County,7,1,26333,13487,12846
50,12,9,Florida,Brevard County,7,2,28272,14492,13780
50,12,9,Florida,Brevard County,7,3,33612,17158,16454
50,12,9,Florida,Brevard County,7,4,32667,17314,15353
50,12,9,Florida,Brevard County,7,5,27556,14485,13071
50,12,9,Florida,Brevard County,7,6,24243,12357,11886
50,12,9,Florida,Brevard County,7,7,26881,13314,13567
50,12,9,Florida,Brevard County,7,8,32385,15900,16485
50,12,9,Florida,Brevard County,7,9,42916,21350,21566
50,12,9,Florida,Brevard County,7,10,41469,20543,20926
50,12,9,Florida,Brevard County,7,11,34859,17145,17714
50,12,9,Florida,Brevard County,7,12,31931,15112,16819
50,12,9,Florida,Brevard County,7,13,29095,13627,15468
50,12,9,Florida,Brevard County,7,14,26861,12668,14193
50,12,9,Florida,Brevard County,7,15,25833,12342,13491
50,12,9,Florida,Brevard County,7,16,22484,10100,12384
50,12,9,Florida,Brevard County,7,17,16601,7156,9445
50,12,9,Florida,Brevard County,7,18,11892,4440,7452
50,12,9,Florida,Brevard County,8,0,526088,258075,268013
50,12,9,Florida,Brevard County,8,1,27055,13783,13272
50,12,9,Florida,Brevard County,8,2,28655,14665,13990
50,12,9,Florida,Brevard County,8,3,33346,17021,16325
50,12,9,Florida,Brevard County,8,4,33696,17826,15870
50,12,9,Florida,Brevard County,8,5,28687,15063,13624
50,12,9,Florida,Brevard County,8,6,26026,13317,12709
50,12,9,Florida,Brevard County,8,7,26596,13241,13355
50,12,9,Florida,Brevard County,8,8,31695,15547,16148
50,12,9,Florida,Brevard County,8,9,42497,21020,21477
50,12,9,Florida,Brevard County,8,10,43213,21557,21656
50,12,9,Florida,Brevard County,8,11,36839,18108,18731
50,12,9,Florida,Brevard County,8,12,33494,15850,17644
50,12,9,Florida,Brevard County,8,13,29697,13878,15819
50,12,9,Florida,Brevard County,8,14,26559,12481,14078
50,12,9,Florida,Brevard County,8,15,25672,12239,13433
50,12,9,Florida,Brevard County,8,16,22605,10355,12250
50,12,9,Florida,Brevard County,8,17,16987,7266,9721
50,12,9,Florida,Brevard County,8,18,12769,4858,7911
50,12,9,Florida,Brevard County,9,0,530319,260211,270108
50,12,9,Florida,Brevard County,9,1,27301,13888,13413
50,12,9,Florida,Brevard County,9,2,28885,14832,14053
50,12,9,Florida,Brevard County,9,3,32735,16660,16075
50,12,9,Florida,Brevard County,9,4,34246,18081,16165
50,12,9,Florida,Brevard County,9,5,28986,15335,13651
50,12,9,Florida,Brevard County,9,6,27868,14146,13722
50,12,9,Florida,Brevard County,9,7,25675,12815,12860
50,12,9,Florida,Brevard County,9,8,31358,15418,15940
50,12,9,Florida,Brevard County,9,9,40864,20117,20747
50,12,9,Florida,Brevard County,9,10,44458,22190,22268
50,12,9,Florida,Brevard County,9,11,38395,18863,19532
50,12,9,Florida,Brevard County,9,12,34838,16608,18230
50,12,9,Florida,Brevard County,9,13,29573,13877,15696
50,12,9,Florida,Brevard County,9,14,26420,12358,14062
50,12,9,Florida,Brevard County,9,15,25150,11878,13272
50,12,9,Florida,Brevard County,9,16,22648,10480,12168
50,12,9,Florida,Brevard County,9,17,17101,7276,9825
50,12,9,Florida,Brevard County,9,18,13818,5389,8429
50,12,9,Florida,Brevard County,10,0,534407,262615,271792
50,12,9,Florida,Brevard County,10,1,27684,14143,13541
50,12,9,Florida,Brevard County,10,2,28816,14830,13986
50,12,9,Florida,Brevard County,10,3,32107,16392,15715
50,12,9,Florida,Brevard County,10,4,34403,18137,16266
50,12,9,Florida,Brevard County,10,5,29615,15802,13813
50,12,9,Florida,Brevard County,10,6,28979,14650,14329
50,12,9,Florida,Brevard County,10,7,25442,12799,12643
50,12,9,Florida,Brevard County,10,8,30848,15214,15634
50,12,9,Florida,Brevard County,10,9,38858,19143,19715
50,12,9,Florida,Brevard County,10,10,44885,22355,22530
50,12,9,Florida,Brevard County,10,11,40218,19748,20470
50,12,9,Florida,Brevard County,10,12,34496,16572,17924
50,12,9,Florida,Brevard County,10,13,31377,14766,16611
50,12,9,Florida,Brevard County,10,14,26669,12398,14271
50,12,9,Florida,Brevard County,10,15,24985,11765,13220
50,12,9,Florida,Brevard County,10,16,22673,10551,12122
50,12,9,Florida,Brevard County,10,17,17503,7490,10013
50,12,9,Florida,Brevard County,10,18,14849,5860,8989
50,12,9,Florida,Brevard County,11,0,536314,263533,272781
50,12,9,Florida,Brevard County,11,1,27880,14313,13567
50,12,9,Florida,Brevard County,11,2,28588,14645,13943
50,12,9,Florida,Brevard County,11,3,31204,16000,15204
50,12,9,Florida,Brevard County,11,4,34172,17996,16176
50,12,9,Florida,Brevard County,11,5,30118,15976,14142
50,12,9,Florida,Brevard County,11,6,29465,14992,14473
50,12,9,Florida,Brevard County,11,7,25585,12901,12684
50,12,9,Florida,Brevard County,11,8,30237,14909,15328
50,12,9,Florida,Brevard County,11,9,36542,17998,18544
50,12,9,Florida,Brevard County,11,10,44694,22232,22462
50,12,9,Florida,Brevard County,11,11,41633,20394,21239
50,12,9,Florida,Brevard County,11,12,34892,16905,17987
50,12,9,Florida,Brevard County,11,13,31801,14971,16830
50,12,9,Florida,Brevard County,11,14,27978,12945,15033
50,12,9,Florida,Brevard County,11,15,24924,11663,13261
50,12,9,Florida,Brevard County,11,16,22933,10790,12143
50,12,9,Florida,Brevard County,11,17,17754,7651,10103
50,12,9,Florida,Brevard County,11,18,15914,6252,9662
50,12,9,Florida,Brevard County,12,0,536357,263479,272878
50,12,9,Florida,Brevard County,12,1,27935,14361,13574
50,12,9,Florida,Brevard County,12,2,28374,14525,13849
50,12,9,Florida,Brevard County,12,3,30345,15609,14736
50,12,9,Florida,Brevard County,12,4,33470,17576,15894
50,12,9,Florida,Brevard County,12,5,30001,15915,14086
50,12,9,Florida,Brevard County,12,6,30086,15307,14779
50,12,9,Florida,Brevard County,12,7,25941,13146,12795
50,12,9,Florida,Brevard County,12,8,28891,14314,14577
50,12,9,Florida,Brevard County,12,9,34301,16877,17424
50,12,9,Florida,Brevard County,12,10,44288,21926,22362
50,12,9,Florida,Brevard County,12,11,42414,20803,21611
50,12,9,Florida,Brevard County,12,12,35889,17465,18424
50,12,9,Florida,Brevard County,12,13,32537,15253,17284
50,12,9,Florida,Brevard County,12,14,28991,13503,15488
50,12,9,Florida,Brevard County,12,15,25163,11708,13455
50,12,9,Florida,Brevard County,12,16,22703,10646,12057
50,12,9,Florida,Brevard County,12,17,18042,7918,10124
50,12,9,Florida,Brevard County,12,18,16986,6627,10359
50,12,11,Florida,Broward County,1,0,1623018,783232,839786
50,12,11,Florida,Broward County,1,1,103041,52937,50104
50,12,11,Florida,Broward County,1,2,110142,56644,53498
50,12,11,Florida,Broward County,1,3,109132,55949,53183
50,12,11,Florida,Broward County,1,4,95161,48586,46575
50,12,11,Florida,Broward County,1,5,82834,40710,42124
50,12,11,Florida,Broward County,1,6,105816,51482,54334
50,12,11,Florida,Broward County,1,7,125048,61365,63683
50,12,11,Florida,Broward County,1,8,143477,71280,72197
50,12,11,Florida,Broward County,1,9,135070,67331,67739
50,12,11,Florida,Broward County,1,10,115583,56891,58692
50,12,11,Florida,Broward County,1,11,99503,48713,50790
50,12,11,Florida,Broward County,1,12,76548,36960,39588
50,12,11,Florida,Broward County,1,13,60554,28600,31954
50,12,11,Florida,Broward County,1,14,57034,25513,31521
50,12,11,Florida,Broward County,1,15,59607,25430,34177
50,12,11,Florida,Broward County,1,16,56752,22687,34065
50,12,11,Florida,Broward County,1,17,44665,16977,27688
50,12,11,Florida,Broward County,1,18,43051,15177,27874
50,12,11,Florida,Broward County,2,0,1623016,783231,839785
50,12,11,Florida,Broward County,2,1,103040,52936,50104
50,12,11,Florida,Broward County,2,2,110142,56644,53498
50,12,11,Florida,Broward County,2,3,109132,55949,53183
50,12,11,Florida,Broward County,2,4,95161,48586,46575
50,12,11,Florida,Broward County,2,5,82833,40710,42123
50,12,11,Florida,Broward County,2,6,105816,51482,54334
50,12,11,Florida,Broward County,2,7,125048,61365,63683
50,12,11,Florida,Broward County,2,8,143477,71280,72197
50,12,11,Florida,Broward County,2,9,135070,67331,67739
50,12,11,Florida,Broward County,2,10,115583,56891,58692
50,12,11,Florida,Broward County,2,11,99503,48713,50790
50,12,11,Florida,Broward County,2,12,76548,36960,39588
50,12,11,Florida,Broward County,2,13,60556,28601,31955
50,12,11,Florida,Broward County,2,14,57034,25513,31521
50,12,11,Florida,Broward County,2,15,59607,25430,34177
50,12,11,Florida,Broward County,2,16,56751,22687,34064
50,12,11,Florida,Broward County,2,17,44664,16976,27688
50,12,11,Florida,Broward County,2,18,43051,15177,27874
50,12,11,Florida,Broward County,3,0,1631723,787791,843932
50,12,11,Florida,Broward County,3,1,103567,53197,50370
50,12,11,Florida,Broward County,3,2,110167,56659,53508
50,12,11,Florida,Broward County,3,3,110209,56483,53726
50,12,11,Florida,Broward County,3,4,95720,48885,46835
50,12,11,Florida,Broward County,3,5,83898,41280,42618
50,12,11,Florida,Broward County,3,6,105804,51475,54329
50,12,11,Florida,Broward County,3,7,125646,61671,63975
50,12,11,Florida,Broward County,3,8,143795,71450,72345
50,12,11,Florida,Broward County,3,9,136205,67894,68311
50,12,11,Florida,Broward County,3,10,116786,57494,59292
50,12,11,Florida,Broward County,3,11,100976,49445,51531
50,12,11,Florida,Broward County,3,12,77370,37374,39996
50,12,11,Florida,Broward County,3,13,61087,28863,32224
50,12,11,Florida,Broward County,3,14,56597,25329,31268
50,12,11,Florida,Broward County,3,15,59264,25321,33943
50,12,11,Florida,Broward County,3,16,56618,22655,33963
50,12,11,Florida,Broward County,3,17,44803,17064,27739
50,12,11,Florida,Broward County,3,18,43211,15252,27959
50,12,11,Florida,Broward County,4,0,1667903,806355,861548
50,12,11,Florida,Broward County,4,1,107183,54890,52293
50,12,11,Florida,Broward County,4,2,111837,57678,54159
50,12,11,Florida,Broward County,4,3,114112,58269,55843
50,12,11,Florida,Broward County,4,4,98648,50707,47941
50,12,11,Florida,Broward County,4,5,87806,43449,44357
50,12,11,Florida,Broward County,4,6,104809,50915,53894
50,12,11,Florida,Broward County,4,7,127660,62708,64952
50,12,11,Florida,Broward County,4,8,144883,71738,73145
50,12,11,Florida,Broward County,4,9,141397,70396,71001
50,12,11,Florida,Broward County,4,10,121414,59894,61520
50,12,11,Florida,Broward County,4,11,106522,52049,54473
50,12,11,Florida,Broward County,4,12,80781,38963,41818
50,12,11,Florida,Broward County,4,13,63010,29918,33092
50,12,11,Florida,Broward County,4,14,55742,25122,30620
50,12,11,Florida,Broward County,4,15,57624,24937,32687
50,12,11,Florida,Broward County,4,16,55511,22134,33377
50,12,11,Florida,Broward County,4,17,45093,17192,27901
50,12,11,Florida,Broward County,4,18,43871,15396,28475
50,12,11,Florida,Broward County,5,0,1698735,822133,876602
50,12,11,Florida,Broward County,5,1,110148,56344,53804
50,12,11,Florida,Broward County,5,2,112944,58334,54610
50,12,11,Florida,Broward County,5,3,117174,59930,57244
50,12,11,Florida,Broward County,5,4,101397,52093,49304
50,12,11,Florida,Broward County,5,5,90902,45125,45777
50,12,11,Florida,Broward County,5,6,105564,51472,54092
50,12,11,Florida,Broward County,5,7,128332,62849,65483
50,12,11,Florida,Broward County,5,8,143868,70931,72937
50,12,11,Florida,Broward County,5,9,145495,72572,72923
50,12,11,Florida,Broward County,5,10,126892,62638,64254
50,12,11,Florida,Broward County,5,11,108230,52685,55545
50,12,11,Florida,Broward County,5,12,87401,42160,45241
50,12,11,Florida,Broward County,5,13,65258,31094,34164
50,12,11,Florida,Broward County,5,14,54860,24994,29866
50,12,11,Florida,Broward County,5,15,55980,24305,31675
50,12,11,Florida,Broward County,5,16,54452,21794,32658
50,12,11,Florida,Broward County,5,17,45143,17234,27909
50,12,11,Florida,Broward County,5,18,44695,15579,29116
50,12,11,Florida,Broward County,6,0,1719073,833396,885677
50,12,11,Florida,Broward County,6,1,112094,57409,54685
50,12,11,Florida,Broward County,6,2,113201,58312,54889
50,12,11,Florida,Broward County,6,3,119183,61223,57960
50,12,11,Florida,Broward County,6,4,104164,53460,50704
50,12,11,Florida,Broward County,6,5,93233,46696,46537
50,12,11,Florida,Broward County,6,6,106474,52218,54256
50,12,11,Florida,Broward County,6,7,127228,62366,64862
50,12,11,Florida,Broward County,6,8,141538,69511,72027
50,12,11,Florida,Broward County,6,9,148093,73923,74170
50,12,11,Florida,Broward County,6,10,131423,64929,66494
50,12,11,Florida,Broward County,6,11,110581,53757,56824
50,12,11,Florida,Broward County,6,12,90768,43836,46932
50,12,11,Florida,Broward County,6,13,69075,32937,36138
50,12,11,Florida,Broward County,6,14,54802,25107,29695
50,12,11,Florida,Broward County,6,15,53938,23548,30390
50,12,11,Florida,Broward County,6,16,53057,21488,31569
50,12,11,Florida,Broward County,6,17,44964,17085,27879
50,12,11,Florida,Broward County,6,18,45257,15591,29666
50,12,11,Florida,Broward County,7,0,1741272,844956,896316
50,12,11,Florida,Broward County,7,1,114968,58767,56201
50,12,11,Florida,Broward County,7,2,112488,57845,54643
50,12,11,Florida,Broward County,7,3,119895,61669,58226
50,12,11,Florida,Broward County,7,4,107509,55234,52275
50,12,11,Florida,Broward County,7,5,96359,48409,47950
50,12,11,Florida,Broward County,7,6,109525,54082,55443
50,12,11,Florida,Broward County,7,7,125497,61368,64129
50,12,11,Florida,Broward County,7,8,138218,67838,70380
50,12,11,Florida,Broward County,7,9,150238,74770,75468
50,12,11,Florida,Broward County,7,10,135899,67250,68649
50,12,11,Florida,Broward County,7,11,113829,55377,58452
50,12,11,Florida,Broward County,7,12,94835,45778,49057
50,12,11,Florida,Broward County,7,13,72350,34413,37937
50,12,11,Florida,Broward County,7,14,55061,25388,29673
50,12,11,Florida,Broward County,7,15,51902,22777,29125
50,12,11,Florida,Broward County,7,16,51742,21271,30471
50,12,11,Florida,Broward County,7,17,45116,17145,27971
50,12,11,Florida,Broward County,7,18,45841,15575,30266
50,12,11,Florida,Broward County,8,0,1766620,858189,908431
50,12,11,Florida,Broward County,8,1,117595,60227,57368
50,12,11,Florida,Broward County,8,2,113172,58117,55055
50,12,11,Florida,Broward County,8,3,119133,61309,57824
50,12,11,Florida,Broward County,8,4,111288,57001,54287
50,12,11,Florida,Broward County,8,5,99242,50099,49143
50,12,11,Florida,Broward County,8,6,112677,55804,56873
50,12,11,Florida,Broward County,8,7,123534,60435,63099
50,12,11,Florida,Broward County,8,8,136892,67090,69802
50,12,11,Florida,Broward County,8,9,150646,74644,76002
50,12,11,Florida,Broward County,8,10,140293,69597,70696
50,12,11,Florida,Broward County,8,11,118157,57575,60582
50,12,11,Florida,Broward County,8,12,99430,48015,51415
50,12,11,Florida,Broward County,8,13,75346,35892,39454
50,12,11,Florida,Broward County,8,14,55894,25968,29926
50,12,11,Florida,Broward County,8,15,50330,22161,28169
50,12,11,Florida,Broward County,8,16,51040,21317,29723
50,12,11,Florida,Broward County,8,17,44805,17007,27798
50,12,11,Florida,Broward County,8,18,47146,15931,31215
50,12,11,Florida,Broward County,9,0,1762334,856861,905473
50,12,11,Florida,Broward County,9,1,116829,59753,57076
50,12,11,Florida,Broward County,9,2,112726,57710,55016
50,12,11,Florida,Broward County,9,3,117247,60504,56743
50,12,11,Florida,Broward County,9,4,112596,57525,55071
50,12,11,Florida,Broward County,9,5,99030,50336,48694
50,12,11,Florida,Broward County,9,6,113742,56539,57203
50,12,11,Florida,Broward County,9,7,119268,58301,60967
50,12,11,Florida,Broward County,9,8,135544,66460,69084
50,12,11,Florida,Broward County,9,9,148481,73336,75145
50,12,11,Florida,Broward County,9,10,142899,70797,72102
50,12,11,Florida,Broward County,9,11,120872,59103,61769
50,12,11,Florida,Broward County,9,12,103238,49818,53420
50,12,11,Florida,Broward County,9,13,77248,36753,40495
50,12,11,Florida,Broward County,9,14,55884,26049,29835
50,12,11,Florida,Broward County,9,15,47904,21227,26677
50,12,11,Florida,Broward County,9,16,48227,20326,27901
50,12,11,Florida,Broward County,9,17,43025,16301,26724
50,12,11,Florida,Broward County,9,18,47574,16023,31551
50,12,11,Florida,Broward County,10,0,1746968,850233,896735
50,12,11,Florida,Broward County,10,1,114959,58732,56227
50,12,11,Florida,Broward County,10,2,110677,56584,54093
50,12,11,Florida,Broward County,10,3,113825,58882,54943
50,12,11,Florida,Broward County,10,4,111957,57314,54643
50,12,11,Florida,Broward County,10,5,99144,50470,48674
50,12,11,Florida,Broward County,10,6,113481,56769,56712
50,12,11,Florida,Broward County,10,7,115460,56690,58770
50,12,11,Florida,Broward County,10,8,131282,64186,67096
50,12,11,Florida,Broward County,10,9,143174,70458,72716
50,12,11,Florida,Broward County,10,10,142902,70961,71941
50,12,11,Florida,Broward County,10,11,123560,60568,62992
50,12,11,Florida,Broward County,10,12,103451,49837,53614
50,12,11,Florida,Broward County,10,13,81215,38616,42599
50,12,11,Florida,Broward County,10,14,57696,27014,30682
50,12,11,Florida,Broward County,10,15,46832,20955,25877
50,12,11,Florida,Broward County,10,16,46750,19811,26939
50,12,11,Florida,Broward County,10,17,42005,15962,26043
50,12,11,Florida,Broward County,10,18,48598,16424,32174
50,12,11,Florida,Broward County,11,0,1753262,853446,899816
50,12,11,Florida,Broward County,11,1,114792,58521,56271
50,12,11,Florida,Broward County,11,2,111595,57150,54445
50,12,11,Florida,Broward County,11,3,111880,57733,54147
50,12,11,Florida,Broward County,11,4,112018,57536,54482
50,12,11,Florida,Broward County,11,5,100741,51154,49587
50,12,11,Florida,Broward County,11,6,113821,57097,56724
50,12,11,Florida,Broward County,11,7,114573,56408,58165
50,12,11,Florida,Broward County,11,8,128475,62793,65682
50,12,11,Florida,Broward County,11,9,139431,68359,71072
50,12,11,Florida,Broward County,11,10,143778,71382,72396
50,12,11,Florida,Broward County,11,11,126787,62205,64582
50,12,11,Florida,Broward County,11,12,105267,50662,54605
50,12,11,Florida,Broward County,11,13,84768,40429,44339
50,12,11,Florida,Broward County,11,14,61503,28853,32650
50,12,11,Florida,Broward County,11,15,47007,21109,25898
50,12,11,Florida,Broward County,11,16,45427,19333,26094
50,12,11,Florida,Broward County,11,17,41319,15967,25352
50,12,11,Florida,Broward County,11,18,50080,16755,33325
50,12,11,Florida,Broward County,12,0,1766476,860504,905972
50,12,11,Florida,Broward County,12,1,114547,58471,56076
50,12,11,Florida,Broward County,12,2,113526,58052,55474
50,12,11,Florida,Broward County,12,3,110460,56939,53521
50,12,11,Florida,Broward County,12,4,111560,57386,54174
50,12,11,Florida,Broward County,12,5,102428,52039,50389
50,12,11,Florida,Broward County,12,6,115533,58061,57472
50,12,11,Florida,Broward County,12,7,116123,57517,58606
50,12,11,Florida,Broward County,12,8,125960,61449,64511
50,12,11,Florida,Broward County,12,9,135914,66649,69265
50,12,11,Florida,Broward County,12,10,145804,72193,73611
50,12,11,Florida,Broward County,12,11,130645,64217,66428
50,12,11,Florida,Broward County,12,12,108111,52045,56066
50,12,11,Florida,Broward County,12,13,88200,41991,46209
50,12,11,Florida,Broward County,12,14,65031,30469,34562
50,12,11,Florida,Broward County,12,15,47461,21422,26039
50,12,11,Florida,Broward County,12,16,43714,18697,25017
50,12,11,Florida,Broward County,12,17,40601,15967,24634
50,12,11,Florida,Broward County,12,18,50858,16940,33918
50,12,13,Florida,Calhoun County,1,0,13017,7024,5993
50,12,13,Florida,Calhoun County,1,1,767,381,386
50,12,13,Florida,Calhoun County,1,2,772,387,385
50,12,13,Florida,Calhoun County,1,3,914,501,413
50,12,13,Florida,Calhoun County,1,4,879,459,420
50,12,13,Florida,Calhoun County,1,5,863,535,328
50,12,13,Florida,Calhoun County,1,6,1029,660,369
50,12,13,Florida,Calhoun County,1,7,1058,682,376
50,12,13,Florida,Calhoun County,1,8,998,617,381
50,12,13,Florida,Calhoun County,1,9,1013,578,435
50,12,13,Florida,Calhoun County,1,10,878,491,387
50,12,13,Florida,Calhoun County,1,11,749,393,356
50,12,13,Florida,Calhoun County,1,12,682,319,363
50,12,13,Florida,Calhoun County,1,13,599,300,299
50,12,13,Florida,Calhoun County,1,14,484,223,261
50,12,13,Florida,Calhoun County,1,15,468,223,245
50,12,13,Florida,Calhoun County,1,16,353,124,229
50,12,13,Florida,Calhoun County,1,17,250,84,166
50,12,13,Florida,Calhoun County,1,18,261,67,194
50,12,13,Florida,Calhoun County,2,0,13017,7024,5993
50,12,13,Florida,Calhoun County,2,1,767,381,386
50,12,13,Florida,Calhoun County,2,2,772,387,385
50,12,13,Florida,Calhoun County,2,3,914,501,413
50,12,13,Florida,Calhoun County,2,4,879,459,420
50,12,13,Florida,Calhoun County,2,5,863,535,328
50,12,13,Florida,Calhoun County,2,6,1029,660,369
50,12,13,Florida,Calhoun County,2,7,1058,682,376
50,12,13,Florida,Calhoun County,2,8,998,617,381
50,12,13,Florida,Calhoun County,2,9,1013,578,435
50,12,13,Florida,Calhoun County,2,10,878,491,387
50,12,13,Florida,Calhoun County,2,11,749,393,356
50,12,13,Florida,Calhoun County,2,12,682,319,363
50,12,13,Florida,Calhoun County,2,13,599,300,299
50,12,13,Florida,Calhoun County,2,14,484,223,261
50,12,13,Florida,Calhoun County,2,15,468,223,245
50,12,13,Florida,Calhoun County,2,16,353,124,229
50,12,13,Florida,Calhoun County,2,17,250,84,166
50,12,13,Florida,Calhoun County,2,18,261,67,194
50,12,13,Florida,Calhoun County,3,0,13040,7032,6008
50,12,13,Florida,Calhoun County,3,1,767,381,386
50,12,13,Florida,Calhoun County,3,2,769,386,383
50,12,13,Florida,Calhoun County,3,3,913,500,413
50,12,13,Florida,Calhoun County,3,4,881,460,421
50,12,13,Florida,Calhoun County,3,5,869,538,331
50,12,13,Florida,Calhoun County,3,6,1023,657,366
50,12,13,Florida,Calhoun County,3,7,1058,682,376
50,12,13,Florida,Calhoun County,3,8,996,616,380
50,12,13,Florida,Calhoun County,3,9,1013,578,435
50,12,13,Florida,Calhoun County,3,10,882,493,389
50,12,13,Florida,Calhoun County,3,11,756,396,360
50,12,13,Florida,Calhoun County,3,12,686,321,365
50,12,13,Florida,Calhoun County,3,13,599,300,299
50,12,13,Florida,Calhoun County,3,14,485,223,262
50,12,13,Florida,Calhoun County,3,15,468,223,245
50,12,13,Florida,Calhoun County,3,16,356,124,232
50,12,13,Florida,Calhoun County,3,17,254,86,168
50,12,13,Florida,Calhoun County,3,18,265,68,197
50,12,13,Florida,Calhoun County,4,0,12734,6803,5931
50,12,13,Florida,Calhoun County,4,1,771,374,397
50,12,13,Florida,Calhoun County,4,2,706,353,353
50,12,13,Florida,Calhoun County,4,3,882,469,413
50,12,13,Florida,Calhoun County,4,4,853,453,400
50,12,13,Florida,Calhoun County,4,5,828,515,313
50,12,13,Florida,Calhoun County,4,6,981,620,361
50,12,13,Florida,Calhoun County,4,7,1004,636,368
50,12,13,Florida,Calhoun County,4,8,970,597,373
50,12,13,Florida,Calhoun County,4,9,963,553,410
50,12,13,Florida,Calhoun County,4,10,896,485,411
50,12,13,Florida,Calhoun County,4,11,762,403,359
50,12,13,Florida,Calhoun County,4,12,690,329,361
50,12,13,Florida,Calhoun County,4,13,576,280,296
50,12,13,Florida,Calhoun County,4,14,511,233,278
50,12,13,Florida,Calhoun County,4,15,453,223,230
50,12,13,Florida,Calhoun County,4,16,360,124,236
50,12,13,Florida,Calhoun County,4,17,268,92,176
50,12,13,Florida,Calhoun County,4,18,260,64,196
50,12,13,Florida,Calhoun County,5,0,12745,6840,5905
50,12,13,Florida,Calhoun County,5,1,757,375,382
50,12,13,Florida,Calhoun County,5,2,719,349,370
50,12,13,Florida,Calhoun County,5,3,854,451,403
50,12,13,Florida,Calhoun County,5,4,841,454,387
50,12,13,Florida,Calhoun County,5,5,832,525,307
50,12,13,Florida,Calhoun County,5,6,969,620,349
50,12,13,Florida,Calhoun County,5,7,1019,651,368
50,12,13,Florida,Calhoun County,5,8,978,600,378
50,12,13,Florida,Calhoun County,5,9,936,533,403
50,12,13,Florida,Calhoun County,5,10,912,500,412
50,12,13,Florida,Calhoun County,5,11,785,427,358
50,12,13,Florida,Calhoun County,5,12,667,305,362
50,12,13,Florida,Calhoun County,5,13,611,304,307
50,12,13,Florida,Calhoun County,5,14,508,225,283
50,12,13,Florida,Calhoun County,5,15,467,232,235
50,12,13,Florida,Calhoun County,5,16,368,134,234
50,12,13,Florida,Calhoun County,5,17,270,91,179
50,12,13,Florida,Calhoun County,5,18,252,64,188
50,12,13,Florida,Calhoun County,6,0,12986,7006,5980
50,12,13,Florida,Calhoun County,6,1,779,403,376
50,12,13,Florida,Calhoun County,6,2,766,360,406
50,12,13,Florida,Calhoun County,6,3,820,431,389
50,12,13,Florida,Calhoun County,6,4,853,461,392
50,12,13,Florida,Calhoun County,6,5,901,564,337
50,12,13,Florida,Calhoun County,6,6,983,648,335
50,12,13,Florida,Calhoun County,6,7,1000,627,373
50,12,13,Florida,Calhoun County,6,8,1008,639,369
50,12,13,Florida,Calhoun County,6,9,955,550,405
50,12,13,Florida,Calhoun County,6,10,921,498,423
50,12,13,Florida,Calhoun County,6,11,782,421,361
50,12,13,Florida,Calhoun County,6,12,699,330,369
50,12,13,Florida,Calhoun County,6,13,605,293,312
50,12,13,Florida,Calhoun County,6,14,539,254,285
50,12,13,Florida,Calhoun County,6,15,459,217,242
50,12,13,Florida,Calhoun County,6,16,376,154,222
50,12,13,Florida,Calhoun County,6,17,273,77,196
50,12,13,Florida,Calhoun County,6,18,267,79,188
50,12,13,Florida,Calhoun County,7,0,13058,7092,5966
50,12,13,Florida,Calhoun County,7,1,767,388,379
50,12,13,Florida,Calhoun County,7,2,777,374,403
50,12,13,Florida,Calhoun County,7,3,814,417,397
50,12,13,Florida,Calhoun County,7,4,825,462,363
50,12,13,Florida,Calhoun County,7,5,912,580,332
50,12,13,Florida,Calhoun County,7,6,1040,684,356
50,12,13,Florida,Calhoun County,7,7,1021,647,374
50,12,13,Florida,Calhoun County,7,8,990,632,358
50,12,13,Florida,Calhoun County,7,9,949,559,390
50,12,13,Florida,Calhoun County,7,10,931,506,425
50,12,13,Florida,Calhoun County,7,11,769,408,361
50,12,13,Florida,Calhoun County,7,12,729,355,374
50,12,13,Florida,Calhoun County,7,13,624,296,328
50,12,13,Florida,Calhoun County,7,14,531,268,263
50,12,13,Florida,Calhoun County,7,15,450,197,253
50,12,13,Florida,Calhoun County,7,16,373,159,214
50,12,13,Florida,Calhoun County,7,17,282,83,199
50,12,13,Florida,Calhoun County,7,18,274,77,197
50,12,13,Florida,Calhoun County,8,0,13352,7233,6119
50,12,13,Florida,Calhoun County,8,1,772,387,385
50,12,13,Florida,Calhoun County,8,2,831,416,415
50,12,13,Florida,Calhoun County,8,3,809,405,404
50,12,13,Florida,Calhoun County,8,4,861,475,386
50,12,13,Florida,Calhoun County,8,5,979,620,359
50,12,13,Florida,Calhoun County,8,6,1015,666,349
50,12,13,Florida,Calhoun County,8,7,1020,641,379
50,12,13,Florida,Calhoun County,8,8,1027,651,376
50,12,13,Florida,Calhoun County,8,9,942,561,381
50,12,13,Florida,Calhoun County,8,10,963,523,440
50,12,13,Florida,Calhoun County,8,11,793,411,382
50,12,13,Florida,Calhoun County,8,12,714,355,359
50,12,13,Florida,Calhoun County,8,13,657,299,358
50,12,13,Florida,Calhoun County,8,14,544,272,272
50,12,13,Florida,Calhoun County,8,15,444,193,251
50,12,13,Florida,Calhoun County,8,16,404,188,216
50,12,13,Florida,Calhoun County,8,17,276,78,198
50,12,13,Florida,Calhoun County,8,18,301,92,209
50,12,13,Florida,Calhoun County,9,0,13394,7244,6150
50,12,13,Florida,Calhoun County,9,1,801,407,394
50,12,13,Florida,Calhoun County,9,2,809,395,414
50,12,13,Florida,Calhoun County,9,3,750,374,376
50,12,13,Florida,Calhoun County,9,4,821,444,377
50,12,13,Florida,Calhoun County,9,5,1006,636,370
50,12,13,Florida,Calhoun County,9,6,1038,684,354
50,12,13,Florida,Calhoun County,9,7,1017,636,381
50,12,13,Florida,Calhoun County,9,8,1035,649,386
50,12,13,Florida,Calhoun County,9,9,939,563,376
50,12,13,Florida,Calhoun County,9,10,944,524,420
50,12,13,Florida,Calhoun County,9,11,846,427,419
50,12,13,Florida,Calhoun County,9,12,728,369,359
50,12,13,Florida,Calhoun County,9,13,664,308,356
50,12,13,Florida,Calhoun County,9,14,523,251,272
50,12,13,Florida,Calhoun County,9,15,466,206,260
50,12,13,Florida,Calhoun County,9,16,399,189,210
50,12,13,Florida,Calhoun County,9,17,291,87,204
50,12,13,Florida,Calhoun County,9,18,317,95,222
50,12,13,Florida,Calhoun County,10,0,13515,7323,6192
50,12,13,Florida,Calhoun County,10,1,793,396,397
50,12,13,Florida,Calhoun County,10,2,802,399,403
50,12,13,Florida,Calhoun County,10,3,780,381,399
50,12,13,Florida,Calhoun County,10,4,821,440,381
50,12,13,Florida,Calhoun County,10,5,1017,650,367
50,12,13,Florida,Calhoun County,10,6,1053,701,352
50,12,13,Florida,Calhoun County,10,7,1023,641,382
50,12,13,Florida,Calhoun County,10,8,1051,664,387
50,12,13,Florida,Calhoun County,10,9,977,581,396
50,12,13,Florida,Calhoun County,10,10,908,501,407
50,12,13,Florida,Calhoun County,10,11,860,438,422
50,12,13,Florida,Calhoun County,10,12,776,403,373
50,12,13,Florida,Calhoun County,10,13,649,287,362
50,12,13,Florida,Calhoun County,10,14,544,271,273
50,12,13,Florida,Calhoun County,10,15,452,200,252
50,12,13,Florida,Calhoun County,10,16,397,182,215
50,12,13,Florida,Calhoun County,10,17,295,99,196
50,12,13,Florida,Calhoun County,10,18,317,89,228
50,12,13,Florida,Calhoun County,11,0,13543,7330,6213
50,12,13,Florida,Calhoun County,11,1,833,412,421
50,12,13,Florida,Calhoun County,11,2,780,403,377
50,12,13,Florida,Calhoun County,11,3,774,364,410
50,12,13,Florida,Calhoun County,11,4,784,420,364
50,12,13,Florida,Calhoun County,11,5,1017,647,370
50,12,13,Florida,Calhoun County,11,6,1106,729,377
50,12,13,Florida,Calhoun County,11,7,989,636,353
50,12,13,Florida,Calhoun County,11,8,997,615,382
50,12,13,Florida,Calhoun County,11,9,1003,612,391
50,12,13,Florida,Calhoun County,11,10,911,505,406
50,12,13,Florida,Calhoun County,11,11,873,434,439
50,12,13,Florida,Calhoun County,11,12,768,393,375
50,12,13,Florida,Calhoun County,11,13,673,307,366
50,12,13,Florida,Calhoun County,11,14,556,267,289
50,12,13,Florida,Calhoun County,11,15,460,218,242
50,12,13,Florida,Calhoun County,11,16,389,164,225
50,12,13,Florida,Calhoun County,11,17,301,113,188
50,12,13,Florida,Calhoun County,11,18,329,91,238
50,12,13,Florida,Calhoun County,12,0,13821,7616,6205
50,12,13,Florida,Calhoun County,12,1,845,418,427
50,12,13,Florida,Calhoun County,12,2,795,401,394
50,12,13,Florida,Calhoun County,12,3,779,374,405
50,12,13,Florida,Calhoun County,12,4,761,402,359
50,12,13,Florida,Calhoun County,12,5,1054,707,347
50,12,13,Florida,Calhoun County,12,6,1172,795,377
50,12,13,Florida,Calhoun County,12,7,1074,706,368
50,12,13,Florida,Calhoun County,12,8,1015,643,372
50,12,13,Florida,Calhoun County,12,9,1006,622,384
50,12,13,Florida,Calhoun County,12,10,908,522,386
50,12,13,Florida,Calhoun County,12,11,908,458,450
50,12,13,Florida,Calhoun County,12,12,747,375,372
50,12,13,Florida,Calhoun County,12,13,699,329,370
50,12,13,Florida,Calhoun County,12,14,583,276,307
50,12,13,Florida,Calhoun County,12,15,459,230,229
50,12,13,Florida,Calhoun County,12,16,385,153,232
50,12,13,Florida,Calhoun County,12,17,292,109,183
50,12,13,Florida,Calhoun County,12,18,339,96,243
50,12,15,Florida,Charlotte County,1,0,141627,67648,73979
50,12,15,Florida,Charlotte County,1,1,5254,2633,2621
50,12,15,Florida,Charlotte County,1,2,6119,3113,3006
50,12,15,Florida,Charlotte County,1,3,6761,3409,3352
50,12,15,Florida,Charlotte County,1,4,6184,3170,3014
50,12,15,Florida,Charlotte County,1,5,4215,2220,1995
50,12,15,Florida,Charlotte County,1,6,4834,2428,2406
50,12,15,Florida,Charlotte County,1,7,5945,3020,2925
50,12,15,Florida,Charlotte County,1,8,7590,3726,3864
50,12,15,Florida,Charlotte County,1,9,8233,4010,4223
50,12,15,Florida,Charlotte County,1,10,8141,3761,4380
50,12,15,Florida,Charlotte County,1,11,8618,3862,4756
50,12,15,Florida,Charlotte County,1,12,9575,4232,5343
50,12,15,Florida,Charlotte County,1,13,10991,5016,5975
50,12,15,Florida,Charlotte County,1,14,12862,6365,6497
50,12,15,Florida,Charlotte County,1,15,13214,6323,6891
50,12,15,Florida,Charlotte County,1,16,11095,5291,5804
50,12,15,Florida,Charlotte County,1,17,6916,3133,3783
50,12,15,Florida,Charlotte County,1,18,5080,1936,3144
50,12,15,Florida,Charlotte County,2,0,141627,67648,73979
50,12,15,Florida,Charlotte County,2,1,5254,2633,2621
50,12,15,Florida,Charlotte County,2,2,6119,3113,3006
50,12,15,Florida,Charlotte County,2,3,6761,3409,3352
50,12,15,Florida,Charlotte County,2,4,6184,3170,3014
50,12,15,Florida,Charlotte County,2,5,4215,2220,1995
50,12,15,Florida,Charlotte County,2,6,4834,2428,2406
50,12,15,Florida,Charlotte County,2,7,5945,3020,2925
50,12,15,Florida,Charlotte County,2,8,7590,3726,3864
50,12,15,Florida,Charlotte County,2,9,8233,4010,4223
50,12,15,Florida,Charlotte County,2,10,8141,3761,4380
50,12,15,Florida,Charlotte County,2,11,8618,3862,4756
50,12,15,Florida,Charlotte County,2,12,9575,4232,5343
50,12,15,Florida,Charlotte County,2,13,10991,5016,5975
50,12,15,Florida,Charlotte County,2,14,12862,6365,6497
50,12,15,Florida,Charlotte County,2,15,13214,6323,6891
50,12,15,Florida,Charlotte County,2,16,11095,5291,5804
50,12,15,Florida,Charlotte County,2,17,6916,3133,3783
50,12,15,Florida,Charlotte County,2,18,5080,1936,3144
50,12,15,Florida,Charlotte County,3,0,142246,67959,74287
50,12,15,Florida,Charlotte County,3,1,5268,2639,2629
50,12,15,Florida,Charlotte County,3,2,6108,3107,3001
50,12,15,Florida,Charlotte County,3,3,6805,3431,3374
50,12,15,Florida,Charlotte County,3,4,6213,3187,3026
50,12,15,Florida,Charlotte County,3,5,4271,2252,2019
50,12,15,Florida,Charlotte County,3,6,4812,2418,2394
50,12,15,Florida,Charlotte County,3,7,5957,3026,2931
50,12,15,Florida,Charlotte County,3,8,7583,3723,3860
50,12,15,Florida,Charlotte County,3,9,8274,4030,4244
50,12,15,Florida,Charlotte County,3,10,8213,3794,4419
50,12,15,Florida,Charlotte County,3,11,8729,3911,4818
50,12,15,Florida,Charlotte County,3,12,9666,4273,5393
50,12,15,Florida,Charlotte County,3,13,11061,5049,6012
50,12,15,Florida,Charlotte County,3,14,12827,6349,6478
50,12,15,Florida,Charlotte County,3,15,13214,6331,6883
50,12,15,Florida,Charlotte County,3,16,11132,5312,5820
50,12,15,Florida,Charlotte County,3,17,6983,3168,3815
50,12,15,Florida,Charlotte County,3,18,5130,1959,3171
50,12,15,Florida,Charlotte County,4,0,146008,69931,76077
50,12,15,Florida,Charlotte County,4,1,5365,2698,2667
50,12,15,Florida,Charlotte County,4,2,6024,3038,2986
50,12,15,Florida,Charlotte County,4,3,7001,3596,3405
50,12,15,Florida,Charlotte County,4,4,6398,3260,3138
50,12,15,Florida,Charlotte County,4,5,4503,2404,2099
50,12,15,Florida,Charlotte County,4,6,4623,2346,2277
50,12,15,Florida,Charlotte County,4,7,6052,3096,2956
50,12,15,Florida,Charlotte County,4,8,7487,3698,3789
50,12,15,Florida,Charlotte County,4,9,8659,4238,4421
50,12,15,Florida,Charlotte County,4,10,8494,3924,4570
50,12,15,Florida,Charlotte County,4,11,9445,4300,5145
50,12,15,Florida,Charlotte County,4,12,10055,4475,5580
50,12,15,Florida,Charlotte County,4,13,11445,5233,6212
50,12,15,Florida,Charlotte County,4,14,12661,6147,6514
50,12,15,Florida,Charlotte County,4,15,13443,6516,6927
50,12,15,Florida,Charlotte County,4,16,11487,5423,6064
50,12,15,Florida,Charlotte County,4,17,7309,3351,3958
50,12,15,Florida,Charlotte County,4,18,5557,2188,3369
50,12,15,Florida,Charlotte County,5,0,149473,71618,77855
50,12,15,Florida,Charlotte County,5,1,5316,2661,2655
50,12,15,Florida,Charlotte County,5,2,6109,3094,3015
50,12,15,Florida,Charlotte County,5,3,7154,3630,3524
50,12,15,Florida,Charlotte County,5,4,6641,3460,3181
50,12,15,Florida,Charlotte County,5,5,4858,2547,2311
50,12,15,Florida,Charlotte County,5,6,4600,2358,2242
50,12,15,Florida,Charlotte County,5,7,6080,3094,2986
50,12,15,Florida,Charlotte County,5,8,7335,3649,3686
50,12,15,Florida,Charlotte County,5,9,8936,4343,4593
50,12,15,Florida,Charlotte County,5,10,8864,4140,4724
50,12,15,Florida,Charlotte County,5,11,9596,4429,5167
50,12,15,Florida,Charlotte County,5,12,10895,4860,6035
50,12,15,Florida,Charlotte County,5,13,11819,5413,6406
50,12,15,Florida,Charlotte County,5,14,12536,5996,6540
50,12,15,Florida,Charlotte County,5,15,13364,6514,6850
50,12,15,Florida,Charlotte County,5,16,11768,5526,6242
50,12,15,Florida,Charlotte County,5,17,7792,3597,4195
50,12,15,Florida,Charlotte County,5,18,5810,2307,3503
50,12,15,Florida,Charlotte County,6,0,152138,72856,79282
50,12,15,Florida,Charlotte County,6,1,5515,2758,2757
50,12,15,Florida,Charlotte County,6,2,6169,3145,3024
50,12,15,Florida,Charlotte County,6,3,7255,3707,3548
50,12,15,Florida,Charlotte County,6,4,6915,3562,3353
50,12,15,Florida,Charlotte County,6,5,5070,2614,2456
50,12,15,Florida,Charlotte County,6,6,4627,2422,2205
50,12,15,Florida,Charlotte County,6,7,6037,3037,3000
50,12,15,Florida,Charlotte County,6,8,7158,3527,3631
50,12,15,Florida,Charlotte County,6,9,8996,4375,4621
50,12,15,Florida,Charlotte County,6,10,9170,4319,4851
50,12,15,Florida,Charlotte County,6,11,9820,4515,5305
50,12,15,Florida,Charlotte County,6,12,11327,5079,6248
50,12,15,Florida,Charlotte County,6,13,12472,5672,6800
50,12,15,Florida,Charlotte County,6,14,12586,5967,6619
50,12,15,Florida,Charlotte County,6,15,12933,6293,6640
50,12,15,Florida,Charlotte County,6,16,11820,5627,6193
50,12,15,Florida,Charlotte County,6,17,8173,3803,4370
50,12,15,Florida,Charlotte County,6,18,6095,2434,3661
50,12,15,Florida,Charlotte County,7,0,156281,75121,81160
50,12,15,Florida,Charlotte County,7,1,5588,2829,2759
50,12,15,Florida,Charlotte County,7,2,6384,3232,3152
50,12,15,Florida,Charlotte County,7,3,7368,3773,3595
50,12,15,Florida,Charlotte County,7,4,7085,3657,3428
50,12,15,Florida,Charlotte County,7,5,5510,2866,2644
50,12,15,Florida,Charlotte County,7,6,4923,2609,2314
50,12,15,Florida,Charlotte County,7,7,6015,3071,2944
50,12,15,Florida,Charlotte County,7,8,7244,3650,3594
50,12,15,Florida,Charlotte County,7,9,9075,4427,4648
50,12,15,Florida,Charlotte County,7,10,9784,4658,5126
50,12,15,Florida,Charlotte County,7,11,10027,4584,5443
50,12,15,Florida,Charlotte County,7,12,11956,5389,6567
50,12,15,Florida,Charlotte County,7,13,13135,5887,7248
50,12,15,Florida,Charlotte County,7,14,12799,6096,6703
50,12,15,Florida,Charlotte County,7,15,12615,6185,6430
50,12,15,Florida,Charlotte County,7,16,11753,5603,6150
50,12,15,Florida,Charlotte County,7,17,8518,3957,4561
50,12,15,Florida,Charlotte County,7,18,6502,2648,3854
50,12,15,Florida,Charlotte County,8,0,153407,73828,79579
50,12,15,Florida,Charlotte County,8,1,5549,2852,2697
50,12,15,Florida,Charlotte County,8,2,6075,3062,3013
50,12,15,Florida,Charlotte County,8,3,7105,3629,3476
50,12,15,Florida,Charlotte County,8,4,7176,3701,3475
50,12,15,Florida,Charlotte County,8,5,5388,2812,2576
50,12,15,Florida,Charlotte County,8,6,5021,2714,2307
50,12,15,Florida,Charlotte County,8,7,5624,2842,2782
50,12,15,Florida,Charlotte County,8,8,7033,3566,3467
50,12,15,Florida,Charlotte County,8,9,8930,4385,4545
50,12,15,Florida,Charlotte County,8,10,9824,4704,5120
50,12,15,Florida,Charlotte County,8,11,10091,4608,5483
50,12,15,Florida,Charlotte County,8,12,12267,5507,6760
50,12,15,Florida,Charlotte County,8,13,13252,5997,7255
50,12,15,Florida,Charlotte County,8,14,12343,5760,6583
50,12,15,Florida,Charlotte County,8,15,11870,5860,6010
50,12,15,Florida,Charlotte County,8,16,10975,5232,5743
50,12,15,Florida,Charlotte County,8,17,8406,3947,4459
50,12,15,Florida,Charlotte County,8,18,6478,2650,3828
50,12,15,Florida,Charlotte County,9,0,154885,74627,80258
50,12,15,Florida,Charlotte County,9,1,5718,2963,2755
50,12,15,Florida,Charlotte County,9,2,6220,3145,3075
50,12,15,Florida,Charlotte County,9,3,7032,3568,3464
50,12,15,Florida,Charlotte County,9,4,7336,3832,3504
50,12,15,Florida,Charlotte County,9,5,5766,2968,2798
50,12,15,Florida,Charlotte County,9,6,5436,2941,2495
50,12,15,Florida,Charlotte County,9,7,5492,2784,2708
50,12,15,Florida,Charlotte County,9,8,7184,3644,3540
50,12,15,Florida,Charlotte County,9,9,8770,4311,4459
50,12,15,Florida,Charlotte County,9,10,10069,4843,5226
50,12,15,Florida,Charlotte County,9,11,10288,4698,5590
50,12,15,Florida,Charlotte County,9,12,12502,5650,6852
50,12,15,Florida,Charlotte County,9,13,13236,5994,7242
50,12,15,Florida,Charlotte County,9,14,12233,5681,6552
50,12,15,Florida,Charlotte County,9,15,11306,5489,5817
50,12,15,Florida,Charlotte County,9,16,10911,5298,5613
50,12,15,Florida,Charlotte County,9,17,8423,3902,4521
50,12,15,Florida,Charlotte County,9,18,6963,2916,4047
50,12,15,Florida,Charlotte County,10,0,157235,75871,81364
50,12,15,Florida,Charlotte County,10,1,5913,3082,2831
50,12,15,Florida,Charlotte County,10,2,6289,3165,3124
50,12,15,Florida,Charlotte County,10,3,7059,3602,3457
50,12,15,Florida,Charlotte County,10,4,7440,3856,3584
50,12,15,Florida,Charlotte County,10,5,6038,3181,2857
50,12,15,Florida,Charlotte County,10,6,5743,3070,2673
50,12,15,Florida,Charlotte County,10,7,5618,2875,2743
50,12,15,Florida,Charlotte County,10,8,7122,3604,3518
50,12,15,Florida,Charlotte County,10,9,8578,4248,4330
50,12,15,Florida,Charlotte County,10,10,10168,4861,5307
50,12,15,Florida,Charlotte County,10,11,10439,4832,5607
50,12,15,Florida,Charlotte County,10,12,12180,5552,6628
50,12,15,Florida,Charlotte County,10,13,13890,6290,7600
50,12,15,Florida,Charlotte County,10,14,12608,5840,6768
50,12,15,Florida,Charlotte County,10,15,11210,5359,5851
50,12,15,Florida,Charlotte County,10,16,10861,5275,5586
50,12,15,Florida,Charlotte County,10,17,8601,3974,4627
50,12,15,Florida,Charlotte County,10,18,7478,3205,4273
50,12,15,Florida,Charlotte County,11,0,157736,76092,81644
50,12,15,Florida,Charlotte County,11,1,5948,3115,2833
50,12,15,Florida,Charlotte County,11,2,6250,3140,3110
50,12,15,Florida,Charlotte County,11,3,6824,3504,3320
50,12,15,Florida,Charlotte County,11,4,7332,3814,3518
50,12,15,Florida,Charlotte County,11,5,6168,3215,2953
50,12,15,Florida,Charlotte County,11,6,5777,3055,2722
50,12,15,Florida,Charlotte County,11,7,5443,2863,2580
50,12,15,Florida,Charlotte County,11,8,6961,3518,3443
50,12,15,Florida,Charlotte County,11,9,8196,4053,4143
50,12,15,Florida,Charlotte County,11,10,10109,4858,5251
50,12,15,Florida,Charlotte County,11,11,10520,4918,5602
50,12,15,Florida,Charlotte County,11,12,11894,5415,6479
50,12,15,Florida,Charlotte County,11,13,13922,6301,7621
50,12,15,Florida,Charlotte County,11,14,13504,6210,7294
50,12,15,Florida,Charlotte County,11,15,11418,5395,6023
50,12,15,Florida,Charlotte County,11,16,10666,5140,5526
50,12,15,Florida,Charlotte County,11,17,8771,4134,4637
50,12,15,Florida,Charlotte County,11,18,8033,3444,4589
50,12,15,Florida,Charlotte County,12,0,156952,75658,81294
50,12,15,Florida,Charlotte County,12,1,5961,3100,2861
50,12,15,Florida,Charlotte County,12,2,5959,3027,2932
50,12,15,Florida,Charlotte County,12,3,6693,3414,3279
50,12,15,Florida,Charlotte County,12,4,7104,3707,3397
50,12,15,Florida,Charlotte County,12,5,5948,3097,2851
50,12,15,Florida,Charlotte County,12,6,5729,3038,2691
50,12,15,Florida,Charlotte County,12,7,5311,2806,2505
50,12,15,Florida,Charlotte County,12,8,6558,3335,3223
50,12,15,Florida,Charlotte County,12,9,7809,3908,3901
50,12,15,Florida,Charlotte County,12,10,9800,4698,5102
50,12,15,Florida,Charlotte County,12,11,10745,5061,5684
50,12,15,Florida,Charlotte County,12,12,11490,5191,6299
50,12,15,Florida,Charlotte County,12,13,14031,6349,7682
50,12,15,Florida,Charlotte County,12,14,14182,6434,7748
50,12,15,Florida,Charlotte County,12,15,11730,5552,6178
50,12,15,Florida,Charlotte County,12,16,10542,5114,5428
50,12,15,Florida,Charlotte County,12,17,8845,4160,4685
50,12,15,Florida,Charlotte County,12,18,8515,3667,4848
50,12,17,Florida,Citrus County,1,0,118085,56691,61394
50,12,17,Florida,Citrus County,1,1,4469,2271,2198
50,12,17,Florida,Citrus County,1,2,5540,2874,2666
50,12,17,Florida,Citrus County,1,3,6477,3374,3103
50,12,17,Florida,Citrus County,1,4,5690,2922,2768
50,12,17,Florida,Citrus County,1,5,3528,1783,1745
50,12,17,Florida,Citrus County,1,6,4097,1979,2118
50,12,17,Florida,Citrus County,1,7,5009,2387,2622
50,12,17,Florida,Citrus County,1,8,6408,3102,3306
50,12,17,Florida,Citrus County,1,9,7099,3427,3672
50,12,17,Florida,Citrus County,1,10,6937,3292,3645
50,12,17,Florida,Citrus County,1,11,7390,3357,4033
50,12,17,Florida,Citrus County,1,12,8185,3695,4490
50,12,17,Florida,Citrus County,1,13,9246,4387,4859
50,12,17,Florida,Citrus County,1,14,10194,5007,5187
50,12,17,Florida,Citrus County,1,15,10371,5092,5279
50,12,17,Florida,Citrus County,1,16,8502,3964,4538
50,12,17,Florida,Citrus County,1,17,5205,2387,2818
50,12,17,Florida,Citrus County,1,18,3738,1391,2347
50,12,17,Florida,Citrus County,2,0,118085,56691,61394
50,12,17,Florida,Citrus County,2,1,4469,2271,2198
50,12,17,Florida,Citrus County,2,2,5540,2874,2666
50,12,17,Florida,Citrus County,2,3,6477,3374,3103
50,12,17,Florida,Citrus County,2,4,5690,2922,2768
50,12,17,Florida,Citrus County,2,5,3528,1783,1745
50,12,17,Florida,Citrus County,2,6,4097,1979,2118
50,12,17,Florida,Citrus County,2,7,5009,2387,2622
50,12,17,Florida,Citrus County,2,8,6408,3102,3306
50,12,17,Florida,Citrus County,2,9,7099,3427,3672
50,12,17,Florida,Citrus County,2,10,6937,3292,3645
50,12,17,Florida,Citrus County,2,11,7390,3357,4033
50,12,17,Florida,Citrus County,2,12,8185,3695,4490
50,12,17,Florida,Citrus County,2,13,9246,4387,4859
50,12,17,Florida,Citrus County,2,14,10194,5007,5187
50,12,17,Florida,Citrus County,2,15,10371,5092,5279
50,12,17,Florida,Citrus County,2,16,8502,3964,4538
50,12,17,Florida,Citrus County,2,17,5205,2387,2818
50,12,17,Florida,Citrus County,2,18,3738,1391,2347
50,12,17,Florida,Citrus County,3,0,118639,56977,61662
50,12,17,Florida,Citrus County,3,1,4482,2278,2204
50,12,17,Florida,Citrus County,3,2,5529,2869,2660
50,12,17,Florida,Citrus County,3,3,6521,3396,3125
50,12,17,Florida,Citrus County,3,4,5721,2939,2782
50,12,17,Florida,Citrus County,3,5,3578,1810,1768
50,12,17,Florida,Citrus County,3,6,4079,1972,2107
50,12,17,Florida,Citrus County,3,7,5020,2393,2627
50,12,17,Florida,Citrus County,3,8,6401,3099,3302
50,12,17,Florida,Citrus County,3,9,7140,3447,3693
50,12,17,Florida,Citrus County,3,10,7006,3324,3682
50,12,17,Florida,Citrus County,3,11,7494,3404,4090
50,12,17,Florida,Citrus County,3,12,8265,3734,4531
50,12,17,Florida,Citrus County,3,13,9311,4418,4893
50,12,17,Florida,Citrus County,3,14,10169,4996,5173
50,12,17,Florida,Citrus County,3,15,10366,5096,5270
50,12,17,Florida,Citrus County,3,16,8526,3979,4547
50,12,17,Florida,Citrus County,3,17,5258,2416,2842
50,12,17,Florida,Citrus County,3,18,3773,1407,2366
50,12,17,Florida,Citrus County,4,0,121081,58145,62936
50,12,17,Florida,Citrus County,4,1,4485,2267,2218
50,12,17,Florida,Citrus County,4,2,5536,2854,2682
50,12,17,Florida,Citrus County,4,3,6592,3408,3184
50,12,17,Florida,Citrus County,4,4,6113,3184,2929
50,12,17,Florida,Citrus County,4,5,3840,1925,1915
50,12,17,Florida,Citrus County,4,6,3880,1911,1969
50,12,17,Florida,Citrus County,4,7,5020,2420,2600
50,12,17,Florida,Citrus County,4,8,6372,3046,3326
50,12,17,Florida,Citrus County,4,9,7319,3562,3757
50,12,17,Florida,Citrus County,4,10,7305,3475,3830
50,12,17,Florida,Citrus County,4,11,7936,3632,4304
50,12,17,Florida,Citrus County,4,12,8597,3874,4723
50,12,17,Florida,Citrus County,4,13,9571,4488,5083
50,12,17,Florida,Citrus County,4,14,10052,4868,5184
50,12,17,Florida,Citrus County,4,15,10252,5099,5153
50,12,17,Florida,Citrus County,4,16,8638,4029,4609
50,12,17,Florida,Citrus County,4,17,5558,2577,2981
50,12,17,Florida,Citrus County,4,18,4015,1526,2489
50,12,17,Florida,Citrus County,5,0,123243,59199,64044
50,12,17,Florida,Citrus County,5,1,4485,2272,2213
50,12,17,Florida,Citrus County,5,2,5446,2800,2646
50,12,17,Florida,Citrus County,5,3,6730,3477,3253
50,12,17,Florida,Citrus County,5,4,6346,3337,3009
50,12,17,Florida,Citrus County,5,5,4121,2019,2102
50,12,17,Florida,Citrus County,5,6,3720,1877,1843
50,12,17,Florida,Citrus County,5,7,5092,2444,2648
50,12,17,Florida,Citrus County,5,8,6281,3035,3246
50,12,17,Florida,Citrus County,5,9,7386,3553,3833
50,12,17,Florida,Citrus County,5,10,7586,3653,3933
50,12,17,Florida,Citrus County,5,11,7891,3580,4311
50,12,17,Florida,Citrus County,5,12,9182,4150,5032
50,12,17,Florida,Citrus County,5,13,10023,4677,5346
50,12,17,Florida,Citrus County,5,14,10104,4890,5214
50,12,17,Florida,Citrus County,5,15,10017,4964,5053
50,12,17,Florida,Citrus County,5,16,8781,4135,4646
50,12,17,Florida,Citrus County,5,17,5829,2697,3132
50,12,17,Florida,Citrus County,5,18,4223,1639,2584
50,12,17,Florida,Citrus County,6,0,125757,60408,65349
50,12,17,Florida,Citrus County,6,1,4581,2311,2270
50,12,17,Florida,Citrus County,6,2,5442,2807,2635
50,12,17,Florida,Citrus County,6,3,6732,3458,3274
50,12,17,Florida,Citrus County,6,4,6457,3420,3037
50,12,17,Florida,Citrus County,6,5,4356,2146,2210
50,12,17,Florida,Citrus County,6,6,3788,1944,1844
50,12,17,Florida,Citrus County,6,7,5069,2442,2627
50,12,17,Florida,Citrus County,6,8,6249,3005,3244
50,12,17,Florida,Citrus County,6,9,7471,3588,3883
50,12,17,Florida,Citrus County,6,10,7925,3799,4126
50,12,17,Florida,Citrus County,6,11,7957,3646,4311
50,12,17,Florida,Citrus County,6,12,9586,4334,5252
50,12,17,Florida,Citrus County,6,13,10486,4875,5611
50,12,17,Florida,Citrus County,6,14,10458,5050,5408
50,12,17,Florida,Citrus County,6,15,9915,4870,5045
50,12,17,Florida,Citrus County,6,16,8796,4181,4615
50,12,17,Florida,Citrus County,6,17,6030,2760,3270
50,12,17,Florida,Citrus County,6,18,4459,1772,2687
50,12,17,Florida,Citrus County,7,0,129208,62091,67117
50,12,17,Florida,Citrus County,7,1,4728,2407,2321
50,12,17,Florida,Citrus County,7,2,5506,2803,2703
50,12,17,Florida,Citrus County,7,3,6822,3526,3296
50,12,17,Florida,Citrus County,7,4,6719,3538,3181
50,12,17,Florida,Citrus County,7,5,4699,2372,2327
50,12,17,Florida,Citrus County,7,6,3937,1996,1941
50,12,17,Florida,Citrus County,7,7,5015,2429,2586
50,12,17,Florida,Citrus County,7,8,6248,2987,3261
50,12,17,Florida,Citrus County,7,9,7664,3702,3962
50,12,17,Florida,Citrus County,7,10,8290,3986,4304
50,12,17,Florida,Citrus County,7,11,8284,3840,4444
50,12,17,Florida,Citrus County,7,12,10026,4518,5508
50,12,17,Florida,Citrus County,7,13,10987,5069,5918
50,12,17,Florida,Citrus County,7,14,10719,5145,5574
50,12,17,Florida,Citrus County,7,15,9812,4778,5034
50,12,17,Florida,Citrus County,7,16,8785,4209,4576
50,12,17,Florida,Citrus County,7,17,6363,2912,3451
50,12,17,Florida,Citrus County,7,18,4604,1874,2730
50,12,17,Florida,Citrus County,8,0,132947,63867,69080
50,12,17,Florida,Citrus County,8,1,4915,2519,2396
50,12,17,Florida,Citrus County,8,2,5606,2837,2769
50,12,17,Florida,Citrus County,8,3,6787,3492,3295
50,12,17,Florida,Citrus County,8,4,7048,3717,3331
50,12,17,Florida,Citrus County,8,5,4893,2469,2424
50,12,17,Florida,Citrus County,8,6,4408,2235,2173
50,12,17,Florida,Citrus County,8,7,4900,2383,2517
50,12,17,Florida,Citrus County,8,8,6187,2946,3241
50,12,17,Florida,Citrus County,8,9,7801,3787,4014
50,12,17,Florida,Citrus County,8,10,8591,4130,4461
50,12,17,Florida,Citrus County,8,11,8887,4153,4734
50,12,17,Florida,Citrus County,8,12,10477,4743,5734
50,12,17,Florida,Citrus County,8,13,11626,5332,6294
50,12,17,Florida,Citrus County,8,14,10962,5221,5741
50,12,17,Florida,Citrus County,8,15,9725,4725,5000
50,12,17,Florida,Citrus County,8,16,8758,4211,4547
50,12,17,Florida,Citrus County,8,17,6449,2926,3523
50,12,17,Florida,Citrus County,8,18,4927,2041,2886
50,12,17,Florida,Citrus County,9,0,136796,65715,71081
50,12,17,Florida,Citrus County,9,1,5179,2654,2525
50,12,17,Florida,Citrus County,9,2,5783,2914,2869
50,12,17,Florida,Citrus County,9,3,6893,3531,3362
50,12,17,Florida,Citrus County,9,4,7191,3770,3421
50,12,17,Florida,Citrus County,9,5,5263,2681,2582
50,12,17,Florida,Citrus County,9,6,4760,2392,2368
50,12,17,Florida,Citrus County,9,7,4825,2388,2437
50,12,17,Florida,Citrus County,9,8,6310,3037,3273
50,12,17,Florida,Citrus County,9,9,7933,3825,4108
50,12,17,Florida,Citrus County,9,10,8899,4312,4587
50,12,17,Florida,Citrus County,9,11,9366,4384,4982
50,12,17,Florida,Citrus County,9,12,10998,5003,5995
50,12,17,Florida,Citrus County,9,13,12050,5525,6525
50,12,17,Florida,Citrus County,9,14,11243,5310,5933
50,12,17,Florida,Citrus County,9,15,9695,4653,5042
50,12,17,Florida,Citrus County,9,16,8676,4193,4483
50,12,17,Florida,Citrus County,9,17,6465,2927,3538
50,12,17,Florida,Citrus County,9,18,5267,2216,3051
50,12,17,Florida,Citrus County,10,0,139838,67199,72639
50,12,17,Florida,Citrus County,10,1,5475,2809,2666
50,12,17,Florida,Citrus County,10,2,5882,2972,2910
50,12,17,Florida,Citrus County,10,3,6811,3489,3322
50,12,17,Florida,Citrus County,10,4,7419,3888,3531
50,12,17,Florida,Citrus County,10,5,5681,2934,2747
50,12,17,Florida,Citrus County,10,6,5127,2538,2589
50,12,17,Florida,Citrus County,10,7,4830,2446,2384
50,12,17,Florida,Citrus County,10,8,6445,3099,3346
50,12,17,Florida,Citrus County,10,9,7864,3834,4030
50,12,17,Florida,Citrus County,10,10,9107,4382,4725
50,12,17,Florida,Citrus County,10,11,9697,4599,5098
50,12,17,Florida,Citrus County,10,12,10801,4884,5917
50,12,17,Florida,Citrus County,10,13,12629,5779,6850
50,12,17,Florida,Citrus County,10,14,11728,5506,6222
50,12,17,Florida,Citrus County,10,15,9648,4623,5025
50,12,17,Florida,Citrus County,10,16,8608,4123,4485
50,12,17,Florida,Citrus County,10,17,6534,2939,3595
50,12,17,Florida,Citrus County,10,18,5552,2355,3197
50,12,17,Florida,Citrus County,11,0,140865,67643,73222
50,12,17,Florida,Citrus County,11,1,5567,2862,2705
50,12,17,Florida,Citrus County,11,2,5903,2974,2929
50,12,17,Florida,Citrus County,11,3,6826,3504,3322
50,12,17,Florida,Citrus County,11,4,7350,3831,3519
50,12,17,Florida,Citrus County,11,5,5843,3038,2805
50,12,17,Florida,Citrus County,11,6,5358,2649,2709
50,12,17,Florida,Citrus County,11,7,4837,2472,2365
50,12,17,Florida,Citrus County,11,8,6363,3069,3294
50,12,17,Florida,Citrus County,11,9,7671,3724,3947
50,12,17,Florida,Citrus County,11,10,9132,4385,4747
50,12,17,Florida,Citrus County,11,11,9885,4681,5204
50,12,17,Florida,Citrus County,11,12,10641,4834,5807
50,12,17,Florida,Citrus County,11,13,12705,5810,6895
50,12,17,Florida,Citrus County,11,14,12256,5735,6521
50,12,17,Florida,Citrus County,11,15,9843,4701,5142
50,12,17,Florida,Citrus County,11,16,8457,4023,4434
50,12,17,Florida,Citrus County,11,17,6506,2947,3559
50,12,17,Florida,Citrus County,11,18,5722,2404,3318
50,12,17,Florida,Citrus County,12,0,140357,67353,73004
50,12,17,Florida,Citrus County,12,1,5692,2924,2768
50,12,17,Florida,Citrus County,12,2,5735,2908,2827
50,12,17,Florida,Citrus County,12,3,6599,3352,3247
50,12,17,Florida,Citrus County,12,4,7253,3802,3451
50,12,17,Florida,Citrus County,12,5,5918,3055,2863
50,12,17,Florida,Citrus County,12,6,5500,2773,2727
50,12,17,Florida,Citrus County,12,7,4830,2440,2390
50,12,17,Florida,Citrus County,12,8,6007,2899,3108
50,12,17,Florida,Citrus County,12,9,7356,3546,3810
50,12,17,Florida,Citrus County,12,10,9060,4372,4688
50,12,17,Florida,Citrus County,12,11,9931,4724,5207
50,12,17,Florida,Citrus County,12,12,10524,4808,5716
50,12,17,Florida,Citrus County,12,13,12625,5734,6891
50,12,17,Florida,Citrus County,12,14,12663,5879,6784
50,12,17,Florida,Citrus County,12,15,10062,4788,5274
50,12,17,Florida,Citrus County,12,16,8246,3906,4340
50,12,17,Florida,Citrus County,12,17,6537,2997,3540
50,12,17,Florida,Citrus County,12,18,5819,2446,3373
50,12,19,Florida,Clay County,1,0,140814,69335,71479
50,12,19,Florida,Clay County,1,1,9229,4680,4549
50,12,19,Florida,Clay County,1,2,10993,5635,5358
50,12,19,Florida,Clay County,1,3,12079,6246,5833
50,12,19,Florida,Clay County,1,4,10877,5549,5328
50,12,19,Florida,Clay County,1,5,7341,3720,3621
50,12,19,Florida,Clay County,1,6,8164,4005,4159
50,12,19,Florida,Clay County,1,7,9734,4747,4987
50,12,19,Florida,Clay County,1,8,12642,6159,6483
50,12,19,Florida,Clay County,1,9,12186,5947,6239
50,12,19,Florida,Clay County,1,10,10812,5259,5553
50,12,19,Florida,Clay County,1,11,9842,4856,4986
50,12,19,Florida,Clay County,1,12,7444,3693,3751
50,12,19,Florida,Clay County,1,13,5699,2825,2874
50,12,19,Florida,Clay County,1,14,4324,2104,2220
50,12,19,Florida,Clay County,1,15,3554,1628,1926
50,12,19,Florida,Clay County,1,16,2775,1187,1588
50,12,19,Florida,Clay County,1,17,1737,696,1041
50,12,19,Florida,Clay County,1,18,1382,399,983
50,12,19,Florida,Clay County,2,0,140814,69335,71479
50,12,19,Florida,Clay County,2,1,9229,4680,4549
50,12,19,Florida,Clay County,2,2,10993,5635,5358
50,12,19,Florida,Clay County,2,3,12079,6246,5833
50,12,19,Florida,Clay County,2,4,10877,5549,5328
50,12,19,Florida,Clay County,2,5,7341,3720,3621
50,12,19,Florida,Clay County,2,6,8164,4005,4159
50,12,19,Florida,Clay County,2,7,9734,4747,4987
50,12,19,Florida,Clay County,2,8,12642,6159,6483
50,12,19,Florida,Clay County,2,9,12186,5947,6239
50,12,19,Florida,Clay County,2,10,10812,5259,5553
50,12,19,Florida,Clay County,2,11,9842,4856,4986
50,12,19,Florida,Clay County,2,12,7444,3693,3751
50,12,19,Florida,Clay County,2,13,5699,2825,2874
50,12,19,Florida,Clay County,2,14,4324,2104,2220
50,12,19,Florida,Clay County,2,15,3554,1628,1926
50,12,19,Florida,Clay County,2,16,2775,1187,1588
50,12,19,Florida,Clay County,2,17,1737,696,1041
50,12,19,Florida,Clay County,2,18,1382,399,983
50,12,19,Florida,Clay County,3,0,141621,69728,71893
50,12,19,Florida,Clay County,3,1,9260,4694,4566
50,12,19,Florida,Clay County,3,2,10976,5626,5350
50,12,19,Florida,Clay County,3,3,12160,6286,5874
50,12,19,Florida,Clay County,3,4,10939,5583,5356
50,12,19,Florida,Clay County,3,5,7435,3772,3663
50,12,19,Florida,Clay County,3,6,8134,3990,4144
50,12,19,Florida,Clay County,3,7,9765,4762,5003
50,12,19,Florida,Clay County,3,8,12635,6155,6480
50,12,19,Florida,Clay County,3,9,12255,5979,6276
50,12,19,Florida,Clay County,3,10,10918,5310,5608
50,12,19,Florida,Clay County,3,11,9977,4922,5055
50,12,19,Florida,Clay County,3,12,7508,3724,3784
50,12,19,Florida,Clay County,3,13,5738,2845,2893
50,12,19,Florida,Clay County,3,14,4357,2120,2237
50,12,19,Florida,Clay County,3,15,3588,1644,1944
50,12,19,Florida,Clay County,3,16,2807,1201,1606
50,12,19,Florida,Clay County,3,17,1766,709,1057
50,12,19,Florida,Clay County,3,18,1403,406,997
50,12,19,Florida,Clay County,4,0,145492,71580,73912
50,12,19,Florida,Clay County,4,1,9523,4790,4733
50,12,19,Florida,Clay County,4,2,10988,5613,5375
50,12,19,Florida,Clay County,4,3,12491,6503,5988
50,12,19,Florida,Clay County,4,4,11121,5645,5476
50,12,19,Florida,Clay County,4,5,7796,3966,3830
50,12,19,Florida,Clay County,4,6,8044,3997,4047
50,12,19,Florida,Clay County,4,7,9959,4873,5086
50,12,19,Florida,Clay County,4,8,12468,6053,6415
50,12,19,Florida,Clay County,4,9,12891,6256,6635
50,12,19,Florida,Clay County,4,10,11236,5449,5787
50,12,19,Florida,Clay County,4,11,10558,5161,5397
50,12,19,Florida,Clay County,4,12,7894,3956,3938
50,12,19,Florida,Clay County,4,13,6003,2961,3042
50,12,19,Florida,Clay County,4,14,4514,2191,2323
50,12,19,Florida,Clay County,4,15,3745,1729,2016
50,12,19,Florida,Clay County,4,16,2930,1254,1676
50,12,19,Florida,Clay County,4,17,1834,735,1099
50,12,19,Florida,Clay County,4,18,1497,448,1049
50,12,19,Florida,Clay County,5,0,150645,74087,76558
50,12,19,Florida,Clay County,5,1,9993,5013,4980
50,12,19,Florida,Clay County,5,2,11067,5625,5442
50,12,19,Florida,Clay County,5,3,12820,6676,6144
50,12,19,Florida,Clay County,5,4,11597,5907,5690
50,12,19,Florida,Clay County,5,5,8291,4178,4113
50,12,19,Florida,Clay County,5,6,8266,4170,4096
50,12,19,Florida,Clay County,5,7,10189,4959,5230
50,12,19,Florida,Clay County,5,8,12323,5954,6369
50,12,19,Florida,Clay County,5,9,13374,6507,6867
50,12,19,Florida,Clay County,5,10,11839,5711,6128
50,12,19,Florida,Clay County,5,11,10540,5150,5390
50,12,19,Florida,Clay County,5,12,8791,4373,4418
50,12,19,Florida,Clay County,5,13,6419,3167,3252
50,12,19,Florida,Clay County,5,14,4655,2272,2383
50,12,19,Florida,Clay County,5,15,3876,1818,2058
50,12,19,Florida,Clay County,5,16,3029,1321,1708
50,12,19,Florida,Clay County,5,17,2019,807,1212
50,12,19,Florida,Clay County,5,18,1557,479,1078
50,12,19,Florida,Clay County,6,0,155357,76376,78981
50,12,19,Florida,Clay County,6,1,10289,5215,5074
50,12,19,Florida,Clay County,6,2,11257,5729,5528
50,12,19,Florida,Clay County,6,3,13182,6793,6389
50,12,19,Florida,Clay County,6,4,11841,6070,5771
50,12,19,Florida,Clay County,6,5,8603,4334,4269
50,12,19,Florida,Clay County,6,6,8336,4184,4152
50,12,19,Florida,Clay County,6,7,10485,5108,5377
50,12,19,Florida,Clay County,6,8,12183,5850,6333
50,12,19,Florida,Clay County,6,9,13880,6748,7132
50,12,19,Florida,Clay County,6,10,12272,5936,6336
50,12,19,Florida,Clay County,6,11,10723,5202,5521
50,12,19,Florida,Clay County,6,12,9447,4699,4748
50,12,19,Florida,Clay County,6,13,6956,3408,3548
50,12,19,Florida,Clay County,6,14,4995,2460,2535
50,12,19,Florida,Clay County,6,15,3931,1863,2068
50,12,19,Florida,Clay County,6,16,3179,1372,1807
50,12,19,Florida,Clay County,6,17,2142,880,1262
50,12,19,Florida,Clay County,6,18,1656,525,1131
50,12,19,Florida,Clay County,7,0,162473,80035,82438
50,12,19,Florida,Clay County,7,1,10771,5441,5330
50,12,19,Florida,Clay County,7,2,11888,6087,5801
50,12,19,Florida,Clay County,7,3,13600,6975,6625
50,12,19,Florida,Clay County,7,4,12342,6374,5968
50,12,19,Florida,Clay County,7,5,9354,4742,4612
50,12,19,Florida,Clay County,7,6,8994,4512,4482
50,12,19,Florida,Clay County,7,7,10806,5298,5508
50,12,19,Florida,Clay County,7,8,12186,5887,6299
50,12,19,Florida,Clay County,7,9,14525,7073,7452
50,12,19,Florida,Clay County,7,10,12797,6236,6561
50,12,19,Florida,Clay County,7,11,11132,5385,5747
50,12,19,Florida,Clay County,7,12,9932,4863,5069
50,12,19,Florida,Clay County,7,13,7507,3666,3841
50,12,19,Florida,Clay County,7,14,5266,2596,2670
50,12,19,Florida,Clay County,7,15,4028,1946,2082
50,12,19,Florida,Clay County,7,16,3318,1464,1854
50,12,19,Florida,Clay County,7,17,2333,945,1388
50,12,19,Florida,Clay County,7,18,1694,545,1149
50,12,19,Florida,Clay County,8,0,168280,82929,85351
50,12,19,Florida,Clay County,8,1,11079,5641,5438
50,12,19,Florida,Clay County,8,2,12406,6289,6117
50,12,19,Florida,Clay County,8,3,13801,7065,6736
50,12,19,Florida,Clay County,8,4,12823,6668,6155
50,12,19,Florida,Clay County,8,5,9698,4895,4803
50,12,19,Florida,Clay County,8,6,9257,4624,4633
50,12,19,Florida,Clay County,8,7,10886,5365,5521
50,12,19,Florida,Clay County,8,8,12658,6195,6463
50,12,19,Florida,Clay County,8,9,14861,7224,7637
50,12,19,Florida,Clay County,8,10,13364,6489,6875
50,12,19,Florida,Clay County,8,11,11613,5591,6022
50,12,19,Florida,Clay County,8,12,10578,5160,5418
50,12,19,Florida,Clay County,8,13,8021,3939,4082
50,12,19,Florida,Clay County,8,14,5555,2716,2839
50,12,19,Florida,Clay County,8,15,4133,1987,2146
50,12,19,Florida,Clay County,8,16,3336,1482,1854
50,12,19,Florida,Clay County,8,17,2419,1000,1419
50,12,19,Florida,Clay County,8,18,1792,599,1193
50,12,19,Florida,Clay County,9,0,176720,87216,89504
50,12,19,Florida,Clay County,9,1,11695,6011,5684
50,12,19,Florida,Clay County,9,2,13077,6590,6487
50,12,19,Florida,Clay County,9,3,14259,7285,6974
50,12,19,Florida,Clay County,9,4,13405,7000,6405
50,12,19,Florida,Clay County,9,5,10210,5142,5068
50,12,19,Florida,Clay County,9,6,10040,5039,5001
50,12,19,Florida,Clay County,9,7,10941,5460,5481
50,12,19,Florida,Clay County,9,8,13318,6554,6764
50,12,19,Florida,Clay County,9,9,15070,7340,7730
50,12,19,Florida,Clay County,9,10,14363,6949,7414
50,12,19,Florida,Clay County,9,11,12158,5839,6319
50,12,19,Florida,Clay County,9,12,11408,5509,5899
50,12,19,Florida,Clay County,9,13,8472,4193,4279
50,12,19,Florida,Clay County,9,14,5977,2914,3063
50,12,19,Florida,Clay County,9,15,4394,2113,2281
50,12,19,Florida,Clay County,9,16,3522,1600,1922
50,12,19,Florida,Clay County,9,17,2547,1050,1497
50,12,19,Florida,Clay County,9,18,1864,628,1236
50,12,19,Florida,Clay County,10,0,182392,90054,92338
50,12,19,Florida,Clay County,10,1,12140,6209,5931
50,12,19,Florida,Clay County,10,2,13494,6793,6701
50,12,19,Florida,Clay County,10,3,14495,7379,7116
50,12,19,Florida,Clay County,10,4,14066,7347,6719
50,12,19,Florida,Clay County,10,5,10504,5310,5194
50,12,19,Florida,Clay County,10,6,10355,5207,5148
50,12,19,Florida,Clay County,10,7,11149,5632,5517
50,12,19,Florida,Clay County,10,8,13673,6722,6951
50,12,19,Florida,Clay County,10,9,14907,7250,7657
50,12,19,Florida,Clay County,10,10,15010,7300,7710
50,12,19,Florida,Clay County,10,11,12747,6106,6641
50,12,19,Florida,Clay County,10,12,11534,5566,5968
50,12,19,Florida,Clay County,10,13,9172,4523,4649
50,12,19,Florida,Clay County,10,14,6436,3143,3293
50,12,19,Florida,Clay County,10,15,4458,2144,2314
50,12,19,Florida,Clay County,10,16,3622,1661,1961
50,12,19,Florida,Clay County,10,17,2580,1077,1503
50,12,19,Florida,Clay County,10,18,2050,685,1365
50,12,19,Florida,Clay County,11,0,185102,91407,93695
50,12,19,Florida,Clay County,11,1,12195,6234,5961
50,12,19,Florida,Clay County,11,2,13455,6821,6634
50,12,19,Florida,Clay County,11,3,14619,7447,7172
50,12,19,Florida,Clay County,11,4,14355,7426,6929
50,12,19,Florida,Clay County,11,5,10708,5433,5275
50,12,19,Florida,Clay County,11,6,10496,5308,5188
50,12,19,Florida,Clay County,11,7,10850,5475,5375
50,12,19,Florida,Clay County,11,8,13768,6778,6990
50,12,19,Florida,Clay County,11,9,14755,7161,7594
50,12,19,Florida,Clay County,11,10,15399,7498,7901
50,12,19,Florida,Clay County,11,11,13170,6328,6842
50,12,19,Florida,Clay County,11,12,11482,5514,5968
50,12,19,Florida,Clay County,11,13,9884,4869,5015
50,12,19,Florida,Clay County,11,14,6930,3356,3574
50,12,19,Florida,Clay County,11,15,4599,2241,2358
50,12,19,Florida,Clay County,11,16,3633,1688,1945
50,12,19,Florida,Clay County,11,17,2633,1083,1550
50,12,19,Florida,Clay County,11,18,2171,747,1424
50,12,19,Florida,Clay County,12,0,186756,92226,94530
50,12,19,Florida,Clay County,12,1,12313,6297,6016
50,12,19,Florida,Clay County,12,2,13207,6679,6528
50,12,19,Florida,Clay County,12,3,14463,7403,7060
50,12,19,Florida,Clay County,12,4,14525,7481,7044
50,12,19,Florida,Clay County,12,5,10931,5586,5345
50,12,19,Florida,Clay County,12,6,10890,5515,5375
50,12,19,Florida,Clay County,12,7,10774,5412,5362
50,12,19,Florida,Clay County,12,8,13473,6652,6821
50,12,19,Florida,Clay County,12,9,14167,6879,7288
50,12,19,Florida,Clay County,12,10,15753,7666,8087
50,12,19,Florida,Clay County,12,11,13569,6564,7005
50,12,19,Florida,Clay County,12,12,11730,5619,6111
50,12,19,Florida,Clay County,12,13,10257,4974,5283
50,12,19,Florida,Clay County,12,14,7353,3549,3804
50,12,19,Florida,Clay County,12,15,4727,2307,2420
50,12,19,Florida,Clay County,12,16,3624,1713,1911
50,12,19,Florida,Clay County,12,17,2726,1159,1567
50,12,19,Florida,Clay County,12,18,2274,771,1503
50,12,21,Florida,Collier County,1,0,251377,125856,125521
50,12,21,Florida,Collier County,1,1,13441,6960,6481
50,12,21,Florida,Collier County,1,2,14444,7289,7155
50,12,21,Florida,Collier County,1,3,13677,6909,6768
50,12,21,Florida,Collier County,1,4,13382,7270,6112
50,12,21,Florida,Collier County,1,5,11708,6777,4931
50,12,21,Florida,Collier County,1,6,13361,7290,6071
50,12,21,Florida,Collier County,1,7,14901,7952,6949
50,12,21,Florida,Collier County,1,8,17181,8880,8301
50,12,21,Florida,Collier County,1,9,16277,8230,8047
50,12,21,Florida,Collier County,1,10,14755,7296,7459
50,12,21,Florida,Collier County,1,11,14760,6775,7985
50,12,21,Florida,Collier County,1,12,15518,6997,8521
50,12,21,Florida,Collier County,1,13,16459,7698,8761
50,12,21,Florida,Collier County,1,14,17755,8768,8987
50,12,21,Florida,Collier County,1,15,17333,8569,8764
50,12,21,Florida,Collier County,1,16,13298,6463,6835
50,12,21,Florida,Collier County,1,17,7762,3638,4124
50,12,21,Florida,Collier County,1,18,5365,2095,3270
50,12,21,Florida,Collier County,2,0,251377,125856,125521
50,12,21,Florida,Collier County,2,1,13441,6960,6481
50,12,21,Florida,Collier County,2,2,14444,7289,7155
50,12,21,Florida,Collier County,2,3,13677,6909,6768
50,12,21,Florida,Collier County,2,4,13382,7270,6112
50,12,21,Florida,Collier County,2,5,11708,6777,4931
50,12,21,Florida,Collier County,2,6,13361,7290,6071
50,12,21,Florida,Collier County,2,7,14901,7952,6949
50,12,21,Florida,Collier County,2,8,17181,8880,8301
50,12,21,Florida,Collier County,2,9,16277,8230,8047
50,12,21,Florida,Collier County,2,10,14755,7296,7459
50,12,21,Florida,Collier County,2,11,14760,6775,7985
50,12,21,Florida,Collier County,2,12,15518,6997,8521
50,12,21,Florida,Collier County,2,13,16459,7698,8761
50,12,21,Florida,Collier County,2,14,17755,8768,8987
50,12,21,Florida,Collier County,2,15,17333,8569,8764
50,12,21,Florida,Collier County,2,16,13298,6463,6835
50,12,21,Florida,Collier County,2,17,7762,3638,4124
50,12,21,Florida,Collier County,2,18,5365,2095,3270
50,12,21,Florida,Collier County,3,0,254070,127268,126802
50,12,21,Florida,Collier County,3,1,13594,7038,6556
50,12,21,Florida,Collier County,3,2,14527,7333,7194
50,12,21,Florida,Collier County,3,3,13859,7001,6858
50,12,21,Florida,Collier County,3,4,13517,7341,6176
50,12,21,Florida,Collier County,3,5,11905,6896,5009
50,12,21,Florida,Collier County,3,6,13442,7343,6099
50,12,21,Florida,Collier County,3,7,15051,8038,7013
50,12,21,Florida,Collier County,3,8,17293,8945,8348
50,12,21,Florida,Collier County,3,9,16468,8331,8137
50,12,21,Florida,Collier County,3,10,14970,7406,7564
50,12,21,Florida,Collier County,3,11,15031,6901,8130
50,12,21,Florida,Collier County,3,12,15739,7100,8639
50,12,21,Florida,Collier County,3,13,16644,7788,8856
50,12,21,Florida,Collier County,3,14,17825,8806,9019
50,12,21,Florida,Collier County,3,15,17439,8633,8806
50,12,21,Florida,Collier County,3,16,13431,6533,6898
50,12,21,Florida,Collier County,3,17,7888,3703,4185
50,12,21,Florida,Collier County,3,18,5447,2132,3315
50,12,21,Florida,Collier County,4,0,264232,132561,131671
50,12,21,Florida,Collier County,4,1,14692,7543,7149
50,12,21,Florida,Collier County,4,2,14746,7517,7229
50,12,21,Florida,Collier County,4,3,14639,7347,7292
50,12,21,Florida,Collier County,4,4,13976,7575,6401
50,12,21,Florida,Collier County,4,5,12500,7321,5179
50,12,21,Florida,Collier County,4,6,13565,7445,6120
50,12,21,Florida,Collier County,4,7,15511,8230,7281
50,12,21,Florida,Collier County,4,8,17452,9098,8354
50,12,21,Florida,Collier County,4,9,17500,8893,8607
50,12,21,Florida,Collier County,4,10,15747,7851,7896
50,12,21,Florida,Collier County,4,11,16065,7469,8596
50,12,21,Florida,Collier County,4,12,16368,7362,9006
50,12,21,Florida,Collier County,4,13,17398,8118,9280
50,12,21,Florida,Collier County,4,14,17778,8715,9063
50,12,21,Florida,Collier County,4,15,17841,8838,9003
50,12,21,Florida,Collier County,4,16,13782,6746,7036
50,12,21,Florida,Collier County,4,17,8722,4118,4604
50,12,21,Florida,Collier County,4,18,5950,2375,3575
50,12,21,Florida,Collier County,5,0,275367,138385,136982
50,12,21,Florida,Collier County,5,1,15970,8181,7789
50,12,21,Florida,Collier County,5,2,14890,7595,7295
50,12,21,Florida,Collier County,5,3,15512,7782,7730
50,12,21,Florida,Collier County,5,4,14496,7797,6699
50,12,21,Florida,Collier County,5,5,13331,7850,5481
50,12,21,Florida,Collier County,5,6,14037,7774,6263
50,12,21,Florida,Collier County,5,7,15953,8534,7419
50,12,21,Florida,Collier County,5,8,17900,9357,8543
50,12,21,Florida,Collier County,5,9,18334,9324,9010
50,12,21,Florida,Collier County,5,10,16738,8296,8442
50,12,21,Florida,Collier County,5,11,16244,7651,8593
50,12,21,Florida,Collier County,5,12,17672,7951,9721
50,12,21,Florida,Collier County,5,13,18246,8479,9767
50,12,21,Florida,Collier County,5,14,17888,8718,9170
50,12,21,Florida,Collier County,5,15,18107,8997,9110
50,12,21,Florida,Collier County,5,16,14298,7031,7267
50,12,21,Florida,Collier County,5,17,9360,4455,4905
50,12,21,Florida,Collier County,5,18,6391,2613,3778
50,12,21,Florida,Collier County,6,0,284896,143549,141347
50,12,21,Florida,Collier County,6,1,17240,8893,8347
50,12,21,Florida,Collier County,6,2,15363,7879,7484
50,12,21,Florida,Collier County,6,3,15975,8042,7933
50,12,21,Florida,Collier County,6,4,14852,7868,6984
50,12,21,Florida,Collier County,6,5,14256,8402,5854
50,12,21,Florida,Collier County,6,6,14492,8116,6376
50,12,21,Florida,Collier County,6,7,16172,8719,7453
50,12,21,Florida,Collier County,6,8,17912,9428,8484
50,12,21,Florida,Collier County,6,9,19098,9688,9410
50,12,21,Florida,Collier County,6,10,17517,8731,8786
50,12,21,Florida,Collier County,6,11,16634,7918,8716
50,12,21,Florida,Collier County,6,12,18129,8221,9908
50,12,21,Florida,Collier County,6,13,19333,8867,10466
50,12,21,Florida,Collier County,6,14,18288,8911,9377
50,12,21,Florida,Collier County,6,15,17917,8882,9035
50,12,21,Florida,Collier County,6,16,14894,7347,7547
50,12,21,Florida,Collier County,6,17,9903,4716,5187
50,12,21,Florida,Collier County,6,18,6921,2921,4000
50,12,21,Florida,Collier County,7,0,295453,149135,146318
50,12,21,Florida,Collier County,7,1,18659,9590,9069
50,12,21,Florida,Collier County,7,2,15710,8093,7617
50,12,21,Florida,Collier County,7,3,16626,8375,8251
50,12,21,Florida,Collier County,7,4,15405,8183,7222
50,12,21,Florida,Collier County,7,5,14945,8679,6266
50,12,21,Florida,Collier County,7,6,15119,8609,6510
50,12,21,Florida,Collier County,7,7,16490,8911,7579
50,12,21,Florida,Collier County,7,8,18014,9505,8509
50,12,21,Florida,Collier County,7,9,19958,10162,9796
50,12,21,Florida,Collier County,7,10,18353,9184,9169
50,12,21,Florida,Collier County,7,11,17236,8312,8924
50,12,21,Florida,Collier County,7,12,18426,8367,10059
50,12,21,Florida,Collier County,7,13,20350,9335,11015
50,12,21,Florida,Collier County,7,14,18831,9053,9778
50,12,21,Florida,Collier County,7,15,17623,8751,8872
50,12,21,Florida,Collier County,7,16,15598,7739,7859
50,12,21,Florida,Collier County,7,17,10593,5053,5540
50,12,21,Florida,Collier County,7,18,7517,3234,4283
50,12,21,Florida,Collier County,8,0,306640,155040,151600
50,12,21,Florida,Collier County,8,1,20009,10274,9735
50,12,21,Florida,Collier County,8,2,16192,8361,7831
50,12,21,Florida,Collier County,8,3,16973,8542,8431
50,12,21,Florida,Collier County,8,4,16037,8554,7483
50,12,21,Florida,Collier County,8,5,15625,8902,6723
50,12,21,Florida,Collier County,8,6,16085,9264,6821
50,12,21,Florida,Collier County,8,7,16580,9012,7568
50,12,21,Florida,Collier County,8,8,18278,9724,8554
50,12,21,Florida,Collier County,8,9,20461,10482,9979
50,12,21,Florida,Collier County,8,10,19408,9708,9700
50,12,21,Florida,Collier County,8,11,17857,8701,9156
50,12,21,Florida,Collier County,8,12,19206,8761,10445
50,12,21,Florida,Collier County,8,13,20903,9552,11351
50,12,21,Florida,Collier County,8,14,19441,9300,10141
50,12,21,Florida,Collier County,8,15,17915,8867,9048
50,12,21,Florida,Collier County,8,16,16136,8030,8106
50,12,21,Florida,Collier County,8,17,11281,5424,5857
50,12,21,Florida,Collier County,8,18,8253,3582,4671
50,12,21,Florida,Collier County,9,0,311650,157835,153815
50,12,21,Florida,Collier County,9,1,20549,10551,9998
50,12,21,Florida,Collier County,9,2,16849,8639,8210
50,12,21,Florida,Collier County,9,3,16935,8598,8337
50,12,21,Florida,Collier County,9,4,16581,8788,7793
50,12,21,Florida,Collier County,9,5,15849,9027,6822
50,12,21,Florida,Collier County,9,6,16356,9535,6821
50,12,21,Florida,Collier County,9,7,16014,8771,7243
50,12,21,Florida,Collier County,9,8,18546,9818,8728
50,12,21,Florida,Collier County,9,9,20333,10501,9832
50,12,21,Florida,Collier County,9,10,20124,10121,10003
50,12,21,Florida,Collier County,9,11,18108,8898,9210
50,12,21,Florida,Collier County,9,12,19784,9106,10678
50,12,21,Florida,Collier County,9,13,20985,9558,11427
50,12,21,Florida,Collier County,9,14,19880,9452,10428
50,12,21,Florida,Collier County,9,15,17811,8770,9041
50,12,21,Florida,Collier County,9,16,16313,8116,8197
50,12,21,Florida,Collier County,9,17,11551,5589,5962
50,12,21,Florida,Collier County,9,18,9082,3997,5085
50,12,21,Florida,Collier County,10,0,313463,159031,154432
50,12,21,Florida,Collier County,10,1,20669,10607,10062
50,12,21,Florida,Collier County,10,2,17416,8910,8506
50,12,21,Florida,Collier County,10,3,16434,8353,8081
50,12,21,Florida,Collier County,10,4,16769,8876,7893
50,12,21,Florida,Collier County,10,5,15712,8910,6802
50,12,21,Florida,Collier County,10,6,16389,9700,6689
50,12,21,Florida,Collier County,10,7,15544,8633,6911
50,12,21,Florida,Collier County,10,8,18006,9617,8389
50,12,21,Florida,Collier County,10,9,19912,10323,9589
50,12,21,Florida,Collier County,10,10,20208,10185,10023
50,12,21,Florida,Collier County,10,11,18376,9029,9347
50,12,21,Florida,Collier County,10,12,19127,8907,10220
50,12,21,Florida,Collier County,10,13,21637,9828,11809
50,12,21,Florida,Collier County,10,14,20654,9762,10892
50,12,21,Florida,Collier County,10,15,18007,8793,9214
50,12,21,Florida,Collier County,10,16,16616,8314,8302
50,12,21,Florida,Collier County,10,17,12107,5854,6253
50,12,21,Florida,Collier County,10,18,9880,4430,5450
50,12,21,Florida,Collier County,11,0,315533,160171,155362
50,12,21,Florida,Collier County,11,1,20160,10254,9906
50,12,21,Florida,Collier County,11,2,17786,9164,8622
50,12,21,Florida,Collier County,11,3,16251,8303,7948
50,12,21,Florida,Collier County,11,4,16711,8838,7873
50,12,21,Florida,Collier County,11,5,15581,8710,6871
50,12,21,Florida,Collier County,11,6,16582,9849,6733
50,12,21,Florida,Collier County,11,7,15246,8575,6671
50,12,21,Florida,Collier County,11,8,17356,9352,8004
50,12,21,Florida,Collier County,11,9,19073,9961,9112
50,12,21,Florida,Collier County,11,10,20363,10251,10112
50,12,21,Florida,Collier County,11,11,18746,9265,9481
50,12,21,Florida,Collier County,11,12,18657,8790,9867
50,12,21,Florida,Collier County,11,13,21483,9810,11673
50,12,21,Florida,Collier County,11,14,22133,10309,11824
50,12,21,Florida,Collier County,11,15,18940,9232,9708
50,12,21,Florida,Collier County,11,16,16792,8347,8445
50,12,21,Florida,Collier County,11,17,12902,6287,6615
50,12,21,Florida,Collier County,11,18,10771,4874,5897
50,12,21,Florida,Collier County,12,0,318537,161842,156695
50,12,21,Florida,Collier County,12,1,20112,10210,9902
50,12,21,Florida,Collier County,12,2,18378,9443,8935
50,12,21,Florida,Collier County,12,3,15807,8111,7696
50,12,21,Florida,Collier County,12,4,16576,8775,7801
50,12,21,Florida,Collier County,12,5,15477,8678,6799
50,12,21,Florida,Collier County,12,6,16638,9792,6846
50,12,21,Florida,Collier County,12,7,15265,8752,6513
50,12,21,Florida,Collier County,12,8,16951,9179,7772
50,12,21,Florida,Collier County,12,9,18491,9700,8791
50,12,21,Florida,Collier County,12,10,20451,10333,10118
50,12,21,Florida,Collier County,12,11,19109,9491,9618
50,12,21,Florida,Collier County,12,12,18615,8882,9733
50,12,21,Florida,Collier County,12,13,21197,9668,11529
50,12,21,Florida,Collier County,12,14,23093,10740,12353
50,12,21,Florida,Collier County,12,15,19856,9559,10297
50,12,21,Florida,Collier County,12,16,17134,8488,8646
50,12,21,Florida,Collier County,12,17,13696,6728,6968
50,12,21,Florida,Collier County,12,18,11691,5313,6378
50,12,23,Florida,Columbia County,1,0,56513,28656,27857
50,12,23,Florida,Columbia County,1,1,3628,1855,1773
50,12,23,Florida,Columbia County,1,2,3928,2059,1869
50,12,23,Florida,Columbia County,1,3,4152,2157,1995
50,12,23,Florida,Columbia County,1,4,4229,2163,2066
50,12,23,Florida,Columbia County,1,5,3491,1951,1540
50,12,23,Florida,Columbia County,1,6,3348,1765,1583
50,12,23,Florida,Columbia County,1,7,3586,1912,1674
50,12,23,Florida,Columbia County,1,8,4187,2145,2042
50,12,23,Florida,Columbia County,1,9,4513,2255,2258
50,12,23,Florida,Columbia County,1,10,3989,2034,1955
50,12,23,Florida,Columbia County,1,11,3726,1817,1909
50,12,23,Florida,Columbia County,1,12,3130,1574,1556
50,12,23,Florida,Columbia County,1,13,2697,1334,1363
50,12,23,Florida,Columbia County,1,14,2434,1208,1226
50,12,23,Florida,Columbia County,1,15,2113,1009,1104
50,12,23,Florida,Columbia County,1,16,1659,782,877
50,12,23,Florida,Columbia County,1,17,985,403,582
50,12,23,Florida,Columbia County,1,18,718,233,485
50,12,23,Florida,Columbia County,2,0,56510,28654,27856
50,12,23,Florida,Columbia County,2,1,3628,1855,1773
50,12,23,Florida,Columbia County,2,2,3928,2059,1869
50,12,23,Florida,Columbia County,2,3,4152,2157,1995
50,12,23,Florida,Columbia County,2,4,4229,2163,2066
50,12,23,Florida,Columbia County,2,5,3491,1951,1540
50,12,23,Florida,Columbia County,2,6,3347,1764,1583
50,12,23,Florida,Columbia County,2,7,3586,1912,1674
50,12,23,Florida,Columbia County,2,8,4187,2145,2042
50,12,23,Florida,Columbia County,2,9,4513,2255,2258
50,12,23,Florida,Columbia County,2,10,3989,2034,1955
50,12,23,Florida,Columbia County,2,11,3726,1817,1909
50,12,23,Florida,Columbia County,2,12,3128,1573,1555
50,12,23,Florida,Columbia County,2,13,2697,1334,1363
50,12,23,Florida,Columbia County,2,14,2434,1208,1226
50,12,23,Florida,Columbia County,2,15,2113,1009,1104
50,12,23,Florida,Columbia County,2,16,1659,782,877
50,12,23,Florida,Columbia County,2,17,985,403,582
50,12,23,Florida,Columbia County,2,18,718,233,485
50,12,23,Florida,Columbia County,3,0,56726,28760,27966
50,12,23,Florida,Columbia County,3,1,3633,1857,1776
50,12,23,Florida,Columbia County,3,2,3917,2053,1864
50,12,23,Florida,Columbia County,3,3,4174,2169,2005
50,12,23,Florida,Columbia County,3,4,4248,2173,2075
50,12,23,Florida,Columbia County,3,5,3527,1970,1557
50,12,23,Florida,Columbia County,3,6,3329,1755,1574
50,12,23,Florida,Columbia County,3,7,3590,1914,1676
50,12,23,Florida,Columbia County,3,8,4181,2143,2038
50,12,23,Florida,Columbia County,3,9,4531,2263,2268
50,12,23,Florida,Columbia County,3,10,4017,2047,1970
50,12,23,Florida,Columbia County,3,11,3771,1839,1932
50,12,23,Florida,Columbia County,3,12,3150,1583,1567
50,12,23,Florida,Columbia County,3,13,2712,1342,1370
50,12,23,Florida,Columbia County,3,14,2439,1210,1229
50,12,23,Florida,Columbia County,3,15,2117,1012,1105
50,12,23,Florida,Columbia County,3,16,1668,786,882
50,12,23,Florida,Columbia County,3,17,997,408,589
50,12,23,Florida,Columbia County,3,18,725,236,489
50,12,23,Florida,Columbia County,4,0,57340,29043,28297
50,12,23,Florida,Columbia County,4,1,3642,1827,1815
50,12,23,Florida,Columbia County,4,2,3820,1992,1828
50,12,23,Florida,Columbia County,4,3,4173,2193,1980
50,12,23,Florida,Columbia County,4,4,4212,2172,2040
50,12,23,Florida,Columbia County,4,5,3750,2094,1656
50,12,23,Florida,Columbia County,4,6,3269,1703,1566
50,12,23,Florida,Columbia County,4,7,3572,1900,1672
50,12,23,Florida,Columbia County,4,8,4097,2117,1980
50,12,23,Florida,Columbia County,4,9,4548,2290,2258
50,12,23,Florida,Columbia County,4,10,4117,2105,2012
50,12,23,Florida,Columbia County,4,11,3987,1932,2055
50,12,23,Florida,Columbia County,4,12,3208,1595,1613
50,12,23,Florida,Columbia County,4,13,2810,1386,1424
50,12,23,Florida,Columbia County,4,14,2440,1189,1251
50,12,23,Florida,Columbia County,4,15,2149,1042,1107
50,12,23,Florida,Columbia County,4,16,1722,803,919
50,12,23,Florida,Columbia County,4,17,1064,448,616
50,12,23,Florida,Columbia County,4,18,760,255,505
50,12,23,Florida,Columbia County,5,0,58333,29573,28760
50,12,23,Florida,Columbia County,5,1,3835,1934,1901
50,12,23,Florida,Columbia County,5,2,3728,1947,1781
50,12,23,Florida,Columbia County,5,3,4200,2211,1989
50,12,23,Florida,Columbia County,5,4,4221,2188,2033
50,12,23,Florida,Columbia County,5,5,3955,2218,1737
50,12,23,Florida,Columbia County,5,6,3247,1699,1548
50,12,23,Florida,Columbia County,5,7,3664,1897,1767
50,12,23,Florida,Columbia County,5,8,3972,2078,1894
50,12,23,Florida,Columbia County,5,9,4492,2300,2192
50,12,23,Florida,Columbia County,5,10,4358,2194,2164
50,12,23,Florida,Columbia County,5,11,3931,1936,1995
50,12,23,Florida,Columbia County,5,12,3499,1678,1821
50,12,23,Florida,Columbia County,5,13,2877,1439,1438
50,12,23,Florida,Columbia County,5,14,2475,1197,1278
50,12,23,Florida,Columbia County,5,15,2182,1092,1090
50,12,23,Florida,Columbia County,5,16,1782,821,961
50,12,23,Florida,Columbia County,5,17,1111,474,637
50,12,23,Florida,Columbia County,5,18,804,270,534
50,12,23,Florida,Columbia County,6,0,59898,30430,29468
50,12,23,Florida,Columbia County,6,1,4002,2062,1940
50,12,23,Florida,Columbia County,6,2,3753,1949,1804
50,12,23,Florida,Columbia County,6,3,4276,2227,2049
50,12,23,Florida,Columbia County,6,4,4233,2226,2007
50,12,23,Florida,Columbia County,6,5,4251,2379,1872
50,12,23,Florida,Columbia County,6,6,3478,1832,1646
50,12,23,Florida,Columbia County,6,7,3647,1908,1739
50,12,23,Florida,Columbia County,6,8,3971,2102,1869
50,12,23,Florida,Columbia County,6,9,4439,2248,2191
50,12,23,Florida,Columbia County,6,10,4475,2230,2245
50,12,23,Florida,Columbia County,6,11,4043,1995,2048
50,12,23,Florida,Columbia County,6,12,3752,1833,1919
50,12,23,Florida,Columbia County,6,13,3044,1491,1553
50,12,23,Florida,Columbia County,6,14,2531,1232,1299
50,12,23,Florida,Columbia County,6,15,2164,1082,1082
50,12,23,Florida,Columbia County,6,16,1830,835,995
50,12,23,Florida,Columbia County,6,17,1163,501,662
50,12,23,Florida,Columbia County,6,18,846,298,548
50,12,23,Florida,Columbia County,7,0,61457,31232,30225
50,12,23,Florida,Columbia County,7,1,4031,2092,1939
50,12,23,Florida,Columbia County,7,2,3882,1968,1914
50,12,23,Florida,Columbia County,7,3,4411,2288,2123
50,12,23,Florida,Columbia County,7,4,4181,2223,1958
50,12,23,Florida,Columbia County,7,5,4396,2478,1918
50,12,23,Florida,Columbia County,7,6,3823,2037,1786
50,12,23,Florida,Columbia County,7,7,3643,1889,1754
50,12,23,Florida,Columbia County,7,8,3938,2098,1840
50,12,23,Florida,Columbia County,7,9,4508,2293,2215
50,12,23,Florida,Columbia County,7,10,4623,2287,2336
50,12,23,Florida,Columbia County,7,11,4110,2040,2070
50,12,23,Florida,Columbia County,7,12,3888,1883,2005
50,12,23,Florida,Columbia County,7,13,3279,1603,1676
50,12,23,Florida,Columbia County,7,14,2595,1254,1341
50,12,23,Florida,Columbia County,7,15,2212,1102,1110
50,12,23,Florida,Columbia County,7,16,1819,840,979
50,12,23,Florida,Columbia County,7,17,1224,539,685
50,12,23,Florida,Columbia County,7,18,894,318,576
50,12,23,Florida,Columbia County,8,0,63916,32514,31402
50,12,23,Florida,Columbia County,8,1,4298,2222,2076
50,12,23,Florida,Columbia County,8,2,4064,2072,1992
50,12,23,Florida,Columbia County,8,3,4387,2293,2094
50,12,23,Florida,Columbia County,8,4,4285,2290,1995
50,12,23,Florida,Columbia County,8,5,4656,2633,2023
50,12,23,Florida,Columbia County,8,6,4135,2184,1951
50,12,23,Florida,Columbia County,8,7,3748,1976,1772
50,12,23,Florida,Columbia County,8,8,3986,2142,1844
50,12,23,Florida,Columbia County,8,9,4560,2336,2224
50,12,23,Florida,Columbia County,8,10,4826,2366,2460
50,12,23,Florida,Columbia County,8,11,4273,2136,2137
50,12,23,Florida,Columbia County,8,12,4124,1969,2155
50,12,23,Florida,Columbia County,8,13,3443,1682,1761
50,12,23,Florida,Columbia County,8,14,2699,1314,1385
50,12,23,Florida,Columbia County,8,15,2311,1122,1189
50,12,23,Florida,Columbia County,8,16,1873,867,1006
50,12,23,Florida,Columbia County,8,17,1286,567,719
50,12,23,Florida,Columbia County,8,18,962,343,619
50,12,23,Florida,Columbia County,9,0,66975,34370,32605
50,12,23,Florida,Columbia County,9,1,4362,2271,2091
50,12,23,Florida,Columbia County,9,2,4208,2107,2101
50,12,23,Florida,Columbia County,9,3,4350,2262,2088
50,12,23,Florida,Columbia County,9,4,4488,2434,2054
50,12,23,Florida,Columbia County,9,5,4966,2918,2048
50,12,23,Florida,Columbia County,9,6,4550,2437,2113
50,12,23,Florida,Columbia County,9,7,3934,2097,1837
50,12,23,Florida,Columbia County,9,8,4190,2292,1898
50,12,23,Florida,Columbia County,9,9,4663,2438,2225
50,12,23,Florida,Columbia County,9,10,4933,2464,2469
50,12,23,Florida,Columbia County,9,11,4497,2250,2247
50,12,23,Florida,Columbia County,9,12,4452,2119,2333
50,12,23,Florida,Columbia County,9,13,3627,1765,1862
50,12,23,Florida,Columbia County,9,14,2992,1463,1529
50,12,23,Florida,Columbia County,9,15,2380,1120,1260
50,12,23,Florida,Columbia County,9,16,2023,968,1055
50,12,23,Florida,Columbia County,9,17,1306,573,733
50,12,23,Florida,Columbia County,9,18,1054,392,662
50,12,23,Florida,Columbia County,10,0,67927,34848,33079
50,12,23,Florida,Columbia County,10,1,4374,2232,2142
50,12,23,Florida,Columbia County,10,2,4364,2196,2168
50,12,23,Florida,Columbia County,10,3,4200,2186,2014
50,12,23,Florida,Columbia County,10,4,4585,2488,2097
50,12,23,Florida,Columbia County,10,5,5013,2959,2054
50,12,23,Florida,Columbia County,10,6,4735,2567,2168
50,12,23,Florida,Columbia County,10,7,3935,2108,1827
50,12,23,Florida,Columbia County,10,8,4273,2287,1986
50,12,23,Florida,Columbia County,10,9,4643,2457,2186
50,12,23,Florida,Columbia County,10,10,4842,2452,2390
50,12,23,Florida,Columbia County,10,11,4719,2336,2383
50,12,23,Florida,Columbia County,10,12,4381,2117,2264
50,12,23,Florida,Columbia County,10,13,3845,1814,2031
50,12,23,Florida,Columbia County,10,14,3092,1518,1574
50,12,23,Florida,Columbia County,10,15,2434,1140,1294
50,12,23,Florida,Columbia County,10,16,2038,1001,1037
50,12,23,Florida,Columbia County,10,17,1345,578,767
50,12,23,Florida,Columbia County,10,18,1109,412,697
50,12,23,Florida,Columbia County,11,0,68901,35445,33456
50,12,23,Florida,Columbia County,11,1,4367,2209,2158
50,12,23,Florida,Columbia County,11,2,4436,2276,2160
50,12,23,Florida,Columbia County,11,3,4137,2139,1998
50,12,23,Florida,Columbia County,11,4,4593,2475,2118
50,12,23,Florida,Columbia County,11,5,5048,3031,2017
50,12,23,Florida,Columbia County,11,6,4997,2706,2291
50,12,23,Florida,Columbia County,11,7,4067,2198,1869
50,12,23,Florida,Columbia County,11,8,4225,2287,1938
50,12,23,Florida,Columbia County,11,9,4562,2450,2112
50,12,23,Florida,Columbia County,11,10,4878,2448,2430
50,12,23,Florida,Columbia County,11,11,4819,2367,2452
50,12,23,Florida,Columbia County,11,12,4378,2126,2252
50,12,23,Florida,Columbia County,11,13,4060,1948,2112
50,12,23,Florida,Columbia County,11,14,3274,1583,1691
50,12,23,Florida,Columbia County,11,15,2479,1160,1319
50,12,23,Florida,Columbia County,11,16,2011,982,1029
50,12,23,Florida,Columbia County,11,17,1413,618,795
50,12,23,Florida,Columbia County,11,18,1157,442,715
50,12,23,Florida,Columbia County,12,0,69264,35581,33683
50,12,23,Florida,Columbia County,12,1,4365,2223,2142
50,12,23,Florida,Columbia County,12,2,4371,2258,2113
50,12,23,Florida,Columbia County,12,3,4193,2123,2070
50,12,23,Florida,Columbia County,12,4,4503,2423,2080
50,12,23,Florida,Columbia County,12,5,5037,3021,2016
50,12,23,Florida,Columbia County,12,6,5001,2728,2273
50,12,23,Florida,Columbia County,12,7,4332,2351,1981
50,12,23,Florida,Columbia County,12,8,4129,2215,1914
50,12,23,Florida,Columbia County,12,9,4411,2378,2033
50,12,23,Florida,Columbia County,12,10,4917,2471,2446
50,12,23,Florida,Columbia County,12,11,4862,2365,2497
50,12,23,Florida,Columbia County,12,12,4369,2129,2240
50,12,23,Florida,Columbia County,12,13,4172,1987,2185
50,12,23,Florida,Columbia County,12,14,3460,1665,1795
50,12,23,Florida,Columbia County,12,15,2507,1168,1339
50,12,23,Florida,Columbia County,12,16,2012,981,1031
50,12,23,Florida,Columbia County,12,17,1399,616,783
50,12,23,Florida,Columbia County,12,18,1224,479,745
50,12,27,Florida,DeSoto County,1,0,32209,18103,14106
50,12,27,Florida,DeSoto County,1,1,1873,940,933
50,12,27,Florida,DeSoto County,1,2,1944,1028,916
50,12,27,Florida,DeSoto County,1,3,2115,1106,1009
50,12,27,Florida,DeSoto County,1,4,2431,1427,1004
50,12,27,Florida,DeSoto County,1,5,2542,1845,697
50,12,27,Florida,DeSoto County,1,6,2486,1722,764
50,12,27,Florida,DeSoto County,1,7,2062,1305,757
50,12,27,Florida,DeSoto County,1,8,2095,1288,807
50,12,27,Florida,DeSoto County,1,9,1957,1148,809
50,12,27,Florida,DeSoto County,1,10,1736,977,759
50,12,27,Florida,DeSoto County,1,11,1605,797,808
50,12,27,Florida,DeSoto County,1,12,1618,808,810
50,12,27,Florida,DeSoto County,1,13,1632,765,867
50,12,27,Florida,DeSoto County,1,14,1764,872,892
50,12,27,Florida,DeSoto County,1,15,1657,822,835
50,12,27,Florida,DeSoto County,1,16,1353,640,713
50,12,27,Florida,DeSoto County,1,17,806,390,416
50,12,27,Florida,DeSoto County,1,18,533,223,310
50,12,27,Florida,DeSoto County,2,0,32209,18103,14106
50,12,27,Florida,DeSoto County,2,1,1873,940,933
50,12,27,Florida,DeSoto County,2,2,1944,1028,916
50,12,27,Florida,DeSoto County,2,3,2115,1106,1009
50,12,27,Florida,DeSoto County,2,4,2431,1427,1004
50,12,27,Florida,DeSoto County,2,5,2542,1845,697
50,12,27,Florida,DeSoto County,2,6,2486,1722,764
50,12,27,Florida,DeSoto County,2,7,2062,1305,757
50,12,27,Florida,DeSoto County,2,8,2095,1288,807
50,12,27,Florida,DeSoto County,2,9,1957,1148,809
50,12,27,Florida,DeSoto County,2,10,1736,977,759
50,12,27,Florida,DeSoto County,2,11,1605,797,808
50,12,27,Florida,DeSoto County,2,12,1618,808,810
50,12,27,Florida,DeSoto County,2,13,1632,765,867
50,12,27,Florida,DeSoto County,2,14,1764,872,892
50,12,27,Florida,DeSoto County,2,15,1657,822,835
50,12,27,Florida,DeSoto County,2,16,1353,640,713
50,12,27,Florida,DeSoto County,2,17,806,390,416
50,12,27,Florida,DeSoto County,2,18,533,223,310
50,12,27,Florida,DeSoto County,3,0,32262,18143,14119
50,12,27,Florida,DeSoto County,3,1,1876,941,935
50,12,27,Florida,DeSoto County,3,2,1938,1024,914
50,12,27,Florida,DeSoto County,3,3,2125,1110,1015
50,12,27,Florida,DeSoto County,3,4,2435,1429,1006
50,12,27,Florida,DeSoto County,3,5,2559,1857,702
50,12,27,Florida,DeSoto County,3,6,2485,1725,760
50,12,27,Florida,DeSoto County,3,7,2066,1310,756
50,12,27,Florida,DeSoto County,3,8,2093,1288,805
50,12,27,Florida,DeSoto County,3,9,1963,1152,811
50,12,27,Florida,DeSoto County,3,10,1744,983,761
50,12,27,Florida,DeSoto County,3,11,1618,804,814
50,12,27,Florida,DeSoto County,3,12,1622,810,812
50,12,27,Florida,DeSoto County,3,13,1634,766,868
50,12,27,Florida,DeSoto County,3,14,1753,867,886
50,12,27,Florida,DeSoto County,3,15,1651,820,831
50,12,27,Florida,DeSoto County,3,16,1353,640,713
50,12,27,Florida,DeSoto County,3,17,810,392,418
50,12,27,Florida,DeSoto County,3,18,537,225,312
50,12,27,Florida,DeSoto County,4,0,32603,18456,14147
50,12,27,Florida,DeSoto County,4,1,1955,1007,948
50,12,27,Florida,DeSoto County,4,2,1885,967,918
50,12,27,Florida,DeSoto County,4,3,2154,1144,1010
50,12,27,Florida,DeSoto County,4,4,2422,1432,990
50,12,27,Florida,DeSoto County,4,5,2715,1958,757
50,12,27,Florida,DeSoto County,4,6,2511,1780,731
50,12,27,Florida,DeSoto County,4,7,2078,1354,724
50,12,27,Florida,DeSoto County,4,8,2144,1297,847
50,12,27,Florida,DeSoto County,4,9,2051,1225,826
50,12,27,Florida,DeSoto County,4,10,1789,986,803
50,12,27,Florida,DeSoto County,4,11,1636,824,812
50,12,27,Florida,DeSoto County,4,12,1616,796,820
50,12,27,Florida,DeSoto County,4,13,1627,794,833
50,12,27,Florida,DeSoto County,4,14,1681,827,854
50,12,27,Florida,DeSoto County,4,15,1632,805,827
50,12,27,Florida,DeSoto County,4,16,1312,613,699
50,12,27,Florida,DeSoto County,4,17,864,428,436
50,12,27,Florida,DeSoto County,4,18,531,219,312
50,12,27,Florida,DeSoto County,5,0,32662,18596,14066
50,12,27,Florida,DeSoto County,5,1,2099,1104,995
50,12,27,Florida,DeSoto County,5,2,1838,928,910
50,12,27,Florida,DeSoto County,5,3,2105,1153,952
50,12,27,Florida,DeSoto County,5,4,2358,1400,958
50,12,27,Florida,DeSoto County,5,5,2882,2082,800
50,12,27,Florida,DeSoto County,5,6,2493,1800,693
50,12,27,Florida,DeSoto County,5,7,2177,1408,769
50,12,27,Florida,DeSoto County,5,8,2025,1241,784
50,12,27,Florida,DeSoto County,5,9,2070,1237,833
50,12,27,Florida,DeSoto County,5,10,1874,1013,861
50,12,27,Florida,DeSoto County,5,11,1610,842,768
50,12,27,Florida,DeSoto County,5,12,1615,811,804
50,12,27,Florida,DeSoto County,5,13,1641,790,851
50,12,27,Florida,DeSoto County,5,14,1591,749,842
50,12,27,Florida,DeSoto County,5,15,1580,780,800
50,12,27,Florida,DeSoto County,5,16,1262,613,649
50,12,27,Florida,DeSoto County,5,17,894,421,473
50,12,27,Florida,DeSoto County,5,18,548,224,324
50,12,27,Florida,DeSoto County,6,0,33531,19197,14334
50,12,27,Florida,DeSoto County,6,1,2293,1203,1090
50,12,27,Florida,DeSoto County,6,2,1769,881,888
50,12,27,Florida,DeSoto County,6,3,2131,1178,953
50,12,27,Florida,DeSoto County,6,4,2390,1416,974
50,12,27,Florida,DeSoto County,6,5,3048,2218,830
50,12,27,Florida,DeSoto County,6,6,2617,1882,735
50,12,27,Florida,DeSoto County,6,7,2277,1491,786
50,12,27,Florida,DeSoto County,6,8,2072,1276,796
50,12,27,Florida,DeSoto County,6,9,2071,1248,823
50,12,27,Florida,DeSoto County,6,10,1953,1103,850
50,12,27,Florida,DeSoto County,6,11,1642,841,801
50,12,27,Florida,DeSoto County,6,12,1669,837,832
50,12,27,Florida,DeSoto County,6,13,1657,801,856
50,12,27,Florida,DeSoto County,6,14,1582,755,827
50,12,27,Florida,DeSoto County,6,15,1534,737,797
50,12,27,Florida,DeSoto County,6,16,1294,636,658
50,12,27,Florida,DeSoto County,6,17,958,452,506
50,12,27,Florida,DeSoto County,6,18,574,242,332
50,12,27,Florida,DeSoto County,7,0,34240,19621,14619
50,12,27,Florida,DeSoto County,7,1,2371,1223,1148
50,12,27,Florida,DeSoto County,7,2,1875,923,952
50,12,27,Florida,DeSoto County,7,3,2087,1177,910
50,12,27,Florida,DeSoto County,7,4,2376,1392,984
50,12,27,Florida,DeSoto County,7,5,3067,2200,867
50,12,27,Florida,DeSoto County,7,6,2741,1998,743
50,12,27,Florida,DeSoto County,7,7,2450,1615,835
50,12,27,Florida,DeSoto County,7,8,2026,1262,764
50,12,27,Florida,DeSoto County,7,9,2087,1257,830
50,12,27,Florida,DeSoto County,7,10,2020,1127,893
50,12,27,Florida,DeSoto County,7,11,1680,883,797
50,12,27,Florida,DeSoto County,7,12,1729,853,876
50,12,27,Florida,DeSoto County,7,13,1694,831,863
50,12,27,Florida,DeSoto County,7,14,1593,759,834
50,12,27,Florida,DeSoto County,7,15,1513,734,779
50,12,27,Florida,DeSoto County,7,16,1303,628,675
50,12,27,Florida,DeSoto County,7,17,993,479,514
50,12,27,Florida,DeSoto County,7,18,635,280,355
50,12,27,Florida,DeSoto County,8,0,34258,19786,14472
50,12,27,Florida,DeSoto County,8,1,2343,1215,1128
50,12,27,Florida,DeSoto County,8,2,1878,930,948
50,12,27,Florida,DeSoto County,8,3,1992,1105,887
50,12,27,Florida,DeSoto County,8,4,2426,1435,991
50,12,27,Florida,DeSoto County,8,5,3026,2187,839
50,12,27,Florida,DeSoto County,8,6,2916,2126,790
50,12,27,Florida,DeSoto County,8,7,2457,1662,795
50,12,27,Florida,DeSoto County,8,8,2071,1307,764
50,12,27,Florida,DeSoto County,8,9,2101,1255,846
50,12,27,Florida,DeSoto County,8,10,2017,1147,870
50,12,27,Florida,DeSoto County,8,11,1773,940,833
50,12,27,Florida,DeSoto County,8,12,1725,855,870
50,12,27,Florida,DeSoto County,8,13,1689,842,847
50,12,27,Florida,DeSoto County,8,14,1490,701,789
50,12,27,Florida,DeSoto County,8,15,1458,702,756
50,12,27,Florida,DeSoto County,8,16,1259,622,637
50,12,27,Florida,DeSoto County,8,17,967,453,514
50,12,27,Florida,DeSoto County,8,18,670,302,368
50,12,27,Florida,DeSoto County,9,0,34764,20138,14626
50,12,27,Florida,DeSoto County,9,1,2349,1205,1144
50,12,27,Florida,DeSoto County,9,2,1981,1008,973
50,12,27,Florida,DeSoto County,9,3,1965,1057,908
50,12,27,Florida,DeSoto County,9,4,2427,1453,974
50,12,27,Florida,DeSoto County,9,5,2994,2174,820
50,12,27,Florida,DeSoto County,9,6,3105,2239,866
50,12,27,Florida,DeSoto County,9,7,2493,1714,779
50,12,27,Florida,DeSoto County,9,8,2119,1369,750
50,12,27,Florida,DeSoto County,9,9,2086,1227,859
50,12,27,Florida,DeSoto County,9,10,2023,1177,846
50,12,27,Florida,DeSoto County,9,11,1809,944,865
50,12,27,Florida,DeSoto County,9,12,1748,873,875
50,12,27,Florida,DeSoto County,9,13,1682,825,857
50,12,27,Florida,DeSoto County,9,14,1526,743,783
50,12,27,Florida,DeSoto County,9,15,1442,699,743
50,12,27,Florida,DeSoto County,9,16,1314,639,675
50,12,27,Florida,DeSoto County,9,17,943,441,502
50,12,27,Florida,DeSoto County,9,18,758,351,407
50,12,27,Florida,DeSoto County,10,0,35096,20413,14683
50,12,27,Florida,DeSoto County,10,1,2372,1210,1162
50,12,27,Florida,DeSoto County,10,2,2099,1091,1008
50,12,27,Florida,DeSoto County,10,3,1920,1022,898
50,12,27,Florida,DeSoto County,10,4,2374,1446,928
50,12,27,Florida,DeSoto County,10,5,2950,2110,840
50,12,27,Florida,DeSoto County,10,6,3305,2388,917
50,12,27,Florida,DeSoto County,10,7,2484,1746,738
50,12,27,Florida,DeSoto County,10,8,2196,1410,786
50,12,27,Florida,DeSoto County,10,9,1954,1169,785
50,12,27,Florida,DeSoto County,10,10,2063,1209,854
50,12,27,Florida,DeSoto County,10,11,1868,965,903
50,12,27,Florida,DeSoto County,10,12,1724,896,828
50,12,27,Florida,DeSoto County,10,13,1699,846,853
50,12,27,Florida,DeSoto County,10,14,1587,765,822
50,12,27,Florida,DeSoto County,10,15,1358,629,729
50,12,27,Florida,DeSoto County,10,16,1324,643,681
50,12,27,Florida,DeSoto County,10,17,961,473,488
50,12,27,Florida,DeSoto County,10,18,858,395,463
50,12,27,Florida,DeSoto County,11,0,35036,20448,14588
50,12,27,Florida,DeSoto County,11,1,2353,1190,1163
50,12,27,Florida,DeSoto County,11,2,2156,1121,1035
50,12,27,Florida,DeSoto County,11,3,1814,955,859
50,12,27,Florida,DeSoto County,11,4,2323,1426,897
50,12,27,Florida,DeSoto County,11,5,2908,2078,830
50,12,27,Florida,DeSoto County,11,6,3268,2401,867
50,12,27,Florida,DeSoto County,11,7,2532,1773,759
50,12,27,Florida,DeSoto County,11,8,2243,1453,790
50,12,27,Florida,DeSoto County,11,9,1925,1154,771
50,12,27,Florida,DeSoto County,11,10,2006,1182,824
50,12,27,Florida,DeSoto County,11,11,1895,1019,876
50,12,27,Florida,DeSoto County,11,12,1715,870,845
50,12,27,Florida,DeSoto County,11,13,1671,839,832
50,12,27,Florida,DeSoto County,11,14,1654,800,854
50,12,27,Florida,DeSoto County,11,15,1380,650,730
50,12,27,Florida,DeSoto County,11,16,1287,612,675
50,12,27,Florida,DeSoto County,11,17,1018,506,512
50,12,27,Florida,DeSoto County,11,18,888,419,469
50,12,27,Florida,DeSoto County,12,0,35297,20710,14587
50,12,27,Florida,DeSoto County,12,1,2356,1210,1146
50,12,27,Florida,DeSoto County,12,2,2148,1098,1050
50,12,27,Florida,DeSoto County,12,3,1855,966,889
50,12,27,Florida,DeSoto County,12,4,2254,1404,850
50,12,27,Florida,DeSoto County,12,5,2918,2087,831
50,12,27,Florida,DeSoto County,12,6,3296,2393,903
50,12,27,Florida,DeSoto County,12,7,2615,1877,738
50,12,27,Florida,DeSoto County,12,8,2327,1535,792
50,12,27,Florida,DeSoto County,12,9,1889,1150,739
50,12,27,Florida,DeSoto County,12,10,1996,1183,813
50,12,27,Florida,DeSoto County,12,11,1920,1029,891
50,12,27,Florida,DeSoto County,12,12,1683,879,804
50,12,27,Florida,DeSoto County,12,13,1698,840,858
50,12,27,Florida,DeSoto County,12,14,1654,808,846
50,12,27,Florida,DeSoto County,12,15,1437,680,757
50,12,27,Florida,DeSoto County,12,16,1269,611,658
50,12,27,Florida,DeSoto County,12,17,1027,497,530
50,12,27,Florida,DeSoto County,12,18,955,463,492
50,12,29,Florida,Dixie County,1,0,13827,7364,6463
50,12,29,Florida,Dixie County,1,1,770,396,374
50,12,29,Florida,Dixie County,1,2,819,413,406
50,12,29,Florida,Dixie County,1,3,871,440,431
50,12,29,Florida,Dixie County,1,4,916,482,434
50,12,29,Florida,Dixie County,1,5,774,438,336
50,12,29,Florida,Dixie County,1,6,808,470,338
50,12,29,Florida,Dixie County,1,7,825,497,328
50,12,29,Florida,Dixie County,1,8,1004,606,398
50,12,29,Florida,Dixie County,1,9,1046,588,458
50,12,29,Florida,Dixie County,1,10,916,501,415
50,12,29,Florida,Dixie County,1,11,949,472,477
50,12,29,Florida,Dixie County,1,12,877,443,434
50,12,29,Florida,Dixie County,1,13,883,443,440
50,12,29,Florida,Dixie County,1,14,800,431,369
50,12,29,Florida,Dixie County,1,15,675,318,357
50,12,29,Florida,Dixie County,1,16,479,258,221
50,12,29,Florida,Dixie County,1,17,250,115,135
50,12,29,Florida,Dixie County,1,18,165,53,112
50,12,29,Florida,Dixie County,2,0,13827,7364,6463
50,12,29,Florida,Dixie County,2,1,770,396,374
50,12,29,Florida,Dixie County,2,2,819,413,406
50,12,29,Florida,Dixie County,2,3,871,440,431
50,12,29,Florida,Dixie County,2,4,916,482,434
50,12,29,Florida,Dixie County,2,5,774,438,336
50,12,29,Florida,Dixie County,2,6,808,470,338
50,12,29,Florida,Dixie County,2,7,825,497,328
50,12,29,Florida,Dixie County,2,8,1004,606,398
50,12,29,Florida,Dixie County,2,9,1046,588,458
50,12,29,Florida,Dixie County,2,10,916,501,415
50,12,29,Florida,Dixie County,2,11,949,472,477
50,12,29,Florida,Dixie County,2,12,877,443,434
50,12,29,Florida,Dixie County,2,13,883,443,440
50,12,29,Florida,Dixie County,2,14,800,431,369
50,12,29,Florida,Dixie County,2,15,675,318,357
50,12,29,Florida,Dixie County,2,16,479,258,221
50,12,29,Florida,Dixie County,2,17,250,115,135
50,12,29,Florida,Dixie County,2,18,165,53,112
50,12,29,Florida,Dixie County,3,0,13817,7362,6455
50,12,29,Florida,Dixie County,3,1,765,393,372
50,12,29,Florida,Dixie County,3,2,812,409,403
50,12,29,Florida,Dixie County,3,3,870,439,431
50,12,29,Florida,Dixie County,3,4,915,482,433
50,12,29,Florida,Dixie County,3,5,780,441,339
50,12,29,Florida,Dixie County,3,6,803,468,335
50,12,29,Florida,Dixie County,3,7,823,497,326
50,12,29,Florida,Dixie County,3,8,998,603,395
50,12,29,Florida,Dixie County,3,9,1044,587,457
50,12,29,Florida,Dixie County,3,10,919,502,417
50,12,29,Florida,Dixie County,3,11,953,474,479
50,12,29,Florida,Dixie County,3,12,880,445,435
50,12,29,Florida,Dixie County,3,13,881,442,439
50,12,29,Florida,Dixie County,3,14,799,431,368
50,12,29,Florida,Dixie County,3,15,675,319,356
50,12,29,Florida,Dixie County,3,16,480,260,220
50,12,29,Florida,Dixie County,3,17,254,117,137
50,12,29,Florida,Dixie County,3,18,166,53,113
50,12,29,Florida,Dixie County,4,0,13921,7386,6535
50,12,29,Florida,Dixie County,4,1,788,415,373
50,12,29,Florida,Dixie County,4,2,819,405,414
50,12,29,Florida,Dixie County,4,3,846,424,422
50,12,29,Florida,Dixie County,4,4,862,451,411
50,12,29,Florida,Dixie County,4,5,831,471,360
50,12,29,Florida,Dixie County,4,6,757,455,302
50,12,29,Florida,Dixie County,4,7,815,467,348
50,12,29,Florida,Dixie County,4,8,965,586,379
50,12,29,Florida,Dixie County,4,9,1041,584,457
50,12,29,Florida,Dixie County,4,10,956,507,449
50,12,29,Florida,Dixie County,4,11,969,495,474
50,12,29,Florida,Dixie County,4,12,894,454,440
50,12,29,Florida,Dixie County,4,13,884,424,460
50,12,29,Florida,Dixie County,4,14,821,447,374
50,12,29,Florida,Dixie County,4,15,677,326,351
50,12,29,Florida,Dixie County,4,16,549,287,262
50,12,29,Florida,Dixie County,4,17,265,127,138
50,12,29,Florida,Dixie County,4,18,182,61,121
50,12,29,Florida,Dixie County,5,0,13940,7308,6632
50,12,29,Florida,Dixie County,5,1,834,427,407
50,12,29,Florida,Dixie County,5,2,805,404,401
50,12,29,Florida,Dixie County,5,3,838,416,422
50,12,29,Florida,Dixie County,5,4,857,449,408
50,12,29,Florida,Dixie County,5,5,874,481,393
50,12,29,Florida,Dixie County,5,6,769,457,312
50,12,29,Florida,Dixie County,5,7,776,429,347
50,12,29,Florida,Dixie County,5,8,924,551,373
50,12,29,Florida,Dixie County,5,9,1045,576,469
50,12,29,Florida,Dixie County,5,10,960,504,456
50,12,29,Florida,Dixie County,5,11,913,464,449
50,12,29,Florida,Dixie County,5,12,969,485,484
50,12,29,Florida,Dixie County,5,13,864,411,453
50,12,29,Florida,Dixie County,5,14,813,429,384
50,12,29,Florida,Dixie County,5,15,681,331,350
50,12,29,Florida,Dixie County,5,16,542,293,249
50,12,29,Florida,Dixie County,5,17,287,132,155
50,12,29,Florida,Dixie County,5,18,189,69,120
50,12,29,Florida,Dixie County,6,0,13895,7292,6603
50,12,29,Florida,Dixie County,6,1,772,400,372
50,12,29,Florida,Dixie County,6,2,790,404,386
50,12,29,Florida,Dixie County,6,3,893,432,461
50,12,29,Florida,Dixie County,6,4,799,424,375
50,12,29,Florida,Dixie County,6,5,877,487,390
50,12,29,Florida,Dixie County,6,6,763,459,304
50,12,29,Florida,Dixie County,6,7,777,423,354
50,12,29,Florida,Dixie County,6,8,893,535,358
50,12,29,Florida,Dixie County,6,9,1043,597,446
50,12,29,Florida,Dixie County,6,10,976,490,486
50,12,29,Florida,Dixie County,6,11,894,471,423
50,12,29,Florida,Dixie County,6,12,989,493,496
50,12,29,Florida,Dixie County,6,13,889,420,469
50,12,29,Florida,Dixie County,6,14,791,407,384
50,12,29,Florida,Dixie County,6,15,669,343,326
50,12,29,Florida,Dixie County,6,16,555,274,281
50,12,29,Florida,Dixie County,6,17,318,150,168
50,12,29,Florida,Dixie County,6,18,207,83,124
50,12,29,Florida,Dixie County,7,0,14199,7552,6647
50,12,29,Florida,Dixie County,7,1,803,403,400
50,12,29,Florida,Dixie County,7,2,768,390,378
50,12,29,Florida,Dixie County,7,3,884,444,440
50,12,29,Florida,Dixie County,7,4,782,419,363
50,12,29,Florida,Dixie County,7,5,908,512,396
50,12,29,Florida,Dixie County,7,6,832,522,310
50,12,29,Florida,Dixie County,7,7,813,469,344
50,12,29,Florida,Dixie County,7,8,914,560,354
50,12,29,Florida,Dixie County,7,9,1062,630,432
50,12,29,Florida,Dixie County,7,10,1027,541,486
50,12,29,Florida,Dixie County,7,11,905,459,446
50,12,29,Florida,Dixie County,7,12,993,500,493
50,12,29,Florida,Dixie County,7,13,921,447,474
50,12,29,Florida,Dixie County,7,14,786,385,401
50,12,29,Florida,Dixie County,7,15,680,347,333
50,12,29,Florida,Dixie County,7,16,551,262,289
50,12,29,Florida,Dixie County,7,17,350,173,177
50,12,29,Florida,Dixie County,7,18,220,89,131
50,12,29,Florida,Dixie County,8,0,14600,7854,6746
50,12,29,Florida,Dixie County,8,1,821,412,409
50,12,29,Florida,Dixie County,8,2,767,394,373
50,12,29,Florida,Dixie County,8,3,822,415,407
50,12,29,Florida,Dixie County,8,4,836,432,404
50,12,29,Florida,Dixie County,8,5,930,558,372
50,12,29,Florida,Dixie County,8,6,953,594,359
50,12,29,Florida,Dixie County,8,7,816,486,330
50,12,29,Florida,Dixie County,8,8,926,590,336
50,12,29,Florida,Dixie County,8,9,1112,674,438
50,12,29,Florida,Dixie County,8,10,1059,566,493
50,12,29,Florida,Dixie County,8,11,948,501,447
50,12,29,Florida,Dixie County,8,12,1013,483,530
50,12,29,Florida,Dixie County,8,13,927,455,472
50,12,29,Florida,Dixie County,8,14,829,406,423
50,12,29,Florida,Dixie County,8,15,671,349,322
50,12,29,Florida,Dixie County,8,16,543,246,297
50,12,29,Florida,Dixie County,8,17,394,201,193
50,12,29,Florida,Dixie County,8,18,233,92,141
50,12,29,Florida,Dixie County,9,0,14859,7977,6882
50,12,29,Florida,Dixie County,9,1,820,415,405
50,12,29,Florida,Dixie County,9,2,812,427,385
50,12,29,Florida,Dixie County,9,3,847,419,428
50,12,29,Florida,Dixie County,9,4,827,423,404
50,12,29,Florida,Dixie County,9,5,914,546,368
50,12,29,Florida,Dixie County,9,6,1036,640,396
50,12,29,Florida,Dixie County,9,7,804,495,309
50,12,29,Florida,Dixie County,9,8,945,580,365
50,12,29,Florida,Dixie County,9,9,1048,647,401
50,12,29,Florida,Dixie County,9,10,1084,584,500
50,12,29,Florida,Dixie County,9,11,996,515,481
50,12,29,Florida,Dixie County,9,12,1013,496,517
50,12,29,Florida,Dixie County,9,13,975,483,492
50,12,29,Florida,Dixie County,9,14,833,388,445
50,12,29,Florida,Dixie County,9,15,681,356,325
50,12,29,Florida,Dixie County,9,16,534,244,290
50,12,29,Florida,Dixie County,9,17,434,209,225
50,12,29,Florida,Dixie County,9,18,256,110,146
50,12,29,Florida,Dixie County,10,0,14871,7952,6919
50,12,29,Florida,Dixie County,10,1,851,438,413
50,12,29,Florida,Dixie County,10,2,835,427,408
50,12,29,Florida,Dixie County,10,3,833,418,415
50,12,29,Florida,Dixie County,10,4,803,408,395
50,12,29,Florida,Dixie County,10,5,916,543,373
50,12,29,Florida,Dixie County,10,6,1039,642,397
50,12,29,Florida,Dixie County,10,7,794,498,296
50,12,29,Florida,Dixie County,10,8,902,546,356
50,12,29,Florida,Dixie County,10,9,1030,631,399
50,12,29,Florida,Dixie County,10,10,1066,575,491
50,12,29,Florida,Dixie County,10,11,1033,534,499
50,12,29,Florida,Dixie County,10,12,953,469,484
50,12,29,Florida,Dixie County,10,13,1026,503,523
50,12,29,Florida,Dixie County,10,14,827,376,451
50,12,29,Florida,Dixie County,10,15,702,357,345
50,12,29,Florida,Dixie County,10,16,554,259,295
50,12,29,Florida,Dixie County,10,17,416,206,210
50,12,29,Florida,Dixie County,10,18,291,122,169
50,12,29,Florida,Dixie County,11,0,14846,7961,6885
50,12,29,Florida,Dixie County,11,1,890,460,430
50,12,29,Florida,Dixie County,11,2,777,403,374
50,12,29,Florida,Dixie County,11,3,772,395,377
50,12,29,Florida,Dixie County,11,4,816,405,411
50,12,29,Florida,Dixie County,11,5,878,534,344
50,12,29,Florida,Dixie County,11,6,1102,676,426
50,12,29,Florida,Dixie County,11,7,792,502,290
50,12,29,Florida,Dixie County,11,8,877,525,352
50,12,29,Florida,Dixie County,11,9,973,602,371
50,12,29,Florida,Dixie County,11,10,1081,600,481
50,12,29,Florida,Dixie County,11,11,1078,536,542
50,12,29,Florida,Dixie County,11,12,920,467,453
50,12,29,Florida,Dixie County,11,13,1044,513,531
50,12,29,Florida,Dixie County,11,14,860,387,473
50,12,29,Florida,Dixie County,11,15,690,339,351
50,12,29,Florida,Dixie County,11,16,554,280,274
50,12,29,Florida,Dixie County,11,17,424,189,235
50,12,29,Florida,Dixie County,11,18,318,148,170
50,12,29,Florida,Dixie County,12,0,14824,7963,6861
50,12,29,Florida,Dixie County,12,1,889,461,428
50,12,29,Florida,Dixie County,12,2,833,419,414
50,12,29,Florida,Dixie County,12,3,749,380,369
50,12,29,Florida,Dixie County,12,4,797,413,384
50,12,29,Florida,Dixie County,12,5,837,521,316
50,12,29,Florida,Dixie County,12,6,1111,673,438
50,12,29,Florida,Dixie County,12,7,860,543,317
50,12,29,Florida,Dixie County,12,8,840,516,324
50,12,29,Florida,Dixie County,12,9,940,580,360
50,12,29,Florida,Dixie County,12,10,1014,572,442
50,12,29,Florida,Dixie County,12,11,1088,559,529
50,12,29,Florida,Dixie County,12,12,955,462,493
50,12,29,Florida,Dixie County,12,13,1019,503,516
50,12,29,Florida,Dixie County,12,14,904,422,482
50,12,29,Florida,Dixie County,12,15,679,317,362
50,12,29,Florida,Dixie County,12,16,553,273,280
50,12,29,Florida,Dixie County,12,17,423,188,235
50,12,29,Florida,Dixie County,12,18,333,161,172
50,12,31,Florida,Duval County,1,0,778879,377781,401098
50,12,31,Florida,Duval County,1,1,56247,28624,27623
50,12,31,Florida,Duval County,1,2,57959,29583,28376
50,12,31,Florida,Duval County,1,3,57826,29597,28229
50,12,31,Florida,Duval County,1,4,54381,27433,26948
50,12,31,Florida,Duval County,1,5,53365,26494,26871
50,12,31,Florida,Duval County,1,6,59664,29534,30130
50,12,31,Florida,Duval County,1,7,61317,30568,30749
50,12,31,Florida,Duval County,1,8,67216,33264,33952
50,12,31,Florida,Duval County,1,9,64190,31469,32721
50,12,31,Florida,Duval County,1,10,55493,26672,28821
50,12,31,Florida,Duval County,1,11,48039,23155,24884
50,12,31,Florida,Duval County,1,12,34768,16438,18330
50,12,31,Florida,Duval County,1,13,26661,12501,14160
50,12,31,Florida,Duval County,1,14,22670,10250,12420
50,12,31,Florida,Duval County,1,15,20915,8753,12162
50,12,31,Florida,Duval County,1,16,17753,6926,10827
50,12,31,Florida,Duval County,1,17,11251,4011,7240
50,12,31,Florida,Duval County,1,18,9164,2509,6655
50,12,31,Florida,Duval County,2,0,778866,377768,401098
50,12,31,Florida,Duval County,2,1,56247,28624,27623
50,12,31,Florida,Duval County,2,2,57959,29583,28376
50,12,31,Florida,Duval County,2,3,57826,29597,28229
50,12,31,Florida,Duval County,2,4,54380,27432,26948
50,12,31,Florida,Duval County,2,5,53365,26494,26871
50,12,31,Florida,Duval County,2,6,59663,29533,30130
50,12,31,Florida,Duval County,2,7,61316,30567,30749
50,12,31,Florida,Duval County,2,8,67210,33258,33952
50,12,31,Florida,Duval County,2,9,64190,31469,32721
50,12,31,Florida,Duval County,2,10,55492,26671,28821
50,12,31,Florida,Duval County,2,11,48037,23153,24884
50,12,31,Florida,Duval County,2,12,34767,16437,18330
50,12,31,Florida,Duval County,2,13,26661,12501,14160
50,12,31,Florida,Duval County,2,14,22670,10250,12420
50,12,31,Florida,Duval County,2,15,20915,8753,12162
50,12,31,Florida,Duval County,2,16,17753,6926,10827
50,12,31,Florida,Duval County,2,17,11251,4011,7240
50,12,31,Florida,Duval County,2,18,9164,2509,6655
50,12,31,Florida,Duval County,3,0,779803,378247,401556
50,12,31,Florida,Duval County,3,1,56202,28595,27607
50,12,31,Florida,Duval County,3,2,57633,29417,28216
50,12,31,Florida,Duval County,3,3,58054,29710,28344
50,12,31,Florida,Duval County,3,4,54423,27471,26952
50,12,31,Florida,Duval County,3,5,53802,26726,27076
50,12,31,Florida,Duval County,3,6,59258,29332,29926
50,12,31,Florida,Duval County,3,7,61251,30536,30715
50,12,31,Florida,Duval County,3,8,66915,33112,33803
50,12,31,Florida,Duval County,3,9,64318,31529,32789
50,12,31,Florida,Duval County,3,10,55779,26815,28964
50,12,31,Florida,Duval County,3,11,48501,23382,25119
50,12,31,Florida,Duval County,3,12,34935,16517,18418
50,12,31,Florida,Duval County,3,13,26742,12544,14198
50,12,31,Florida,Duval County,3,14,22650,10242,12408
50,12,31,Florida,Duval County,3,15,20926,8773,12153
50,12,31,Florida,Duval County,3,16,17829,6961,10868
50,12,31,Florida,Duval County,3,17,11355,4056,7299
50,12,31,Florida,Duval County,3,18,9230,2529,6701
50,12,31,Florida,Duval County,4,0,791064,383756,407308
50,12,31,Florida,Duval County,4,1,57591,29289,28302
50,12,31,Florida,Duval County,4,2,56790,28979,27811
50,12,31,Florida,Duval County,4,3,58930,30152,28778
50,12,31,Florida,Duval County,4,4,54390,27703,26687
50,12,31,Florida,Duval County,4,5,58134,28691,29443
50,12,31,Florida,Duval County,4,6,58098,28827,29271
50,12,31,Florida,Duval County,4,7,62058,30771,31287
50,12,31,Florida,Duval County,4,8,65306,32287,33019
50,12,31,Florida,Duval County,4,9,65516,32219,33297
50,12,31,Florida,Duval County,4,10,57243,27530,29713
50,12,31,Florida,Duval County,4,11,51138,24514,26624
50,12,31,Florida,Duval County,4,12,36114,17129,18985
50,12,31,Florida,Duval County,4,13,27364,12858,14506
50,12,31,Florida,Duval County,4,14,22335,10137,12198
50,12,31,Florida,Duval County,4,15,20355,8630,11725
50,12,31,Florida,Duval County,4,16,17906,6996,10910
50,12,31,Florida,Duval County,4,17,11935,4323,7612
50,12,31,Florida,Duval County,4,18,9861,2721,7140
50,12,31,Florida,Duval County,5,0,802673,389475,413198
50,12,31,Florida,Duval County,5,1,58697,29864,28833
50,12,31,Florida,Duval County,5,2,56445,28690,27755
50,12,31,Florida,Duval County,5,3,59328,30375,28953
50,12,31,Florida,Duval County,5,4,54967,28270,26697
50,12,31,Florida,Duval County,5,5,61196,30157,31039
50,12,31,Florida,Duval County,5,6,58422,28947,29475
50,12,31,Florida,Duval County,5,7,62918,31070,31848
50,12,31,Florida,Duval County,5,8,63643,31407,32236
50,12,31,Florida,Duval County,5,9,65837,32330,33507
50,12,31,Florida,Duval County,5,10,59420,28685,30735
50,12,31,Florida,Duval County,5,11,51289,24392,26897
50,12,31,Florida,Duval County,5,12,39405,18893,20512
50,12,31,Florida,Duval County,5,13,28241,13250,14991
50,12,31,Florida,Duval County,5,14,22271,10043,12228
50,12,31,Florida,Duval County,5,15,20000,8655,11345
50,12,31,Florida,Duval County,5,16,17930,7052,10878
50,12,31,Florida,Duval County,5,17,12502,4554,7948
50,12,31,Florida,Duval County,5,18,10162,2841,7321
50,12,31,Florida,Duval County,6,0,812238,393081,419157
50,12,31,Florida,Duval County,6,1,60339,30735,29604
50,12,31,Florida,Duval County,6,2,56164,28601,27563
50,12,31,Florida,Duval County,6,3,59561,30443,29118
50,12,31,Florida,Duval County,6,4,55284,28401,26883
50,12,31,Florida,Duval County,6,5,62482,30502,31980
50,12,31,Florida,Duval County,6,6,59878,29228,30650
50,12,31,Florida,Duval County,6,7,62782,30817,31965
50,12,31,Florida,Duval County,6,8,61984,30411,31573
50,12,31,Florida,Duval County,6,9,65656,32248,33408
50,12,31,Florida,Duval County,6,10,61120,29558,31562
50,12,31,Florida,Duval County,6,11,51965,24603,27362
50,12,31,Florida,Duval County,6,12,41821,19980,21841
50,12,31,Florida,Duval County,6,13,29694,13925,15769
50,12,31,Florida,Duval County,6,14,22431,10247,12184
50,12,31,Florida,Duval County,6,15,19666,8592,11074
50,12,31,Florida,Duval County,6,16,17783,6988,10795
50,12,31,Florida,Duval County,6,17,13151,4808,8343
50,12,31,Florida,Duval County,6,18,10477,2994,7483
50,12,31,Florida,Duval County,7,0,821644,398239,423405
50,12,31,Florida,Duval County,7,1,61289,31148,30141
50,12,31,Florida,Duval County,7,2,56035,28669,27366
50,12,31,Florida,Duval County,7,3,58953,30036,28917
50,12,31,Florida,Duval County,7,4,56240,28985,27255
50,12,31,Florida,Duval County,7,5,64019,31772,32247
50,12,31,Florida,Duval County,7,6,62679,30449,32230
50,12,31,Florida,Duval County,7,7,61944,30400,31544
50,12,31,Florida,Duval County,7,8,60599,29873,30726
50,12,31,Florida,Duval County,7,9,65956,32358,33598
50,12,31,Florida,Duval County,7,10,61925,29919,32006
50,12,31,Florida,Duval County,7,11,52939,25201,27738
50,12,31,Florida,Duval County,7,12,43950,20941,23009
50,12,31,Florida,Duval County,7,13,30881,14349,16532
50,12,31,Florida,Duval County,7,14,22684,10541,12143
50,12,31,Florida,Duval County,7,15,19471,8499,10972
50,12,31,Florida,Duval County,7,16,17670,7028,10642
50,12,31,Florida,Duval County,7,17,13675,4992,8683
50,12,31,Florida,Duval County,7,18,10735,3079,7656
50,12,31,Florida,Duval County,8,0,830828,402913,427915
50,12,31,Florida,Duval County,8,1,62208,31831,30377
50,12,31,Florida,Duval County,8,2,56307,28602,27705
50,12,31,Florida,Duval County,8,3,57392,29249,28143
50,12,31,Florida,Duval County,8,4,57186,29557,27629
50,12,31,Florida,Duval County,8,5,64393,32466,31927
50,12,31,Florida,Duval County,8,6,65720,31640,34080
50,12,31,Florida,Duval County,8,7,60601,29621,30980
50,12,31,Florida,Duval County,8,8,60097,29643,30454
50,12,31,Florida,Duval County,8,9,65468,32050,33418
50,12,31,Florida,Duval County,8,10,63015,30563,32452
50,12,31,Florida,Duval County,8,11,54490,25898,28592
50,12,31,Florida,Duval County,8,12,46411,22105,24306
50,12,31,Florida,Duval County,8,13,31910,14900,17010
50,12,31,Florida,Duval County,8,14,23279,10723,12556
50,12,31,Florida,Duval County,8,15,19473,8569,10904
50,12,31,Florida,Duval County,8,16,17591,7070,10521
50,12,31,Florida,Duval County,8,17,13864,5110,8754
50,12,31,Florida,Duval County,8,18,11423,3316,8107
50,12,31,Florida,Duval County,9,0,842100,408351,433749
50,12,31,Florida,Duval County,9,1,63329,32588,30741
50,12,31,Florida,Duval County,9,2,57128,28980,28148
50,12,31,Florida,Duval County,9,3,56051,28555,27496
50,12,31,Florida,Duval County,9,4,57915,29822,28093
50,12,31,Florida,Duval County,9,5,63800,32431,31369
50,12,31,Florida,Duval County,9,6,69624,33185,36439
50,12,31,Florida,Duval County,9,7,59262,29030,30232
50,12,31,Florida,Duval County,9,8,60607,29737,30870
50,12,31,Florida,Duval County,9,9,64087,31423,32664
50,12,31,Florida,Duval County,9,10,64229,31267,32962
50,12,31,Florida,Duval County,9,11,55951,26624,29327
50,12,31,Florida,Duval County,9,12,49072,23236,25836
50,12,31,Florida,Duval County,9,13,33196,15536,17660
50,12,31,Florida,Duval County,9,14,24241,11212,13029
50,12,31,Florida,Duval County,9,15,19692,8699,10993
50,12,31,Florida,Duval County,9,16,17520,7159,10361
50,12,31,Florida,Duval County,9,17,14234,5285,8949
50,12,31,Florida,Duval County,9,18,12162,3582,8580
50,12,31,Florida,Duval County,10,0,848841,411053,437788
50,12,31,Florida,Duval County,10,1,64552,33291,31261
50,12,31,Florida,Duval County,10,2,57517,29185,28332
50,12,31,Florida,Duval County,10,3,55235,28059,27176
50,12,31,Florida,Duval County,10,4,56921,29201,27720
50,12,31,Florida,Duval County,10,5,62961,31799,31162
50,12,31,Florida,Duval County,10,6,71894,34124,37770
50,12,31,Florida,Duval County,10,7,58657,28610,30047
50,12,31,Florida,Duval County,10,8,60966,29807,31159
50,12,31,Florida,Duval County,10,9,62206,30517,31689
50,12,31,Florida,Duval County,10,10,64411,31361,33050
50,12,31,Florida,Duval County,10,11,58105,27791,30314
50,12,31,Florida,Duval County,10,12,49416,23216,26200
50,12,31,Florida,Duval County,10,13,36387,17249,19138
50,12,31,Florida,Duval County,10,14,25181,11589,13592
50,12,31,Florida,Duval County,10,15,19800,8725,11075
50,12,31,Florida,Duval County,10,16,17310,7274,10036
50,12,31,Florida,Duval County,10,17,14351,5390,8961
50,12,31,Florida,Duval County,10,18,12971,3865,9106
50,12,31,Florida,Duval County,11,0,853116,413012,440104
50,12,31,Florida,Duval County,11,1,64783,33398,31385
50,12,31,Florida,Duval County,11,2,58066,29501,28565
50,12,31,Florida,Duval County,11,3,54133,27564,26569
50,12,31,Florida,Duval County,11,4,56293,28789,27504
50,12,31,Florida,Duval County,11,5,62554,31621,30933
50,12,31,Florida,Duval County,11,6,72291,34569,37722
50,12,31,Florida,Duval County,11,7,59622,28791,30831
50,12,31,Florida,Duval County,11,8,60182,29368,30814
50,12,31,Florida,Duval County,11,9,60184,29486,30698
50,12,31,Florida,Duval County,11,10,64465,31487,32978
50,12,31,Florida,Duval County,11,11,59648,28616,31032
50,12,31,Florida,Duval County,11,12,50022,23429,26593
50,12,31,Florida,Duval County,11,13,38825,18319,20506
50,12,31,Florida,Duval County,11,14,26645,12277,14368
50,12,31,Florida,Duval County,11,15,20023,8947,11076
50,12,31,Florida,Duval County,11,16,17203,7260,9943
50,12,31,Florida,Duval County,11,17,14284,5339,8945
50,12,31,Florida,Duval County,11,18,13893,4251,9642
50,12,31,Florida,Duval County,12,0,857040,414868,442172
50,12,31,Florida,Duval County,12,1,64721,33345,31376
50,12,31,Florida,Duval County,12,2,58645,29739,28906
50,12,31,Florida,Duval County,12,3,53505,27396,26109
50,12,31,Florida,Duval County,12,4,54978,28051,26927
50,12,31,Florida,Duval County,12,5,62363,31535,30828
50,12,31,Florida,Duval County,12,6,72154,34839,37315
50,12,31,Florida,Duval County,12,7,61804,29577,32227
50,12,31,Florida,Duval County,12,8,59218,28841,30377
50,12,31,Florida,Duval County,12,9,58411,28705,29706
50,12,31,Florida,Duval County,12,10,64298,31324,32974
50,12,31,Florida,Duval County,12,11,60504,28976,31528
50,12,31,Florida,Duval County,12,12,51288,24162,27126
50,12,31,Florida,Duval County,12,13,41040,19334,21706
50,12,31,Florida,Duval County,12,14,27925,12740,15185
50,12,31,Florida,Duval County,12,15,20428,9284,11144
50,12,31,Florida,Duval County,12,16,17028,7180,9848
50,12,31,Florida,Duval County,12,17,14123,5334,8789
50,12,31,Florida,Duval County,12,18,14607,4506,10101
50,12,33,Florida,Escambia County,1,0,294410,146183,148227
50,12,33,Florida,Escambia County,1,1,17913,9147,8766
50,12,33,Florida,Escambia County,1,2,19513,9980,9533
50,12,33,Florida,Escambia County,1,3,20020,10128,9892
50,12,33,Florida,Escambia County,1,4,24197,13131,11066
50,12,33,Florida,Escambia County,1,5,23456,12708,10748
50,12,33,Florida,Escambia County,1,6,20433,11077,9356
50,12,33,Florida,Escambia County,1,7,19812,10404,9408
50,12,33,Florida,Escambia County,1,8,22575,11447,11128
50,12,33,Florida,Escambia County,1,9,22413,11171,11242
50,12,33,Florida,Escambia County,1,10,19789,9588,10201
50,12,33,Florida,Escambia County,1,11,18106,8666,9440
50,12,33,Florida,Escambia County,1,12,14552,6810,7742
50,12,33,Florida,Escambia County,1,13,12462,5864,6598
50,12,33,Florida,Escambia County,1,14,11186,5085,6101
50,12,33,Florida,Escambia County,1,15,10171,4372,5799
50,12,33,Florida,Escambia County,1,16,8306,3441,4865
50,12,33,Florida,Escambia County,1,17,5343,1992,3351
50,12,33,Florida,Escambia County,1,18,4163,1172,2991
50,12,33,Florida,Escambia County,2,0,294410,146183,148227
50,12,33,Florida,Escambia County,2,1,17913,9147,8766
50,12,33,Florida,Escambia County,2,2,19513,9980,9533
50,12,33,Florida,Escambia County,2,3,20020,10128,9892
50,12,33,Florida,Escambia County,2,4,24197,13131,11066
50,12,33,Florida,Escambia County,2,5,23456,12708,10748
50,12,33,Florida,Escambia County,2,6,20433,11077,9356
50,12,33,Florida,Escambia County,2,7,19812,10404,9408
50,12,33,Florida,Escambia County,2,8,22575,11447,11128
50,12,33,Florida,Escambia County,2,9,22413,11171,11242
50,12,33,Florida,Escambia County,2,10,19789,9588,10201
50,12,33,Florida,Escambia County,2,11,18106,8666,9440
50,12,33,Florida,Escambia County,2,12,14552,6810,7742
50,12,33,Florida,Escambia County,2,13,12462,5864,6598
50,12,33,Florida,Escambia County,2,14,11186,5085,6101
50,12,33,Florida,Escambia County,2,15,10171,4372,5799
50,12,33,Florida,Escambia County,2,16,8306,3441,4865
50,12,33,Florida,Escambia County,2,17,5343,1992,3351
50,12,33,Florida,Escambia County,2,18,4163,1172,2991
50,12,33,Florida,Escambia County,3,0,294784,146365,148419
50,12,33,Florida,Escambia County,3,1,17891,9134,8757
50,12,33,Florida,Escambia County,3,2,19400,9922,9478
50,12,33,Florida,Escambia County,3,3,20089,10161,9928
50,12,33,Florida,Escambia County,3,4,24211,13144,11067
50,12,33,Florida,Escambia County,3,5,23616,12793,10823
50,12,33,Florida,Escambia County,3,6,20300,11011,9289
50,12,33,Florida,Escambia County,3,7,19787,10391,9396
50,12,33,Florida,Escambia County,3,8,22475,11399,11076
50,12,33,Florida,Escambia County,3,9,22443,11183,11260
50,12,33,Florida,Escambia County,3,10,19885,9635,10250
50,12,33,Florida,Escambia County,3,11,18280,8750,9530
50,12,33,Florida,Escambia County,3,12,14618,6841,7777
50,12,33,Florida,Escambia County,3,13,12494,5879,6615
50,12,33,Florida,Escambia County,3,14,11184,5084,6100
50,12,33,Florida,Escambia County,3,15,10179,4381,5798
50,12,33,Florida,Escambia County,3,16,8342,3461,4881
50,12,33,Florida,Escambia County,3,17,5395,2014,3381
50,12,33,Florida,Escambia County,3,18,4195,1182,3013
50,12,33,Florida,Escambia County,4,0,298831,149275,149556
50,12,33,Florida,Escambia County,4,1,18172,9314,8858
50,12,33,Florida,Escambia County,4,2,18833,9589,9244
50,12,33,Florida,Escambia County,4,3,20014,10170,9844
50,12,33,Florida,Escambia County,4,4,25709,14212,11497
50,12,33,Florida,Escambia County,4,5,24930,13604,11326
50,12,33,Florida,Escambia County,4,6,19858,11002,8856
50,12,33,Florida,Escambia County,4,7,19915,10557,9358
50,12,33,Florida,Escambia County,4,8,21932,11216,10716
50,12,33,Florida,Escambia County,4,9,22625,11273,11352
50,12,33,Florida,Escambia County,4,10,20365,9862,10503
50,12,33,Florida,Escambia County,4,11,19095,9097,9998
50,12,33,Florida,Escambia County,4,12,14913,7006,7907
50,12,33,Florida,Escambia County,4,13,12714,5965,6749
50,12,33,Florida,Escambia County,4,14,11148,5084,6064
50,12,33,Florida,Escambia County,4,15,10088,4392,5696
50,12,33,Florida,Escambia County,4,16,8500,3487,5013
50,12,33,Florida,Escambia County,4,17,5684,2188,3496
50,12,33,Florida,Escambia County,4,18,4336,1257,3079
50,12,33,Florida,Escambia County,5,0,299746,149258,150488
50,12,33,Florida,Escambia County,5,1,18380,9363,9017
50,12,33,Florida,Escambia County,5,2,18260,9333,8927
50,12,33,Florida,Escambia County,5,3,19984,10183,9801
50,12,33,Florida,Escambia County,5,4,25905,14334,11571
50,12,33,Florida,Escambia County,5,5,25587,13712,11875
50,12,33,Florida,Escambia County,5,6,19344,10717,8627
50,12,33,Florida,Escambia County,5,7,19690,10366,9324
50,12,33,Florida,Escambia County,5,8,20708,10552,10156
50,12,33,Florida,Escambia County,5,9,22487,11105,11382
50,12,33,Florida,Escambia County,5,10,20647,10031,10616
50,12,33,Florida,Escambia County,5,11,18994,8992,10002
50,12,33,Florida,Escambia County,5,12,16254,7669,8585
50,12,33,Florida,Escambia County,5,13,13109,6116,6993
50,12,33,Florida,Escambia County,5,14,11095,5097,5998
50,12,33,Florida,Escambia County,5,15,10219,4551,5668
50,12,33,Florida,Escambia County,5,16,8566,3444,5122
50,12,33,Florida,Escambia County,5,17,5997,2349,3648
50,12,33,Florida,Escambia County,5,18,4520,1344,3176
50,12,33,Florida,Escambia County,6,0,301040,149293,151747
50,12,33,Florida,Escambia County,6,1,18861,9679,9182
50,12,33,Florida,Escambia County,6,2,17902,9146,8756
50,12,33,Florida,Escambia County,6,3,19946,10131,9815
50,12,33,Florida,Escambia County,6,4,25461,14129,11332
50,12,33,Florida,Escambia County,6,5,25346,13364,11982
50,12,33,Florida,Escambia County,6,6,19670,10735,8935
50,12,33,Florida,Escambia County,6,7,19329,10160,9169
50,12,33,Florida,Escambia County,6,8,19563,9899,9664
50,12,33,Florida,Escambia County,6,9,22362,10960,11402
50,12,33,Florida,Escambia County,6,10,21422,10354,11068
50,12,33,Florida,Escambia County,6,11,19226,9115,10111
50,12,33,Florida,Escambia County,6,12,16953,7977,8976
50,12,33,Florida,Escambia County,6,13,13853,6465,7388
50,12,33,Florida,Escambia County,6,14,11226,5225,6001
50,12,33,Florida,Escambia County,6,15,10253,4570,5683
50,12,33,Florida,Escambia County,6,16,8688,3490,5198
50,12,33,Florida,Escambia County,6,17,6229,2439,3790
50,12,33,Florida,Escambia County,6,18,4750,1455,3295
50,12,33,Florida,Escambia County,7,0,301768,148705,153063
50,12,33,Florida,Escambia County,7,1,19349,9901,9448
50,12,33,Florida,Escambia County,7,2,17596,8947,8649
50,12,33,Florida,Escambia County,7,3,19746,10079,9667
50,12,33,Florida,Escambia County,7,4,24883,13516,11367
50,12,33,Florida,Escambia County,7,5,25548,13342,12206
50,12,33,Florida,Escambia County,7,6,19809,10506,9303
50,12,33,Florida,Escambia County,7,7,18790,9900,8890
50,12,33,Florida,Escambia County,7,8,18846,9474,9372
50,12,33,Florida,Escambia County,7,9,22085,10793,11292
50,12,33,Florida,Escambia County,7,10,21730,10529,11201
50,12,33,Florida,Escambia County,7,11,19575,9221,10354
50,12,33,Florida,Escambia County,7,12,17494,8249,9245
50,12,33,Florida,Escambia County,7,13,14303,6651,7652
50,12,33,Florida,Escambia County,7,14,11687,5499,6188
50,12,33,Florida,Escambia County,7,15,10058,4467,5591
50,12,33,Florida,Escambia County,7,16,8711,3533,5178
50,12,33,Florida,Escambia County,7,17,6430,2476,3954
50,12,33,Florida,Escambia County,7,18,5128,1622,3506
50,12,33,Florida,Escambia County,8,0,302476,149061,153415
50,12,33,Florida,Escambia County,8,1,19673,10092,9581
50,12,33,Florida,Escambia County,8,2,17303,8848,8455
50,12,33,Florida,Escambia County,8,3,18940,9672,9268
50,12,33,Florida,Escambia County,8,4,24869,13447,11422
50,12,33,Florida,Escambia County,8,5,25967,13798,12169
50,12,33,Florida,Escambia County,8,6,20375,10623,9752
50,12,33,Florida,Escambia County,8,7,18075,9544,8531
50,12,33,Florida,Escambia County,8,8,18426,9339,9087
50,12,33,Florida,Escambia County,8,9,21222,10255,10967
50,12,33,Florida,Escambia County,8,10,22086,10733,11353
50,12,33,Florida,Escambia County,8,11,19830,9338,10492
50,12,33,Florida,Escambia County,8,12,18360,8647,9713
50,12,33,Florida,Escambia County,8,13,14640,6801,7839
50,12,33,Florida,Escambia County,8,14,11769,5530,6239
50,12,33,Florida,Escambia County,8,15,10055,4492,5563
50,12,33,Florida,Escambia County,8,16,8829,3604,5225
50,12,33,Florida,Escambia County,8,17,6581,2576,4005
50,12,33,Florida,Escambia County,8,18,5476,1722,3754
50,12,33,Florida,Escambia County,9,0,305287,151451,153836
50,12,33,Florida,Escambia County,9,1,20045,10256,9789
50,12,33,Florida,Escambia County,9,2,17493,8968,8525
50,12,33,Florida,Escambia County,9,3,18358,9326,9032
50,12,33,Florida,Escambia County,9,4,25527,14032,11495
50,12,33,Florida,Escambia County,9,5,27911,15152,12759
50,12,33,Florida,Escambia County,9,6,21077,11000,10077
50,12,33,Florida,Escambia County,9,7,17677,9551,8126
50,12,33,Florida,Escambia County,9,8,18325,9362,8963
50,12,33,Florida,Escambia County,9,9,20609,10033,10576
50,12,33,Florida,Escambia County,9,10,22021,10682,11339
50,12,33,Florida,Escambia County,9,11,20028,9447,10581
50,12,33,Florida,Escambia County,9,12,19096,8943,10153
50,12,33,Florida,Escambia County,9,13,14638,6831,7807
50,12,33,Florida,Escambia County,9,14,11690,5437,6253
50,12,33,Florida,Escambia County,9,15,9784,4412,5372
50,12,33,Florida,Escambia County,9,16,8645,3592,5053
50,12,33,Florida,Escambia County,9,17,6648,2556,4092
50,12,33,Florida,Escambia County,9,18,5715,1871,3844
50,12,33,Florida,Escambia County,10,0,302580,149207,153373
50,12,33,Florida,Escambia County,10,1,20536,10540,9996
50,12,33,Florida,Escambia County,10,2,17611,8978,8633
50,12,33,Florida,Escambia County,10,3,17704,9035,8669
50,12,33,Florida,Escambia County,10,4,24274,13163,11111
50,12,33,Florida,Escambia County,10,5,27027,14532,12495
50,12,33,Florida,Escambia County,10,6,21271,10882,10389
50,12,33,Florida,Escambia County,10,7,17093,9174,7919
50,12,33,Florida,Escambia County,10,8,17919,9079,8840
50,12,33,Florida,Escambia County,10,9,19239,9356,9883
50,12,33,Florida,Escambia County,10,10,21967,10568,11399
50,12,33,Florida,Escambia County,10,11,20227,9582,10645
50,12,33,Florida,Escambia County,10,12,18815,8749,10066
50,12,33,Florida,Escambia County,10,13,15694,7362,8332
50,12,33,Florida,Escambia County,10,14,11995,5538,6457
50,12,33,Florida,Escambia County,10,15,9669,4385,5284
50,12,33,Florida,Escambia County,10,16,8694,3738,4956
50,12,33,Florida,Escambia County,10,17,6756,2536,4220
50,12,33,Florida,Escambia County,10,18,6089,2010,4079
50,12,33,Florida,Escambia County,11,0,302776,149673,153103
50,12,33,Florida,Escambia County,11,1,20604,10515,10089
50,12,33,Florida,Escambia County,11,2,17774,9118,8656
50,12,33,Florida,Escambia County,11,3,16945,8651,8294
50,12,33,Florida,Escambia County,11,4,24096,13144,10952
50,12,33,Florida,Escambia County,11,5,27053,14764,12289
50,12,33,Florida,Escambia County,11,6,21979,11271,10708
50,12,33,Florida,Escambia County,11,7,17187,9215,7972
50,12,33,Florida,Escambia County,11,8,17547,9003,8544
50,12,33,Florida,Escambia County,11,9,18202,8870,9332
50,12,33,Florida,Escambia County,11,10,21466,10297,11169
50,12,33,Florida,Escambia County,11,11,20736,9795,10941
50,12,33,Florida,Escambia County,11,12,18708,8719,9989
50,12,33,Florida,Escambia County,11,13,16209,7575,8634
50,12,33,Florida,Escambia County,11,14,12561,5802,6759
50,12,33,Florida,Escambia County,11,15,9806,4471,5335
50,12,33,Florida,Escambia County,11,16,8627,3717,4910
50,12,33,Florida,Escambia County,11,17,6846,2574,4272
50,12,33,Florida,Escambia County,11,18,6430,2172,4258
50,12,33,Florida,Escambia County,12,0,303343,149940,153403
50,12,33,Florida,Escambia County,12,1,20576,10537,10039
50,12,33,Florida,Escambia County,12,2,18255,9342,8913
50,12,33,Florida,Escambia County,12,3,16402,8338,8064
50,12,33,Florida,Escambia County,12,4,23849,13076,10773
50,12,33,Florida,Escambia County,12,5,27063,14754,12309
50,12,33,Florida,Escambia County,12,6,22635,11740,10895
50,12,33,Florida,Escambia County,12,7,17395,9137,8258
50,12,33,Florida,Escambia County,12,8,17223,8957,8266
50,12,33,Florida,Escambia County,12,9,17465,8498,8967
50,12,33,Florida,Escambia County,12,10,20960,10030,10930
50,12,33,Florida,Escambia County,12,11,20808,9863,10945
50,12,33,Florida,Escambia County,12,12,18890,8742,10148
50,12,33,Florida,Escambia County,12,13,16659,7788,8871
50,12,33,Florida,Escambia County,12,14,12985,5998,6987
50,12,33,Florida,Escambia County,12,15,10095,4620,5475
50,12,33,Florida,Escambia County,12,16,8472,3625,4847
50,12,33,Florida,Escambia County,12,17,6838,2602,4236
50,12,33,Florida,Escambia County,12,18,6773,2293,4480
50,12,35,Florida,Flagler County,1,0,49832,23887,25945
50,12,35,Florida,Flagler County,1,1,2058,1047,1011
50,12,35,Florida,Flagler County,1,2,2381,1198,1183
50,12,35,Florida,Flagler County,1,3,2819,1450,1369
50,12,35,Florida,Flagler County,1,4,2505,1290,1215
50,12,35,Florida,Flagler County,1,5,1560,797,763
50,12,35,Florida,Flagler County,1,6,1759,858,901
50,12,35,Florida,Flagler County,1,7,2255,1088,1167
50,12,35,Florida,Flagler County,1,8,2886,1358,1528
50,12,35,Florida,Flagler County,1,9,3227,1500,1727
50,12,35,Florida,Flagler County,1,10,3235,1523,1712
50,12,35,Florida,Flagler County,1,11,3364,1526,1838
50,12,35,Florida,Flagler County,1,12,3515,1587,1928
50,12,35,Florida,Flagler County,1,13,3999,1827,2172
50,12,35,Florida,Flagler County,1,14,4361,2130,2231
50,12,35,Florida,Flagler County,1,15,4145,1996,2149
50,12,35,Florida,Flagler County,1,16,3247,1622,1625
50,12,35,Florida,Flagler County,1,17,1553,744,809
50,12,35,Florida,Flagler County,1,18,963,346,617
50,12,35,Florida,Flagler County,2,0,49832,23887,25945
50,12,35,Florida,Flagler County,2,1,2058,1047,1011
50,12,35,Florida,Flagler County,2,2,2381,1198,1183
50,12,35,Florida,Flagler County,2,3,2819,1450,1369
50,12,35,Florida,Flagler County,2,4,2505,1290,1215
50,12,35,Florida,Flagler County,2,5,1560,797,763
50,12,35,Florida,Flagler County,2,6,1759,858,901
50,12,35,Florida,Flagler County,2,7,2255,1088,1167
50,12,35,Florida,Flagler County,2,8,2886,1358,1528
50,12,35,Florida,Flagler County,2,9,3227,1500,1727
50,12,35,Florida,Flagler County,2,10,3235,1523,1712
50,12,35,Florida,Flagler County,2,11,3364,1526,1838
50,12,35,Florida,Flagler County,2,12,3515,1587,1928
50,12,35,Florida,Flagler County,2,13,3999,1827,2172
50,12,35,Florida,Flagler County,2,14,4361,2130,2231
50,12,35,Florida,Flagler County,2,15,4145,1996,2149
50,12,35,Florida,Flagler County,2,16,3247,1622,1625
50,12,35,Florida,Flagler County,2,17,1553,744,809
50,12,35,Florida,Flagler County,2,18,963,346,617
50,12,35,Florida,Flagler County,3,0,50560,24242,26318
50,12,35,Florida,Flagler County,3,1,2082,1059,1023
50,12,35,Florida,Flagler County,3,2,2395,1204,1191
50,12,35,Florida,Flagler County,3,3,2868,1476,1392
50,12,35,Florida,Flagler County,3,4,2544,1309,1235
50,12,35,Florida,Flagler County,3,5,1597,816,781
50,12,35,Florida,Flagler County,3,6,1767,861,906
50,12,35,Florida,Flagler County,3,7,2280,1102,1178
50,12,35,Florida,Flagler County,3,8,2912,1371,1541
50,12,35,Florida,Flagler County,3,9,3274,1522,1752
50,12,35,Florida,Flagler County,3,10,3295,1550,1745
50,12,35,Florida,Flagler County,3,11,3444,1564,1880
50,12,35,Florida,Flagler County,3,12,3590,1622,1968
50,12,35,Florida,Flagler County,3,13,4066,1857,2209
50,12,35,Florida,Flagler County,3,14,4402,2150,2252
50,12,35,Florida,Flagler County,3,15,4190,2019,2171
50,12,35,Florida,Flagler County,3,16,3293,1648,1645
50,12,35,Florida,Flagler County,3,17,1582,760,822
50,12,35,Florida,Flagler County,3,18,979,352,627
50,12,35,Florida,Flagler County,4,0,53715,25805,27910
50,12,35,Florida,Flagler County,4,1,2197,1104,1093
50,12,35,Florida,Flagler County,4,2,2573,1305,1268
50,12,35,Florida,Flagler County,4,3,3048,1577,1471
50,12,35,Florida,Flagler County,4,4,2745,1402,1343
50,12,35,Florida,Flagler County,4,5,1780,937,843
50,12,35,Florida,Flagler County,4,6,1935,945,990
50,12,35,Florida,Flagler County,4,7,2442,1173,1269
50,12,35,Florida,Flagler County,4,8,3039,1433,1606
50,12,35,Florida,Flagler County,4,9,3473,1639,1834
50,12,35,Florida,Flagler County,4,10,3525,1640,1885
50,12,35,Florida,Flagler County,4,11,3747,1740,2007
50,12,35,Florida,Flagler County,4,12,3794,1724,2070
50,12,35,Florida,Flagler County,4,13,4277,1943,2334
50,12,35,Florida,Flagler County,4,14,4573,2213,2360
50,12,35,Florida,Flagler County,4,15,4282,2075,2207
50,12,35,Florida,Flagler County,4,16,3344,1625,1719
50,12,35,Florida,Flagler County,4,17,1830,913,917
50,12,35,Florida,Flagler County,4,18,1111,417,694
50,12,35,Florida,Flagler County,5,0,57432,27649,29783
50,12,35,Florida,Flagler County,5,1,2407,1217,1190
50,12,35,Florida,Flagler County,5,2,2712,1378,1334
50,12,35,Florida,Flagler County,5,3,3200,1646,1554
50,12,35,Florida,Flagler County,5,4,2984,1519,1465
50,12,35,Florida,Flagler County,5,5,1938,1025,913
50,12,35,Florida,Flagler County,5,6,2083,1020,1063
50,12,35,Florida,Flagler County,5,7,2595,1264,1331
50,12,35,Florida,Flagler County,5,8,3190,1522,1668
50,12,35,Florida,Flagler County,5,9,3648,1748,1900
50,12,35,Florida,Flagler County,5,10,3806,1767,2039
50,12,35,Florida,Flagler County,5,11,3896,1795,2101
50,12,35,Florida,Flagler County,5,12,4411,2008,2403
50,12,35,Florida,Flagler County,5,13,4660,2143,2517
50,12,35,Florida,Flagler County,5,14,4639,2226,2413
50,12,35,Florida,Flagler County,5,15,4447,2155,2292
50,12,35,Florida,Flagler County,5,16,3543,1705,1838
50,12,35,Florida,Flagler County,5,17,2041,1051,990
50,12,35,Florida,Flagler County,5,18,1232,460,772
50,12,35,Florida,Flagler County,6,0,62154,29995,32159
50,12,35,Florida,Flagler County,6,1,2627,1339,1288
50,12,35,Florida,Flagler County,6,2,3002,1519,1483
50,12,35,Florida,Flagler County,6,3,3456,1749,1707
50,12,35,Florida,Flagler County,6,4,3171,1643,1528
50,12,35,Florida,Flagler County,6,5,2236,1174,1062
50,12,35,Florida,Flagler County,6,6,2293,1143,1150
50,12,35,Florida,Flagler County,6,7,2835,1398,1437
50,12,35,Florida,Flagler County,6,8,3418,1644,1774
50,12,35,Florida,Flagler County,6,9,3870,1866,2004
50,12,35,Florida,Flagler County,6,10,4164,1940,2224
50,12,35,Florida,Flagler County,6,11,4179,1924,2255
50,12,35,Florida,Flagler County,6,12,4814,2196,2618
50,12,35,Florida,Flagler County,6,13,5193,2388,2805
50,12,35,Florida,Flagler County,6,14,4967,2375,2592
50,12,35,Florida,Flagler County,6,15,4622,2255,2367
50,12,35,Florida,Flagler County,6,16,3794,1799,1995
50,12,35,Florida,Flagler County,6,17,2177,1125,1052
50,12,35,Florida,Flagler County,6,18,1336,518,818
50,12,35,Florida,Flagler County,7,0,68241,33009,35232
50,12,35,Florida,Flagler County,7,1,2959,1504,1455
50,12,35,Florida,Flagler County,7,2,3313,1695,1618
50,12,35,Florida,Flagler County,7,3,3866,1962,1904
50,12,35,Florida,Flagler County,7,4,3468,1783,1685
50,12,35,Florida,Flagler County,7,5,2627,1372,1255
50,12,35,Florida,Flagler County,7,6,2482,1258,1224
50,12,35,Florida,Flagler County,7,7,3208,1579,1629
50,12,35,Florida,Flagler County,7,8,3717,1817,1900
50,12,35,Florida,Flagler County,7,9,4337,2112,2225
50,12,35,Florida,Flagler County,7,10,4582,2156,2426
50,12,35,Florida,Flagler County,7,11,4659,2153,2506
50,12,35,Florida,Flagler County,7,12,5470,2506,2964
50,12,35,Florida,Flagler County,7,13,5620,2596,3024
50,12,35,Florida,Flagler County,7,14,5359,2497,2862
50,12,35,Florida,Flagler County,7,15,4742,2321,2421
50,12,35,Florida,Flagler County,7,16,3924,1845,2079
50,12,35,Florida,Flagler County,7,17,2459,1241,1218
50,12,35,Florida,Flagler County,7,18,1449,612,837
50,12,35,Florida,Flagler County,8,0,75420,36574,38846
50,12,35,Florida,Flagler County,8,1,3416,1766,1650
50,12,35,Florida,Flagler County,8,2,3825,1954,1871
50,12,35,Florida,Flagler County,8,3,4327,2187,2140
50,12,35,Florida,Flagler County,8,4,3920,2031,1889
50,12,35,Florida,Flagler County,8,5,3089,1579,1510
50,12,35,Florida,Flagler County,8,6,2946,1524,1422
50,12,35,Florida,Flagler County,8,7,3695,1829,1866
50,12,35,Florida,Flagler County,8,8,4214,2097,2117
50,12,35,Florida,Flagler County,8,9,4721,2284,2437
50,12,35,Florida,Flagler County,8,10,5044,2376,2668
50,12,35,Florida,Flagler County,8,11,5072,2365,2707
50,12,35,Florida,Flagler County,8,12,6114,2801,3313
50,12,35,Florida,Flagler County,8,13,6076,2818,3258
50,12,35,Florida,Flagler County,8,14,5671,2638,3033
50,12,35,Florida,Flagler County,8,15,4902,2357,2545
50,12,35,Florida,Flagler County,8,16,4033,1902,2131
50,12,35,Florida,Flagler County,8,17,2758,1384,1374
50,12,35,Florida,Flagler County,8,18,1597,682,915
50,12,35,Florida,Flagler County,9,0,82285,40014,42271
50,12,35,Florida,Flagler County,9,1,3871,2030,1841
50,12,35,Florida,Flagler County,9,2,4293,2175,2118
50,12,35,Florida,Flagler County,9,3,4767,2425,2342
50,12,35,Florida,Flagler County,9,4,4393,2276,2117
50,12,35,Florida,Flagler County,9,5,3515,1777,1738
50,12,35,Florida,Flagler County,9,6,3594,1883,1711
50,12,35,Florida,Flagler County,9,7,3999,1987,2012
50,12,35,Florida,Flagler County,9,8,4735,2352,2383
50,12,35,Florida,Flagler County,9,9,5203,2531,2672
50,12,35,Florida,Flagler County,9,10,5463,2607,2856
50,12,35,Florida,Flagler County,9,11,5580,2597,2983
50,12,35,Florida,Flagler County,9,12,6497,3002,3495
50,12,35,Florida,Flagler County,9,13,6420,2981,3439
50,12,35,Florida,Flagler County,9,14,5963,2765,3198
50,12,35,Florida,Flagler County,9,15,5133,2460,2673
50,12,35,Florida,Flagler County,9,16,4199,1978,2221
50,12,35,Florida,Flagler County,9,17,2822,1362,1460
50,12,35,Florida,Flagler County,9,18,1838,826,1012
50,12,35,Florida,Flagler County,10,0,88088,42920,45168
50,12,35,Florida,Flagler County,10,1,4375,2270,2105
50,12,35,Florida,Flagler County,10,2,4685,2386,2299
50,12,35,Florida,Flagler County,10,3,5159,2631,2528
50,12,35,Florida,Flagler County,10,4,4750,2448,2302
50,12,35,Florida,Flagler County,10,5,3972,1999,1973
50,12,35,Florida,Flagler County,10,6,4130,2175,1955
50,12,35,Florida,Flagler County,10,7,4382,2183,2199
50,12,35,Florida,Flagler County,10,8,5063,2536,2527
50,12,35,Florida,Flagler County,10,9,5484,2686,2798
50,12,35,Florida,Flagler County,10,10,5745,2780,2965
50,12,35,Florida,Flagler County,10,11,5862,2726,3136
50,12,35,Florida,Flagler County,10,12,6496,2988,3508
50,12,35,Florida,Flagler County,10,13,7078,3281,3797
50,12,35,Florida,Flagler County,10,14,6370,2963,3407
50,12,35,Florida,Flagler County,10,15,5140,2439,2701
50,12,35,Florida,Flagler County,10,16,4345,2057,2288
50,12,35,Florida,Flagler County,10,17,2985,1412,1573
50,12,35,Florida,Flagler County,10,18,2067,960,1107
50,12,35,Florida,Flagler County,11,0,90700,44163,46537
50,12,35,Florida,Flagler County,11,1,4563,2377,2186
50,12,35,Florida,Flagler County,11,2,4733,2416,2317
50,12,35,Florida,Flagler County,11,3,5277,2687,2590
50,12,35,Florida,Flagler County,11,4,4989,2551,2438
50,12,35,Florida,Flagler County,11,5,4034,2042,1992
50,12,35,Florida,Flagler County,11,6,4433,2313,2120
50,12,35,Florida,Flagler County,11,7,4456,2228,2228
50,12,35,Florida,Flagler County,11,8,5147,2588,2559
50,12,35,Florida,Flagler County,11,9,5530,2712,2818
50,12,35,Florida,Flagler County,11,10,5825,2834,2991
50,12,35,Florida,Flagler County,11,11,6068,2836,3232
50,12,35,Florida,Flagler County,11,12,6500,2981,3519
50,12,35,Florida,Flagler County,11,13,7330,3389,3941
50,12,35,Florida,Flagler County,11,14,6744,3131,3613
50,12,35,Florida,Flagler County,11,15,5345,2508,2837
50,12,35,Florida,Flagler County,11,16,4367,2079,2288
50,12,35,Florida,Flagler County,11,17,3167,1476,1691
50,12,35,Florida,Flagler County,11,18,2192,1015,1177
50,12,35,Florida,Flagler County,12,0,91622,44563,47059
50,12,35,Florida,Flagler County,12,1,4668,2429,2239
50,12,35,Florida,Flagler County,12,2,4672,2381,2291
50,12,35,Florida,Flagler County,12,3,5237,2684,2553
50,12,35,Florida,Flagler County,12,4,5078,2595,2483
50,12,35,Florida,Flagler County,12,5,3915,1972,1943
50,12,35,Florida,Flagler County,12,6,4509,2341,2168
50,12,35,Florida,Flagler County,12,7,4287,2155,2132
50,12,35,Florida,Flagler County,12,8,5162,2585,2577
50,12,35,Florida,Flagler County,12,9,5409,2667,2742
50,12,35,Florida,Flagler County,12,10,5850,2854,2996
50,12,35,Florida,Flagler County,12,11,6124,2886,3238
50,12,35,Florida,Flagler County,12,12,6489,2973,3516
50,12,35,Florida,Flagler County,12,13,7589,3499,4090
50,12,35,Florida,Flagler County,12,14,6942,3228,3714
50,12,35,Florida,Flagler County,12,15,5673,2614,3059
50,12,35,Florida,Flagler County,12,16,4404,2101,2303
50,12,35,Florida,Flagler County,12,17,3238,1493,1745
50,12,35,Florida,Flagler County,12,18,2376,1106,1270
50,12,37,Florida,Franklin County,1,0,11057,6242,4815
50,12,37,Florida,Franklin County,1,1,509,261,248
50,12,37,Florida,Franklin County,1,2,516,265,251
50,12,37,Florida,Franklin County,1,3,619,314,305
50,12,37,Florida,Franklin County,1,4,574,295,279
50,12,37,Florida,Franklin County,1,5,612,385,227
50,12,37,Florida,Franklin County,1,6,773,525,248
50,12,37,Florida,Franklin County,1,7,780,532,248
50,12,37,Florida,Franklin County,1,8,962,616,346
50,12,37,Florida,Franklin County,1,9,894,548,346
50,12,37,Florida,Franklin County,1,10,832,475,357
50,12,37,Florida,Franklin County,1,11,770,413,357
50,12,37,Florida,Franklin County,1,12,766,413,353
50,12,37,Florida,Franklin County,1,13,709,378,331
50,12,37,Florida,Franklin County,1,14,528,281,247
50,12,37,Florida,Franklin County,1,15,457,234,223
50,12,37,Florida,Franklin County,1,16,321,159,162
50,12,37,Florida,Franklin County,1,17,228,78,150
50,12,37,Florida,Franklin County,1,18,207,70,137
50,12,37,Florida,Franklin County,2,0,9829,5016,4813
50,12,37,Florida,Franklin County,2,1,509,261,248
50,12,37,Florida,Franklin County,2,2,516,265,251
50,12,37,Florida,Franklin County,2,3,619,314,305
50,12,37,Florida,Franklin County,2,4,566,287,279
50,12,37,Florida,Franklin County,2,5,475,248,227
50,12,37,Florida,Franklin County,2,6,529,282,247
50,12,37,Florida,Franklin County,2,7,560,313,247
50,12,37,Florida,Franklin County,2,8,739,393,346
50,12,37,Florida,Franklin County,2,9,729,383,346
50,12,37,Florida,Franklin County,2,10,710,353,357
50,12,37,Florida,Franklin County,2,11,720,363,357
50,12,37,Florida,Franklin County,2,12,738,385,353
50,12,37,Florida,Franklin County,2,13,688,357,331
50,12,37,Florida,Franklin County,2,14,523,276,247
50,12,37,Florida,Franklin County,2,15,454,231,223
50,12,37,Florida,Franklin County,2,16,321,159,162
50,12,37,Florida,Franklin County,2,17,227,77,150
50,12,37,Florida,Franklin County,2,18,206,69,137
50,12,37,Florida,Franklin County,3,0,9841,5022,4819
50,12,37,Florida,Franklin County,3,1,509,261,248
50,12,37,Florida,Franklin County,3,2,514,264,250
50,12,37,Florida,Franklin County,3,3,619,314,305
50,12,37,Florida,Franklin County,3,4,565,287,278
50,12,37,Florida,Franklin County,3,5,477,249,228
50,12,37,Florida,Franklin County,3,6,523,279,244
50,12,37,Florida,Franklin County,3,7,559,313,246
50,12,37,Florida,Franklin County,3,8,736,391,345
50,12,37,Florida,Franklin County,3,9,728,382,346
50,12,37,Florida,Franklin County,3,10,714,355,359
50,12,37,Florida,Franklin County,3,11,727,367,360
50,12,37,Florida,Franklin County,3,12,742,387,355
50,12,37,Florida,Franklin County,3,13,689,357,332
50,12,37,Florida,Franklin County,3,14,524,276,248
50,12,37,Florida,Franklin County,3,15,455,232,223
50,12,37,Florida,Franklin County,3,16,322,160,162
50,12,37,Florida,Franklin County,3,17,230,78,152
50,12,37,Florida,Franklin County,3,18,208,70,138
50,12,37,Florida,Franklin County,4,0,9882,5027,4855
50,12,37,Florida,Franklin County,4,1,517,273,244
50,12,37,Florida,Franklin County,4,2,512,261,251
50,12,37,Florida,Franklin County,4,3,595,304,291
50,12,37,Florida,Franklin County,4,4,567,290,277
50,12,37,Florida,Franklin County,4,5,509,254,255
50,12,37,Florida,Franklin County,4,6,515,276,239
50,12,37,Florida,Franklin County,4,7,546,293,253
50,12,37,Florida,Franklin County,4,8,702,377,325
50,12,37,Florida,Franklin County,4,9,733,379,354
50,12,37,Florida,Franklin County,4,10,709,360,349
50,12,37,Florida,Franklin County,4,11,760,365,395
50,12,37,Florida,Franklin County,4,12,760,407,353
50,12,37,Florida,Franklin County,4,13,712,347,365
50,12,37,Florida,Franklin County,4,14,540,296,244
50,12,37,Florida,Franklin County,4,15,447,233,214
50,12,37,Florida,Franklin County,4,16,331,169,162
50,12,37,Florida,Franklin County,4,17,226,73,153
50,12,37,Florida,Franklin County,4,18,201,70,131
50,12,37,Florida,Franklin County,5,0,9934,5057,4877
50,12,37,Florida,Franklin County,5,1,503,257,246
50,12,37,Florida,Franklin County,5,2,509,253,256
50,12,37,Florida,Franklin County,5,3,607,314,293
50,12,37,Florida,Franklin County,5,4,575,299,276
50,12,37,Florida,Franklin County,5,5,534,270,264
50,12,37,Florida,Franklin County,5,6,510,285,225
50,12,37,Florida,Franklin County,5,7,545,289,256
50,12,37,Florida,Franklin County,5,8,702,387,315
50,12,37,Florida,Franklin County,5,9,761,392,369
50,12,37,Florida,Franklin County,5,10,702,353,349
50,12,37,Florida,Franklin County,5,11,760,370,390
50,12,37,Florida,Franklin County,5,12,782,394,388
50,12,37,Florida,Franklin County,5,13,736,380,356
50,12,37,Florida,Franklin County,5,14,528,285,243
50,12,37,Florida,Franklin County,5,15,428,221,207
50,12,37,Florida,Franklin County,5,16,335,172,163
50,12,37,Florida,Franklin County,5,17,205,67,138
50,12,37,Florida,Franklin County,5,18,212,69,143
50,12,37,Florida,Franklin County,6,0,9950,5084,4866
50,12,37,Florida,Franklin County,6,1,505,259,246
50,12,37,Florida,Franklin County,6,2,472,238,234
50,12,37,Florida,Franklin County,6,3,559,280,279
50,12,37,Florida,Franklin County,6,4,587,302,285
50,12,37,Florida,Franklin County,6,5,526,279,247
50,12,37,Florida,Franklin County,6,6,553,315,238
50,12,37,Florida,Franklin County,6,7,548,292,256
50,12,37,Florida,Franklin County,6,8,658,355,303
50,12,37,Florida,Franklin County,6,9,760,403,357
50,12,37,Florida,Franklin County,6,10,725,361,364
50,12,37,Florida,Franklin County,6,11,776,389,387
50,12,37,Florida,Franklin County,6,12,800,383,417
50,12,37,Florida,Franklin County,6,13,762,411,351
50,12,37,Florida,Franklin County,6,14,550,274,276
50,12,37,Florida,Franklin County,6,15,398,213,185
50,12,37,Florida,Franklin County,6,16,342,180,162
50,12,37,Florida,Franklin County,6,17,219,82,137
50,12,37,Florida,Franklin County,6,18,210,68,142
50,12,37,Florida,Franklin County,7,0,9981,5098,4883
50,12,37,Florida,Franklin County,7,1,545,268,277
50,12,37,Florida,Franklin County,7,2,496,256,240
50,12,37,Florida,Franklin County,7,3,530,262,268
50,12,37,Florida,Franklin County,7,4,605,321,284
50,12,37,Florida,Franklin County,7,5,543,282,261
50,12,37,Florida,Franklin County,7,6,560,321,239
50,12,37,Florida,Franklin County,7,7,550,283,267
50,12,37,Florida,Franklin County,7,8,597,332,265
50,12,37,Florida,Franklin County,7,9,793,415,378
50,12,37,Florida,Franklin County,7,10,725,371,354
50,12,37,Florida,Franklin County,7,11,771,375,396
50,12,37,Florida,Franklin County,7,12,810,389,421
50,12,37,Florida,Franklin County,7,13,763,404,359
50,12,37,Florida,Franklin County,7,14,571,297,274
50,12,37,Florida,Franklin County,7,15,380,194,186
50,12,37,Florida,Franklin County,7,16,315,169,146
50,12,37,Florida,Franklin County,7,17,222,95,127
50,12,37,Florida,Franklin County,7,18,205,64,141
50,12,37,Florida,Franklin County,8,0,10055,5131,4924
50,12,37,Florida,Franklin County,8,1,564,285,279
50,12,37,Florida,Franklin County,8,2,490,251,239
50,12,37,Florida,Franklin County,8,3,525,269,256
50,12,37,Florida,Franklin County,8,4,598,306,292
50,12,37,Florida,Franklin County,8,5,582,313,269
50,12,37,Florida,Franklin County,8,6,598,325,273
50,12,37,Florida,Franklin County,8,7,505,263,242
50,12,37,Florida,Franklin County,8,8,576,322,254
50,12,37,Florida,Franklin County,8,9,766,398,368
50,12,37,Florida,Franklin County,8,10,754,385,369
50,12,37,Florida,Franklin County,8,11,775,379,396
50,12,37,Florida,Franklin County,8,12,802,391,411
50,12,37,Florida,Franklin County,8,13,821,416,405
50,12,37,Florida,Franklin County,8,14,589,301,288
50,12,37,Florida,Franklin County,8,15,344,187,157
50,12,37,Florida,Franklin County,8,16,314,163,151
50,12,37,Florida,Franklin County,8,17,224,106,118
50,12,37,Florida,Franklin County,8,18,228,71,157
50,12,37,Florida,Franklin County,9,0,11134,6161,4973
50,12,37,Florida,Franklin County,9,1,590,302,288
50,12,37,Florida,Franklin County,9,2,498,262,236
50,12,37,Florida,Franklin County,9,3,528,268,260
50,12,37,Florida,Franklin County,9,4,568,302,266
50,12,37,Florida,Franklin County,9,5,723,459,264
50,12,37,Florida,Franklin County,9,6,886,579,307
50,12,37,Florida,Franklin County,9,7,710,458,252
50,12,37,Florida,Franklin County,9,8,745,476,269
50,12,37,Florida,Franklin County,9,9,868,517,351
50,12,37,Florida,Franklin County,9,10,799,438,361
50,12,37,Florida,Franklin County,9,11,802,419,383
50,12,37,Florida,Franklin County,9,12,869,415,454
50,12,37,Florida,Franklin County,9,13,840,439,401
50,12,37,Florida,Franklin County,9,14,614,294,320
50,12,37,Florida,Franklin County,9,15,358,202,156
50,12,37,Florida,Franklin County,9,16,292,154,138
50,12,37,Florida,Franklin County,9,17,217,105,112
50,12,37,Florida,Franklin County,9,18,227,72,155
50,12,37,Florida,Franklin County,10,0,11272,6357,4915
50,12,37,Florida,Franklin County,10,1,585,306,279
50,12,37,Florida,Franklin County,10,2,492,251,241
50,12,37,Florida,Franklin County,10,3,527,261,266
50,12,37,Florida,Franklin County,10,4,540,293,247
50,12,37,Florida,Franklin County,10,5,741,494,247
50,12,37,Florida,Franklin County,10,6,956,647,309
50,12,37,Florida,Franklin County,10,7,737,501,236
50,12,37,Florida,Franklin County,10,8,766,500,266
50,12,37,Florida,Franklin County,10,9,878,542,336
50,12,37,Florida,Franklin County,10,10,822,452,370
50,12,37,Florida,Franklin County,10,11,778,410,368
50,12,37,Florida,Franklin County,10,12,864,421,443
50,12,37,Florida,Franklin County,10,13,842,419,423
50,12,37,Florida,Franklin County,10,14,632,319,313
50,12,37,Florida,Franklin County,10,15,376,212,164
50,12,37,Florida,Franklin County,10,16,289,152,137
50,12,37,Florida,Franklin County,10,17,221,105,116
50,12,37,Florida,Franklin County,10,18,226,72,154
50,12,37,Florida,Franklin County,11,0,11247,6347,4900
50,12,37,Florida,Franklin County,11,1,611,317,294
50,12,37,Florida,Franklin County,11,2,507,260,247
50,12,37,Florida,Franklin County,11,3,481,242,239
50,12,37,Florida,Franklin County,11,4,521,275,246
50,12,37,Florida,Franklin County,11,5,759,498,261
50,12,37,Florida,Franklin County,11,6,944,658,286
50,12,37,Florida,Franklin County,11,7,767,523,244
50,12,37,Florida,Franklin County,11,8,740,484,256
50,12,37,Florida,Franklin County,11,9,837,510,327
50,12,37,Florida,Franklin County,11,10,796,445,351
50,12,37,Florida,Franklin County,11,11,799,420,379
50,12,37,Florida,Franklin County,11,12,838,420,418
50,12,37,Florida,Franklin County,11,13,822,387,435
50,12,37,Florida,Franklin County,11,14,672,356,316
50,12,37,Florida,Franklin County,11,15,409,208,201
50,12,37,Florida,Franklin County,11,16,279,154,125
50,12,37,Florida,Franklin County,11,17,228,108,120
50,12,37,Florida,Franklin County,11,18,237,82,155
50,12,37,Florida,Franklin County,12,0,11280,6421,4859
50,12,37,Florida,Franklin County,12,1,586,309,277
50,12,37,Florida,Franklin County,12,2,487,240,247
50,12,37,Florida,Franklin County,12,3,498,255,243
50,12,37,Florida,Franklin County,12,4,490,261,229
50,12,37,Florida,Franklin County,12,5,776,528,248
50,12,37,Florida,Franklin County,12,6,962,673,289
50,12,37,Florida,Franklin County,12,7,789,545,244
50,12,37,Florida,Franklin County,12,8,756,492,264
50,12,37,Florida,Franklin County,12,9,766,490,276
50,12,37,Florida,Franklin County,12,10,838,465,373
50,12,37,Florida,Franklin County,12,11,802,432,370
50,12,37,Florida,Franklin County,12,12,814,398,416
50,12,37,Florida,Franklin County,12,13,818,384,434
50,12,37,Florida,Franklin County,12,14,694,365,329
50,12,37,Florida,Franklin County,12,15,450,236,214
50,12,37,Florida,Franklin County,12,16,276,146,130
50,12,37,Florida,Franklin County,12,17,232,113,119
50,12,37,Florida,Franklin County,12,18,246,89,157
50,12,39,Florida,Gadsden County,1,0,45087,21448,23639
50,12,39,Florida,Gadsden County,1,1,3018,1534,1484
50,12,39,Florida,Gadsden County,1,2,3323,1675,1648
50,12,39,Florida,Gadsden County,1,3,3440,1785,1655
50,12,39,Florida,Gadsden County,1,4,3557,1804,1753
50,12,39,Florida,Gadsden County,1,5,2854,1438,1416
50,12,39,Florida,Gadsden County,1,6,2970,1389,1581
50,12,39,Florida,Gadsden County,1,7,3033,1398,1635
50,12,39,Florida,Gadsden County,1,8,3463,1649,1814
50,12,39,Florida,Gadsden County,1,9,3571,1682,1889
50,12,39,Florida,Gadsden County,1,10,3434,1661,1773
50,12,39,Florida,Gadsden County,1,11,2808,1318,1490
50,12,39,Florida,Gadsden County,1,12,2251,1016,1235
50,12,39,Florida,Gadsden County,1,13,1878,864,1014
50,12,39,Florida,Gadsden County,1,14,1641,764,877
50,12,39,Florida,Gadsden County,1,15,1403,578,825
50,12,39,Florida,Gadsden County,1,16,1043,412,631
50,12,39,Florida,Gadsden County,1,17,739,279,460
50,12,39,Florida,Gadsden County,1,18,661,202,459
50,12,39,Florida,Gadsden County,2,0,45087,21448,23639
50,12,39,Florida,Gadsden County,2,1,3018,1534,1484
50,12,39,Florida,Gadsden County,2,2,3323,1675,1648
50,12,39,Florida,Gadsden County,2,3,3440,1785,1655
50,12,39,Florida,Gadsden County,2,4,3557,1804,1753
50,12,39,Florida,Gadsden County,2,5,2854,1438,1416
50,12,39,Florida,Gadsden County,2,6,2970,1389,1581
50,12,39,Florida,Gadsden County,2,7,3033,1398,1635
50,12,39,Florida,Gadsden County,2,8,3463,1649,1814
50,12,39,Florida,Gadsden County,2,9,3571,1682,1889
50,12,39,Florida,Gadsden County,2,10,3434,1661,1773
50,12,39,Florida,Gadsden County,2,11,2808,1318,1490
50,12,39,Florida,Gadsden County,2,12,2251,1016,1235
50,12,39,Florida,Gadsden County,2,13,1878,864,1014
50,12,39,Florida,Gadsden County,2,14,1641,764,877
50,12,39,Florida,Gadsden County,2,15,1403,578,825
50,12,39,Florida,Gadsden County,2,16,1043,412,631
50,12,39,Florida,Gadsden County,2,17,739,279,460
50,12,39,Florida,Gadsden County,2,18,661,202,459
50,12,39,Florida,Gadsden County,3,0,45067,21444,23623
50,12,39,Florida,Gadsden County,3,1,3007,1528,1479
50,12,39,Florida,Gadsden County,3,2,3296,1662,1634
50,12,39,Florida,Gadsden County,3,3,3448,1788,1660
50,12,39,Florida,Gadsden County,3,4,3553,1803,1750
50,12,39,Florida,Gadsden County,3,5,2874,1451,1423
50,12,39,Florida,Gadsden County,3,6,2954,1384,1570
50,12,39,Florida,Gadsden County,3,7,3024,1393,1631
50,12,39,Florida,Gadsden County,3,8,3443,1640,1803
50,12,39,Florida,Gadsden County,3,9,3570,1681,1889
50,12,39,Florida,Gadsden County,3,10,3443,1665,1778
50,12,39,Florida,Gadsden County,3,11,2832,1331,1501
50,12,39,Florida,Gadsden County,3,12,2256,1018,1238
50,12,39,Florida,Gadsden County,3,13,1877,864,1013
50,12,39,Florida,Gadsden County,3,14,1638,763,875
50,12,39,Florida,Gadsden County,3,15,1401,578,823
50,12,39,Florida,Gadsden County,3,16,1043,411,632
50,12,39,Florida,Gadsden County,3,17,746,282,464
50,12,39,Florida,Gadsden County,3,18,662,202,460
50,12,39,Florida,Gadsden County,4,0,45467,21600,23867
50,12,39,Florida,Gadsden County,4,1,3156,1596,1560
50,12,39,Florida,Gadsden County,4,2,3104,1563,1541
50,12,39,Florida,Gadsden County,4,3,3381,1743,1638
50,12,39,Florida,Gadsden County,4,4,3393,1728,1665
50,12,39,Florida,Gadsden County,4,5,3014,1562,1452
50,12,39,Florida,Gadsden County,4,6,2972,1392,1580
50,12,39,Florida,Gadsden County,4,7,3100,1404,1696
50,12,39,Florida,Gadsden County,4,8,3442,1627,1815
50,12,39,Florida,Gadsden County,4,9,3568,1670,1898
50,12,39,Florida,Gadsden County,4,10,3555,1690,1865
50,12,39,Florida,Gadsden County,4,11,3021,1431,1590
50,12,39,Florida,Gadsden County,4,12,2314,1058,1256
50,12,39,Florida,Gadsden County,4,13,1902,874,1028
50,12,39,Florida,Gadsden County,4,14,1665,769,896
50,12,39,Florida,Gadsden County,4,15,1400,590,810
50,12,39,Florida,Gadsden County,4,16,1061,429,632
50,12,39,Florida,Gadsden County,4,17,750,278,472
50,12,39,Florida,Gadsden County,4,18,669,196,473
50,12,39,Florida,Gadsden County,5,0,45182,21502,23680
50,12,39,Florida,Gadsden County,5,1,3174,1619,1555
50,12,39,Florida,Gadsden County,5,2,2917,1479,1438
50,12,39,Florida,Gadsden County,5,3,3418,1744,1674
50,12,39,Florida,Gadsden County,5,4,3195,1627,1568
50,12,39,Florida,Gadsden County,5,5,3061,1624,1437
50,12,39,Florida,Gadsden County,5,6,2957,1388,1569
50,12,39,Florida,Gadsden County,5,7,3142,1442,1700
50,12,39,Florida,Gadsden County,5,8,3231,1515,1716
50,12,39,Florida,Gadsden County,5,9,3539,1646,1893
50,12,39,Florida,Gadsden County,5,10,3626,1720,1906
50,12,39,Florida,Gadsden County,5,11,3036,1443,1593
50,12,39,Florida,Gadsden County,5,12,2449,1125,1324
50,12,39,Florida,Gadsden County,5,13,1949,905,1044
50,12,39,Florida,Gadsden County,5,14,1621,713,908
50,12,39,Florida,Gadsden County,5,15,1410,605,805
50,12,39,Florida,Gadsden County,5,16,1049,444,605
50,12,39,Florida,Gadsden County,5,17,762,271,491
50,12,39,Florida,Gadsden County,5,18,646,192,454
50,12,39,Florida,Gadsden County,6,0,45223,21453,23770
50,12,39,Florida,Gadsden County,6,1,3233,1642,1591
50,12,39,Florida,Gadsden County,6,2,2769,1410,1359
50,12,39,Florida,Gadsden County,6,3,3372,1728,1644
50,12,39,Florida,Gadsden County,6,4,3143,1614,1529
50,12,39,Florida,Gadsden County,6,5,3179,1681,1498
50,12,39,Florida,Gadsden County,6,6,2880,1383,1497
50,12,39,Florida,Gadsden County,6,7,3261,1476,1785
50,12,39,Florida,Gadsden County,6,8,3085,1429,1656
50,12,39,Florida,Gadsden County,6,9,3529,1606,1923
50,12,39,Florida,Gadsden County,6,10,3586,1673,1913
50,12,39,Florida,Gadsden County,6,11,3170,1507,1663
50,12,39,Florida,Gadsden County,6,12,2524,1152,1372
50,12,39,Florida,Gadsden County,6,13,1983,906,1077
50,12,39,Florida,Gadsden County,6,14,1637,717,920
50,12,39,Florida,Gadsden County,6,15,1407,618,789
50,12,39,Florida,Gadsden County,6,16,1057,436,621
50,12,39,Florida,Gadsden County,6,17,747,274,473
50,12,39,Florida,Gadsden County,6,18,661,201,460
50,12,39,Florida,Gadsden County,7,0,45506,21577,23929
50,12,39,Florida,Gadsden County,7,1,3308,1681,1627
50,12,39,Florida,Gadsden County,7,2,2756,1404,1352
50,12,39,Florida,Gadsden County,7,3,3239,1641,1598
50,12,39,Florida,Gadsden County,7,4,3102,1602,1500
50,12,39,Florida,Gadsden County,7,5,3233,1716,1517
50,12,39,Florida,Gadsden County,7,6,2928,1426,1502
50,12,39,Florida,Gadsden County,7,7,3204,1458,1746
50,12,39,Florida,Gadsden County,7,8,3110,1413,1697
50,12,39,Florida,Gadsden County,7,9,3463,1577,1886
50,12,39,Florida,Gadsden County,7,10,3514,1646,1868
50,12,39,Florida,Gadsden County,7,11,3334,1557,1777
50,12,39,Florida,Gadsden County,7,12,2670,1239,1431
50,12,39,Florida,Gadsden County,7,13,2080,951,1129
50,12,39,Florida,Gadsden County,7,14,1645,720,925
50,12,39,Florida,Gadsden County,7,15,1390,610,780
50,12,39,Florida,Gadsden County,7,16,1096,453,643
50,12,39,Florida,Gadsden County,7,17,781,283,498
50,12,39,Florida,Gadsden County,7,18,653,200,453
50,12,39,Florida,Gadsden County,8,0,45863,21809,24054
50,12,39,Florida,Gadsden County,8,1,3383,1720,1663
50,12,39,Florida,Gadsden County,8,2,2726,1398,1328
50,12,39,Florida,Gadsden County,8,3,3062,1543,1519
50,12,39,Florida,Gadsden County,8,4,3105,1618,1487
50,12,39,Florida,Gadsden County,8,5,3136,1652,1484
50,12,39,Florida,Gadsden County,8,6,2943,1472,1471
50,12,39,Florida,Gadsden County,8,7,3193,1443,1750
50,12,39,Florida,Gadsden County,8,8,3163,1454,1709
50,12,39,Florida,Gadsden County,8,9,3450,1592,1858
50,12,39,Florida,Gadsden County,8,10,3510,1644,1866
50,12,39,Florida,Gadsden County,8,11,3447,1635,1812
50,12,39,Florida,Gadsden County,8,12,2885,1327,1558
50,12,39,Florida,Gadsden County,8,13,2128,946,1182
50,12,39,Florida,Gadsden County,8,14,1741,787,954
50,12,39,Florida,Gadsden County,8,15,1383,620,763
50,12,39,Florida,Gadsden County,8,16,1139,456,683
50,12,39,Florida,Gadsden County,8,17,773,281,492
50,12,39,Florida,Gadsden County,8,18,696,221,475
50,12,39,Florida,Gadsden County,9,0,46109,22043,24066
50,12,39,Florida,Gadsden County,9,1,3416,1768,1648
50,12,39,Florida,Gadsden County,9,2,2865,1458,1407
50,12,39,Florida,Gadsden County,9,3,2916,1469,1447
50,12,39,Florida,Gadsden County,9,4,3001,1560,1441
50,12,39,Florida,Gadsden County,9,5,3042,1603,1439
50,12,39,Florida,Gadsden County,9,6,3024,1554,1470
50,12,39,Florida,Gadsden County,9,7,3184,1452,1732
50,12,39,Florida,Gadsden County,9,8,3098,1435,1663
50,12,39,Florida,Gadsden County,9,9,3485,1627,1858
50,12,39,Florida,Gadsden County,9,10,3442,1623,1819
50,12,39,Florida,Gadsden County,9,11,3560,1674,1886
50,12,39,Florida,Gadsden County,9,12,3040,1416,1624
50,12,39,Florida,Gadsden County,9,13,2203,990,1213
50,12,39,Florida,Gadsden County,9,14,1741,791,950
50,12,39,Florida,Gadsden County,9,15,1451,648,803
50,12,39,Florida,Gadsden County,9,16,1134,458,676
50,12,39,Florida,Gadsden County,9,17,800,301,499
50,12,39,Florida,Gadsden County,9,18,707,216,491
50,12,39,Florida,Gadsden County,10,0,46728,22303,24425
50,12,39,Florida,Gadsden County,10,1,3526,1814,1712
50,12,39,Florida,Gadsden County,10,2,2972,1525,1447
50,12,39,Florida,Gadsden County,10,3,2760,1401,1359
50,12,39,Florida,Gadsden County,10,4,3110,1595,1515
50,12,39,Florida,Gadsden County,10,5,3009,1583,1426
50,12,39,Florida,Gadsden County,10,6,3264,1707,1557
50,12,39,Florida,Gadsden County,10,7,3127,1423,1704
50,12,39,Florida,Gadsden County,10,8,3225,1505,1720
50,12,39,Florida,Gadsden County,10,9,3289,1514,1775
50,12,39,Florida,Gadsden County,10,10,3433,1601,1832
50,12,39,Florida,Gadsden County,10,11,3609,1682,1927
50,12,39,Florida,Gadsden County,10,12,3107,1448,1659
50,12,39,Florida,Gadsden County,10,13,2363,1073,1290
50,12,39,Florida,Gadsden County,10,14,1780,802,978
50,12,39,Florida,Gadsden County,10,15,1449,619,830
50,12,39,Florida,Gadsden County,10,16,1191,492,699
50,12,39,Florida,Gadsden County,10,17,789,302,487
50,12,39,Florida,Gadsden County,10,18,725,217,508
50,12,39,Florida,Gadsden County,11,0,47450,22631,24819
50,12,39,Florida,Gadsden County,11,1,3579,1844,1735
50,12,39,Florida,Gadsden County,11,2,3027,1546,1481
50,12,39,Florida,Gadsden County,11,3,2684,1369,1315
50,12,39,Florida,Gadsden County,11,4,3094,1590,1504
50,12,39,Florida,Gadsden County,11,5,2987,1600,1387
50,12,39,Florida,Gadsden County,11,6,3431,1767,1664
50,12,39,Florida,Gadsden County,11,7,3247,1507,1740
50,12,39,Florida,Gadsden County,11,8,3392,1575,1817
50,12,39,Florida,Gadsden County,11,9,3210,1472,1738
50,12,39,Florida,Gadsden County,11,10,3427,1584,1843
50,12,39,Florida,Gadsden County,11,11,3566,1643,1923
50,12,39,Florida,Gadsden County,11,12,3274,1538,1736
50,12,39,Florida,Gadsden County,11,13,2455,1104,1351
50,12,39,Florida,Gadsden County,11,14,1848,827,1021
50,12,39,Florida,Gadsden County,11,15,1468,629,839
50,12,39,Florida,Gadsden County,11,16,1218,519,699
50,12,39,Florida,Gadsden County,11,17,799,294,505
50,12,39,Florida,Gadsden County,11,18,744,223,521
50,12,39,Florida,Gadsden County,12,0,47474,22661,24813
50,12,39,Florida,Gadsden County,12,1,3633,1873,1760
50,12,39,Florida,Gadsden County,12,2,3116,1592,1524
50,12,39,Florida,Gadsden County,12,3,2720,1389,1331
50,12,39,Florida,Gadsden County,12,4,2912,1482,1430
50,12,39,Florida,Gadsden County,12,5,2895,1552,1343
50,12,39,Florida,Gadsden County,12,6,3489,1803,1686
50,12,39,Florida,Gadsden County,12,7,3192,1502,1690
50,12,39,Florida,Gadsden County,12,8,3317,1553,1764
50,12,39,Florida,Gadsden County,12,9,3203,1454,1749
50,12,39,Florida,Gadsden County,12,10,3378,1570,1808
50,12,39,Florida,Gadsden County,12,11,3438,1590,1848
50,12,39,Florida,Gadsden County,12,12,3372,1558,1814
50,12,39,Florida,Gadsden County,12,13,2613,1193,1420
50,12,39,Florida,Gadsden County,12,14,1950,874,1076
50,12,39,Florida,Gadsden County,12,15,1472,620,852
50,12,39,Florida,Gadsden County,12,16,1197,515,682
50,12,39,Florida,Gadsden County,12,17,817,307,510
50,12,39,Florida,Gadsden County,12,18,760,234,526
50,12,41,Florida,Gilchrist County,1,0,14437,7643,6794
50,12,41,Florida,Gilchrist County,1,1,827,418,409
50,12,41,Florida,Gilchrist County,1,2,975,498,477
50,12,41,Florida,Gilchrist County,1,3,1077,544,533
50,12,41,Florida,Gilchrist County,1,4,1154,701,453
50,12,41,Florida,Gilchrist County,1,5,1549,1219,330
50,12,41,Florida,Gilchrist County,1,6,757,358,399
50,12,41,Florida,Gilchrist County,1,7,807,395,412
50,12,41,Florida,Gilchrist County,1,8,971,469,502
50,12,41,Florida,Gilchrist County,1,9,1052,521,531
50,12,41,Florida,Gilchrist County,1,10,922,456,466
50,12,41,Florida,Gilchrist County,1,11,885,451,434
50,12,41,Florida,Gilchrist County,1,12,792,386,406
50,12,41,Florida,Gilchrist County,1,13,701,346,355
50,12,41,Florida,Gilchrist County,1,14,613,307,306
50,12,41,Florida,Gilchrist County,1,15,532,243,289
50,12,41,Florida,Gilchrist County,1,16,387,180,207
50,12,41,Florida,Gilchrist County,1,17,244,95,149
50,12,41,Florida,Gilchrist County,1,18,192,56,136
50,12,41,Florida,Gilchrist County,2,0,14443,7647,6796
50,12,41,Florida,Gilchrist County,2,1,827,418,409
50,12,41,Florida,Gilchrist County,2,2,976,499,477
50,12,41,Florida,Gilchrist County,2,3,1077,544,533
50,12,41,Florida,Gilchrist County,2,4,1155,702,453
50,12,41,Florida,Gilchrist County,2,5,1549,1219,330
50,12,41,Florida,Gilchrist County,2,6,757,358,399
50,12,41,Florida,Gilchrist County,2,7,807,395,412
50,12,41,Florida,Gilchrist County,2,8,973,470,503
50,12,41,Florida,Gilchrist County,2,9,1052,521,531
50,12,41,Florida,Gilchrist County,2,10,922,456,466
50,12,41,Florida,Gilchrist County,2,11,885,451,434
50,12,41,Florida,Gilchrist County,2,12,792,386,406
50,12,41,Florida,Gilchrist County,2,13,703,347,356
50,12,41,Florida,Gilchrist County,2,14,613,307,306
50,12,41,Florida,Gilchrist County,2,15,532,243,289
50,12,41,Florida,Gilchrist County,2,16,387,180,207
50,12,41,Florida,Gilchrist County,2,17,244,95,149
50,12,41,Florida,Gilchrist County,2,18,192,56,136
50,12,41,Florida,Gilchrist County,3,0,14540,7699,6841
50,12,41,Florida,Gilchrist County,3,1,831,420,411
50,12,41,Florida,Gilchrist County,3,2,978,500,478
50,12,41,Florida,Gilchrist County,3,3,1083,547,536
50,12,41,Florida,Gilchrist County,3,4,1163,707,456
50,12,41,Florida,Gilchrist County,3,5,1557,1223,334
50,12,41,Florida,Gilchrist County,3,6,754,357,397
50,12,41,Florida,Gilchrist County,3,7,809,396,413
50,12,41,Florida,Gilchrist County,3,8,975,471,504
50,12,41,Florida,Gilchrist County,3,9,1058,524,534
50,12,41,Florida,Gilchrist County,3,10,934,462,472
50,12,41,Florida,Gilchrist County,3,11,899,459,440
50,12,41,Florida,Gilchrist County,3,12,799,390,409
50,12,41,Florida,Gilchrist County,3,13,710,351,359
50,12,41,Florida,Gilchrist County,3,14,617,309,308
50,12,41,Florida,Gilchrist County,3,15,537,246,291
50,12,41,Florida,Gilchrist County,3,16,393,183,210
50,12,41,Florida,Gilchrist County,3,17,248,97,151
50,12,41,Florida,Gilchrist County,3,18,195,57,138
50,12,41,Florida,Gilchrist County,4,0,14556,7654,6902
50,12,41,Florida,Gilchrist County,4,1,849,425,424
50,12,41,Florida,Gilchrist County,4,2,930,481,449
50,12,41,Florida,Gilchrist County,4,3,1049,535,514
50,12,41,Florida,Gilchrist County,4,4,1201,705,496
50,12,41,Florida,Gilchrist County,4,5,1508,1176,332
50,12,41,Florida,Gilchrist County,4,6,718,340,378
50,12,41,Florida,Gilchrist County,4,7,803,390,413
50,12,41,Florida,Gilchrist County,4,8,935,458,477
50,12,41,Florida,Gilchrist County,4,9,1068,515,553
50,12,41,Florida,Gilchrist County,4,10,955,468,487
50,12,41,Florida,Gilchrist County,4,11,937,463,474
50,12,41,Florida,Gilchrist County,4,12,812,412,400
50,12,41,Florida,Gilchrist County,4,13,734,358,376
50,12,41,Florida,Gilchrist County,4,14,650,321,329
50,12,41,Florida,Gilchrist County,4,15,546,257,289
50,12,41,Florida,Gilchrist County,4,16,398,183,215
50,12,41,Florida,Gilchrist County,4,17,266,107,159
50,12,41,Florida,Gilchrist County,4,18,197,60,137
50,12,41,Florida,Gilchrist County,5,0,14874,7804,7070
50,12,41,Florida,Gilchrist County,5,1,874,442,432
50,12,41,Florida,Gilchrist County,5,2,924,482,442
50,12,41,Florida,Gilchrist County,5,3,1047,535,512
50,12,41,Florida,Gilchrist County,5,4,1197,693,504
50,12,41,Florida,Gilchrist County,5,5,1571,1213,358
50,12,41,Florida,Gilchrist County,5,6,697,337,360
50,12,41,Florida,Gilchrist County,5,7,810,387,423
50,12,41,Florida,Gilchrist County,5,8,931,453,478
50,12,41,Florida,Gilchrist County,5,9,1122,536,586
50,12,41,Florida,Gilchrist County,5,10,1010,504,506
50,12,41,Florida,Gilchrist County,5,11,878,423,455
50,12,41,Florida,Gilchrist County,5,12,894,455,439
50,12,41,Florida,Gilchrist County,5,13,739,364,375
50,12,41,Florida,Gilchrist County,5,14,680,320,360
50,12,41,Florida,Gilchrist County,5,15,543,263,280
50,12,41,Florida,Gilchrist County,5,16,437,206,231
50,12,41,Florida,Gilchrist County,5,17,305,124,181
50,12,41,Florida,Gilchrist County,5,18,215,67,148
50,12,41,Florida,Gilchrist County,6,0,15448,8123,7325
50,12,41,Florida,Gilchrist County,6,1,904,472,432
50,12,41,Florida,Gilchrist County,6,2,989,499,490
50,12,41,Florida,Gilchrist County,6,3,1066,553,513
50,12,41,Florida,Gilchrist County,6,4,1254,719,535
50,12,41,Florida,Gilchrist County,6,5,1661,1291,370
50,12,41,Florida,Gilchrist County,6,6,706,343,363
50,12,41,Florida,Gilchrist County,6,7,862,402,460
50,12,41,Florida,Gilchrist County,6,8,947,470,477
50,12,41,Florida,Gilchrist County,6,9,1071,516,555
50,12,41,Florida,Gilchrist County,6,10,1095,539,556
50,12,41,Florida,Gilchrist County,6,11,902,432,470
50,12,41,Florida,Gilchrist County,6,12,930,484,446
50,12,41,Florida,Gilchrist County,6,13,787,380,407
50,12,41,Florida,Gilchrist County,6,14,704,334,370
50,12,41,Florida,Gilchrist County,6,15,552,268,284
50,12,41,Florida,Gilchrist County,6,16,460,210,250
50,12,41,Florida,Gilchrist County,6,17,332,136,196
50,12,41,Florida,Gilchrist County,6,18,226,75,151
50,12,41,Florida,Gilchrist County,7,0,15714,8240,7474
50,12,41,Florida,Gilchrist County,7,1,936,473,463
50,12,41,Florida,Gilchrist County,7,2,1020,514,506
50,12,41,Florida,Gilchrist County,7,3,1070,555,515
50,12,41,Florida,Gilchrist County,7,4,1212,707,505
50,12,41,Florida,Gilchrist County,7,5,1725,1338,387
50,12,41,Florida,Gilchrist County,7,6,751,356,395
50,12,41,Florida,Gilchrist County,7,7,826,384,442
50,12,41,Florida,Gilchrist County,7,8,932,464,468
50,12,41,Florida,Gilchrist County,7,9,1069,518,551
50,12,41,Florida,Gilchrist County,7,10,1141,567,574
50,12,41,Florida,Gilchrist County,7,11,910,431,479
50,12,41,Florida,Gilchrist County,7,12,964,493,471
50,12,41,Florida,Gilchrist County,7,13,845,406,439
50,12,41,Florida,Gilchrist County,7,14,694,323,371
50,12,41,Florida,Gilchrist County,7,15,548,264,284
50,12,41,Florida,Gilchrist County,7,16,506,241,265
50,12,41,Florida,Gilchrist County,7,17,337,135,202
50,12,41,Florida,Gilchrist County,7,18,228,71,157
50,12,41,Florida,Gilchrist County,8,0,16217,8489,7728
50,12,41,Florida,Gilchrist County,8,1,984,484,500
50,12,41,Florida,Gilchrist County,8,2,1008,512,496
50,12,41,Florida,Gilchrist County,8,3,1082,556,526
50,12,41,Florida,Gilchrist County,8,4,1254,734,520
50,12,41,Florida,Gilchrist County,8,5,1751,1354,397
50,12,41,Florida,Gilchrist County,8,6,801,384,417
50,12,41,Florida,Gilchrist County,8,7,823,389,434
50,12,41,Florida,Gilchrist County,8,8,939,465,474
50,12,41,Florida,Gilchrist County,8,9,1080,523,557
50,12,41,Florida,Gilchrist County,8,10,1191,588,603
50,12,41,Florida,Gilchrist County,8,11,1008,490,518
50,12,41,Florida,Gilchrist County,8,12,989,498,491
50,12,41,Florida,Gilchrist County,8,13,883,423,460
50,12,41,Florida,Gilchrist County,8,14,716,343,373
50,12,41,Florida,Gilchrist County,8,15,586,281,305
50,12,41,Florida,Gilchrist County,8,16,491,223,268
50,12,41,Florida,Gilchrist County,8,17,355,155,200
50,12,41,Florida,Gilchrist County,8,18,276,87,189
50,12,41,Florida,Gilchrist County,9,0,16558,8626,7932
50,12,41,Florida,Gilchrist County,9,1,958,465,493
50,12,41,Florida,Gilchrist County,9,2,1027,519,508
50,12,41,Florida,Gilchrist County,9,3,1135,587,548
50,12,41,Florida,Gilchrist County,9,4,1258,736,522
50,12,41,Florida,Gilchrist County,9,5,1705,1310,395
50,12,41,Florida,Gilchrist County,9,6,841,414,427
50,12,41,Florida,Gilchrist County,9,7,819,387,432
50,12,41,Florida,Gilchrist County,9,8,951,467,484
50,12,41,Florida,Gilchrist County,9,9,1095,541,554
50,12,41,Florida,Gilchrist County,9,10,1215,588,627
50,12,41,Florida,Gilchrist County,9,11,1080,528,552
50,12,41,Florida,Gilchrist County,9,12,1031,499,532
50,12,41,Florida,Gilchrist County,9,13,912,455,457
50,12,41,Florida,Gilchrist County,9,14,733,341,392
50,12,41,Florida,Gilchrist County,9,15,634,303,331
50,12,41,Florida,Gilchrist County,9,16,504,231,273
50,12,41,Florida,Gilchrist County,9,17,362,154,208
50,12,41,Florida,Gilchrist County,9,18,298,101,197
50,12,41,Florida,Gilchrist County,10,0,16918,8786,8132
50,12,41,Florida,Gilchrist County,10,1,989,462,527
50,12,41,Florida,Gilchrist County,10,2,1067,543,524
50,12,41,Florida,Gilchrist County,10,3,1125,586,539
50,12,41,Florida,Gilchrist County,10,4,1305,759,546
50,12,41,Florida,Gilchrist County,10,5,1724,1315,409
50,12,41,Florida,Gilchrist County,10,6,890,447,443
50,12,41,Florida,Gilchrist County,10,7,768,369,399
50,12,41,Florida,Gilchrist County,10,8,999,484,515
50,12,41,Florida,Gilchrist County,10,9,1097,541,556
50,12,41,Florida,Gilchrist County,10,10,1242,594,648
50,12,41,Florida,Gilchrist County,10,11,1133,564,569
50,12,41,Florida,Gilchrist County,10,12,991,473,518
50,12,41,Florida,Gilchrist County,10,13,974,480,494
50,12,41,Florida,Gilchrist County,10,14,765,363,402
50,12,41,Florida,Gilchrist County,10,15,641,290,351
50,12,41,Florida,Gilchrist County,10,16,499,239,260
50,12,41,Florida,Gilchrist County,10,17,383,162,221
50,12,41,Florida,Gilchrist County,10,18,326,115,211
50,12,41,Florida,Gilchrist County,11,0,17046,8839,8207
50,12,41,Florida,Gilchrist County,11,1,991,454,537
50,12,41,Florida,Gilchrist County,11,2,1056,549,507
50,12,41,Florida,Gilchrist County,11,3,1150,583,567
50,12,41,Florida,Gilchrist County,11,4,1272,748,524
50,12,41,Florida,Gilchrist County,11,5,1782,1336,446
50,12,41,Florida,Gilchrist County,11,6,887,457,430
50,12,41,Florida,Gilchrist County,11,7,781,376,405
50,12,41,Florida,Gilchrist County,11,8,1020,482,538
50,12,41,Florida,Gilchrist County,11,9,1056,530,526
50,12,41,Florida,Gilchrist County,11,10,1163,559,604
50,12,41,Florida,Gilchrist County,11,11,1212,597,615
50,12,41,Florida,Gilchrist County,11,12,983,462,521
50,12,41,Florida,Gilchrist County,11,13,992,499,493
50,12,41,Florida,Gilchrist County,11,14,819,384,435
50,12,41,Florida,Gilchrist County,11,15,646,293,353
50,12,41,Florida,Gilchrist County,11,16,492,242,250
50,12,41,Florida,Gilchrist County,11,17,398,161,237
50,12,41,Florida,Gilchrist County,11,18,346,127,219
50,12,41,Florida,Gilchrist County,12,0,17116,8930,8186
50,12,41,Florida,Gilchrist County,12,1,979,455,524
50,12,41,Florida,Gilchrist County,12,2,1055,532,523
50,12,41,Florida,Gilchrist County,12,3,1147,582,565
50,12,41,Florida,Gilchrist County,12,4,1239,745,494
50,12,41,Florida,Gilchrist County,12,5,1852,1418,434
50,12,41,Florida,Gilchrist County,12,6,887,476,411
50,12,41,Florida,Gilchrist County,12,7,840,397,443
50,12,41,Florida,Gilchrist County,12,8,950,449,501
50,12,41,Florida,Gilchrist County,12,9,1016,511,505
50,12,41,Florida,Gilchrist County,12,10,1163,561,602
50,12,41,Florida,Gilchrist County,12,11,1237,613,624
50,12,41,Florida,Gilchrist County,12,12,958,450,508
50,12,41,Florida,Gilchrist County,12,13,1015,502,513
50,12,41,Florida,Gilchrist County,12,14,876,408,468
50,12,41,Florida,Gilchrist County,12,15,639,284,355
50,12,41,Florida,Gilchrist County,12,16,485,237,248
50,12,41,Florida,Gilchrist County,12,17,424,184,240
50,12,41,Florida,Gilchrist County,12,18,354,126,228
50,12,43,Florida,Glades County,1,0,10576,5801,4775
50,12,43,Florida,Glades County,1,1,618,331,287
50,12,43,Florida,Glades County,1,2,655,334,321
50,12,43,Florida,Glades County,1,3,653,340,313
50,12,43,Florida,Glades County,1,4,641,327,314
50,12,43,Florida,Glades County,1,5,572,362,210
50,12,43,Florida,Glades County,1,6,692,452,240
50,12,43,Florida,Glades County,1,7,714,411,303
50,12,43,Florida,Glades County,1,8,710,432,278
50,12,43,Florida,Glades County,1,9,742,441,301
50,12,43,Florida,Glades County,1,10,617,344,273
50,12,43,Florida,Glades County,1,11,602,314,288
50,12,43,Florida,Glades County,1,12,678,329,349
50,12,43,Florida,Glades County,1,13,692,355,337
50,12,43,Florida,Glades County,1,14,682,381,301
50,12,43,Florida,Glades County,1,15,577,293,284
50,12,43,Florida,Glades County,1,16,374,202,172
50,12,43,Florida,Glades County,1,17,215,91,124
50,12,43,Florida,Glades County,1,18,142,62,80
50,12,43,Florida,Glades County,2,0,10576,5801,4775
50,12,43,Florida,Glades County,2,1,618,331,287
50,12,43,Florida,Glades County,2,2,655,334,321
50,12,43,Florida,Glades County,2,3,653,340,313
50,12,43,Florida,Glades County,2,4,641,327,314
50,12,43,Florida,Glades County,2,5,572,362,210
50,12,43,Florida,Glades County,2,6,692,452,240
50,12,43,Florida,Glades County,2,7,714,411,303
50,12,43,Florida,Glades County,2,8,710,432,278
50,12,43,Florida,Glades County,2,9,742,441,301
50,12,43,Florida,Glades County,2,10,617,344,273
50,12,43,Florida,Glades County,2,11,602,314,288
50,12,43,Florida,Glades County,2,12,678,329,349
50,12,43,Florida,Glades County,2,13,692,355,337
50,12,43,Florida,Glades County,2,14,682,381,301
50,12,43,Florida,Glades County,2,15,577,293,284
50,12,43,Florida,Glades County,2,16,374,202,172
50,12,43,Florida,Glades County,2,17,215,91,124
50,12,43,Florida,Glades County,2,18,142,62,80
50,12,43,Florida,Glades County,3,0,10585,5808,4777
50,12,43,Florida,Glades County,3,1,619,332,287
50,12,43,Florida,Glades County,3,2,654,333,321
50,12,43,Florida,Glades County,3,3,653,340,313
50,12,43,Florida,Glades County,3,4,641,327,314
50,12,43,Florida,Glades County,3,5,572,362,210
50,12,43,Florida,Glades County,3,6,689,450,239
50,12,43,Florida,Glades County,3,7,714,412,302
50,12,43,Florida,Glades County,3,8,709,432,277
50,12,43,Florida,Glades County,3,9,743,441,302
50,12,43,Florida,Glades County,3,10,619,346,273
50,12,43,Florida,Glades County,3,11,604,315,289
50,12,43,Florida,Glades County,3,12,680,330,350
50,12,43,Florida,Glades County,3,13,691,355,336
50,12,43,Florida,Glades County,3,14,681,381,300
50,12,43,Florida,Glades County,3,15,578,294,284
50,12,43,Florida,Glades County,3,16,376,203,173
50,12,43,Florida,Glades County,3,17,218,92,126
50,12,43,Florida,Glades County,3,18,144,63,81
50,12,43,Florida,Glades County,4,0,10761,5882,4879
50,12,43,Florida,Glades County,4,1,647,350,297
50,12,43,Florida,Glades County,4,2,620,314,306
50,12,43,Florida,Glades County,4,3,687,357,330
50,12,43,Florida,Glades County,4,4,637,331,306
50,12,43,Florida,Glades County,4,5,622,385,237
50,12,43,Florida,Glades County,4,6,689,446,243
50,12,43,Florida,Glades County,4,7,709,415,294
50,12,43,Florida,Glades County,4,8,677,413,264
50,12,43,Florida,Glades County,4,9,782,451,331
50,12,43,Florida,Glades County,4,10,657,363,294
50,12,43,Florida,Glades County,4,11,607,327,280
50,12,43,Florida,Glades County,4,12,681,323,358
50,12,43,Florida,Glades County,4,13,680,341,339
50,12,43,Florida,Glades County,4,14,681,371,310
50,12,43,Florida,Glades County,4,15,614,320,294
50,12,43,Florida,Glades County,4,16,382,214,168
50,12,43,Florida,Glades County,4,17,241,103,138
50,12,43,Florida,Glades County,4,18,148,58,90
50,12,43,Florida,Glades County,5,0,10912,5974,4938
50,12,43,Florida,Glades County,5,1,622,349,273
50,12,43,Florida,Glades County,5,2,610,300,310
50,12,43,Florida,Glades County,5,3,662,349,313
50,12,43,Florida,Glades County,5,4,630,326,304
50,12,43,Florida,Glades County,5,5,676,412,264
50,12,43,Florida,Glades County,5,6,678,433,245
50,12,43,Florida,Glades County,5,7,702,433,269
50,12,43,Florida,Glades County,5,8,708,422,286
50,12,43,Florida,Glades County,5,9,748,446,302
50,12,43,Florida,Glades County,5,10,693,379,314
50,12,43,Florida,Glades County,5,11,595,322,273
50,12,43,Florida,Glades County,5,12,699,334,365
50,12,43,Florida,Glades County,5,13,707,350,357
50,12,43,Florida,Glades County,5,14,702,375,327
50,12,43,Florida,Glades County,5,15,630,330,300
50,12,43,Florida,Glades County,5,16,425,234,191
50,12,43,Florida,Glades County,5,17,258,115,143
50,12,43,Florida,Glades County,5,18,167,65,102
50,12,43,Florida,Glades County,6,0,10946,6019,4927
50,12,43,Florida,Glades County,6,1,539,294,245
50,12,43,Florida,Glades County,6,2,651,332,319
50,12,43,Florida,Glades County,6,3,681,352,329
50,12,43,Florida,Glades County,6,4,601,316,285
50,12,43,Florida,Glades County,6,5,677,414,263
50,12,43,Florida,Glades County,6,6,697,447,250
50,12,43,Florida,Glades County,6,7,703,452,251
50,12,43,Florida,Glades County,6,8,731,432,299
50,12,43,Florida,Glades County,6,9,759,459,300
50,12,43,Florida,Glades County,6,10,693,385,308
50,12,43,Florida,Glades County,6,11,606,320,286
50,12,43,Florida,Glades County,6,12,679,326,353
50,12,43,Florida,Glades County,6,13,735,364,371
50,12,43,Florida,Glades County,6,14,683,354,329
50,12,43,Florida,Glades County,6,15,628,348,280
50,12,43,Florida,Glades County,6,16,428,225,203
50,12,43,Florida,Glades County,6,17,276,126,150
50,12,43,Florida,Glades County,6,18,179,73,106
50,12,43,Florida,Glades County,7,0,11123,6103,5020
50,12,43,Florida,Glades County,7,1,505,271,234
50,12,43,Florida,Glades County,7,2,689,352,337
50,12,43,Florida,Glades County,7,3,670,350,320
50,12,43,Florida,Glades County,7,4,619,319,300
50,12,43,Florida,Glades County,7,5,711,432,279
50,12,43,Florida,Glades County,7,6,739,478,261
50,12,43,Florida,Glades County,7,7,699,434,265
50,12,43,Florida,Glades County,7,8,743,445,298
50,12,43,Florida,Glades County,7,9,748,451,297
50,12,43,Florida,Glades County,7,10,698,388,310
50,12,43,Florida,Glades County,7,11,633,341,292
50,12,43,Florida,Glades County,7,12,669,321,348
50,12,43,Florida,Glades County,7,13,746,365,381
50,12,43,Florida,Glades County,7,14,669,346,323
50,12,43,Florida,Glades County,7,15,645,356,289
50,12,43,Florida,Glades County,7,16,459,234,225
50,12,43,Florida,Glades County,7,17,295,138,157
50,12,43,Florida,Glades County,7,18,186,82,104
50,12,43,Florida,Glades County,8,0,11270,6180,5090
50,12,43,Florida,Glades County,8,1,440,231,209
50,12,43,Florida,Glades County,8,2,750,395,355
50,12,43,Florida,Glades County,8,3,693,355,338
50,12,43,Florida,Glades County,8,4,631,337,294
50,12,43,Florida,Glades County,8,5,700,410,290
50,12,43,Florida,Glades County,8,6,742,488,254
50,12,43,Florida,Glades County,8,7,706,453,253
50,12,43,Florida,Glades County,8,8,751,431,320
50,12,43,Florida,Glades County,8,9,775,476,299
50,12,43,Florida,Glades County,8,10,724,398,326
50,12,43,Florida,Glades County,8,11,662,356,306
50,12,43,Florida,Glades County,8,12,670,333,337
50,12,43,Florida,Glades County,8,13,720,339,381
50,12,43,Florida,Glades County,8,14,692,346,346
50,12,43,Florida,Glades County,8,15,610,336,274
50,12,43,Florida,Glades County,8,16,503,254,249
50,12,43,Florida,Glades County,8,17,286,152,134
50,12,43,Florida,Glades County,8,18,215,90,125
50,12,43,Florida,Glades County,9,0,11093,6082,5011
50,12,43,Florida,Glades County,9,1,408,213,195
50,12,43,Florida,Glades County,9,2,692,370,322
50,12,43,Florida,Glades County,9,3,677,346,331
50,12,43,Florida,Glades County,9,4,654,346,308
50,12,43,Florida,Glades County,9,5,659,397,262
50,12,43,Florida,Glades County,9,6,756,491,265
50,12,43,Florida,Glades County,9,7,695,443,252
50,12,43,Florida,Glades County,9,8,738,433,305
50,12,43,Florida,Glades County,9,9,741,456,285
50,12,43,Florida,Glades County,9,10,737,396,341
50,12,43,Florida,Glades County,9,11,679,362,317
50,12,43,Florida,Glades County,9,12,658,339,319
50,12,43,Florida,Glades County,9,13,760,354,406
50,12,43,Florida,Glades County,9,14,652,320,332
50,12,43,Florida,Glades County,9,15,582,309,273
50,12,43,Florida,Glades County,9,16,504,260,244
50,12,43,Florida,Glades County,9,17,273,152,121
50,12,43,Florida,Glades County,9,18,228,95,133
50,12,43,Florida,Glades County,10,0,10967,6010,4957
50,12,43,Florida,Glades County,10,1,442,218,224
50,12,43,Florida,Glades County,10,2,624,348,276
50,12,43,Florida,Glades County,10,3,631,312,319
50,12,43,Florida,Glades County,10,4,648,346,302
50,12,43,Florida,Glades County,10,5,641,391,250
50,12,43,Florida,Glades County,10,6,827,525,302
50,12,43,Florida,Glades County,10,7,641,408,233
50,12,43,Florida,Glades County,10,8,695,427,268
50,12,43,Florida,Glades County,10,9,756,455,301
50,12,43,Florida,Glades County,10,10,700,385,315
50,12,43,Florida,Glades County,10,11,690,364,326
50,12,43,Florida,Glades County,10,12,645,329,316
50,12,43,Florida,Glades County,10,13,742,350,392
50,12,43,Florida,Glades County,10,14,656,319,337
50,12,43,Florida,Glades County,10,15,583,303,280
50,12,43,Florida,Glades County,10,16,497,260,237
50,12,43,Florida,Glades County,10,17,305,165,140
50,12,43,Florida,Glades County,10,18,244,105,139
50,12,43,Florida,Glades County,11,0,11072,6179,4893
50,12,43,Florida,Glades County,11,1,458,233,225
50,12,43,Florida,Glades County,11,2,478,260,218
50,12,43,Florida,Glades County,11,3,673,346,327
50,12,43,Florida,Glades County,11,4,659,346,313
50,12,43,Florida,Glades County,11,5,660,411,249
50,12,43,Florida,Glades County,11,6,841,558,283
50,12,43,Florida,Glades County,11,7,731,474,257
50,12,43,Florida,Glades County,11,8,703,461,242
50,12,43,Florida,Glades County,11,9,766,473,293
50,12,43,Florida,Glades County,11,10,699,397,302
50,12,43,Florida,Glades County,11,11,703,383,320
50,12,43,Florida,Glades County,11,12,637,319,318
50,12,43,Florida,Glades County,11,13,722,342,380
50,12,43,Florida,Glades County,11,14,679,329,350
50,12,43,Florida,Glades County,11,15,569,285,284
50,12,43,Florida,Glades County,11,16,503,276,227
50,12,43,Florida,Glades County,11,17,322,167,155
50,12,43,Florida,Glades County,11,18,269,119,150
50,12,43,Florida,Glades County,12,0,10950,6125,4825
50,12,43,Florida,Glades County,12,1,456,236,220
50,12,43,Florida,Glades County,12,2,434,232,202
50,12,43,Florida,Glades County,12,3,654,338,316
50,12,43,Florida,Glades County,12,4,624,329,295
50,12,43,Florida,Glades County,12,5,697,425,272
50,12,43,Florida,Glades County,12,6,832,554,278
50,12,43,Florida,Glades County,12,7,743,490,253
50,12,43,Florida,Glades County,12,8,663,426,237
50,12,43,Florida,Glades County,12,9,749,472,277
50,12,43,Florida,Glades County,12,10,677,385,292
50,12,43,Florida,Glades County,12,11,701,378,323
50,12,43,Florida,Glades County,12,12,638,330,308
50,12,43,Florida,Glades County,12,13,695,331,364
50,12,43,Florida,Glades County,12,14,692,334,358
50,12,43,Florida,Glades County,12,15,564,281,283
50,12,43,Florida,Glades County,12,16,505,279,226
50,12,43,Florida,Glades County,12,17,338,169,169
50,12,43,Florida,Glades County,12,18,288,136,152
50,12,45,Florida,Gulf County,1,0,13332,7119,6213
50,12,45,Florida,Gulf County,1,1,674,360,314
50,12,45,Florida,Gulf County,1,2,807,424,383
50,12,45,Florida,Gulf County,1,3,870,427,443
50,12,45,Florida,Gulf County,1,4,818,442,376
50,12,45,Florida,Gulf County,1,5,628,344,284
50,12,45,Florida,Gulf County,1,6,826,527,299
50,12,45,Florida,Gulf County,1,7,861,511,350
50,12,45,Florida,Gulf County,1,8,1120,676,444
50,12,45,Florida,Gulf County,1,9,1110,643,467
50,12,45,Florida,Gulf County,1,10,984,523,461
50,12,45,Florida,Gulf County,1,11,903,470,433
50,12,45,Florida,Gulf County,1,12,812,410,402
50,12,45,Florida,Gulf County,1,13,761,363,398
50,12,45,Florida,Gulf County,1,14,689,362,327
50,12,45,Florida,Gulf County,1,15,593,286,307
50,12,45,Florida,Gulf County,1,16,419,178,241
50,12,45,Florida,Gulf County,1,17,257,107,150
50,12,45,Florida,Gulf County,1,18,200,66,134
50,12,45,Florida,Gulf County,2,0,14559,8345,6214
50,12,45,Florida,Gulf County,2,1,674,360,314
50,12,45,Florida,Gulf County,2,2,807,424,383
50,12,45,Florida,Gulf County,2,3,870,427,443
50,12,45,Florida,Gulf County,2,4,826,450,376
50,12,45,Florida,Gulf County,2,5,765,481,284
50,12,45,Florida,Gulf County,2,6,1070,770,300
50,12,45,Florida,Gulf County,2,7,1081,730,351
50,12,45,Florida,Gulf County,2,8,1343,899,444
50,12,45,Florida,Gulf County,2,9,1275,808,467
50,12,45,Florida,Gulf County,2,10,1106,645,461
50,12,45,Florida,Gulf County,2,11,953,520,433
50,12,45,Florida,Gulf County,2,12,840,438,402
50,12,45,Florida,Gulf County,2,13,782,384,398
50,12,45,Florida,Gulf County,2,14,693,367,326
50,12,45,Florida,Gulf County,2,15,596,289,307
50,12,45,Florida,Gulf County,2,16,419,178,241
50,12,45,Florida,Gulf County,2,17,258,108,150
50,12,45,Florida,Gulf County,2,18,201,67,134
50,12,45,Florida,Gulf County,3,0,14587,8360,6227
50,12,45,Florida,Gulf County,3,1,674,360,314
50,12,45,Florida,Gulf County,3,2,803,422,381
50,12,45,Florida,Gulf County,3,3,870,427,443
50,12,45,Florida,Gulf County,3,4,828,451,377
50,12,45,Florida,Gulf County,3,5,773,486,287
50,12,45,Florida,Gulf County,3,6,1068,771,297
50,12,45,Florida,Gulf County,3,7,1082,731,351
50,12,45,Florida,Gulf County,3,8,1338,896,442
50,12,45,Florida,Gulf County,3,9,1273,807,466
50,12,45,Florida,Gulf County,3,10,1111,647,464
50,12,45,Florida,Gulf County,3,11,960,523,437
50,12,45,Florida,Gulf County,3,12,844,440,404
50,12,45,Florida,Gulf County,3,13,783,384,399
50,12,45,Florida,Gulf County,3,14,694,368,326
50,12,45,Florida,Gulf County,3,15,597,290,307
50,12,45,Florida,Gulf County,3,16,423,179,244
50,12,45,Florida,Gulf County,3,17,262,110,152
50,12,45,Florida,Gulf County,3,18,204,68,136
50,12,45,Florida,Gulf County,4,0,14889,8700,6189
50,12,45,Florida,Gulf County,4,1,647,340,307
50,12,45,Florida,Gulf County,4,2,743,400,343
50,12,45,Florida,Gulf County,4,3,870,412,458
50,12,45,Florida,Gulf County,4,4,826,463,363
50,12,45,Florida,Gulf County,4,5,812,527,285
50,12,45,Florida,Gulf County,4,6,1132,845,287
50,12,45,Florida,Gulf County,4,7,1101,768,333
50,12,45,Florida,Gulf County,4,8,1356,945,411
50,12,45,Florida,Gulf County,4,9,1357,879,478
50,12,45,Florida,Gulf County,4,10,1139,688,451
50,12,45,Florida,Gulf County,4,11,1023,547,476
50,12,45,Florida,Gulf County,4,12,831,444,387
50,12,45,Florida,Gulf County,4,13,836,412,424
50,12,45,Florida,Gulf County,4,14,724,384,340
50,12,45,Florida,Gulf County,4,15,565,271,294
50,12,45,Florida,Gulf County,4,16,455,194,261
50,12,45,Florida,Gulf County,4,17,255,104,151
50,12,45,Florida,Gulf County,4,18,217,77,140
50,12,45,Florida,Gulf County,5,0,14880,8654,6226
50,12,45,Florida,Gulf County,5,1,627,323,304
50,12,45,Florida,Gulf County,5,2,753,415,338
50,12,45,Florida,Gulf County,5,3,847,398,449
50,12,45,Florida,Gulf County,5,4,853,468,385
50,12,45,Florida,Gulf County,5,5,853,556,297
50,12,45,Florida,Gulf County,5,6,1070,804,266
50,12,45,Florida,Gulf County,5,7,1100,770,330
50,12,45,Florida,Gulf County,5,8,1326,910,416
50,12,45,Florida,Gulf County,5,9,1331,854,477
50,12,45,Florida,Gulf County,5,10,1140,691,449
50,12,45,Florida,Gulf County,5,11,1034,562,472
50,12,45,Florida,Gulf County,5,12,875,455,420
50,12,45,Florida,Gulf County,5,13,820,399,421
50,12,45,Florida,Gulf County,5,14,723,386,337
50,12,45,Florida,Gulf County,5,15,551,257,294
50,12,45,Florida,Gulf County,5,16,474,208,266
50,12,45,Florida,Gulf County,5,17,279,118,161
50,12,45,Florida,Gulf County,5,18,224,80,144
50,12,45,Florida,Gulf County,6,0,15210,8931,6279
50,12,45,Florida,Gulf County,6,1,626,319,307
50,12,45,Florida,Gulf County,6,2,712,390,322
50,12,45,Florida,Gulf County,6,3,869,422,447
50,12,45,Florida,Gulf County,6,4,841,452,389
50,12,45,Florida,Gulf County,6,5,924,613,311
50,12,45,Florida,Gulf County,6,6,1078,831,247
50,12,45,Florida,Gulf County,6,7,1134,811,323
50,12,45,Florida,Gulf County,6,8,1336,936,400
50,12,45,Florida,Gulf County,6,9,1375,887,488
50,12,45,Florida,Gulf County,6,10,1201,732,469
50,12,45,Florida,Gulf County,6,11,1042,567,475
50,12,45,Florida,Gulf County,6,12,944,499,445
50,12,45,Florida,Gulf County,6,13,820,399,421
50,12,45,Florida,Gulf County,6,14,699,351,348
50,12,45,Florida,Gulf County,6,15,595,290,305
50,12,45,Florida,Gulf County,6,16,501,232,269
50,12,45,Florida,Gulf County,6,17,271,110,161
50,12,45,Florida,Gulf County,6,18,242,90,152
50,12,45,Florida,Gulf County,7,0,15364,9060,6304
50,12,45,Florida,Gulf County,7,1,622,310,312
50,12,45,Florida,Gulf County,7,2,682,368,314
50,12,45,Florida,Gulf County,7,3,878,436,442
50,12,45,Florida,Gulf County,7,4,845,442,403
50,12,45,Florida,Gulf County,7,5,994,667,327
50,12,45,Florida,Gulf County,7,6,1135,869,266
50,12,45,Florida,Gulf County,7,7,1158,838,320
50,12,45,Florida,Gulf County,7,8,1271,906,365
50,12,45,Florida,Gulf County,7,9,1379,905,474
50,12,45,Florida,Gulf County,7,10,1242,757,485
50,12,45,Florida,Gulf County,7,11,1023,549,474
50,12,45,Florida,Gulf County,7,12,983,518,465
50,12,45,Florida,Gulf County,7,13,837,421,416
50,12,45,Florida,Gulf County,7,14,690,335,355
50,12,45,Florida,Gulf County,7,15,619,305,314
50,12,45,Florida,Gulf County,7,16,472,225,247
50,12,45,Florida,Gulf County,7,17,290,118,172
50,12,45,Florida,Gulf County,7,18,244,91,153
50,12,45,Florida,Gulf County,8,0,15658,9287,6371
50,12,45,Florida,Gulf County,8,1,619,303,316
50,12,45,Florida,Gulf County,8,2,720,382,338
50,12,45,Florida,Gulf County,8,3,831,435,396
50,12,45,Florida,Gulf County,8,4,848,425,423
50,12,45,Florida,Gulf County,8,5,1048,723,325
50,12,45,Florida,Gulf County,8,6,1227,911,316
50,12,45,Florida,Gulf County,8,7,1189,876,313
50,12,45,Florida,Gulf County,8,8,1317,941,376
50,12,45,Florida,Gulf County,8,9,1409,938,471
50,12,45,Florida,Gulf County,8,10,1261,770,491
50,12,45,Florida,Gulf County,8,11,1052,567,485
50,12,45,Florida,Gulf County,8,12,1025,538,487
50,12,45,Florida,Gulf County,8,13,792,407,385
50,12,45,Florida,Gulf County,8,14,710,336,374
50,12,45,Florida,Gulf County,8,15,591,300,291
50,12,45,Florida,Gulf County,8,16,476,224,252
50,12,45,Florida,Gulf County,8,17,299,116,183
50,12,45,Florida,Gulf County,8,18,244,95,149
50,12,45,Florida,Gulf County,9,0,15713,9292,6421
50,12,45,Florida,Gulf County,9,1,624,310,314
50,12,45,Florida,Gulf County,9,2,726,376,350
50,12,45,Florida,Gulf County,9,3,823,440,383
50,12,45,Florida,Gulf County,9,4,849,417,432
50,12,45,Florida,Gulf County,9,5,993,700,293
50,12,45,Florida,Gulf County,9,6,1277,932,345
50,12,45,Florida,Gulf County,9,7,1202,880,322
50,12,45,Florida,Gulf County,9,8,1282,911,371
50,12,45,Florida,Gulf County,9,9,1350,904,446
50,12,45,Florida,Gulf County,9,10,1287,781,506
50,12,45,Florida,Gulf County,9,11,1071,584,487
50,12,45,Florida,Gulf County,9,12,1053,540,513
50,12,45,Florida,Gulf County,9,13,811,420,391
50,12,45,Florida,Gulf County,9,14,720,339,381
50,12,45,Florida,Gulf County,9,15,602,313,289
50,12,45,Florida,Gulf County,9,16,462,207,255
50,12,45,Florida,Gulf County,9,17,320,135,185
50,12,45,Florida,Gulf County,9,18,261,103,158
50,12,45,Florida,Gulf County,10,0,15763,9365,6398
50,12,45,Florida,Gulf County,10,1,662,329,333
50,12,45,Florida,Gulf County,10,2,676,342,334
50,12,45,Florida,Gulf County,10,3,777,426,351
50,12,45,Florida,Gulf County,10,4,828,403,425
50,12,45,Florida,Gulf County,10,5,1050,724,326
50,12,45,Florida,Gulf County,10,6,1311,975,336
50,12,45,Florida,Gulf County,10,7,1198,884,314
50,12,45,Florida,Gulf County,10,8,1281,927,354
50,12,45,Florida,Gulf County,10,9,1327,889,438
50,12,45,Florida,Gulf County,10,10,1293,780,513
50,12,45,Florida,Gulf County,10,11,1058,589,469
50,12,45,Florida,Gulf County,10,12,1063,553,510
50,12,45,Florida,Gulf County,10,13,861,439,422
50,12,45,Florida,Gulf County,10,14,719,337,382
50,12,45,Florida,Gulf County,10,15,601,316,285
50,12,45,Florida,Gulf County,10,16,458,202,256
50,12,45,Florida,Gulf County,10,17,330,140,190
50,12,45,Florida,Gulf County,10,18,270,110,160
50,12,45,Florida,Gulf County,11,0,15683,9314,6369
50,12,45,Florida,Gulf County,11,1,627,308,319
50,12,45,Florida,Gulf County,11,2,661,334,327
50,12,45,Florida,Gulf County,11,3,740,402,338
50,12,45,Florida,Gulf County,11,4,835,420,415
50,12,45,Florida,Gulf County,11,5,1019,698,321
50,12,45,Florida,Gulf County,11,6,1346,998,348
50,12,45,Florida,Gulf County,11,7,1143,854,289
50,12,45,Florida,Gulf County,11,8,1276,930,346
50,12,45,Florida,Gulf County,11,9,1285,867,418
50,12,45,Florida,Gulf County,11,10,1281,767,514
50,12,45,Florida,Gulf County,11,11,1081,600,481
50,12,45,Florida,Gulf County,11,12,1049,543,506
50,12,45,Florida,Gulf County,11,13,923,478,445
50,12,45,Florida,Gulf County,11,14,704,329,375
50,12,45,Florida,Gulf County,11,15,603,295,308
50,12,45,Florida,Gulf County,11,16,484,225,259
50,12,45,Florida,Gulf County,11,17,366,164,202
50,12,45,Florida,Gulf County,11,18,260,102,158
50,12,45,Florida,Gulf County,12,0,15755,9453,6302
50,12,45,Florida,Gulf County,12,1,638,319,319
50,12,45,Florida,Gulf County,12,2,603,299,304
50,12,45,Florida,Gulf County,12,3,714,381,333
50,12,45,Florida,Gulf County,12,4,851,441,410
50,12,45,Florida,Gulf County,12,5,1008,690,318
50,12,45,Florida,Gulf County,12,6,1425,1075,350
50,12,45,Florida,Gulf County,12,7,1175,889,286
50,12,45,Florida,Gulf County,12,8,1292,959,333
50,12,45,Florida,Gulf County,12,9,1257,860,397
50,12,45,Florida,Gulf County,12,10,1274,782,492
50,12,45,Florida,Gulf County,12,11,1104,616,488
50,12,45,Florida,Gulf County,12,12,1010,512,498
50,12,45,Florida,Gulf County,12,13,955,492,463
50,12,45,Florida,Gulf County,12,14,723,353,370
50,12,45,Florida,Gulf County,12,15,579,269,310
50,12,45,Florida,Gulf County,12,16,513,244,269
50,12,45,Florida,Gulf County,12,17,344,155,189
50,12,45,Florida,Gulf County,12,18,290,117,173
50,12,47,Florida,Hamilton County,1,0,13327,7657,5670
50,12,47,Florida,Hamilton County,1,1,840,435,405
50,12,47,Florida,Hamilton County,1,2,821,407,414
50,12,47,Florida,Hamilton County,1,3,888,449,439
50,12,47,Florida,Hamilton County,1,4,920,523,397
50,12,47,Florida,Hamilton County,1,5,1101,775,326
50,12,47,Florida,Hamilton County,1,6,1002,648,354
50,12,47,Florida,Hamilton County,1,7,1077,687,390
50,12,47,Florida,Hamilton County,1,8,1099,717,382
50,12,47,Florida,Hamilton County,1,9,1054,652,402
50,12,47,Florida,Hamilton County,1,10,1000,585,415
50,12,47,Florida,Hamilton County,1,11,845,471,374
50,12,47,Florida,Hamilton County,1,12,642,368,274
50,12,47,Florida,Hamilton County,1,13,548,280,268
50,12,47,Florida,Hamilton County,1,14,488,244,244
50,12,47,Florida,Hamilton County,1,15,366,176,190
50,12,47,Florida,Hamilton County,1,16,272,120,152
50,12,47,Florida,Hamilton County,1,17,193,80,113
50,12,47,Florida,Hamilton County,1,18,171,40,131
50,12,47,Florida,Hamilton County,2,0,13327,7657,5670
50,12,47,Florida,Hamilton County,2,1,840,435,405
50,12,47,Florida,Hamilton County,2,2,821,407,414
50,12,47,Florida,Hamilton County,2,3,888,449,439
50,12,47,Florida,Hamilton County,2,4,920,523,397
50,12,47,Florida,Hamilton County,2,5,1101,775,326
50,12,47,Florida,Hamilton County,2,6,1002,648,354
50,12,47,Florida,Hamilton County,2,7,1077,687,390
50,12,47,Florida,Hamilton County,2,8,1099,717,382
50,12,47,Florida,Hamilton County,2,9,1054,652,402
50,12,47,Florida,Hamilton County,2,10,1000,585,415
50,12,47,Florida,Hamilton County,2,11,845,471,374
50,12,47,Florida,Hamilton County,2,12,642,368,274
50,12,47,Florida,Hamilton County,2,13,548,280,268
50,12,47,Florida,Hamilton County,2,14,488,244,244
50,12,47,Florida,Hamilton County,2,15,366,176,190
50,12,47,Florida,Hamilton County,2,16,272,120,152
50,12,47,Florida,Hamilton County,2,17,193,80,113
50,12,47,Florida,Hamilton County,2,18,171,40,131
50,12,47,Florida,Hamilton County,3,0,13325,7656,5669
50,12,47,Florida,Hamilton County,3,1,837,433,404
50,12,47,Florida,Hamilton County,3,2,818,405,413
50,12,47,Florida,Hamilton County,3,3,889,450,439
50,12,47,Florida,Hamilton County,3,4,919,523,396
50,12,47,Florida,Hamilton County,3,5,1101,775,326
50,12,47,Florida,Hamilton County,3,6,996,645,351
50,12,47,Florida,Hamilton County,3,7,1074,685,389
50,12,47,Florida,Hamilton County,3,8,1095,715,380
50,12,47,Florida,Hamilton County,3,9,1054,652,402
50,12,47,Florida,Hamilton County,3,10,1003,587,416
50,12,47,Florida,Hamilton County,3,11,852,475,377
50,12,47,Florida,Hamilton County,3,12,642,368,274
50,12,47,Florida,Hamilton County,3,13,548,280,268
50,12,47,Florida,Hamilton County,3,14,489,244,245
50,12,47,Florida,Hamilton County,3,15,366,176,190
50,12,47,Florida,Hamilton County,3,16,274,121,153
50,12,47,Florida,Hamilton County,3,17,195,81,114
50,12,47,Florida,Hamilton County,3,18,173,41,132
50,12,47,Florida,Hamilton County,4,0,13702,8016,5686
50,12,47,Florida,Hamilton County,4,1,844,438,406
50,12,47,Florida,Hamilton County,4,2,818,428,390
50,12,47,Florida,Hamilton County,4,3,877,433,444
50,12,47,Florida,Hamilton County,4,4,954,559,395
50,12,47,Florida,Hamilton County,4,5,1152,813,339
50,12,47,Florida,Hamilton County,4,6,1024,693,331
50,12,47,Florida,Hamilton County,4,7,1127,723,404
50,12,47,Florida,Hamilton County,4,8,1163,790,373
50,12,47,Florida,Hamilton County,4,9,1081,687,394
50,12,47,Florida,Hamilton County,4,10,1036,608,428
50,12,47,Florida,Hamilton County,4,11,888,503,385
50,12,47,Florida,Hamilton County,4,12,677,382,295
50,12,47,Florida,Hamilton County,4,13,563,285,278
50,12,47,Florida,Hamilton County,4,14,476,241,235
50,12,47,Florida,Hamilton County,4,15,366,182,184
50,12,47,Florida,Hamilton County,4,16,288,133,155
50,12,47,Florida,Hamilton County,4,17,192,76,116
50,12,47,Florida,Hamilton County,4,18,176,42,134
50,12,47,Florida,Hamilton County,5,0,13698,8064,5634
50,12,47,Florida,Hamilton County,5,1,825,430,395
50,12,47,Florida,Hamilton County,5,2,826,441,385
50,12,47,Florida,Hamilton County,5,3,846,418,428
50,12,47,Florida,Hamilton County,5,4,935,541,394
50,12,47,Florida,Hamilton County,5,5,1132,834,298
50,12,47,Florida,Hamilton County,5,6,1011,676,335
50,12,47,Florida,Hamilton County,5,7,1097,712,385
50,12,47,Florida,Hamilton County,5,8,1141,785,356
50,12,47,Florida,Hamilton County,5,9,1085,699,386
50,12,47,Florida,Hamilton County,5,10,1060,634,426
50,12,47,Florida,Hamilton County,5,11,879,493,386
50,12,47,Florida,Hamilton County,5,12,788,431,357
50,12,47,Florida,Hamilton County,5,13,561,285,276
50,12,47,Florida,Hamilton County,5,14,473,251,222
50,12,47,Florida,Hamilton County,5,15,378,179,199
50,12,47,Florida,Hamilton County,5,16,285,128,157
50,12,47,Florida,Hamilton County,5,17,206,80,126
50,12,47,Florida,Hamilton County,5,18,170,47,123
50,12,47,Florida,Hamilton County,6,0,13850,8182,5668
50,12,47,Florida,Hamilton County,6,1,833,433,400
50,12,47,Florida,Hamilton County,6,2,817,437,380
50,12,47,Florida,Hamilton County,6,3,833,418,415
50,12,47,Florida,Hamilton County,6,4,914,527,387
50,12,47,Florida,Hamilton County,6,5,1172,848,324
50,12,47,Florida,Hamilton County,6,6,1030,717,313
50,12,47,Florida,Hamilton County,6,7,1064,698,366
50,12,47,Florida,Hamilton County,6,8,1146,797,349
50,12,47,Florida,Hamilton County,6,9,1085,700,385
50,12,47,Florida,Hamilton County,6,10,1078,638,440
50,12,47,Florida,Hamilton County,6,11,901,522,379
50,12,47,Florida,Hamilton County,6,12,825,440,385
50,12,47,Florida,Hamilton County,6,13,588,297,291
50,12,47,Florida,Hamilton County,6,14,503,256,247
50,12,47,Florida,Hamilton County,6,15,377,195,182
50,12,47,Florida,Hamilton County,6,16,283,119,164
50,12,47,Florida,Hamilton County,6,17,227,87,140
50,12,47,Florida,Hamilton County,6,18,174,53,121
50,12,47,Florida,Hamilton County,7,0,13894,8256,5638
50,12,47,Florida,Hamilton County,7,1,856,452,404
50,12,47,Florida,Hamilton County,7,2,779,411,368
50,12,47,Florida,Hamilton County,7,3,813,410,403
50,12,47,Florida,Hamilton County,7,4,884,504,380
50,12,47,Florida,Hamilton County,7,5,1184,882,302
50,12,47,Florida,Hamilton County,7,6,1034,723,311
50,12,47,Florida,Hamilton County,7,7,1072,720,352
50,12,47,Florida,Hamilton County,7,8,1186,812,374
50,12,47,Florida,Hamilton County,7,9,1072,692,380
50,12,47,Florida,Hamilton County,7,10,1059,651,408
50,12,47,Florida,Hamilton County,7,11,922,516,406
50,12,47,Florida,Hamilton County,7,12,845,452,393
50,12,47,Florida,Hamilton County,7,13,626,331,295
50,12,47,Florida,Hamilton County,7,14,526,265,261
50,12,47,Florida,Hamilton County,7,15,364,176,188
50,12,47,Florida,Hamilton County,7,16,280,126,154
50,12,47,Florida,Hamilton County,7,17,211,81,130
50,12,47,Florida,Hamilton County,7,18,181,52,129
50,12,47,Florida,Hamilton County,8,0,13762,8156,5606
50,12,47,Florida,Hamilton County,8,1,853,459,394
50,12,47,Florida,Hamilton County,8,2,753,390,363
50,12,47,Florida,Hamilton County,8,3,797,396,401
50,12,47,Florida,Hamilton County,8,4,874,495,379
50,12,47,Florida,Hamilton County,8,5,1134,854,280
50,12,47,Florida,Hamilton County,8,6,1028,732,296
50,12,47,Florida,Hamilton County,8,7,1045,703,342
50,12,47,Florida,Hamilton County,8,8,1134,765,369
50,12,47,Florida,Hamilton County,8,9,1074,701,373
50,12,47,Florida,Hamilton County,8,10,1030,630,400
50,12,47,Florida,Hamilton County,8,11,930,510,420
50,12,47,Florida,Hamilton County,8,12,848,448,400
50,12,47,Florida,Hamilton County,8,13,683,372,311
50,12,47,Florida,Hamilton County,8,14,508,249,259
50,12,47,Florida,Hamilton County,8,15,394,186,208
50,12,47,Florida,Hamilton County,8,16,290,132,158
50,12,47,Florida,Hamilton County,8,17,204,81,123
50,12,47,Florida,Hamilton County,8,18,183,53,130
50,12,47,Florida,Hamilton County,9,0,14124,8365,5759
50,12,47,Florida,Hamilton County,9,1,884,446,438
50,12,47,Florida,Hamilton County,9,2,792,411,381
50,12,47,Florida,Hamilton County,9,3,778,408,370
50,12,47,Florida,Hamilton County,9,4,921,511,410
50,12,47,Florida,Hamilton County,9,5,1138,880,258
50,12,47,Florida,Hamilton County,9,6,1075,740,335
50,12,47,Florida,Hamilton County,9,7,1041,716,325
50,12,47,Florida,Hamilton County,9,8,1145,767,378
50,12,47,Florida,Hamilton County,9,9,1120,741,379
50,12,47,Florida,Hamilton County,9,10,1047,648,399
50,12,47,Florida,Hamilton County,9,11,952,512,440
50,12,47,Florida,Hamilton County,9,12,865,460,405
50,12,47,Florida,Hamilton County,9,13,712,382,330
50,12,47,Florida,Hamilton County,9,14,550,266,284
50,12,47,Florida,Hamilton County,9,15,400,187,213
50,12,47,Florida,Hamilton County,9,16,305,152,153
50,12,47,Florida,Hamilton County,9,17,204,84,120
50,12,47,Florida,Hamilton County,9,18,195,54,141
50,12,47,Florida,Hamilton County,10,0,14251,8459,5792
50,12,47,Florida,Hamilton County,10,1,888,446,442
50,12,47,Florida,Hamilton County,10,2,821,426,395
50,12,47,Florida,Hamilton County,10,3,801,430,371
50,12,47,Florida,Hamilton County,10,4,900,502,398
50,12,47,Florida,Hamilton County,10,5,1186,896,290
50,12,47,Florida,Hamilton County,10,6,1055,756,299
50,12,47,Florida,Hamilton County,10,7,1021,691,330
50,12,47,Florida,Hamilton County,10,8,1165,783,382
50,12,47,Florida,Hamilton County,10,9,1077,722,355
50,12,47,Florida,Hamilton County,10,10,1042,652,390
50,12,47,Florida,Hamilton County,10,11,985,538,447
50,12,47,Florida,Hamilton County,10,12,835,437,398
50,12,47,Florida,Hamilton County,10,13,778,410,368
50,12,47,Florida,Hamilton County,10,14,550,268,282
50,12,47,Florida,Hamilton County,10,15,415,209,206
50,12,47,Florida,Hamilton County,10,16,333,153,180
50,12,47,Florida,Hamilton County,10,17,195,75,120
50,12,47,Florida,Hamilton County,10,18,204,65,139
50,12,47,Florida,Hamilton County,11,0,14412,8531,5881
50,12,47,Florida,Hamilton County,11,1,927,466,461
50,12,47,Florida,Hamilton County,11,2,800,414,386
50,12,47,Florida,Hamilton County,11,3,793,427,366
50,12,47,Florida,Hamilton County,11,4,902,507,395
50,12,47,Florida,Hamilton County,11,5,1162,881,281
50,12,47,Florida,Hamilton County,11,6,1069,747,322
50,12,47,Florida,Hamilton County,11,7,1002,708,294
50,12,47,Florida,Hamilton County,11,8,1162,774,388
50,12,47,Florida,Hamilton County,11,9,1076,722,354
50,12,47,Florida,Hamilton County,11,10,1067,661,406
50,12,47,Florida,Hamilton County,11,11,1009,544,465
50,12,47,Florida,Hamilton County,11,12,829,452,377
50,12,47,Florida,Hamilton County,11,13,816,413,403
50,12,47,Florida,Hamilton County,11,14,600,290,310
50,12,47,Florida,Hamilton County,11,15,444,215,229
50,12,47,Florida,Hamilton County,11,16,326,164,162
50,12,47,Florida,Hamilton County,11,17,202,78,124
50,12,47,Florida,Hamilton County,11,18,226,68,158
50,12,47,Florida,Hamilton County,12,0,14592,8643,5949
50,12,47,Florida,Hamilton County,12,1,908,453,455
50,12,47,Florida,Hamilton County,12,2,847,446,401
50,12,47,Florida,Hamilton County,12,3,796,421,375
50,12,47,Florida,Hamilton County,12,4,881,500,381
50,12,47,Florida,Hamilton County,12,5,1195,891,304
50,12,47,Florida,Hamilton County,12,6,1059,766,293
50,12,47,Florida,Hamilton County,12,7,1032,726,306
50,12,47,Florida,Hamilton County,12,8,1160,790,370
50,12,47,Florida,Hamilton County,12,9,1092,723,369
50,12,47,Florida,Hamilton County,12,10,1045,642,403
50,12,47,Florida,Hamilton County,12,11,983,550,433
50,12,47,Florida,Hamilton County,12,12,862,450,412
50,12,47,Florida,Hamilton County,12,13,840,424,416
50,12,47,Florida,Hamilton County,12,14,634,325,309
50,12,47,Florida,Hamilton County,12,15,487,231,256
50,12,47,Florida,Hamilton County,12,16,324,148,176
50,12,47,Florida,Hamilton County,12,17,226,92,134
50,12,47,Florida,Hamilton County,12,18,221,65,156
50,12,49,Florida,Hardee County,1,0,26938,14645,12293
50,12,49,Florida,Hardee County,1,1,2065,1053,1012
50,12,49,Florida,Hardee County,1,2,2009,1015,994
50,12,49,Florida,Hardee County,1,3,2073,1117,956
50,12,49,Florida,Hardee County,1,4,2199,1219,980
50,12,49,Florida,Hardee County,1,5,2063,1277,786
50,12,49,Florida,Hardee County,1,6,2065,1262,803
50,12,49,Florida,Hardee County,1,7,1853,1119,734
50,12,49,Florida,Hardee County,1,8,1955,1147,808
50,12,49,Florida,Hardee County,1,9,1739,979,760
50,12,49,Florida,Hardee County,1,10,1515,836,679
50,12,49,Florida,Hardee County,1,11,1376,707,669
50,12,49,Florida,Hardee County,1,12,1209,601,608
50,12,49,Florida,Hardee County,1,13,1067,555,512
50,12,49,Florida,Hardee County,1,14,1043,495,548
50,12,49,Florida,Hardee County,1,15,1083,533,550
50,12,49,Florida,Hardee County,1,16,867,415,452
50,12,49,Florida,Hardee County,1,17,432,204,228
50,12,49,Florida,Hardee County,1,18,325,111,214
50,12,49,Florida,Hardee County,2,0,26938,14645,12293
50,12,49,Florida,Hardee County,2,1,2065,1053,1012
50,12,49,Florida,Hardee County,2,2,2009,1015,994
50,12,49,Florida,Hardee County,2,3,2073,1117,956
50,12,49,Florida,Hardee County,2,4,2199,1219,980
50,12,49,Florida,Hardee County,2,5,2063,1277,786
50,12,49,Florida,Hardee County,2,6,2065,1262,803
50,12,49,Florida,Hardee County,2,7,1853,1119,734
50,12,49,Florida,Hardee County,2,8,1955,1147,808
50,12,49,Florida,Hardee County,2,9,1739,979,760
50,12,49,Florida,Hardee County,2,10,1515,836,679
50,12,49,Florida,Hardee County,2,11,1376,707,669
50,12,49,Florida,Hardee County,2,12,1209,601,608
50,12,49,Florida,Hardee County,2,13,1067,555,512
50,12,49,Florida,Hardee County,2,14,1043,495,548
50,12,49,Florida,Hardee County,2,15,1083,533,550
50,12,49,Florida,Hardee County,2,16,867,415,452
50,12,49,Florida,Hardee County,2,17,432,204,228
50,12,49,Florida,Hardee County,2,18,325,111,214
50,12,49,Florida,Hardee County,3,0,26911,14640,12271
50,12,49,Florida,Hardee County,3,1,2068,1055,1013
50,12,49,Florida,Hardee County,3,2,1999,1010,989
50,12,49,Florida,Hardee County,3,3,2075,1118,957
50,12,49,Florida,Hardee County,3,4,2194,1216,978
50,12,49,Florida,Hardee County,3,5,2070,1283,787
50,12,49,Florida,Hardee County,3,6,2054,1256,798
50,12,49,Florida,Hardee County,3,7,1850,1119,731
50,12,49,Florida,Hardee County,3,8,1947,1143,804
50,12,49,Florida,Hardee County,3,9,1741,980,761
50,12,49,Florida,Hardee County,3,10,1516,838,678
50,12,49,Florida,Hardee County,3,11,1380,709,671
50,12,49,Florida,Hardee County,3,12,1208,601,607
50,12,49,Florida,Hardee County,3,13,1064,554,510
50,12,49,Florida,Hardee County,3,14,1036,492,544
50,12,49,Florida,Hardee County,3,15,1079,532,547
50,12,49,Florida,Hardee County,3,16,867,416,451
50,12,49,Florida,Hardee County,3,17,436,206,230
50,12,49,Florida,Hardee County,3,18,327,112,215
50,12,49,Florida,Hardee County,4,0,26679,14538,12141
50,12,49,Florida,Hardee County,4,1,2127,1061,1066
50,12,49,Florida,Hardee County,4,2,1919,992,927
50,12,49,Florida,Hardee County,4,3,2035,1080,955
50,12,49,Florida,Hardee County,4,4,2098,1169,929
50,12,49,Florida,Hardee County,4,5,2093,1303,790
50,12,49,Florida,Hardee County,4,6,2030,1254,776
50,12,49,Florida,Hardee County,4,7,1837,1127,710
50,12,49,Florida,Hardee County,4,8,1902,1123,779
50,12,49,Florida,Hardee County,4,9,1733,963,770
50,12,49,Florida,Hardee County,4,10,1550,850,700
50,12,49,Florida,Hardee County,4,11,1347,703,644
50,12,49,Florida,Hardee County,4,12,1225,600,625
50,12,49,Florida,Hardee County,4,13,1070,558,512
50,12,49,Florida,Hardee County,4,14,984,469,515
50,12,49,Florida,Hardee County,4,15,1018,503,515
50,12,49,Florida,Hardee County,4,16,883,431,452
50,12,49,Florida,Hardee County,4,17,485,234,251
50,12,49,Florida,Hardee County,4,18,343,118,225
50,12,49,Florida,Hardee County,5,0,27284,15086,12198
50,12,49,Florida,Hardee County,5,1,2230,1119,1111
50,12,49,Florida,Hardee County,5,2,1897,980,917
50,12,49,Florida,Hardee County,5,3,1969,1044,925
50,12,49,Florida,Hardee County,5,4,2072,1146,926
50,12,49,Florida,Hardee County,5,5,2243,1387,856
50,12,49,Florida,Hardee County,5,6,2167,1418,749
50,12,49,Florida,Hardee County,5,7,1946,1210,736
50,12,49,Florida,Hardee County,5,8,1964,1192,772
50,12,49,Florida,Hardee County,5,9,1819,1034,785
50,12,49,Florida,Hardee County,5,10,1608,912,696
50,12,49,Florida,Hardee County,5,11,1360,718,642
50,12,49,Florida,Hardee County,5,12,1224,595,629
50,12,49,Florida,Hardee County,5,13,1093,572,521
50,12,49,Florida,Hardee County,5,14,954,463,491
50,12,49,Florida,Hardee County,5,15,936,458,478
50,12,49,Florida,Hardee County,5,16,916,451,465
50,12,49,Florida,Hardee County,5,17,528,254,274
50,12,49,Florida,Hardee County,5,18,358,133,225
50,12,49,Florida,Hardee County,6,0,27416,15213,12203
50,12,49,Florida,Hardee County,6,1,2299,1141,1158
50,12,49,Florida,Hardee County,6,2,1889,1000,889
50,12,49,Florida,Hardee County,6,3,1995,1037,958
50,12,49,Florida,Hardee County,6,4,2016,1123,893
50,12,49,Florida,Hardee County,6,5,2255,1393,862
50,12,49,Florida,Hardee County,6,6,2163,1426,737
50,12,49,Florida,Hardee County,6,7,2011,1272,739
50,12,49,Florida,Hardee County,6,8,1913,1179,734
50,12,49,Florida,Hardee County,6,9,1823,1060,763
50,12,49,Florida,Hardee County,6,10,1575,871,704
50,12,49,Florida,Hardee County,6,11,1416,752,664
50,12,49,Florida,Hardee County,6,12,1217,597,620
50,12,49,Florida,Hardee County,6,13,1097,560,537
50,12,49,Florida,Hardee County,6,14,954,486,468
50,12,49,Florida,Hardee County,6,15,911,432,479
50,12,49,Florida,Hardee County,6,16,929,460,469
50,12,49,Florida,Hardee County,6,17,571,270,301
50,12,49,Florida,Hardee County,6,18,382,154,228
50,12,49,Florida,Hardee County,7,0,27657,15349,12308
50,12,49,Florida,Hardee County,7,1,2390,1172,1218
50,12,49,Florida,Hardee County,7,2,1954,1021,933
50,12,49,Florida,Hardee County,7,3,1964,1010,954
50,12,49,Florida,Hardee County,7,4,1959,1105,854
50,12,49,Florida,Hardee County,7,5,2268,1379,889
50,12,49,Florida,Hardee County,7,6,2210,1515,695
50,12,49,Florida,Hardee County,7,7,2044,1271,773
50,12,49,Florida,Hardee County,7,8,1881,1179,702
50,12,49,Florida,Hardee County,7,9,1880,1088,792
50,12,49,Florida,Hardee County,7,10,1569,859,710
50,12,49,Florida,Hardee County,7,11,1417,766,651
50,12,49,Florida,Hardee County,7,12,1229,605,624
50,12,49,Florida,Hardee County,7,13,1116,570,546
50,12,49,Florida,Hardee County,7,14,939,471,468
50,12,49,Florida,Hardee County,7,15,862,398,464
50,12,49,Florida,Hardee County,7,16,928,459,469
50,12,49,Florida,Hardee County,7,17,666,319,347
50,12,49,Florida,Hardee County,7,18,381,162,219
50,12,49,Florida,Hardee County,8,0,27846,15528,12318
50,12,49,Florida,Hardee County,8,1,2427,1186,1241
50,12,49,Florida,Hardee County,8,2,2004,1030,974
50,12,49,Florida,Hardee County,8,3,1879,951,928
50,12,49,Florida,Hardee County,8,4,1972,1116,856
50,12,49,Florida,Hardee County,8,5,2233,1370,863
50,12,49,Florida,Hardee County,8,6,2322,1624,698
50,12,49,Florida,Hardee County,8,7,2064,1278,786
50,12,49,Florida,Hardee County,8,8,1910,1215,695
50,12,49,Florida,Hardee County,8,9,1862,1095,767
50,12,49,Florida,Hardee County,8,10,1586,873,713
50,12,49,Florida,Hardee County,8,11,1445,783,662
50,12,49,Florida,Hardee County,8,12,1274,642,632
50,12,49,Florida,Hardee County,8,13,1098,539,559
50,12,49,Florida,Hardee County,8,14,933,480,453
50,12,49,Florida,Hardee County,8,15,867,402,465
50,12,49,Florida,Hardee County,8,16,896,450,446
50,12,49,Florida,Hardee County,8,17,657,314,343
50,12,49,Florida,Hardee County,8,18,417,180,237
50,12,49,Florida,Hardee County,9,0,28192,15671,12521
50,12,49,Florida,Hardee County,9,1,2448,1198,1250
50,12,49,Florida,Hardee County,9,2,2150,1081,1069
50,12,49,Florida,Hardee County,9,3,1895,980,915
50,12,49,Florida,Hardee County,9,4,1952,1085,867
50,12,49,Florida,Hardee County,9,5,2240,1372,868
50,12,49,Florida,Hardee County,9,6,2458,1694,764
50,12,49,Florida,Hardee County,9,7,2031,1268,763
50,12,49,Florida,Hardee County,9,8,1933,1232,701
50,12,49,Florida,Hardee County,9,9,1864,1099,765
50,12,49,Florida,Hardee County,9,10,1609,869,740
50,12,49,Florida,Hardee County,9,11,1495,809,686
50,12,49,Florida,Hardee County,9,12,1246,638,608
50,12,49,Florida,Hardee County,9,13,1134,544,590
50,12,49,Florida,Hardee County,9,14,918,472,446
50,12,49,Florida,Hardee County,9,15,811,370,441
50,12,49,Florida,Hardee County,9,16,873,441,432
50,12,49,Florida,Hardee County,9,17,678,326,352
50,12,49,Florida,Hardee County,9,18,457,193,264
50,12,49,Florida,Hardee County,10,0,28832,16169,12663
50,12,49,Florida,Hardee County,10,1,2558,1260,1298
50,12,49,Florida,Hardee County,10,2,2155,1091,1064
50,12,49,Florida,Hardee County,10,3,1935,999,936
50,12,49,Florida,Hardee County,10,4,1966,1089,877
50,12,49,Florida,Hardee County,10,5,2202,1353,849
50,12,49,Florida,Hardee County,10,6,2645,1809,836
50,12,49,Florida,Hardee County,10,7,2048,1352,696
50,12,49,Florida,Hardee County,10,8,2026,1292,734
50,12,49,Florida,Hardee County,10,9,1871,1117,754
50,12,49,Florida,Hardee County,10,10,1667,912,755
50,12,49,Florida,Hardee County,10,11,1520,842,678
50,12,49,Florida,Hardee County,10,12,1281,656,625
50,12,49,Florida,Hardee County,10,13,1118,530,588
50,12,49,Florida,Hardee County,10,14,984,510,474
50,12,49,Florida,Hardee County,10,15,813,378,435
50,12,49,Florida,Hardee County,10,16,816,399,417
50,12,49,Florida,Hardee County,10,17,701,343,358
50,12,49,Florida,Hardee County,10,18,526,237,289
50,12,49,Florida,Hardee County,11,0,29135,16365,12770
50,12,49,Florida,Hardee County,11,1,2615,1290,1325
50,12,49,Florida,Hardee County,11,2,2248,1127,1121
50,12,49,Florida,Hardee County,11,3,1946,1028,918
50,12,49,Florida,Hardee County,11,4,1976,1072,904
50,12,49,Florida,Hardee County,11,5,2175,1342,833
50,12,49,Florida,Hardee County,11,6,2679,1828,851
50,12,49,Florida,Hardee County,11,7,2102,1383,719
50,12,49,Florida,Hardee County,11,8,2106,1357,749
50,12,49,Florida,Hardee County,11,9,1822,1102,720
50,12,49,Florida,Hardee County,11,10,1671,937,734
50,12,49,Florida,Hardee County,11,11,1478,795,683
50,12,49,Florida,Hardee County,11,12,1319,682,637
50,12,49,Florida,Hardee County,11,13,1111,531,580
50,12,49,Florida,Hardee County,11,14,990,500,490
50,12,49,Florida,Hardee County,11,15,822,407,415
50,12,49,Florida,Hardee County,11,16,784,368,416
50,12,49,Florida,Hardee County,11,17,719,354,365
50,12,49,Florida,Hardee County,11,18,572,262,310
50,12,49,Florida,Hardee County,12,0,29415,16577,12838
50,12,49,Florida,Hardee County,12,1,2636,1321,1315
50,12,49,Florida,Hardee County,12,2,2329,1152,1177
50,12,49,Florida,Hardee County,12,3,1986,1038,948
50,12,49,Florida,Hardee County,12,4,1945,1045,900
50,12,49,Florida,Hardee County,12,5,2147,1338,809
50,12,49,Florida,Hardee County,12,6,2707,1828,879
50,12,49,Florida,Hardee County,12,7,2146,1475,671
50,12,49,Florida,Hardee County,12,8,2160,1380,780
50,12,49,Florida,Hardee County,12,9,1792,1103,689
50,12,49,Florida,Hardee County,12,10,1748,980,768
50,12,49,Florida,Hardee County,12,11,1466,780,686
50,12,49,Florida,Hardee County,12,12,1323,700,623
50,12,49,Florida,Hardee County,12,13,1111,533,578
50,12,49,Florida,Hardee County,12,14,1014,510,504
50,12,49,Florida,Hardee County,12,15,824,407,417
50,12,49,Florida,Hardee County,12,16,751,345,406
50,12,49,Florida,Hardee County,12,17,706,349,357
50,12,49,Florida,Hardee County,12,18,624,293,331
50,12,51,Florida,Hendry County,1,0,36210,20120,16090
50,12,51,Florida,Hendry County,1,1,2826,1464,1362
50,12,51,Florida,Hendry County,1,2,3026,1546,1480
50,12,51,Florida,Hendry County,1,3,3103,1617,1486
50,12,51,Florida,Hendry County,1,4,3358,2069,1289
50,12,51,Florida,Hendry County,1,5,3392,2417,975
50,12,51,Florida,Hendry County,1,6,2704,1589,1115
50,12,51,Florida,Hendry County,1,7,2665,1502,1163
50,12,51,Florida,Hendry County,1,8,2589,1431,1158
50,12,51,Florida,Hendry County,1,9,2288,1247,1041
50,12,51,Florida,Hendry County,1,10,1974,1070,904
50,12,51,Florida,Hendry County,1,11,1802,912,890
50,12,51,Florida,Hendry County,1,12,1488,771,717
50,12,51,Florida,Hendry County,1,13,1354,722,632
50,12,51,Florida,Hendry County,1,14,1150,594,556
50,12,51,Florida,Hendry County,1,15,986,515,471
50,12,51,Florida,Hendry County,1,16,743,348,395
50,12,51,Florida,Hendry County,1,17,428,185,243
50,12,51,Florida,Hendry County,1,18,334,121,213
50,12,51,Florida,Hendry County,2,0,36210,20120,16090
50,12,51,Florida,Hendry County,2,1,2826,1464,1362
50,12,51,Florida,Hendry County,2,2,3026,1546,1480
50,12,51,Florida,Hendry County,2,3,3103,1617,1486
50,12,51,Florida,Hendry County,2,4,3358,2069,1289
50,12,51,Florida,Hendry County,2,5,3392,2417,975
50,12,51,Florida,Hendry County,2,6,2704,1589,1115
50,12,51,Florida,Hendry County,2,7,2665,1502,1163
50,12,51,Florida,Hendry County,2,8,2589,1431,1158
50,12,51,Florida,Hendry County,2,9,2288,1247,1041
50,12,51,Florida,Hendry County,2,10,1974,1070,904
50,12,51,Florida,Hendry County,2,11,1802,912,890
50,12,51,Florida,Hendry County,2,12,1488,771,717
50,12,51,Florida,Hendry County,2,13,1354,722,632
50,12,51,Florida,Hendry County,2,14,1150,594,556
50,12,51,Florida,Hendry County,2,15,986,515,471
50,12,51,Florida,Hendry County,2,16,743,348,395
50,12,51,Florida,Hendry County,2,17,428,185,243
50,12,51,Florida,Hendry County,2,18,334,121,213
50,12,51,Florida,Hendry County,3,0,36326,20195,16131
50,12,51,Florida,Hendry County,3,1,2834,1468,1366
50,12,51,Florida,Hendry County,3,2,3021,1543,1478
50,12,51,Florida,Hendry County,3,3,3119,1625,1494
50,12,51,Florida,Hendry County,3,4,3366,2072,1294
50,12,51,Florida,Hendry County,3,5,3414,2431,983
50,12,51,Florida,Hendry County,3,6,2704,1592,1112
50,12,51,Florida,Hendry County,3,7,2670,1506,1164
50,12,51,Florida,Hendry County,3,8,2589,1435,1154
50,12,51,Florida,Hendry County,3,9,2296,1253,1043
50,12,51,Florida,Hendry County,3,10,1986,1077,909
50,12,51,Florida,Hendry County,3,11,1818,921,897
50,12,51,Florida,Hendry County,3,12,1495,776,719
50,12,51,Florida,Hendry County,3,13,1354,723,631
50,12,51,Florida,Hendry County,3,14,1154,597,557
50,12,51,Florida,Hendry County,3,15,988,516,472
50,12,51,Florida,Hendry County,3,16,749,351,398
50,12,51,Florida,Hendry County,3,17,432,187,245
50,12,51,Florida,Hendry County,3,18,337,122,215
50,12,51,Florida,Hendry County,4,0,36173,20032,16141
50,12,51,Florida,Hendry County,4,1,2922,1499,1423
50,12,51,Florida,Hendry County,4,2,2885,1484,1401
50,12,51,Florida,Hendry County,4,3,3094,1616,1478
50,12,51,Florida,Hendry County,4,4,3330,2010,1320
50,12,51,Florida,Hendry County,4,5,3241,2279,962
50,12,51,Florida,Hendry County,4,6,2683,1617,1066
50,12,51,Florida,Hendry County,4,7,2659,1506,1153
50,12,51,Florida,Hendry County,4,8,2606,1422,1184
50,12,51,Florida,Hendry County,4,9,2291,1243,1048
50,12,51,Florida,Hendry County,4,10,2049,1102,947
50,12,51,Florida,Hendry County,4,11,1831,934,897
50,12,51,Florida,Hendry County,4,12,1498,786,712
50,12,51,Florida,Hendry County,4,13,1350,698,652
50,12,51,Florida,Hendry County,4,14,1129,608,521
50,12,51,Florida,Hendry County,4,15,1022,523,499
50,12,51,Florida,Hendry County,4,16,775,374,401
50,12,51,Florida,Hendry County,4,17,467,204,263
50,12,51,Florida,Hendry County,4,18,341,127,214
50,12,51,Florida,Hendry County,5,0,36248,20052,16196
50,12,51,Florida,Hendry County,5,1,3076,1610,1466
50,12,51,Florida,Hendry County,5,2,2743,1417,1326
50,12,51,Florida,Hendry County,5,3,3075,1621,1454
50,12,51,Florida,Hendry County,5,4,3236,1898,1338
50,12,51,Florida,Hendry County,5,5,3236,2233,1003
50,12,51,Florida,Hendry County,5,6,2638,1600,1038
50,12,51,Florida,Hendry County,5,7,2671,1552,1119
50,12,51,Florida,Hendry County,5,8,2625,1432,1193
50,12,51,Florida,Hendry County,5,9,2298,1225,1073
50,12,51,Florida,Hendry County,5,10,2118,1135,983
50,12,51,Florida,Hendry County,5,11,1807,936,871
50,12,51,Florida,Hendry County,5,12,1600,826,774
50,12,51,Florida,Hendry County,5,13,1337,689,648
50,12,51,Florida,Hendry County,5,14,1168,636,532
50,12,51,Florida,Hendry County,5,15,983,501,482
50,12,51,Florida,Hendry County,5,16,819,406,413
50,12,51,Florida,Hendry County,5,17,446,187,259
50,12,51,Florida,Hendry County,5,18,372,148,224
50,12,51,Florida,Hendry County,6,0,36424,20065,16359
50,12,51,Florida,Hendry County,6,1,3211,1648,1563
50,12,51,Florida,Hendry County,6,2,2797,1465,1332
50,12,51,Florida,Hendry County,6,3,3055,1611,1444
50,12,51,Florida,Hendry County,6,4,3099,1780,1319
50,12,51,Florida,Hendry County,6,5,3135,2086,1049
50,12,51,Florida,Hendry County,6,6,2764,1730,1034
50,12,51,Florida,Hendry County,6,7,2586,1504,1082
50,12,51,Florida,Hendry County,6,8,2666,1467,1199
50,12,51,Florida,Hendry County,6,9,2316,1239,1077
50,12,51,Florida,Hendry County,6,10,2122,1135,987
50,12,51,Florida,Hendry County,6,11,1788,926,862
50,12,51,Florida,Hendry County,6,12,1630,840,790
50,12,51,Florida,Hendry County,6,13,1370,702,668
50,12,51,Florida,Hendry County,6,14,1147,634,513
50,12,51,Florida,Hendry County,6,15,1018,506,512
50,12,51,Florida,Hendry County,6,16,817,411,406
50,12,51,Florida,Hendry County,6,17,495,216,279
50,12,51,Florida,Hendry County,6,18,408,165,243
50,12,51,Florida,Hendry County,7,0,37221,20591,16630
50,12,51,Florida,Hendry County,7,1,3304,1711,1593
50,12,51,Florida,Hendry County,7,2,2815,1484,1331
50,12,51,Florida,Hendry County,7,3,3045,1616,1429
50,12,51,Florida,Hendry County,7,4,3170,1794,1376
50,12,51,Florida,Hendry County,7,5,3180,2120,1060
50,12,51,Florida,Hendry County,7,6,2827,1828,999
50,12,51,Florida,Hendry County,7,7,2630,1541,1089
50,12,51,Florida,Hendry County,7,8,2706,1494,1212
50,12,51,Florida,Hendry County,7,9,2432,1322,1110
50,12,51,Florida,Hendry County,7,10,2184,1160,1024
50,12,51,Florida,Hendry County,7,11,1869,983,886
50,12,51,Florida,Hendry County,7,12,1709,876,833
50,12,51,Florida,Hendry County,7,13,1397,711,686
50,12,51,Florida,Hendry County,7,14,1145,622,523
50,12,51,Florida,Hendry County,7,15,1031,511,520
50,12,51,Florida,Hendry County,7,16,822,413,409
50,12,51,Florida,Hendry County,7,17,541,242,299
50,12,51,Florida,Hendry County,7,18,414,163,251
50,12,51,Florida,Hendry County,8,0,38521,21567,16954
50,12,51,Florida,Hendry County,8,1,3508,1814,1694
50,12,51,Florida,Hendry County,8,2,2811,1481,1330
50,12,51,Florida,Hendry County,8,3,2992,1568,1424
50,12,51,Florida,Hendry County,8,4,3378,1975,1403
50,12,51,Florida,Hendry County,8,5,3473,2383,1090
50,12,51,Florida,Hendry County,8,6,2940,1927,1013
50,12,51,Florida,Hendry County,8,7,2667,1594,1073
50,12,51,Florida,Hendry County,8,8,2737,1560,1177
50,12,51,Florida,Hendry County,8,9,2603,1411,1192
50,12,51,Florida,Hendry County,8,10,2297,1237,1060
50,12,51,Florida,Hendry County,8,11,1912,1023,889
50,12,51,Florida,Hendry County,8,12,1764,892,872
50,12,51,Florida,Hendry County,8,13,1346,692,654
50,12,51,Florida,Hendry County,8,14,1238,657,581
50,12,51,Florida,Hendry County,8,15,1013,510,503
50,12,51,Florida,Hendry County,8,16,826,412,414
50,12,51,Florida,Hendry County,8,17,583,266,317
50,12,51,Florida,Hendry County,8,18,433,165,268
50,12,51,Florida,Hendry County,9,0,39106,21925,17181
50,12,51,Florida,Hendry County,9,1,3567,1805,1762
50,12,51,Florida,Hendry County,9,2,2958,1543,1415
50,12,51,Florida,Hendry County,9,3,2905,1534,1371
50,12,51,Florida,Hendry County,9,4,3380,1983,1397
50,12,51,Florida,Hendry County,9,5,3498,2392,1106
50,12,51,Florida,Hendry County,9,6,3043,2007,1036
50,12,51,Florida,Hendry County,9,7,2724,1670,1054
50,12,51,Florida,Hendry County,9,8,2790,1604,1186
50,12,51,Florida,Hendry County,9,9,2632,1420,1212
50,12,51,Florida,Hendry County,9,10,2322,1251,1071
50,12,51,Florida,Hendry County,9,11,2016,1076,940
50,12,51,Florida,Hendry County,9,12,1780,907,873
50,12,51,Florida,Hendry County,9,13,1364,707,657
50,12,51,Florida,Hendry County,9,14,1212,624,588
50,12,51,Florida,Hendry County,9,15,1003,528,475
50,12,51,Florida,Hendry County,9,16,859,411,448
50,12,51,Florida,Hendry County,9,17,573,273,300
50,12,51,Florida,Hendry County,9,18,480,190,290
50,12,51,Florida,Hendry County,10,0,39399,22135,17264
50,12,51,Florida,Hendry County,10,1,3619,1816,1803
50,12,51,Florida,Hendry County,10,2,3075,1632,1443
50,12,51,Florida,Hendry County,10,3,2845,1508,1337
50,12,51,Florida,Hendry County,10,4,3310,1954,1356
50,12,51,Florida,Hendry County,10,5,3400,2296,1104
50,12,51,Florida,Hendry County,10,6,3090,2058,1032
50,12,51,Florida,Hendry County,10,7,2742,1693,1049
50,12,51,Florida,Hendry County,10,8,2813,1663,1150
50,12,51,Florida,Hendry County,10,9,2698,1453,1245
50,12,51,Florida,Hendry County,10,10,2256,1213,1043
50,12,51,Florida,Hendry County,10,11,2068,1100,968
50,12,51,Florida,Hendry County,10,12,1789,922,867
50,12,51,Florida,Hendry County,10,13,1463,746,717
50,12,51,Florida,Hendry County,10,14,1209,612,597
50,12,51,Florida,Hendry County,10,15,1037,559,478
50,12,51,Florida,Hendry County,10,16,839,405,434
50,12,51,Florida,Hendry County,10,17,657,319,338
50,12,51,Florida,Hendry County,10,18,489,186,303
50,12,51,Florida,Hendry County,11,0,39602,22412,17190
50,12,51,Florida,Hendry County,11,1,3600,1816,1784
50,12,51,Florida,Hendry County,11,2,3061,1593,1468
50,12,51,Florida,Hendry County,11,3,2831,1519,1312
50,12,51,Florida,Hendry County,11,4,3314,1978,1336
50,12,51,Florida,Hendry County,11,5,3475,2377,1098
50,12,51,Florida,Hendry County,11,6,3101,2051,1050
50,12,51,Florida,Hendry County,11,7,2769,1783,986
50,12,51,Florida,Hendry County,11,8,2748,1642,1106
50,12,51,Florida,Hendry County,11,9,2737,1495,1242
50,12,51,Florida,Hendry County,11,10,2252,1219,1033
50,12,51,Florida,Hendry County,11,11,2075,1105,970
50,12,51,Florida,Hendry County,11,12,1751,905,846
50,12,51,Florida,Hendry County,11,13,1502,767,735
50,12,51,Florida,Hendry County,11,14,1258,636,622
50,12,51,Florida,Hendry County,11,15,1037,566,471
50,12,51,Florida,Hendry County,11,16,903,421,482
50,12,51,Florida,Hendry County,11,17,644,317,327
50,12,51,Florida,Hendry County,11,18,544,222,322
50,12,51,Florida,Hendry County,12,0,39594,22479,17115
50,12,51,Florida,Hendry County,12,1,3569,1784,1785
50,12,51,Florida,Hendry County,12,2,3136,1645,1491
50,12,51,Florida,Hendry County,12,3,2698,1461,1237
50,12,51,Florida,Hendry County,12,4,3300,1980,1320
50,12,51,Florida,Hendry County,12,5,3480,2355,1125
50,12,51,Florida,Hendry County,12,6,3084,2025,1059
50,12,51,Florida,Hendry County,12,7,2793,1858,935
50,12,51,Florida,Hendry County,12,8,2694,1625,1069
50,12,51,Florida,Hendry County,12,9,2664,1467,1197
50,12,51,Florida,Hendry County,12,10,2308,1270,1038
50,12,51,Florida,Hendry County,12,11,2047,1084,963
50,12,51,Florida,Hendry County,12,12,1718,906,812
50,12,51,Florida,Hendry County,12,13,1579,800,779
50,12,51,Florida,Hendry County,12,14,1277,638,639
50,12,51,Florida,Hendry County,12,15,1060,561,499
50,12,51,Florida,Hendry County,12,16,903,429,474
50,12,51,Florida,Hendry County,12,17,690,340,350
50,12,51,Florida,Hendry County,12,18,594,251,343
50,12,53,Florida,Hernando County,1,0,130802,62130,68672
50,12,53,Florida,Hernando County,1,1,5905,3050,2855
50,12,53,Florida,Hernando County,1,2,6811,3420,3391
50,12,53,Florida,Hernando County,1,3,7532,3840,3692
50,12,53,Florida,Hernando County,1,4,6802,3513,3289
50,12,53,Florida,Hernando County,1,5,4788,2269,2519
50,12,53,Florida,Hernando County,1,6,4982,2450,2532
50,12,53,Florida,Hernando County,1,7,6008,2843,3165
50,12,53,Florida,Hernando County,1,8,7518,3541,3977
50,12,53,Florida,Hernando County,1,9,8135,3803,4332
50,12,53,Florida,Hernando County,1,10,7600,3562,4038
50,12,53,Florida,Hernando County,1,11,7890,3627,4263
50,12,53,Florida,Hernando County,1,12,8004,3633,4371
50,12,53,Florida,Hernando County,1,13,8474,3838,4636
50,12,53,Florida,Hernando County,1,14,10145,4836,5309
50,12,53,Florida,Hernando County,1,15,11227,5296,5931
50,12,53,Florida,Hernando County,1,16,9884,4641,5243
50,12,53,Florida,Hernando County,1,17,5663,2654,3009
50,12,53,Florida,Hernando County,1,18,3434,1314,2120
50,12,53,Florida,Hernando County,2,0,130803,62131,68672
50,12,53,Florida,Hernando County,2,1,5905,3050,2855
50,12,53,Florida,Hernando County,2,2,6811,3420,3391
50,12,53,Florida,Hernando County,2,3,7532,3840,3692
50,12,53,Florida,Hernando County,2,4,6802,3513,3289
50,12,53,Florida,Hernando County,2,5,4788,2269,2519
50,12,53,Florida,Hernando County,2,6,4982,2450,2532
50,12,53,Florida,Hernando County,2,7,6008,2843,3165
50,12,53,Florida,Hernando County,2,8,7518,3541,3977
50,12,53,Florida,Hernando County,2,9,8135,3803,4332
50,12,53,Florida,Hernando County,2,10,7600,3562,4038
50,12,53,Florida,Hernando County,2,11,7891,3628,4263
50,12,53,Florida,Hernando County,2,12,8004,3633,4371
50,12,53,Florida,Hernando County,2,13,8474,3838,4636
50,12,53,Florida,Hernando County,2,14,10145,4836,5309
50,12,53,Florida,Hernando County,2,15,11227,5296,5931
50,12,53,Florida,Hernando County,2,16,9884,4641,5243
50,12,53,Florida,Hernando County,2,17,5663,2654,3009
50,12,53,Florida,Hernando County,2,18,3434,1314,2120
50,12,53,Florida,Hernando County,3,0,131425,62458,68967
50,12,53,Florida,Hernando County,3,1,5933,3065,2868
50,12,53,Florida,Hernando County,3,2,6811,3420,3391
50,12,53,Florida,Hernando County,3,3,7589,3868,3721
50,12,53,Florida,Hernando County,3,4,6843,3535,3308
50,12,53,Florida,Hernando County,3,5,4856,2305,2551
50,12,53,Florida,Hernando County,3,6,4965,2442,2523
50,12,53,Florida,Hernando County,3,7,6031,2855,3176
50,12,53,Florida,Hernando County,3,8,7519,3542,3977
50,12,53,Florida,Hernando County,3,9,8190,3829,4361
50,12,53,Florida,Hernando County,3,10,7678,3601,4077
50,12,53,Florida,Hernando County,3,11,8010,3685,4325
50,12,53,Florida,Hernando County,3,12,8091,3674,4417
50,12,53,Florida,Hernando County,3,13,8542,3871,4671
50,12,53,Florida,Hernando County,3,14,10097,4815,5282
50,12,53,Florida,Hernando County,3,15,11203,5292,5911
50,12,53,Florida,Hernando County,3,16,9896,4651,5245
50,12,53,Florida,Hernando County,3,17,5709,2680,3029
50,12,53,Florida,Hernando County,3,18,3462,1328,2134
50,12,53,Florida,Hernando County,4,0,134090,63756,70334
50,12,53,Florida,Hernando County,4,1,6113,3119,2994
50,12,53,Florida,Hernando County,4,2,6924,3532,3392
50,12,53,Florida,Hernando County,4,3,7909,3996,3913
50,12,53,Florida,Hernando County,4,4,6956,3594,3362
50,12,53,Florida,Hernando County,4,5,5162,2476,2686
50,12,53,Florida,Hernando County,4,6,4991,2454,2537
50,12,53,Florida,Hernando County,4,7,6280,3022,3258
50,12,53,Florida,Hernando County,4,8,7652,3582,4070
50,12,53,Florida,Hernando County,4,9,8312,3909,4403
50,12,53,Florida,Hernando County,4,10,7997,3710,4287
50,12,53,Florida,Hernando County,4,11,8417,3919,4498
50,12,53,Florida,Hernando County,4,12,8290,3768,4522
50,12,53,Florida,Hernando County,4,13,8743,4011,4732
50,12,53,Florida,Hernando County,4,14,9792,4637,5155
50,12,53,Florida,Hernando County,4,15,10861,5139,5722
50,12,53,Florida,Hernando County,4,16,9934,4573,5361
50,12,53,Florida,Hernando County,4,17,6063,2878,3185
50,12,53,Florida,Hernando County,4,18,3694,1437,2257
50,12,53,Florida,Hernando County,5,0,137681,65558,72123
50,12,53,Florida,Hernando County,5,1,6428,3306,3122
50,12,53,Florida,Hernando County,5,2,7042,3581,3461
50,12,53,Florida,Hernando County,5,3,8214,4168,4046
50,12,53,Florida,Hernando County,5,4,7249,3713,3536
50,12,53,Florida,Hernando County,5,5,5567,2690,2877
50,12,53,Florida,Hernando County,5,6,5032,2492,2540
50,12,53,Florida,Hernando County,5,7,6507,3132,3375
50,12,53,Florida,Hernando County,5,8,7696,3628,4068
50,12,53,Florida,Hernando County,5,9,8609,4075,4534
50,12,53,Florida,Hernando County,5,10,8465,3940,4525
50,12,53,Florida,Hernando County,5,11,8411,3884,4527
50,12,53,Florida,Hernando County,5,12,8991,4149,4842
50,12,53,Florida,Hernando County,5,13,8991,4071,4920
50,12,53,Florida,Hernando County,5,14,9676,4580,5096
50,12,53,Florida,Hernando County,5,15,10552,5024,5528
50,12,53,Florida,Hernando County,5,16,9874,4533,5341
50,12,53,Florida,Hernando County,5,17,6436,3013,3423
50,12,53,Florida,Hernando County,5,18,3941,1579,2362
50,12,53,Florida,Hernando County,6,0,142368,67916,74452
50,12,53,Florida,Hernando County,6,1,6643,3412,3231
50,12,53,Florida,Hernando County,6,2,7338,3748,3590
50,12,53,Florida,Hernando County,6,3,8540,4300,4240
50,12,53,Florida,Hernando County,6,4,7579,3898,3681
50,12,53,Florida,Hernando County,6,5,6154,3037,3117
50,12,53,Florida,Hernando County,6,6,5350,2634,2716
50,12,53,Florida,Hernando County,6,7,6805,3309,3496
50,12,53,Florida,Hernando County,6,8,7816,3709,4107
50,12,53,Florida,Hernando County,6,9,8928,4257,4671
50,12,53,Florida,Hernando County,6,10,9049,4244,4805
50,12,53,Florida,Hernando County,6,11,8651,3989,4662
50,12,53,Florida,Hernando County,6,12,9190,4239,4951
50,12,53,Florida,Hernando County,6,13,9572,4366,5206
50,12,53,Florida,Hernando County,6,14,9646,4494,5152
50,12,53,Florida,Hernando County,6,15,10267,4901,5366
50,12,53,Florida,Hernando County,6,16,9875,4538,5337
50,12,53,Florida,Hernando County,6,17,6749,3109,3640
50,12,53,Florida,Hernando County,6,18,4216,1732,2484
50,12,53,Florida,Hernando County,7,0,149114,71315,77799
50,12,53,Florida,Hernando County,7,1,7022,3606,3416
50,12,53,Florida,Hernando County,7,2,7788,3983,3805
50,12,53,Florida,Hernando County,7,3,8861,4450,4411
50,12,53,Florida,Hernando County,7,4,8073,4163,3910
50,12,53,Florida,Hernando County,7,5,6591,3295,3296
50,12,53,Florida,Hernando County,7,6,6059,2980,3079
50,12,53,Florida,Hernando County,7,7,7158,3529,3629
50,12,53,Florida,Hernando County,7,8,8237,3946,4291
50,12,53,Florida,Hernando County,7,9,9327,4471,4856
50,12,53,Florida,Hernando County,7,10,9518,4432,5086
50,12,53,Florida,Hernando County,7,11,9159,4250,4909
50,12,53,Florida,Hernando County,7,12,9825,4546,5279
50,12,53,Florida,Hernando County,7,13,10137,4651,5486
50,12,53,Florida,Hernando County,7,14,9923,4572,5351
50,12,53,Florida,Hernando County,7,15,9967,4748,5219
50,12,53,Florida,Hernando County,7,16,9825,4536,5289
50,12,53,Florida,Hernando County,7,17,7165,3286,3879
50,12,53,Florida,Hernando County,7,18,4479,1871,2608
50,12,53,Florida,Hernando County,8,0,156478,74943,81535
50,12,53,Florida,Hernando County,8,1,7504,3771,3733
50,12,53,Florida,Hernando County,8,2,8292,4272,4020
50,12,53,Florida,Hernando County,8,3,9118,4609,4509
50,12,53,Florida,Hernando County,8,4,8690,4468,4222
50,12,53,Florida,Hernando County,8,5,6965,3470,3495
50,12,53,Florida,Hernando County,8,6,6710,3314,3396
50,12,53,Florida,Hernando County,8,7,7399,3675,3724
50,12,53,Florida,Hernando County,8,8,8642,4169,4473
50,12,53,Florida,Hernando County,8,9,9934,4784,5150
50,12,53,Florida,Hernando County,8,10,10176,4775,5401
50,12,53,Florida,Hernando County,8,11,9802,4570,5232
50,12,53,Florida,Hernando County,8,12,10553,4857,5696
50,12,53,Florida,Hernando County,8,13,10780,4962,5818
50,12,53,Florida,Hernando County,8,14,10070,4627,5443
50,12,53,Florida,Hernando County,8,15,9886,4699,5187
50,12,53,Florida,Hernando County,8,16,9655,4456,5199
50,12,53,Florida,Hernando County,8,17,7400,3366,4034
50,12,53,Florida,Hernando County,8,18,4902,2099,2803
50,12,53,Florida,Hernando County,9,0,163551,78466,85085
50,12,53,Florida,Hernando County,9,1,7868,3974,3894
50,12,53,Florida,Hernando County,9,2,8792,4483,4309
50,12,53,Florida,Hernando County,9,3,9505,4863,4642
50,12,53,Florida,Hernando County,9,4,9191,4688,4503
50,12,53,Florida,Hernando County,9,5,7408,3692,3716
50,12,53,Florida,Hernando County,9,6,7375,3655,3720
50,12,53,Florida,Hernando County,9,7,7594,3781,3813
50,12,53,Florida,Hernando County,9,8,9160,4478,4682
50,12,53,Florida,Hernando County,9,9,10356,4984,5372
50,12,53,Florida,Hernando County,9,10,10745,5104,5641
50,12,53,Florida,Hernando County,9,11,10432,4827,5605
50,12,53,Florida,Hernando County,9,12,11224,5207,6017
50,12,53,Florida,Hernando County,9,13,11187,5143,6044
50,12,53,Florida,Hernando County,9,14,10491,4876,5615
50,12,53,Florida,Hernando County,9,15,9867,4650,5217
50,12,53,Florida,Hernando County,9,16,9582,4435,5147
50,12,53,Florida,Hernando County,9,17,7449,3308,4141
50,12,53,Florida,Hernando County,9,18,5325,2318,3007
50,12,53,Florida,Hernando County,10,0,168982,81204,87778
50,12,53,Florida,Hernando County,10,1,8294,4212,4082
50,12,53,Florida,Hernando County,10,2,9281,4764,4517
50,12,53,Florida,Hernando County,10,3,9810,5014,4796
50,12,53,Florida,Hernando County,10,4,9603,4906,4697
50,12,53,Florida,Hernando County,10,5,7916,3927,3989
50,12,53,Florida,Hernando County,10,6,7919,3958,3961
50,12,53,Florida,Hernando County,10,7,7787,3911,3876
50,12,53,Florida,Hernando County,10,8,9657,4735,4922
50,12,53,Florida,Hernando County,10,9,10482,5081,5401
50,12,53,Florida,Hernando County,10,10,11059,5285,5774
50,12,53,Florida,Hernando County,10,11,10852,5049,5803
50,12,53,Florida,Hernando County,10,12,11140,5132,6008
50,12,53,Florida,Hernando County,10,13,11814,5483,6331
50,12,53,Florida,Hernando County,10,14,10744,4904,5840
50,12,53,Florida,Hernando County,10,15,9813,4597,5216
50,12,53,Florida,Hernando County,10,16,9389,4357,5032
50,12,53,Florida,Hernando County,10,17,7606,3346,4260
50,12,53,Florida,Hernando County,10,18,5816,2543,3273
50,12,53,Florida,Hernando County,11,0,171447,82376,89071
50,12,53,Florida,Hernando County,11,1,8478,4315,4163
50,12,53,Florida,Hernando County,11,2,9106,4672,4434
50,12,53,Florida,Hernando County,11,3,9987,5118,4869
50,12,53,Florida,Hernando County,11,4,9816,4990,4826
50,12,53,Florida,Hernando County,11,5,7965,3939,4026
50,12,53,Florida,Hernando County,11,6,8421,4254,4167
50,12,53,Florida,Hernando County,11,7,7820,3898,3922
50,12,53,Florida,Hernando County,11,8,9607,4721,4886
50,12,53,Florida,Hernando County,11,9,10487,5101,5386
50,12,53,Florida,Hernando County,11,10,11171,5364,5807
50,12,53,Florida,Hernando County,11,11,11217,5266,5951
50,12,53,Florida,Hernando County,11,12,11156,5117,6039
50,12,53,Florida,Hernando County,11,13,11939,5521,6418
50,12,53,Florida,Hernando County,11,14,11368,5227,6141
50,12,53,Florida,Hernando County,11,15,9859,4545,5314
50,12,53,Florida,Hernando County,11,16,9239,4266,4973
50,12,53,Florida,Hernando County,11,17,7663,3390,4273
50,12,53,Florida,Hernando County,11,18,6148,2672,3476
50,12,53,Florida,Hernando County,12,0,171233,82254,88979
50,12,53,Florida,Hernando County,12,1,8506,4323,4183
50,12,53,Florida,Hernando County,12,2,8934,4581,4353
50,12,53,Florida,Hernando County,12,3,9859,5060,4799
50,12,53,Florida,Hernando County,12,4,9741,4953,4788
50,12,53,Florida,Hernando County,12,5,7918,3920,3998
50,12,53,Florida,Hernando County,12,6,8349,4251,4098
50,12,53,Florida,Hernando County,12,7,7993,3963,4030
50,12,53,Florida,Hernando County,12,8,9196,4549,4647
50,12,53,Florida,Hernando County,12,9,10274,5007,5267
50,12,53,Florida,Hernando County,12,10,11174,5380,5794
50,12,53,Florida,Hernando County,12,11,11270,5259,6011
50,12,53,Florida,Hernando County,12,12,11089,5110,5979
50,12,53,Florida,Hernando County,12,13,11923,5516,6407
50,12,53,Florida,Hernando County,12,14,11779,5415,6364
50,12,53,Florida,Hernando County,12,15,10116,4619,5497
50,12,53,Florida,Hernando County,12,16,9054,4166,4888
50,12,53,Florida,Hernando County,12,17,7674,3406,4268
50,12,53,Florida,Hernando County,12,18,6384,2776,3608
50,12,55,Florida,Highlands County,1,0,87366,42600,44766
50,12,55,Florida,Highlands County,1,1,4210,2154,2056
50,12,55,Florida,Highlands County,1,2,4610,2374,2236
50,12,55,Florida,Highlands County,1,3,4814,2511,2303
50,12,55,Florida,Highlands County,1,4,4911,2675,2236
50,12,55,Florida,Highlands County,1,5,3677,2017,1660
50,12,55,Florida,Highlands County,1,6,3672,1925,1747
50,12,55,Florida,Highlands County,1,7,3799,1962,1837
50,12,55,Florida,Highlands County,1,8,4641,2295,2346
50,12,55,Florida,Highlands County,1,9,4783,2365,2418
50,12,55,Florida,Highlands County,1,10,4523,2178,2345
50,12,55,Florida,Highlands County,1,11,4415,2070,2345
50,12,55,Florida,Highlands County,1,12,4823,2168,2655
50,12,55,Florida,Highlands County,1,13,5655,2605,3050
50,12,55,Florida,Highlands County,1,14,6982,3243,3739
50,12,55,Florida,Highlands County,1,15,7929,3838,4091
50,12,55,Florida,Highlands County,1,16,6959,3220,3739
50,12,55,Florida,Highlands County,1,17,4168,1912,2256
50,12,55,Florida,Highlands County,1,18,2795,1088,1707
50,12,55,Florida,Highlands County,2,0,87366,42600,44766
50,12,55,Florida,Highlands County,2,1,4210,2154,2056
50,12,55,Florida,Highlands County,2,2,4610,2374,2236
50,12,55,Florida,Highlands County,2,3,4814,2511,2303
50,12,55,Florida,Highlands County,2,4,4911,2675,2236
50,12,55,Florida,Highlands County,2,5,3677,2017,1660
50,12,55,Florida,Highlands County,2,6,3672,1925,1747
50,12,55,Florida,Highlands County,2,7,3799,1962,1837
50,12,55,Florida,Highlands County,2,8,4641,2295,2346
50,12,55,Florida,Highlands County,2,9,4783,2365,2418
50,12,55,Florida,Highlands County,2,10,4523,2178,2345
50,12,55,Florida,Highlands County,2,11,4415,2070,2345
50,12,55,Florida,Highlands County,2,12,4823,2168,2655
50,12,55,Florida,Highlands County,2,13,5655,2605,3050
50,12,55,Florida,Highlands County,2,14,6982,3243,3739
50,12,55,Florida,Highlands County,2,15,7929,3838,4091
50,12,55,Florida,Highlands County,2,16,6959,3220,3739
50,12,55,Florida,Highlands County,2,17,4168,1912,2256
50,12,55,Florida,Highlands County,2,18,2795,1088,1707
50,12,55,Florida,Highlands County,3,0,87407,42641,44766
50,12,55,Florida,Highlands County,3,1,4208,2153,2055
50,12,55,Florida,Highlands County,3,2,4585,2361,2224
50,12,55,Florida,Highlands County,3,3,4830,2519,2311
50,12,55,Florida,Highlands County,3,4,4911,2675,2236
50,12,55,Florida,Highlands County,3,5,3706,2036,1670
50,12,55,Florida,Highlands County,3,6,3651,1918,1733
50,12,55,Florida,Highlands County,3,7,3794,1960,1834
50,12,55,Florida,Highlands County,3,8,4621,2287,2334
50,12,55,Florida,Highlands County,3,9,4792,2369,2423
50,12,55,Florida,Highlands County,3,10,4544,2189,2355
50,12,55,Florida,Highlands County,3,11,4448,2085,2363
50,12,55,Florida,Highlands County,3,12,4839,2177,2662
50,12,55,Florida,Highlands County,3,13,5658,2607,3051
50,12,55,Florida,Highlands County,3,14,6943,3225,3718
50,12,55,Florida,Highlands County,3,15,7905,3832,4073
50,12,55,Florida,Highlands County,3,16,6960,3222,3738
50,12,55,Florida,Highlands County,3,17,4197,1928,2269
50,12,55,Florida,Highlands County,3,18,2815,1098,1717
50,12,55,Florida,Highlands County,4,0,88459,43203,45256
50,12,55,Florida,Highlands County,4,1,4325,2207,2118
50,12,55,Florida,Highlands County,4,2,4550,2328,2222
50,12,55,Florida,Highlands County,4,3,4899,2555,2344
50,12,55,Florida,Highlands County,4,4,4865,2629,2236
50,12,55,Florida,Highlands County,4,5,3912,2183,1729
50,12,55,Florida,Highlands County,4,6,3674,1969,1705
50,12,55,Florida,Highlands County,4,7,3812,1952,1860
50,12,55,Florida,Highlands County,4,8,4489,2245,2244
50,12,55,Florida,Highlands County,4,9,4932,2416,2516
50,12,55,Florida,Highlands County,4,10,4710,2302,2408
50,12,55,Florida,Highlands County,4,11,4756,2239,2517
50,12,55,Florida,Highlands County,4,12,4912,2225,2687
50,12,55,Florida,Highlands County,4,13,5762,2633,3129
50,12,55,Florida,Highlands County,4,14,6639,3086,3553
50,12,55,Florida,Highlands County,4,15,7737,3730,4007
50,12,55,Florida,Highlands County,4,16,6965,3242,3723
50,12,55,Florida,Highlands County,4,17,4522,2071,2451
50,12,55,Florida,Highlands County,4,18,2998,1191,1807
50,12,55,Florida,Highlands County,5,0,89822,43946,45876
50,12,55,Florida,Highlands County,5,1,4508,2283,2225
50,12,55,Florida,Highlands County,5,2,4528,2341,2187
50,12,55,Florida,Highlands County,5,3,4998,2591,2407
50,12,55,Florida,Highlands County,5,4,4924,2649,2275
50,12,55,Florida,Highlands County,5,5,4115,2314,1801
50,12,55,Florida,Highlands County,5,6,3783,2051,1732
50,12,55,Florida,Highlands County,5,7,3852,1972,1880
50,12,55,Florida,Highlands County,5,8,4468,2285,2183
50,12,55,Florida,Highlands County,5,9,4988,2432,2556
50,12,55,Florida,Highlands County,5,10,4888,2405,2483
50,12,55,Florida,Highlands County,5,11,4812,2269,2543
50,12,55,Florida,Highlands County,5,12,5205,2353,2852
50,12,55,Florida,Highlands County,5,13,5851,2676,3175
50,12,55,Florida,Highlands County,5,14,6578,3059,3519
50,12,55,Florida,Highlands County,5,15,7506,3581,3925
50,12,55,Florida,Highlands County,5,16,6827,3200,3627
50,12,55,Florida,Highlands County,5,17,4837,2218,2619
50,12,55,Florida,Highlands County,5,18,3154,1267,1887
50,12,55,Florida,Highlands County,6,0,90700,44488,46212
50,12,55,Florida,Highlands County,6,1,4487,2327,2160
50,12,55,Florida,Highlands County,6,2,4533,2300,2233
50,12,55,Florida,Highlands County,6,3,5025,2595,2430
50,12,55,Florida,Highlands County,6,4,4870,2613,2257
50,12,55,Florida,Highlands County,6,5,4320,2462,1858
50,12,55,Florida,Highlands County,6,6,3877,2136,1741
50,12,55,Florida,Highlands County,6,7,3925,2029,1896
50,12,55,Florida,Highlands County,6,8,4323,2240,2083
50,12,55,Florida,Highlands County,6,9,5074,2488,2586
50,12,55,Florida,Highlands County,6,10,5050,2505,2545
50,12,55,Florida,Highlands County,6,11,4896,2291,2605
50,12,55,Florida,Highlands County,6,12,5314,2429,2885
50,12,55,Florida,Highlands County,6,13,6047,2753,3294
50,12,55,Florida,Highlands County,6,14,6408,2967,3441
50,12,55,Florida,Highlands County,6,15,7295,3446,3849
50,12,55,Florida,Highlands County,6,16,6829,3221,3608
50,12,55,Florida,Highlands County,6,17,5044,2294,2750
50,12,55,Florida,Highlands County,6,18,3383,1392,1991
50,12,55,Florida,Highlands County,7,0,92752,45578,47174
50,12,55,Florida,Highlands County,7,1,4702,2423,2279
50,12,55,Florida,Highlands County,7,2,4574,2340,2234
50,12,55,Florida,Highlands County,7,3,5056,2595,2461
50,12,55,Florida,Highlands County,7,4,4980,2654,2326
50,12,55,Florida,Highlands County,7,5,4452,2552,1900
50,12,55,Florida,Highlands County,7,6,4109,2284,1825
50,12,55,Florida,Highlands County,7,7,4028,2103,1925
50,12,55,Florida,Highlands County,7,8,4197,2187,2010
50,12,55,Florida,Highlands County,7,9,5169,2538,2631
50,12,55,Florida,Highlands County,7,10,5266,2626,2640
50,12,55,Florida,Highlands County,7,11,5157,2429,2728
50,12,55,Florida,Highlands County,7,12,5564,2556,3008
50,12,55,Florida,Highlands County,7,13,6305,2881,3424
50,12,55,Florida,Highlands County,7,14,6648,3087,3561
50,12,55,Florida,Highlands County,7,15,6924,3222,3702
50,12,55,Florida,Highlands County,7,16,6842,3270,3572
50,12,55,Florida,Highlands County,7,17,5215,2339,2876
50,12,55,Florida,Highlands County,7,18,3564,1492,2072
50,12,55,Florida,Highlands County,8,0,95174,46805,48369
50,12,55,Florida,Highlands County,8,1,4849,2480,2369
50,12,55,Florida,Highlands County,8,2,4640,2378,2262
50,12,55,Florida,Highlands County,8,3,5034,2583,2451
50,12,55,Florida,Highlands County,8,4,5089,2716,2373
50,12,55,Florida,Highlands County,8,5,4649,2636,2013
50,12,55,Florida,Highlands County,8,6,4311,2423,1888
50,12,55,Florida,Highlands County,8,7,4111,2178,1933
50,12,55,Florida,Highlands County,8,8,4262,2203,2059
50,12,55,Florida,Highlands County,8,9,5206,2596,2610
50,12,55,Florida,Highlands County,8,10,5461,2707,2754
50,12,55,Florida,Highlands County,8,11,5411,2565,2846
50,12,55,Florida,Highlands County,8,12,5793,2699,3094
50,12,55,Florida,Highlands County,8,13,6586,3002,3584
50,12,55,Florida,Highlands County,8,14,6935,3241,3694
50,12,55,Florida,Highlands County,8,15,6793,3130,3663
50,12,55,Florida,Highlands County,8,16,6915,3290,3625
50,12,55,Florida,Highlands County,8,17,5283,2388,2895
50,12,55,Florida,Highlands County,8,18,3846,1590,2256
50,12,55,Florida,Highlands County,9,0,97265,47880,49385
50,12,55,Florida,Highlands County,9,1,5004,2559,2445
50,12,55,Florida,Highlands County,9,2,4784,2445,2339
50,12,55,Florida,Highlands County,9,3,5114,2608,2506
50,12,55,Florida,Highlands County,9,4,5248,2798,2450
50,12,55,Florida,Highlands County,9,5,4749,2654,2095
50,12,55,Florida,Highlands County,9,6,4600,2617,1983
50,12,55,Florida,Highlands County,9,7,4191,2260,1931
50,12,55,Florida,Highlands County,9,8,4382,2250,2132
50,12,55,Florida,Highlands County,9,9,5159,2604,2555
50,12,55,Florida,Highlands County,9,10,5621,2764,2857
50,12,55,Florida,Highlands County,9,11,5553,2678,2875
50,12,55,Florida,Highlands County,9,12,6087,2845,3242
50,12,55,Florida,Highlands County,9,13,6622,3030,3592
50,12,55,Florida,Highlands County,9,14,7097,3307,3790
50,12,55,Florida,Highlands County,9,15,6704,3081,3623
50,12,55,Florida,Highlands County,9,16,6802,3215,3587
50,12,55,Florida,Highlands County,9,17,5287,2397,2890
50,12,55,Florida,Highlands County,9,18,4261,1768,2493
50,12,55,Florida,Highlands County,10,0,98512,48614,49898
50,12,55,Florida,Highlands County,10,1,5291,2723,2568
50,12,55,Florida,Highlands County,10,2,4955,2512,2443
50,12,55,Florida,Highlands County,10,3,5010,2584,2426
50,12,55,Florida,Highlands County,10,4,5241,2775,2466
50,12,55,Florida,Highlands County,10,5,4798,2665,2133
50,12,55,Florida,Highlands County,10,6,4908,2807,2101
50,12,55,Florida,Highlands County,10,7,4241,2315,1926
50,12,55,Florida,Highlands County,10,8,4403,2261,2142
50,12,55,Florida,Highlands County,10,9,5099,2634,2465
50,12,55,Florida,Highlands County,10,10,5693,2795,2898
50,12,55,Florida,Highlands County,10,11,5674,2759,2915
50,12,55,Florida,Highlands County,10,12,5943,2779,3164
50,12,55,Florida,Highlands County,10,13,6868,3141,3727
50,12,55,Florida,Highlands County,10,14,7125,3315,3810
50,12,55,Florida,Highlands County,10,15,6665,3088,3577
50,12,55,Florida,Highlands County,10,16,6687,3110,3577
50,12,55,Florida,Highlands County,10,17,5269,2412,2857
50,12,55,Florida,Highlands County,10,18,4642,1939,2703
50,12,55,Florida,Highlands County,11,0,99034,48957,50077
50,12,55,Florida,Highlands County,11,1,5381,2750,2631
50,12,55,Florida,Highlands County,11,2,4996,2592,2404
50,12,55,Florida,Highlands County,11,3,4992,2530,2462
50,12,55,Florida,Highlands County,11,4,5286,2784,2502
50,12,55,Florida,Highlands County,11,5,4760,2626,2134
50,12,55,Florida,Highlands County,11,6,5103,2944,2159
50,12,55,Florida,Highlands County,11,7,4356,2410,1946
50,12,55,Florida,Highlands County,11,8,4379,2262,2117
50,12,55,Florida,Highlands County,11,9,4920,2572,2348
50,12,55,Florida,Highlands County,11,10,5695,2810,2885
50,12,55,Florida,Highlands County,11,11,5720,2811,2909
50,12,55,Florida,Highlands County,11,12,5936,2767,3169
50,12,55,Florida,Highlands County,11,13,6713,3072,3641
50,12,55,Florida,Highlands County,11,14,7356,3412,3944
50,12,55,Florida,Highlands County,11,15,6582,3042,3540
50,12,55,Florida,Highlands County,11,16,6619,3065,3554
50,12,55,Florida,Highlands County,11,17,5305,2452,2853
50,12,55,Florida,Highlands County,11,18,4935,2056,2879
50,12,55,Florida,Highlands County,12,0,98704,48831,49873
50,12,55,Florida,Highlands County,12,1,5362,2747,2615
50,12,55,Florida,Highlands County,12,2,5031,2594,2437
50,12,55,Florida,Highlands County,12,3,4894,2501,2393
50,12,55,Florida,Highlands County,12,4,5150,2699,2451
50,12,55,Florida,Highlands County,12,5,4752,2603,2149
50,12,55,Florida,Highlands County,12,6,5091,2956,2135
50,12,55,Florida,Highlands County,12,7,4448,2484,1964
50,12,55,Florida,Highlands County,12,8,4353,2272,2081
50,12,55,Florida,Highlands County,12,9,4683,2458,2225
50,12,55,Florida,Highlands County,12,10,5657,2806,2851
50,12,55,Florida,Highlands County,12,11,5697,2814,2883
50,12,55,Florida,Highlands County,12,12,5830,2723,3107
50,12,55,Florida,Highlands County,12,13,6671,3060,3611
50,12,55,Florida,Highlands County,12,14,7424,3435,3989
50,12,55,Florida,Highlands County,12,15,6787,3142,3645
50,12,55,Florida,Highlands County,12,16,6298,2865,3433
50,12,55,Florida,Highlands County,12,17,5421,2533,2888
50,12,55,Florida,Highlands County,12,18,5155,2139,3016
50,12,57,Florida,Hillsborough County,1,0,998948,488772,510176
50,12,57,Florida,Hillsborough County,1,1,68444,34968,33476
50,12,57,Florida,Hillsborough County,1,2,72849,37283,35566
50,12,57,Florida,Hillsborough County,1,3,71261,36530,34731
50,12,57,Florida,Hillsborough County,1,4,67522,34505,33017
50,12,57,Florida,Hillsborough County,1,5,66133,32763,33370
50,12,57,Florida,Hillsborough County,1,6,73428,36628,36800
50,12,57,Florida,Hillsborough County,1,7,77476,38897,38579
50,12,57,Florida,Hillsborough County,1,8,85114,42250,42864
50,12,57,Florida,Hillsborough County,1,9,80585,39881,40704
50,12,57,Florida,Hillsborough County,1,10,70299,34225,36074
50,12,57,Florida,Hillsborough County,1,11,62155,30416,31739
50,12,57,Florida,Hillsborough County,1,12,46871,22539,24332
50,12,57,Florida,Hillsborough County,1,13,37138,17622,19516
50,12,57,Florida,Hillsborough County,1,14,33016,15488,17528
50,12,57,Florida,Hillsborough County,1,15,30759,13543,17216
50,12,57,Florida,Hillsborough County,1,16,25797,10602,15195
50,12,57,Florida,Hillsborough County,1,17,16834,6528,10306
50,12,57,Florida,Hillsborough County,1,18,13267,4104,9163
50,12,57,Florida,Hillsborough County,2,0,998943,488770,510173
50,12,57,Florida,Hillsborough County,2,1,68444,34968,33476
50,12,57,Florida,Hillsborough County,2,2,72847,37282,35565
50,12,57,Florida,Hillsborough County,2,3,71260,36530,34730
50,12,57,Florida,Hillsborough County,2,4,67522,34505,33017
50,12,57,Florida,Hillsborough County,2,5,66133,32763,33370
50,12,57,Florida,Hillsborough County,2,6,73427,36628,36799
50,12,57,Florida,Hillsborough County,2,7,77475,38896,38579
50,12,57,Florida,Hillsborough County,2,8,85114,42250,42864
50,12,57,Florida,Hillsborough County,2,9,80585,39881,40704
50,12,57,Florida,Hillsborough County,2,10,70299,34225,36074
50,12,57,Florida,Hillsborough County,2,11,62155,30416,31739
50,12,57,Florida,Hillsborough County,2,12,46871,22539,24332
50,12,57,Florida,Hillsborough County,2,13,37138,17622,19516
50,12,57,Florida,Hillsborough County,2,14,33016,15488,17528
50,12,57,Florida,Hillsborough County,2,15,30759,13543,17216
50,12,57,Florida,Hillsborough County,2,16,25797,10602,15195
50,12,57,Florida,Hillsborough County,2,17,16834,6528,10306
50,12,57,Florida,Hillsborough County,2,18,13267,4104,9163
50,12,57,Florida,Hillsborough County,3,0,1003269,490987,512282
50,12,57,Florida,Hillsborough County,3,1,68675,35080,33595
50,12,57,Florida,Hillsborough County,3,2,72739,37229,35510
50,12,57,Florida,Hillsborough County,3,3,71775,36784,34991
50,12,57,Florida,Hillsborough County,3,4,67745,34621,33124
50,12,57,Florida,Hillsborough County,3,5,66808,33127,33681
50,12,57,Florida,Hillsborough County,3,6,73217,36535,36682
50,12,57,Florida,Hillsborough County,3,7,77679,39008,38671
50,12,57,Florida,Hillsborough County,3,8,85068,42237,42831
50,12,57,Florida,Hillsborough County,3,9,81029,40108,40921
50,12,57,Florida,Hillsborough County,3,10,70879,34518,36361
50,12,57,Florida,Hillsborough County,3,11,62944,30802,32142
50,12,57,Florida,Hillsborough County,3,12,47262,22735,24527
50,12,57,Florida,Hillsborough County,3,13,37367,17737,19630
50,12,57,Florida,Hillsborough County,3,14,32970,15471,17499
50,12,57,Florida,Hillsborough County,3,15,30795,13578,17217
50,12,57,Florida,Hillsborough County,3,16,25915,10661,15254
50,12,57,Florida,Hillsborough County,3,17,17010,6606,10404
50,12,57,Florida,Hillsborough County,3,18,13392,4150,9242
50,12,57,Florida,Hillsborough County,4,0,1026319,502551,523768
50,12,57,Florida,Hillsborough County,4,1,70736,36174,34562
50,12,57,Florida,Hillsborough County,4,2,72701,37224,35477
50,12,57,Florida,Hillsborough County,4,3,74194,37988,36206
50,12,57,Florida,Hillsborough County,4,4,68816,35272,33544
50,12,57,Florida,Hillsborough County,4,5,71965,35675,36290
50,12,57,Florida,Hillsborough County,4,6,73155,36539,36616
50,12,57,Florida,Hillsborough County,4,7,79084,39522,39562
50,12,57,Florida,Hillsborough County,4,8,84862,42250,42612
50,12,57,Florida,Hillsborough County,4,9,83446,41253,42193
50,12,57,Florida,Hillsborough County,4,10,73227,35579,37648
50,12,57,Florida,Hillsborough County,4,11,66134,32296,33838
50,12,57,Florida,Hillsborough County,4,12,48834,23484,25350
50,12,57,Florida,Hillsborough County,4,13,38167,18167,20000
50,12,57,Florida,Hillsborough County,4,14,32742,15400,17342
50,12,57,Florida,Hillsborough County,4,15,30691,13712,16979
50,12,57,Florida,Hillsborough County,4,16,25844,10633,15211
50,12,57,Florida,Hillsborough County,4,17,18102,7124,10978
50,12,57,Florida,Hillsborough County,4,18,13619,4259,9360
50,12,57,Florida,Hillsborough County,5,0,1050928,514949,535979
50,12,57,Florida,Hillsborough County,5,1,73037,37304,35733
50,12,57,Florida,Hillsborough County,5,2,73294,37461,35833
50,12,57,Florida,Hillsborough County,5,3,76005,38873,37132
50,12,57,Florida,Hillsborough County,5,4,69707,35995,33712
50,12,57,Florida,Hillsborough County,5,5,75194,37208,37986
50,12,57,Florida,Hillsborough County,5,6,74889,37438,37451
50,12,57,Florida,Hillsborough County,5,7,81204,40551,40653
50,12,57,Florida,Hillsborough County,5,8,84461,42009,42452
50,12,57,Florida,Hillsborough County,5,9,85103,42162,42941
50,12,57,Florida,Hillsborough County,5,10,76298,37134,39164
50,12,57,Florida,Hillsborough County,5,11,66251,32166,34085
50,12,57,Florida,Hillsborough County,5,12,53629,25910,27719
50,12,57,Florida,Hillsborough County,5,13,39565,18803,20762
50,12,57,Florida,Hillsborough County,5,14,32741,15415,17326
50,12,57,Florida,Hillsborough County,5,15,30269,13679,16590
50,12,57,Florida,Hillsborough County,5,16,26118,10818,15300
50,12,57,Florida,Hillsborough County,5,17,18917,7417,11500
50,12,57,Florida,Hillsborough County,5,18,14246,4606,9640
50,12,57,Florida,Hillsborough County,6,0,1071415,525494,545921
50,12,57,Florida,Hillsborough County,6,1,74978,38364,36614
50,12,57,Florida,Hillsborough County,6,2,73206,37350,35856
50,12,57,Florida,Hillsborough County,6,3,77430,39653,37777
50,12,57,Florida,Hillsborough County,6,4,71677,36817,34860
50,12,57,Florida,Hillsborough County,6,5,77193,38488,38705
50,12,57,Florida,Hillsborough County,6,6,77509,38871,38638
50,12,57,Florida,Hillsborough County,6,7,81817,40894,40923
50,12,57,Florida,Hillsborough County,6,8,83210,41312,41898
50,12,57,Florida,Hillsborough County,6,9,86489,42939,43550
50,12,57,Florida,Hillsborough County,6,10,78418,38235,40183
50,12,57,Florida,Hillsborough County,6,11,67731,32729,35002
50,12,57,Florida,Hillsborough County,6,12,56126,27108,29018
50,12,57,Florida,Hillsborough County,6,13,41457,19679,21778
50,12,57,Florida,Hillsborough County,6,14,33153,15686,17467
50,12,57,Florida,Hillsborough County,6,15,29897,13640,16257
50,12,57,Florida,Hillsborough County,6,16,26483,11054,15429
50,12,57,Florida,Hillsborough County,6,17,19566,7742,11824
50,12,57,Florida,Hillsborough County,6,18,15075,4933,10142
50,12,57,Florida,Hillsborough County,7,0,1099688,540079,559609
50,12,57,Florida,Hillsborough County,7,1,77588,39710,37878
50,12,57,Florida,Hillsborough County,7,2,74546,38198,36348
50,12,57,Florida,Hillsborough County,7,3,78516,40090,38426
50,12,57,Florida,Hillsborough County,7,4,74195,38061,36134
50,12,57,Florida,Hillsborough County,7,5,78936,39657,39279
50,12,57,Florida,Hillsborough County,7,6,82554,41412,41142
50,12,57,Florida,Hillsborough County,7,7,82529,41270,41259
50,12,57,Florida,Hillsborough County,7,8,82679,41173,41506
50,12,57,Florida,Hillsborough County,7,9,88698,43848,44850
50,12,57,Florida,Hillsborough County,7,10,80609,39532,41077
50,12,57,Florida,Hillsborough County,7,11,69435,33460,35975
50,12,57,Florida,Hillsborough County,7,12,59327,28784,30543
50,12,57,Florida,Hillsborough County,7,13,43663,20680,22983
50,12,57,Florida,Hillsborough County,7,14,33663,15839,17824
50,12,57,Florida,Hillsborough County,7,15,29786,13715,16071
50,12,57,Florida,Hillsborough County,7,16,26680,11306,15374
50,12,57,Florida,Hillsborough County,7,17,20273,8019,12254
50,12,57,Florida,Hillsborough County,7,18,16011,5325,10686
50,12,57,Florida,Hillsborough County,8,0,1132025,556658,575367
50,12,57,Florida,Hillsborough County,8,1,81011,41517,39494
50,12,57,Florida,Hillsborough County,8,2,76236,38997,37239
50,12,57,Florida,Hillsborough County,8,3,79489,40648,38841
50,12,57,Florida,Hillsborough County,8,4,76685,39223,37462
50,12,57,Florida,Hillsborough County,8,5,79520,40408,39112
50,12,57,Florida,Hillsborough County,8,6,87754,43948,43806
50,12,57,Florida,Hillsborough County,8,7,83268,41631,41637
50,12,57,Florida,Hillsborough County,8,8,84679,42328,42351
50,12,57,Florida,Hillsborough County,8,9,90268,44643,45625
50,12,57,Florida,Hillsborough County,8,10,83597,41154,42443
50,12,57,Florida,Hillsborough County,8,11,71844,34531,37313
50,12,57,Florida,Hillsborough County,8,12,62441,30182,32259
50,12,57,Florida,Hillsborough County,8,13,45736,21742,23994
50,12,57,Florida,Hillsborough County,8,14,34781,16350,18431
50,12,57,Florida,Hillsborough County,8,15,29701,13647,16054
50,12,57,Florida,Hillsborough County,8,16,26963,11623,15340
50,12,57,Florida,Hillsborough County,8,17,20914,8358,12556
50,12,57,Florida,Hillsborough County,8,18,17138,5728,11410
50,12,57,Florida,Hillsborough County,9,0,1158212,570072,588140
50,12,57,Florida,Hillsborough County,9,1,83096,42584,40512
50,12,57,Florida,Hillsborough County,9,2,78489,40160,38329
50,12,57,Florida,Hillsborough County,9,3,79689,40773,38916
50,12,57,Florida,Hillsborough County,9,4,79350,40515,38835
50,12,57,Florida,Hillsborough County,9,5,80291,41105,39186
50,12,57,Florida,Hillsborough County,9,6,92886,46554,46332
50,12,57,Florida,Hillsborough County,9,7,82756,41448,41308
50,12,57,Florida,Hillsborough County,9,8,86862,43318,43544
50,12,57,Florida,Hillsborough County,9,9,90194,44793,45401
50,12,57,Florida,Hillsborough County,9,10,86283,42449,43834
50,12,57,Florida,Hillsborough County,9,11,74354,35713,38641
50,12,57,Florida,Hillsborough County,9,12,65397,31554,33843
50,12,57,Florida,Hillsborough County,9,13,47212,22452,24760
50,12,57,Florida,Hillsborough County,9,14,35469,16699,18770
50,12,57,Florida,Hillsborough County,9,15,29535,13602,15933
50,12,57,Florida,Hillsborough County,9,16,27025,11750,15275
50,12,57,Florida,Hillsborough County,9,17,20965,8327,12638
50,12,57,Florida,Hillsborough County,9,18,18359,6276,12083
50,12,57,Florida,Hillsborough County,10,0,1169910,576670,593240
50,12,57,Florida,Hillsborough County,10,1,84399,43395,41004
50,12,57,Florida,Hillsborough County,10,2,79090,40428,38662
50,12,57,Florida,Hillsborough County,10,3,78962,40357,38605
50,12,57,Florida,Hillsborough County,10,4,80141,40921,39220
50,12,57,Florida,Hillsborough County,10,5,80626,41661,38965
50,12,57,Florida,Hillsborough County,10,6,94640,47510,47130
50,12,57,Florida,Hillsborough County,10,7,82269,41273,40996
50,12,57,Florida,Hillsborough County,10,8,86791,43304,43487
50,12,57,Florida,Hillsborough County,10,9,88794,44117,44677
50,12,57,Florida,Hillsborough County,10,10,87488,43173,44315
50,12,57,Florida,Hillsborough County,10,11,76290,36743,39547
50,12,57,Florida,Hillsborough County,10,12,65672,31544,34128
50,12,57,Florida,Hillsborough County,10,13,51293,24475,26818
50,12,57,Florida,Hillsborough County,10,14,36579,17183,19396
50,12,57,Florida,Hillsborough County,10,15,29660,13711,15949
50,12,57,Florida,Hillsborough County,10,16,26612,11667,14945
50,12,57,Florida,Hillsborough County,10,17,21180,8495,12685
50,12,57,Florida,Hillsborough County,10,18,19424,6713,12711
50,12,57,Florida,Hillsborough County,11,0,1180118,581866,598252
50,12,57,Florida,Hillsborough County,11,1,85446,43929,41517
50,12,57,Florida,Hillsborough County,11,2,79598,40755,38843
50,12,57,Florida,Hillsborough County,11,3,77920,39790,38130
50,12,57,Florida,Hillsborough County,11,4,80531,41131,39400
50,12,57,Florida,Hillsborough County,11,5,80627,41487,39140
50,12,57,Florida,Hillsborough County,11,6,94697,47813,46884
50,12,57,Florida,Hillsborough County,11,7,83320,41841,41479
50,12,57,Florida,Hillsborough County,11,8,86469,43151,43318
50,12,57,Florida,Hillsborough County,11,9,87120,43259,43861
50,12,57,Florida,Hillsborough County,11,10,88536,43786,44750
50,12,57,Florida,Hillsborough County,11,11,78024,37684,40340
50,12,57,Florida,Hillsborough County,11,12,66810,31968,34842
50,12,57,Florida,Hillsborough County,11,13,53731,25618,28113
50,12,57,Florida,Hillsborough County,11,14,38526,18090,20436
50,12,57,Florida,Hillsborough County,11,15,30129,13962,16167
50,12,57,Florida,Hillsborough County,11,16,26337,11601,14736
50,12,57,Florida,Hillsborough County,11,17,21780,8820,12960
50,12,57,Florida,Hillsborough County,11,18,20517,7181,13336
50,12,57,Florida,Hillsborough County,12,0,1195317,589575,605742
50,12,57,Florida,Hillsborough County,12,1,85988,44111,41877
50,12,57,Florida,Hillsborough County,12,2,80933,41477,39456
50,12,57,Florida,Hillsborough County,12,3,77516,39767,37749
50,12,57,Florida,Hillsborough County,12,4,81121,41287,39834
50,12,57,Florida,Hillsborough County,12,5,81364,41795,39569
50,12,57,Florida,Hillsborough County,12,6,94452,47986,46466
50,12,57,Florida,Hillsborough County,12,7,86664,43482,43182
50,12,57,Florida,Hillsborough County,12,8,85935,42914,43021
50,12,57,Florida,Hillsborough County,12,9,85641,42643,42998
50,12,57,Florida,Hillsborough County,12,10,89900,44249,45651
50,12,57,Florida,Hillsborough County,12,11,80254,39021,41233
50,12,57,Florida,Hillsborough County,12,12,68132,32468,35664
50,12,57,Florida,Hillsborough County,12,13,56813,27205,29608
50,12,57,Florida,Hillsborough County,12,14,40468,18972,21496
50,12,57,Florida,Hillsborough County,12,15,30517,14037,16480
50,12,57,Florida,Hillsborough County,12,16,26168,11614,14554
50,12,57,Florida,Hillsborough County,12,17,21751,8911,12840
50,12,57,Florida,Hillsborough County,12,18,21700,7636,14064
50,12,59,Florida,Holmes County,1,0,18564,9846,8718
50,12,59,Florida,Holmes County,1,1,1028,526,502
50,12,59,Florida,Holmes County,1,2,1191,628,563
50,12,59,Florida,Holmes County,1,3,1269,659,610
50,12,59,Florida,Holmes County,1,4,1283,696,587
50,12,59,Florida,Holmes County,1,5,1147,733,414
50,12,59,Florida,Holmes County,1,6,1280,805,475
50,12,59,Florida,Holmes County,1,7,1392,819,573
50,12,59,Florida,Holmes County,1,8,1452,846,606
50,12,59,Florida,Holmes County,1,9,1319,728,591
50,12,59,Florida,Holmes County,1,10,1200,624,576
50,12,59,Florida,Holmes County,1,11,1225,624,601
50,12,59,Florida,Holmes County,1,12,1055,515,540
50,12,59,Florida,Holmes County,1,13,974,489,485
50,12,59,Florida,Holmes County,1,14,799,415,384
50,12,59,Florida,Holmes County,1,15,671,300,371
50,12,59,Florida,Holmes County,1,16,533,210,323
50,12,59,Florida,Holmes County,1,17,375,128,247
50,12,59,Florida,Holmes County,1,18,371,101,270
50,12,59,Florida,Holmes County,2,0,18564,9846,8718
50,12,59,Florida,Holmes County,2,1,1028,526,502
50,12,59,Florida,Holmes County,2,2,1191,628,563
50,12,59,Florida,Holmes County,2,3,1269,659,610
50,12,59,Florida,Holmes County,2,4,1283,696,587
50,12,59,Florida,Holmes County,2,5,1147,733,414
50,12,59,Florida,Holmes County,2,6,1280,805,475
50,12,59,Florida,Holmes County,2,7,1392,819,573
50,12,59,Florida,Holmes County,2,8,1452,846,606
50,12,59,Florida,Holmes County,2,9,1319,728,591
50,12,59,Florida,Holmes County,2,10,1200,624,576
50,12,59,Florida,Holmes County,2,11,1225,624,601
50,12,59,Florida,Holmes County,2,12,1055,515,540
50,12,59,Florida,Holmes County,2,13,974,489,485
50,12,59,Florida,Holmes County,2,14,799,415,384
50,12,59,Florida,Holmes County,2,15,671,300,371
50,12,59,Florida,Holmes County,2,16,533,210,323
50,12,59,Florida,Holmes County,2,17,375,128,247
50,12,59,Florida,Holmes County,2,18,371,101,270
50,12,59,Florida,Holmes County,3,0,18535,9832,8703
50,12,59,Florida,Holmes County,3,1,1022,523,499
50,12,59,Florida,Holmes County,3,2,1180,622,558
50,12,59,Florida,Holmes County,3,3,1265,657,608
50,12,59,Florida,Holmes County,3,4,1276,693,583
50,12,59,Florida,Holmes County,3,5,1153,737,416
50,12,59,Florida,Holmes County,3,6,1269,800,469
50,12,59,Florida,Holmes County,3,7,1385,815,570
50,12,59,Florida,Holmes County,3,8,1439,840,599
50,12,59,Florida,Holmes County,3,9,1314,725,589
50,12,59,Florida,Holmes County,3,10,1199,624,575
50,12,59,Florida,Holmes County,3,11,1230,626,604
50,12,59,Florida,Holmes County,3,12,1054,515,539
50,12,59,Florida,Holmes County,3,13,972,488,484
50,12,59,Florida,Holmes County,3,14,803,417,386
50,12,59,Florida,Holmes County,3,15,677,304,373
50,12,59,Florida,Holmes County,3,16,539,213,326
50,12,59,Florida,Holmes County,3,17,381,130,251
50,12,59,Florida,Holmes County,3,18,377,103,274
50,12,59,Florida,Holmes County,4,0,18634,9909,8725
50,12,59,Florida,Holmes County,4,1,1067,558,509
50,12,59,Florida,Holmes County,4,2,1178,622,556
50,12,59,Florida,Holmes County,4,3,1239,637,602
50,12,59,Florida,Holmes County,4,4,1232,670,562
50,12,59,Florida,Holmes County,4,5,1255,799,456
50,12,59,Florida,Holmes County,4,6,1298,820,478
50,12,59,Florida,Holmes County,4,7,1369,808,561
50,12,59,Florida,Holmes County,4,8,1365,797,568
50,12,59,Florida,Holmes County,4,9,1378,757,621
50,12,59,Florida,Holmes County,4,10,1166,607,559
50,12,59,Florida,Holmes County,4,11,1237,641,596
50,12,59,Florida,Holmes County,4,12,1066,524,542
50,12,59,Florida,Holmes County,4,13,942,463,479
50,12,59,Florida,Holmes County,4,14,846,425,421
50,12,59,Florida,Holmes County,4,15,669,315,354
50,12,59,Florida,Holmes County,4,16,576,231,345
50,12,59,Florida,Holmes County,4,17,371,128,243
50,12,59,Florida,Holmes County,4,18,380,107,273
50,12,59,Florida,Holmes County,5,0,18614,9879,8735
50,12,59,Florida,Holmes County,5,1,1038,547,491
50,12,59,Florida,Holmes County,5,2,1181,612,569
50,12,59,Florida,Holmes County,5,3,1229,639,590
50,12,59,Florida,Holmes County,5,4,1229,674,555
50,12,59,Florida,Holmes County,5,5,1205,761,444
50,12,59,Florida,Holmes County,5,6,1280,809,471
50,12,59,Florida,Holmes County,5,7,1346,796,550
50,12,59,Florida,Holmes County,5,8,1403,812,591
50,12,59,Florida,Holmes County,5,9,1367,749,618
50,12,59,Florida,Holmes County,5,10,1193,609,584
50,12,59,Florida,Holmes County,5,11,1199,633,566
50,12,59,Florida,Holmes County,5,12,1131,554,577
50,12,59,Florida,Holmes County,5,13,952,466,486
50,12,59,Florida,Holmes County,5,14,849,417,432
50,12,59,Florida,Holmes County,5,15,685,323,362
50,12,59,Florida,Holmes County,5,16,571,238,333
50,12,59,Florida,Holmes County,5,17,376,132,244
50,12,59,Florida,Holmes County,5,18,380,108,272
50,12,59,Florida,Holmes County,6,0,18876,10105,8771
50,12,59,Florida,Holmes County,6,1,1067,556,511
50,12,59,Florida,Holmes County,6,2,1159,605,554
50,12,59,Florida,Holmes County,6,3,1193,611,582
50,12,59,Florida,Holmes County,6,4,1286,712,574
50,12,59,Florida,Holmes County,6,5,1264,809,455
50,12,59,Florida,Holmes County,6,6,1269,818,451
50,12,59,Florida,Holmes County,6,7,1408,869,539
50,12,59,Florida,Holmes County,6,8,1417,824,593
50,12,59,Florida,Holmes County,6,9,1345,733,612
50,12,59,Florida,Holmes County,6,10,1257,665,592
50,12,59,Florida,Holmes County,6,11,1173,598,575
50,12,59,Florida,Holmes County,6,12,1127,555,572
50,12,59,Florida,Holmes County,6,13,1009,492,517
50,12,59,Florida,Holmes County,6,14,840,415,425
50,12,59,Florida,Holmes County,6,15,696,335,361
50,12,59,Florida,Holmes County,6,16,592,259,333
50,12,59,Florida,Holmes County,6,17,394,133,261
50,12,59,Florida,Holmes County,6,18,380,116,264
50,12,59,Florida,Holmes County,7,0,18819,10052,8767
50,12,59,Florida,Holmes County,7,1,1054,544,510
50,12,59,Florida,Holmes County,7,2,1106,578,528
50,12,59,Florida,Holmes County,7,3,1212,632,580
50,12,59,Florida,Holmes County,7,4,1255,690,565
50,12,59,Florida,Holmes County,7,5,1259,791,468
50,12,59,Florida,Holmes County,7,6,1196,789,407
50,12,59,Florida,Holmes County,7,7,1413,867,546
50,12,59,Florida,Holmes County,7,8,1378,806,572
50,12,59,Florida,Holmes County,7,9,1328,718,610
50,12,59,Florida,Holmes County,7,10,1263,670,593
50,12,59,Florida,Holmes County,7,11,1165,584,581
50,12,59,Florida,Holmes County,7,12,1159,573,586
50,12,59,Florida,Holmes County,7,13,1053,511,542
50,12,59,Florida,Holmes County,7,14,902,451,451
50,12,59,Florida,Holmes County,7,15,684,333,351
50,12,59,Florida,Holmes County,7,16,578,251,327
50,12,59,Florida,Holmes County,7,17,434,160,274
50,12,59,Florida,Holmes County,7,18,380,104,276
50,12,59,Florida,Holmes County,8,0,18882,10041,8841
50,12,59,Florida,Holmes County,8,1,1095,557,538
50,12,59,Florida,Holmes County,8,2,1059,542,517
50,12,59,Florida,Holmes County,8,3,1267,666,601
50,12,59,Florida,Holmes County,8,4,1212,668,544
50,12,59,Florida,Holmes County,8,5,1281,805,476
50,12,59,Florida,Holmes County,8,6,1223,795,428
50,12,59,Florida,Holmes County,8,7,1338,824,514
50,12,59,Florida,Holmes County,8,8,1342,776,566
50,12,59,Florida,Holmes County,8,9,1369,761,608
50,12,59,Florida,Holmes County,8,10,1272,658,614
50,12,59,Florida,Holmes County,8,11,1167,575,592
50,12,59,Florida,Holmes County,8,12,1209,605,604
50,12,59,Florida,Holmes County,8,13,1031,494,537
50,12,59,Florida,Holmes County,8,14,901,443,458
50,12,59,Florida,Holmes County,8,15,712,360,352
50,12,59,Florida,Holmes County,8,16,556,242,314
50,12,59,Florida,Holmes County,8,17,431,148,283
50,12,59,Florida,Holmes County,8,18,417,122,295
50,12,59,Florida,Holmes County,9,0,19055,10124,8931
50,12,59,Florida,Holmes County,9,1,1137,566,571
50,12,59,Florida,Holmes County,9,2,1055,551,504
50,12,59,Florida,Holmes County,9,3,1271,670,601
50,12,59,Florida,Holmes County,9,4,1211,659,552
50,12,59,Florida,Holmes County,9,5,1274,793,481
50,12,59,Florida,Holmes County,9,6,1330,860,470
50,12,59,Florida,Holmes County,9,7,1347,832,515
50,12,59,Florida,Holmes County,9,8,1329,765,564
50,12,59,Florida,Holmes County,9,9,1273,708,565
50,12,59,Florida,Holmes County,9,10,1372,710,662
50,12,59,Florida,Holmes County,9,11,1160,570,590
50,12,59,Florida,Holmes County,9,12,1226,628,598
50,12,59,Florida,Holmes County,9,13,1047,499,548
50,12,59,Florida,Holmes County,9,14,876,427,449
50,12,59,Florida,Holmes County,9,15,733,352,381
50,12,59,Florida,Holmes County,9,16,539,245,294
50,12,59,Florida,Holmes County,9,17,464,172,292
50,12,59,Florida,Holmes County,9,18,411,117,294
50,12,59,Florida,Holmes County,10,0,19119,10150,8969
50,12,59,Florida,Holmes County,10,1,1155,580,575
50,12,59,Florida,Holmes County,10,2,1046,551,495
50,12,59,Florida,Holmes County,10,3,1224,633,591
50,12,59,Florida,Holmes County,10,4,1228,675,553
50,12,59,Florida,Holmes County,10,5,1294,812,482
50,12,59,Florida,Holmes County,10,6,1339,854,485
50,12,59,Florida,Holmes County,10,7,1285,803,482
50,12,59,Florida,Holmes County,10,8,1340,777,563
50,12,59,Florida,Holmes County,10,9,1339,737,602
50,12,59,Florida,Holmes County,10,10,1338,693,645
50,12,59,Florida,Holmes County,10,11,1190,581,609
50,12,59,Florida,Holmes County,10,12,1192,616,576
50,12,59,Florida,Holmes County,10,13,1068,509,559
50,12,59,Florida,Holmes County,10,14,891,427,464
50,12,59,Florida,Holmes County,10,15,748,350,398
50,12,59,Florida,Holmes County,10,16,548,247,301
50,12,59,Florida,Holmes County,10,17,448,169,279
50,12,59,Florida,Holmes County,10,18,446,136,310
50,12,59,Florida,Holmes County,11,0,19170,10216,8954
50,12,59,Florida,Holmes County,11,1,1157,586,571
50,12,59,Florida,Holmes County,11,2,1105,575,530
50,12,59,Florida,Holmes County,11,3,1163,607,556
50,12,59,Florida,Holmes County,11,4,1203,657,546
50,12,59,Florida,Holmes County,11,5,1323,837,486
50,12,59,Florida,Holmes County,11,6,1387,885,502
50,12,59,Florida,Holmes County,11,7,1233,779,454
50,12,59,Florida,Holmes County,11,8,1409,841,568
50,12,59,Florida,Holmes County,11,9,1300,710,590
50,12,59,Florida,Holmes County,11,10,1307,668,639
50,12,59,Florida,Holmes County,11,11,1193,601,592
50,12,59,Florida,Holmes County,11,12,1160,575,585
50,12,59,Florida,Holmes County,11,13,1106,535,571
50,12,59,Florida,Holmes County,11,14,933,445,488
50,12,59,Florida,Holmes County,11,15,733,348,385
50,12,59,Florida,Holmes County,11,16,559,253,306
50,12,59,Florida,Holmes County,11,17,443,172,271
50,12,59,Florida,Holmes County,11,18,456,142,314
50,12,59,Florida,Holmes County,12,0,19099,10241,8858
50,12,59,Florida,Holmes County,12,1,1134,575,559
50,12,59,Florida,Holmes County,12,2,1126,581,545
50,12,59,Florida,Holmes County,12,3,1068,559,509
50,12,59,Florida,Holmes County,12,4,1232,683,549
50,12,59,Florida,Holmes County,12,5,1281,826,455
50,12,59,Florida,Holmes County,12,6,1435,908,527
50,12,59,Florida,Holmes County,12,7,1232,802,430
50,12,59,Florida,Holmes County,12,8,1411,850,561
50,12,59,Florida,Holmes County,12,9,1299,719,580
50,12,59,Florida,Holmes County,12,10,1268,646,622
50,12,59,Florida,Holmes County,12,11,1217,620,597
50,12,59,Florida,Holmes County,12,12,1141,555,586
50,12,59,Florida,Holmes County,12,13,1100,534,566
50,12,59,Florida,Holmes County,12,14,965,459,506
50,12,59,Florida,Holmes County,12,15,764,365,399
50,12,59,Florida,Holmes County,12,16,547,250,297
50,12,59,Florida,Holmes County,12,17,410,158,252
50,12,59,Florida,Holmes County,12,18,469,151,318
50,12,61,Florida,Indian River County,1,0,112947,54633,58314
50,12,61,Florida,Indian River County,1,1,5259,2716,2543
50,12,61,Florida,Indian River County,1,2,6020,3073,2947
50,12,61,Florida,Indian River County,1,3,6398,3276,3122
50,12,61,Florida,Indian River County,1,4,6354,3498,2856
50,12,61,Florida,Indian River County,1,5,4430,2372,2058
50,12,61,Florida,Indian River County,1,6,4799,2494,2305
50,12,61,Florida,Indian River County,1,7,5630,2804,2826
50,12,61,Florida,Indian River County,1,8,7033,3446,3587
50,12,61,Florida,Indian River County,1,9,7692,3699,3993
50,12,61,Florida,Indian River County,1,10,7015,3453,3562
50,12,61,Florida,Indian River County,1,11,6722,3150,3572
50,12,61,Florida,Indian River County,1,12,6169,2768,3401
50,12,61,Florida,Indian River County,1,13,6454,2964,3490
50,12,61,Florida,Indian River County,1,14,7783,3600,4183
50,12,61,Florida,Indian River County,1,15,8668,4003,4665
50,12,61,Florida,Indian River County,1,16,7843,3631,4212
50,12,61,Florida,Indian River County,1,17,5154,2341,2813
50,12,61,Florida,Indian River County,1,18,3524,1345,2179
50,12,61,Florida,Indian River County,2,0,112943,54631,58312
50,12,61,Florida,Indian River County,2,1,5259,2716,2543
50,12,61,Florida,Indian River County,2,2,6020,3073,2947
50,12,61,Florida,Indian River County,2,3,6398,3276,3122
50,12,61,Florida,Indian River County,2,4,6354,3498,2856
50,12,61,Florida,Indian River County,2,5,4430,2372,2058
50,12,61,Florida,Indian River County,2,6,4799,2494,2305
50,12,61,Florida,Indian River County,2,7,5630,2804,2826
50,12,61,Florida,Indian River County,2,8,7033,3446,3587
50,12,61,Florida,Indian River County,2,9,7692,3699,3993
50,12,61,Florida,Indian River County,2,10,7015,3453,3562
50,12,61,Florida,Indian River County,2,11,6722,3150,3572
50,12,61,Florida,Indian River County,2,12,6166,2767,3399
50,12,61,Florida,Indian River County,2,13,6453,2963,3490
50,12,61,Florida,Indian River County,2,14,7783,3600,4183
50,12,61,Florida,Indian River County,2,15,8668,4003,4665
50,12,61,Florida,Indian River County,2,16,7843,3631,4212
50,12,61,Florida,Indian River County,2,17,5154,2341,2813
50,12,61,Florida,Indian River County,2,18,3524,1345,2179
50,12,61,Florida,Indian River County,3,0,113387,54865,58522
50,12,61,Florida,Indian River County,3,1,5277,2724,2553
50,12,61,Florida,Indian River County,3,2,6014,3070,2944
50,12,61,Florida,Indian River County,3,3,6441,3298,3143
50,12,61,Florida,Indian River County,3,4,6383,3514,2869
50,12,61,Florida,Indian River County,3,5,4483,2402,2081
50,12,61,Florida,Indian River County,3,6,4788,2489,2299
50,12,61,Florida,Indian River County,3,7,5645,2814,2831
50,12,61,Florida,Indian River County,3,8,7027,3444,3583
50,12,61,Florida,Indian River County,3,9,7729,3716,4013
50,12,61,Florida,Indian River County,3,10,7073,3481,3592
50,12,61,Florida,Indian River County,3,11,6806,3189,3617
50,12,61,Florida,Indian River County,3,12,6222,2793,3429
50,12,61,Florida,Indian River County,3,13,6488,2980,3508
50,12,61,Florida,Indian River County,3,14,7753,3586,4167
50,12,61,Florida,Indian River County,3,15,8653,4003,4650
50,12,61,Florida,Indian River County,3,16,7855,3640,4215
50,12,61,Florida,Indian River County,3,17,5195,2363,2832
50,12,61,Florida,Indian River County,3,18,3555,1359,2196
50,12,61,Florida,Indian River County,4,0,115324,55862,59462
50,12,61,Florida,Indian River County,4,1,5477,2848,2629
50,12,61,Florida,Indian River County,4,2,5966,3053,2913
50,12,61,Florida,Indian River County,4,3,6600,3366,3234
50,12,61,Florida,Indian River County,4,4,6498,3569,2929
50,12,61,Florida,Indian River County,4,5,4760,2523,2237
50,12,61,Florida,Indian River County,4,6,4826,2546,2280
50,12,61,Florida,Indian River County,4,7,5607,2816,2791
50,12,61,Florida,Indian River County,4,8,6913,3368,3545
50,12,61,Florida,Indian River County,4,9,7907,3841,4066
50,12,61,Florida,Indian River County,4,10,7407,3612,3795
50,12,61,Florida,Indian River County,4,11,7219,3379,3840
50,12,61,Florida,Indian River County,4,12,6454,2938,3516
50,12,61,Florida,Indian River County,4,13,6603,2998,3605
50,12,61,Florida,Indian River County,4,14,7405,3467,3938
50,12,61,Florida,Indian River County,4,15,8574,3941,4633
50,12,61,Florida,Indian River County,4,16,7861,3644,4217
50,12,61,Florida,Indian River County,4,17,5455,2496,2959
50,12,61,Florida,Indian River County,4,18,3792,1457,2335
50,12,61,Florida,Indian River County,5,0,117807,57171,60636
50,12,61,Florida,Indian River County,5,1,5708,2971,2737
50,12,61,Florida,Indian River County,5,2,6001,3072,2929
50,12,61,Florida,Indian River County,5,3,6690,3421,3269
50,12,61,Florida,Indian River County,5,4,6694,3646,3048
50,12,61,Florida,Indian River County,5,5,5128,2727,2401
50,12,61,Florida,Indian River County,5,6,4895,2596,2299
50,12,61,Florida,Indian River County,5,7,5768,2955,2813
50,12,61,Florida,Indian River County,5,8,6646,3214,3432
50,12,61,Florida,Indian River County,5,9,8098,3966,4132
50,12,61,Florida,Indian River County,5,10,7725,3695,4030
50,12,61,Florida,Indian River County,5,11,7375,3525,3850
50,12,61,Florida,Indian River County,5,12,7076,3220,3856
50,12,61,Florida,Indian River County,5,13,6778,3066,3712
50,12,61,Florida,Indian River County,5,14,7229,3390,3839
50,12,61,Florida,Indian River County,5,15,8352,3835,4517
50,12,61,Florida,Indian River County,5,16,7986,3744,4242
50,12,61,Florida,Indian River County,5,17,5602,2532,3070
50,12,61,Florida,Indian River County,5,18,4056,1596,2460
50,12,61,Florida,Indian River County,6,0,119836,58313,61523
50,12,61,Florida,Indian River County,6,1,5858,3058,2800
50,12,61,Florida,Indian River County,6,2,6089,3117,2972
50,12,61,Florida,Indian River County,6,3,6762,3446,3316
50,12,61,Florida,Indian River County,6,4,6800,3713,3087
50,12,61,Florida,Indian River County,6,5,5336,2861,2475
50,12,61,Florida,Indian River County,6,6,5026,2706,2320
50,12,61,Florida,Indian River County,6,7,5787,2966,2821
50,12,61,Florida,Indian River County,6,8,6522,3220,3302
50,12,61,Florida,Indian River County,6,9,8041,3918,4123
50,12,61,Florida,Indian River County,6,10,8104,3865,4239
50,12,61,Florida,Indian River County,6,11,7547,3641,3906
50,12,61,Florida,Indian River County,6,12,7401,3382,4019
50,12,61,Florida,Indian River County,6,13,7194,3265,3929
50,12,61,Florida,Indian River County,6,14,7233,3362,3871
50,12,61,Florida,Indian River County,6,15,8077,3730,4347
50,12,61,Florida,Indian River County,6,16,7927,3741,4186
50,12,61,Florida,Indian River County,6,17,5797,2575,3222
50,12,61,Florida,Indian River County,6,18,4335,1747,2588
50,12,61,Florida,Indian River County,7,0,124105,60493,63612
50,12,61,Florida,Indian River County,7,1,6137,3205,2932
50,12,61,Florida,Indian River County,7,2,6346,3252,3094
50,12,61,Florida,Indian River County,7,3,6875,3519,3356
50,12,61,Florida,Indian River County,7,4,7057,3842,3215
50,12,61,Florida,Indian River County,7,5,5809,3103,2706
50,12,61,Florida,Indian River County,7,6,5175,2796,2379
50,12,61,Florida,Indian River County,7,7,5764,2955,2809
50,12,61,Florida,Indian River County,7,8,6710,3363,3347
50,12,61,Florida,Indian River County,7,9,8197,3998,4199
50,12,61,Florida,Indian River County,7,10,8516,4096,4420
50,12,61,Florida,Indian River County,7,11,7942,3821,4121
50,12,61,Florida,Indian River County,7,12,8008,3665,4343
50,12,61,Florida,Indian River County,7,13,7625,3503,4122
50,12,61,Florida,Indian River County,7,14,7319,3375,3944
50,12,61,Florida,Indian River County,7,15,8051,3741,4310
50,12,61,Florida,Indian River County,7,16,7956,3684,4272
50,12,61,Florida,Indian River County,7,17,6059,2698,3361
50,12,61,Florida,Indian River County,7,18,4559,1877,2682
50,12,61,Florida,Indian River County,8,0,126778,61908,64870
50,12,61,Florida,Indian River County,8,1,6474,3338,3136
50,12,61,Florida,Indian River County,8,2,6547,3370,3177
50,12,61,Florida,Indian River County,8,3,7010,3585,3425
50,12,61,Florida,Indian River County,8,4,7169,3893,3276
50,12,61,Florida,Indian River County,8,5,6042,3260,2782
50,12,61,Florida,Indian River County,8,6,5547,2980,2567
50,12,61,Florida,Indian River County,8,7,5782,2993,2789
50,12,61,Florida,Indian River County,8,8,6792,3406,3386
50,12,61,Florida,Indian River County,8,9,8206,4045,4161
50,12,61,Florida,Indian River County,8,10,8885,4258,4627
50,12,61,Florida,Indian River County,8,11,8218,3963,4255
50,12,61,Florida,Indian River County,8,12,8530,3956,4574
50,12,61,Florida,Indian River County,8,13,7924,3603,4321
50,12,61,Florida,Indian River County,8,14,7377,3434,3943
50,12,61,Florida,Indian River County,8,15,7660,3541,4119
50,12,61,Florida,Indian River County,8,16,7702,3530,4172
50,12,61,Florida,Indian River County,8,17,6277,2851,3426
50,12,61,Florida,Indian River County,8,18,4636,1902,2734
50,12,61,Florida,Indian River County,9,0,129980,63570,66410
50,12,61,Florida,Indian River County,9,1,6871,3517,3354
50,12,61,Florida,Indian River County,9,2,6712,3476,3236
50,12,61,Florida,Indian River County,9,3,6994,3583,3411
50,12,61,Florida,Indian River County,9,4,7453,4033,3420
50,12,61,Florida,Indian River County,9,5,6484,3479,3005
50,12,61,Florida,Indian River County,9,6,5894,3141,2753
50,12,61,Florida,Indian River County,9,7,5866,3085,2781
50,12,61,Florida,Indian River County,9,8,6854,3470,3384
50,12,61,Florida,Indian River County,9,9,8123,3997,4126
50,12,61,Florida,Indian River County,9,10,9205,4467,4738
50,12,61,Florida,Indian River County,9,11,8491,4082,4409
50,12,61,Florida,Indian River County,9,12,9041,4190,4851
50,12,61,Florida,Indian River County,9,13,8141,3742,4399
50,12,61,Florida,Indian River County,9,14,7466,3430,4036
50,12,61,Florida,Indian River County,9,15,7332,3440,3892
50,12,61,Florida,Indian River County,9,16,7749,3516,4233
50,12,61,Florida,Indian River County,9,17,6297,2874,3423
50,12,61,Florida,Indian River County,9,18,5007,2048,2959
50,12,61,Florida,Indian River County,10,0,132837,65055,67782
50,12,61,Florida,Indian River County,10,1,7079,3603,3476
50,12,61,Florida,Indian River County,10,2,6934,3590,3344
50,12,61,Florida,Indian River County,10,3,7224,3708,3516
50,12,61,Florida,Indian River County,10,4,7476,4051,3425
50,12,61,Florida,Indian River County,10,5,6724,3573,3151
50,12,61,Florida,Indian River County,10,6,6260,3358,2902
50,12,61,Florida,Indian River County,10,7,5894,3117,2777
50,12,61,Florida,Indian River County,10,8,7046,3633,3413
50,12,61,Florida,Indian River County,10,9,7906,3864,4042
50,12,61,Florida,Indian River County,10,10,9312,4550,4762
50,12,61,Florida,Indian River County,10,11,8822,4181,4641
50,12,61,Florida,Indian River County,10,12,8978,4240,4738
50,12,61,Florida,Indian River County,10,13,8736,4003,4733
50,12,61,Florida,Indian River County,10,14,7837,3592,4245
50,12,61,Florida,Indian River County,10,15,7176,3353,3823
50,12,61,Florida,Indian River County,10,16,7644,3462,4182
50,12,61,Florida,Indian River County,10,17,6460,2997,3463
50,12,61,Florida,Indian River County,10,18,5329,2180,3149
50,12,61,Florida,Indian River County,11,0,134293,65766,68527
50,12,61,Florida,Indian River County,11,1,7118,3600,3518
50,12,61,Florida,Indian River County,11,2,6958,3613,3345
50,12,61,Florida,Indian River County,11,3,7301,3745,3556
50,12,61,Florida,Indian River County,11,4,7546,4074,3472
50,12,61,Florida,Indian River County,11,5,6565,3484,3081
50,12,61,Florida,Indian River County,11,6,6579,3519,3060
50,12,61,Florida,Indian River County,11,7,5880,3141,2739
50,12,61,Florida,Indian River County,11,8,6957,3579,3378
50,12,61,Florida,Indian River County,11,9,7693,3819,3874
50,12,61,Florida,Indian River County,11,10,9245,4497,4748
50,12,61,Florida,Indian River County,11,11,9127,4314,4813
50,12,61,Florida,Indian River County,11,12,8941,4247,4694
50,12,61,Florida,Indian River County,11,13,9015,4127,4888
50,12,61,Florida,Indian River County,11,14,8285,3805,4480
50,12,61,Florida,Indian River County,11,15,7298,3383,3915
50,12,61,Florida,Indian River County,11,16,7511,3422,4089
50,12,61,Florida,Indian River County,11,17,6491,3023,3468
50,12,61,Florida,Indian River County,11,18,5783,2374,3409
50,12,61,Florida,Indian River County,12,0,135167,66224,68943
50,12,61,Florida,Indian River County,12,1,7212,3639,3573
50,12,61,Florida,Indian River County,12,2,6968,3624,3344
50,12,61,Florida,Indian River County,12,3,7261,3731,3530
50,12,61,Florida,Indian River County,12,4,7473,4051,3422
50,12,61,Florida,Indian River County,12,5,6563,3488,3075
50,12,61,Florida,Indian River County,12,6,6712,3587,3125
50,12,61,Florida,Indian River County,12,7,5824,3119,2705
50,12,61,Florida,Indian River County,12,8,6688,3444,3244
50,12,61,Florida,Indian River County,12,9,7706,3875,3831
50,12,61,Florida,Indian River County,12,10,9025,4388,4637
50,12,61,Florida,Indian River County,12,11,9282,4419,4863
50,12,61,Florida,Indian River County,12,12,9035,4275,4760
50,12,61,Florida,Indian River County,12,13,9274,4239,5035
50,12,61,Florida,Indian River County,12,14,8742,4039,4703
50,12,61,Florida,Indian River County,12,15,7434,3413,4021
50,12,61,Florida,Indian River County,12,16,7412,3415,3997
50,12,61,Florida,Indian River County,12,17,6472,2953,3519
50,12,61,Florida,Indian River County,12,18,6084,2525,3559
50,12,63,Florida,Jackson County,1,0,46755,24533,22222
50,12,63,Florida,Jackson County,1,1,2558,1281,1277
50,12,63,Florida,Jackson County,1,2,2852,1434,1418
50,12,63,Florida,Jackson County,1,3,2909,1514,1395
50,12,63,Florida,Jackson County,1,4,3533,1943,1590
50,12,63,Florida,Jackson County,1,5,3129,1858,1271
50,12,63,Florida,Jackson County,1,6,3198,1903,1295
50,12,63,Florida,Jackson County,1,7,3279,1904,1375
50,12,63,Florida,Jackson County,1,8,3742,2162,1580
50,12,63,Florida,Jackson County,1,9,3601,1991,1610
50,12,63,Florida,Jackson County,1,10,3458,1880,1578
50,12,63,Florida,Jackson County,1,11,3012,1589,1423
50,12,63,Florida,Jackson County,1,12,2560,1215,1345
50,12,63,Florida,Jackson County,1,13,2120,1077,1043
50,12,63,Florida,Jackson County,1,14,1935,909,1026
50,12,63,Florida,Jackson County,1,15,1684,746,938
50,12,63,Florida,Jackson County,1,16,1334,537,797
50,12,63,Florida,Jackson County,1,17,965,335,630
50,12,63,Florida,Jackson County,1,18,886,255,631
50,12,63,Florida,Jackson County,2,0,46754,24532,22222
50,12,63,Florida,Jackson County,2,1,2558,1281,1277
50,12,63,Florida,Jackson County,2,2,2852,1434,1418
50,12,63,Florida,Jackson County,2,3,2909,1514,1395
50,12,63,Florida,Jackson County,2,4,3533,1943,1590
50,12,63,Florida,Jackson County,2,5,3129,1858,1271
50,12,63,Florida,Jackson County,2,6,3198,1903,1295
50,12,63,Florida,Jackson County,2,7,3279,1904,1375
50,12,63,Florida,Jackson County,2,8,3742,2162,1580
50,12,63,Florida,Jackson County,2,9,3601,1991,1610
50,12,63,Florida,Jackson County,2,10,3458,1880,1578
50,12,63,Florida,Jackson County,2,11,3011,1588,1423
50,12,63,Florida,Jackson County,2,12,2560,1215,1345
50,12,63,Florida,Jackson County,2,13,2120,1077,1043
50,12,63,Florida,Jackson County,2,14,1935,909,1026
50,12,63,Florida,Jackson County,2,15,1684,746,938
50,12,63,Florida,Jackson County,2,16,1334,537,797
50,12,63,Florida,Jackson County,2,17,965,335,630
50,12,63,Florida,Jackson County,2,18,886,255,631
50,12,63,Florida,Jackson County,3,0,46754,24536,22218
50,12,63,Florida,Jackson County,3,1,2551,1278,1273
50,12,63,Florida,Jackson County,3,2,2832,1424,1408
50,12,63,Florida,Jackson County,3,3,2915,1517,1398
50,12,63,Florida,Jackson County,3,4,3532,1944,1588
50,12,63,Florida,Jackson County,3,5,3148,1868,1280
50,12,63,Florida,Jackson County,3,6,3178,1894,1284
50,12,63,Florida,Jackson County,3,7,3272,1900,1372
50,12,63,Florida,Jackson County,3,8,3726,2154,1572
50,12,63,Florida,Jackson County,3,9,3602,1991,1611
50,12,63,Florida,Jackson County,3,10,3469,1885,1584
50,12,63,Florida,Jackson County,3,11,3034,1599,1435
50,12,63,Florida,Jackson County,3,12,2563,1217,1346
50,12,63,Florida,Jackson County,3,13,2123,1079,1044
50,12,63,Florida,Jackson County,3,14,1928,906,1022
50,12,63,Florida,Jackson County,3,15,1680,746,934
50,12,63,Florida,Jackson County,3,16,1336,538,798
50,12,63,Florida,Jackson County,3,17,974,339,635
50,12,63,Florida,Jackson County,3,18,891,257,634
50,12,63,Florida,Jackson County,4,0,46431,24317,22114
50,12,63,Florida,Jackson County,4,1,2572,1301,1271
50,12,63,Florida,Jackson County,4,2,2681,1352,1329
50,12,63,Florida,Jackson County,4,3,2950,1519,1431
50,12,63,Florida,Jackson County,4,4,3292,1827,1465
50,12,63,Florida,Jackson County,4,5,3250,1923,1327
50,12,63,Florida,Jackson County,4,6,3098,1838,1260
50,12,63,Florida,Jackson County,4,7,3210,1865,1345
50,12,63,Florida,Jackson County,4,8,3497,2016,1481
50,12,63,Florida,Jackson County,4,9,3667,2012,1655
50,12,63,Florida,Jackson County,4,10,3427,1856,1571
50,12,63,Florida,Jackson County,4,11,3110,1627,1483
50,12,63,Florida,Jackson County,4,12,2634,1270,1364
50,12,63,Florida,Jackson County,4,13,2155,1073,1082
50,12,63,Florida,Jackson County,4,14,1949,912,1037
50,12,63,Florida,Jackson County,4,15,1662,762,900
50,12,63,Florida,Jackson County,4,16,1358,548,810
50,12,63,Florida,Jackson County,4,17,1018,353,665
50,12,63,Florida,Jackson County,4,18,901,263,638
50,12,63,Florida,Jackson County,5,0,46441,24288,22153
50,12,63,Florida,Jackson County,5,1,2683,1350,1333
50,12,63,Florida,Jackson County,5,2,2482,1242,1240
50,12,63,Florida,Jackson County,5,3,2967,1520,1447
50,12,63,Florida,Jackson County,5,4,3192,1787,1405
50,12,63,Florida,Jackson County,5,5,3299,1931,1368
50,12,63,Florida,Jackson County,5,6,3159,1879,1280
50,12,63,Florida,Jackson County,5,7,3190,1843,1347
50,12,63,Florida,Jackson County,5,8,3319,1906,1413
50,12,63,Florida,Jackson County,5,9,3664,2047,1617
50,12,63,Florida,Jackson County,5,10,3466,1864,1602
50,12,63,Florida,Jackson County,5,11,3103,1617,1486
50,12,63,Florida,Jackson County,5,12,2778,1328,1450
50,12,63,Florida,Jackson County,5,13,2227,1098,1129
50,12,63,Florida,Jackson County,5,14,1924,924,1000
50,12,63,Florida,Jackson County,5,15,1666,728,938
50,12,63,Florida,Jackson County,5,16,1399,597,802
50,12,63,Florida,Jackson County,5,17,1011,368,643
50,12,63,Florida,Jackson County,5,18,912,259,653
50,12,63,Florida,Jackson County,6,0,46688,24613,22075
50,12,63,Florida,Jackson County,6,1,2633,1310,1323
50,12,63,Florida,Jackson County,6,2,2440,1225,1215
50,12,63,Florida,Jackson County,6,3,2912,1490,1422
50,12,63,Florida,Jackson County,6,4,3114,1743,1371
50,12,63,Florida,Jackson County,6,5,3418,2060,1358
50,12,63,Florida,Jackson County,6,6,3143,1906,1237
50,12,63,Florida,Jackson County,6,7,3196,1882,1314
50,12,63,Florida,Jackson County,6,8,3303,1924,1379
50,12,63,Florida,Jackson County,6,9,3672,2063,1609
50,12,63,Florida,Jackson County,6,10,3486,1884,1602
50,12,63,Florida,Jackson County,6,11,3200,1696,1504
50,12,63,Florida,Jackson County,6,12,2856,1383,1473
50,12,63,Florida,Jackson County,6,13,2307,1101,1206
50,12,63,Florida,Jackson County,6,14,1924,946,978
50,12,63,Florida,Jackson County,6,15,1716,736,980
50,12,63,Florida,Jackson County,6,16,1356,582,774
50,12,63,Florida,Jackson County,6,17,1098,421,677
50,12,63,Florida,Jackson County,6,18,914,261,653
50,12,63,Florida,Jackson County,7,0,47424,25080,22344
50,12,63,Florida,Jackson County,7,1,2679,1318,1361
50,12,63,Florida,Jackson County,7,2,2474,1241,1233
50,12,63,Florida,Jackson County,7,3,2906,1487,1419
50,12,63,Florida,Jackson County,7,4,3101,1736,1365
50,12,63,Florida,Jackson County,7,5,3582,2164,1418
50,12,63,Florida,Jackson County,7,6,3209,1965,1244
50,12,63,Florida,Jackson County,7,7,3174,1918,1256
50,12,63,Florida,Jackson County,7,8,3327,1954,1373
50,12,63,Florida,Jackson County,7,9,3714,2082,1632
50,12,63,Florida,Jackson County,7,10,3530,1930,1600
50,12,63,Florida,Jackson County,7,11,3243,1679,1564
50,12,63,Florida,Jackson County,7,12,2919,1446,1473
50,12,63,Florida,Jackson County,7,13,2437,1151,1286
50,12,63,Florida,Jackson County,7,14,1944,955,989
50,12,63,Florida,Jackson County,7,15,1767,790,977
50,12,63,Florida,Jackson County,7,16,1372,579,793
50,12,63,Florida,Jackson County,7,17,1072,407,665
50,12,63,Florida,Jackson County,7,18,974,278,696
50,12,63,Florida,Jackson County,8,0,48460,25642,22818
50,12,63,Florida,Jackson County,8,1,2838,1414,1424
50,12,63,Florida,Jackson County,8,2,2558,1283,1275
50,12,63,Florida,Jackson County,8,3,2907,1466,1441
50,12,63,Florida,Jackson County,8,4,3103,1766,1337
50,12,63,Florida,Jackson County,8,5,3587,2140,1447
50,12,63,Florida,Jackson County,8,6,3470,2122,1348
50,12,63,Florida,Jackson County,8,7,3250,1966,1284
50,12,63,Florida,Jackson County,8,8,3350,1981,1369
50,12,63,Florida,Jackson County,8,9,3650,2062,1588
50,12,63,Florida,Jackson County,8,10,3597,1955,1642
50,12,63,Florida,Jackson County,8,11,3405,1752,1653
50,12,63,Florida,Jackson County,8,12,2954,1494,1460
50,12,63,Florida,Jackson County,8,13,2526,1175,1351
50,12,63,Florida,Jackson County,8,14,2003,986,1017
50,12,63,Florida,Jackson County,8,15,1795,810,985
50,12,63,Florida,Jackson County,8,16,1382,576,806
50,12,63,Florida,Jackson County,8,17,1063,402,661
50,12,63,Florida,Jackson County,8,18,1022,292,730
50,12,63,Florida,Jackson County,9,0,48832,25856,22976
50,12,63,Florida,Jackson County,9,1,2844,1417,1427
50,12,63,Florida,Jackson County,9,2,2616,1323,1293
50,12,63,Florida,Jackson County,9,3,2784,1405,1379
50,12,63,Florida,Jackson County,9,4,3269,1837,1432
50,12,63,Florida,Jackson County,9,5,3471,2090,1381
50,12,63,Florida,Jackson County,9,6,3555,2178,1377
50,12,63,Florida,Jackson County,9,7,3233,1952,1281
50,12,63,Florida,Jackson County,9,8,3363,2002,1361
50,12,63,Florida,Jackson County,9,9,3550,2003,1547
50,12,63,Florida,Jackson County,9,10,3633,1971,1662
50,12,63,Florida,Jackson County,9,11,3417,1759,1658
50,12,63,Florida,Jackson County,9,12,3047,1524,1523
50,12,63,Florida,Jackson County,9,13,2622,1245,1377
50,12,63,Florida,Jackson County,9,14,2071,998,1073
50,12,63,Florida,Jackson County,9,15,1808,811,997
50,12,63,Florida,Jackson County,9,16,1388,614,774
50,12,63,Florida,Jackson County,9,17,1110,422,688
50,12,63,Florida,Jackson County,9,18,1051,305,746
50,12,63,Florida,Jackson County,10,0,48955,25843,23112
50,12,63,Florida,Jackson County,10,1,2854,1429,1425
50,12,63,Florida,Jackson County,10,2,2742,1379,1363
50,12,63,Florida,Jackson County,10,3,2652,1329,1323
50,12,63,Florida,Jackson County,10,4,3264,1818,1446
50,12,63,Florida,Jackson County,10,5,3439,2079,1360
50,12,63,Florida,Jackson County,10,6,3612,2190,1422
50,12,63,Florida,Jackson County,10,7,3273,1976,1297
50,12,63,Florida,Jackson County,10,8,3327,1969,1358
50,12,63,Florida,Jackson County,10,9,3376,1893,1483
50,12,63,Florida,Jackson County,10,10,3632,2002,1630
50,12,63,Florida,Jackson County,10,11,3406,1744,1662
50,12,63,Florida,Jackson County,10,12,3033,1523,1510
50,12,63,Florida,Jackson County,10,13,2769,1296,1473
50,12,63,Florida,Jackson County,10,14,2118,1006,1112
50,12,63,Florida,Jackson County,10,15,1792,824,968
50,12,63,Florida,Jackson County,10,16,1417,578,839
50,12,63,Florida,Jackson County,10,17,1172,489,683
50,12,63,Florida,Jackson County,10,18,1077,319,758
50,12,63,Florida,Jackson County,11,0,50915,27614,23301
50,12,63,Florida,Jackson County,11,1,2901,1472,1429
50,12,63,Florida,Jackson County,11,2,2769,1378,1391
50,12,63,Florida,Jackson County,11,3,2607,1310,1297
50,12,63,Florida,Jackson County,11,4,3288,1852,1436
50,12,63,Florida,Jackson County,11,5,3587,2264,1323
50,12,63,Florida,Jackson County,11,6,4078,2587,1491
50,12,63,Florida,Jackson County,11,7,3549,2245,1304
50,12,63,Florida,Jackson County,11,8,3585,2238,1347
50,12,63,Florida,Jackson County,11,9,3556,2075,1481
50,12,63,Florida,Jackson County,11,10,3744,2118,1626
50,12,63,Florida,Jackson County,11,11,3441,1787,1654
50,12,63,Florida,Jackson County,11,12,3137,1605,1532
50,12,63,Florida,Jackson County,11,13,2850,1356,1494
50,12,63,Florida,Jackson County,11,14,2221,1031,1190
50,12,63,Florida,Jackson County,11,15,1820,860,960
50,12,63,Florida,Jackson County,11,16,1491,593,898
50,12,63,Florida,Jackson County,11,17,1118,462,656
50,12,63,Florida,Jackson County,11,18,1173,381,792
50,12,63,Florida,Jackson County,12,0,50930,27578,23352
50,12,63,Florida,Jackson County,12,1,2910,1490,1420
50,12,63,Florida,Jackson County,12,2,2841,1403,1438
50,12,63,Florida,Jackson County,12,3,2646,1326,1320
50,12,63,Florida,Jackson County,12,4,3158,1754,1404
50,12,63,Florida,Jackson County,12,5,3588,2252,1336
50,12,63,Florida,Jackson County,12,6,4096,2600,1496
50,12,63,Florida,Jackson County,12,7,3520,2231,1289
50,12,63,Florida,Jackson County,12,8,3511,2227,1284
50,12,63,Florida,Jackson County,12,9,3497,2046,1451
50,12,63,Florida,Jackson County,12,10,3751,2106,1645
50,12,63,Florida,Jackson County,12,11,3452,1810,1642
50,12,63,Florida,Jackson County,12,12,3096,1545,1551
50,12,63,Florida,Jackson County,12,13,2850,1380,1470
50,12,63,Florida,Jackson County,12,14,2350,1080,1270
50,12,63,Florida,Jackson County,12,15,1811,851,960
50,12,63,Florida,Jackson County,12,16,1537,657,880
50,12,63,Florida,Jackson County,12,17,1138,448,690
50,12,63,Florida,Jackson County,12,18,1178,372,806
50,12,65,Florida,Jefferson County,1,0,12902,6581,6321
50,12,65,Florida,Jefferson County,1,1,682,357,325
50,12,65,Florida,Jefferson County,1,2,805,390,415
50,12,65,Florida,Jefferson County,1,3,874,429,445
50,12,65,Florida,Jefferson County,1,4,892,487,405
50,12,65,Florida,Jefferson County,1,5,735,406,329
50,12,65,Florida,Jefferson County,1,6,756,411,345
50,12,65,Florida,Jefferson County,1,7,847,458,389
50,12,65,Florida,Jefferson County,1,8,988,550,438
50,12,65,Florida,Jefferson County,1,9,1142,603,539
50,12,65,Florida,Jefferson County,1,10,1019,536,483
50,12,65,Florida,Jefferson County,1,11,998,507,491
50,12,65,Florida,Jefferson County,1,12,750,386,364
50,12,65,Florida,Jefferson County,1,13,549,265,284
50,12,65,Florida,Jefferson County,1,14,519,239,280
50,12,65,Florida,Jefferson County,1,15,477,223,254
50,12,65,Florida,Jefferson County,1,16,395,172,223
50,12,65,Florida,Jefferson County,1,17,245,89,156
50,12,65,Florida,Jefferson County,1,18,229,73,156
50,12,65,Florida,Jefferson County,2,0,12902,6581,6321
50,12,65,Florida,Jefferson County,2,1,682,357,325
50,12,65,Florida,Jefferson County,2,2,805,390,415
50,12,65,Florida,Jefferson County,2,3,874,429,445
50,12,65,Florida,Jefferson County,2,4,892,487,405
50,12,65,Florida,Jefferson County,2,5,735,406,329
50,12,65,Florida,Jefferson County,2,6,756,411,345
50,12,65,Florida,Jefferson County,2,7,847,458,389
50,12,65,Florida,Jefferson County,2,8,988,550,438
50,12,65,Florida,Jefferson County,2,9,1142,603,539
50,12,65,Florida,Jefferson County,2,10,1019,536,483
50,12,65,Florida,Jefferson County,2,11,998,507,491
50,12,65,Florida,Jefferson County,2,12,750,386,364
50,12,65,Florida,Jefferson County,2,13,549,265,284
50,12,65,Florida,Jefferson County,2,14,519,239,280
50,12,65,Florida,Jefferson County,2,15,477,223,254
50,12,65,Florida,Jefferson County,2,16,395,172,223
50,12,65,Florida,Jefferson County,2,17,245,89,156
50,12,65,Florida,Jefferson County,2,18,229,73,156
50,12,65,Florida,Jefferson County,3,0,12906,6587,6319
50,12,65,Florida,Jefferson County,3,1,682,357,325
50,12,65,Florida,Jefferson County,3,2,803,389,414
50,12,65,Florida,Jefferson County,3,3,876,430,446
50,12,65,Florida,Jefferson County,3,4,892,487,405
50,12,65,Florida,Jefferson County,3,5,739,410,329
50,12,65,Florida,Jefferson County,3,6,750,409,341
50,12,65,Florida,Jefferson County,3,7,844,457,387
50,12,65,Florida,Jefferson County,3,8,983,547,436
50,12,65,Florida,Jefferson County,3,9,1142,603,539
50,12,65,Florida,Jefferson County,3,10,1025,539,486
50,12,65,Florida,Jefferson County,3,11,1004,509,495
50,12,65,Florida,Jefferson County,3,12,751,387,364
50,12,65,Florida,Jefferson County,3,13,549,265,284
50,12,65,Florida,Jefferson County,3,14,520,241,279
50,12,65,Florida,Jefferson County,3,15,477,223,254
50,12,65,Florida,Jefferson County,3,16,395,172,223
50,12,65,Florida,Jefferson County,3,17,245,89,156
50,12,65,Florida,Jefferson County,3,18,229,73,156
50,12,65,Florida,Jefferson County,4,0,12835,6549,6286
50,12,65,Florida,Jefferson County,4,1,686,352,334
50,12,65,Florida,Jefferson County,4,2,754,383,371
50,12,65,Florida,Jefferson County,4,3,859,408,451
50,12,65,Florida,Jefferson County,4,4,873,482,391
50,12,65,Florida,Jefferson County,4,5,707,401,306
50,12,65,Florida,Jefferson County,4,6,725,391,334
50,12,65,Florida,Jefferson County,4,7,865,466,399
50,12,65,Florida,Jefferson County,4,8,933,528,405
50,12,65,Florida,Jefferson County,4,9,1132,612,520
50,12,65,Florida,Jefferson County,4,10,1049,545,504
50,12,65,Florida,Jefferson County,4,11,995,498,497
50,12,65,Florida,Jefferson County,4,12,807,404,403
50,12,65,Florida,Jefferson County,4,13,600,299,301
50,12,65,Florida,Jefferson County,4,14,497,237,260
50,12,65,Florida,Jefferson County,4,15,493,218,275
50,12,65,Florida,Jefferson County,4,16,387,166,221
50,12,65,Florida,Jefferson County,4,17,261,93,168
50,12,65,Florida,Jefferson County,4,18,212,66,146
50,12,65,Florida,Jefferson County,5,0,13200,6725,6475
50,12,65,Florida,Jefferson County,5,1,756,377,379
50,12,65,Florida,Jefferson County,5,2,760,388,372
50,12,65,Florida,Jefferson County,5,3,881,432,449
50,12,65,Florida,Jefferson County,5,4,882,474,408
50,12,65,Florida,Jefferson County,5,5,746,406,340
50,12,65,Florida,Jefferson County,5,6,747,429,318
50,12,65,Florida,Jefferson County,5,7,867,463,404
50,12,65,Florida,Jefferson County,5,8,944,527,417
50,12,65,Florida,Jefferson County,5,9,1091,590,501
50,12,65,Florida,Jefferson County,5,10,1118,578,540
50,12,65,Florida,Jefferson County,5,11,978,498,480
50,12,65,Florida,Jefferson County,5,12,910,448,462
50,12,65,Florida,Jefferson County,5,13,625,317,308
50,12,65,Florida,Jefferson County,5,14,492,229,263
50,12,65,Florida,Jefferson County,5,15,506,230,276
50,12,65,Florida,Jefferson County,5,16,389,156,233
50,12,65,Florida,Jefferson County,5,17,283,117,166
50,12,65,Florida,Jefferson County,5,18,225,66,159
50,12,65,Florida,Jefferson County,6,0,13405,6882,6523
50,12,65,Florida,Jefferson County,6,1,758,378,380
50,12,65,Florida,Jefferson County,6,2,724,375,349
50,12,65,Florida,Jefferson County,6,3,891,442,449
50,12,65,Florida,Jefferson County,6,4,837,439,398
50,12,65,Florida,Jefferson County,6,5,787,442,345
50,12,65,Florida,Jefferson County,6,6,722,431,291
50,12,65,Florida,Jefferson County,6,7,855,463,392
50,12,65,Florida,Jefferson County,6,8,933,519,414
50,12,65,Florida,Jefferson County,6,9,1136,630,506
50,12,65,Florida,Jefferson County,6,10,1129,601,528
50,12,65,Florida,Jefferson County,6,11,1043,523,520
50,12,65,Florida,Jefferson County,6,12,968,468,500
50,12,65,Florida,Jefferson County,6,13,676,351,325
50,12,65,Florida,Jefferson County,6,14,494,225,269
50,12,65,Florida,Jefferson County,6,15,510,232,278
50,12,65,Florida,Jefferson County,6,16,410,171,239
50,12,65,Florida,Jefferson County,6,17,286,122,164
50,12,65,Florida,Jefferson County,6,18,246,70,176
50,12,65,Florida,Jefferson County,7,0,13723,7196,6527
50,12,65,Florida,Jefferson County,7,1,837,411,426
50,12,65,Florida,Jefferson County,7,2,656,344,312
50,12,65,Florida,Jefferson County,7,3,817,411,406
50,12,65,Florida,Jefferson County,7,4,847,425,422
50,12,65,Florida,Jefferson County,7,5,812,484,328
50,12,65,Florida,Jefferson County,7,6,759,476,283
50,12,65,Florida,Jefferson County,7,7,929,542,387
50,12,65,Florida,Jefferson County,7,8,942,546,396
50,12,65,Florida,Jefferson County,7,9,1197,688,509
50,12,65,Florida,Jefferson County,7,10,1146,613,533
50,12,65,Florida,Jefferson County,7,11,1080,555,525
50,12,65,Florida,Jefferson County,7,12,996,480,516
50,12,65,Florida,Jefferson County,7,13,731,376,355
50,12,65,Florida,Jefferson County,7,14,503,243,260
50,12,65,Florida,Jefferson County,7,15,493,212,281
50,12,65,Florida,Jefferson County,7,16,425,194,231
50,12,65,Florida,Jefferson County,7,17,308,121,187
50,12,65,Florida,Jefferson County,7,18,245,75,170
50,12,65,Florida,Jefferson County,8,0,13831,7233,6598
50,12,65,Florida,Jefferson County,8,1,798,399,399
50,12,65,Florida,Jefferson County,8,2,682,356,326
50,12,65,Florida,Jefferson County,8,3,775,376,399
50,12,65,Florida,Jefferson County,8,4,851,428,423
50,12,65,Florida,Jefferson County,8,5,815,479,336
50,12,65,Florida,Jefferson County,8,6,803,510,293
50,12,65,Florida,Jefferson County,8,7,884,519,365
50,12,65,Florida,Jefferson County,8,8,909,527,382
50,12,65,Florida,Jefferson County,8,9,1144,674,470
50,12,65,Florida,Jefferson County,8,10,1192,626,566
50,12,65,Florida,Jefferson County,8,11,1069,535,534
50,12,65,Florida,Jefferson County,8,12,1057,525,532
50,12,65,Florida,Jefferson County,8,13,831,422,409
50,12,65,Florida,Jefferson County,8,14,551,257,294
50,12,65,Florida,Jefferson County,8,15,465,202,263
50,12,65,Florida,Jefferson County,8,16,412,179,233
50,12,65,Florida,Jefferson County,8,17,333,137,196
50,12,65,Florida,Jefferson County,8,18,260,82,178
50,12,65,Florida,Jefferson County,9,0,13988,7321,6667
50,12,65,Florida,Jefferson County,9,1,782,396,386
50,12,65,Florida,Jefferson County,9,2,710,363,347
50,12,65,Florida,Jefferson County,9,3,729,372,357
50,12,65,Florida,Jefferson County,9,4,878,430,448
50,12,65,Florida,Jefferson County,9,5,799,480,319
50,12,65,Florida,Jefferson County,9,6,801,512,289
50,12,65,Florida,Jefferson County,9,7,877,512,365
50,12,65,Florida,Jefferson County,9,8,921,532,389
50,12,65,Florida,Jefferson County,9,9,1111,656,455
50,12,65,Florida,Jefferson County,9,10,1241,660,581
50,12,65,Florida,Jefferson County,9,11,1092,537,555
50,12,65,Florida,Jefferson County,9,12,1065,523,542
50,12,65,Florida,Jefferson County,9,13,898,451,447
50,12,65,Florida,Jefferson County,9,14,569,276,293
50,12,65,Florida,Jefferson County,9,15,466,208,258
50,12,65,Florida,Jefferson County,9,16,435,180,255
50,12,65,Florida,Jefferson County,9,17,334,134,200
50,12,65,Florida,Jefferson County,9,18,280,99,181
50,12,65,Florida,Jefferson County,10,0,13854,7252,6602
50,12,65,Florida,Jefferson County,10,1,762,388,374
50,12,65,Florida,Jefferson County,10,2,704,349,355
50,12,65,Florida,Jefferson County,10,3,657,336,321
50,12,65,Florida,Jefferson County,10,4,852,430,422
50,12,65,Florida,Jefferson County,10,5,772,460,312
50,12,65,Florida,Jefferson County,10,6,817,506,311
50,12,65,Florida,Jefferson County,10,7,818,510,308
50,12,65,Florida,Jefferson County,10,8,886,509,377
50,12,65,Florida,Jefferson County,10,9,1081,633,448
50,12,65,Florida,Jefferson County,10,10,1205,635,570
50,12,65,Florida,Jefferson County,10,11,1148,567,581
50,12,65,Florida,Jefferson County,10,12,1074,537,537
50,12,65,Florida,Jefferson County,10,13,968,476,492
50,12,65,Florida,Jefferson County,10,14,594,292,302
50,12,65,Florida,Jefferson County,10,15,476,210,266
50,12,65,Florida,Jefferson County,10,16,430,181,249
50,12,65,Florida,Jefferson County,10,17,315,120,195
50,12,65,Florida,Jefferson County,10,18,295,113,182
50,12,65,Florida,Jefferson County,11,0,13982,7312,6670
50,12,65,Florida,Jefferson County,11,1,786,401,385
50,12,65,Florida,Jefferson County,11,2,759,377,382
50,12,65,Florida,Jefferson County,11,3,664,346,318
50,12,65,Florida,Jefferson County,11,4,790,401,389
50,12,65,Florida,Jefferson County,11,5,736,431,305
50,12,65,Florida,Jefferson County,11,6,863,536,327
50,12,65,Florida,Jefferson County,11,7,794,500,294
50,12,65,Florida,Jefferson County,11,8,891,507,384
50,12,65,Florida,Jefferson County,11,9,1011,586,425
50,12,65,Florida,Jefferson County,11,10,1208,645,563
50,12,65,Florida,Jefferson County,11,11,1163,587,576
50,12,65,Florida,Jefferson County,11,12,1125,550,575
50,12,65,Florida,Jefferson County,11,13,1011,491,520
50,12,65,Florida,Jefferson County,11,14,646,320,326
50,12,65,Florida,Jefferson County,11,15,456,201,255
50,12,65,Florida,Jefferson County,11,16,434,183,251
50,12,65,Florida,Jefferson County,11,17,330,132,198
50,12,65,Florida,Jefferson County,11,18,315,118,197
50,12,65,Florida,Jefferson County,12,0,14010,7344,6666
50,12,65,Florida,Jefferson County,12,1,807,419,388
50,12,65,Florida,Jefferson County,12,2,775,376,399
50,12,65,Florida,Jefferson County,12,3,644,340,304
50,12,65,Florida,Jefferson County,12,4,729,377,352
50,12,65,Florida,Jefferson County,12,5,787,435,352
50,12,65,Florida,Jefferson County,12,6,828,540,288
50,12,65,Florida,Jefferson County,12,7,775,495,280
50,12,65,Florida,Jefferson County,12,8,920,536,384
50,12,65,Florida,Jefferson County,12,9,979,569,410
50,12,65,Florida,Jefferson County,12,10,1225,659,566
50,12,65,Florida,Jefferson County,12,11,1128,560,568
50,12,65,Florida,Jefferson County,12,12,1129,553,576
50,12,65,Florida,Jefferson County,12,13,1041,502,539
50,12,65,Florida,Jefferson County,12,14,711,350,361
50,12,65,Florida,Jefferson County,12,15,463,216,247
50,12,65,Florida,Jefferson County,12,16,404,155,249
50,12,65,Florida,Jefferson County,12,17,338,142,196
50,12,65,Florida,Jefferson County,12,18,327,120,207
50,12,67,Florida,Lafayette County,1,0,7022,4200,2822
50,12,67,Florida,Lafayette County,1,1,389,222,167
50,12,67,Florida,Lafayette County,1,2,431,227,204
50,12,67,Florida,Lafayette County,1,3,420,223,197
50,12,67,Florida,Lafayette County,1,4,486,277,209
50,12,67,Florida,Lafayette County,1,5,548,405,143
50,12,67,Florida,Lafayette County,1,6,643,469,174
50,12,67,Florida,Lafayette County,1,7,613,429,184
50,12,67,Florida,Lafayette County,1,8,608,416,192
50,12,67,Florida,Lafayette County,1,9,521,333,188
50,12,67,Florida,Lafayette County,1,10,420,229,191
50,12,67,Florida,Lafayette County,1,11,416,235,181
50,12,67,Florida,Lafayette County,1,12,337,172,165
50,12,67,Florida,Lafayette County,1,13,321,166,155
50,12,67,Florida,Lafayette County,1,14,281,152,129
50,12,67,Florida,Lafayette County,1,15,215,107,108
50,12,67,Florida,Lafayette County,1,16,172,69,103
50,12,67,Florida,Lafayette County,1,17,111,50,61
50,12,67,Florida,Lafayette County,1,18,90,19,71
50,12,67,Florida,Lafayette County,2,0,7022,4200,2822
50,12,67,Florida,Lafayette County,2,1,389,222,167
50,12,67,Florida,Lafayette County,2,2,431,227,204
50,12,67,Florida,Lafayette County,2,3,420,223,197
50,12,67,Florida,Lafayette County,2,4,486,277,209
50,12,67,Florida,Lafayette County,2,5,548,405,143
50,12,67,Florida,Lafayette County,2,6,643,469,174
50,12,67,Florida,Lafayette County,2,7,613,429,184
50,12,67,Florida,Lafayette County,2,8,608,416,192
50,12,67,Florida,Lafayette County,2,9,521,333,188
50,12,67,Florida,Lafayette County,2,10,420,229,191
50,12,67,Florida,Lafayette County,2,11,416,235,181
50,12,67,Florida,Lafayette County,2,12,337,172,165
50,12,67,Florida,Lafayette County,2,13,321,166,155
50,12,67,Florida,Lafayette County,2,14,281,152,129
50,12,67,Florida,Lafayette County,2,15,215,107,108
50,12,67,Florida,Lafayette County,2,16,172,69,103
50,12,67,Florida,Lafayette County,2,17,111,50,61
50,12,67,Florida,Lafayette County,2,18,90,19,71
50,12,67,Florida,Lafayette County,3,0,7038,4209,2829
50,12,67,Florida,Lafayette County,3,1,389,222,167
50,12,67,Florida,Lafayette County,3,2,431,227,204
50,12,67,Florida,Lafayette County,3,3,420,223,197
50,12,67,Florida,Lafayette County,3,4,487,278,209
50,12,67,Florida,Lafayette County,3,5,551,407,144
50,12,67,Florida,Lafayette County,3,6,641,468,173
50,12,67,Florida,Lafayette County,3,7,614,430,184
50,12,67,Florida,Lafayette County,3,8,606,415,191
50,12,67,Florida,Lafayette County,3,9,523,334,189
50,12,67,Florida,Lafayette County,3,10,423,230,193
50,12,67,Florida,Lafayette County,3,11,421,238,183
50,12,67,Florida,Lafayette County,3,12,339,172,167
50,12,67,Florida,Lafayette County,3,13,321,166,155
50,12,67,Florida,Lafayette County,3,14,282,153,129
50,12,67,Florida,Lafayette County,3,15,215,107,108
50,12,67,Florida,Lafayette County,3,16,172,69,103
50,12,67,Florida,Lafayette County,3,17,112,51,61
50,12,67,Florida,Lafayette County,3,18,91,19,72
50,12,67,Florida,Lafayette County,4,0,7119,4238,2881
50,12,67,Florida,Lafayette County,4,1,417,223,194
50,12,67,Florida,Lafayette County,4,2,407,221,186
50,12,67,Florida,Lafayette County,4,3,448,235,213
50,12,67,Florida,Lafayette County,4,4,451,262,189
50,12,67,Florida,Lafayette County,4,5,603,433,170
50,12,67,Florida,Lafayette County,4,6,629,457,172
50,12,67,Florida,Lafayette County,4,7,603,428,175
50,12,67,Florida,Lafayette County,4,8,607,410,197
50,12,67,Florida,Lafayette County,4,9,539,343,196
50,12,67,Florida,Lafayette County,4,10,423,235,188
50,12,67,Florida,Lafayette County,4,11,402,222,180
50,12,67,Florida,Lafayette County,4,12,367,187,180
50,12,67,Florida,Lafayette County,4,13,329,170,159
50,12,67,Florida,Lafayette County,4,14,278,149,129
50,12,67,Florida,Lafayette County,4,15,224,115,109
50,12,67,Florida,Lafayette County,4,16,188,75,113
50,12,67,Florida,Lafayette County,4,17,114,54,60
50,12,67,Florida,Lafayette County,4,18,90,19,71
50,12,67,Florida,Lafayette County,5,0,7202,4289,2913
50,12,67,Florida,Lafayette County,5,1,425,213,212
50,12,67,Florida,Lafayette County,5,2,417,236,181
50,12,67,Florida,Lafayette County,5,3,454,242,212
50,12,67,Florida,Lafayette County,5,4,428,250,178
50,12,67,Florida,Lafayette County,5,5,628,438,190
50,12,67,Florida,Lafayette County,5,6,633,471,162
50,12,67,Florida,Lafayette County,5,7,639,445,194
50,12,67,Florida,Lafayette County,5,8,613,416,197
50,12,67,Florida,Lafayette County,5,9,535,342,193
50,12,67,Florida,Lafayette County,5,10,417,230,187
50,12,67,Florida,Lafayette County,5,11,400,225,175
50,12,67,Florida,Lafayette County,5,12,401,204,197
50,12,67,Florida,Lafayette County,5,13,317,161,156
50,12,67,Florida,Lafayette County,5,14,273,146,127
50,12,67,Florida,Lafayette County,5,15,227,115,112
50,12,67,Florida,Lafayette County,5,16,175,72,103
50,12,67,Florida,Lafayette County,5,17,127,64,63
50,12,67,Florida,Lafayette County,5,18,93,19,74
50,12,67,Florida,Lafayette County,6,0,7228,4345,2883
50,12,67,Florida,Lafayette County,6,1,419,213,206
50,12,67,Florida,Lafayette County,6,2,380,214,166
50,12,67,Florida,Lafayette County,6,3,432,232,200
50,12,67,Florida,Lafayette County,6,4,420,237,183
50,12,67,Florida,Lafayette County,6,5,694,490,204
50,12,67,Florida,Lafayette County,6,6,621,473,148
50,12,67,Florida,Lafayette County,6,7,687,479,208
50,12,67,Florida,Lafayette County,6,8,599,414,185
50,12,67,Florida,Lafayette County,6,9,550,368,182
50,12,67,Florida,Lafayette County,6,10,425,238,187
50,12,67,Florida,Lafayette County,6,11,389,215,174
50,12,67,Florida,Lafayette County,6,12,404,210,194
50,12,67,Florida,Lafayette County,6,13,314,146,168
50,12,67,Florida,Lafayette County,6,14,263,140,123
50,12,67,Florida,Lafayette County,6,15,232,112,120
50,12,67,Florida,Lafayette County,6,16,172,79,93
50,12,67,Florida,Lafayette County,6,17,131,67,64
50,12,67,Florida,Lafayette County,6,18,96,18,78
50,12,67,Florida,Lafayette County,7,0,7438,4532,2906
50,12,67,Florida,Lafayette County,7,1,447,227,220
50,12,67,Florida,Lafayette County,7,2,370,205,165
50,12,67,Florida,Lafayette County,7,3,447,241,206
50,12,67,Florida,Lafayette County,7,4,405,228,177
50,12,67,Florida,Lafayette County,7,5,719,522,197
50,12,67,Florida,Lafayette County,7,6,678,517,161
50,12,67,Florida,Lafayette County,7,7,700,505,195
50,12,67,Florida,Lafayette County,7,8,621,439,182
50,12,67,Florida,Lafayette County,7,9,591,394,197
50,12,67,Florida,Lafayette County,7,10,438,260,178
50,12,67,Florida,Lafayette County,7,11,388,203,185
50,12,67,Florida,Lafayette County,7,12,399,213,186
50,12,67,Florida,Lafayette County,7,13,332,154,178
50,12,67,Florida,Lafayette County,7,14,270,141,129
50,12,67,Florida,Lafayette County,7,15,231,119,112
50,12,67,Florida,Lafayette County,7,16,171,80,91
50,12,67,Florida,Lafayette County,7,17,136,64,72
50,12,67,Florida,Lafayette County,7,18,95,20,75
50,12,67,Florida,Lafayette County,8,0,7868,4903,2965
50,12,67,Florida,Lafayette County,8,1,493,242,251
50,12,67,Florida,Lafayette County,8,2,364,206,158
50,12,67,Florida,Lafayette County,8,3,441,232,209
50,12,67,Florida,Lafayette County,8,4,424,244,180
50,12,67,Florida,Lafayette County,8,5,779,588,191
50,12,67,Florida,Lafayette County,8,6,758,593,165
50,12,67,Florida,Lafayette County,8,7,750,563,187
50,12,67,Florida,Lafayette County,8,8,683,491,192
50,12,67,Florida,Lafayette County,8,9,633,433,200
50,12,67,Florida,Lafayette County,8,10,473,277,196
50,12,67,Florida,Lafayette County,8,11,393,212,181
50,12,67,Florida,Lafayette County,8,12,402,216,186
50,12,67,Florida,Lafayette County,8,13,354,175,179
50,12,67,Florida,Lafayette County,8,14,279,138,141
50,12,67,Florida,Lafayette County,8,15,235,127,108
50,12,67,Florida,Lafayette County,8,16,170,78,92
50,12,67,Florida,Lafayette County,8,17,134,52,82
50,12,67,Florida,Lafayette County,8,18,103,36,67
50,12,67,Florida,Lafayette County,9,0,8013,4977,3036
50,12,67,Florida,Lafayette County,9,1,484,247,237
50,12,67,Florida,Lafayette County,9,2,396,210,186
50,12,67,Florida,Lafayette County,9,3,438,236,202
50,12,67,Florida,Lafayette County,9,4,457,261,196
50,12,67,Florida,Lafayette County,9,5,738,564,174
50,12,67,Florida,Lafayette County,9,6,819,626,193
50,12,67,Florida,Lafayette County,9,7,746,557,189
50,12,67,Florida,Lafayette County,9,8,676,494,182
50,12,67,Florida,Lafayette County,9,9,636,431,205
50,12,67,Florida,Lafayette County,9,10,486,285,201
50,12,67,Florida,Lafayette County,9,11,424,231,193
50,12,67,Florida,Lafayette County,9,12,398,211,187
50,12,67,Florida,Lafayette County,9,13,355,177,178
50,12,67,Florida,Lafayette County,9,14,302,149,153
50,12,67,Florida,Lafayette County,9,15,225,118,107
50,12,67,Florida,Lafayette County,9,16,179,83,96
50,12,67,Florida,Lafayette County,9,17,148,59,89
50,12,67,Florida,Lafayette County,9,18,106,38,68
50,12,67,Florida,Lafayette County,10,0,8023,5008,3015
50,12,67,Florida,Lafayette County,10,1,479,238,241
50,12,67,Florida,Lafayette County,10,2,410,204,206
50,12,67,Florida,Lafayette County,10,3,420,237,183
50,12,67,Florida,Lafayette County,10,4,433,249,184
50,12,67,Florida,Lafayette County,10,5,715,557,158
50,12,67,Florida,Lafayette County,10,6,843,635,208
50,12,67,Florida,Lafayette County,10,7,727,562,165
50,12,67,Florida,Lafayette County,10,8,698,507,191
50,12,67,Florida,Lafayette County,10,9,624,430,194
50,12,67,Florida,Lafayette County,10,10,486,288,198
50,12,67,Florida,Lafayette County,10,11,423,230,193
50,12,67,Florida,Lafayette County,10,12,395,212,183
50,12,67,Florida,Lafayette County,10,13,383,195,188
50,12,67,Florida,Lafayette County,10,14,303,148,155
50,12,67,Florida,Lafayette County,10,15,240,123,117
50,12,67,Florida,Lafayette County,10,16,185,86,99
50,12,67,Florida,Lafayette County,10,17,150,63,87
50,12,67,Florida,Lafayette County,10,18,109,44,65
50,12,67,Florida,Lafayette County,11,0,8054,5035,3019
50,12,67,Florida,Lafayette County,11,1,499,256,243
50,12,67,Florida,Lafayette County,11,2,426,215,211
50,12,67,Florida,Lafayette County,11,3,402,225,177
50,12,67,Florida,Lafayette County,11,4,417,241,176
50,12,67,Florida,Lafayette County,11,5,695,543,152
50,12,67,Florida,Lafayette County,11,6,874,658,216
50,12,67,Florida,Lafayette County,11,7,709,551,158
50,12,67,Florida,Lafayette County,11,8,737,528,209
50,12,67,Florida,Lafayette County,11,9,619,424,195
50,12,67,Florida,Lafayette County,11,10,475,294,181
50,12,67,Florida,Lafayette County,11,11,438,243,195
50,12,67,Florida,Lafayette County,11,12,388,204,184
50,12,67,Florida,Lafayette County,11,13,391,202,189
50,12,67,Florida,Lafayette County,11,14,299,135,164
50,12,67,Florida,Lafayette County,11,15,229,117,112
50,12,67,Florida,Lafayette County,11,16,188,84,104
50,12,67,Florida,Lafayette County,11,17,149,70,79
50,12,67,Florida,Lafayette County,11,18,119,45,74
50,12,67,Florida,Lafayette County,12,0,7949,4930,3019
50,12,67,Florida,Lafayette County,12,1,477,242,235
50,12,67,Florida,Lafayette County,12,2,459,231,228
50,12,67,Florida,Lafayette County,12,3,381,210,171
50,12,67,Florida,Lafayette County,12,4,422,244,178
50,12,67,Florida,Lafayette County,12,5,645,500,145
50,12,67,Florida,Lafayette County,12,6,850,639,211
50,12,67,Florida,Lafayette County,12,7,710,541,169
50,12,67,Florida,Lafayette County,12,8,730,522,208
50,12,67,Florida,Lafayette County,12,9,589,405,184
50,12,67,Florida,Lafayette County,12,10,486,293,193
50,12,67,Florida,Lafayette County,12,11,452,258,194
50,12,67,Florida,Lafayette County,12,12,378,190,188
50,12,67,Florida,Lafayette County,12,13,394,208,186
50,12,67,Florida,Lafayette County,12,14,285,130,155
50,12,67,Florida,Lafayette County,12,15,240,120,120
50,12,67,Florida,Lafayette County,12,16,182,85,97
50,12,67,Florida,Lafayette County,12,17,143,68,75
50,12,67,Florida,Lafayette County,12,18,126,44,82
50,12,69,Florida,Lake County,1,0,210528,101866,108662
50,12,69,Florida,Lake County,1,1,10993,5675,5318
50,12,69,Florida,Lake County,1,2,12277,6298,5979
50,12,69,Florida,Lake County,1,3,12484,6284,6200
50,12,69,Florida,Lake County,1,4,10849,5658,5191
50,12,69,Florida,Lake County,1,5,8286,4147,4139
50,12,69,Florida,Lake County,1,6,9809,4849,4960
50,12,69,Florida,Lake County,1,7,11701,5776,5925
50,12,69,Florida,Lake County,1,8,14322,7215,7107
50,12,69,Florida,Lake County,1,9,14172,7043,7129
50,12,69,Florida,Lake County,1,10,12444,6160,6284
50,12,69,Florida,Lake County,1,11,11969,5602,6367
50,12,69,Florida,Lake County,1,12,12102,5481,6621
50,12,69,Florida,Lake County,1,13,13517,6116,7401
50,12,69,Florida,Lake County,1,14,15090,7226,7864
50,12,69,Florida,Lake County,1,15,15178,7409,7769
50,12,69,Florida,Lake County,1,16,12409,5698,6711
50,12,69,Florida,Lake County,1,17,7232,3227,4005
50,12,69,Florida,Lake County,1,18,5694,2002,3692
50,12,69,Florida,Lake County,2,0,210509,101859,108650
50,12,69,Florida,Lake County,2,1,10993,5675,5318
50,12,69,Florida,Lake County,2,2,12275,6298,5977
50,12,69,Florida,Lake County,2,3,12484,6284,6200
50,12,69,Florida,Lake County,2,4,10846,5657,5189
50,12,69,Florida,Lake County,2,5,8285,4147,4138
50,12,69,Florida,Lake County,2,6,9808,4848,4960
50,12,69,Florida,Lake County,2,7,11695,5773,5922
50,12,69,Florida,Lake County,2,8,14320,7214,7106
50,12,69,Florida,Lake County,2,9,14171,7042,7129
50,12,69,Florida,Lake County,2,10,12443,6160,6283
50,12,69,Florida,Lake County,2,11,11968,5602,6366
50,12,69,Florida,Lake County,2,12,12103,5481,6622
50,12,69,Florida,Lake County,2,13,13518,6117,7401
50,12,69,Florida,Lake County,2,14,15088,7225,7863
50,12,69,Florida,Lake County,2,15,15177,7409,7768
50,12,69,Florida,Lake County,2,16,12409,5698,6711
50,12,69,Florida,Lake County,2,17,7232,3227,4005
50,12,69,Florida,Lake County,2,18,5694,2002,3692
50,12,69,Florida,Lake County,3,0,212808,102988,109820
50,12,69,Florida,Lake County,3,1,11105,5732,5373
50,12,69,Florida,Lake County,3,2,12336,6329,6007
50,12,69,Florida,Lake County,3,3,12653,6367,6286
50,12,69,Florida,Lake County,3,4,10968,5721,5247
50,12,69,Florida,Lake County,3,5,8442,4227,4215
50,12,69,Florida,Lake County,3,6,9834,4861,4973
50,12,69,Florida,Lake County,3,7,11807,5827,5980
50,12,69,Florida,Lake County,3,8,14402,7256,7146
50,12,69,Florida,Lake County,3,9,14339,7123,7216
50,12,69,Florida,Lake County,3,10,12633,6252,6381
50,12,69,Florida,Lake County,3,11,12206,5713,6493
50,12,69,Florida,Lake County,3,12,12293,5569,6724
50,12,69,Florida,Lake County,3,13,13692,6198,7494
50,12,69,Florida,Lake County,3,14,15151,7257,7894
50,12,69,Florida,Lake County,3,15,15279,7471,7808
50,12,69,Florida,Lake County,3,16,12534,5761,6773
50,12,69,Florida,Lake County,3,17,7353,3287,4066
50,12,69,Florida,Lake County,3,18,5781,2037,3744
50,12,69,Florida,Lake County,4,0,224077,108655,115422
50,12,69,Florida,Lake County,4,1,11740,6084,5656
50,12,69,Florida,Lake County,4,2,12620,6449,6171
50,12,69,Florida,Lake County,4,3,13424,6758,6666
50,12,69,Florida,Lake County,4,4,11298,5893,5405
50,12,69,Florida,Lake County,4,5,9215,4632,4583
50,12,69,Florida,Lake County,4,6,9960,4966,4994
50,12,69,Florida,Lake County,4,7,12553,6213,6340
50,12,69,Florida,Lake County,4,8,14672,7389,7283
50,12,69,Florida,Lake County,4,9,15272,7649,7623
50,12,69,Florida,Lake County,4,10,13514,6683,6831
50,12,69,Florida,Lake County,4,11,13242,6230,7012
50,12,69,Florida,Lake County,4,12,13077,5908,7169
50,12,69,Florida,Lake County,4,13,14754,6757,7997
50,12,69,Florida,Lake County,4,14,15820,7532,8288
50,12,69,Florida,Lake County,4,15,15756,7685,8071
50,12,69,Florida,Lake County,4,16,13143,6047,7096
50,12,69,Florida,Lake County,4,17,7970,3602,4368
50,12,69,Florida,Lake County,4,18,6047,2178,3869
50,12,69,Florida,Lake County,5,0,234662,113898,120764
50,12,69,Florida,Lake County,5,1,12579,6476,6103
50,12,69,Florida,Lake County,5,2,13046,6688,6358
50,12,69,Florida,Lake County,5,3,14065,7095,6970
50,12,69,Florida,Lake County,5,4,11755,6123,5632
50,12,69,Florida,Lake County,5,5,9927,5033,4894
50,12,69,Florida,Lake County,5,6,10497,5247,5250
50,12,69,Florida,Lake County,5,7,13418,6700,6718
50,12,69,Florida,Lake County,5,8,14969,7450,7519
50,12,69,Florida,Lake County,5,9,15793,7936,7857
50,12,69,Florida,Lake County,5,10,14449,7098,7351
50,12,69,Florida,Lake County,5,11,13561,6447,7114
50,12,69,Florida,Lake County,5,12,14348,6579,7769
50,12,69,Florida,Lake County,5,13,15098,6833,8265
50,12,69,Florida,Lake County,5,14,16371,7803,8568
50,12,69,Florida,Lake County,5,15,16068,7789,8279
50,12,69,Florida,Lake County,5,16,13667,6336,7331
50,12,69,Florida,Lake County,5,17,8667,3922,4745
50,12,69,Florida,Lake County,5,18,6384,2343,4041
50,12,69,Florida,Lake County,6,0,246008,119541,126467
50,12,69,Florida,Lake County,6,1,13403,6891,6512
50,12,69,Florida,Lake County,6,2,13486,6876,6610
50,12,69,Florida,Lake County,6,3,14652,7459,7193
50,12,69,Florida,Lake County,6,4,12391,6404,5987
50,12,69,Florida,Lake County,6,5,10561,5449,5112
50,12,69,Florida,Lake County,6,6,11039,5541,5498
50,12,69,Florida,Lake County,6,7,13740,6881,6859
50,12,69,Florida,Lake County,6,8,15289,7601,7688
50,12,69,Florida,Lake County,6,9,16491,8280,8211
50,12,69,Florida,Lake County,6,10,15398,7623,7775
50,12,69,Florida,Lake County,6,11,14159,6722,7437
50,12,69,Florida,Lake County,6,12,14874,6901,7973
50,12,69,Florida,Lake County,6,13,16021,7282,8739
50,12,69,Florida,Lake County,6,14,17231,8088,9143
50,12,69,Florida,Lake County,6,15,16431,7963,8468
50,12,69,Florida,Lake County,6,16,14328,6723,7605
50,12,69,Florida,Lake County,6,17,9506,4241,5265
50,12,69,Florida,Lake County,6,18,7008,2616,4392
50,12,69,Florida,Lake County,7,0,260829,126911,133918
50,12,69,Florida,Lake County,7,1,14312,7390,6922
50,12,69,Florida,Lake County,7,2,14271,7299,6972
50,12,69,Florida,Lake County,7,3,15281,7791,7490
50,12,69,Florida,Lake County,7,4,13333,6857,6476
50,12,69,Florida,Lake County,7,5,11372,5908,5464
50,12,69,Florida,Lake County,7,6,11744,5930,5814
50,12,69,Florida,Lake County,7,7,14173,7120,7053
50,12,69,Florida,Lake County,7,8,15788,7859,7929
50,12,69,Florida,Lake County,7,9,17373,8729,8644
50,12,69,Florida,Lake County,7,10,16281,8043,8238
50,12,69,Florida,Lake County,7,11,14993,7162,7831
50,12,69,Florida,Lake County,7,12,16022,7478,8544
50,12,69,Florida,Lake County,7,13,16968,7707,9261
50,12,69,Florida,Lake County,7,14,18381,8590,9791
50,12,69,Florida,Lake County,7,15,17103,8278,8825
50,12,69,Florida,Lake County,7,16,15169,7076,8093
50,12,69,Florida,Lake County,7,17,10633,4736,5897
50,12,69,Florida,Lake County,7,18,7632,2958,4674
50,12,69,Florida,Lake County,8,0,275559,134221,141338
50,12,69,Florida,Lake County,8,1,15204,7806,7398
50,12,69,Florida,Lake County,8,2,14797,7635,7162
50,12,69,Florida,Lake County,8,3,15904,8148,7756
50,12,69,Florida,Lake County,8,4,14267,7291,6976
50,12,69,Florida,Lake County,8,5,11924,6184,5740
50,12,69,Florida,Lake County,8,6,12643,6417,6226
50,12,69,Florida,Lake County,8,7,14407,7205,7202
50,12,69,Florida,Lake County,8,8,16409,8214,8195
50,12,69,Florida,Lake County,8,9,18213,9157,9056
50,12,69,Florida,Lake County,8,10,17450,8596,8854
50,12,69,Florida,Lake County,8,11,15846,7676,8170
50,12,69,Florida,Lake County,8,12,17198,7975,9223
50,12,69,Florida,Lake County,8,13,17762,8177,9585
50,12,69,Florida,Lake County,8,14,19152,8837,10315
50,12,69,Florida,Lake County,8,15,18189,8679,9510
50,12,69,Florida,Lake County,8,16,15900,7620,8280
50,12,69,Florida,Lake County,8,17,11708,5202,6506
50,12,69,Florida,Lake County,8,18,8586,3402,5184
50,12,69,Florida,Lake County,9,0,291330,141932,149398
50,12,69,Florida,Lake County,9,1,16084,8281,7803
50,12,69,Florida,Lake County,9,2,15723,8130,7593
50,12,69,Florida,Lake County,9,3,16268,8315,7953
50,12,69,Florida,Lake County,9,4,15055,7686,7369
50,12,69,Florida,Lake County,9,5,12174,6314,5860
50,12,69,Florida,Lake County,9,6,13903,7056,6847
50,12,69,Florida,Lake County,9,7,14354,7203,7151
50,12,69,Florida,Lake County,9,8,17343,8698,8645
50,12,69,Florida,Lake County,9,9,18440,9259,9181
50,12,69,Florida,Lake County,9,10,18495,9171,9324
50,12,69,Florida,Lake County,9,11,16796,8158,8638
50,12,69,Florida,Lake County,9,12,18050,8390,9660
50,12,69,Florida,Lake County,9,13,18155,8320,9835
50,12,69,Florida,Lake County,9,14,20521,9503,11018
50,12,69,Florida,Lake County,9,15,19811,9392,10419
50,12,69,Florida,Lake County,9,16,17247,8224,9023
50,12,69,Florida,Lake County,9,17,12921,5796,7125
50,12,69,Florida,Lake County,9,18,9990,4036,5954
50,12,69,Florida,Lake County,10,0,302170,147373,154797
50,12,69,Florida,Lake County,10,1,16956,8771,8185
50,12,69,Florida,Lake County,10,2,16364,8423,7941
50,12,69,Florida,Lake County,10,3,16454,8439,8015
50,12,69,Florida,Lake County,10,4,15619,7996,7623
50,12,69,Florida,Lake County,10,5,12854,6660,6194
50,12,69,Florida,Lake County,10,6,14660,7518,7142
50,12,69,Florida,Lake County,10,7,14543,7326,7217
50,12,69,Florida,Lake County,10,8,17674,8915,8759
50,12,69,Florida,Lake County,10,9,18590,9262,9328
50,12,69,Florida,Lake County,10,10,18773,9342,9431
50,12,69,Florida,Lake County,10,11,17597,8540,9057
50,12,69,Florida,Lake County,10,12,17979,8414,9565
50,12,69,Florida,Lake County,10,13,19267,8907,10360
50,12,69,Florida,Lake County,10,14,21097,9700,11397
50,12,69,Florida,Lake County,10,15,20907,9884,11023
50,12,69,Florida,Lake County,10,16,17809,8464,9345
50,12,69,Florida,Lake County,10,17,13763,6222,7541
50,12,69,Florida,Lake County,10,18,11264,4590,6674
50,12,69,Florida,Lake County,11,0,307964,150148,157816
50,12,69,Florida,Lake County,11,1,17083,8858,8225
50,12,69,Florida,Lake County,11,2,16441,8450,7991
50,12,69,Florida,Lake County,11,3,16361,8355,8006
50,12,69,Florida,Lake County,11,4,15922,8218,7704
50,12,69,Florida,Lake County,11,5,13072,6691,6381
50,12,69,Florida,Lake County,11,6,14775,7652,7123
50,12,69,Florida,Lake County,11,7,14554,7337,7217
50,12,69,Florida,Lake County,11,8,17568,8860,8708
50,12,69,Florida,Lake County,11,9,18358,9136,9222
50,12,69,Florida,Lake County,11,10,18974,9433,9541
50,12,69,Florida,Lake County,11,11,18079,8854,9225
50,12,69,Florida,Lake County,11,12,17667,8263,9404
50,12,69,Florida,Lake County,11,13,19365,8985,10380
50,12,69,Florida,Lake County,11,14,21967,10139,11828
50,12,69,Florida,Lake County,11,15,21955,10221,11734
50,12,69,Florida,Lake County,11,16,18532,8837,9695
50,12,69,Florida,Lake County,11,17,14627,6692,7935
50,12,69,Florida,Lake County,11,18,12664,5167,7497
50,12,69,Florida,Lake County,12,0,312119,152112,160007
50,12,69,Florida,Lake County,12,1,17125,8838,8287
50,12,69,Florida,Lake County,12,2,16554,8536,8018
50,12,69,Florida,Lake County,12,3,16321,8359,7962
50,12,69,Florida,Lake County,12,4,15780,8161,7619
50,12,69,Florida,Lake County,12,5,13107,6687,6420
50,12,69,Florida,Lake County,12,6,15018,7809,7209
50,12,69,Florida,Lake County,12,7,14588,7378,7210
50,12,69,Florida,Lake County,12,8,17052,8620,8432
50,12,69,Florida,Lake County,12,9,18014,8966,9048
50,12,69,Florida,Lake County,12,10,19107,9512,9595
50,12,69,Florida,Lake County,12,11,18081,8852,9229
50,12,69,Florida,Lake County,12,12,17540,8260,9280
50,12,69,Florida,Lake County,12,13,19555,9095,10460
50,12,69,Florida,Lake County,12,14,22538,10352,12186
50,12,69,Florida,Lake County,12,15,23247,10790,12457
50,12,69,Florida,Lake County,12,16,19269,9187,10082
50,12,69,Florida,Lake County,12,17,15271,6926,8345
50,12,69,Florida,Lake County,12,18,13952,5784,8168
50,12,71,Florida,Lee County,1,0,440888,215504,225384
50,12,71,Florida,Lee County,1,1,22970,11770,11200
50,12,71,Florida,Lee County,1,2,24224,12575,11649
50,12,71,Florida,Lee County,1,3,25034,12786,12248
50,12,71,Florida,Lee County,1,4,22501,11826,10675
50,12,71,Florida,Lee County,1,5,18816,9880,8936
50,12,71,Florida,Lee County,1,6,21797,11142,10655
50,12,71,Florida,Lee County,1,7,24694,12590,12104
50,12,71,Florida,Lee County,1,8,29498,14741,14757
50,12,71,Florida,Lee County,1,9,29734,14654,15080
50,12,71,Florida,Lee County,1,10,27349,13182,14167
50,12,71,Florida,Lee County,1,11,27484,12876,14608
50,12,71,Florida,Lee County,1,12,26820,12526,14294
50,12,71,Florida,Lee County,1,13,27856,12956,14900
50,12,71,Florida,Lee County,1,14,29921,14413,15508
50,12,71,Florida,Lee County,1,15,30642,14772,15870
50,12,71,Florida,Lee County,1,16,25148,11828,13320
50,12,71,Florida,Lee County,1,17,15482,6956,8526
50,12,71,Florida,Lee County,1,18,10918,4031,6887
50,12,71,Florida,Lee County,2,0,440889,215505,225384
50,12,71,Florida,Lee County,2,1,22970,11770,11200
50,12,71,Florida,Lee County,2,2,24224,12575,11649
50,12,71,Florida,Lee County,2,3,25034,12786,12248
50,12,71,Florida,Lee County,2,4,22501,11826,10675
50,12,71,Florida,Lee County,2,5,18816,9880,8936
50,12,71,Florida,Lee County,2,6,21797,11142,10655
50,12,71,Florida,Lee County,2,7,24694,12590,12104
50,12,71,Florida,Lee County,2,8,29498,14741,14757
50,12,71,Florida,Lee County,2,9,29734,14654,15080
50,12,71,Florida,Lee County,2,10,27349,13182,14167
50,12,71,Florida,Lee County,2,11,27484,12876,14608
50,12,71,Florida,Lee County,2,12,26820,12526,14294
50,12,71,Florida,Lee County,2,13,27856,12956,14900
50,12,71,Florida,Lee County,2,14,29921,14413,15508
50,12,71,Florida,Lee County,2,15,30643,14773,15870
50,12,71,Florida,Lee County,2,16,25148,11828,13320
50,12,71,Florida,Lee County,2,17,15482,6956,8526
50,12,71,Florida,Lee County,2,18,10918,4031,6887
50,12,71,Florida,Lee County,3,0,443916,217057,226859
50,12,71,Florida,Lee County,3,1,23130,11850,11280
50,12,71,Florida,Lee County,3,2,24265,12598,11667
50,12,71,Florida,Lee County,3,3,25279,12908,12371
50,12,71,Florida,Lee County,3,4,22665,11913,10752
50,12,71,Florida,Lee County,3,5,19101,10039,9062
50,12,71,Florida,Lee County,3,6,21800,11152,10648
50,12,71,Florida,Lee County,3,7,24834,12666,12168
50,12,71,Florida,Lee County,3,8,29563,14778,14785
50,12,71,Florida,Lee County,3,9,29974,14773,15201
50,12,71,Florida,Lee County,3,10,27655,13329,14326
50,12,71,Florida,Lee County,3,11,27914,13076,14838
50,12,71,Florida,Lee County,3,12,27133,12676,14457
50,12,71,Florida,Lee County,3,13,28099,13072,15027
50,12,71,Florida,Lee County,3,14,29875,14396,15479
50,12,71,Florida,Lee County,3,15,30674,14810,15864
50,12,71,Florida,Lee County,3,16,25260,11892,13368
50,12,71,Florida,Lee County,3,17,15657,7045,8612
50,12,71,Florida,Lee County,3,18,11038,4084,6954
50,12,71,Florida,Lee County,4,0,458557,224547,234010
50,12,71,Florida,Lee County,4,1,24541,12495,12046
50,12,71,Florida,Lee County,4,2,24774,12892,11882
50,12,71,Florida,Lee County,4,3,26415,13481,12934
50,12,71,Florida,Lee County,4,4,23172,12296,10876
50,12,71,Florida,Lee County,4,5,20810,10868,9942
50,12,71,Florida,Lee County,4,6,21895,11253,10642
50,12,71,Florida,Lee County,4,7,25881,13214,12667
50,12,71,Florida,Lee County,4,8,29737,14867,14870
50,12,71,Florida,Lee County,4,9,31297,15556,15741
50,12,71,Florida,Lee County,4,10,29080,14057,15023
50,12,71,Florida,Lee County,4,11,29781,13947,15834
50,12,71,Florida,Lee County,4,12,28396,13160,15236
50,12,71,Florida,Lee County,4,13,28933,13489,15444
50,12,71,Florida,Lee County,4,14,29630,14269,15361
50,12,71,Florida,Lee County,4,15,30686,14840,15846
50,12,71,Florida,Lee County,4,16,25476,12041,13435
50,12,71,Florida,Lee County,4,17,16386,7427,8959
50,12,71,Florida,Lee County,4,18,11667,4395,7272
50,12,71,Florida,Lee County,5,0,474109,232532,241577
50,12,71,Florida,Lee County,5,1,26081,13309,12772
50,12,71,Florida,Lee County,5,2,25302,13053,12249
50,12,71,Florida,Lee County,5,3,27131,13879,13252
50,12,71,Florida,Lee County,5,4,24176,12831,11345
50,12,71,Florida,Lee County,5,5,22316,11684,10632
50,12,71,Florida,Lee County,5,6,22578,11712,10866
50,12,71,Florida,Lee County,5,7,26940,13784,13156
50,12,71,Florida,Lee County,5,8,29740,14889,14851
50,12,71,Florida,Lee County,5,9,32293,16054,16239
50,12,71,Florida,Lee County,5,10,30781,14895,15886
50,12,71,Florida,Lee County,5,11,30187,14235,15952
50,12,71,Florida,Lee County,5,12,30854,14279,16575
50,12,71,Florida,Lee County,5,13,30613,14291,16322
50,12,71,Florida,Lee County,5,14,29614,14143,15471
50,12,71,Florida,Lee County,5,15,30129,14619,15510
50,12,71,Florida,Lee County,5,16,25952,12279,13673
50,12,71,Florida,Lee County,5,17,17123,7819,9304
50,12,71,Florida,Lee County,5,18,12299,4777,7522
50,12,71,Florida,Lee County,6,0,490139,240868,249271
50,12,71,Florida,Lee County,6,1,27168,13844,13324
50,12,71,Florida,Lee County,6,2,26011,13430,12581
50,12,71,Florida,Lee County,6,3,27820,14267,13553
50,12,71,Florida,Lee County,6,4,25429,13392,12037
50,12,71,Florida,Lee County,6,5,23989,12596,11393
50,12,71,Florida,Lee County,6,6,23665,12412,11253
50,12,71,Florida,Lee County,6,7,27403,14045,13358
50,12,71,Florida,Lee County,6,8,29901,15126,14775
50,12,71,Florida,Lee County,6,9,33490,16626,16864
50,12,71,Florida,Lee County,6,10,32231,15686,16545
50,12,71,Florida,Lee County,6,11,30978,14610,16368
50,12,71,Florida,Lee County,6,12,32518,15117,17401
50,12,71,Florida,Lee County,6,13,32610,15076,17534
50,12,71,Florida,Lee County,6,14,29984,14387,15597
50,12,71,Florida,Lee County,6,15,29699,14354,15345
50,12,71,Florida,Lee County,6,16,26551,12641,13910
50,12,71,Florida,Lee County,6,17,17587,8083,9504
50,12,71,Florida,Lee County,6,18,13105,5176,7929
50,12,71,Florida,Lee County,7,0,512180,252194,259986
50,12,71,Florida,Lee County,7,1,28790,14751,14039
50,12,71,Florida,Lee County,7,2,27205,14032,13173
50,12,71,Florida,Lee County,7,3,28869,14869,14000
50,12,71,Florida,Lee County,7,4,27012,14116,12896
50,12,71,Florida,Lee County,7,5,25482,13371,12111
50,12,71,Florida,Lee County,7,6,25750,13565,12185
50,12,71,Florida,Lee County,7,7,28320,14547,13773
50,12,71,Florida,Lee County,7,8,30450,15459,14991
50,12,71,Florida,Lee County,7,9,34999,17480,17519
50,12,71,Florida,Lee County,7,10,34081,16611,17470
50,12,71,Florida,Lee County,7,11,32396,15416,16980
50,12,71,Florida,Lee County,7,12,34622,16018,18604
50,12,71,Florida,Lee County,7,13,34428,15959,18469
50,12,71,Florida,Lee County,7,14,31220,14884,16336
50,12,71,Florida,Lee County,7,15,29377,14235,15142
50,12,71,Florida,Lee County,7,16,26709,12752,13957
50,12,71,Florida,Lee County,7,17,18616,8571,10045
50,12,71,Florida,Lee County,7,18,13854,5558,8296
50,12,71,Florida,Lee County,8,0,541542,267089,274453
50,12,71,Florida,Lee County,8,1,31462,16148,15314
50,12,71,Florida,Lee County,8,2,29222,14995,14227
50,12,71,Florida,Lee County,8,3,30033,15563,14470
50,12,71,Florida,Lee County,8,4,28824,14950,13874
50,12,71,Florida,Lee County,8,5,27181,14336,12845
50,12,71,Florida,Lee County,8,6,28906,15221,13685
50,12,71,Florida,Lee County,8,7,29681,15252,14429
50,12,71,Florida,Lee County,8,8,32043,16331,15712
50,12,71,Florida,Lee County,8,9,36828,18437,18391
50,12,71,Florida,Lee County,8,10,36388,17786,18602
50,12,71,Florida,Lee County,8,11,34548,16420,18128
50,12,71,Florida,Lee County,8,12,37137,17232,19905
50,12,71,Florida,Lee County,8,13,36307,17008,19299
50,12,71,Florida,Lee County,8,14,32448,15317,17131
50,12,71,Florida,Lee County,8,15,29086,14036,15050
50,12,71,Florida,Lee County,8,16,27059,13008,14051
50,12,71,Florida,Lee County,8,17,19685,9077,10608
50,12,71,Florida,Lee County,8,18,14704,5972,8732
50,12,71,Florida,Lee County,9,0,565956,279755,286201
50,12,71,Florida,Lee County,9,1,33828,17361,16467
50,12,71,Florida,Lee County,9,2,31484,16065,15419
50,12,71,Florida,Lee County,9,3,31139,16174,14965
50,12,71,Florida,Lee County,9,4,30590,15845,14745
50,12,71,Florida,Lee County,9,5,28915,15332,13583
50,12,71,Florida,Lee County,9,6,32512,17023,15489
50,12,71,Florida,Lee County,9,7,30844,15938,14906
50,12,71,Florida,Lee County,9,8,34085,17416,16669
50,12,71,Florida,Lee County,9,9,37796,18978,18818
50,12,71,Florida,Lee County,9,10,38496,18992,19504
50,12,71,Florida,Lee County,9,11,36133,17263,18870
50,12,71,Florida,Lee County,9,12,38952,18065,20887
50,12,71,Florida,Lee County,9,13,37558,17480,20078
50,12,71,Florida,Lee County,9,14,33036,15583,17453
50,12,71,Florida,Lee County,9,15,28544,13760,14784
50,12,71,Florida,Lee County,9,16,26800,12901,13899
50,12,71,Florida,Lee County,9,17,19691,9164,10527
50,12,71,Florida,Lee County,9,18,15553,6415,9138
50,12,71,Florida,Lee County,10,0,585264,290008,295256
50,12,71,Florida,Lee County,10,1,35794,18444,17350
50,12,71,Florida,Lee County,10,2,33451,17101,16350
50,12,71,Florida,Lee County,10,3,31942,16484,15458
50,12,71,Florida,Lee County,10,4,31590,16411,15179
50,12,71,Florida,Lee County,10,5,30703,16246,14457
50,12,71,Florida,Lee County,10,6,34630,18238,16392
50,12,71,Florida,Lee County,10,7,31972,16679,15293
50,12,71,Florida,Lee County,10,8,35629,18268,17361
50,12,71,Florida,Lee County,10,9,38001,19131,18870
50,12,71,Florida,Lee County,10,10,39387,19485,19902
50,12,71,Florida,Lee County,10,11,37572,18017,19555
50,12,71,Florida,Lee County,10,12,38445,17938,20507
50,12,71,Florida,Lee County,10,13,39544,18358,21186
50,12,71,Florida,Lee County,10,14,34834,16371,18463
50,12,71,Florida,Lee County,10,15,28750,13741,15009
50,12,71,Florida,Lee County,10,16,26179,12616,13563
50,12,71,Florida,Lee County,10,17,20350,9522,10828
50,12,71,Florida,Lee County,10,18,16491,6958,9533
50,12,71,Florida,Lee County,11,0,588709,291802,296907
50,12,71,Florida,Lee County,11,1,36064,18618,17446
50,12,71,Florida,Lee County,11,2,33796,17259,16537
50,12,71,Florida,Lee County,11,3,31998,16523,15475
50,12,71,Florida,Lee County,11,4,31366,16319,15047
50,12,71,Florida,Lee County,11,5,30556,16058,14498
50,12,71,Florida,Lee County,11,6,35081,18434,16647
50,12,71,Florida,Lee County,11,7,31813,16712,15101
50,12,71,Florida,Lee County,11,8,35095,17979,17116
50,12,71,Florida,Lee County,11,9,36797,18669,18128
50,12,71,Florida,Lee County,11,10,39591,19569,20022
50,12,71,Florida,Lee County,11,11,37869,18283,19586
50,12,71,Florida,Lee County,11,12,37899,17684,20215
50,12,71,Florida,Lee County,11,13,40478,18834,21644
50,12,71,Florida,Lee County,11,14,36971,17226,19745
50,12,71,Florida,Lee County,11,15,29325,14071,15254
50,12,71,Florida,Lee County,11,16,25887,12404,13483
50,12,71,Florida,Lee County,11,17,20835,9775,11060
50,12,71,Florida,Lee County,11,18,17288,7385,9903
50,12,71,Florida,Lee County,12,0,586908,290846,296062
50,12,71,Florida,Lee County,12,1,35785,18387,17398
50,12,71,Florida,Lee County,12,2,33315,17086,16229
50,12,71,Florida,Lee County,12,3,31367,16197,15170
50,12,71,Florida,Lee County,12,4,30859,16110,14749
50,12,71,Florida,Lee County,12,5,30024,15714,14310
50,12,71,Florida,Lee County,12,6,34456,18082,16374
50,12,71,Florida,Lee County,12,7,31571,16635,14936
50,12,71,Florida,Lee County,12,8,34021,17469,16552
50,12,71,Florida,Lee County,12,9,35252,17920,17332
50,12,71,Florida,Lee County,12,10,39484,19594,19890
50,12,71,Florida,Lee County,12,11,38251,18509,19742
50,12,71,Florida,Lee County,12,12,37773,17748,20025
50,12,71,Florida,Lee County,12,13,41262,19100,22162
50,12,71,Florida,Lee County,12,14,38336,17869,20467
50,12,71,Florida,Lee County,12,15,30499,14523,15976
50,12,71,Florida,Lee County,12,16,25561,12282,13279
50,12,71,Florida,Lee County,12,17,20808,9760,11048
50,12,71,Florida,Lee County,12,18,18284,7861,10423
50,12,73,Florida,Leon County,1,0,239452,114134,125318
50,12,73,Florida,Leon County,1,1,13727,6991,6736
50,12,73,Florida,Leon County,1,2,14158,7198,6960
50,12,73,Florida,Leon County,1,3,14407,7372,7035
50,12,73,Florida,Leon County,1,4,24541,11277,13264
50,12,73,Florida,Leon County,1,5,35465,16960,18505
50,12,73,Florida,Leon County,1,6,19334,9636,9698
50,12,73,Florida,Leon County,1,7,15984,7887,8097
50,12,73,Florida,Leon County,1,8,16716,7862,8854
50,12,73,Florida,Leon County,1,9,17250,8117,9133
50,12,73,Florida,Leon County,1,10,16730,7846,8884
50,12,73,Florida,Leon County,1,11,14588,7094,7494
50,12,73,Florida,Leon County,1,12,9834,4763,5071
50,12,73,Florida,Leon County,1,13,6827,3204,3623
50,12,73,Florida,Leon County,1,14,5456,2520,2936
50,12,73,Florida,Leon County,1,15,4978,2128,2850
50,12,73,Florida,Leon County,1,16,4166,1622,2544
50,12,73,Florida,Leon County,1,17,2882,1018,1864
50,12,73,Florida,Leon County,1,18,2409,639,1770
50,12,73,Florida,Leon County,2,0,239454,114135,125319
50,12,73,Florida,Leon County,2,1,13727,6991,6736
50,12,73,Florida,Leon County,2,2,14158,7198,6960
50,12,73,Florida,Leon County,2,3,14407,7372,7035
50,12,73,Florida,Leon County,2,4,24541,11277,13264
50,12,73,Florida,Leon County,2,5,35465,16960,18505
50,12,73,Florida,Leon County,2,6,19334,9636,9698
50,12,73,Florida,Leon County,2,7,15984,7887,8097
50,12,73,Florida,Leon County,2,8,16716,7862,8854
50,12,73,Florida,Leon County,2,9,17250,8117,9133
50,12,73,Florida,Leon County,2,10,16730,7846,8884
50,12,73,Florida,Leon County,2,11,14590,7095,7495
50,12,73,Florida,Leon County,2,12,9834,4763,5071
50,12,73,Florida,Leon County,2,13,6827,3204,3623
50,12,73,Florida,Leon County,2,14,5456,2520,2936
50,12,73,Florida,Leon County,2,15,4978,2128,2850
50,12,73,Florida,Leon County,2,16,4166,1622,2544
50,12,73,Florida,Leon County,2,17,2882,1018,1864
50,12,73,Florida,Leon County,2,18,2409,639,1770
50,12,73,Florida,Leon County,3,0,240410,114548,125862
50,12,73,Florida,Leon County,3,1,13727,6990,6737
50,12,73,Florida,Leon County,3,2,14089,7163,6926
50,12,73,Florida,Leon County,3,3,14468,7402,7066
50,12,73,Florida,Leon County,3,4,24782,11362,13420
50,12,73,Florida,Leon County,3,5,35872,17143,18729
50,12,73,Florida,Leon County,3,6,19244,9591,9653
50,12,73,Florida,Leon County,3,7,15994,7895,8099
50,12,73,Florida,Leon County,3,8,16662,7837,8825
50,12,73,Florida,Leon County,3,9,17299,8139,9160
50,12,73,Florida,Leon County,3,10,16833,7895,8938
50,12,73,Florida,Leon County,3,11,14738,7166,7572
50,12,73,Florida,Leon County,3,12,9887,4789,5098
50,12,73,Florida,Leon County,3,13,6852,3217,3635
50,12,73,Florida,Leon County,3,14,5453,2519,2934
50,12,73,Florida,Leon County,3,15,4982,2133,2849
50,12,73,Florida,Leon County,3,16,4191,1633,2558
50,12,73,Florida,Leon County,3,17,2911,1030,1881
50,12,73,Florida,Leon County,3,18,2426,644,1782
50,12,73,Florida,Leon County,4,0,241627,115272,126355
50,12,73,Florida,Leon County,4,1,13847,7026,6821
50,12,73,Florida,Leon County,4,2,13794,7054,6740
50,12,73,Florida,Leon County,4,3,14532,7369,7163
50,12,73,Florida,Leon County,4,4,25013,11570,13443
50,12,73,Florida,Leon County,4,5,38058,18347,19711
50,12,73,Florida,Leon County,4,6,17037,8452,8585
50,12,73,Florida,Leon County,4,7,16224,8010,8214
50,12,73,Florida,Leon County,4,8,15990,7536,8454
50,12,73,Florida,Leon County,4,9,17154,8029,9125
50,12,73,Florida,Leon County,4,10,16770,7835,8935
50,12,73,Florida,Leon County,4,11,15523,7493,8030
50,12,73,Florida,Leon County,4,12,10272,5028,5244
50,12,73,Florida,Leon County,4,13,7180,3386,3794
50,12,73,Florida,Leon County,4,14,5545,2578,2967
50,12,73,Florida,Leon County,4,15,4909,2118,2791
50,12,73,Florida,Leon County,4,16,4177,1592,2585
50,12,73,Florida,Leon County,4,17,3062,1140,1922
50,12,73,Florida,Leon County,4,18,2540,709,1831
50,12,73,Florida,Leon County,5,0,243733,116416,127317
50,12,73,Florida,Leon County,5,1,14009,7128,6881
50,12,73,Florida,Leon County,5,2,13673,6948,6725
50,12,73,Florida,Leon County,5,3,14465,7385,7080
50,12,73,Florida,Leon County,5,4,24856,11578,13278
50,12,73,Florida,Leon County,5,5,40859,19691,21168
50,12,73,Florida,Leon County,5,6,15179,7567,7612
50,12,73,Florida,Leon County,5,7,16744,8254,8490
50,12,73,Florida,Leon County,5,8,15373,7335,8038
50,12,73,Florida,Leon County,5,9,16951,7922,9029
50,12,73,Florida,Leon County,5,10,16728,7792,8936
50,12,73,Florida,Leon County,5,11,15671,7494,8177
50,12,73,Florida,Leon County,5,12,11451,5563,5888
50,12,73,Florida,Leon County,5,13,7462,3565,3897
50,12,73,Florida,Leon County,5,14,5541,2566,2975
50,12,73,Florida,Leon County,5,15,4776,2089,2687
50,12,73,Florida,Leon County,5,16,4160,1617,2543
50,12,73,Florida,Leon County,5,17,3234,1201,2033
50,12,73,Florida,Leon County,5,18,2601,721,1880
50,12,73,Florida,Leon County,6,0,248102,118582,129520
50,12,73,Florida,Leon County,6,1,14328,7284,7044
50,12,73,Florida,Leon County,6,2,13621,6893,6728
50,12,73,Florida,Leon County,6,3,14476,7422,7054
50,12,73,Florida,Leon County,6,4,25605,11869,13736
50,12,73,Florida,Leon County,6,5,44334,21492,22842
50,12,73,Florida,Leon County,6,6,13481,6666,6815
50,12,73,Florida,Leon County,6,7,16888,8349,8539
50,12,73,Florida,Leon County,6,8,15000,7215,7785
50,12,73,Florida,Leon County,6,9,16752,7859,8893
50,12,73,Florida,Leon County,6,10,16727,7828,8899
50,12,73,Florida,Leon County,6,11,15985,7502,8483
50,12,73,Florida,Leon County,6,12,12231,5998,6233
50,12,73,Florida,Leon County,6,13,8002,3764,4238
50,12,73,Florida,Leon County,6,14,5604,2612,2992
50,12,73,Florida,Leon County,6,15,4782,2151,2631
50,12,73,Florida,Leon County,6,16,4218,1668,2550
50,12,73,Florida,Leon County,6,17,3334,1247,2087
50,12,73,Florida,Leon County,6,18,2734,763,1971
50,12,73,Florida,Leon County,7,0,250863,120072,130791
50,12,73,Florida,Leon County,7,1,14976,7605,7371
50,12,73,Florida,Leon County,7,2,13512,6836,6676
50,12,73,Florida,Leon County,7,3,14403,7364,7039
50,12,73,Florida,Leon County,7,4,25153,11723,13430
50,12,73,Florida,Leon County,7,5,46927,22805,24122
50,12,73,Florida,Leon County,7,6,12103,5990,6113
50,12,73,Florida,Leon County,7,7,16945,8323,8622
50,12,73,Florida,Leon County,7,8,14929,7305,7624
50,12,73,Florida,Leon County,7,9,16614,7790,8824
50,12,73,Florida,Leon County,7,10,16652,7770,8882
50,12,73,Florida,Leon County,7,11,16197,7626,8571
50,12,73,Florida,Leon County,7,12,13044,6323,6721
50,12,73,Florida,Leon County,7,13,8406,3992,4414
50,12,73,Florida,Leon County,7,14,5755,2652,3103
50,12,73,Florida,Leon County,7,15,4675,2140,2535
50,12,73,Florida,Leon County,7,16,4256,1760,2496
50,12,73,Florida,Leon County,7,17,3431,1222,2209
50,12,73,Florida,Leon County,7,18,2885,846,2039
50,12,73,Florida,Leon County,8,0,253978,121698,132280
50,12,73,Florida,Leon County,8,1,15269,7758,7511
50,12,73,Florida,Leon County,8,2,13747,6982,6765
50,12,73,Florida,Leon County,8,3,14130,7164,6966
50,12,73,Florida,Leon County,8,4,24799,11585,13214
50,12,73,Florida,Leon County,8,5,49386,23819,25567
50,12,73,Florida,Leon County,8,6,10924,5606,5318
50,12,73,Florida,Leon County,8,7,17073,8442,8631
50,12,73,Florida,Leon County,8,8,15151,7415,7736
50,12,73,Florida,Leon County,8,9,16129,7591,8538
50,12,73,Florida,Leon County,8,10,16887,7913,8974
50,12,73,Florida,Leon County,8,11,16143,7534,8609
50,12,73,Florida,Leon County,8,12,13890,6721,7169
50,12,73,Florida,Leon County,8,13,8966,4296,4670
50,12,73,Florida,Leon County,8,14,5883,2734,3149
50,12,73,Florida,Leon County,8,15,4699,2144,2555
50,12,73,Florida,Leon County,8,16,4341,1823,2518
50,12,73,Florida,Leon County,8,17,3451,1256,2195
50,12,73,Florida,Leon County,8,18,3110,915,2195
50,12,73,Florida,Leon County,9,0,258104,123595,134509
50,12,73,Florida,Leon County,9,1,15444,7837,7607
50,12,73,Florida,Leon County,9,2,14029,7097,6932
50,12,73,Florida,Leon County,9,3,13711,6987,6724
50,12,73,Florida,Leon County,9,4,25300,11739,13561
50,12,73,Florida,Leon County,9,5,51817,24927,26890
50,12,73,Florida,Leon County,9,6,12216,6370,5846
50,12,73,Florida,Leon County,9,7,15005,7372,7633
50,12,73,Florida,Leon County,9,8,15553,7632,7921
50,12,73,Florida,Leon County,9,9,15579,7352,8227
50,12,73,Florida,Leon County,9,10,16831,7853,8978
50,12,73,Florida,Leon County,9,11,16231,7545,8686
50,12,73,Florida,Leon County,9,12,14774,7098,7676
50,12,73,Florida,Leon County,9,13,9476,4595,4881
50,12,73,Florida,Leon County,9,14,6214,2881,3333
50,12,73,Florida,Leon County,9,15,4844,2231,2613
50,12,73,Florida,Leon County,9,16,4278,1795,2483
50,12,73,Florida,Leon County,9,17,3461,1234,2227
50,12,73,Florida,Leon County,9,18,3341,1050,2291
50,12,73,Florida,Leon County,10,0,262720,125673,137047
50,12,73,Florida,Leon County,10,1,15684,7885,7799
50,12,73,Florida,Leon County,10,2,14155,7187,6968
50,12,73,Florida,Leon County,10,3,13664,6922,6742
50,12,73,Florida,Leon County,10,4,26397,12179,14218
50,12,73,Florida,Leon County,10,5,52621,25343,27278
50,12,73,Florida,Leon County,10,6,14745,7537,7208
50,12,73,Florida,Leon County,10,7,13196,6509,6687
50,12,73,Florida,Leon County,10,8,15941,7824,8117
50,12,73,Florida,Leon County,10,9,15127,7243,7884
50,12,73,Florida,Leon County,10,10,16711,7784,8927
50,12,73,Florida,Leon County,10,11,16260,7540,8720
50,12,73,Florida,Leon County,10,12,14923,7107,7816
50,12,73,Florida,Leon County,10,13,10547,5075,5472
50,12,73,Florida,Leon County,10,14,6586,3102,3484
50,12,73,Florida,Leon County,10,15,4876,2232,2644
50,12,73,Florida,Leon County,10,16,4202,1798,2404
50,12,73,Florida,Leon County,10,17,3538,1301,2237
50,12,73,Florida,Leon County,10,18,3547,1105,2442
50,12,73,Florida,Leon County,11,0,264597,126469,138128
50,12,73,Florida,Leon County,11,1,15571,7824,7747
50,12,73,Florida,Leon County,11,2,14341,7275,7066
50,12,73,Florida,Leon County,11,3,13619,6874,6745
50,12,73,Florida,Leon County,11,4,26253,12104,14149
50,12,73,Florida,Leon County,11,5,52638,25311,27327
50,12,73,Florida,Leon County,11,6,17925,9103,8822
50,12,73,Florida,Leon County,11,7,11073,5381,5692
50,12,73,Florida,Leon County,11,8,15776,7752,8024
50,12,73,Florida,Leon County,11,9,14742,7111,7631
50,12,73,Florida,Leon County,11,10,16451,7702,8749
50,12,73,Florida,Leon County,11,11,16243,7564,8679
50,12,73,Florida,Leon County,11,12,15127,7066,8061
50,12,73,Florida,Leon County,11,13,11250,5464,5786
50,12,73,Florida,Leon County,11,14,7098,3285,3813
50,12,73,Florida,Leon County,11,15,4930,2277,2653
50,12,73,Florida,Leon County,11,16,4285,1880,2405
50,12,73,Florida,Leon County,11,17,3567,1334,2233
50,12,73,Florida,Leon County,11,18,3708,1162,2546
50,12,73,Florida,Leon County,12,0,265714,126890,138824
50,12,73,Florida,Leon County,12,1,15771,7931,7840
50,12,73,Florida,Leon County,12,2,14480,7342,7138
50,12,73,Florida,Leon County,12,3,13452,6789,6663
50,12,73,Florida,Leon County,12,4,26118,11999,14119
50,12,73,Florida,Leon County,12,5,52295,25124,27171
50,12,73,Florida,Leon County,12,6,20439,10244,10195
50,12,73,Florida,Leon County,12,7,9265,4488,4777
50,12,73,Florida,Leon County,12,8,15576,7599,7977
50,12,73,Florida,Leon County,12,9,14511,7136,7375
50,12,73,Florida,Leon County,12,10,16047,7502,8545
50,12,73,Florida,Leon County,12,11,16115,7484,8631
50,12,73,Florida,Leon County,12,12,15311,7173,8138
50,12,73,Florida,Leon County,12,13,12005,5753,6252
50,12,73,Florida,Leon County,12,14,7541,3538,4003
50,12,73,Florida,Leon County,12,15,5067,2303,2764
50,12,73,Florida,Leon County,12,16,4166,1867,2299
50,12,73,Florida,Leon County,12,17,3657,1437,2220
50,12,73,Florida,Leon County,12,18,3898,1181,2717
50,12,75,Florida,Levy County,1,0,34450,16690,17760
50,12,75,Florida,Levy County,1,1,1975,1036,939
50,12,75,Florida,Levy County,1,2,2228,1137,1091
50,12,75,Florida,Levy County,1,3,2392,1211,1181
50,12,75,Florida,Levy County,1,4,2346,1186,1160
50,12,75,Florida,Levy County,1,5,1559,782,777
50,12,75,Florida,Levy County,1,6,1753,817,936
50,12,75,Florida,Levy County,1,7,1988,902,1086
50,12,75,Florida,Levy County,1,8,2381,1113,1268
50,12,75,Florida,Levy County,1,9,2503,1114,1389
50,12,75,Florida,Levy County,1,10,2370,1140,1230
50,12,75,Florida,Levy County,1,11,2358,1104,1254
50,12,75,Florida,Levy County,1,12,2250,1087,1163
50,12,75,Florida,Levy County,1,13,2175,1093,1082
50,12,75,Florida,Levy County,1,14,1837,939,898
50,12,75,Florida,Levy County,1,15,1719,886,833
50,12,75,Florida,Levy County,1,16,1315,589,726
50,12,75,Florida,Levy County,1,17,768,356,412
50,12,75,Florida,Levy County,1,18,533,198,335
50,12,75,Florida,Levy County,2,0,34450,16690,17760
50,12,75,Florida,Levy County,2,1,1975,1036,939
50,12,75,Florida,Levy County,2,2,2228,1137,1091
50,12,75,Florida,Levy County,2,3,2392,1211,1181
50,12,75,Florida,Levy County,2,4,2346,1186,1160
50,12,75,Florida,Levy County,2,5,1559,782,777
50,12,75,Florida,Levy County,2,6,1753,817,936
50,12,75,Florida,Levy County,2,7,1988,902,1086
50,12,75,Florida,Levy County,2,8,2381,1113,1268
50,12,75,Florida,Levy County,2,9,2503,1114,1389
50,12,75,Florida,Levy County,2,10,2370,1140,1230
50,12,75,Florida,Levy County,2,11,2358,1104,1254
50,12,75,Florida,Levy County,2,12,2250,1087,1163
50,12,75,Florida,Levy County,2,13,2175,1093,1082
50,12,75,Florida,Levy County,2,14,1837,939,898
50,12,75,Florida,Levy County,2,15,1719,886,833
50,12,75,Florida,Levy County,2,16,1315,589,726
50,12,75,Florida,Levy County,2,17,768,356,412
50,12,75,Florida,Levy County,2,18,533,198,335
50,12,75,Florida,Levy County,3,0,34617,16776,17841
50,12,75,Florida,Levy County,3,1,1983,1039,944
50,12,75,Florida,Levy County,3,2,2223,1134,1089
50,12,75,Florida,Levy County,3,3,2408,1219,1189
50,12,75,Florida,Levy County,3,4,2359,1193,1166
50,12,75,Florida,Levy County,3,5,1581,794,787
50,12,75,Florida,Levy County,3,6,1744,813,931
50,12,75,Florida,Levy County,3,7,1991,904,1087
50,12,75,Florida,Levy County,3,8,2376,1110,1266
50,12,75,Florida,Levy County,3,9,2515,1120,1395
50,12,75,Florida,Levy County,3,10,2389,1149,1240
50,12,75,Florida,Levy County,3,11,2389,1119,1270
50,12,75,Florida,Levy County,3,12,2267,1096,1171
50,12,75,Florida,Levy County,3,13,2188,1100,1088
50,12,75,Florida,Levy County,3,14,1839,941,898
50,12,75,Florida,Levy County,3,15,1724,889,835
50,12,75,Florida,Levy County,3,16,1323,593,730
50,12,75,Florida,Levy County,3,17,778,362,416
50,12,75,Florida,Levy County,3,18,540,201,339
50,12,75,Florida,Levy County,4,0,34927,16913,18014
50,12,75,Florida,Levy County,4,1,1979,1028,951
50,12,75,Florida,Levy County,4,2,2178,1105,1073
50,12,75,Florida,Levy County,4,3,2471,1257,1214
50,12,75,Florida,Levy County,4,4,2325,1195,1130
50,12,75,Florida,Levy County,4,5,1701,853,848
50,12,75,Florida,Levy County,4,6,1644,759,885
50,12,75,Florida,Levy County,4,7,1960,903,1057
50,12,75,Florida,Levy County,4,8,2369,1099,1270
50,12,75,Florida,Levy County,4,9,2558,1156,1402
50,12,75,Florida,Levy County,4,10,2505,1177,1328
50,12,75,Florida,Levy County,4,11,2477,1183,1294
50,12,75,Florida,Levy County,4,12,2299,1076,1223
50,12,75,Florida,Levy County,4,13,2233,1120,1113
50,12,75,Florida,Levy County,4,14,1853,939,914
50,12,75,Florida,Levy County,4,15,1713,888,825
50,12,75,Florida,Levy County,4,16,1314,600,714
50,12,75,Florida,Levy County,4,17,793,359,434
50,12,75,Florida,Levy County,4,18,555,216,339
50,12,75,Florida,Levy County,5,0,35586,17239,18347
50,12,75,Florida,Levy County,5,1,2037,1064,973
50,12,75,Florida,Levy County,5,2,2129,1069,1060
50,12,75,Florida,Levy County,5,3,2497,1277,1220
50,12,75,Florida,Levy County,5,4,2321,1209,1112
50,12,75,Florida,Levy County,5,5,1844,910,934
50,12,75,Florida,Levy County,5,6,1634,758,876
50,12,75,Florida,Levy County,5,7,2009,949,1060
50,12,75,Florida,Levy County,5,8,2294,1029,1265
50,12,75,Florida,Levy County,5,9,2598,1227,1371
50,12,75,Florida,Levy County,5,10,2636,1236,1400
50,12,75,Florida,Levy County,5,11,2525,1176,1349
50,12,75,Florida,Levy County,5,12,2415,1142,1273
50,12,75,Florida,Levy County,5,13,2324,1145,1179
50,12,75,Florida,Levy County,5,14,1921,973,948
50,12,75,Florida,Levy County,5,15,1624,824,800
50,12,75,Florida,Levy County,5,16,1336,634,702
50,12,75,Florida,Levy County,5,17,863,378,485
50,12,75,Florida,Levy County,5,18,579,239,340
50,12,75,Florida,Levy County,6,0,35946,17442,18504
50,12,75,Florida,Levy County,6,1,2082,1070,1012
50,12,75,Florida,Levy County,6,2,2116,1092,1024
50,12,75,Florida,Levy County,6,3,2449,1252,1197
50,12,75,Florida,Levy County,6,4,2301,1184,1117
50,12,75,Florida,Levy County,6,5,1929,978,951
50,12,75,Florida,Levy County,6,6,1641,785,856
50,12,75,Florida,Levy County,6,7,2017,966,1051
50,12,75,Florida,Levy County,6,8,2248,1010,1238
50,12,75,Florida,Levy County,6,9,2651,1254,1397
50,12,75,Florida,Levy County,6,10,2640,1232,1408
50,12,75,Florida,Levy County,6,11,2605,1208,1397
50,12,75,Florida,Levy County,6,12,2472,1165,1307
50,12,75,Florida,Levy County,6,13,2429,1185,1244
50,12,75,Florida,Levy County,6,14,1925,968,957
50,12,75,Florida,Levy County,6,15,1586,794,792
50,12,75,Florida,Levy County,6,16,1395,685,710
50,12,75,Florida,Levy County,6,17,862,375,487
50,12,75,Florida,Levy County,6,18,598,239,359
50,12,75,Florida,Levy County,7,0,36729,17818,18911
50,12,75,Florida,Levy County,7,1,2124,1092,1032
50,12,75,Florida,Levy County,7,2,2161,1135,1026
50,12,75,Florida,Levy County,7,3,2429,1242,1187
50,12,75,Florida,Levy County,7,4,2343,1195,1148
50,12,75,Florida,Levy County,7,5,1975,1003,972
50,12,75,Florida,Levy County,7,6,1792,884,908
50,12,75,Florida,Levy County,7,7,2042,945,1097
50,12,75,Florida,Levy County,7,8,2188,983,1205
50,12,75,Florida,Levy County,7,9,2706,1279,1427
50,12,75,Florida,Levy County,7,10,2771,1301,1470
50,12,75,Florida,Levy County,7,11,2624,1207,1417
50,12,75,Florida,Levy County,7,12,2544,1204,1340
50,12,75,Florida,Levy County,7,13,2532,1218,1314
50,12,75,Florida,Levy County,7,14,2022,1009,1013
50,12,75,Florida,Levy County,7,15,1550,778,772
50,12,75,Florida,Levy County,7,16,1392,685,707
50,12,75,Florida,Levy County,7,17,875,390,485
50,12,75,Florida,Levy County,7,18,659,268,391
50,12,75,Florida,Levy County,8,0,37357,18121,19236
50,12,75,Florida,Levy County,8,1,2090,1084,1006
50,12,75,Florida,Levy County,8,2,2172,1137,1035
50,12,75,Florida,Levy County,8,3,2428,1238,1190
50,12,75,Florida,Levy County,8,4,2389,1226,1163
50,12,75,Florida,Levy County,8,5,2016,1019,997
50,12,75,Florida,Levy County,8,6,1891,938,953
50,12,75,Florida,Levy County,8,7,1938,904,1034
50,12,75,Florida,Levy County,8,8,2192,997,1195
50,12,75,Florida,Levy County,8,9,2728,1307,1421
50,12,75,Florida,Levy County,8,10,2816,1274,1542
50,12,75,Florida,Levy County,8,11,2728,1302,1426
50,12,75,Florida,Levy County,8,12,2725,1264,1461
50,12,75,Florida,Levy County,8,13,2536,1213,1323
50,12,75,Florida,Levy County,8,14,2112,1044,1068
50,12,75,Florida,Levy County,8,15,1597,792,805
50,12,75,Florida,Levy County,8,16,1372,691,681
50,12,75,Florida,Levy County,8,17,943,399,544
50,12,75,Florida,Levy County,8,18,684,292,392
50,12,75,Florida,Levy County,9,0,38240,18536,19704
50,12,75,Florida,Levy County,9,1,2194,1145,1049
50,12,75,Florida,Levy County,9,2,2227,1155,1072
50,12,75,Florida,Levy County,9,3,2430,1231,1199
50,12,75,Florida,Levy County,9,4,2482,1283,1199
50,12,75,Florida,Levy County,9,5,2018,1039,979
50,12,75,Florida,Levy County,9,6,2076,1026,1050
50,12,75,Florida,Levy County,9,7,1898,882,1016
50,12,75,Florida,Levy County,9,8,2225,1026,1199
50,12,75,Florida,Levy County,9,9,2676,1272,1404
50,12,75,Florida,Levy County,9,10,2897,1332,1565
50,12,75,Florida,Levy County,9,11,2862,1339,1523
50,12,75,Florida,Levy County,9,12,2843,1338,1505
50,12,75,Florida,Levy County,9,13,2602,1210,1392
50,12,75,Florida,Levy County,9,14,2159,1059,1100
50,12,75,Florida,Levy County,9,15,1625,805,820
50,12,75,Florida,Levy County,9,16,1365,687,678
50,12,75,Florida,Levy County,9,17,964,413,551
50,12,75,Florida,Levy County,9,18,697,294,403
50,12,75,Florida,Levy County,10,0,38830,18836,19994
50,12,75,Florida,Levy County,10,1,2318,1200,1118
50,12,75,Florida,Levy County,10,2,2218,1157,1061
50,12,75,Florida,Levy County,10,3,2388,1199,1189
50,12,75,Florida,Levy County,10,4,2544,1323,1221
50,12,75,Florida,Levy County,10,5,1944,1021,923
50,12,75,Florida,Levy County,10,6,2230,1092,1138
50,12,75,Florida,Levy County,10,7,1877,874,1003
50,12,75,Florida,Levy County,10,8,2274,1073,1201
50,12,75,Florida,Levy County,10,9,2586,1197,1389
50,12,75,Florida,Levy County,10,10,2927,1396,1531
50,12,75,Florida,Levy County,10,11,2965,1388,1577
50,12,75,Florida,Levy County,10,12,2865,1316,1549
50,12,75,Florida,Levy County,10,13,2683,1260,1423
50,12,75,Florida,Levy County,10,14,2298,1101,1197
50,12,75,Florida,Levy County,10,15,1640,818,822
50,12,75,Florida,Levy County,10,16,1291,630,661
50,12,75,Florida,Levy County,10,17,1014,457,557
50,12,75,Florida,Levy County,10,18,768,334,434
50,12,75,Florida,Levy County,11,0,39199,19037,20162
50,12,75,Florida,Levy County,11,1,2371,1226,1145
50,12,75,Florida,Levy County,11,2,2246,1155,1091
50,12,75,Florida,Levy County,11,3,2349,1208,1141
50,12,75,Florida,Levy County,11,4,2497,1301,1196
50,12,75,Florida,Levy County,11,5,2026,1036,990
50,12,75,Florida,Levy County,11,6,2274,1146,1128
50,12,75,Florida,Levy County,11,7,1900,911,989
50,12,75,Florida,Levy County,11,8,2258,1072,1186
50,12,75,Florida,Levy County,11,9,2423,1116,1307
50,12,75,Florida,Levy County,11,10,2981,1422,1559
50,12,75,Florida,Levy County,11,11,3037,1420,1617
50,12,75,Florida,Levy County,11,12,2895,1321,1574
50,12,75,Florida,Levy County,11,13,2785,1303,1482
50,12,75,Florida,Levy County,11,14,2407,1141,1266
50,12,75,Florida,Levy County,11,15,1641,818,823
50,12,75,Florida,Levy County,11,16,1267,609,658
50,12,75,Florida,Levy County,11,17,1068,498,570
50,12,75,Florida,Levy County,11,18,774,334,440
50,12,75,Florida,Levy County,12,0,39147,18987,20160
50,12,75,Florida,Levy County,12,1,2413,1243,1170
50,12,75,Florida,Levy County,12,2,2203,1133,1070
50,12,75,Florida,Levy County,12,3,2295,1201,1094
50,12,75,Florida,Levy County,12,4,2452,1271,1181
50,12,75,Florida,Levy County,12,5,2010,1028,982
50,12,75,Florida,Levy County,12,6,2272,1137,1135
50,12,75,Florida,Levy County,12,7,1938,953,985
50,12,75,Florida,Levy County,12,8,2215,1021,1194
50,12,75,Florida,Levy County,12,9,2302,1065,1237
50,12,75,Florida,Levy County,12,10,2954,1410,1544
50,12,75,Florida,Levy County,12,11,3082,1445,1637
50,12,75,Florida,Levy County,12,12,2900,1319,1581
50,12,75,Florida,Levy County,12,13,2835,1327,1508
50,12,75,Florida,Levy County,12,14,2436,1140,1296
50,12,75,Florida,Levy County,12,15,1743,853,890
50,12,75,Florida,Levy County,12,16,1264,610,654
50,12,75,Florida,Levy County,12,17,1035,487,548
50,12,75,Florida,Levy County,12,18,798,344,454
50,12,77,Florida,Liberty County,1,0,7021,4154,2867
50,12,77,Florida,Liberty County,1,1,384,200,184
50,12,77,Florida,Liberty County,1,2,414,218,196
50,12,77,Florida,Liberty County,1,3,437,214,223
50,12,77,Florida,Liberty County,1,4,461,240,221
50,12,77,Florida,Liberty County,1,5,493,317,176
50,12,77,Florida,Liberty County,1,6,672,499,173
50,12,77,Florida,Liberty County,1,7,644,458,186
50,12,77,Florida,Liberty County,1,8,681,456,225
50,12,77,Florida,Liberty County,1,9,647,420,227
50,12,77,Florida,Liberty County,1,10,446,261,185
50,12,77,Florida,Liberty County,1,11,404,221,183
50,12,77,Florida,Liberty County,1,12,327,173,154
50,12,77,Florida,Liberty County,1,13,295,148,147
50,12,77,Florida,Liberty County,1,14,233,115,118
50,12,77,Florida,Liberty County,1,15,203,98,105
50,12,77,Florida,Liberty County,1,16,142,67,75
50,12,77,Florida,Liberty County,1,17,81,27,54
50,12,77,Florida,Liberty County,1,18,57,22,35
50,12,77,Florida,Liberty County,2,0,7021,4154,2867
50,12,77,Florida,Liberty County,2,1,384,200,184
50,12,77,Florida,Liberty County,2,2,414,218,196
50,12,77,Florida,Liberty County,2,3,437,214,223
50,12,77,Florida,Liberty County,2,4,461,240,221
50,12,77,Florida,Liberty County,2,5,493,317,176
50,12,77,Florida,Liberty County,2,6,672,499,173
50,12,77,Florida,Liberty County,2,7,644,458,186
50,12,77,Florida,Liberty County,2,8,681,456,225
50,12,77,Florida,Liberty County,2,9,647,420,227
50,12,77,Florida,Liberty County,2,10,446,261,185
50,12,77,Florida,Liberty County,2,11,404,221,183
50,12,77,Florida,Liberty County,2,12,327,173,154
50,12,77,Florida,Liberty County,2,13,295,148,147
50,12,77,Florida,Liberty County,2,14,233,115,118
50,12,77,Florida,Liberty County,2,15,203,98,105
50,12,77,Florida,Liberty County,2,16,142,67,75
50,12,77,Florida,Liberty County,2,17,81,27,54
50,12,77,Florida,Liberty County,2,18,57,22,35
50,12,77,Florida,Liberty County,3,0,6996,4143,2853
50,12,77,Florida,Liberty County,3,1,382,199,183
50,12,77,Florida,Liberty County,3,2,409,215,194
50,12,77,Florida,Liberty County,3,3,436,214,222
50,12,77,Florida,Liberty County,3,4,460,240,220
50,12,77,Florida,Liberty County,3,5,494,318,176
50,12,77,Florida,Liberty County,3,6,667,497,170
50,12,77,Florida,Liberty County,3,7,641,457,184
50,12,77,Florida,Liberty County,3,8,677,454,223
50,12,77,Florida,Liberty County,3,9,642,417,225
50,12,77,Florida,Liberty County,3,10,446,261,185
50,12,77,Florida,Liberty County,3,11,402,220,182
50,12,77,Florida,Liberty County,3,12,325,172,153
50,12,77,Florida,Liberty County,3,13,295,148,147
50,12,77,Florida,Liberty County,3,14,233,115,118
50,12,77,Florida,Liberty County,3,15,204,99,105
50,12,77,Florida,Liberty County,3,16,142,67,75
50,12,77,Florida,Liberty County,3,17,82,27,55
50,12,77,Florida,Liberty County,3,18,59,23,36
50,12,77,Florida,Liberty County,4,0,7005,4130,2875
50,12,77,Florida,Liberty County,4,1,411,213,198
50,12,77,Florida,Liberty County,4,2,409,216,193
50,12,77,Florida,Liberty County,4,3,416,213,203
50,12,77,Florida,Liberty County,4,4,458,231,227
50,12,77,Florida,Liberty County,4,5,531,338,193
50,12,77,Florida,Liberty County,4,6,658,487,171
50,12,77,Florida,Liberty County,4,7,627,443,184
50,12,77,Florida,Liberty County,4,8,666,442,224
50,12,77,Florida,Liberty County,4,9,631,407,224
50,12,77,Florida,Liberty County,4,10,467,271,196
50,12,77,Florida,Liberty County,4,11,400,220,180
50,12,77,Florida,Liberty County,4,12,331,171,160
50,12,77,Florida,Liberty County,4,13,282,142,140
50,12,77,Florida,Liberty County,4,14,234,121,113
50,12,77,Florida,Liberty County,4,15,197,98,99
50,12,77,Florida,Liberty County,4,16,138,60,78
50,12,77,Florida,Liberty County,4,17,93,34,59
50,12,77,Florida,Liberty County,4,18,56,23,33
50,12,77,Florida,Liberty County,5,0,7141,4224,2917
50,12,77,Florida,Liberty County,5,1,433,223,210
50,12,77,Florida,Liberty County,5,2,418,221,197
50,12,77,Florida,Liberty County,5,3,424,222,202
50,12,77,Florida,Liberty County,5,4,457,227,230
50,12,77,Florida,Liberty County,5,5,555,349,206
50,12,77,Florida,Liberty County,5,6,677,511,166
50,12,77,Florida,Liberty County,5,7,638,451,187
50,12,77,Florida,Liberty County,5,8,664,441,223
50,12,77,Florida,Liberty County,5,9,641,423,218
50,12,77,Florida,Liberty County,5,10,503,289,214
50,12,77,Florida,Liberty County,5,11,379,209,170
50,12,77,Florida,Liberty County,5,12,342,177,165
50,12,77,Florida,Liberty County,5,13,280,140,140
50,12,77,Florida,Liberty County,5,14,238,120,118
50,12,77,Florida,Liberty County,5,15,195,93,102
50,12,77,Florida,Liberty County,5,16,152,67,85
50,12,77,Florida,Liberty County,5,17,81,36,45
50,12,77,Florida,Liberty County,5,18,64,25,39
50,12,77,Florida,Liberty County,6,0,7210,4284,2926
50,12,77,Florida,Liberty County,6,1,424,206,218
50,12,77,Florida,Liberty County,6,2,399,214,185
50,12,77,Florida,Liberty County,6,3,461,237,224
50,12,77,Florida,Liberty County,6,4,424,221,203
50,12,77,Florida,Liberty County,6,5,552,355,197
50,12,77,Florida,Liberty County,6,6,692,523,169
50,12,77,Florida,Liberty County,6,7,664,471,193
50,12,77,Florida,Liberty County,6,8,652,442,210
50,12,77,Florida,Liberty County,6,9,639,422,217
50,12,77,Florida,Liberty County,6,10,543,313,230
50,12,77,Florida,Liberty County,6,11,386,213,173
50,12,77,Florida,Liberty County,6,12,353,185,168
50,12,77,Florida,Liberty County,6,13,283,128,155
50,12,77,Florida,Liberty County,6,14,237,126,111
50,12,77,Florida,Liberty County,6,15,196,94,102
50,12,77,Florida,Liberty County,6,16,143,67,76
50,12,77,Florida,Liberty County,6,17,88,38,50
50,12,77,Florida,Liberty County,6,18,74,29,45
50,12,77,Florida,Liberty County,7,0,7292,4342,2950
50,12,77,Florida,Liberty County,7,1,430,202,228
50,12,77,Florida,Liberty County,7,2,424,229,195
50,12,77,Florida,Liberty County,7,3,430,226,204
50,12,77,Florida,Liberty County,7,4,436,222,214
50,12,77,Florida,Liberty County,7,5,545,359,186
50,12,77,Florida,Liberty County,7,6,706,533,173
50,12,77,Florida,Liberty County,7,7,693,496,197
50,12,77,Florida,Liberty County,7,8,643,444,199
50,12,77,Florida,Liberty County,7,9,652,425,227
50,12,77,Florida,Liberty County,7,10,526,302,224
50,12,77,Florida,Liberty County,7,11,415,232,183
50,12,77,Florida,Liberty County,7,12,348,175,173
50,12,77,Florida,Liberty County,7,13,290,143,147
50,12,77,Florida,Liberty County,7,14,251,122,129
50,12,77,Florida,Liberty County,7,15,178,87,91
50,12,77,Florida,Liberty County,7,16,158,75,83
50,12,77,Florida,Liberty County,7,17,100,41,59
50,12,77,Florida,Liberty County,7,18,67,29,38
50,12,77,Florida,Liberty County,8,0,7577,4569,3008
50,12,77,Florida,Liberty County,8,1,458,222,236
50,12,77,Florida,Liberty County,8,2,438,231,207
50,12,77,Florida,Liberty County,8,3,449,236,213
50,12,77,Florida,Liberty County,8,4,446,236,210
50,12,77,Florida,Liberty County,8,5,555,377,178
50,12,77,Florida,Liberty County,8,6,778,576,202
50,12,77,Florida,Liberty County,8,7,727,544,183
50,12,77,Florida,Liberty County,8,8,661,467,194
50,12,77,Florida,Liberty County,8,9,663,431,232
50,12,77,Florida,Liberty County,8,10,565,335,230
50,12,77,Florida,Liberty County,8,11,412,227,185
50,12,77,Florida,Liberty County,8,12,358,185,173
50,12,77,Florida,Liberty County,8,13,307,151,156
50,12,77,Florida,Liberty County,8,14,252,120,132
50,12,77,Florida,Liberty County,8,15,182,85,97
50,12,77,Florida,Liberty County,8,16,158,71,87
50,12,77,Florida,Liberty County,8,17,105,49,56
50,12,77,Florida,Liberty County,8,18,63,26,37
50,12,77,Florida,Liberty County,9,0,7729,4633,3096
50,12,77,Florida,Liberty County,9,1,498,245,253
50,12,77,Florida,Liberty County,9,2,493,256,237
50,12,77,Florida,Liberty County,9,3,435,231,204
50,12,77,Florida,Liberty County,9,4,429,231,198
50,12,77,Florida,Liberty County,9,5,559,371,188
50,12,77,Florida,Liberty County,9,6,824,599,225
50,12,77,Florida,Liberty County,9,7,732,543,189
50,12,77,Florida,Liberty County,9,8,657,460,197
50,12,77,Florida,Liberty County,9,9,633,414,219
50,12,77,Florida,Liberty County,9,10,575,339,236
50,12,77,Florida,Liberty County,9,11,440,246,194
50,12,77,Florida,Liberty County,9,12,366,190,176
50,12,77,Florida,Liberty County,9,13,307,147,160
50,12,77,Florida,Liberty County,9,14,250,116,134
50,12,77,Florida,Liberty County,9,15,192,94,98
50,12,77,Florida,Liberty County,9,16,161,74,87
50,12,77,Florida,Liberty County,9,17,108,44,64
50,12,77,Florida,Liberty County,9,18,70,33,37
50,12,77,Florida,Liberty County,10,0,7798,4649,3149
50,12,77,Florida,Liberty County,10,1,525,263,262
50,12,77,Florida,Liberty County,10,2,490,252,238
50,12,77,Florida,Liberty County,10,3,433,230,203
50,12,77,Florida,Liberty County,10,4,432,238,194
50,12,77,Florida,Liberty County,10,5,567,368,199
50,12,77,Florida,Liberty County,10,6,829,591,238
50,12,77,Florida,Liberty County,10,7,709,536,173
50,12,77,Florida,Liberty County,10,8,668,463,205
50,12,77,Florida,Liberty County,10,9,618,398,220
50,12,77,Florida,Liberty County,10,10,555,334,221
50,12,77,Florida,Liberty County,10,11,499,272,227
50,12,77,Florida,Liberty County,10,12,353,184,169
50,12,77,Florida,Liberty County,10,13,315,153,162
50,12,77,Florida,Liberty County,10,14,256,115,141
50,12,77,Florida,Liberty County,10,15,200,98,102
50,12,77,Florida,Liberty County,10,16,156,68,88
50,12,77,Florida,Liberty County,10,17,117,50,67
50,12,77,Florida,Liberty County,10,18,76,36,40
50,12,77,Florida,Liberty County,11,0,7966,4758,3208
50,12,77,Florida,Liberty County,11,1,533,278,255
50,12,77,Florida,Liberty County,11,2,513,251,262
50,12,77,Florida,Liberty County,11,3,443,238,205
50,12,77,Florida,Liberty County,11,4,464,253,211
50,12,77,Florida,Liberty County,11,5,550,369,181
50,12,77,Florida,Liberty County,11,6,827,599,228
50,12,77,Florida,Liberty County,11,7,754,558,196
50,12,77,Florida,Liberty County,11,8,686,473,213
50,12,77,Florida,Liberty County,11,9,614,400,214
50,12,77,Florida,Liberty County,11,10,546,329,217
50,12,77,Florida,Liberty County,11,11,515,283,232
50,12,77,Florida,Liberty County,11,12,366,191,175
50,12,77,Florida,Liberty County,11,13,320,159,161
50,12,77,Florida,Liberty County,11,14,260,104,156
50,12,77,Florida,Liberty County,11,15,214,110,104
50,12,77,Florida,Liberty County,11,16,158,74,84
50,12,77,Florida,Liberty County,11,17,123,55,68
50,12,77,Florida,Liberty County,11,18,80,34,46
50,12,77,Florida,Liberty County,12,0,7983,4775,3208
50,12,77,Florida,Liberty County,12,1,523,280,243
50,12,77,Florida,Liberty County,12,2,494,235,259
50,12,77,Florida,Liberty County,12,3,453,245,208
50,12,77,Florida,Liberty County,12,4,449,248,201
50,12,77,Florida,Liberty County,12,5,543,363,180
50,12,77,Florida,Liberty County,12,6,839,610,229
50,12,77,Florida,Liberty County,12,7,750,555,195
50,12,77,Florida,Liberty County,12,8,695,486,209
50,12,77,Florida,Liberty County,12,9,598,397,201
50,12,77,Florida,Liberty County,12,10,549,325,224
50,12,77,Florida,Liberty County,12,11,509,276,233
50,12,77,Florida,Liberty County,12,12,388,204,184
50,12,77,Florida,Liberty County,12,13,331,157,174
50,12,77,Florida,Liberty County,12,14,265,119,146
50,12,77,Florida,Liberty County,12,15,223,102,121
50,12,77,Florida,Liberty County,12,16,158,75,83
50,12,77,Florida,Liberty County,12,17,133,63,70
50,12,77,Florida,Liberty County,12,18,83,35,48
50,12,79,Florida,Madison County,1,0,18733,9710,9023
50,12,79,Florida,Madison County,1,1,1074,557,517
50,12,79,Florida,Madison County,1,2,1217,622,595
50,12,79,Florida,Madison County,1,3,1465,751,714
50,12,79,Florida,Madison County,1,4,1497,849,648
50,12,79,Florida,Madison County,1,5,1213,711,502
50,12,79,Florida,Madison County,1,6,1307,759,548
50,12,79,Florida,Madison County,1,7,1237,719,518
50,12,79,Florida,Madison County,1,8,1406,814,592
50,12,79,Florida,Madison County,1,9,1342,707,635
50,12,79,Florida,Madison County,1,10,1282,633,649
50,12,79,Florida,Madison County,1,11,1128,593,535
50,12,79,Florida,Madison County,1,12,934,448,486
50,12,79,Florida,Madison County,1,13,905,439,466
50,12,79,Florida,Madison County,1,14,734,350,384
50,12,79,Florida,Madison County,1,15,680,302,378
50,12,79,Florida,Madison County,1,16,556,205,351
50,12,79,Florida,Madison County,1,17,376,145,231
50,12,79,Florida,Madison County,1,18,380,106,274
50,12,79,Florida,Madison County,2,0,18733,9710,9023
50,12,79,Florida,Madison County,2,1,1074,557,517
50,12,79,Florida,Madison County,2,2,1217,622,595
50,12,79,Florida,Madison County,2,3,1465,751,714
50,12,79,Florida,Madison County,2,4,1497,849,648
50,12,79,Florida,Madison County,2,5,1213,711,502
50,12,79,Florida,Madison County,2,6,1307,759,548
50,12,79,Florida,Madison County,2,7,1237,719,518
50,12,79,Florida,Madison County,2,8,1406,814,592
50,12,79,Florida,Madison County,2,9,1342,707,635
50,12,79,Florida,Madison County,2,10,1282,633,649
50,12,79,Florida,Madison County,2,11,1128,593,535
50,12,79,Florida,Madison County,2,12,934,448,486
50,12,79,Florida,Madison County,2,13,905,439,466
50,12,79,Florida,Madison County,2,14,734,350,384
50,12,79,Florida,Madison County,2,15,680,302,378
50,12,79,Florida,Madison County,2,16,556,205,351
50,12,79,Florida,Madison County,2,17,376,145,231
50,12,79,Florida,Madison County,2,18,380,106,274
50,12,79,Florida,Madison County,3,0,18746,9718,9028
50,12,79,Florida,Madison County,3,1,1071,556,515
50,12,79,Florida,Madison County,3,2,1209,619,590
50,12,79,Florida,Madison County,3,3,1468,751,717
50,12,79,Florida,Madison County,3,4,1499,850,649
50,12,79,Florida,Madison County,3,5,1225,717,508
50,12,79,Florida,Madison County,3,6,1298,755,543
50,12,79,Florida,Madison County,3,7,1234,718,516
50,12,79,Florida,Madison County,3,8,1397,809,588
50,12,79,Florida,Madison County,3,9,1344,708,636
50,12,79,Florida,Madison County,3,10,1287,635,652
50,12,79,Florida,Madison County,3,11,1137,599,538
50,12,79,Florida,Madison County,3,12,937,450,487
50,12,79,Florida,Madison County,3,13,904,439,465
50,12,79,Florida,Madison County,3,14,734,351,383
50,12,79,Florida,Madison County,3,15,680,302,378
50,12,79,Florida,Madison County,3,16,559,205,354
50,12,79,Florida,Madison County,3,17,381,147,234
50,12,79,Florida,Madison County,3,18,382,107,275
50,12,79,Florida,Madison County,4,0,18828,9778,9050
50,12,79,Florida,Madison County,4,1,1120,587,533
50,12,79,Florida,Madison County,4,2,1121,571,550
50,12,79,Florida,Madison County,4,3,1468,751,717
50,12,79,Florida,Madison County,4,4,1500,846,654
50,12,79,Florida,Madison County,4,5,1276,755,521
50,12,79,Florida,Madison County,4,6,1245,734,511
50,12,79,Florida,Madison County,4,7,1269,749,520
50,12,79,Florida,Madison County,4,8,1343,769,574
50,12,79,Florida,Madison County,4,9,1330,698,632
50,12,79,Florida,Madison County,4,10,1309,656,653
50,12,79,Florida,Madison County,4,11,1222,636,586
50,12,79,Florida,Madison County,4,12,909,443,466
50,12,79,Florida,Madison County,4,13,908,427,481
50,12,79,Florida,Madison County,4,14,785,378,407
50,12,79,Florida,Madison County,4,15,668,302,366
50,12,79,Florida,Madison County,4,16,577,222,355
50,12,79,Florida,Madison County,4,17,383,144,239
50,12,79,Florida,Madison County,4,18,395,110,285
50,12,79,Florida,Madison County,5,0,18621,9681,8940
50,12,79,Florida,Madison County,5,1,1087,560,527
50,12,79,Florida,Madison County,5,2,1071,560,511
50,12,79,Florida,Madison County,5,3,1436,742,694
50,12,79,Florida,Madison County,5,4,1489,826,663
50,12,79,Florida,Madison County,5,5,1234,733,501
50,12,79,Florida,Madison County,5,6,1244,741,503
50,12,79,Florida,Madison County,5,7,1256,742,514
50,12,79,Florida,Madison County,5,8,1279,741,538
50,12,79,Florida,Madison County,5,9,1297,694,603
50,12,79,Florida,Madison County,5,10,1330,647,683
50,12,79,Florida,Madison County,5,11,1231,632,599
50,12,79,Florida,Madison County,5,12,972,495,477
50,12,79,Florida,Madison County,5,13,880,404,476
50,12,79,Florida,Madison County,5,14,805,396,409
50,12,79,Florida,Madison County,5,15,639,289,350
50,12,79,Florida,Madison County,5,16,581,220,361
50,12,79,Florida,Madison County,5,17,408,151,257
50,12,79,Florida,Madison County,5,18,382,108,274
50,12,79,Florida,Madison County,6,0,18619,9709,8910
50,12,79,Florida,Madison County,6,1,1152,581,571
50,12,79,Florida,Madison County,6,2,1035,542,493
50,12,79,Florida,Madison County,6,3,1341,688,653
50,12,79,Florida,Madison County,6,4,1456,814,642
50,12,79,Florida,Madison County,6,5,1266,747,519
50,12,79,Florida,Madison County,6,6,1273,789,484
50,12,79,Florida,Madison County,6,7,1279,759,520
50,12,79,Florida,Madison County,6,8,1244,729,515
50,12,79,Florida,Madison County,6,9,1282,686,596
50,12,79,Florida,Madison County,6,10,1304,648,656
50,12,79,Florida,Madison County,6,11,1250,615,635
50,12,79,Florida,Madison County,6,12,1017,531,486
50,12,79,Florida,Madison County,6,13,892,410,482
50,12,79,Florida,Madison County,6,14,788,390,398
50,12,79,Florida,Madison County,6,15,619,267,352
50,12,79,Florida,Madison County,6,16,588,242,346
50,12,79,Florida,Madison County,6,17,422,155,267
50,12,79,Florida,Madison County,6,18,411,116,295
50,12,79,Florida,Madison County,7,0,18859,9886,8973
50,12,79,Florida,Madison County,7,1,1179,603,576
50,12,79,Florida,Madison County,7,2,1051,541,510
50,12,79,Florida,Madison County,7,3,1276,677,599
50,12,79,Florida,Madison County,7,4,1501,826,675
50,12,79,Florida,Madison County,7,5,1349,784,565
50,12,79,Florida,Madison County,7,6,1256,806,450
50,12,79,Florida,Madison County,7,7,1292,768,524
50,12,79,Florida,Madison County,7,8,1266,746,520
50,12,79,Florida,Madison County,7,9,1316,716,600
50,12,79,Florida,Madison County,7,10,1256,637,619
50,12,79,Florida,Madison County,7,11,1278,615,663
50,12,79,Florida,Madison County,7,12,1095,575,520
50,12,79,Florida,Madison County,7,13,894,410,484
50,12,79,Florida,Madison County,7,14,796,395,401
50,12,79,Florida,Madison County,7,15,627,273,354
50,12,79,Florida,Madison County,7,16,576,240,336
50,12,79,Florida,Madison County,7,17,437,150,287
50,12,79,Florida,Madison County,7,18,414,124,290
50,12,79,Florida,Madison County,8,0,18801,9834,8967
50,12,79,Florida,Madison County,8,1,1190,607,583
50,12,79,Florida,Madison County,8,2,1071,561,510
50,12,79,Florida,Madison County,8,3,1194,630,564
50,12,79,Florida,Madison County,8,4,1445,788,657
50,12,79,Florida,Madison County,8,5,1326,801,525
50,12,79,Florida,Madison County,8,6,1304,807,497
50,12,79,Florida,Madison County,8,7,1273,762,511
50,12,79,Florida,Madison County,8,8,1213,704,509
50,12,79,Florida,Madison County,8,9,1363,753,610
50,12,79,Florida,Madison County,8,10,1239,623,616
50,12,79,Florida,Madison County,8,11,1298,624,674
50,12,79,Florida,Madison County,8,12,1115,576,539
50,12,79,Florida,Madison County,8,13,911,426,485
50,12,79,Florida,Madison County,8,14,805,385,420
50,12,79,Florida,Madison County,8,15,621,276,345
50,12,79,Florida,Madison County,8,16,554,238,316
50,12,79,Florida,Madison County,8,17,449,145,304
50,12,79,Florida,Madison County,8,18,430,128,302
50,12,79,Florida,Madison County,9,0,18981,9924,9057
50,12,79,Florida,Madison County,9,1,1179,597,582
50,12,79,Florida,Madison County,9,2,1145,604,541
50,12,79,Florida,Madison County,9,3,1138,598,540
50,12,79,Florida,Madison County,9,4,1430,779,651
50,12,79,Florida,Madison County,9,5,1340,806,534
50,12,79,Florida,Madison County,9,6,1351,836,515
50,12,79,Florida,Madison County,9,7,1220,734,486
50,12,79,Florida,Madison County,9,8,1256,734,522
50,12,79,Florida,Madison County,9,9,1312,711,601
50,12,79,Florida,Madison County,9,10,1268,637,631
50,12,79,Florida,Madison County,9,11,1305,638,667
50,12,79,Florida,Madison County,9,12,1212,622,590
50,12,79,Florida,Madison County,9,13,881,415,466
50,12,79,Florida,Madison County,9,14,856,402,454
50,12,79,Florida,Madison County,9,15,664,300,364
50,12,79,Florida,Madison County,9,16,532,231,301
50,12,79,Florida,Madison County,9,17,454,156,298
50,12,79,Florida,Madison County,9,18,438,124,314
50,12,79,Florida,Madison County,10,0,18977,9927,9050
50,12,79,Florida,Madison County,10,1,1221,617,604
50,12,79,Florida,Madison County,10,2,1162,602,560
50,12,79,Florida,Madison County,10,3,1112,598,514
50,12,79,Florida,Madison County,10,4,1381,762,619
50,12,79,Florida,Madison County,10,5,1310,779,531
50,12,79,Florida,Madison County,10,6,1343,837,506
50,12,79,Florida,Madison County,10,7,1261,762,499
50,12,79,Florida,Madison County,10,8,1234,723,511
50,12,79,Florida,Madison County,10,9,1261,692,569
50,12,79,Florida,Madison County,10,10,1239,634,605
50,12,79,Florida,Madison County,10,11,1301,616,685
50,12,79,Florida,Madison County,10,12,1257,632,625
50,12,79,Florida,Madison County,10,13,941,463,478
50,12,79,Florida,Madison County,10,14,844,386,458
50,12,79,Florida,Madison County,10,15,702,326,376
50,12,79,Florida,Madison County,10,16,522,228,294
50,12,79,Florida,Madison County,10,17,445,145,300
50,12,79,Florida,Madison County,10,18,441,125,316
50,12,79,Florida,Madison County,11,0,18961,9932,9029
50,12,79,Florida,Madison County,11,1,1258,644,614
50,12,79,Florida,Madison County,11,2,1143,581,562
50,12,79,Florida,Madison County,11,3,1080,580,500
50,12,79,Florida,Madison County,11,4,1338,740,598
50,12,79,Florida,Madison County,11,5,1321,782,539
50,12,79,Florida,Madison County,11,6,1342,833,509
50,12,79,Florida,Madison County,11,7,1281,800,481
50,12,79,Florida,Madison County,11,8,1230,725,505
50,12,79,Florida,Madison County,11,9,1214,671,543
50,12,79,Florida,Madison County,11,10,1225,624,601
50,12,79,Florida,Madison County,11,11,1285,624,661
50,12,79,Florida,Madison County,11,12,1233,591,642
50,12,79,Florida,Madison County,11,13,1005,511,494
50,12,79,Florida,Madison County,11,14,831,378,453
50,12,79,Florida,Madison County,11,15,711,332,379
50,12,79,Florida,Madison County,11,16,527,212,315
50,12,79,Florida,Madison County,11,17,448,166,282
50,12,79,Florida,Madison County,11,18,489,138,351
50,12,79,Florida,Madison County,12,0,18901,9946,8955
50,12,79,Florida,Madison County,12,1,1260,642,618
50,12,79,Florida,Madison County,12,2,1101,567,534
50,12,79,Florida,Madison County,12,3,1080,573,507
50,12,79,Florida,Madison County,12,4,1280,733,547
50,12,79,Florida,Madison County,12,5,1350,795,555
50,12,79,Florida,Madison County,12,6,1377,841,536
50,12,79,Florida,Madison County,12,7,1231,797,434
50,12,79,Florida,Madison County,12,8,1240,730,510
50,12,79,Florida,Madison County,12,9,1183,658,525
50,12,79,Florida,Madison County,12,10,1259,649,610
50,12,79,Florida,Madison County,12,11,1211,601,610
50,12,79,Florida,Madison County,12,12,1221,569,652
50,12,79,Florida,Madison County,12,13,1060,544,516
50,12,79,Florida,Madison County,12,14,862,393,469
50,12,79,Florida,Madison County,12,15,720,339,381
50,12,79,Florida,Madison County,12,16,535,221,314
50,12,79,Florida,Madison County,12,17,436,159,277
50,12,79,Florida,Madison County,12,18,495,135,360
50,12,81,Florida,Manatee County,1,0,264002,127549,136453
50,12,81,Florida,Manatee County,1,1,14902,7572,7330
50,12,81,Florida,Manatee County,1,2,15411,7887,7524
50,12,81,Florida,Manatee County,1,3,15625,8075,7550
50,12,81,Florida,Manatee County,1,4,14016,7407,6609
50,12,81,Florida,Manatee County,1,5,11896,6255,5641
50,12,81,Florida,Manatee County,1,6,13607,6815,6792
50,12,81,Florida,Manatee County,1,7,15415,7802,7613
50,12,81,Florida,Manatee County,1,8,17851,8907,8944
50,12,81,Florida,Manatee County,1,9,18190,9015,9175
50,12,81,Florida,Manatee County,1,10,16744,8124,8620
50,12,81,Florida,Manatee County,1,11,15833,7450,8383
50,12,81,Florida,Manatee County,1,12,14471,6723,7748
50,12,81,Florida,Manatee County,1,13,14394,6650,7744
50,12,81,Florida,Manatee County,1,14,15706,7326,8380
50,12,81,Florida,Manatee County,1,15,17316,7926,9390
50,12,81,Florida,Manatee County,1,16,14967,6731,8236
50,12,81,Florida,Manatee County,1,17,9923,4155,5768
50,12,81,Florida,Manatee County,1,18,7735,2729,5006
50,12,81,Florida,Manatee County,2,0,264006,127551,136455
50,12,81,Florida,Manatee County,2,1,14902,7572,7330
50,12,81,Florida,Manatee County,2,2,15411,7887,7524
50,12,81,Florida,Manatee County,2,3,15625,8075,7550
50,12,81,Florida,Manatee County,2,4,14016,7407,6609
50,12,81,Florida,Manatee County,2,5,11896,6255,5641
50,12,81,Florida,Manatee County,2,6,13607,6815,6792
50,12,81,Florida,Manatee County,2,7,15415,7802,7613
50,12,81,Florida,Manatee County,2,8,17851,8907,8944
50,12,81,Florida,Manatee County,2,9,18190,9015,9175
50,12,81,Florida,Manatee County,2,10,16744,8124,8620
50,12,81,Florida,Manatee County,2,11,15833,7450,8383
50,12,81,Florida,Manatee County,2,12,14471,6723,7748
50,12,81,Florida,Manatee County,2,13,14395,6650,7745
50,12,81,Florida,Manatee County,2,14,15707,7326,8381
50,12,81,Florida,Manatee County,2,15,17317,7927,9390
50,12,81,Florida,Manatee County,2,16,14967,6731,8236
50,12,81,Florida,Manatee County,2,17,9923,4155,5768
50,12,81,Florida,Manatee County,2,18,7736,2730,5006
50,12,81,Florida,Manatee County,3,0,265662,128402,137260
50,12,81,Florida,Manatee County,3,1,15011,7626,7385
50,12,81,Florida,Manatee County,3,2,15445,7906,7539
50,12,81,Florida,Manatee County,3,3,15784,8155,7629
50,12,81,Florida,Manatee County,3,4,14122,7463,6659
50,12,81,Florida,Manatee County,3,5,12073,6350,5723
50,12,81,Florida,Manatee County,3,6,13616,6823,6793
50,12,81,Florida,Manatee County,3,7,15510,7851,7659
50,12,81,Florida,Manatee County,3,8,17892,8930,8962
50,12,81,Florida,Manatee County,3,9,18344,9093,9251
50,12,81,Florida,Manatee County,3,10,16938,8219,8719
50,12,81,Florida,Manatee County,3,11,16084,7567,8517
50,12,81,Florida,Manatee County,3,12,14642,6803,7839
50,12,81,Florida,Manatee County,3,13,14525,6712,7813
50,12,81,Florida,Manatee County,3,14,15628,7291,8337
50,12,81,Florida,Manatee County,3,15,17273,7919,9354
50,12,81,Florida,Manatee County,3,16,14981,6743,8238
50,12,81,Florida,Manatee County,3,17,9998,4194,5804
50,12,81,Florida,Manatee County,3,18,7796,2757,5039
50,12,81,Florida,Manatee County,4,0,272034,131789,140245
50,12,81,Florida,Manatee County,4,1,15514,7951,7563
50,12,81,Florida,Manatee County,4,2,15643,8004,7639
50,12,81,Florida,Manatee County,4,3,16303,8392,7911
50,12,81,Florida,Manatee County,4,4,14366,7608,6758
50,12,81,Florida,Manatee County,4,5,12949,6761,6188
50,12,81,Florida,Manatee County,4,6,13424,6803,6621
50,12,81,Florida,Manatee County,4,7,15871,7974,7897
50,12,81,Florida,Manatee County,4,8,17712,8907,8805
50,12,81,Florida,Manatee County,4,9,19153,9466,9687
50,12,81,Florida,Manatee County,4,10,17871,8723,9148
50,12,81,Florida,Manatee County,4,11,17135,8052,9083
50,12,81,Florida,Manatee County,4,12,15376,7189,8187
50,12,81,Florida,Manatee County,4,13,14906,6840,8066
50,12,81,Florida,Manatee County,4,14,15364,7189,8175
50,12,81,Florida,Manatee County,4,15,16901,7805,9096
50,12,81,Florida,Manatee County,4,16,15153,6857,8296
50,12,81,Florida,Manatee County,4,17,10390,4393,5997
50,12,81,Florida,Manatee County,4,18,8003,2875,5128
50,12,81,Florida,Manatee County,5,0,279448,135575,143873
50,12,81,Florida,Manatee County,5,1,16172,8216,7956
50,12,81,Florida,Manatee County,5,2,15806,8040,7766
50,12,81,Florida,Manatee County,5,3,16740,8650,8090
50,12,81,Florida,Manatee County,5,4,14645,7759,6886
50,12,81,Florida,Manatee County,5,5,13744,7158,6586
50,12,81,Florida,Manatee County,5,6,13837,7038,6799
50,12,81,Florida,Manatee County,5,7,16275,8179,8096
50,12,81,Florida,Manatee County,5,8,17695,8955,8740
50,12,81,Florida,Manatee County,5,9,19588,9646,9942
50,12,81,Florida,Manatee County,5,10,18836,9203,9633
50,12,81,Florida,Manatee County,5,11,17563,8307,9256
50,12,81,Florida,Manatee County,5,12,16942,7946,8996
50,12,81,Florida,Manatee County,5,13,15604,7174,8430
50,12,81,Florida,Manatee County,5,14,15247,7102,8145
50,12,81,Florida,Manatee County,5,15,16443,7594,8849
50,12,81,Florida,Manatee County,5,16,15210,6958,8252
50,12,81,Florida,Manatee County,5,17,10715,4571,6144
50,12,81,Florida,Manatee County,5,18,8386,3079,5307
50,12,81,Florida,Manatee County,6,0,286175,139070,147105
50,12,81,Florida,Manatee County,6,1,16655,8484,8171
50,12,81,Florida,Manatee County,6,2,15974,8103,7871
50,12,81,Florida,Manatee County,6,3,17171,8880,8291
50,12,81,Florida,Manatee County,6,4,15342,8083,7259
50,12,81,Florida,Manatee County,6,5,14411,7518,6893
50,12,81,Florida,Manatee County,6,6,13889,7178,6711
50,12,81,Florida,Manatee County,6,7,16531,8289,8242
50,12,81,Florida,Manatee County,6,8,17615,8825,8790
50,12,81,Florida,Manatee County,6,9,19915,9884,10031
50,12,81,Florida,Manatee County,6,10,19614,9591,10023
50,12,81,Florida,Manatee County,6,11,18061,8589,9472
50,12,81,Florida,Manatee County,6,12,17728,8285,9443
50,12,81,Florida,Manatee County,6,13,16688,7739,8949
50,12,81,Florida,Manatee County,6,14,15513,7245,8268
50,12,81,Florida,Manatee County,6,15,15850,7298,8552
50,12,81,Florida,Manatee County,6,16,15315,7022,8293
50,12,81,Florida,Manatee County,6,17,11090,4767,6323
50,12,81,Florida,Manatee County,6,18,8813,3290,5523
50,12,81,Florida,Manatee County,7,0,294894,143584,151310
50,12,81,Florida,Manatee County,7,1,17279,8800,8479
50,12,81,Florida,Manatee County,7,2,16406,8304,8102
50,12,81,Florida,Manatee County,7,3,17388,8939,8449
50,12,81,Florida,Manatee County,7,4,16057,8500,7557
50,12,81,Florida,Manatee County,7,5,14939,7885,7054
50,12,81,Florida,Manatee County,7,6,14597,7537,7060
50,12,81,Florida,Manatee County,7,7,16585,8260,8325
50,12,81,Florida,Manatee County,7,8,17662,8890,8772
50,12,81,Florida,Manatee County,7,9,20435,10157,10278
50,12,81,Florida,Manatee County,7,10,20365,10010,10355
50,12,81,Florida,Manatee County,7,11,18928,9030,9898
50,12,81,Florida,Manatee County,7,12,19094,8931,10163
50,12,81,Florida,Manatee County,7,13,17672,8170,9502
50,12,81,Florida,Manatee County,7,14,15968,7449,8519
50,12,81,Florida,Manatee County,7,15,15479,7223,8256
50,12,81,Florida,Manatee County,7,16,15221,6976,8245
50,12,81,Florida,Manatee County,7,17,11584,5027,6557
50,12,81,Florida,Manatee County,7,18,9235,3496,5739
50,12,81,Florida,Manatee County,8,0,305054,148767,156287
50,12,81,Florida,Manatee County,8,1,18240,9268,8972
50,12,81,Florida,Manatee County,8,2,16977,8642,8335
50,12,81,Florida,Manatee County,8,3,17586,8989,8597
50,12,81,Florida,Manatee County,8,4,16743,8868,7875
50,12,81,Florida,Manatee County,8,5,15799,8311,7488
50,12,81,Florida,Manatee County,8,6,15574,8049,7525
50,12,81,Florida,Manatee County,8,7,16396,8220,8176
50,12,81,Florida,Manatee County,8,8,18275,9206,9069
50,12,81,Florida,Manatee County,8,9,20959,10431,10528
50,12,81,Florida,Manatee County,8,10,21211,10444,10767
50,12,81,Florida,Manatee County,8,11,19949,9523,10426
50,12,81,Florida,Manatee County,8,12,20362,9503,10859
50,12,81,Florida,Manatee County,8,13,18724,8716,10008
50,12,81,Florida,Manatee County,8,14,16142,7594,8548
50,12,81,Florida,Manatee County,8,15,15282,7111,8171
50,12,81,Florida,Manatee County,8,16,15114,6897,8217
50,12,81,Florida,Manatee County,8,17,11875,5201,6674
50,12,81,Florida,Manatee County,8,18,9846,3794,6052
50,12,81,Florida,Manatee County,9,0,311553,152223,159330
50,12,81,Florida,Manatee County,9,1,19091,9637,9454
50,12,81,Florida,Manatee County,9,2,17650,9048,8602
50,12,81,Florida,Manatee County,9,3,17635,9017,8618
50,12,81,Florida,Manatee County,9,4,17271,9110,8161
50,12,81,Florida,Manatee County,9,5,15925,8431,7494
50,12,81,Florida,Manatee County,9,6,16898,8699,8199
50,12,81,Florida,Manatee County,9,7,16191,8207,7984
50,12,81,Florida,Manatee County,9,8,18941,9515,9426
50,12,81,Florida,Manatee County,9,9,20618,10349,10269
50,12,81,Florida,Manatee County,9,10,21886,10767,11119
50,12,81,Florida,Manatee County,9,11,20538,9879,10659
50,12,81,Florida,Manatee County,9,12,21217,9893,11324
50,12,81,Florida,Manatee County,9,13,19299,9022,10277
50,12,81,Florida,Manatee County,9,14,16434,7666,8768
50,12,81,Florida,Manatee County,9,15,14827,6907,7920
50,12,81,Florida,Manatee County,9,16,14807,6772,8035
50,12,81,Florida,Manatee County,9,17,11869,5208,6661
50,12,81,Florida,Manatee County,9,18,10456,4096,6360
50,12,81,Florida,Manatee County,10,0,314027,153618,160409
50,12,81,Florida,Manatee County,10,1,19533,9935,9598
50,12,81,Florida,Manatee County,10,2,17777,9037,8740
50,12,81,Florida,Manatee County,10,3,17550,8927,8623
50,12,81,Florida,Manatee County,10,4,17517,9272,8245
50,12,81,Florida,Manatee County,10,5,16016,8498,7518
50,12,81,Florida,Manatee County,10,6,17436,9011,8425
50,12,81,Florida,Manatee County,10,7,16007,8150,7857
50,12,81,Florida,Manatee County,10,8,18981,9547,9434
50,12,81,Florida,Manatee County,10,9,20091,10168,9923
50,12,81,Florida,Manatee County,10,10,21793,10690,11103
50,12,81,Florida,Manatee County,10,11,21045,10157,10888
50,12,81,Florida,Manatee County,10,12,20779,9739,11040
50,12,81,Florida,Manatee County,10,13,20406,9536,10870
50,12,81,Florida,Manatee County,10,14,16892,7840,9052
50,12,81,Florida,Manatee County,10,15,14735,6828,7907
50,12,81,Florida,Manatee County,10,16,14428,6586,7842
50,12,81,Florida,Manatee County,10,17,12003,5338,6665
50,12,81,Florida,Manatee County,10,18,11038,4359,6679
50,12,81,Florida,Manatee County,11,0,316059,154616,161443
50,12,81,Florida,Manatee County,11,1,19872,10098,9774
50,12,81,Florida,Manatee County,11,2,17989,9168,8821
50,12,81,Florida,Manatee County,11,3,17200,8726,8474
50,12,81,Florida,Manatee County,11,4,17523,9262,8261
50,12,81,Florida,Manatee County,11,5,16090,8496,7594
50,12,81,Florida,Manatee County,11,6,17745,9188,8557
50,12,81,Florida,Manatee County,11,7,15803,8156,7647
50,12,81,Florida,Manatee County,11,8,18804,9427,9377
50,12,81,Florida,Manatee County,11,9,19720,9890,9830
50,12,81,Florida,Manatee County,11,10,21606,10690,10916
50,12,81,Florida,Manatee County,11,11,21384,10332,11052
50,12,81,Florida,Manatee County,11,12,20501,9658,10843
50,12,81,Florida,Manatee County,11,13,20835,9693,11142
50,12,81,Florida,Manatee County,11,14,18056,8416,9640
50,12,81,Florida,Manatee County,11,15,15049,6987,8062
50,12,81,Florida,Manatee County,11,16,13961,6335,7626
50,12,81,Florida,Manatee County,11,17,12237,5439,6798
50,12,81,Florida,Manatee County,11,18,11684,4655,7029
50,12,81,Florida,Manatee County,12,0,318361,155823,162538
50,12,81,Florida,Manatee County,12,1,19976,10174,9802
50,12,81,Florida,Manatee County,12,2,18363,9355,9008
50,12,81,Florida,Manatee County,12,3,17231,8724,8507
50,12,81,Florida,Manatee County,12,4,17231,9076,8155
50,12,81,Florida,Manatee County,12,5,16226,8598,7628
50,12,81,Florida,Manatee County,12,6,17725,9267,8458
50,12,81,Florida,Manatee County,12,7,16219,8358,7861
50,12,81,Florida,Manatee County,12,8,18255,9086,9169
50,12,81,Florida,Manatee County,12,9,19248,9684,9564
50,12,81,Florida,Manatee County,12,10,21677,10741,10936
50,12,81,Florida,Manatee County,12,11,21512,10456,11056
50,12,81,Florida,Manatee County,12,12,20644,9759,10885
50,12,81,Florida,Manatee County,12,13,21466,9973,11493
50,12,81,Florida,Manatee County,12,14,18801,8725,10076
50,12,81,Florida,Manatee County,12,15,15422,7150,8272
50,12,81,Florida,Manatee County,12,16,13840,6364,7476
50,12,81,Florida,Manatee County,12,17,12188,5382,6806
50,12,81,Florida,Manatee County,12,18,12337,4951,7386
50,12,83,Florida,Marion County,1,0,258916,124945,133971
50,12,83,Florida,Marion County,1,1,13488,6966,6522
50,12,83,Florida,Marion County,1,2,15313,7899,7414
50,12,83,Florida,Marion County,1,3,16756,8603,8153
50,12,83,Florida,Marion County,1,4,15419,7915,7504
50,12,83,Florida,Marion County,1,5,10941,5500,5441
50,12,83,Florida,Marion County,1,6,12349,6030,6319
50,12,83,Florida,Marion County,1,7,14086,6889,7197
50,12,83,Florida,Marion County,1,8,17298,8512,8786
50,12,83,Florida,Marion County,1,9,17954,8701,9253
50,12,83,Florida,Marion County,1,10,15831,7578,8253
50,12,83,Florida,Marion County,1,11,15431,7230,8201
50,12,83,Florida,Marion County,1,12,14908,6677,8231
50,12,83,Florida,Marion County,1,13,15654,7166,8488
50,12,83,Florida,Marion County,1,14,17303,8256,9047
50,12,83,Florida,Marion County,1,15,17986,8643,9343
50,12,83,Florida,Marion County,1,16,14400,6671,7729
50,12,83,Florida,Marion County,1,17,8356,3753,4603
50,12,83,Florida,Marion County,1,18,5443,1956,3487
50,12,83,Florida,Marion County,2,0,258914,124944,133970
50,12,83,Florida,Marion County,2,1,13488,6966,6522
50,12,83,Florida,Marion County,2,2,15313,7899,7414
50,12,83,Florida,Marion County,2,3,16756,8603,8153
50,12,83,Florida,Marion County,2,4,15419,7915,7504
50,12,83,Florida,Marion County,2,5,10941,5500,5441
50,12,83,Florida,Marion County,2,6,12349,6030,6319
50,12,83,Florida,Marion County,2,7,14086,6889,7197
50,12,83,Florida,Marion County,2,8,17298,8512,8786
50,12,83,Florida,Marion County,2,9,17954,8701,9253
50,12,83,Florida,Marion County,2,10,15831,7578,8253
50,12,83,Florida,Marion County,2,11,15431,7230,8201
50,12,83,Florida,Marion County,2,12,14908,6677,8231
50,12,83,Florida,Marion County,2,13,15653,7166,8487
50,12,83,Florida,Marion County,2,14,17302,8255,9047
50,12,83,Florida,Marion County,2,15,17986,8643,9343
50,12,83,Florida,Marion County,2,16,14400,6671,7729
50,12,83,Florida,Marion County,2,17,8356,3753,4603
50,12,83,Florida,Marion County,2,18,5443,1956,3487
50,12,83,Florida,Marion County,3,0,260285,125622,134663
50,12,83,Florida,Marion County,3,1,13538,6988,6550
50,12,83,Florida,Marion County,3,2,15291,7888,7403
50,12,83,Florida,Marion County,3,3,16879,8665,8214
50,12,83,Florida,Marion County,3,4,15498,7958,7540
50,12,83,Florida,Marion County,3,5,11082,5575,5507
50,12,83,Florida,Marion County,3,6,12310,6012,6298
50,12,83,Florida,Marion County,3,7,14126,6908,7218
50,12,83,Florida,Marion County,3,8,17289,8507,8782
50,12,83,Florida,Marion County,3,9,18053,8748,9305
50,12,83,Florida,Marion County,3,10,15973,7644,8329
50,12,83,Florida,Marion County,3,11,15646,7328,8318
50,12,83,Florida,Marion County,3,12,15052,6744,8308
50,12,83,Florida,Marion County,3,13,15755,7215,8540
50,12,83,Florida,Marion County,3,14,17302,8257,9045
50,12,83,Florida,Marion County,3,15,18032,8678,9354
50,12,83,Florida,Marion County,3,16,14492,6719,7773
50,12,83,Florida,Marion County,3,17,8462,3806,4656
50,12,83,Florida,Marion County,3,18,5505,1982,3523
50,12,83,Florida,Marion County,4,0,264393,127607,136786
50,12,83,Florida,Marion County,4,1,13941,7220,6721
50,12,83,Florida,Marion County,4,2,15079,7762,7317
50,12,83,Florida,Marion County,4,3,17090,8807,8283
50,12,83,Florida,Marion County,4,4,15666,8080,7586
50,12,83,Florida,Marion County,4,5,11851,5974,5877
50,12,83,Florida,Marion County,4,6,11886,5802,6084
50,12,83,Florida,Marion County,4,7,14262,6988,7274
50,12,83,Florida,Marion County,4,8,16918,8302,8616
50,12,83,Florida,Marion County,4,9,18330,8915,9415
50,12,83,Florida,Marion County,4,10,16609,7930,8679
50,12,83,Florida,Marion County,4,11,16308,7652,8656
50,12,83,Florida,Marion County,4,12,15630,7033,8597
50,12,83,Florida,Marion County,4,13,15880,7251,8629
50,12,83,Florida,Marion County,4,14,17111,8112,8999
50,12,83,Florida,Marion County,4,15,18013,8586,9427
50,12,83,Florida,Marion County,4,16,14882,6966,7916
50,12,83,Florida,Marion County,4,17,9109,4070,5039
50,12,83,Florida,Marion County,4,18,5828,2157,3671
50,12,83,Florida,Marion County,5,0,271261,131005,140256
50,12,83,Florida,Marion County,5,1,14561,7550,7011
50,12,83,Florida,Marion County,5,2,15129,7797,7332
50,12,83,Florida,Marion County,5,3,17468,9004,8464
50,12,83,Florida,Marion County,5,4,16074,8352,7722
50,12,83,Florida,Marion County,5,5,12812,6421,6391
50,12,83,Florida,Marion County,5,6,11873,5818,6055
50,12,83,Florida,Marion County,5,7,14570,7151,7419
50,12,83,Florida,Marion County,5,8,16781,8211,8570
50,12,83,Florida,Marion County,5,9,18697,9152,9545
50,12,83,Florida,Marion County,5,10,17376,8324,9052
50,12,83,Florida,Marion County,5,11,16473,7721,8752
50,12,83,Florida,Marion County,5,12,16877,7604,9273
50,12,83,Florida,Marion County,5,13,16695,7668,9027
50,12,83,Florida,Marion County,5,14,17137,8058,9079
50,12,83,Florida,Marion County,5,15,17847,8523,9324
50,12,83,Florida,Marion County,5,16,15012,6959,8053
50,12,83,Florida,Marion County,5,17,9737,4388,5349
50,12,83,Florida,Marion County,5,18,6142,2304,3838
50,12,83,Florida,Marion County,6,0,279156,135086,144070
50,12,83,Florida,Marion County,6,1,14822,7648,7174
50,12,83,Florida,Marion County,6,2,15287,7861,7426
50,12,83,Florida,Marion County,6,3,17594,9070,8524
50,12,83,Florida,Marion County,6,4,16526,8599,7927
50,12,83,Florida,Marion County,6,5,13756,6962,6794
50,12,83,Florida,Marion County,6,6,12133,6061,6072
50,12,83,Florida,Marion County,6,7,14799,7254,7545
50,12,83,Florida,Marion County,6,8,16528,8117,8411
50,12,83,Florida,Marion County,6,9,19093,9385,9708
50,12,83,Florida,Marion County,6,10,18128,8719,9409
50,12,83,Florida,Marion County,6,11,17062,7990,9072
50,12,83,Florida,Marion County,6,12,17838,8139,9699
50,12,83,Florida,Marion County,6,13,18486,8480,10006
50,12,83,Florida,Marion County,6,14,17703,8239,9464
50,12,83,Florida,Marion County,6,15,17597,8448,9149
50,12,83,Florida,Marion County,6,16,15270,7098,8172
50,12,83,Florida,Marion County,6,17,10111,4599,5512
50,12,83,Florida,Marion County,6,18,6423,2417,4006
50,12,83,Florida,Marion County,7,0,289817,140393,149424
50,12,83,Florida,Marion County,7,1,15306,7817,7489
50,12,83,Florida,Marion County,7,2,15538,8019,7519
50,12,83,Florida,Marion County,7,3,17658,9095,8563
50,12,83,Florida,Marion County,7,4,17109,8964,8145
50,12,83,Florida,Marion County,7,5,14705,7482,7223
50,12,83,Florida,Marion County,7,6,12872,6453,6419
50,12,83,Florida,Marion County,7,7,14928,7298,7630
50,12,83,Florida,Marion County,7,8,16613,8213,8400
50,12,83,Florida,Marion County,7,9,19449,9614,9835
50,12,83,Florida,Marion County,7,10,19070,9142,9928
50,12,83,Florida,Marion County,7,11,17735,8329,9406
50,12,83,Florida,Marion County,7,12,19330,8875,10455
50,12,83,Florida,Marion County,7,13,20428,9367,11061
50,12,83,Florida,Marion County,7,14,18852,8816,10036
50,12,83,Florida,Marion County,7,15,17399,8244,9155
50,12,83,Florida,Marion County,7,16,15425,7246,8179
50,12,83,Florida,Marion County,7,17,10526,4750,5776
50,12,83,Florida,Marion County,7,18,6874,2669,4205
50,12,83,Florida,Marion County,8,0,301714,146270,155444
50,12,83,Florida,Marion County,8,1,16236,8318,7918
50,12,83,Florida,Marion County,8,2,15907,8188,7719
50,12,83,Florida,Marion County,8,3,17820,9189,8631
50,12,83,Florida,Marion County,8,4,17864,9316,8548
50,12,83,Florida,Marion County,8,5,15412,7818,7594
50,12,83,Florida,Marion County,8,6,13861,7019,6842
50,12,83,Florida,Marion County,8,7,14916,7346,7570
50,12,83,Florida,Marion County,8,8,17062,8389,8673
50,12,83,Florida,Marion County,8,9,19719,9793,9926
50,12,83,Florida,Marion County,8,10,20156,9666,10490
50,12,83,Florida,Marion County,8,11,18667,8817,9850
50,12,83,Florida,Marion County,8,12,20538,9534,11004
50,12,83,Florida,Marion County,8,13,21795,9941,11854
50,12,83,Florida,Marion County,8,14,20000,9330,10670
50,12,83,Florida,Marion County,8,15,17718,8341,9377
50,12,83,Florida,Marion County,8,16,15704,7399,8305
50,12,83,Florida,Marion County,8,17,10836,4898,5938
50,12,83,Florida,Marion County,8,18,7503,2968,4535
50,12,83,Florida,Marion County,9,0,313964,152415,161549
50,12,83,Florida,Marion County,9,1,17104,8762,8342
50,12,83,Florida,Marion County,9,2,16729,8626,8103
50,12,83,Florida,Marion County,9,3,17987,9257,8730
50,12,83,Florida,Marion County,9,4,18546,9690,8856
50,12,83,Florida,Marion County,9,5,15982,8140,7842
50,12,83,Florida,Marion County,9,6,15332,7765,7567
50,12,83,Florida,Marion County,9,7,15045,7433,7612
50,12,83,Florida,Marion County,9,8,17706,8761,8945
50,12,83,Florida,Marion County,9,9,20184,10027,10157
50,12,83,Florida,Marion County,9,10,20946,10098,10848
50,12,83,Florida,Marion County,9,11,19532,9237,10295
50,12,83,Florida,Marion County,9,12,21713,10081,11632
50,12,83,Florida,Marion County,9,13,22752,10418,12334
50,12,83,Florida,Marion County,9,14,21127,9844,11283
50,12,83,Florida,Marion County,9,15,18121,8522,9599
50,12,83,Florida,Marion County,9,16,15857,7391,8466
50,12,83,Florida,Marion County,9,17,11265,5135,6130
50,12,83,Florida,Marion County,9,18,8036,3228,4808
50,12,83,Florida,Marion County,10,0,323032,157139,165893
50,12,83,Florida,Marion County,10,1,17788,9093,8695
50,12,83,Florida,Marion County,10,2,17421,8995,8426
50,12,83,Florida,Marion County,10,3,18076,9323,8753
50,12,83,Florida,Marion County,10,4,19111,9983,9128
50,12,83,Florida,Marion County,10,5,16532,8517,8015
50,12,83,Florida,Marion County,10,6,16512,8372,8140
50,12,83,Florida,Marion County,10,7,15155,7539,7616
50,12,83,Florida,Marion County,10,8,18343,9125,9218
50,12,83,Florida,Marion County,10,9,20204,10057,10147
50,12,83,Florida,Marion County,10,10,21409,10402,11007
50,12,83,Florida,Marion County,10,11,20409,9695,10714
50,12,83,Florida,Marion County,10,12,21637,10043,11594
50,12,83,Florida,Marion County,10,13,24147,11048,13099
50,12,83,Florida,Marion County,10,14,22262,10371,11891
50,12,83,Florida,Marion County,10,15,18224,8534,9690
50,12,83,Florida,Marion County,10,16,15772,7368,8404
50,12,83,Florida,Marion County,10,17,11404,5125,6279
50,12,83,Florida,Marion County,10,18,8626,3549,5077
50,12,83,Florida,Marion County,11,0,327172,159067,168105
50,12,83,Florida,Marion County,11,1,18337,9396,8941
50,12,83,Florida,Marion County,11,2,17644,9071,8573
50,12,83,Florida,Marion County,11,3,18234,9391,8843
50,12,83,Florida,Marion County,11,4,19094,9977,9117
50,12,83,Florida,Marion County,11,5,16770,8610,8160
50,12,83,Florida,Marion County,11,6,17225,8745,8480
50,12,83,Florida,Marion County,11,7,15148,7618,7530
50,12,83,Florida,Marion County,11,8,18243,9036,9207
50,12,83,Florida,Marion County,11,9,19622,9761,9861
50,12,83,Florida,Marion County,11,10,21694,10571,11123
50,12,83,Florida,Marion County,11,11,20957,9977,10980
50,12,83,Florida,Marion County,11,12,21383,9907,11476
50,12,83,Florida,Marion County,11,13,24106,11082,13024
50,12,83,Florida,Marion County,11,14,23708,10987,12721
50,12,83,Florida,Marion County,11,15,18665,8625,10040
50,12,83,Florida,Marion County,11,16,15656,7330,8326
50,12,83,Florida,Marion County,11,17,11706,5295,6411
50,12,83,Florida,Marion County,11,18,8980,3688,5292
50,12,83,Florida,Marion County,12,0,328547,159706,168841
50,12,83,Florida,Marion County,12,1,18525,9498,9027
50,12,83,Florida,Marion County,12,2,17646,8995,8651
50,12,83,Florida,Marion County,12,3,18142,9377,8765
50,12,83,Florida,Marion County,12,4,18744,9803,8941
50,12,83,Florida,Marion County,12,5,16702,8642,8060
50,12,83,Florida,Marion County,12,6,17677,8989,8688
50,12,83,Florida,Marion County,12,7,15283,7688,7595
50,12,83,Florida,Marion County,12,8,17880,8831,9049
50,12,83,Florida,Marion County,12,9,19176,9599,9577
50,12,83,Florida,Marion County,12,10,21575,10555,11020
50,12,83,Florida,Marion County,12,11,21174,10058,11116
50,12,83,Florida,Marion County,12,12,20931,9715,11216
50,12,83,Florida,Marion County,12,13,24264,11152,13112
50,12,83,Florida,Marion County,12,14,24748,11423,13325
50,12,83,Florida,Marion County,12,15,19471,8994,10477
50,12,83,Florida,Marion County,12,16,15482,7175,8307
50,12,83,Florida,Marion County,12,17,11807,5397,6410
50,12,83,Florida,Marion County,12,18,9320,3815,5505
50,12,85,Florida,Martin County,1,0,126731,62192,64539
50,12,85,Florida,Martin County,1,1,5599,2868,2731
50,12,85,Florida,Martin County,1,2,6804,3476,3328
50,12,85,Florida,Martin County,1,3,7188,3754,3434
50,12,85,Florida,Martin County,1,4,6130,3202,2928
50,12,85,Florida,Martin County,1,5,4626,2628,1998
50,12,85,Florida,Martin County,1,6,4988,2678,2310
50,12,85,Florida,Martin County,1,7,6291,3261,3030
50,12,85,Florida,Martin County,1,8,8556,4295,4261
50,12,85,Florida,Martin County,1,9,9180,4609,4571
50,12,85,Florida,Martin County,1,10,8358,4172,4186
50,12,85,Florida,Martin County,1,11,8169,4021,4148
50,12,85,Florida,Martin County,1,12,7581,3495,4086
50,12,85,Florida,Martin County,1,13,7475,3453,4022
50,12,85,Florida,Martin County,1,14,8670,4105,4565
50,12,85,Florida,Martin County,1,15,9289,4378,4911
50,12,85,Florida,Martin County,1,16,8509,3929,4580
50,12,85,Florida,Martin County,1,17,5382,2421,2961
50,12,85,Florida,Martin County,1,18,3936,1447,2489
50,12,85,Florida,Martin County,2,0,126731,62192,64539
50,12,85,Florida,Martin County,2,1,5599,2868,2731
50,12,85,Florida,Martin County,2,2,6804,3476,3328
50,12,85,Florida,Martin County,2,3,7188,3754,3434
50,12,85,Florida,Martin County,2,4,6130,3202,2928
50,12,85,Florida,Martin County,2,5,4626,2628,1998
50,12,85,Florida,Martin County,2,6,4988,2678,2310
50,12,85,Florida,Martin County,2,7,6291,3261,3030
50,12,85,Florida,Martin County,2,8,8556,4295,4261
50,12,85,Florida,Martin County,2,9,9180,4609,4571
50,12,85,Florida,Martin County,2,10,8358,4172,4186
50,12,85,Florida,Martin County,2,11,8169,4021,4148
50,12,85,Florida,Martin County,2,12,7581,3495,4086
50,12,85,Florida,Martin County,2,13,7475,3453,4022
50,12,85,Florida,Martin County,2,14,8670,4105,4565
50,12,85,Florida,Martin County,2,15,9289,4378,4911
50,12,85,Florida,Martin County,2,16,8509,3929,4580
50,12,85,Florida,Martin County,2,17,5382,2421,2961
50,12,85,Florida,Martin County,2,18,3936,1447,2489
50,12,85,Florida,Martin County,3,0,127160,62423,64737
50,12,85,Florida,Martin County,3,1,5613,2874,2739
50,12,85,Florida,Martin County,3,2,6786,3467,3319
50,12,85,Florida,Martin County,3,3,7223,3772,3451
50,12,85,Florida,Martin County,3,4,6149,3213,2936
50,12,85,Florida,Martin County,3,5,4674,2657,2017
50,12,85,Florida,Martin County,3,6,4971,2671,2300
50,12,85,Florida,Martin County,3,7,6297,3264,3033
50,12,85,Florida,Martin County,3,8,8537,4287,4250
50,12,85,Florida,Martin County,3,9,9211,4623,4588
50,12,85,Florida,Martin County,3,10,8414,4200,4214
50,12,85,Florida,Martin County,3,11,8257,4064,4193
50,12,85,Florida,Martin County,3,12,7634,3520,4114
50,12,85,Florida,Martin County,3,13,7503,3467,4036
50,12,85,Florida,Martin County,3,14,8651,4097,4554
50,12,85,Florida,Martin County,3,15,9287,4384,4903
50,12,85,Florida,Martin County,3,16,8539,3948,4591
50,12,85,Florida,Martin County,3,17,5437,2450,2987
50,12,85,Florida,Martin County,3,18,3977,1465,2512
50,12,85,Florida,Martin County,4,0,129149,63507,65642
50,12,85,Florida,Martin County,4,1,5813,2967,2846
50,12,85,Florida,Martin County,4,2,6649,3424,3225
50,12,85,Florida,Martin County,4,3,7460,3844,3616
50,12,85,Florida,Martin County,4,4,6364,3357,3007
50,12,85,Florida,Martin County,4,5,4839,2776,2063
50,12,85,Florida,Martin County,4,6,4763,2584,2179
50,12,85,Florida,Martin County,4,7,6240,3229,3011
50,12,85,Florida,Martin County,4,8,8434,4279,4155
50,12,85,Florida,Martin County,4,9,9449,4679,4770
50,12,85,Florida,Martin County,4,10,8594,4290,4304
50,12,85,Florida,Martin County,4,11,8757,4305,4452
50,12,85,Florida,Martin County,4,12,7868,3677,4191
50,12,85,Florida,Martin County,4,13,7743,3560,4183
50,12,85,Florida,Martin County,4,14,8449,3986,4463
50,12,85,Florida,Martin County,4,15,9271,4410,4861
50,12,85,Florida,Martin County,4,16,8509,3930,4579
50,12,85,Florida,Martin County,4,17,5765,2635,3130
50,12,85,Florida,Martin County,4,18,4182,1575,2607
50,12,85,Florida,Martin County,5,0,131604,64774,66830
50,12,85,Florida,Martin County,5,1,5992,3050,2942
50,12,85,Florida,Martin County,5,2,6669,3439,3230
50,12,85,Florida,Martin County,5,3,7611,3928,3683
50,12,85,Florida,Martin County,5,4,6670,3535,3135
50,12,85,Florida,Martin County,5,5,4977,2803,2174
50,12,85,Florida,Martin County,5,6,4816,2627,2189
50,12,85,Florida,Martin County,5,7,6194,3243,2951
50,12,85,Florida,Martin County,5,8,8247,4182,4065
50,12,85,Florida,Martin County,5,9,9633,4801,4832
50,12,85,Florida,Martin County,5,10,9083,4488,4595
50,12,85,Florida,Martin County,5,11,8744,4290,4454
50,12,85,Florida,Martin County,5,12,8568,4019,4549
50,12,85,Florida,Martin County,5,13,8084,3737,4347
50,12,85,Florida,Martin County,5,14,8274,3874,4400
50,12,85,Florida,Martin County,5,15,9056,4349,4707
50,12,85,Florida,Martin County,5,16,8425,3884,4541
50,12,85,Florida,Martin County,5,17,6097,2796,3301
50,12,85,Florida,Martin County,5,18,4464,1729,2735
50,12,85,Florida,Martin County,6,0,134556,66448,68108
50,12,85,Florida,Martin County,6,1,6249,3207,3042
50,12,85,Florida,Martin County,6,2,6713,3425,3288
50,12,85,Florida,Martin County,6,3,7755,4001,3754
50,12,85,Florida,Martin County,6,4,7030,3752,3278
50,12,85,Florida,Martin County,6,5,5221,2954,2267
50,12,85,Florida,Martin County,6,6,4922,2699,2223
50,12,85,Florida,Martin County,6,7,6188,3302,2886
50,12,85,Florida,Martin County,6,8,8144,4164,3980
50,12,85,Florida,Martin County,6,9,9856,4904,4952
50,12,85,Florida,Martin County,6,10,9595,4745,4850
50,12,85,Florida,Martin County,6,11,8849,4376,4473
50,12,85,Florida,Martin County,6,12,8873,4220,4653
50,12,85,Florida,Martin County,6,13,8650,3928,4722
50,12,85,Florida,Martin County,6,14,8157,3873,4284
50,12,85,Florida,Martin County,6,15,8843,4221,4622
50,12,85,Florida,Martin County,6,16,8477,3948,4529
50,12,85,Florida,Martin County,6,17,6257,2854,3403
50,12,85,Florida,Martin County,6,18,4777,1875,2902
50,12,85,Florida,Martin County,7,0,137009,67790,69219
50,12,85,Florida,Martin County,7,1,6398,3296,3102
50,12,85,Florida,Martin County,7,2,6774,3468,3306
50,12,85,Florida,Martin County,7,3,7854,4033,3821
50,12,85,Florida,Martin County,7,4,7424,3968,3456
50,12,85,Florida,Martin County,7,5,5547,3089,2458
50,12,85,Florida,Martin County,7,6,4899,2779,2120
50,12,85,Florida,Martin County,7,7,6026,3264,2762
50,12,85,Florida,Martin County,7,8,7876,4003,3873
50,12,85,Florida,Martin County,7,9,10144,5102,5042
50,12,85,Florida,Martin County,7,10,10023,4949,5074
50,12,85,Florida,Martin County,7,11,9121,4482,4639
50,12,85,Florida,Martin County,7,12,9348,4489,4859
50,12,85,Florida,Martin County,7,13,8994,4108,4886
50,12,85,Florida,Martin County,7,14,8341,3925,4416
50,12,85,Florida,Martin County,7,15,8526,4117,4409
50,12,85,Florida,Martin County,7,16,8308,3843,4465
50,12,85,Florida,Martin County,7,17,6382,2879,3503
50,12,85,Florida,Martin County,7,18,5024,1996,3028
50,12,85,Florida,Martin County,8,0,138474,68622,69852
50,12,85,Florida,Martin County,8,1,6648,3451,3197
50,12,85,Florida,Martin County,8,2,6770,3480,3290
50,12,85,Florida,Martin County,8,3,7833,4005,3828
50,12,85,Florida,Martin County,8,4,7688,4123,3565
50,12,85,Florida,Martin County,8,5,5847,3199,2648
50,12,85,Florida,Martin County,8,6,5082,2914,2168
50,12,85,Florida,Martin County,8,7,5772,3113,2659
50,12,85,Florida,Martin County,8,8,7711,3964,3747
50,12,85,Florida,Martin County,8,9,10010,5024,4986
50,12,85,Florida,Martin County,8,10,10340,5114,5226
50,12,85,Florida,Martin County,8,11,9439,4629,4810
50,12,85,Florida,Martin County,8,12,9737,4679,5058
50,12,85,Florida,Martin County,8,13,9204,4256,4948
50,12,85,Florida,Martin County,8,14,8322,3907,4415
50,12,85,Florida,Martin County,8,15,8231,3903,4328
50,12,85,Florida,Martin County,8,16,8027,3737,4290
50,12,85,Florida,Martin County,8,17,6593,2998,3595
50,12,85,Florida,Martin County,8,18,5220,2126,3094
50,12,85,Florida,Martin County,9,0,137740,68338,69402
50,12,85,Florida,Martin County,9,1,6616,3430,3186
50,12,85,Florida,Martin County,9,2,6736,3450,3286
50,12,85,Florida,Martin County,9,3,7562,3892,3670
50,12,85,Florida,Martin County,9,4,7971,4230,3741
50,12,85,Florida,Martin County,9,5,6112,3342,2770
50,12,85,Florida,Martin County,9,6,5003,2927,2076
50,12,85,Florida,Martin County,9,7,5504,3001,2503
50,12,85,Florida,Martin County,9,8,7441,3820,3621
50,12,85,Florida,Martin County,9,9,9808,4971,4837
50,12,85,Florida,Martin County,9,10,10503,5147,5356
50,12,85,Florida,Martin County,9,11,9515,4673,4842
50,12,85,Florida,Martin County,9,12,10029,4823,5206
50,12,85,Florida,Martin County,9,13,9263,4318,4945
50,12,85,Florida,Martin County,9,14,8102,3762,4340
50,12,85,Florida,Martin County,9,15,7852,3723,4129
50,12,85,Florida,Martin County,9,16,7791,3652,4139
50,12,85,Florida,Martin County,9,17,6475,2937,3538
50,12,85,Florida,Martin County,9,18,5457,2240,3217
50,12,85,Florida,Martin County,10,0,138865,69001,69864
50,12,85,Florida,Martin County,10,1,6816,3512,3304
50,12,85,Florida,Martin County,10,2,6854,3503,3351
50,12,85,Florida,Martin County,10,3,7494,3868,3626
50,12,85,Florida,Martin County,10,4,8023,4264,3759
50,12,85,Florida,Martin County,10,5,6618,3614,3004
50,12,85,Florida,Martin County,10,6,5126,2979,2147
50,12,85,Florida,Martin County,10,7,5380,2969,2411
50,12,85,Florida,Martin County,10,8,7270,3793,3477
50,12,85,Florida,Martin County,10,9,9372,4767,4605
50,12,85,Florida,Martin County,10,10,10642,5252,5390
50,12,85,Florida,Martin County,10,11,9850,4813,5037
50,12,85,Florida,Martin County,10,12,9752,4687,5065
50,12,85,Florida,Martin County,10,13,9631,4491,5140
50,12,85,Florida,Martin County,10,14,8382,3879,4503
50,12,85,Florida,Martin County,10,15,7660,3616,4044
50,12,85,Florida,Martin County,10,16,7700,3628,4072
50,12,85,Florida,Martin County,10,17,6483,2948,3535
50,12,85,Florida,Martin County,10,18,5812,2418,3394
50,12,85,Florida,Martin County,11,0,139080,69188,69892
50,12,85,Florida,Martin County,11,1,6840,3545,3295
50,12,85,Florida,Martin County,11,2,6900,3552,3348
50,12,85,Florida,Martin County,11,3,7333,3746,3587
50,12,85,Florida,Martin County,11,4,7945,4226,3719
50,12,85,Florida,Martin County,11,5,6710,3685,3025
50,12,85,Florida,Martin County,11,6,5400,3118,2282
50,12,85,Florida,Martin County,11,7,5364,2966,2398
50,12,85,Florida,Martin County,11,8,6825,3609,3216
50,12,85,Florida,Martin County,11,9,8935,4564,4371
50,12,85,Florida,Martin County,11,10,10596,5208,5388
50,12,85,Florida,Martin County,11,11,10181,4979,5202
50,12,85,Florida,Martin County,11,12,9548,4620,4928
50,12,85,Florida,Martin County,11,13,9855,4652,5203
50,12,85,Florida,Martin County,11,14,8904,4047,4857
50,12,85,Florida,Martin County,11,15,7629,3626,4003
50,12,85,Florida,Martin County,11,16,7514,3530,3984
50,12,85,Florida,Martin County,11,17,6558,2991,3567
50,12,85,Florida,Martin County,11,18,6043,2524,3519
50,12,85,Florida,Martin County,12,0,139794,69727,70067
50,12,85,Florida,Martin County,12,1,6857,3530,3327
50,12,85,Florida,Martin County,12,2,6902,3564,3338
50,12,85,Florida,Martin County,12,3,7295,3744,3551
50,12,85,Florida,Martin County,12,4,7854,4171,3683
50,12,85,Florida,Martin County,12,5,6914,3826,3088
50,12,85,Florida,Martin County,12,6,5667,3226,2441
50,12,85,Florida,Martin County,12,7,5424,3102,2322
50,12,85,Florida,Martin County,12,8,6678,3592,3086
50,12,85,Florida,Martin County,12,9,8434,4295,4139
50,12,85,Florida,Martin County,12,10,10668,5305,5363
50,12,85,Florida,Martin County,12,11,10452,5108,5344
50,12,85,Florida,Martin County,12,12,9577,4618,4959
50,12,85,Florida,Martin County,12,13,9954,4730,5224
50,12,85,Florida,Martin County,12,14,9168,4192,4976
50,12,85,Florida,Martin County,12,15,7845,3684,4161
50,12,85,Florida,Martin County,12,16,7297,3473,3824
50,12,85,Florida,Martin County,12,17,6454,2914,3540
50,12,85,Florida,Martin County,12,18,6354,2653,3701
50,12,86,Florida,Miami-Dade County,1,0,2253362,1088895,1164467
50,12,86,Florida,Miami-Dade County,1,1,145752,74703,71049
50,12,86,Florida,Miami-Dade County,1,2,157871,80633,77238
50,12,86,Florida,Miami-Dade County,1,3,160754,81888,78866
50,12,86,Florida,Miami-Dade County,1,4,154989,78781,76208
50,12,86,Florida,Miami-Dade County,1,5,144721,72172,72549
50,12,86,Florida,Miami-Dade County,1,6,163859,81817,82042
50,12,86,Florida,Miami-Dade County,1,7,173574,86770,86804
50,12,86,Florida,Miami-Dade County,1,8,191834,95210,96624
50,12,86,Florida,Miami-Dade County,1,9,170132,82669,87463
50,12,86,Florida,Miami-Dade County,1,10,150878,71898,78980
50,12,86,Florida,Miami-Dade County,1,11,131888,62742,69146
50,12,86,Florida,Miami-Dade County,1,12,109141,51578,57563
50,12,86,Florida,Miami-Dade County,1,13,97417,44998,52419
50,12,86,Florida,Miami-Dade County,1,14,84496,38239,46257
50,12,86,Florida,Miami-Dade County,1,15,77761,33904,43857
50,12,86,Florida,Miami-Dade County,1,16,59856,24429,35427
50,12,86,Florida,Miami-Dade County,1,17,39971,14715,25256
50,12,86,Florida,Miami-Dade County,1,18,38468,11749,26719
50,12,86,Florida,Miami-Dade County,2,0,2253786,1089123,1164663
50,12,86,Florida,Miami-Dade County,2,1,145778,74718,71060
50,12,86,Florida,Miami-Dade County,2,2,157901,80652,77249
50,12,86,Florida,Miami-Dade County,2,3,160781,81899,78882
50,12,86,Florida,Miami-Dade County,2,4,155022,78797,76225
50,12,86,Florida,Miami-Dade County,2,5,144750,72190,72560
50,12,86,Florida,Miami-Dade County,2,6,163887,81830,82057
50,12,86,Florida,Miami-Dade County,2,7,173604,86783,86821
50,12,86,Florida,Miami-Dade County,2,8,191865,95226,96639
50,12,86,Florida,Miami-Dade County,2,9,170178,82694,87484
50,12,86,Florida,Miami-Dade County,2,10,150904,71910,78994
50,12,86,Florida,Miami-Dade County,2,11,131920,62759,69161
50,12,86,Florida,Miami-Dade County,2,12,109169,51595,57574
50,12,86,Florida,Miami-Dade County,2,13,97434,45009,52425
50,12,86,Florida,Miami-Dade County,2,14,84510,38247,46263
50,12,86,Florida,Miami-Dade County,2,15,77773,33913,43860
50,12,86,Florida,Miami-Dade County,2,16,59862,24432,35430
50,12,86,Florida,Miami-Dade County,2,17,39976,14717,25259
50,12,86,Florida,Miami-Dade County,2,18,38472,11752,26720
50,12,86,Florida,Miami-Dade County,3,0,2258765,1091872,1166893
50,12,86,Florida,Miami-Dade County,3,1,145635,74641,70994
50,12,86,Florida,Miami-Dade County,3,2,157024,80210,76814
50,12,86,Florida,Miami-Dade County,3,3,161430,82226,79204
50,12,86,Florida,Miami-Dade County,3,4,154695,78587,76108
50,12,86,Florida,Miami-Dade County,3,5,145252,72554,72698
50,12,86,Florida,Miami-Dade County,3,6,163478,81660,81818
50,12,86,Florida,Miami-Dade County,3,7,173726,86897,86829
50,12,86,Florida,Miami-Dade County,3,8,191913,95334,96579
50,12,86,Florida,Miami-Dade County,3,9,171118,83191,87927
50,12,86,Florida,Miami-Dade County,3,10,151789,72380,79409
50,12,86,Florida,Miami-Dade County,3,11,133334,63444,69890
50,12,86,Florida,Miami-Dade County,3,12,109893,51975,57918
50,12,86,Florida,Miami-Dade County,3,13,97897,45262,52635
50,12,86,Florida,Miami-Dade County,3,14,84256,38140,46116
50,12,86,Florida,Miami-Dade County,3,15,77892,34023,43869
50,12,86,Florida,Miami-Dade County,3,16,60215,24593,35622
50,12,86,Florida,Miami-Dade County,3,17,40429,14905,25524
50,12,86,Florida,Miami-Dade County,3,18,38789,11850,26939
50,12,86,Florida,Miami-Dade County,4,0,2294643,1110097,1184546
50,12,86,Florida,Miami-Dade County,4,1,150763,77278,73485
50,12,86,Florida,Miami-Dade County,4,2,154811,79214,75597
50,12,86,Florida,Miami-Dade County,4,3,164453,83823,80630
50,12,86,Florida,Miami-Dade County,4,4,157198,80051,77147
50,12,86,Florida,Miami-Dade County,4,5,148732,74399,74333
50,12,86,Florida,Miami-Dade County,4,6,162412,81162,81250
50,12,86,Florida,Miami-Dade County,4,7,173113,86437,86676
50,12,86,Florida,Miami-Dade County,4,8,193287,96297,96990
50,12,86,Florida,Miami-Dade County,4,9,176141,85775,90366
50,12,86,Florida,Miami-Dade County,4,10,155954,74660,81294
50,12,86,Florida,Miami-Dade County,4,11,137851,65313,72538
50,12,86,Florida,Miami-Dade County,4,12,112707,53192,59515
50,12,86,Florida,Miami-Dade County,4,13,99631,46262,53369
50,12,86,Florida,Miami-Dade County,4,14,84596,38047,46549
50,12,86,Florida,Miami-Dade County,4,15,78994,34767,44227
50,12,86,Florida,Miami-Dade County,4,16,61804,25558,36246
50,12,86,Florida,Miami-Dade County,4,17,42390,15780,26610
50,12,86,Florida,Miami-Dade County,4,18,39806,12082,27724
50,12,86,Florida,Miami-Dade County,5,0,2328122,1127450,1200672
50,12,86,Florida,Miami-Dade County,5,1,155466,79574,75892
50,12,86,Florida,Miami-Dade County,5,2,153591,78502,75089
50,12,86,Florida,Miami-Dade County,5,3,165949,84749,81200
50,12,86,Florida,Miami-Dade County,5,4,158746,80928,77818
50,12,86,Florida,Miami-Dade County,5,5,152242,76565,75677
50,12,86,Florida,Miami-Dade County,5,6,161728,80864,80864
50,12,86,Florida,Miami-Dade County,5,7,174468,87254,87214
50,12,86,Florida,Miami-Dade County,5,8,192036,95497,96539
50,12,86,Florida,Miami-Dade County,5,9,181063,88521,92542
50,12,86,Florida,Miami-Dade County,5,10,160472,76977,83495
50,12,86,Florida,Miami-Dade County,5,11,140485,66452,74033
50,12,86,Florida,Miami-Dade County,5,12,118290,56097,62193
50,12,86,Florida,Miami-Dade County,5,13,100618,46562,54056
50,12,86,Florida,Miami-Dade County,5,14,85677,38431,47246
50,12,86,Florida,Miami-Dade County,5,15,78264,34665,43599
50,12,86,Florida,Miami-Dade County,5,16,63911,26663,37248
50,12,86,Florida,Miami-Dade County,5,17,44310,16673,27637
50,12,86,Florida,Miami-Dade County,5,18,40806,12476,28330
50,12,86,Florida,Miami-Dade County,6,0,2352658,1140776,1211882
50,12,86,Florida,Miami-Dade County,6,1,159878,81872,78006
50,12,86,Florida,Miami-Dade County,6,2,151063,77060,74003
50,12,86,Florida,Miami-Dade County,6,3,164941,84565,80376
50,12,86,Florida,Miami-Dade County,6,4,160300,81592,78708
50,12,86,Florida,Miami-Dade County,6,5,155767,79050,76717
50,12,86,Florida,Miami-Dade County,6,6,161638,80967,80671
50,12,86,Florida,Miami-Dade County,6,7,175506,88041,87465
50,12,86,Florida,Miami-Dade County,6,8,187501,93535,93966
50,12,86,Florida,Miami-Dade County,6,9,185791,90819,94972
50,12,86,Florida,Miami-Dade County,6,10,163680,78755,84925
50,12,86,Florida,Miami-Dade County,6,11,143493,67800,75693
50,12,86,Florida,Miami-Dade County,6,12,121474,57510,63964
50,12,86,Florida,Miami-Dade County,6,13,103037,47754,55283
50,12,86,Florida,Miami-Dade County,6,14,86969,39131,47838
50,12,86,Florida,Miami-Dade County,6,15,77838,34545,43293
50,12,86,Florida,Miami-Dade County,6,16,65408,27210,38198
50,12,86,Florida,Miami-Dade County,6,17,46027,17622,28405
50,12,86,Florida,Miami-Dade County,6,18,42347,12948,29399
50,12,86,Florida,Miami-Dade County,7,0,2381215,1155955,1225260
50,12,86,Florida,Miami-Dade County,7,1,164461,83989,80472
50,12,86,Florida,Miami-Dade County,7,2,148941,76299,72642
50,12,86,Florida,Miami-Dade County,7,3,163529,83719,79810
50,12,86,Florida,Miami-Dade County,7,4,161633,82250,79383
50,12,86,Florida,Miami-Dade County,7,5,159652,81127,78525
50,12,86,Florida,Miami-Dade County,7,6,163356,82378,80978
50,12,86,Florida,Miami-Dade County,7,7,176024,88496,87528
50,12,86,Florida,Miami-Dade County,7,8,182938,91345,91593
50,12,86,Florida,Miami-Dade County,7,9,191254,93965,97289
50,12,86,Florida,Miami-Dade County,7,10,167351,80576,86775
50,12,86,Florida,Miami-Dade County,7,11,147772,69865,77907
50,12,86,Florida,Miami-Dade County,7,12,125277,59256,66021
50,12,86,Florida,Miami-Dade County,7,13,104908,48632,56276
50,12,86,Florida,Miami-Dade County,7,14,88750,40004,48746
50,12,86,Florida,Miami-Dade County,7,15,76396,33871,42525
50,12,86,Florida,Miami-Dade County,7,16,67119,27984,39135
50,12,86,Florida,Miami-Dade County,7,17,47832,18554,29278
50,12,86,Florida,Miami-Dade County,7,18,44022,13645,30377
50,12,86,Florida,Miami-Dade County,8,0,2413583,1173204,1240379
50,12,86,Florida,Miami-Dade County,8,1,168318,86106,82212
50,12,86,Florida,Miami-Dade County,8,2,148174,76015,72159
50,12,86,Florida,Miami-Dade County,8,3,159616,81805,77811
50,12,86,Florida,Miami-Dade County,8,4,164254,83528,80726
50,12,86,Florida,Miami-Dade County,8,5,161221,82098,79123
50,12,86,Florida,Miami-Dade County,8,6,167085,84914,82171
50,12,86,Florida,Miami-Dade County,8,7,174953,88133,86820
50,12,86,Florida,Miami-Dade County,8,8,180347,90084,90263
50,12,86,Florida,Miami-Dade County,8,9,193835,95748,98087
50,12,86,Florida,Miami-Dade County,8,10,171594,82727,88867
50,12,86,Florida,Miami-Dade County,8,11,151597,71771,79826
50,12,86,Florida,Miami-Dade County,8,12,130924,61826,69098
50,12,86,Florida,Miami-Dade County,8,13,106452,49506,56946
50,12,86,Florida,Miami-Dade County,8,14,91885,41514,50371
50,12,86,Florida,Miami-Dade County,8,15,76603,33752,42851
50,12,86,Florida,Miami-Dade County,8,16,69402,29238,40164
50,12,86,Florida,Miami-Dade County,8,17,50313,19701,30612
50,12,86,Florida,Miami-Dade County,8,18,47010,14738,32272
50,12,86,Florida,Miami-Dade County,9,0,2438702,1186632,1252070
50,12,86,Florida,Miami-Dade County,9,1,168591,86274,82317
50,12,86,Florida,Miami-Dade County,9,2,151500,77781,73719
50,12,86,Florida,Miami-Dade County,9,3,156276,80222,76054
50,12,86,Florida,Miami-Dade County,9,4,165971,84438,81533
50,12,86,Florida,Miami-Dade County,9,5,163561,83584,79977
50,12,86,Florida,Miami-Dade County,9,6,171074,87152,83922
50,12,86,Florida,Miami-Dade County,9,7,173875,87733,86142
50,12,86,Florida,Miami-Dade County,9,8,178236,89001,89235
50,12,86,Florida,Miami-Dade County,9,9,194870,96621,98249
50,12,86,Florida,Miami-Dade County,9,10,176211,85167,91044
50,12,86,Florida,Miami-Dade County,9,11,155277,73811,81466
50,12,86,Florida,Miami-Dade County,9,12,135196,63587,71609
50,12,86,Florida,Miami-Dade County,9,13,109045,50621,58424
50,12,86,Florida,Miami-Dade County,9,14,92329,41882,50447
50,12,86,Florida,Miami-Dade County,9,15,76077,33247,42830
50,12,86,Florida,Miami-Dade County,9,16,69965,29740,40225
50,12,86,Florida,Miami-Dade County,9,17,51206,20198,31008
50,12,86,Florida,Miami-Dade County,9,18,49442,15573,33869
50,12,86,Florida,Miami-Dade County,10,0,2453567,1195474,1258093
50,12,86,Florida,Miami-Dade County,10,1,169295,86709,82586
50,12,86,Florida,Miami-Dade County,10,2,153562,78735,74827
50,12,86,Florida,Miami-Dade County,10,3,152219,78093,74126
50,12,86,Florida,Miami-Dade County,10,4,165469,84388,81081
50,12,86,Florida,Miami-Dade County,10,5,164341,84260,80081
50,12,86,Florida,Miami-Dade County,10,6,172863,88814,84049
50,12,86,Florida,Miami-Dade County,10,7,171434,86683,84751
50,12,86,Florida,Miami-Dade County,10,8,177429,88877,88552
50,12,86,Florida,Miami-Dade County,10,9,192104,95167,96937
50,12,86,Florida,Miami-Dade County,10,10,179745,87224,92521
50,12,86,Florida,Miami-Dade County,10,11,158644,75534,83110
50,12,86,Florida,Miami-Dade County,10,12,137347,64499,72848
50,12,86,Florida,Miami-Dade County,10,13,113529,52983,60546
50,12,86,Florida,Miami-Dade County,10,14,92913,41939,50974
50,12,86,Florida,Miami-Dade County,10,15,77334,33819,43515
50,12,86,Florida,Miami-Dade County,10,16,69748,29864,39884
50,12,86,Florida,Miami-Dade County,10,17,53402,21279,32123
50,12,86,Florida,Miami-Dade County,10,18,52189,16607,35582
50,12,86,Florida,Miami-Dade County,11,0,2478745,1208700,1270045
50,12,86,Florida,Miami-Dade County,11,1,169106,86545,82561
50,12,86,Florida,Miami-Dade County,11,2,158275,81166,77109
50,12,86,Florida,Miami-Dade County,11,3,149212,76451,72761
50,12,86,Florida,Miami-Dade County,11,4,164222,84026,80196
50,12,86,Florida,Miami-Dade County,11,5,165671,84773,80898
50,12,86,Florida,Miami-Dade County,11,6,174921,90412,84509
50,12,86,Florida,Miami-Dade County,11,7,171371,86685,84686
50,12,86,Florida,Miami-Dade County,11,8,178904,89957,88947
50,12,86,Florida,Miami-Dade County,11,9,187886,93438,94448
50,12,86,Florida,Miami-Dade County,11,10,185050,89812,95238
50,12,86,Florida,Miami-Dade County,11,11,161812,77242,84570
50,12,86,Florida,Miami-Dade County,11,12,140668,66039,74629
50,12,86,Florida,Miami-Dade County,11,13,117127,54594,62533
50,12,86,Florida,Miami-Dade County,11,14,95504,43236,52268
50,12,86,Florida,Miami-Dade County,11,15,78844,34584,44260
50,12,86,Florida,Miami-Dade County,11,16,69616,29917,39699
50,12,86,Florida,Miami-Dade County,11,17,55113,21864,33249
50,12,86,Florida,Miami-Dade County,11,18,55443,17959,37484
50,12,86,Florida,Miami-Dade County,12,0,2500625,1220665,1279960
50,12,86,Florida,Miami-Dade County,12,1,169012,86517,82495
50,12,86,Florida,Miami-Dade County,12,2,162754,83251,79503
50,12,86,Florida,Miami-Dade County,12,3,147185,75782,71403
50,12,86,Florida,Miami-Dade County,12,4,162193,82894,79299
50,12,86,Florida,Miami-Dade County,12,5,167014,85402,81612
50,12,86,Florida,Miami-Dade County,12,6,177798,91957,85841
50,12,86,Florida,Miami-Dade County,12,7,172480,87821,84659
50,12,86,Florida,Miami-Dade County,12,8,179453,90497,88956
50,12,86,Florida,Miami-Dade County,12,9,183272,91273,91999
50,12,86,Florida,Miami-Dade County,12,10,189503,92459,97044
50,12,86,Florida,Miami-Dade County,12,11,164688,78730,85958
50,12,86,Florida,Miami-Dade County,12,12,144458,67797,76661
50,12,86,Florida,Miami-Dade County,12,13,120419,56022,64397
50,12,86,Florida,Miami-Dade County,12,14,97131,44057,53074
50,12,86,Florida,Miami-Dade County,12,15,80393,35325,45068
50,12,86,Florida,Miami-Dade County,12,16,68068,29153,38915
50,12,86,Florida,Miami-Dade County,12,17,56455,22563,33892
50,12,86,Florida,Miami-Dade County,12,18,58349,19165,39184
50,12,87,Florida,Monroe County,1,0,79589,42379,37210
50,12,87,Florida,Monroe County,1,1,3462,1813,1649
50,12,87,Florida,Monroe County,1,2,3802,1982,1820
50,12,87,Florida,Monroe County,1,3,4003,2067,1936
50,12,87,Florida,Monroe County,1,4,3698,1971,1727
50,12,87,Florida,Monroe County,1,5,3639,2018,1621
50,12,87,Florida,Monroe County,1,6,4655,2517,2138
50,12,87,Florida,Monroe County,1,7,5605,3023,2582
50,12,87,Florida,Monroe County,1,8,6936,3712,3224
50,12,87,Florida,Monroe County,1,9,7557,3946,3611
50,12,87,Florida,Monroe County,1,10,7498,4020,3478
50,12,87,Florida,Monroe County,1,11,7149,3936,3213
50,12,87,Florida,Monroe County,1,12,5596,3092,2504
50,12,87,Florida,Monroe County,1,13,4341,2415,1926
50,12,87,Florida,Monroe County,1,14,3576,1926,1650
50,12,87,Florida,Monroe County,1,15,3203,1713,1490
50,12,87,Florida,Monroe County,1,16,2417,1178,1239
50,12,87,Florida,Monroe County,1,17,1476,675,801
50,12,87,Florida,Monroe County,1,18,976,375,601
50,12,87,Florida,Monroe County,2,0,79589,42379,37210
50,12,87,Florida,Monroe County,2,1,3462,1813,1649
50,12,87,Florida,Monroe County,2,2,3802,1982,1820
50,12,87,Florida,Monroe County,2,3,4003,2067,1936
50,12,87,Florida,Monroe County,2,4,3698,1971,1727
50,12,87,Florida,Monroe County,2,5,3639,2018,1621
50,12,87,Florida,Monroe County,2,6,4655,2517,2138
50,12,87,Florida,Monroe County,2,7,5605,3023,2582
50,12,87,Florida,Monroe County,2,8,6936,3712,3224
50,12,87,Florida,Monroe County,2,9,7557,3946,3611
50,12,87,Florida,Monroe County,2,10,7498,4020,3478
50,12,87,Florida,Monroe County,2,11,7149,3936,3213
50,12,87,Florida,Monroe County,2,12,5596,3092,2504
50,12,87,Florida,Monroe County,2,13,4341,2415,1926
50,12,87,Florida,Monroe County,2,14,3576,1926,1650
50,12,87,Florida,Monroe County,2,15,3203,1713,1490
50,12,87,Florida,Monroe County,2,16,2417,1178,1239
50,12,87,Florida,Monroe County,2,17,1476,675,801
50,12,87,Florida,Monroe County,2,18,976,375,601
50,12,87,Florida,Monroe County,3,0,79483,42328,37155
50,12,87,Florida,Monroe County,3,1,3454,1809,1645
50,12,87,Florida,Monroe County,3,2,3779,1969,1810
50,12,87,Florida,Monroe County,3,3,4003,2066,1937
50,12,87,Florida,Monroe County,3,4,3692,1967,1725
50,12,87,Florida,Monroe County,3,5,3655,2028,1627
50,12,87,Florida,Monroe County,3,6,4614,2496,2118
50,12,87,Florida,Monroe County,3,7,5589,3014,2575
50,12,87,Florida,Monroe County,3,8,6891,3686,3205
50,12,87,Florida,Monroe County,3,9,7548,3941,3607
50,12,87,Florida,Monroe County,3,10,7512,4028,3484
50,12,87,Florida,Monroe County,3,11,7186,3958,3228
50,12,87,Florida,Monroe County,3,12,5607,3099,2508
50,12,87,Florida,Monroe County,3,13,4341,2415,1926
50,12,87,Florida,Monroe County,3,14,3551,1912,1639
50,12,87,Florida,Monroe County,3,15,3188,1707,1481
50,12,87,Florida,Monroe County,3,16,2412,1178,1234
50,12,87,Florida,Monroe County,3,17,1479,677,802
50,12,87,Florida,Monroe County,3,18,982,378,604
50,12,87,Florida,Monroe County,4,0,79105,42094,37011
50,12,87,Florida,Monroe County,4,1,3431,1771,1660
50,12,87,Florida,Monroe County,4,2,3654,1874,1780
50,12,87,Florida,Monroe County,4,3,3945,2045,1900
50,12,87,Florida,Monroe County,4,4,3659,1954,1705
50,12,87,Florida,Monroe County,4,5,3662,2020,1642
50,12,87,Florida,Monroe County,4,6,4538,2484,2054
50,12,87,Florida,Monroe County,4,7,5436,2913,2523
50,12,87,Florida,Monroe County,4,8,6699,3592,3107
50,12,87,Florida,Monroe County,4,9,7395,3867,3528
50,12,87,Florida,Monroe County,4,10,7498,3997,3501
50,12,87,Florida,Monroe County,4,11,7412,4030,3382
50,12,87,Florida,Monroe County,4,12,5732,3167,2565
50,12,87,Florida,Monroe County,4,13,4496,2497,1999
50,12,87,Florida,Monroe County,4,14,3466,1899,1567
50,12,87,Florida,Monroe County,4,15,3161,1704,1457
50,12,87,Florida,Monroe County,4,16,2364,1163,1201
50,12,87,Florida,Monroe County,4,17,1525,700,825
50,12,87,Florida,Monroe County,4,18,1032,417,615
50,12,87,Florida,Monroe County,5,0,78963,41989,36974
50,12,87,Florida,Monroe County,5,1,3420,1749,1671
50,12,87,Florida,Monroe County,5,2,3574,1843,1731
50,12,87,Florida,Monroe County,5,3,3871,1964,1907
50,12,87,Florida,Monroe County,5,4,3709,2015,1694
50,12,87,Florida,Monroe County,5,5,3811,2067,1744
50,12,87,Florida,Monroe County,5,6,4446,2434,2012
50,12,87,Florida,Monroe County,5,7,5364,2857,2507
50,12,87,Florida,Monroe County,5,8,6331,3426,2905
50,12,87,Florida,Monroe County,5,9,7231,3794,3437
50,12,87,Florida,Monroe County,5,10,7546,3989,3557
50,12,87,Florida,Monroe County,5,11,7375,3919,3456
50,12,87,Florida,Monroe County,5,12,6166,3442,2724
50,12,87,Florida,Monroe County,5,13,4658,2569,2089
50,12,87,Florida,Monroe County,5,14,3421,1897,1524
50,12,87,Florida,Monroe County,5,15,3013,1636,1377
50,12,87,Florida,Monroe County,5,16,2324,1197,1127
50,12,87,Florida,Monroe County,5,17,1616,741,875
50,12,87,Florida,Monroe County,5,18,1087,450,637
50,12,87,Florida,Monroe County,6,0,78880,41863,37017
50,12,87,Florida,Monroe County,6,1,3473,1744,1729
50,12,87,Florida,Monroe County,6,2,3428,1774,1654
50,12,87,Florida,Monroe County,6,3,3880,1983,1897
50,12,87,Florida,Monroe County,6,4,3702,1981,1721
50,12,87,Florida,Monroe County,6,5,3887,2074,1813
50,12,87,Florida,Monroe County,6,6,4489,2452,2037
50,12,87,Florida,Monroe County,6,7,5265,2809,2456
50,12,87,Florida,Monroe County,6,8,6006,3226,2780
50,12,87,Florida,Monroe County,6,9,6933,3654,3279
50,12,87,Florida,Monroe County,6,10,7529,3944,3585
50,12,87,Florida,Monroe County,6,11,7459,3956,3503
50,12,87,Florida,Monroe County,6,12,6567,3631,2936
50,12,87,Florida,Monroe County,6,13,4760,2620,2140
50,12,87,Florida,Monroe County,6,14,3467,1941,1526
50,12,87,Florida,Monroe County,6,15,2896,1575,1321
50,12,87,Florida,Monroe County,6,16,2373,1273,1100
50,12,87,Florida,Monroe County,6,17,1606,734,872
50,12,87,Florida,Monroe County,6,18,1160,492,668
50,12,87,Florida,Monroe County,7,0,77901,41410,36491
50,12,87,Florida,Monroe County,7,1,3498,1755,1743
50,12,87,Florida,Monroe County,7,2,3216,1676,1540
50,12,87,Florida,Monroe County,7,3,3751,1929,1822
50,12,87,Florida,Monroe County,7,4,3647,1923,1724
50,12,87,Florida,Monroe County,7,5,3868,2097,1771
50,12,87,Florida,Monroe County,7,6,4500,2445,2055
50,12,87,Florida,Monroe County,7,7,4980,2700,2280
50,12,87,Florida,Monroe County,7,8,5694,3056,2638
50,12,87,Florida,Monroe County,7,9,6772,3607,3165
50,12,87,Florida,Monroe County,7,10,7420,3807,3613
50,12,87,Florida,Monroe County,7,11,7350,3889,3461
50,12,87,Florida,Monroe County,7,12,6750,3724,3026
50,12,87,Florida,Monroe County,7,13,4968,2722,2246
50,12,87,Florida,Monroe County,7,14,3534,2023,1511
50,12,87,Florida,Monroe County,7,15,2774,1496,1278
50,12,87,Florida,Monroe County,7,16,2358,1290,1068
50,12,87,Florida,Monroe County,7,17,1605,753,852
50,12,87,Florida,Monroe County,7,18,1216,518,698
50,12,87,Florida,Monroe County,8,0,76135,40501,35634
50,12,87,Florida,Monroe County,8,1,3459,1728,1731
50,12,87,Florida,Monroe County,8,2,3007,1571,1436
50,12,87,Florida,Monroe County,8,3,3460,1783,1677
50,12,87,Florida,Monroe County,8,4,3627,1908,1719
50,12,87,Florida,Monroe County,8,5,3805,2056,1749
50,12,87,Florida,Monroe County,8,6,4413,2415,1998
50,12,87,Florida,Monroe County,8,7,4484,2433,2051
50,12,87,Florida,Monroe County,8,8,5312,2841,2471
50,12,87,Florida,Monroe County,8,9,6428,3444,2984
50,12,87,Florida,Monroe County,8,10,7243,3724,3519
50,12,87,Florida,Monroe County,8,11,7378,3880,3498
50,12,87,Florida,Monroe County,8,12,6934,3767,3167
50,12,87,Florida,Monroe County,8,13,5171,2852,2319
50,12,87,Florida,Monroe County,8,14,3499,1966,1533
50,12,87,Florida,Monroe County,8,15,2707,1510,1197
50,12,87,Florida,Monroe County,8,16,2339,1294,1045
50,12,87,Florida,Monroe County,8,17,1613,793,820
50,12,87,Florida,Monroe County,8,18,1256,536,720
50,12,87,Florida,Monroe County,9,0,74104,39498,34606
50,12,87,Florida,Monroe County,9,1,3427,1746,1681
50,12,87,Florida,Monroe County,9,2,2972,1527,1445
50,12,87,Florida,Monroe County,9,3,3228,1636,1592
50,12,87,Florida,Monroe County,9,4,3483,1843,1640
50,12,87,Florida,Monroe County,9,5,3636,1985,1651
50,12,87,Florida,Monroe County,9,6,4458,2437,2021
50,12,87,Florida,Monroe County,9,7,4216,2327,1889
50,12,87,Florida,Monroe County,9,8,5147,2743,2404
50,12,87,Florida,Monroe County,9,9,6106,3295,2811
50,12,87,Florida,Monroe County,9,10,6928,3570,3358
50,12,87,Florida,Monroe County,9,11,7219,3782,3437
50,12,87,Florida,Monroe County,9,12,7059,3790,3269
50,12,87,Florida,Monroe County,9,13,5277,2917,2360
50,12,87,Florida,Monroe County,9,14,3412,1917,1495
50,12,87,Florida,Monroe County,9,15,2503,1425,1078
50,12,87,Florida,Monroe County,9,16,2158,1217,941
50,12,87,Florida,Monroe County,9,17,1593,783,810
50,12,87,Florida,Monroe County,9,18,1282,558,724
50,12,87,Florida,Monroe County,10,0,73420,39197,34223
50,12,87,Florida,Monroe County,10,1,3520,1799,1721
50,12,87,Florida,Monroe County,10,2,2912,1478,1434
50,12,87,Florida,Monroe County,10,3,3143,1610,1533
50,12,87,Florida,Monroe County,10,4,3431,1779,1652
50,12,87,Florida,Monroe County,10,5,3701,2065,1636
50,12,87,Florida,Monroe County,10,6,4471,2435,2036
50,12,87,Florida,Monroe County,10,7,4052,2242,1810
50,12,87,Florida,Monroe County,10,8,4980,2647,2333
50,12,87,Florida,Monroe County,10,9,5757,3154,2603
50,12,87,Florida,Monroe County,10,10,6675,3445,3230
50,12,87,Florida,Monroe County,10,11,7197,3754,3443
50,12,87,Florida,Monroe County,10,12,6885,3632,3253
50,12,87,Florida,Monroe County,10,13,5482,3082,2400
50,12,87,Florida,Monroe County,10,14,3641,2024,1617
50,12,87,Florida,Monroe County,10,15,2484,1426,1058
50,12,87,Florida,Monroe County,10,16,2089,1177,912
50,12,87,Florida,Monroe County,10,17,1584,831,753
50,12,87,Florida,Monroe County,10,18,1416,617,799
50,12,87,Florida,Monroe County,11,0,73298,39143,34155
50,12,87,Florida,Monroe County,11,1,3585,1854,1731
50,12,87,Florida,Monroe County,11,2,3009,1493,1516
50,12,87,Florida,Monroe County,11,3,3036,1564,1472
50,12,87,Florida,Monroe County,11,4,3369,1755,1614
50,12,87,Florida,Monroe County,11,5,3583,1978,1605
50,12,87,Florida,Monroe County,11,6,4472,2441,2031
50,12,87,Florida,Monroe County,11,7,3994,2219,1775
50,12,87,Florida,Monroe County,11,8,4876,2600,2276
50,12,87,Florida,Monroe County,11,9,5501,3006,2495
50,12,87,Florida,Monroe County,11,10,6414,3334,3080
50,12,87,Florida,Monroe County,11,11,7104,3669,3435
50,12,87,Florida,Monroe County,11,12,6817,3587,3230
50,12,87,Florida,Monroe County,11,13,5847,3247,2600
50,12,87,Florida,Monroe County,11,14,3902,2168,1734
50,12,87,Florida,Monroe County,11,15,2582,1491,1091
50,12,87,Florida,Monroe County,11,16,2094,1177,917
50,12,87,Florida,Monroe County,11,17,1668,918,750
50,12,87,Florida,Monroe County,11,18,1445,642,803
50,12,87,Florida,Monroe County,12,0,73165,39044,34121
50,12,87,Florida,Monroe County,12,1,3573,1836,1737
50,12,87,Florida,Monroe County,12,2,3071,1525,1546
50,12,87,Florida,Monroe County,12,3,2868,1486,1382
50,12,87,Florida,Monroe County,12,4,3342,1751,1591
50,12,87,Florida,Monroe County,12,5,3507,1895,1612
50,12,87,Florida,Monroe County,12,6,4514,2495,2019
50,12,87,Florida,Monroe County,12,7,4067,2236,1831
50,12,87,Florida,Monroe County,12,8,4620,2507,2113
50,12,87,Florida,Monroe County,12,9,5286,2879,2407
50,12,87,Florida,Monroe County,12,10,6433,3383,3050
50,12,87,Florida,Monroe County,12,11,6919,3496,3423
50,12,87,Florida,Monroe County,12,12,6824,3579,3245
50,12,87,Florida,Monroe County,12,13,6020,3318,2702
50,12,87,Florida,Monroe County,12,14,4133,2292,1841
50,12,87,Florida,Monroe County,12,15,2705,1588,1117
50,12,87,Florida,Monroe County,12,16,2082,1149,933
50,12,87,Florida,Monroe County,12,17,1648,925,723
50,12,87,Florida,Monroe County,12,18,1553,704,849
50,12,89,Florida,Nassau County,1,0,57663,28443,29220
50,12,89,Florida,Nassau County,1,1,3565,1797,1768
50,12,89,Florida,Nassau County,1,2,3908,2017,1891
50,12,89,Florida,Nassau County,1,3,4435,2273,2162
50,12,89,Florida,Nassau County,1,4,3817,2016,1801
50,12,89,Florida,Nassau County,1,5,2859,1445,1414
50,12,89,Florida,Nassau County,1,6,3272,1615,1657
50,12,89,Florida,Nassau County,1,7,3822,1862,1960
50,12,89,Florida,Nassau County,1,8,4739,2302,2437
50,12,89,Florida,Nassau County,1,9,4797,2372,2425
50,12,89,Florida,Nassau County,1,10,4468,2227,2241
50,12,89,Florida,Nassau County,1,11,4197,2039,2158
50,12,89,Florida,Nassau County,1,12,3579,1718,1861
50,12,89,Florida,Nassau County,1,13,2938,1474,1464
50,12,89,Florida,Nassau County,1,14,2500,1274,1226
50,12,89,Florida,Nassau County,1,15,2072,954,1118
50,12,89,Florida,Nassau County,1,16,1355,597,758
50,12,89,Florida,Nassau County,1,17,796,304,492
50,12,89,Florida,Nassau County,1,18,544,157,387
50,12,89,Florida,Nassau County,2,0,57663,28443,29220
50,12,89,Florida,Nassau County,2,1,3565,1797,1768
50,12,89,Florida,Nassau County,2,2,3908,2017,1891
50,12,89,Florida,Nassau County,2,3,4435,2273,2162
50,12,89,Florida,Nassau County,2,4,3817,2016,1801
50,12,89,Florida,Nassau County,2,5,2859,1445,1414
50,12,89,Florida,Nassau County,2,6,3272,1615,1657
50,12,89,Florida,Nassau County,2,7,3822,1862,1960
50,12,89,Florida,Nassau County,2,8,4739,2302,2437
50,12,89,Florida,Nassau County,2,9,4797,2372,2425
50,12,89,Florida,Nassau County,2,10,4468,2227,2241
50,12,89,Florida,Nassau County,2,11,4197,2039,2158
50,12,89,Florida,Nassau County,2,12,3579,1718,1861
50,12,89,Florida,Nassau County,2,13,2938,1474,1464
50,12,89,Florida,Nassau County,2,14,2500,1274,1226
50,12,89,Florida,Nassau County,2,15,2072,954,1118
50,12,89,Florida,Nassau County,2,16,1355,597,758
50,12,89,Florida,Nassau County,2,17,796,304,492
50,12,89,Florida,Nassau County,2,18,544,157,387
50,12,89,Florida,Nassau County,3,0,57949,28586,29363
50,12,89,Florida,Nassau County,3,1,3572,1800,1772
50,12,89,Florida,Nassau County,3,2,3896,2011,1885
50,12,89,Florida,Nassau County,3,3,4458,2285,2173
50,12,89,Florida,Nassau County,3,4,3833,2025,1808
50,12,89,Florida,Nassau County,3,5,2897,1465,1432
50,12,89,Florida,Nassau County,3,6,3253,1606,1647
50,12,89,Florida,Nassau County,3,7,3828,1866,1962
50,12,89,Florida,Nassau County,3,8,4728,2298,2430
50,12,89,Florida,Nassau County,3,9,4816,2380,2436
50,12,89,Florida,Nassau County,3,10,4501,2244,2257
50,12,89,Florida,Nassau County,3,11,4251,2066,2185
50,12,89,Florida,Nassau County,3,12,3605,1731,1874
50,12,89,Florida,Nassau County,3,13,2955,1483,1472
50,12,89,Florida,Nassau County,3,14,2523,1285,1238
50,12,89,Florida,Nassau County,3,15,2095,965,1130
50,12,89,Florida,Nassau County,3,16,1374,605,769
50,12,89,Florida,Nassau County,3,17,811,311,500
50,12,89,Florida,Nassau County,3,18,553,160,393
50,12,89,Florida,Nassau County,4,0,59123,29156,29967
50,12,89,Florida,Nassau County,4,1,3577,1803,1774
50,12,89,Florida,Nassau County,4,2,3935,2063,1872
50,12,89,Florida,Nassau County,4,3,4423,2247,2176
50,12,89,Florida,Nassau County,4,4,3933,2064,1869
50,12,89,Florida,Nassau County,4,5,3039,1525,1514
50,12,89,Florida,Nassau County,4,6,3172,1558,1614
50,12,89,Florida,Nassau County,4,7,3758,1875,1883
50,12,89,Florida,Nassau County,4,8,4704,2250,2454
50,12,89,Florida,Nassau County,4,9,4898,2456,2442
50,12,89,Florida,Nassau County,4,10,4610,2248,2362
50,12,89,Florida,Nassau County,4,11,4380,2151,2229
50,12,89,Florida,Nassau County,4,12,3796,1823,1973
50,12,89,Florida,Nassau County,4,13,3124,1573,1551
50,12,89,Florida,Nassau County,4,14,2563,1271,1292
50,12,89,Florida,Nassau County,4,15,2240,1070,1170
50,12,89,Florida,Nassau County,4,16,1475,636,839
50,12,89,Florida,Nassau County,4,17,897,357,540
50,12,89,Florida,Nassau County,4,18,599,186,413
50,12,89,Florida,Nassau County,5,0,60458,29828,30630
50,12,89,Florida,Nassau County,5,1,3623,1852,1771
50,12,89,Florida,Nassau County,5,2,3891,1990,1901
50,12,89,Florida,Nassau County,5,3,4529,2336,2193
50,12,89,Florida,Nassau County,5,4,4097,2116,1981
50,12,89,Florida,Nassau County,5,5,3083,1568,1515
50,12,89,Florida,Nassau County,5,6,3078,1533,1545
50,12,89,Florida,Nassau County,5,7,3866,1905,1961
50,12,89,Florida,Nassau County,5,8,4568,2203,2365
50,12,89,Florida,Nassau County,5,9,4969,2477,2492
50,12,89,Florida,Nassau County,5,10,4790,2336,2454
50,12,89,Florida,Nassau County,5,11,4409,2152,2257
50,12,89,Florida,Nassau County,5,12,4198,2039,2159
50,12,89,Florida,Nassau County,5,13,3298,1643,1655
50,12,89,Florida,Nassau County,5,14,2660,1325,1335
50,12,89,Florida,Nassau County,5,15,2246,1075,1171
50,12,89,Florida,Nassau County,5,16,1565,694,871
50,12,89,Florida,Nassau County,5,17,941,378,563
50,12,89,Florida,Nassau County,5,18,647,206,441
50,12,89,Florida,Nassau County,6,0,61513,30330,31183
50,12,89,Florida,Nassau County,6,1,3644,1860,1784
50,12,89,Florida,Nassau County,6,2,3819,1949,1870
50,12,89,Florida,Nassau County,6,3,4486,2303,2183
50,12,89,Florida,Nassau County,6,4,4251,2208,2043
50,12,89,Florida,Nassau County,6,5,3203,1640,1563
50,12,89,Florida,Nassau County,6,6,3166,1576,1590
50,12,89,Florida,Nassau County,6,7,3739,1815,1924
50,12,89,Florida,Nassau County,6,8,4473,2163,2310
50,12,89,Florida,Nassau County,6,9,5047,2510,2537
50,12,89,Florida,Nassau County,6,10,4918,2409,2509
50,12,89,Florida,Nassau County,6,11,4474,2180,2294
50,12,89,Florida,Nassau County,6,12,4346,2106,2240
50,12,89,Florida,Nassau County,6,13,3491,1718,1773
50,12,89,Florida,Nassau County,6,14,2803,1414,1389
50,12,89,Florida,Nassau County,6,15,2266,1096,1170
50,12,89,Florida,Nassau County,6,16,1654,748,906
50,12,89,Florida,Nassau County,6,17,1049,422,627
50,12,89,Florida,Nassau County,6,18,684,213,471
50,12,89,Florida,Nassau County,7,0,62909,31038,31871
50,12,89,Florida,Nassau County,7,1,3716,1920,1796
50,12,89,Florida,Nassau County,7,2,3927,1993,1934
50,12,89,Florida,Nassau County,7,3,4394,2249,2145
50,12,89,Florida,Nassau County,7,4,4304,2232,2072
50,12,89,Florida,Nassau County,7,5,3367,1730,1637
50,12,89,Florida,Nassau County,7,6,3190,1606,1584
50,12,89,Florida,Nassau County,7,7,3758,1817,1941
50,12,89,Florida,Nassau County,7,8,4351,2118,2233
50,12,89,Florida,Nassau County,7,9,5081,2506,2575
50,12,89,Florida,Nassau County,7,10,5068,2492,2576
50,12,89,Florida,Nassau County,7,11,4673,2298,2375
50,12,89,Florida,Nassau County,7,12,4580,2198,2382
50,12,89,Florida,Nassau County,7,13,3688,1794,1894
50,12,89,Florida,Nassau County,7,14,2933,1490,1443
50,12,89,Florida,Nassau County,7,15,2281,1111,1170
50,12,89,Florida,Nassau County,7,16,1763,798,965
50,12,89,Florida,Nassau County,7,17,1104,453,651
50,12,89,Florida,Nassau County,7,18,731,233,498
50,12,89,Florida,Nassau County,8,0,64526,31856,32670
50,12,89,Florida,Nassau County,8,1,3814,1979,1835
50,12,89,Florida,Nassau County,8,2,4011,2015,1996
50,12,89,Florida,Nassau County,8,3,4341,2237,2104
50,12,89,Florida,Nassau County,8,4,4411,2273,2138
50,12,89,Florida,Nassau County,8,5,3339,1737,1602
50,12,89,Florida,Nassau County,8,6,3511,1743,1768
50,12,89,Florida,Nassau County,8,7,3653,1803,1850
50,12,89,Florida,Nassau County,8,8,4253,2072,2181
50,12,89,Florida,Nassau County,8,9,5161,2515,2646
50,12,89,Florida,Nassau County,8,10,5204,2555,2649
50,12,89,Florida,Nassau County,8,11,4919,2438,2481
50,12,89,Florida,Nassau County,8,12,4732,2273,2459
50,12,89,Florida,Nassau County,8,13,3945,1887,2058
50,12,89,Florida,Nassau County,8,14,2995,1513,1482
50,12,89,Florida,Nassau County,8,15,2434,1212,1222
50,12,89,Florida,Nassau County,8,16,1826,831,995
50,12,89,Florida,Nassau County,8,17,1142,490,652
50,12,89,Florida,Nassau County,8,18,835,283,552
50,12,89,Florida,Nassau County,9,0,66529,32869,33660
50,12,89,Florida,Nassau County,9,1,3898,2017,1881
50,12,89,Florida,Nassau County,9,2,4118,2069,2049
50,12,89,Florida,Nassau County,9,3,4448,2325,2123
50,12,89,Florida,Nassau County,9,4,4357,2230,2127
50,12,89,Florida,Nassau County,9,5,3359,1733,1626
50,12,89,Florida,Nassau County,9,6,3782,1868,1914
50,12,89,Florida,Nassau County,9,7,3700,1822,1878
50,12,89,Florida,Nassau County,9,8,4245,2116,2129
50,12,89,Florida,Nassau County,9,9,5305,2561,2744
50,12,89,Florida,Nassau County,9,10,5323,2653,2670
50,12,89,Florida,Nassau County,9,11,5117,2483,2634
50,12,89,Florida,Nassau County,9,12,4945,2398,2547
50,12,89,Florida,Nassau County,9,13,4145,1984,2161
50,12,89,Florida,Nassau County,9,14,3215,1627,1588
50,12,89,Florida,Nassau County,9,15,2477,1214,1263
50,12,89,Florida,Nassau County,9,16,1936,907,1029
50,12,89,Florida,Nassau County,9,17,1250,533,717
50,12,89,Florida,Nassau County,9,18,909,329,580
50,12,89,Florida,Nassau County,10,0,68441,33846,34595
50,12,89,Florida,Nassau County,10,1,4024,2090,1934
50,12,89,Florida,Nassau County,10,2,4150,2112,2038
50,12,89,Florida,Nassau County,10,3,4492,2300,2192
50,12,89,Florida,Nassau County,10,4,4482,2329,2153
50,12,89,Florida,Nassau County,10,5,3501,1775,1726
50,12,89,Florida,Nassau County,10,6,3863,1942,1921
50,12,89,Florida,Nassau County,10,7,3704,1850,1854
50,12,89,Florida,Nassau County,10,8,4524,2238,2286
50,12,89,Florida,Nassau County,10,9,5202,2539,2663
50,12,89,Florida,Nassau County,10,10,5395,2678,2717
50,12,89,Florida,Nassau County,10,11,5299,2575,2724
50,12,89,Florida,Nassau County,10,12,4936,2377,2559
50,12,89,Florida,Nassau County,10,13,4564,2206,2358
50,12,89,Florida,Nassau County,10,14,3382,1684,1698
50,12,89,Florida,Nassau County,10,15,2607,1273,1334
50,12,89,Florida,Nassau County,10,16,1981,935,1046
50,12,89,Florida,Nassau County,10,17,1327,580,747
50,12,89,Florida,Nassau County,10,18,1008,363,645
50,12,89,Florida,Nassau County,11,0,69815,34540,35275
50,12,89,Florida,Nassau County,11,1,4217,2202,2015
50,12,89,Florida,Nassau County,11,2,4185,2126,2059
50,12,89,Florida,Nassau County,11,3,4444,2274,2170
50,12,89,Florida,Nassau County,11,4,4502,2334,2168
50,12,89,Florida,Nassau County,11,5,3677,1873,1804
50,12,89,Florida,Nassau County,11,6,3942,1989,1953
50,12,89,Florida,Nassau County,11,7,3834,1911,1923
50,12,89,Florida,Nassau County,11,8,4542,2221,2321
50,12,89,Florida,Nassau County,11,9,4989,2443,2546
50,12,89,Florida,Nassau County,11,10,5473,2715,2758
50,12,89,Florida,Nassau County,11,11,5413,2641,2772
50,12,89,Florida,Nassau County,11,12,5062,2445,2617
50,12,89,Florida,Nassau County,11,13,4769,2293,2476
50,12,89,Florida,Nassau County,11,14,3555,1755,1800
50,12,89,Florida,Nassau County,11,15,2695,1337,1358
50,12,89,Florida,Nassau County,11,16,2038,971,1067
50,12,89,Florida,Nassau County,11,17,1385,620,765
50,12,89,Florida,Nassau County,11,18,1093,390,703
50,12,89,Florida,Nassau County,12,0,70576,34918,35658
50,12,89,Florida,Nassau County,12,1,4236,2201,2035
50,12,89,Florida,Nassau County,12,2,4261,2190,2071
50,12,89,Florida,Nassau County,12,3,4481,2284,2197
50,12,89,Florida,Nassau County,12,4,4439,2295,2144
50,12,89,Florida,Nassau County,12,5,3784,1926,1858
50,12,89,Florida,Nassau County,12,6,4032,2035,1997
50,12,89,Florida,Nassau County,12,7,3764,1889,1875
50,12,89,Florida,Nassau County,12,8,4538,2210,2328
50,12,89,Florida,Nassau County,12,9,4798,2360,2438
50,12,89,Florida,Nassau County,12,10,5493,2710,2783
50,12,89,Florida,Nassau County,12,11,5449,2670,2779
50,12,89,Florida,Nassau County,12,12,5157,2515,2642
50,12,89,Florida,Nassau County,12,13,4958,2362,2596
50,12,89,Florida,Nassau County,12,14,3766,1832,1934
50,12,89,Florida,Nassau County,12,15,2786,1405,1381
50,12,89,Florida,Nassau County,12,16,2027,962,1065
50,12,89,Florida,Nassau County,12,17,1414,632,782
50,12,89,Florida,Nassau County,12,18,1193,440,753
50,12,91,Florida,Okaloosa County,1,0,170498,86160,84338
50,12,91,Florida,Okaloosa County,1,1,10843,5531,5312
50,12,91,Florida,Okaloosa County,1,2,11599,5925,5674
50,12,91,Florida,Okaloosa County,1,3,12223,6182,6041
50,12,91,Florida,Okaloosa County,1,4,12066,6305,5761
50,12,91,Florida,Okaloosa County,1,5,11831,6573,5258
50,12,91,Florida,Okaloosa County,1,6,11717,6339,5378
50,12,91,Florida,Okaloosa County,1,7,11959,6136,5823
50,12,91,Florida,Okaloosa County,1,8,15033,7929,7104
50,12,91,Florida,Okaloosa County,1,9,14321,7287,7034
50,12,91,Florida,Okaloosa County,1,10,11684,5790,5894
50,12,91,Florida,Okaloosa County,1,11,10635,5315,5320
50,12,91,Florida,Okaloosa County,1,12,8352,4119,4233
50,12,91,Florida,Okaloosa County,1,13,7579,3536,4043
50,12,91,Florida,Okaloosa County,1,14,7260,3594,3666
50,12,91,Florida,Okaloosa County,1,15,5380,2455,2925
50,12,91,Florida,Okaloosa County,1,16,4188,1746,2442
50,12,91,Florida,Okaloosa County,1,17,2258,977,1281
50,12,91,Florida,Okaloosa County,1,18,1570,421,1149
50,12,91,Florida,Okaloosa County,2,0,170497,86159,84338
50,12,91,Florida,Okaloosa County,2,1,10843,5531,5312
50,12,91,Florida,Okaloosa County,2,2,11599,5925,5674
50,12,91,Florida,Okaloosa County,2,3,12223,6182,6041
50,12,91,Florida,Okaloosa County,2,4,12066,6305,5761
50,12,91,Florida,Okaloosa County,2,5,11831,6573,5258
50,12,91,Florida,Okaloosa County,2,6,11717,6339,5378
50,12,91,Florida,Okaloosa County,2,7,11959,6136,5823
50,12,91,Florida,Okaloosa County,2,8,15032,7928,7104
50,12,91,Florida,Okaloosa County,2,9,14321,7287,7034
50,12,91,Florida,Okaloosa County,2,10,11684,5790,5894
50,12,91,Florida,Okaloosa County,2,11,10635,5315,5320
50,12,91,Florida,Okaloosa County,2,12,8352,4119,4233
50,12,91,Florida,Okaloosa County,2,13,7579,3536,4043
50,12,91,Florida,Okaloosa County,2,14,7260,3594,3666
50,12,91,Florida,Okaloosa County,2,15,5380,2455,2925
50,12,91,Florida,Okaloosa County,2,16,4188,1746,2442
50,12,91,Florida,Okaloosa County,2,17,2258,977,1281
50,12,91,Florida,Okaloosa County,2,18,1570,421,1149
50,12,91,Florida,Okaloosa County,3,0,170966,86380,84586
50,12,91,Florida,Okaloosa County,3,1,10849,5532,5317
50,12,91,Florida,Okaloosa County,3,2,11547,5899,5648
50,12,91,Florida,Okaloosa County,3,3,12270,6204,6066
50,12,91,Florida,Okaloosa County,3,4,12092,6320,5772
50,12,91,Florida,Okaloosa County,3,5,11936,6633,5303
50,12,91,Florida,Okaloosa County,3,6,11648,6303,5345
50,12,91,Florida,Okaloosa County,3,7,11957,6134,5823
50,12,91,Florida,Okaloosa County,3,8,14978,7900,7078
50,12,91,Florida,Okaloosa County,3,9,14358,7303,7055
50,12,91,Florida,Okaloosa County,3,10,11759,5826,5933
50,12,91,Florida,Okaloosa County,3,11,10738,5365,5373
50,12,91,Florida,Okaloosa County,3,12,8396,4139,4257
50,12,91,Florida,Okaloosa County,3,13,7605,3549,4056
50,12,91,Florida,Okaloosa County,3,14,7302,3611,3691
50,12,91,Florida,Okaloosa County,3,15,5416,2474,2942
50,12,91,Florida,Okaloosa County,3,16,4229,1765,2464
50,12,91,Florida,Okaloosa County,3,17,2295,995,1300
50,12,91,Florida,Okaloosa County,3,18,1591,428,1163
50,12,91,Florida,Okaloosa County,4,0,171966,86806,85160
50,12,91,Florida,Okaloosa County,4,1,10938,5595,5343
50,12,91,Florida,Okaloosa County,4,2,11345,5805,5540
50,12,91,Florida,Okaloosa County,4,3,12264,6152,6112
50,12,91,Florida,Okaloosa County,4,4,12026,6405,5621
50,12,91,Florida,Okaloosa County,4,5,12423,6720,5703
50,12,91,Florida,Okaloosa County,4,6,11263,6100,5163
50,12,91,Florida,Okaloosa County,4,7,11774,6126,5648
50,12,91,Florida,Okaloosa County,4,8,14281,7439,6842
50,12,91,Florida,Okaloosa County,4,9,14667,7544,7123
50,12,91,Florida,Okaloosa County,4,10,12207,6051,6156
50,12,91,Florida,Okaloosa County,4,11,11223,5573,5650
50,12,91,Florida,Okaloosa County,4,12,8693,4246,4447
50,12,91,Florida,Okaloosa County,4,13,7496,3557,3939
50,12,91,Florida,Okaloosa County,4,14,7293,3478,3815
50,12,91,Florida,Okaloosa County,4,15,5680,2735,2945
50,12,91,Florida,Okaloosa County,4,16,4213,1727,2486
50,12,91,Florida,Okaloosa County,4,17,2502,1080,1422
50,12,91,Florida,Okaloosa County,4,18,1678,473,1205
50,12,91,Florida,Okaloosa County,5,0,175924,88609,87315
50,12,91,Florida,Okaloosa County,5,1,11486,5884,5602
50,12,91,Florida,Okaloosa County,5,2,11333,5731,5602
50,12,91,Florida,Okaloosa County,5,3,12372,6309,6063
50,12,91,Florida,Okaloosa County,5,4,12358,6561,5797
50,12,91,Florida,Okaloosa County,5,5,13655,7198,6457
50,12,91,Florida,Okaloosa County,5,6,11348,6130,5218
50,12,91,Florida,Okaloosa County,5,7,11762,6109,5653
50,12,91,Florida,Okaloosa County,5,8,13554,6998,6556
50,12,91,Florida,Okaloosa County,5,9,14920,7665,7255
50,12,91,Florida,Okaloosa County,5,10,12776,6334,6442
50,12,91,Florida,Okaloosa County,5,11,11197,5495,5702
50,12,91,Florida,Okaloosa County,5,12,9515,4721,4794
50,12,91,Florida,Okaloosa County,5,13,7589,3599,3990
50,12,91,Florida,Okaloosa County,5,14,7353,3514,3839
50,12,91,Florida,Okaloosa County,5,15,5894,2864,3030
50,12,91,Florida,Okaloosa County,5,16,4237,1763,2474
50,12,91,Florida,Okaloosa County,5,17,2752,1175,1577
50,12,91,Florida,Okaloosa County,5,18,1823,559,1264
50,12,91,Florida,Okaloosa County,6,0,178644,89279,89365
50,12,91,Florida,Okaloosa County,6,1,11973,6143,5830
50,12,91,Florida,Okaloosa County,6,2,11293,5690,5603
50,12,91,Florida,Okaloosa County,6,3,12415,6361,6054
50,12,91,Florida,Okaloosa County,6,4,12528,6598,5930
50,12,91,Florida,Okaloosa County,6,5,14222,7201,7021
50,12,91,Florida,Okaloosa County,6,6,11353,5968,5385
50,12,91,Florida,Okaloosa County,6,7,11488,5931,5557
50,12,91,Florida,Okaloosa County,6,8,12936,6581,6355
50,12,91,Florida,Okaloosa County,6,9,15004,7689,7315
50,12,91,Florida,Okaloosa County,6,10,13488,6629,6859
50,12,91,Florida,Okaloosa County,6,11,11292,5501,5791
50,12,91,Florida,Okaloosa County,6,12,10122,5056,5066
50,12,91,Florida,Okaloosa County,6,13,7923,3779,4144
50,12,91,Florida,Okaloosa County,6,14,7283,3458,3825
50,12,91,Florida,Okaloosa County,6,15,6133,3007,3126
50,12,91,Florida,Okaloosa County,6,16,4360,1842,2518
50,12,91,Florida,Okaloosa County,6,17,2885,1220,1665
50,12,91,Florida,Okaloosa County,6,18,1946,625,1321
50,12,91,Florida,Okaloosa County,7,0,182220,91324,90896
50,12,91,Florida,Okaloosa County,7,1,12505,6463,6042
50,12,91,Florida,Okaloosa County,7,2,11156,5602,5554
50,12,91,Florida,Okaloosa County,7,3,12269,6278,5991
50,12,91,Florida,Okaloosa County,7,4,12631,6668,5963
50,12,91,Florida,Okaloosa County,7,5,15635,7905,7730
50,12,91,Florida,Okaloosa County,7,6,12074,6415,5659
50,12,91,Florida,Okaloosa County,7,7,11429,6020,5409
50,12,91,Florida,Okaloosa County,7,8,12250,6207,6043
50,12,91,Florida,Okaloosa County,7,9,15161,7765,7396
50,12,91,Florida,Okaloosa County,7,10,13904,6891,7013
50,12,91,Florida,Okaloosa County,7,11,11527,5588,5939
50,12,91,Florida,Okaloosa County,7,12,10477,5206,5271
50,12,91,Florida,Okaloosa County,7,13,8111,3931,4180
50,12,91,Florida,Okaloosa County,7,14,7304,3410,3894
50,12,91,Florida,Okaloosa County,7,15,6266,3088,3178
50,12,91,Florida,Okaloosa County,7,16,4419,1920,2499
50,12,91,Florida,Okaloosa County,7,17,3039,1256,1783
50,12,91,Florida,Okaloosa County,7,18,2063,711,1352
50,12,91,Florida,Okaloosa County,8,0,183398,91381,92017
50,12,91,Florida,Okaloosa County,8,1,12949,6618,6331
50,12,91,Florida,Okaloosa County,8,2,11023,5618,5405
50,12,91,Florida,Okaloosa County,8,3,12045,6144,5901
50,12,91,Florida,Okaloosa County,8,4,12511,6555,5956
50,12,91,Florida,Okaloosa County,8,5,16313,8299,8014
50,12,91,Florida,Okaloosa County,8,6,12516,6424,6092
50,12,91,Florida,Okaloosa County,8,7,11021,5759,5262
50,12,91,Florida,Okaloosa County,8,8,11660,5788,5872
50,12,91,Florida,Okaloosa County,8,9,14801,7549,7252
50,12,91,Florida,Okaloosa County,8,10,14287,7057,7230
50,12,91,Florida,Okaloosa County,8,11,11790,5715,6075
50,12,91,Florida,Okaloosa County,8,12,10884,5342,5542
50,12,91,Florida,Okaloosa County,8,13,8345,4058,4287
50,12,91,Florida,Okaloosa County,8,14,6973,3224,3749
50,12,91,Florida,Okaloosa County,8,15,6329,3091,3238
50,12,91,Florida,Okaloosa County,8,16,4558,2046,2512
50,12,91,Florida,Okaloosa County,8,17,3182,1299,1883
50,12,91,Florida,Okaloosa County,8,18,2211,795,1416
50,12,91,Florida,Okaloosa County,9,0,182462,91084,91378
50,12,91,Florida,Okaloosa County,9,1,12999,6630,6369
50,12,91,Florida,Okaloosa County,9,2,11003,5617,5386
50,12,91,Florida,Okaloosa County,9,3,11596,5919,5677
50,12,91,Florida,Okaloosa County,9,4,12398,6494,5904
50,12,91,Florida,Okaloosa County,9,5,16053,8478,7575
50,12,91,Florida,Okaloosa County,9,6,13075,6538,6537
50,12,91,Florida,Okaloosa County,9,7,10826,5688,5138
50,12,91,Florida,Okaloosa County,9,8,11325,5697,5628
50,12,91,Florida,Okaloosa County,9,9,14015,7069,6946
50,12,91,Florida,Okaloosa County,9,10,14504,7238,7266
50,12,91,Florida,Okaloosa County,9,11,12019,5825,6194
50,12,91,Florida,Okaloosa County,9,12,11213,5486,5727
50,12,91,Florida,Okaloosa County,9,13,8392,4037,4355
50,12,91,Florida,Okaloosa County,9,14,6651,3114,3537
50,12,91,Florida,Okaloosa County,9,15,6165,2907,3258
50,12,91,Florida,Okaloosa County,9,16,4684,2229,2455
50,12,91,Florida,Okaloosa County,9,17,3198,1264,1934
50,12,91,Florida,Okaloosa County,9,18,2346,854,1492
50,12,91,Florida,Okaloosa County,10,0,180911,90064,90847
50,12,91,Florida,Okaloosa County,10,1,13169,6719,6450
50,12,91,Florida,Okaloosa County,10,2,10962,5605,5357
50,12,91,Florida,Okaloosa County,10,3,11105,5613,5492
50,12,91,Florida,Okaloosa County,10,4,12249,6485,5764
50,12,91,Florida,Okaloosa County,10,5,15549,8197,7352
50,12,91,Florida,Okaloosa County,10,6,13588,6673,6915
50,12,91,Florida,Okaloosa County,10,7,10176,5323,4853
50,12,91,Florida,Okaloosa County,10,8,11020,5547,5473
50,12,91,Florida,Okaloosa County,10,9,13093,6570,6523
50,12,91,Florida,Okaloosa County,10,10,14419,7190,7229
50,12,91,Florida,Okaloosa County,10,11,12311,5976,6335
50,12,91,Florida,Okaloosa County,10,12,10929,5286,5643
50,12,91,Florida,Okaloosa County,10,13,8954,4372,4582
50,12,91,Florida,Okaloosa County,10,14,6623,3096,3527
50,12,91,Florida,Okaloosa County,10,15,6190,2900,3290
50,12,91,Florida,Okaloosa County,10,16,4838,2317,2521
50,12,91,Florida,Okaloosa County,10,17,3156,1264,1892
50,12,91,Florida,Okaloosa County,10,18,2580,931,1649
50,12,91,Florida,Okaloosa County,11,0,179529,89278,90251
50,12,91,Florida,Okaloosa County,11,1,12922,6578,6344
50,12,91,Florida,Okaloosa County,11,2,11081,5669,5412
50,12,91,Florida,Okaloosa County,11,3,10661,5373,5288
50,12,91,Florida,Okaloosa County,11,4,11892,6299,5593
50,12,91,Florida,Okaloosa County,11,5,15294,8051,7243
50,12,91,Florida,Okaloosa County,11,6,13953,6825,7128
50,12,91,Florida,Okaloosa County,11,7,9688,5012,4676
50,12,91,Florida,Okaloosa County,11,8,10783,5502,5281
50,12,91,Florida,Okaloosa County,11,9,12237,6134,6103
50,12,91,Florida,Okaloosa County,11,10,14132,7089,7043
50,12,91,Florida,Okaloosa County,11,11,12773,6158,6615
50,12,91,Florida,Okaloosa County,11,12,10681,5140,5541
50,12,91,Florida,Okaloosa County,11,13,9467,4658,4809
50,12,91,Florida,Okaloosa County,11,14,6826,3210,3616
50,12,91,Florida,Okaloosa County,11,15,6111,2826,3285
50,12,91,Florida,Okaloosa County,11,16,5010,2412,2598
50,12,91,Florida,Okaloosa County,11,17,3310,1351,1959
50,12,91,Florida,Okaloosa County,11,18,2708,991,1717
50,12,91,Florida,Okaloosa County,12,0,178473,88735,89738
50,12,91,Florida,Okaloosa County,12,1,12928,6567,6361
50,12,91,Florida,Okaloosa County,12,2,11213,5796,5417
50,12,91,Florida,Okaloosa County,12,3,10379,5214,5165
50,12,91,Florida,Okaloosa County,12,4,11344,6019,5325
50,12,91,Florida,Okaloosa County,12,5,14774,7790,6984
50,12,91,Florida,Okaloosa County,12,6,14629,7136,7493
50,12,91,Florida,Okaloosa County,12,7,9534,4951,4583
50,12,91,Florida,Okaloosa County,12,8,10259,5316,4943
50,12,91,Florida,Okaloosa County,12,9,11353,5611,5742
50,12,91,Florida,Okaloosa County,12,10,14031,6999,7032
50,12,91,Florida,Okaloosa County,12,11,13059,6345,6714
50,12,91,Florida,Okaloosa County,12,12,10826,5192,5634
50,12,91,Florida,Okaloosa County,12,13,9695,4758,4937
50,12,91,Florida,Okaloosa County,12,14,7015,3359,3656
50,12,91,Florida,Okaloosa County,12,15,6076,2755,3321
50,12,91,Florida,Okaloosa County,12,16,5068,2427,2641
50,12,91,Florida,Okaloosa County,12,17,3358,1427,1931
50,12,91,Florida,Okaloosa County,12,18,2932,1073,1859
50,12,93,Florida,Okeechobee County,1,0,35910,19245,16665
50,12,93,Florida,Okeechobee County,1,1,2255,1187,1068
50,12,93,Florida,Okeechobee County,1,2,2460,1267,1193
50,12,93,Florida,Okeechobee County,1,3,2584,1361,1223
50,12,93,Florida,Okeechobee County,1,4,2822,1700,1122
50,12,93,Florida,Okeechobee County,1,5,2330,1370,960
50,12,93,Florida,Okeechobee County,1,6,2288,1374,914
50,12,93,Florida,Okeechobee County,1,7,2323,1364,959
50,12,93,Florida,Okeechobee County,1,8,2588,1406,1182
50,12,93,Florida,Okeechobee County,1,9,2517,1378,1139
50,12,93,Florida,Okeechobee County,1,10,2104,1116,988
50,12,93,Florida,Okeechobee County,1,11,2029,1023,1006
50,12,93,Florida,Okeechobee County,1,12,1858,922,936
50,12,93,Florida,Okeechobee County,1,13,1888,936,952
50,12,93,Florida,Okeechobee County,1,14,1743,883,860
50,12,93,Florida,Okeechobee County,1,15,1681,837,844
50,12,93,Florida,Okeechobee County,1,16,1248,618,630
50,12,93,Florida,Okeechobee County,1,17,705,315,390
50,12,93,Florida,Okeechobee County,1,18,487,188,299
50,12,93,Florida,Okeechobee County,2,0,35910,19245,16665
50,12,93,Florida,Okeechobee County,2,1,2255,1187,1068
50,12,93,Florida,Okeechobee County,2,2,2460,1267,1193
50,12,93,Florida,Okeechobee County,2,3,2584,1361,1223
50,12,93,Florida,Okeechobee County,2,4,2822,1700,1122
50,12,93,Florida,Okeechobee County,2,5,2330,1370,960
50,12,93,Florida,Okeechobee County,2,6,2288,1374,914
50,12,93,Florida,Okeechobee County,2,7,2323,1364,959
50,12,93,Florida,Okeechobee County,2,8,2588,1406,1182
50,12,93,Florida,Okeechobee County,2,9,2517,1378,1139
50,12,93,Florida,Okeechobee County,2,10,2104,1116,988
50,12,93,Florida,Okeechobee County,2,11,2029,1023,1006
50,12,93,Florida,Okeechobee County,2,12,1858,922,936
50,12,93,Florida,Okeechobee County,2,13,1888,936,952
50,12,93,Florida,Okeechobee County,2,14,1743,883,860
50,12,93,Florida,Okeechobee County,2,15,1681,837,844
50,12,93,Florida,Okeechobee County,2,16,1248,618,630
50,12,93,Florida,Okeechobee County,2,17,705,315,390
50,12,93,Florida,Okeechobee County,2,18,487,188,299
50,12,93,Florida,Okeechobee County,3,0,35917,19260,16657
50,12,93,Florida,Okeechobee County,3,1,2257,1187,1070
50,12,93,Florida,Okeechobee County,3,2,2448,1261,1187
50,12,93,Florida,Okeechobee County,3,3,2586,1362,1224
50,12,93,Florida,Okeechobee County,3,4,2820,1698,1122
50,12,93,Florida,Okeechobee County,3,5,2341,1377,964
50,12,93,Florida,Okeechobee County,3,6,2276,1368,908
50,12,93,Florida,Okeechobee County,3,7,2322,1365,957
50,12,93,Florida,Okeechobee County,3,8,2577,1402,1175
50,12,93,Florida,Okeechobee County,3,9,2519,1381,1138
50,12,93,Florida,Okeechobee County,3,10,2108,1120,988
50,12,93,Florida,Okeechobee County,3,11,2043,1032,1011
50,12,93,Florida,Okeechobee County,3,12,1863,925,938
50,12,93,Florida,Okeechobee County,3,13,1889,937,952
50,12,93,Florida,Okeechobee County,3,14,1737,880,857
50,12,93,Florida,Okeechobee County,3,15,1678,837,841
50,12,93,Florida,Okeechobee County,3,16,1251,620,631
50,12,93,Florida,Okeechobee County,3,17,711,318,393
50,12,93,Florida,Okeechobee County,3,18,491,190,301
50,12,93,Florida,Okeechobee County,4,0,36315,19408,16907
50,12,93,Florida,Okeechobee County,4,1,2442,1254,1188
50,12,93,Florida,Okeechobee County,4,2,2454,1274,1180
50,12,93,Florida,Okeechobee County,4,3,2535,1344,1191
50,12,93,Florida,Okeechobee County,4,4,2832,1691,1141
50,12,93,Florida,Okeechobee County,4,5,2451,1440,1011
50,12,93,Florida,Okeechobee County,4,6,2252,1335,917
50,12,93,Florida,Okeechobee County,4,7,2363,1408,955
50,12,93,Florida,Okeechobee County,4,8,2481,1335,1146
50,12,93,Florida,Okeechobee County,4,9,2520,1354,1166
50,12,93,Florida,Okeechobee County,4,10,2195,1164,1031
50,12,93,Florida,Okeechobee County,4,11,2087,1063,1024
50,12,93,Florida,Okeechobee County,4,12,1833,918,915
50,12,93,Florida,Okeechobee County,4,13,1966,987,979
50,12,93,Florida,Okeechobee County,4,14,1695,824,871
50,12,93,Florida,Okeechobee County,4,15,1650,826,824
50,12,93,Florida,Okeechobee County,4,16,1308,660,648
50,12,93,Florida,Okeechobee County,4,17,748,331,417
50,12,93,Florida,Okeechobee County,4,18,503,200,303
50,12,93,Florida,Okeechobee County,5,0,36822,19690,17132
50,12,93,Florida,Okeechobee County,5,1,2576,1307,1269
50,12,93,Florida,Okeechobee County,5,2,2377,1255,1122
50,12,93,Florida,Okeechobee County,5,3,2578,1355,1223
50,12,93,Florida,Okeechobee County,5,4,2807,1673,1134
50,12,93,Florida,Okeechobee County,5,5,2515,1479,1036
50,12,93,Florida,Okeechobee County,5,6,2305,1369,936
50,12,93,Florida,Okeechobee County,5,7,2411,1430,981
50,12,93,Florida,Okeechobee County,5,8,2481,1366,1115
50,12,93,Florida,Okeechobee County,5,9,2535,1363,1172
50,12,93,Florida,Okeechobee County,5,10,2265,1202,1063
50,12,93,Florida,Okeechobee County,5,11,2111,1074,1037
50,12,93,Florida,Okeechobee County,5,12,1961,991,970
50,12,93,Florida,Okeechobee County,5,13,1935,953,982
50,12,93,Florida,Okeechobee County,5,14,1675,810,865
50,12,93,Florida,Okeechobee County,5,15,1605,798,807
50,12,93,Florida,Okeechobee County,5,16,1367,694,673
50,12,93,Florida,Okeechobee County,5,17,779,355,424
50,12,93,Florida,Okeechobee County,5,18,539,216,323
50,12,93,Florida,Okeechobee County,6,0,37303,19987,17316
50,12,93,Florida,Okeechobee County,6,1,2644,1336,1308
50,12,93,Florida,Okeechobee County,6,2,2351,1231,1120
50,12,93,Florida,Okeechobee County,6,3,2567,1337,1230
50,12,93,Florida,Okeechobee County,6,4,2783,1662,1121
50,12,93,Florida,Okeechobee County,6,5,2546,1529,1017
50,12,93,Florida,Okeechobee County,6,6,2466,1470,996
50,12,93,Florida,Okeechobee County,6,7,2420,1424,996
50,12,93,Florida,Okeechobee County,6,8,2465,1403,1062
50,12,93,Florida,Okeechobee County,6,9,2567,1388,1179
50,12,93,Florida,Okeechobee County,6,10,2316,1216,1100
50,12,93,Florida,Okeechobee County,6,11,2116,1095,1021
50,12,93,Florida,Okeechobee County,6,12,1999,1024,975
50,12,93,Florida,Okeechobee County,6,13,1967,934,1033
50,12,93,Florida,Okeechobee County,6,14,1708,836,872
50,12,93,Florida,Okeechobee County,6,15,1551,783,768
50,12,93,Florida,Okeechobee County,6,16,1441,723,718
50,12,93,Florida,Okeechobee County,6,17,832,376,456
50,12,93,Florida,Okeechobee County,6,18,564,220,344
50,12,93,Florida,Okeechobee County,7,0,38672,20818,17854
50,12,93,Florida,Okeechobee County,7,1,2850,1411,1439
50,12,93,Florida,Okeechobee County,7,2,2417,1269,1148
50,12,93,Florida,Okeechobee County,7,3,2611,1385,1226
50,12,93,Florida,Okeechobee County,7,4,2791,1647,1144
50,12,93,Florida,Okeechobee County,7,5,2687,1628,1059
50,12,93,Florida,Okeechobee County,7,6,2593,1533,1060
50,12,93,Florida,Okeechobee County,7,7,2519,1541,978
50,12,93,Florida,Okeechobee County,7,8,2525,1461,1064
50,12,93,Florida,Okeechobee County,7,9,2720,1500,1220
50,12,93,Florida,Okeechobee County,7,10,2484,1326,1158
50,12,93,Florida,Okeechobee County,7,11,2189,1114,1075
50,12,93,Florida,Okeechobee County,7,12,2046,1048,998
50,12,93,Florida,Okeechobee County,7,13,1988,950,1038
50,12,93,Florida,Okeechobee County,7,14,1773,864,909
50,12,93,Florida,Okeechobee County,7,15,1527,785,742
50,12,93,Florida,Okeechobee County,7,16,1434,673,761
50,12,93,Florida,Okeechobee County,7,17,881,430,451
50,12,93,Florida,Okeechobee County,7,18,637,253,384
50,12,93,Florida,Okeechobee County,8,0,39380,21192,18188
50,12,93,Florida,Okeechobee County,8,1,2930,1458,1472
50,12,93,Florida,Okeechobee County,8,2,2478,1311,1167
50,12,93,Florida,Okeechobee County,8,3,2580,1348,1232
50,12,93,Florida,Okeechobee County,8,4,2857,1693,1164
50,12,93,Florida,Okeechobee County,8,5,2666,1601,1065
50,12,93,Florida,Okeechobee County,8,6,2786,1639,1147
50,12,93,Florida,Okeechobee County,8,7,2525,1549,976
50,12,93,Florida,Okeechobee County,8,8,2557,1511,1046
50,12,93,Florida,Okeechobee County,8,9,2754,1518,1236
50,12,93,Florida,Okeechobee County,8,10,2540,1353,1187
50,12,93,Florida,Okeechobee County,8,11,2293,1189,1104
50,12,93,Florida,Okeechobee County,8,12,2098,1034,1064
50,12,93,Florida,Okeechobee County,8,13,1978,976,1002
50,12,93,Florida,Okeechobee County,8,14,1851,886,965
50,12,93,Florida,Okeechobee County,8,15,1461,721,740
50,12,93,Florida,Okeechobee County,8,16,1409,655,754
50,12,93,Florida,Okeechobee County,8,17,949,488,461
50,12,93,Florida,Okeechobee County,8,18,668,262,406
50,12,93,Florida,Okeechobee County,9,0,39813,21442,18371
50,12,93,Florida,Okeechobee County,9,1,2957,1482,1475
50,12,93,Florida,Okeechobee County,9,2,2652,1371,1281
50,12,93,Florida,Okeechobee County,9,3,2563,1349,1214
50,12,93,Florida,Okeechobee County,9,4,2802,1664,1138
50,12,93,Florida,Okeechobee County,9,5,2674,1590,1084
50,12,93,Florida,Okeechobee County,9,6,2942,1737,1205
50,12,93,Florida,Okeechobee County,9,7,2551,1556,995
50,12,93,Florida,Okeechobee County,9,8,2594,1566,1028
50,12,93,Florida,Okeechobee County,9,9,2728,1501,1227
50,12,93,Florida,Okeechobee County,9,10,2576,1357,1219
50,12,93,Florida,Okeechobee County,9,11,2370,1243,1127
50,12,93,Florida,Okeechobee County,9,12,2224,1102,1122
50,12,93,Florida,Okeechobee County,9,13,1952,971,981
50,12,93,Florida,Okeechobee County,9,14,1807,872,935
50,12,93,Florida,Okeechobee County,9,15,1412,676,736
50,12,93,Florida,Okeechobee County,9,16,1319,617,702
50,12,93,Florida,Okeechobee County,9,17,990,515,475
50,12,93,Florida,Okeechobee County,9,18,700,273,427
50,12,93,Florida,Okeechobee County,10,0,40023,21588,18435
50,12,93,Florida,Okeechobee County,10,1,2998,1513,1485
50,12,93,Florida,Okeechobee County,10,2,2701,1383,1318
50,12,93,Florida,Okeechobee County,10,3,2537,1355,1182
50,12,93,Florida,Okeechobee County,10,4,2828,1668,1160
50,12,93,Florida,Okeechobee County,10,5,2639,1580,1059
50,12,93,Florida,Okeechobee County,10,6,3011,1773,1238
50,12,93,Florida,Okeechobee County,10,7,2581,1569,1012
50,12,93,Florida,Okeechobee County,10,8,2590,1558,1032
50,12,93,Florida,Okeechobee County,10,9,2685,1510,1175
50,12,93,Florida,Okeechobee County,10,10,2639,1389,1250
50,12,93,Florida,Okeechobee County,10,11,2352,1239,1113
50,12,93,Florida,Okeechobee County,10,12,2184,1092,1092
50,12,93,Florida,Okeechobee County,10,13,1992,997,995
50,12,93,Florida,Okeechobee County,10,14,1825,871,954
50,12,93,Florida,Okeechobee County,10,15,1430,676,754
50,12,93,Florida,Okeechobee County,10,16,1258,583,675
50,12,93,Florida,Okeechobee County,10,17,1022,524,498
50,12,93,Florida,Okeechobee County,10,18,751,308,443
50,12,93,Florida,Okeechobee County,11,0,40222,21713,18509
50,12,93,Florida,Okeechobee County,11,1,3040,1551,1489
50,12,93,Florida,Okeechobee County,11,2,2744,1399,1345
50,12,93,Florida,Okeechobee County,11,3,2486,1319,1167
50,12,93,Florida,Okeechobee County,11,4,2883,1691,1192
50,12,93,Florida,Okeechobee County,11,5,2612,1561,1051
50,12,93,Florida,Okeechobee County,11,6,2966,1775,1191
50,12,93,Florida,Okeechobee County,11,7,2683,1628,1055
50,12,93,Florida,Okeechobee County,11,8,2622,1557,1065
50,12,93,Florida,Okeechobee County,11,9,2650,1530,1120
50,12,93,Florida,Okeechobee County,11,10,2566,1353,1213
50,12,93,Florida,Okeechobee County,11,11,2429,1262,1167
50,12,93,Florida,Okeechobee County,11,12,2159,1090,1069
50,12,93,Florida,Okeechobee County,11,13,2021,1025,996
50,12,93,Florida,Okeechobee County,11,14,1833,842,991
50,12,93,Florida,Okeechobee County,11,15,1470,706,764
50,12,93,Florida,Okeechobee County,11,16,1213,580,633
50,12,93,Florida,Okeechobee County,11,17,1063,533,530
50,12,93,Florida,Okeechobee County,11,18,782,311,471
50,12,93,Florida,Okeechobee County,12,0,40241,21742,18499
50,12,93,Florida,Okeechobee County,12,1,3022,1553,1469
50,12,93,Florida,Okeechobee County,12,2,2869,1429,1440
50,12,93,Florida,Okeechobee County,12,3,2451,1307,1144
50,12,93,Florida,Okeechobee County,12,4,2811,1678,1133
50,12,93,Florida,Okeechobee County,12,5,2622,1555,1067
50,12,93,Florida,Okeechobee County,12,6,2973,1787,1186
50,12,93,Florida,Okeechobee County,12,7,2724,1625,1099
50,12,93,Florida,Okeechobee County,12,8,2580,1573,1007
50,12,93,Florida,Okeechobee County,12,9,2553,1485,1068
50,12,93,Florida,Okeechobee County,12,10,2602,1385,1217
50,12,93,Florida,Okeechobee County,12,11,2464,1295,1169
50,12,93,Florida,Okeechobee County,12,12,2136,1060,1076
50,12,93,Florida,Okeechobee County,12,13,2022,1026,996
50,12,93,Florida,Okeechobee County,12,14,1855,863,992
50,12,93,Florida,Okeechobee County,12,15,1484,699,785
50,12,93,Florida,Okeechobee County,12,16,1194,583,611
50,12,93,Florida,Okeechobee County,12,17,1041,488,553
50,12,93,Florida,Okeechobee County,12,18,838,351,487
50,12,95,Florida,Orange County,1,0,896344,443716,452628
50,12,95,Florida,Orange County,1,1,61375,31444,29931
50,12,95,Florida,Orange County,1,2,65241,33477,31764
50,12,95,Florida,Orange County,1,3,63672,32690,30982
50,12,95,Florida,Orange County,1,4,63342,32108,31234
50,12,95,Florida,Orange County,1,5,70763,35810,34953
50,12,95,Florida,Orange County,1,6,73918,37543,36375
50,12,95,Florida,Orange County,1,7,75137,38798,36339
50,12,95,Florida,Orange County,1,8,80275,40870,39405
50,12,95,Florida,Orange County,1,9,73346,36869,36477
50,12,95,Florida,Orange County,1,10,61217,30169,31048
50,12,95,Florida,Orange County,1,11,51296,25010,26286
50,12,95,Florida,Orange County,1,12,37413,17982,19431
50,12,95,Florida,Orange County,1,13,29390,13757,15633
50,12,95,Florida,Orange County,1,14,26064,12022,14042
50,12,95,Florida,Orange County,1,15,23305,10063,13242
50,12,95,Florida,Orange County,1,16,18810,7616,11194
50,12,95,Florida,Orange County,1,17,12137,4663,7474
50,12,95,Florida,Orange County,1,18,9643,2825,6818
50,12,95,Florida,Orange County,2,0,896354,443719,452635
50,12,95,Florida,Orange County,2,1,61375,31444,29931
50,12,95,Florida,Orange County,2,2,65241,33477,31764
50,12,95,Florida,Orange County,2,3,63672,32690,30982
50,12,95,Florida,Orange County,2,4,63342,32108,31234
50,12,95,Florida,Orange County,2,5,70763,35810,34953
50,12,95,Florida,Orange County,2,6,73919,37543,36376
50,12,95,Florida,Orange County,2,7,75137,38798,36339
50,12,95,Florida,Orange County,2,8,80275,40870,39405
50,12,95,Florida,Orange County,2,9,73346,36869,36477
50,12,95,Florida,Orange County,2,10,61219,30170,31049
50,12,95,Florida,Orange County,2,11,51297,25010,26287
50,12,95,Florida,Orange County,2,12,37413,17982,19431
50,12,95,Florida,Orange County,2,13,29392,13758,15634
50,12,95,Florida,Orange County,2,14,26065,12023,14042
50,12,95,Florida,Orange County,2,15,23307,10063,13244
50,12,95,Florida,Orange County,2,16,18810,7616,11194
50,12,95,Florida,Orange County,2,17,12138,4663,7475
50,12,95,Florida,Orange County,2,18,9643,2825,6818
50,12,95,Florida,Orange County,3,0,902756,446954,455802
50,12,95,Florida,Orange County,3,1,61778,31643,30135
50,12,95,Florida,Orange County,3,2,65355,33533,31822
50,12,95,Florida,Orange County,3,3,64353,33035,31318
50,12,95,Florida,Orange County,3,4,63705,32302,31403
50,12,95,Florida,Orange County,3,5,71699,36306,35393
50,12,95,Florida,Orange County,3,6,73992,37584,36408
50,12,95,Florida,Orange County,3,7,75580,39028,36552
50,12,95,Florida,Orange County,3,8,80497,40986,39511
50,12,95,Florida,Orange County,3,9,73985,37188,36797
50,12,95,Florida,Orange County,3,10,61905,30513,31392
50,12,95,Florida,Orange County,3,11,52121,25406,26715
50,12,95,Florida,Orange County,3,12,37850,18195,19655
50,12,95,Florida,Orange County,3,13,29672,13895,15777
50,12,95,Florida,Orange County,3,14,26051,12021,14030
50,12,95,Florida,Orange County,3,15,23341,10093,13248
50,12,95,Florida,Orange County,3,16,18892,7655,11237
50,12,95,Florida,Orange County,3,17,12256,4718,7538
50,12,95,Florida,Orange County,3,18,9724,2853,6871
50,12,95,Florida,Orange County,4,0,927735,459579,468156
50,12,95,Florida,Orange County,4,1,64460,32840,31620
50,12,95,Florida,Orange County,4,2,65899,33925,31974
50,12,95,Florida,Orange County,4,3,66313,33992,32321
50,12,95,Florida,Orange County,4,4,63020,32248,30772
50,12,95,Florida,Orange County,4,5,78998,39759,39239
50,12,95,Florida,Orange County,4,6,74900,38125,36775
50,12,95,Florida,Orange County,4,7,77374,39745,37629
50,12,95,Florida,Orange County,4,8,80130,40839,39291
50,12,95,Florida,Orange County,4,9,76538,38533,38005
50,12,95,Florida,Orange County,4,10,64320,31800,32520
50,12,95,Florida,Orange County,4,11,55196,26818,28378
50,12,95,Florida,Orange County,4,12,39389,19045,20344
50,12,95,Florida,Orange County,4,13,30218,14109,16109
50,12,95,Florida,Orange County,4,14,25633,11792,13841
50,12,95,Florida,Orange County,4,15,23317,10278,13039
50,12,95,Florida,Orange County,4,16,18974,7712,11262
50,12,95,Florida,Orange County,4,17,12991,5007,7984
50,12,95,Florida,Orange County,4,18,10065,3012,7053
50,12,95,Florida,Orange County,5,0,946806,469121,477685
50,12,95,Florida,Orange County,5,1,66742,33977,32765
50,12,95,Florida,Orange County,5,2,66075,34027,32048
50,12,95,Florida,Orange County,5,3,67652,34669,32983
50,12,95,Florida,Orange County,5,4,63249,32561,30688
50,12,95,Florida,Orange County,5,5,81826,40852,40974
50,12,95,Florida,Orange County,5,6,77038,39260,37778
50,12,95,Florida,Orange County,5,7,78481,40201,38280
50,12,95,Florida,Orange County,5,8,79134,40418,38716
50,12,95,Florida,Orange County,5,9,77876,39279,38597
50,12,95,Florida,Orange County,5,10,67078,33239,33839
50,12,95,Florida,Orange County,5,11,55744,27076,28668
50,12,95,Florida,Orange County,5,12,42767,20570,22197
50,12,95,Florida,Orange County,5,13,31181,14624,16557
50,12,95,Florida,Orange County,5,14,25544,11738,13806
50,12,95,Florida,Orange County,5,15,23210,10430,12780
50,12,95,Florida,Orange County,5,16,19285,7807,11478
50,12,95,Florida,Orange County,5,17,13438,5166,8272
50,12,95,Florida,Orange County,5,18,10486,3227,7259
50,12,95,Florida,Orange County,6,0,965744,479068,486676
50,12,95,Florida,Orange County,6,1,68957,35114,33843
50,12,95,Florida,Orange County,6,2,65576,33680,31896
50,12,95,Florida,Orange County,6,3,68797,35374,33423
50,12,95,Florida,Orange County,6,4,64777,33277,31500
50,12,95,Florida,Orange County,6,5,82673,41388,41285
50,12,95,Florida,Orange County,6,6,81170,41622,39548
50,12,95,Florida,Orange County,6,7,78654,40140,38514
50,12,95,Florida,Orange County,6,8,78062,39944,38118
50,12,95,Florida,Orange County,6,9,79403,40188,39215
50,12,95,Florida,Orange County,6,10,69711,34525,35186
50,12,95,Florida,Orange County,6,11,57002,27586,29416
50,12,95,Florida,Orange County,6,12,45314,21895,23419
50,12,95,Florida,Orange County,6,13,32626,15325,17301
50,12,95,Florida,Orange County,6,14,25799,11922,13877
50,12,95,Florida,Orange County,6,15,23041,10429,12612
50,12,95,Florida,Orange County,6,16,19321,7828,11493
50,12,95,Florida,Orange County,6,17,13965,5398,8567
50,12,95,Florida,Orange County,6,18,10896,3433,7463
50,12,95,Florida,Orange County,7,0,993478,493333,500145
50,12,95,Florida,Orange County,7,1,72777,37104,35673
50,12,95,Florida,Orange County,7,2,66367,33965,32402
50,12,95,Florida,Orange County,7,3,70231,36084,34147
50,12,95,Florida,Orange County,7,4,66681,34328,32353
50,12,95,Florida,Orange County,7,5,82572,41555,41017
50,12,95,Florida,Orange County,7,6,87502,44757,42745
50,12,95,Florida,Orange County,7,7,79921,40792,39129
50,12,95,Florida,Orange County,7,8,77630,39782,37848
50,12,95,Florida,Orange County,7,9,81437,41180,40257
50,12,95,Florida,Orange County,7,10,72090,35813,36277
50,12,95,Florida,Orange County,7,11,59284,28800,30484
50,12,95,Florida,Orange County,7,12,48067,23175,24892
50,12,95,Florida,Orange County,7,13,34131,16127,18004
50,12,95,Florida,Orange County,7,14,26359,12134,14225
50,12,95,Florida,Orange County,7,15,22908,10420,12488
50,12,95,Florida,Orange County,7,16,19512,7997,11515
50,12,95,Florida,Orange County,7,17,14532,5633,8899
50,12,95,Florida,Orange County,7,18,11477,3687,7790
50,12,95,Florida,Orange County,8,0,1029447,511272,518175
50,12,95,Florida,Orange County,8,1,77575,39499,38076
50,12,95,Florida,Orange County,8,2,68081,34821,33260
50,12,95,Florida,Orange County,8,3,71566,36715,34851
50,12,95,Florida,Orange County,8,4,69880,35896,33984
50,12,95,Florida,Orange County,8,5,82211,41511,40700
50,12,95,Florida,Orange County,8,6,96046,48986,47060
50,12,95,Florida,Orange County,8,7,80361,40827,39534
50,12,95,Florida,Orange County,8,8,79357,40729,38628
50,12,95,Florida,Orange County,8,9,83184,42101,41083
50,12,95,Florida,Orange County,8,10,75032,37364,37668
50,12,95,Florida,Orange County,8,11,62296,30336,31960
50,12,95,Florida,Orange County,8,12,51195,24559,26636
50,12,95,Florida,Orange County,8,13,35829,17017,18812
50,12,95,Florida,Orange County,8,14,26863,12418,14445
50,12,95,Florida,Orange County,8,15,23011,10481,12530
50,12,95,Florida,Orange County,8,16,19777,8276,11501
50,12,95,Florida,Orange County,8,17,14895,5707,9188
50,12,95,Florida,Orange County,8,18,12288,4029,8259
50,12,95,Florida,Orange County,9,0,1053941,523725,530216
50,12,95,Florida,Orange County,9,1,79926,40738,39188
50,12,95,Florida,Orange County,9,2,70308,35776,34532
50,12,95,Florida,Orange County,9,3,71897,37008,34889
50,12,95,Florida,Orange County,9,4,72189,36990,35199
50,12,95,Florida,Orange County,9,5,81884,41742,40142
50,12,95,Florida,Orange County,9,6,102793,52079,50714
50,12,95,Florida,Orange County,9,7,80946,41223,39723
50,12,95,Florida,Orange County,9,8,80748,41301,39447
50,12,95,Florida,Orange County,9,9,82801,41976,40825
50,12,95,Florida,Orange County,9,10,77611,38735,38876
50,12,95,Florida,Orange County,9,11,64239,31397,32842
50,12,95,Florida,Orange County,9,12,53987,25821,28166
50,12,95,Florida,Orange County,9,13,37317,17818,19499
50,12,95,Florida,Orange County,9,14,27053,12448,14605
50,12,95,Florida,Orange County,9,15,22546,10251,12295
50,12,95,Florida,Orange County,9,16,19608,8356,11252
50,12,95,Florida,Orange County,9,17,15041,5784,9257
50,12,95,Florida,Orange County,9,18,13047,4282,8765
50,12,95,Florida,Orange County,10,0,1066117,530361,535756
50,12,95,Florida,Orange County,10,1,80771,41128,39643
50,12,95,Florida,Orange County,10,2,71589,36393,35196
50,12,95,Florida,Orange County,10,3,70723,36431,34292
50,12,95,Florida,Orange County,10,4,73382,37561,35821
50,12,95,Florida,Orange County,10,5,81228,41782,39446
50,12,95,Florida,Orange County,10,6,104767,52885,51882
50,12,95,Florida,Orange County,10,7,82145,41952,40193
50,12,95,Florida,Orange County,10,8,81102,41492,39610
50,12,95,Florida,Orange County,10,9,81090,41257,39833
50,12,95,Florida,Orange County,10,10,78700,39373,39327
50,12,95,Florida,Orange County,10,11,66621,32698,33923
50,12,95,Florida,Orange County,10,12,54665,26173,28492
50,12,95,Florida,Orange County,10,13,40267,19117,21150
50,12,95,Florida,Orange County,10,14,27937,12950,14987
50,12,95,Florida,Orange County,10,15,22607,10253,12354
50,12,95,Florida,Orange County,10,16,19530,8521,11009
50,12,95,Florida,Orange County,10,17,15320,5857,9463
50,12,95,Florida,Orange County,10,18,13673,4538,9135
50,12,95,Florida,Orange County,11,0,1075737,534916,540821
50,12,95,Florida,Orange County,11,1,81140,41305,39835
50,12,95,Florida,Orange County,11,2,72666,36943,35723
50,12,95,Florida,Orange County,11,3,69195,35576,33619
50,12,95,Florida,Orange County,11,4,73474,37654,35820
50,12,95,Florida,Orange County,11,5,81984,41962,40022
50,12,95,Florida,Orange County,11,6,103666,52247,51419
50,12,95,Florida,Orange County,11,7,85214,43638,41576
50,12,95,Florida,Orange County,11,8,80120,40827,39293
50,12,95,Florida,Orange County,11,9,79393,40469,38924
50,12,95,Florida,Orange County,11,10,79341,39864,39477
50,12,95,Florida,Orange County,11,11,69231,33993,35238
50,12,95,Florida,Orange County,11,12,55674,26563,29111
50,12,95,Florida,Orange County,11,13,42667,20355,22312
50,12,95,Florida,Orange County,11,14,29404,13657,15747
50,12,95,Florida,Orange County,11,15,22888,10412,12476
50,12,95,Florida,Orange County,11,16,19611,8631,10980
50,12,95,Florida,Orange County,11,17,15427,5919,9508
50,12,95,Florida,Orange County,11,18,14642,4901,9741
50,12,95,Florida,Orange County,12,0,1086480,540044,546436
50,12,95,Florida,Orange County,12,1,81416,41459,39957
50,12,95,Florida,Orange County,12,2,74275,37811,36464
50,12,95,Florida,Orange County,12,3,68282,35013,33269
50,12,95,Florida,Orange County,12,4,73135,37457,35678
50,12,95,Florida,Orange County,12,5,82043,41889,40154
50,12,95,Florida,Orange County,12,6,101478,51268,50210
50,12,95,Florida,Orange County,12,7,89393,45586,43807
50,12,95,Florida,Orange County,12,8,80282,40914,39368
50,12,95,Florida,Orange County,12,9,77670,39623,38047
50,12,95,Florida,Orange County,12,10,80324,40258,40066
50,12,95,Florida,Orange County,12,11,71040,34992,36048
50,12,95,Florida,Orange County,12,12,57440,27515,29925
50,12,95,Florida,Orange County,12,13,45247,21501,23746
50,12,95,Florida,Orange County,12,14,30749,14386,16363
50,12,95,Florida,Orange County,12,15,23123,10430,12693
50,12,95,Florida,Orange County,12,16,19463,8625,10838
50,12,95,Florida,Orange County,12,17,15645,6080,9565
50,12,95,Florida,Orange County,12,18,15475,5237,10238
50,12,97,Florida,Osceola County,1,0,172493,85022,87471
50,12,97,Florida,Osceola County,1,1,11720,5989,5731
50,12,97,Florida,Osceola County,1,2,13213,6843,6370
50,12,97,Florida,Osceola County,1,3,13442,6900,6542
50,12,97,Florida,Osceola County,1,4,12492,6464,6028
50,12,97,Florida,Osceola County,1,5,11314,5794,5520
50,12,97,Florida,Osceola County,1,6,12199,6028,6171
50,12,97,Florida,Osceola County,1,7,13039,6493,6546
50,12,97,Florida,Osceola County,1,8,14514,7220,7294
50,12,97,Florida,Osceola County,1,9,13651,6746,6905
50,12,97,Florida,Osceola County,1,10,11684,5657,6027
50,12,97,Florida,Osceola County,1,11,10485,5043,5442
50,12,97,Florida,Osceola County,1,12,8350,3962,4388
50,12,97,Florida,Osceola County,1,13,6681,3265,3416
50,12,97,Florida,Osceola County,1,14,6003,2874,3129
50,12,97,Florida,Osceola County,1,15,5117,2365,2752
50,12,97,Florida,Osceola County,1,16,4022,1726,2296
50,12,97,Florida,Osceola County,1,17,2598,1019,1579
50,12,97,Florida,Osceola County,1,18,1969,634,1335
50,12,97,Florida,Osceola County,2,0,172493,85022,87471
50,12,97,Florida,Osceola County,2,1,11720,5989,5731
50,12,97,Florida,Osceola County,2,2,13213,6843,6370
50,12,97,Florida,Osceola County,2,3,13442,6900,6542
50,12,97,Florida,Osceola County,2,4,12492,6464,6028
50,12,97,Florida,Osceola County,2,5,11314,5794,5520
50,12,97,Florida,Osceola County,2,6,12199,6028,6171
50,12,97,Florida,Osceola County,2,7,13039,6493,6546
50,12,97,Florida,Osceola County,2,8,14514,7220,7294
50,12,97,Florida,Osceola County,2,9,13651,6746,6905
50,12,97,Florida,Osceola County,2,10,11684,5657,6027
50,12,97,Florida,Osceola County,2,11,10485,5043,5442
50,12,97,Florida,Osceola County,2,12,8350,3962,4388
50,12,97,Florida,Osceola County,2,13,6681,3265,3416
50,12,97,Florida,Osceola County,2,14,6003,2874,3129
50,12,97,Florida,Osceola County,2,15,5117,2365,2752
50,12,97,Florida,Osceola County,2,16,4022,1726,2296
50,12,97,Florida,Osceola County,2,17,2598,1019,1579
50,12,97,Florida,Osceola County,2,18,1969,634,1335
50,12,97,Florida,Osceola County,3,0,174182,85872,88310
50,12,97,Florida,Osceola County,3,1,11834,6047,5787
50,12,97,Florida,Osceola County,3,2,13276,6875,6401
50,12,97,Florida,Osceola County,3,3,13617,6990,6627
50,12,97,Florida,Osceola County,3,4,12598,6515,6083
50,12,97,Florida,Osceola County,3,5,11480,5885,5595
50,12,97,Florida,Osceola County,3,6,12243,6052,6191
50,12,97,Florida,Osceola County,3,7,13152,6550,6602
50,12,97,Florida,Osceola County,3,8,14598,7266,7332
50,12,97,Florida,Osceola County,3,9,13812,6827,6985
50,12,97,Florida,Osceola County,3,10,11842,5731,6111
50,12,97,Florida,Osceola County,3,11,10674,5131,5543
50,12,97,Florida,Osceola County,3,12,8468,4020,4448
50,12,97,Florida,Osceola County,3,13,6762,3306,3456
50,12,97,Florida,Osceola County,3,14,6020,2884,3136
50,12,97,Florida,Osceola County,3,15,5135,2377,2758
50,12,97,Florida,Osceola County,3,16,4049,1740,2309
50,12,97,Florida,Osceola County,3,17,2632,1034,1598
50,12,97,Florida,Osceola County,3,18,1990,642,1348
50,12,97,Florida,Osceola County,4,0,183420,90564,92856
50,12,97,Florida,Osceola County,4,1,12694,6524,6170
50,12,97,Florida,Osceola County,4,2,13866,7118,6748
50,12,97,Florida,Osceola County,4,3,14505,7477,7028
50,12,97,Florida,Osceola County,4,4,12942,6717,6225
50,12,97,Florida,Osceola County,4,5,12353,6384,5969
50,12,97,Florida,Osceola County,4,6,12379,6187,6192
50,12,97,Florida,Osceola County,4,7,13927,6932,6995
50,12,97,Florida,Osceola County,4,8,15243,7590,7653
50,12,97,Florida,Osceola County,4,9,14519,7188,7331
50,12,97,Florida,Osceola County,4,10,12554,6064,6490
50,12,97,Florida,Osceola County,4,11,11485,5504,5981
50,12,97,Florida,Osceola County,4,12,9004,4287,4717
50,12,97,Florida,Osceola County,4,13,7283,3514,3769
50,12,97,Florida,Osceola County,4,14,6126,2943,3183
50,12,97,Florida,Osceola County,4,15,5339,2481,2858
50,12,97,Florida,Osceola County,4,16,4211,1835,2376
50,12,97,Florida,Osceola County,4,17,2864,1130,1734
50,12,97,Florida,Osceola County,4,18,2126,689,1437
50,12,97,Florida,Osceola County,5,0,194071,95925,98146
50,12,97,Florida,Osceola County,5,1,13659,7005,6654
50,12,97,Florida,Osceola County,5,2,14294,7435,6859
50,12,97,Florida,Osceola County,5,3,15569,7975,7594
50,12,97,Florida,Osceola County,5,4,13819,7153,6666
50,12,97,Florida,Osceola County,5,5,12898,6638,6260
50,12,97,Florida,Osceola County,5,6,12940,6564,6376
50,12,97,Florida,Osceola County,5,7,14635,7241,7394
50,12,97,Florida,Osceola County,5,8,15905,7910,7995
50,12,97,Florida,Osceola County,5,9,15368,7610,7758
50,12,97,Florida,Osceola County,5,10,13593,6593,7000
50,12,97,Florida,Osceola County,5,11,11828,5697,6131
50,12,97,Florida,Osceola County,5,12,9976,4729,5247
50,12,97,Florida,Osceola County,5,13,7792,3758,4034
50,12,97,Florida,Osceola County,5,14,6520,3137,3383
50,12,97,Florida,Osceola County,5,15,5554,2574,2980
50,12,97,Florida,Osceola County,5,16,4439,1941,2498
50,12,97,Florida,Osceola County,5,17,3046,1222,1824
50,12,97,Florida,Osceola County,5,18,2236,743,1493
50,12,97,Florida,Osceola County,6,0,206016,102056,103960
50,12,97,Florida,Osceola County,6,1,14805,7585,7220
50,12,97,Florida,Osceola County,6,2,15030,7745,7285
50,12,97,Florida,Osceola County,6,3,16670,8576,8094
50,12,97,Florida,Osceola County,6,4,14609,7577,7032
50,12,97,Florida,Osceola County,6,5,13591,7132,6459
50,12,97,Florida,Osceola County,6,6,13930,7113,6817
50,12,97,Florida,Osceola County,6,7,15243,7560,7683
50,12,97,Florida,Osceola County,6,8,16560,8278,8282
50,12,97,Florida,Osceola County,6,9,16461,8090,8371
50,12,97,Florida,Osceola County,6,10,14577,7085,7492
50,12,97,Florida,Osceola County,6,11,12443,6000,6443
50,12,97,Florida,Osceola County,6,12,10730,5101,5629
50,12,97,Florida,Osceola County,6,13,8394,4034,4360
50,12,97,Florida,Osceola County,6,14,6884,3307,3577
50,12,97,Florida,Osceola County,6,15,5834,2695,3139
50,12,97,Florida,Osceola County,6,16,4685,2079,2606
50,12,97,Florida,Osceola County,6,17,3193,1313,1880
50,12,97,Florida,Osceola County,6,18,2377,786,1591
50,12,97,Florida,Osceola County,7,0,220191,109280,110911
50,12,97,Florida,Osceola County,7,1,16138,8273,7865
50,12,97,Florida,Osceola County,7,2,15883,8148,7735
50,12,97,Florida,Osceola County,7,3,17882,9228,8654
50,12,97,Florida,Osceola County,7,4,15898,8215,7683
50,12,97,Florida,Osceola County,7,5,14337,7531,6806
50,12,97,Florida,Osceola County,7,6,14872,7717,7155
50,12,97,Florida,Osceola County,7,7,16037,7990,8047
50,12,97,Florida,Osceola County,7,8,17372,8626,8746
50,12,97,Florida,Osceola County,7,9,17669,8768,8901
50,12,97,Florida,Osceola County,7,10,15624,7622,8002
50,12,97,Florida,Osceola County,7,11,13294,6406,6888
50,12,97,Florida,Osceola County,7,12,11575,5477,6098
50,12,97,Florida,Osceola County,7,13,9060,4300,4760
50,12,97,Florida,Osceola County,7,14,7370,3555,3815
50,12,97,Florida,Osceola County,7,15,6151,2882,3269
50,12,97,Florida,Osceola County,7,16,4949,2239,2710
50,12,97,Florida,Osceola County,7,17,3476,1413,2063
50,12,97,Florida,Osceola County,7,18,2604,890,1714
50,12,97,Florida,Osceola County,8,0,231926,115280,116646
50,12,97,Florida,Osceola County,8,1,16975,8739,8236
50,12,97,Florida,Osceola County,8,2,16759,8583,8176
50,12,97,Florida,Osceola County,8,3,18830,9738,9092
50,12,97,Florida,Osceola County,8,4,17185,8882,8303
50,12,97,Florida,Osceola County,8,5,14834,7785,7049
50,12,97,Florida,Osceola County,8,6,15676,8204,7472
50,12,97,Florida,Osceola County,8,7,16261,8135,8126
50,12,97,Florida,Osceola County,8,8,18015,8908,9107
50,12,97,Florida,Osceola County,8,9,18755,9352,9403
50,12,97,Florida,Osceola County,8,10,16697,8183,8514
50,12,97,Florida,Osceola County,8,11,13977,6701,7276
50,12,97,Florida,Osceola County,8,12,12362,5886,6476
50,12,97,Florida,Osceola County,8,13,9652,4553,5099
50,12,97,Florida,Osceola County,8,14,7795,3752,4043
50,12,97,Florida,Osceola County,8,15,6430,3046,3384
50,12,97,Florida,Osceola County,8,16,5164,2332,2832
50,12,97,Florida,Osceola County,8,17,3673,1523,2150
50,12,97,Florida,Osceola County,8,18,2886,978,1908
50,12,97,Florida,Osceola County,9,0,246259,122601,123658
50,12,97,Florida,Osceola County,9,1,18140,9328,8812
50,12,97,Florida,Osceola County,9,2,18264,9388,8876
50,12,97,Florida,Osceola County,9,3,19787,10175,9612
50,12,97,Florida,Osceola County,9,4,18725,9694,9031
50,12,97,Florida,Osceola County,9,5,15518,8158,7360
50,12,97,Florida,Osceola County,9,6,16797,8813,7984
50,12,97,Florida,Osceola County,9,7,16727,8459,8268
50,12,97,Florida,Osceola County,9,8,19059,9439,9620
50,12,97,Florida,Osceola County,9,9,19665,9816,9849
50,12,97,Florida,Osceola County,9,10,17790,8739,9051
50,12,97,Florida,Osceola County,9,11,14877,7143,7734
50,12,97,Florida,Osceola County,9,12,13292,6325,6967
50,12,97,Florida,Osceola County,9,13,10003,4738,5265
50,12,97,Florida,Osceola County,9,14,8345,3969,4376
50,12,97,Florida,Osceola County,9,15,6688,3184,3504
50,12,97,Florida,Osceola County,9,16,5490,2493,2997
50,12,97,Florida,Osceola County,9,17,3846,1631,2215
50,12,97,Florida,Osceola County,9,18,3246,1109,2137
50,12,97,Florida,Osceola County,10,0,258283,128763,129520
50,12,97,Florida,Osceola County,10,1,19129,9766,9363
50,12,97,Florida,Osceola County,10,2,19227,9869,9358
50,12,97,Florida,Osceola County,10,3,20412,10597,9815
50,12,97,Florida,Osceola County,10,4,19933,10255,9678
50,12,97,Florida,Osceola County,10,5,16453,8635,7818
50,12,97,Florida,Osceola County,10,6,17911,9403,8508
50,12,97,Florida,Osceola County,10,7,17386,8927,8459
50,12,97,Florida,Osceola County,10,8,19726,9756,9970
50,12,97,Florida,Osceola County,10,9,20288,10150,10138
50,12,97,Florida,Osceola County,10,10,18531,9107,9424
50,12,97,Florida,Osceola County,10,11,15848,7641,8207
50,12,97,Florida,Osceola County,10,12,13403,6419,6984
50,12,97,Florida,Osceola County,10,13,10838,5102,5736
50,12,97,Florida,Osceola County,10,14,8703,4136,4567
50,12,97,Florida,Osceola County,10,15,7104,3385,3719
50,12,97,Florida,Osceola County,10,16,5608,2556,3052
50,12,97,Florida,Osceola County,10,17,4217,1814,2403
50,12,97,Florida,Osceola County,10,18,3566,1245,2321
50,12,97,Florida,Osceola County,11,0,266609,132930,133679
50,12,97,Florida,Osceola County,11,1,19998,10236,9762
50,12,97,Florida,Osceola County,11,2,19710,10124,9586
50,12,97,Florida,Osceola County,11,3,20579,10620,9959
50,12,97,Florida,Osceola County,11,4,20658,10662,9996
50,12,97,Florida,Osceola County,11,5,17087,8932,8155
50,12,97,Florida,Osceola County,11,6,18198,9641,8557
50,12,97,Florida,Osceola County,11,7,17998,9258,8740
50,12,97,Florida,Osceola County,11,8,19878,9830,10048
50,12,97,Florida,Osceola County,11,9,20572,10327,10245
50,12,97,Florida,Osceola County,11,10,19118,9325,9793
50,12,97,Florida,Osceola County,11,11,16642,8036,8606
50,12,97,Florida,Osceola County,11,12,13896,6679,7217
50,12,97,Florida,Osceola County,11,13,11476,5422,6054
50,12,97,Florida,Osceola County,11,14,9273,4374,4899
50,12,97,Florida,Osceola County,11,15,7332,3495,3837
50,12,97,Florida,Osceola County,11,16,5878,2662,3216
50,12,97,Florida,Osceola County,11,17,4420,1933,2487
50,12,97,Florida,Osceola County,11,18,3896,1374,2522
50,12,97,Florida,Osceola County,12,0,270618,134945,135673
50,12,97,Florida,Osceola County,12,1,20126,10271,9855
50,12,97,Florida,Osceola County,12,2,19920,10255,9665
50,12,97,Florida,Osceola County,12,3,20310,10458,9852
50,12,97,Florida,Osceola County,12,4,20800,10763,10037
50,12,97,Florida,Osceola County,12,5,17346,9015,8331
50,12,97,Florida,Osceola County,12,6,18305,9701,8604
50,12,97,Florida,Osceola County,12,7,18102,9429,8673
50,12,97,Florida,Osceola County,12,8,19581,9704,9877
50,12,97,Florida,Osceola County,12,9,20453,10198,10255
50,12,97,Florida,Osceola County,12,10,19736,9707,10029
50,12,97,Florida,Osceola County,12,11,17155,8302,8853
50,12,97,Florida,Osceola County,12,12,14349,6912,7437
50,12,97,Florida,Osceola County,12,13,12158,5727,6431
50,12,97,Florida,Osceola County,12,14,9705,4535,5170
50,12,97,Florida,Osceola County,12,15,7676,3658,4018
50,12,97,Florida,Osceola County,12,16,6084,2783,3301
50,12,97,Florida,Osceola County,12,17,4550,2020,2530
50,12,97,Florida,Osceola County,12,18,4262,1507,2755
50,12,99,Florida,Palm Beach County,1,0,1131184,546739,584445
50,12,99,Florida,Palm Beach County,1,1,62913,32246,30667
50,12,99,Florida,Palm Beach County,1,2,68647,35371,33276
50,12,99,Florida,Palm Beach County,1,3,70155,36045,34110
50,12,99,Florida,Palm Beach County,1,4,61738,31980,29758
50,12,99,Florida,Palm Beach County,1,5,51319,26452,24867
50,12,99,Florida,Palm Beach County,1,6,60563,30539,30024
50,12,99,Florida,Palm Beach County,1,7,72457,35886,36571
50,12,99,Florida,Palm Beach County,1,8,86512,43147,43365
50,12,99,Florida,Palm Beach County,1,9,85509,42660,42849
50,12,99,Florida,Palm Beach County,1,10,74361,36653,37708
50,12,99,Florida,Palm Beach County,1,11,66690,31949,34741
50,12,99,Florida,Palm Beach County,1,12,56852,26542,30310
50,12,99,Florida,Palm Beach County,1,13,51392,23059,28333
50,12,99,Florida,Palm Beach County,1,14,56843,25125,31718
50,12,99,Florida,Palm Beach County,1,15,65886,29406,36480
50,12,99,Florida,Palm Beach County,1,16,61037,27295,33742
50,12,99,Florida,Palm Beach County,1,17,43345,18970,24375
50,12,99,Florida,Palm Beach County,1,18,34965,13414,21551
50,12,99,Florida,Palm Beach County,2,0,1131190,546742,584448
50,12,99,Florida,Palm Beach County,2,1,62913,32246,30667
50,12,99,Florida,Palm Beach County,2,2,68647,35371,33276
50,12,99,Florida,Palm Beach County,2,3,70155,36045,34110
50,12,99,Florida,Palm Beach County,2,4,61738,31980,29758
50,12,99,Florida,Palm Beach County,2,5,51319,26452,24867
50,12,99,Florida,Palm Beach County,2,6,60563,30539,30024
50,12,99,Florida,Palm Beach County,2,7,72457,35886,36571
50,12,99,Florida,Palm Beach County,2,8,86512,43147,43365
50,12,99,Florida,Palm Beach County,2,9,85509,42660,42849
50,12,99,Florida,Palm Beach County,2,10,74361,36653,37708
50,12,99,Florida,Palm Beach County,2,11,66690,31949,34741
50,12,99,Florida,Palm Beach County,2,12,56852,26542,30310
50,12,99,Florida,Palm Beach County,2,13,51392,23059,28333
50,12,99,Florida,Palm Beach County,2,14,56844,25126,31718
50,12,99,Florida,Palm Beach County,2,15,65887,29406,36481
50,12,99,Florida,Palm Beach County,2,16,61038,27296,33742
50,12,99,Florida,Palm Beach County,2,17,43347,18971,24376
50,12,99,Florida,Palm Beach County,2,18,34966,13414,21552
50,12,99,Florida,Palm Beach County,3,0,1135318,548951,586367
50,12,99,Florida,Palm Beach County,3,1,63097,32338,30759
50,12,99,Florida,Palm Beach County,3,2,68506,35299,33207
50,12,99,Florida,Palm Beach County,3,3,70630,36285,34345
50,12,99,Florida,Palm Beach County,3,4,61971,32104,29867
50,12,99,Florida,Palm Beach County,3,5,51868,26760,25108
50,12,99,Florida,Palm Beach County,3,6,60418,30480,29938
50,12,99,Florida,Palm Beach County,3,7,72625,35985,36640
50,12,99,Florida,Palm Beach County,3,8,86431,43115,43316
50,12,99,Florida,Palm Beach County,3,9,85936,42877,43059
50,12,99,Florida,Palm Beach County,3,10,74940,36944,37996
50,12,99,Florida,Palm Beach County,3,11,67495,32337,35158
50,12,99,Florida,Palm Beach County,3,12,57293,26758,30535
50,12,99,Florida,Palm Beach County,3,13,51669,23200,28469
50,12,99,Florida,Palm Beach County,3,14,56589,25020,31569
50,12,99,Florida,Palm Beach County,3,15,65759,29389,36370
50,12,99,Florida,Palm Beach County,3,16,61138,27363,33775
50,12,99,Florida,Palm Beach County,3,17,43698,19149,24549
50,12,99,Florida,Palm Beach County,3,18,35255,13548,21707
50,12,99,Florida,Palm Beach County,4,0,1157710,560556,597154
50,12,99,Florida,Palm Beach County,4,1,65079,33470,31609
50,12,99,Florida,Palm Beach County,4,2,68449,35112,33337
50,12,99,Florida,Palm Beach County,4,3,73143,37726,35417
50,12,99,Florida,Palm Beach County,4,4,63975,33036,30939
50,12,99,Florida,Palm Beach County,4,5,54978,28466,26512
50,12,99,Florida,Palm Beach County,4,6,59291,30115,29176
50,12,99,Florida,Palm Beach County,4,7,73574,36440,37134
50,12,99,Florida,Palm Beach County,4,8,85725,42710,43015
50,12,99,Florida,Palm Beach County,4,9,88615,44206,44409
50,12,99,Florida,Palm Beach County,4,10,77488,38253,39235
50,12,99,Florida,Palm Beach County,4,11,70929,34051,36878
50,12,99,Florida,Palm Beach County,4,12,59618,27909,31709
50,12,99,Florida,Palm Beach County,4,13,53161,24064,29097
50,12,99,Florida,Palm Beach County,4,14,54698,24382,30316
50,12,99,Florida,Palm Beach County,4,15,65044,28868,36176
50,12,99,Florida,Palm Beach County,4,16,61401,27516,33885
50,12,99,Florida,Palm Beach County,4,17,45713,19972,25741
50,12,99,Florida,Palm Beach County,4,18,36829,14260,22569
50,12,99,Florida,Palm Beach County,5,0,1185745,574939,610806
50,12,99,Florida,Palm Beach County,5,1,67443,34631,32812
50,12,99,Florida,Palm Beach County,5,2,69122,35516,33606
50,12,99,Florida,Palm Beach County,5,3,74853,38596,36257
50,12,99,Florida,Palm Beach County,5,4,66424,34240,32184
50,12,99,Florida,Palm Beach County,5,5,57991,30001,27990
50,12,99,Florida,Palm Beach County,5,6,60476,31005,29471
50,12,99,Florida,Palm Beach County,5,7,74492,37088,37404
50,12,99,Florida,Palm Beach County,5,8,85407,42307,43100
50,12,99,Florida,Palm Beach County,5,9,90401,45249,45152
50,12,99,Florida,Palm Beach County,5,10,81382,40115,41267
50,12,99,Florida,Palm Beach County,5,11,71786,34580,37206
50,12,99,Florida,Palm Beach County,5,12,64483,30305,34178
50,12,99,Florida,Palm Beach County,5,13,55404,25232,30172
50,12,99,Florida,Palm Beach County,5,14,54132,24243,29889
50,12,99,Florida,Palm Beach County,5,15,63698,28241,35457
50,12,99,Florida,Palm Beach County,5,16,61739,27617,34122
50,12,99,Florida,Palm Beach County,5,17,47866,20962,26904
50,12,99,Florida,Palm Beach County,5,18,38646,15011,23635
50,12,99,Florida,Palm Beach County,6,0,1208940,587569,621371
50,12,99,Florida,Palm Beach County,6,1,70186,36150,34036
50,12,99,Florida,Palm Beach County,6,2,69716,35768,33948
50,12,99,Florida,Palm Beach County,6,3,75574,39000,36574
50,12,99,Florida,Palm Beach County,6,4,68509,35276,33233
50,12,99,Florida,Palm Beach County,6,5,61291,31955,29336
50,12,99,Florida,Palm Beach County,6,6,61933,32016,29917
50,12,99,Florida,Palm Beach County,6,7,74982,37598,37384
50,12,99,Florida,Palm Beach County,6,8,84502,41753,42749
50,12,99,Florida,Palm Beach County,6,9,91492,45751,45741
50,12,99,Florida,Palm Beach County,6,10,85012,41922,43090
50,12,99,Florida,Palm Beach County,6,11,73512,35680,37832
50,12,99,Florida,Palm Beach County,6,12,66565,31276,35289
50,12,99,Florida,Palm Beach County,6,13,59068,27148,31920
50,12,99,Florida,Palm Beach County,6,14,53968,24213,29755
50,12,99,Florida,Palm Beach County,6,15,61128,27004,34124
50,12,99,Florida,Palm Beach County,6,16,61732,27590,34142
50,12,99,Florida,Palm Beach County,6,17,48941,21466,27475
50,12,99,Florida,Palm Beach County,6,18,40829,16003,24826
50,12,99,Florida,Palm Beach County,7,0,1240191,603842,636349
50,12,99,Florida,Palm Beach County,7,1,73463,37839,35624
50,12,99,Florida,Palm Beach County,7,2,70798,36245,34553
50,12,99,Florida,Palm Beach County,7,3,76866,39745,37121
50,12,99,Florida,Palm Beach County,7,4,71802,36960,34842
50,12,99,Florida,Palm Beach County,7,5,64589,33671,30918
50,12,99,Florida,Palm Beach County,7,6,64874,33728,31146
50,12,99,Florida,Palm Beach County,7,7,74991,37786,37205
50,12,99,Florida,Palm Beach County,7,8,84134,41667,42467
50,12,99,Florida,Palm Beach County,7,9,93862,46826,47036
50,12,99,Florida,Palm Beach County,7,10,88480,43687,44793
50,12,99,Florida,Palm Beach County,7,11,76385,37103,39282
50,12,99,Florida,Palm Beach County,7,12,69769,32869,36900
50,12,99,Florida,Palm Beach County,7,13,61865,28668,33197
50,12,99,Florida,Palm Beach County,7,14,54382,24539,29843
50,12,99,Florida,Palm Beach County,7,15,58758,25983,32775
50,12,99,Florida,Palm Beach County,7,16,61815,27533,34282
50,12,99,Florida,Palm Beach County,7,17,50392,22089,28303
50,12,99,Florida,Palm Beach County,7,18,42966,16904,26062
50,12,99,Florida,Palm Beach County,8,0,1262956,615783,647173
50,12,99,Florida,Palm Beach County,8,1,75988,39046,36942
50,12,99,Florida,Palm Beach County,8,2,71452,36548,34904
50,12,99,Florida,Palm Beach County,8,3,76562,39518,37044
50,12,99,Florida,Palm Beach County,8,4,74747,38522,36225
50,12,99,Florida,Palm Beach County,8,5,66137,34438,31699
50,12,99,Florida,Palm Beach County,8,6,67571,35335,32236
50,12,99,Florida,Palm Beach County,8,7,73319,37157,36162
50,12,99,Florida,Palm Beach County,8,8,84362,41734,42628
50,12,99,Florida,Palm Beach County,8,9,94854,47271,47583
50,12,99,Florida,Palm Beach County,8,10,91300,45213,46087
50,12,99,Florida,Palm Beach County,8,11,79344,38574,40770
50,12,99,Florida,Palm Beach County,8,12,73300,34695,38605
50,12,99,Florida,Palm Beach County,8,13,64124,29858,34266
50,12,99,Florida,Palm Beach County,8,14,54817,24828,29989
50,12,99,Florida,Palm Beach County,8,15,56651,25167,31484
50,12,99,Florida,Palm Beach County,8,16,61640,27388,34252
50,12,99,Florida,Palm Beach County,8,17,51537,22418,29119
50,12,99,Florida,Palm Beach County,8,18,45251,18073,27178
50,12,99,Florida,Palm Beach County,9,0,1265707,617964,647743
50,12,99,Florida,Palm Beach County,9,1,76424,39146,37278
50,12,99,Florida,Palm Beach County,9,2,72083,36972,35111
50,12,99,Florida,Palm Beach County,9,3,75093,38603,36490
50,12,99,Florida,Palm Beach County,9,4,76173,39407,36766
50,12,99,Florida,Palm Beach County,9,5,66999,34903,32096
50,12,99,Florida,Palm Beach County,9,6,69685,36562,33123
50,12,99,Florida,Palm Beach County,9,7,70772,36150,34622
50,12,99,Florida,Palm Beach County,9,8,83655,41400,42255
50,12,99,Florida,Palm Beach County,9,9,92898,46303,46595
50,12,99,Florida,Palm Beach County,9,10,92805,46004,46801
50,12,99,Florida,Palm Beach County,9,11,81051,39550,41501
50,12,99,Florida,Palm Beach County,9,12,75805,35956,39849
50,12,99,Florida,Palm Beach County,9,13,65420,30496,34924
50,12,99,Florida,Palm Beach County,9,14,54697,24908,29789
50,12,99,Florida,Palm Beach County,9,15,53723,23967,29756
50,12,99,Florida,Palm Beach County,9,16,59971,26409,33562
50,12,99,Florida,Palm Beach County,9,17,51015,22257,28758
50,12,99,Florida,Palm Beach County,9,18,47438,18971,28467
50,12,99,Florida,Palm Beach County,10,0,1264648,617898,646750
50,12,99,Florida,Palm Beach County,10,1,76576,38991,37585
50,12,99,Florida,Palm Beach County,10,2,71583,36667,34916
50,12,99,Florida,Palm Beach County,10,3,73249,37729,35520
50,12,99,Florida,Palm Beach County,10,4,76465,39529,36936
50,12,99,Florida,Palm Beach County,10,5,68248,35572,32676
50,12,99,Florida,Palm Beach County,10,6,70555,37197,33358
50,12,99,Florida,Palm Beach County,10,7,68718,35436,33282
50,12,99,Florida,Palm Beach County,10,8,81640,40582,41058
50,12,99,Florida,Palm Beach County,10,9,90005,44637,45368
50,12,99,Florida,Palm Beach County,10,10,92841,46180,46661
50,12,99,Florida,Palm Beach County,10,11,83024,40528,42496
50,12,99,Florida,Palm Beach County,10,12,74959,35687,39272
50,12,99,Florida,Palm Beach County,10,13,68414,31975,36439
50,12,99,Florida,Palm Beach County,10,14,56428,25779,30649
50,12,99,Florida,Palm Beach County,10,15,52380,23445,28935
50,12,99,Florida,Palm Beach County,10,16,58174,25576,32598
50,12,99,Florida,Palm Beach County,10,17,51094,22165,28929
50,12,99,Florida,Palm Beach County,10,18,50295,20223,30072
50,12,99,Florida,Palm Beach County,11,0,1269745,620627,649118
50,12,99,Florida,Palm Beach County,11,1,77156,39200,37956
50,12,99,Florida,Palm Beach County,11,2,72192,37075,35117
50,12,99,Florida,Palm Beach County,11,3,72166,37133,35033
50,12,99,Florida,Palm Beach County,11,4,76106,39316,36790
50,12,99,Florida,Palm Beach County,11,5,69180,35911,33269
50,12,99,Florida,Palm Beach County,11,6,71863,38012,33851
50,12,99,Florida,Palm Beach County,11,7,68319,35407,32912
50,12,99,Florida,Palm Beach County,11,8,80093,40024,40069
50,12,99,Florida,Palm Beach County,11,9,87507,43246,44261
50,12,99,Florida,Palm Beach County,11,10,92853,46136,46717
50,12,99,Florida,Palm Beach County,11,11,85600,41808,43792
50,12,99,Florida,Palm Beach County,11,12,74943,35963,38980
50,12,99,Florida,Palm Beach County,11,13,69215,32304,36911
50,12,99,Florida,Palm Beach County,11,14,59811,27488,32323
50,12,99,Florida,Palm Beach County,11,15,52342,23452,28890
50,12,99,Florida,Palm Beach County,11,16,56035,24454,31581
50,12,99,Florida,Palm Beach County,11,17,51458,22330,29128
50,12,99,Florida,Palm Beach County,11,18,52906,21368,31538
50,12,99,Florida,Palm Beach County,12,0,1279950,626141,653809
50,12,99,Florida,Palm Beach County,12,1,77230,39149,38081
50,12,99,Florida,Palm Beach County,12,2,73970,38003,35967
50,12,99,Florida,Palm Beach County,12,3,71749,36870,34879
50,12,99,Florida,Palm Beach County,12,4,75933,39293,36640
50,12,99,Florida,Palm Beach County,12,5,70767,36674,34093
50,12,99,Florida,Palm Beach County,12,6,73486,38885,34601
50,12,99,Florida,Palm Beach County,12,7,69678,36339,33339
50,12,99,Florida,Palm Beach County,12,8,77996,39181,38815
50,12,99,Florida,Palm Beach County,12,9,84813,42008,42805
50,12,99,Florida,Palm Beach County,12,10,93733,46443,47290
50,12,99,Florida,Palm Beach County,12,11,87654,42907,44747
50,12,99,Florida,Palm Beach County,12,12,76258,36620,39638
50,12,99,Florida,Palm Beach County,12,13,71105,33214,37891
50,12,99,Florida,Palm Beach County,12,14,62247,28766,33481
50,12,99,Florida,Palm Beach County,12,15,52655,23670,28985
50,12,99,Florida,Palm Beach County,12,16,54032,23597,30435
50,12,99,Florida,Palm Beach County,12,17,51719,22404,29315
50,12,99,Florida,Palm Beach County,12,18,54925,22118,32807
50,12,101,Florida,Pasco County,1,0,344765,165417,179348
50,12,101,Florida,Pasco County,1,1,18134,9315,8819
50,12,101,Florida,Pasco County,1,2,19713,10123,9590
50,12,101,Florida,Pasco County,1,3,20371,10476,9895
50,12,101,Florida,Pasco County,1,4,17940,9269,8671
50,12,101,Florida,Pasco County,1,5,13507,6680,6827
50,12,101,Florida,Pasco County,1,6,16023,7891,8132
50,12,101,Florida,Pasco County,1,7,19779,9862,9917
50,12,101,Florida,Pasco County,1,8,24003,11974,12029
50,12,101,Florida,Pasco County,1,9,23314,11542,11772
50,12,101,Florida,Pasco County,1,10,21026,10178,10848
50,12,101,Florida,Pasco County,1,11,20713,9795,10918
50,12,101,Florida,Pasco County,1,12,18940,8824,10116
50,12,101,Florida,Pasco County,1,13,18899,8659,10240
50,12,101,Florida,Pasco County,1,14,21152,9732,11420
50,12,101,Florida,Pasco County,1,15,23492,10803,12689
50,12,101,Florida,Pasco County,1,16,21769,9616,12153
50,12,101,Florida,Pasco County,1,17,15166,6556,8610
50,12,101,Florida,Pasco County,1,18,10824,4122,6702
50,12,101,Florida,Pasco County,2,0,344771,165419,179352
50,12,101,Florida,Pasco County,2,1,18134,9315,8819
50,12,101,Florida,Pasco County,2,2,19714,10123,9591
50,12,101,Florida,Pasco County,2,3,20372,10477,9895
50,12,101,Florida,Pasco County,2,4,17940,9269,8671
50,12,101,Florida,Pasco County,2,5,13507,6680,6827
50,12,101,Florida,Pasco County,2,6,16024,7891,8133
50,12,101,Florida,Pasco County,2,7,19779,9862,9917
50,12,101,Florida,Pasco County,2,8,24003,11974,12029
50,12,101,Florida,Pasco County,2,9,23314,11542,11772
50,12,101,Florida,Pasco County,2,10,21026,10178,10848
50,12,101,Florida,Pasco County,2,11,20713,9795,10918
50,12,101,Florida,Pasco County,2,12,18941,8824,10117
50,12,101,Florida,Pasco County,2,13,18899,8659,10240
50,12,101,Florida,Pasco County,2,14,21152,9732,11420
50,12,101,Florida,Pasco County,2,15,23493,10803,12690
50,12,101,Florida,Pasco County,2,16,21770,9617,12153
50,12,101,Florida,Pasco County,2,17,15166,6556,8610
50,12,101,Florida,Pasco County,2,18,10824,4122,6702
50,12,101,Florida,Pasco County,3,0,347318,166728,180590
50,12,101,Florida,Pasco County,3,1,18297,9400,8897
50,12,101,Florida,Pasco County,3,2,19796,10167,9629
50,12,101,Florida,Pasco County,3,3,20616,10602,10014
50,12,101,Florida,Pasco County,3,4,18127,9367,8760
50,12,101,Florida,Pasco County,3,5,13754,6807,6947
50,12,101,Florida,Pasco County,3,6,16045,7903,8142
50,12,101,Florida,Pasco County,3,7,19947,9948,9999
50,12,101,Florida,Pasco County,3,8,24110,12028,12082
50,12,101,Florida,Pasco County,3,9,23564,11665,11899
50,12,101,Florida,Pasco County,3,10,21334,10326,11008
50,12,101,Florida,Pasco County,3,11,21103,9982,11121
50,12,101,Florida,Pasco County,3,12,19222,8957,10265
50,12,101,Florida,Pasco County,3,13,19129,8768,10361
50,12,101,Florida,Pasco County,3,14,21000,9666,11334
50,12,101,Florida,Pasco County,3,15,23386,10770,12616
50,12,101,Florida,Pasco County,3,16,21743,9614,12129
50,12,101,Florida,Pasco County,3,17,15254,6604,8650
50,12,101,Florida,Pasco County,3,18,10891,4154,6737
50,12,101,Florida,Pasco County,4,0,358627,172413,186214
50,12,101,Florida,Pasco County,4,1,19022,9738,9284
50,12,101,Florida,Pasco County,4,2,20446,10471,9975
50,12,101,Florida,Pasco County,4,3,21622,11123,10499
50,12,101,Florida,Pasco County,4,4,18747,9757,8990
50,12,101,Florida,Pasco County,4,5,15279,7560,7719
50,12,101,Florida,Pasco County,4,6,16025,7909,8116
50,12,101,Florida,Pasco County,4,7,20958,10446,10512
50,12,101,Florida,Pasco County,4,8,24506,12286,12220
50,12,101,Florida,Pasco County,4,9,24960,12358,12602
50,12,101,Florida,Pasco County,4,10,22463,10906,11557
50,12,101,Florida,Pasco County,4,11,22530,10643,11887
50,12,101,Florida,Pasco County,4,12,20161,9388,10773
50,12,101,Florida,Pasco County,4,13,19628,9044,10584
50,12,101,Florida,Pasco County,4,14,20596,9538,11058
50,12,101,Florida,Pasco County,4,15,23069,10572,12497
50,12,101,Florida,Pasco County,4,16,21444,9514,11930
50,12,101,Florida,Pasco County,4,17,15829,6827,9002
50,12,101,Florida,Pasco County,4,18,11342,4333,7009
50,12,101,Florida,Pasco County,5,0,371409,178850,192559
50,12,101,Florida,Pasco County,5,1,19927,10204,9723
50,12,101,Florida,Pasco County,5,2,21184,10829,10355
50,12,101,Florida,Pasco County,5,3,22816,11744,11072
50,12,101,Florida,Pasco County,5,4,19490,10129,9361
50,12,101,Florida,Pasco County,5,5,16616,8266,8350
50,12,101,Florida,Pasco County,5,6,16647,8234,8413
50,12,101,Florida,Pasco County,5,7,21776,10874,10902
50,12,101,Florida,Pasco County,5,8,25009,12569,12440
50,12,101,Florida,Pasco County,5,9,26453,13097,13356
50,12,101,Florida,Pasco County,5,10,23742,11554,12188
50,12,101,Florida,Pasco County,5,11,22962,10909,12053
50,12,101,Florida,Pasco County,5,12,22067,10233,11834
50,12,101,Florida,Pasco County,5,13,20359,9401,10958
50,12,101,Florida,Pasco County,5,14,20519,9529,10990
50,12,101,Florida,Pasco County,5,15,22368,10239,12129
50,12,101,Florida,Pasco County,5,16,21199,9472,11727
50,12,101,Florida,Pasco County,5,17,16237,6901,9336
50,12,101,Florida,Pasco County,5,18,12038,4666,7372
50,12,101,Florida,Pasco County,6,0,385513,186050,199463
50,12,101,Florida,Pasco County,6,1,20832,10660,10172
50,12,101,Florida,Pasco County,6,2,21774,11133,10641
50,12,101,Florida,Pasco County,6,3,23747,12230,11517
50,12,101,Florida,Pasco County,6,4,20831,10749,10082
50,12,101,Florida,Pasco County,6,5,18142,9141,9001
50,12,101,Florida,Pasco County,6,6,17816,8846,8970
50,12,101,Florida,Pasco County,6,7,22831,11401,11430
50,12,101,Florida,Pasco County,6,8,25429,12802,12627
50,12,101,Florida,Pasco County,6,9,27775,13850,13925
50,12,101,Florida,Pasco County,6,10,25514,12442,13072
50,12,101,Florida,Pasco County,6,11,23765,11291,12474
50,12,101,Florida,Pasco County,6,12,23298,10867,12431
50,12,101,Florida,Pasco County,6,13,21907,10114,11793
50,12,101,Florida,Pasco County,6,14,20398,9435,10963
50,12,101,Florida,Pasco County,6,15,21562,9854,11708
50,12,101,Florida,Pasco County,6,16,20992,9428,11564
50,12,101,Florida,Pasco County,6,17,16236,6909,9327
50,12,101,Florida,Pasco County,6,18,12664,4898,7766
50,12,101,Florida,Pasco County,7,0,404697,195765,208932
50,12,101,Florida,Pasco County,7,1,22154,11291,10863
50,12,101,Florida,Pasco County,7,2,23013,11770,11243
50,12,101,Florida,Pasco County,7,3,24790,12720,12070
50,12,101,Florida,Pasco County,7,4,22409,11616,10793
50,12,101,Florida,Pasco County,7,5,19581,9894,9687
50,12,101,Florida,Pasco County,7,6,19859,9963,9896
50,12,101,Florida,Pasco County,7,7,24301,12124,12177
50,12,101,Florida,Pasco County,7,8,26321,13272,13049
50,12,101,Florida,Pasco County,7,9,29556,14824,14732
50,12,101,Florida,Pasco County,7,10,27265,13310,13955
50,12,101,Florida,Pasco County,7,11,24955,11830,13125
50,12,101,Florida,Pasco County,7,12,25167,11792,13375
50,12,101,Florida,Pasco County,7,13,23323,10852,12471
50,12,101,Florida,Pasco County,7,14,20747,9567,11180
50,12,101,Florida,Pasco County,7,15,20933,9560,11373
50,12,101,Florida,Pasco County,7,16,20733,9315,11418
50,12,101,Florida,Pasco County,7,17,16462,6935,9527
50,12,101,Florida,Pasco County,7,18,13128,5130,7998
50,12,101,Florida,Pasco County,8,0,425683,206322,219361
50,12,101,Florida,Pasco County,8,1,23595,11901,11694
50,12,101,Florida,Pasco County,8,2,24494,12567,11927
50,12,101,Florida,Pasco County,8,3,25830,13277,12553
50,12,101,Florida,Pasco County,8,4,23862,12323,11539
50,12,101,Florida,Pasco County,8,5,20681,10550,10131
50,12,101,Florida,Pasco County,8,6,22140,11058,11082
50,12,101,Florida,Pasco County,8,7,25448,12742,12706
50,12,101,Florida,Pasco County,8,8,27992,14107,13885
50,12,101,Florida,Pasco County,8,9,31006,15585,15421
50,12,101,Florida,Pasco County,8,10,29329,14418,14911
50,12,101,Florida,Pasco County,8,11,26591,12641,13950
50,12,101,Florida,Pasco County,8,12,26991,12626,14365
50,12,101,Florida,Pasco County,8,13,24592,11464,13128
50,12,101,Florida,Pasco County,8,14,21503,9920,11583
50,12,101,Florida,Pasco County,8,15,20517,9367,11150
50,12,101,Florida,Pasco County,8,16,20471,9238,11233
50,12,101,Florida,Pasco County,8,17,16654,7027,9627
50,12,101,Florida,Pasco County,8,18,13987,5511,8476
50,12,101,Florida,Pasco County,9,0,444325,215787,228538
50,12,101,Florida,Pasco County,9,1,24992,12616,12376
50,12,101,Florida,Pasco County,9,2,25790,13188,12602
50,12,101,Florida,Pasco County,9,3,26798,13750,13048
50,12,101,Florida,Pasco County,9,4,25328,13078,12250
50,12,101,Florida,Pasco County,9,5,21654,11132,10522
50,12,101,Florida,Pasco County,9,6,24672,12292,12380
50,12,101,Florida,Pasco County,9,7,26047,13090,12957
50,12,101,Florida,Pasco County,9,8,30085,15195,14890
50,12,101,Florida,Pasco County,9,9,31992,16180,15812
50,12,101,Florida,Pasco County,9,10,31432,15504,15928
50,12,101,Florida,Pasco County,9,11,27788,13291,14497
50,12,101,Florida,Pasco County,9,12,28761,13408,15353
50,12,101,Florida,Pasco County,9,13,25478,11849,13629
50,12,101,Florida,Pasco County,9,14,22187,10243,11944
50,12,101,Florida,Pasco County,9,15,20052,9211,10841
50,12,101,Florida,Pasco County,9,16,19932,8937,10995
50,12,101,Florida,Pasco County,9,17,16556,7058,9498
50,12,101,Florida,Pasco County,9,18,14781,5765,9016
50,12,101,Florida,Pasco County,10,0,459566,223725,235841
50,12,101,Florida,Pasco County,10,1,26346,13365,12981
50,12,101,Florida,Pasco County,10,2,26836,13733,13103
50,12,101,Florida,Pasco County,10,3,27484,14092,13392
50,12,101,Florida,Pasco County,10,4,26552,13712,12840
50,12,101,Florida,Pasco County,10,5,22893,11771,11122
50,12,101,Florida,Pasco County,10,6,27094,13581,13513
50,12,101,Florida,Pasco County,10,7,26873,13536,13337
50,12,101,Florida,Pasco County,10,8,31459,15935,15524
50,12,101,Florida,Pasco County,10,9,32351,16392,15959
50,12,101,Florida,Pasco County,10,10,32800,16196,16604
50,12,101,Florida,Pasco County,10,11,28964,13920,15044
50,12,101,Florida,Pasco County,10,12,28730,13455,15275
50,12,101,Florida,Pasco County,10,13,27224,12607,14617
50,12,101,Florida,Pasco County,10,14,22991,10616,12375
50,12,101,Florida,Pasco County,10,15,19788,9088,10700
50,12,101,Florida,Pasco County,10,16,19340,8673,10667
50,12,101,Florida,Pasco County,10,17,16167,6929,9238
50,12,101,Florida,Pasco County,10,18,15674,6124,9550
50,12,101,Florida,Pasco County,11,0,468384,228050,240334
50,12,101,Florida,Pasco County,11,1,27131,13825,13306
50,12,101,Florida,Pasco County,11,2,27505,14073,13432
50,12,101,Florida,Pasco County,11,3,28030,14372,13658
50,12,101,Florida,Pasco County,11,4,27124,13984,13140
50,12,101,Florida,Pasco County,11,5,23220,11856,11364
50,12,101,Florida,Pasco County,11,6,27896,14055,13841
50,12,101,Florida,Pasco County,11,7,26951,13570,13381
50,12,101,Florida,Pasco County,11,8,31923,16117,15806
50,12,101,Florida,Pasco County,11,9,32362,16401,15961
50,12,101,Florida,Pasco County,11,10,33550,16660,16890
50,12,101,Florida,Pasco County,11,11,30184,14549,15635
50,12,101,Florida,Pasco County,11,12,28625,13404,15221
50,12,101,Florida,Pasco County,11,13,27984,12968,15016
50,12,101,Florida,Pasco County,11,14,24456,11266,13190
50,12,101,Florida,Pasco County,11,15,20009,9155,10854
50,12,101,Florida,Pasco County,11,16,18826,8419,10407
50,12,101,Florida,Pasco County,11,17,16294,7010,9284
50,12,101,Florida,Pasco County,11,18,16314,6366,9948
50,12,101,Florida,Pasco County,12,0,471709,229725,241984
50,12,101,Florida,Pasco County,12,1,27529,14026,13503
50,12,101,Florida,Pasco County,12,2,27116,13826,13290
50,12,101,Florida,Pasco County,12,3,28074,14402,13672
50,12,101,Florida,Pasco County,12,4,27077,13950,13127
50,12,101,Florida,Pasco County,12,5,23352,11988,11364
50,12,101,Florida,Pasco County,12,6,27824,14029,13795
50,12,101,Florida,Pasco County,12,7,27436,13873,13563
50,12,101,Florida,Pasco County,12,8,31471,15855,15616
50,12,101,Florida,Pasco County,12,9,31824,16147,15677
50,12,101,Florida,Pasco County,12,10,34219,17079,17140
50,12,101,Florida,Pasco County,12,11,31009,14969,16040
50,12,101,Florida,Pasco County,12,12,28529,13348,15181
50,12,101,Florida,Pasco County,12,13,28799,13373,15426
50,12,101,Florida,Pasco County,12,14,25638,11830,13808
50,12,101,Florida,Pasco County,12,15,20470,9348,11122
50,12,101,Florida,Pasco County,12,16,18425,8222,10203
50,12,101,Florida,Pasco County,12,17,16125,6935,9190
50,12,101,Florida,Pasco County,12,18,16792,6525,10267
50,12,103,Florida,Pinellas County,1,0,921482,438959,482523
50,12,103,Florida,Pinellas County,1,1,45354,23370,21984
50,12,103,Florida,Pinellas County,1,2,50785,26142,24643
50,12,103,Florida,Pinellas County,1,3,51675,26396,25279
50,12,103,Florida,Pinellas County,1,4,47384,24265,23119
50,12,103,Florida,Pinellas County,1,5,41432,20691,20741
50,12,103,Florida,Pinellas County,1,6,50604,25279,25325
50,12,103,Florida,Pinellas County,1,7,57874,29096,28778
50,12,103,Florida,Pinellas County,1,8,70834,35182,35652
50,12,103,Florida,Pinellas County,1,9,72642,35629,37013
50,12,103,Florida,Pinellas County,1,10,66792,32541,34251
50,12,103,Florida,Pinellas County,1,11,62423,30218,32205
50,12,103,Florida,Pinellas County,1,12,51089,23877,27212
50,12,103,Florida,Pinellas County,1,13,45031,20952,24079
50,12,103,Florida,Pinellas County,1,14,46762,21343,25419
50,12,103,Florida,Pinellas County,1,15,49775,21864,27911
50,12,103,Florida,Pinellas County,1,16,46312,19127,27185
50,12,103,Florida,Pinellas County,1,17,33759,13189,20570
50,12,103,Florida,Pinellas County,1,18,30955,9798,21157
50,12,103,Florida,Pinellas County,2,0,921497,438966,482531
50,12,103,Florida,Pinellas County,2,1,45355,23370,21985
50,12,103,Florida,Pinellas County,2,2,50787,26144,24643
50,12,103,Florida,Pinellas County,2,3,51675,26396,25279
50,12,103,Florida,Pinellas County,2,4,47384,24265,23119
50,12,103,Florida,Pinellas County,2,5,41432,20691,20741
50,12,103,Florida,Pinellas County,2,6,50601,25277,25324
50,12,103,Florida,Pinellas County,2,7,57876,29096,28780
50,12,103,Florida,Pinellas County,2,8,70836,35184,35652
50,12,103,Florida,Pinellas County,2,9,72642,35630,37012
50,12,103,Florida,Pinellas County,2,10,66795,32542,34253
50,12,103,Florida,Pinellas County,2,11,62424,30220,32204
50,12,103,Florida,Pinellas County,2,12,51089,23875,27214
50,12,103,Florida,Pinellas County,2,13,45031,20952,24079
50,12,103,Florida,Pinellas County,2,14,46765,21344,25421
50,12,103,Florida,Pinellas County,2,15,49776,21865,27911
50,12,103,Florida,Pinellas County,2,16,46315,19128,27187
50,12,103,Florida,Pinellas County,2,17,33759,13189,20570
50,12,103,Florida,Pinellas County,2,18,30955,9798,21157
50,12,103,Florida,Pinellas County,3,0,922261,439500,482761
50,12,103,Florida,Pinellas County,3,1,45387,23382,22005
50,12,103,Florida,Pinellas County,3,2,50566,26029,24537
50,12,103,Florida,Pinellas County,3,3,51876,26493,25383
50,12,103,Florida,Pinellas County,3,4,47471,24318,23153
50,12,103,Florida,Pinellas County,3,5,41816,20893,20923
50,12,103,Florida,Pinellas County,3,6,50281,25122,25159
50,12,103,Florida,Pinellas County,3,7,57879,29101,28778
50,12,103,Florida,Pinellas County,3,8,70563,35055,35508
50,12,103,Florida,Pinellas County,3,9,72808,35713,37095
50,12,103,Florida,Pinellas County,3,10,67188,32739,34449
50,12,103,Florida,Pinellas County,3,11,63057,30535,32522
50,12,103,Florida,Pinellas County,3,12,51407,24032,27375
50,12,103,Florida,Pinellas County,3,13,45208,21045,24163
50,12,103,Florida,Pinellas County,3,14,46304,21139,25165
50,12,103,Florida,Pinellas County,3,15,49410,21735,27675
50,12,103,Florida,Pinellas County,3,16,46139,19073,27066
50,12,103,Florida,Pinellas County,3,17,33850,13251,20599
50,12,103,Florida,Pinellas County,3,18,31051,9845,21206
50,12,103,Florida,Pinellas County,4,0,923153,440482,482671
50,12,103,Florida,Pinellas County,4,1,45812,23526,22286
50,12,103,Florida,Pinellas County,4,2,49516,25579,23937
50,12,103,Florida,Pinellas County,4,3,52731,26896,25835
50,12,103,Florida,Pinellas County,4,4,47865,24647,23218
50,12,103,Florida,Pinellas County,4,5,43929,21891,22038
50,12,103,Florida,Pinellas County,4,6,48419,24223,24196
50,12,103,Florida,Pinellas County,4,7,57783,29060,28723
50,12,103,Florida,Pinellas County,4,8,68320,33991,34329
50,12,103,Florida,Pinellas County,4,9,73674,36236,37438
50,12,103,Florida,Pinellas County,4,10,68553,33198,35355
50,12,103,Florida,Pinellas County,4,11,65896,31948,33948
50,12,103,Florida,Pinellas County,4,12,52761,24798,27963
50,12,103,Florida,Pinellas County,4,13,45437,21064,24373
50,12,103,Florida,Pinellas County,4,14,44503,20368,24135
50,12,103,Florida,Pinellas County,4,15,47687,21141,26546
50,12,103,Florida,Pinellas County,4,16,45073,18732,26341
50,12,103,Florida,Pinellas County,4,17,34016,13275,20741
50,12,103,Florida,Pinellas County,4,18,31178,9909,21269
50,12,103,Florida,Pinellas County,5,0,923557,441060,482497
50,12,103,Florida,Pinellas County,5,1,45994,23567,22427
50,12,103,Florida,Pinellas County,5,2,48428,25079,23349
50,12,103,Florida,Pinellas County,5,3,53467,27303,26164
50,12,103,Florida,Pinellas County,5,4,48144,24834,23310
50,12,103,Florida,Pinellas County,5,5,45083,22461,22622
50,12,103,Florida,Pinellas County,5,6,47991,23978,24013
50,12,103,Florida,Pinellas County,5,7,57161,28736,28425
50,12,103,Florida,Pinellas County,5,8,65558,32545,33013
50,12,103,Florida,Pinellas County,5,9,73659,36383,37276
50,12,103,Florida,Pinellas County,5,10,70373,34033,36340
50,12,103,Florida,Pinellas County,5,11,65239,31437,33802
50,12,103,Florida,Pinellas County,5,12,56973,27159,29814
50,12,103,Florida,Pinellas County,5,13,46606,21470,25136
50,12,103,Florida,Pinellas County,5,14,42944,19721,23223
50,12,103,Florida,Pinellas County,5,15,45823,20392,25431
50,12,103,Florida,Pinellas County,5,16,44096,18428,25668
50,12,103,Florida,Pinellas County,5,17,34515,13466,21049
50,12,103,Florida,Pinellas County,5,18,31503,10068,21435
50,12,103,Florida,Pinellas County,6,0,923484,441810,481674
50,12,103,Florida,Pinellas County,6,1,46252,23725,22527
50,12,103,Florida,Pinellas County,6,2,47659,24652,23007
50,12,103,Florida,Pinellas County,6,3,53331,27448,25883
50,12,103,Florida,Pinellas County,6,4,48741,24982,23759
50,12,103,Florida,Pinellas County,6,5,46306,23293,23013
50,12,103,Florida,Pinellas County,6,6,48362,24399,23963
50,12,103,Florida,Pinellas County,6,7,55877,27981,27896
50,12,103,Florida,Pinellas County,6,8,62614,31091,31523
50,12,103,Florida,Pinellas County,6,9,73189,36127,37062
50,12,103,Florida,Pinellas County,6,10,71812,34806,37006
50,12,103,Florida,Pinellas County,6,11,65477,31545,33932
50,12,103,Florida,Pinellas County,6,12,58807,28038,30769
50,12,103,Florida,Pinellas County,6,13,48595,22406,26189
50,12,103,Florida,Pinellas County,6,14,42019,19314,22705
50,12,103,Florida,Pinellas County,6,15,43882,19638,24244
50,12,103,Florida,Pinellas County,6,16,43256,18191,25065
50,12,103,Florida,Pinellas County,6,17,34864,13623,21241
50,12,103,Florida,Pinellas County,6,18,32441,10551,21890
50,12,103,Florida,Pinellas County,7,0,924605,442969,481636
50,12,103,Florida,Pinellas County,7,1,46488,23888,22600
50,12,103,Florida,Pinellas County,7,2,46800,24172,22628
50,12,103,Florida,Pinellas County,7,3,52823,27173,25650
50,12,103,Florida,Pinellas County,7,4,49810,25626,24184
50,12,103,Florida,Pinellas County,7,5,47584,24141,23443
50,12,103,Florida,Pinellas County,7,6,49515,24970,24545
50,12,103,Florida,Pinellas County,7,7,53892,26926,26966
50,12,103,Florida,Pinellas County,7,8,60179,30037,30142
50,12,103,Florida,Pinellas County,7,9,72905,35902,37003
50,12,103,Florida,Pinellas County,7,10,72770,35349,37421
50,12,103,Florida,Pinellas County,7,11,66604,32004,34600
50,12,103,Florida,Pinellas County,7,12,61151,29207,31944
50,12,103,Florida,Pinellas County,7,13,50125,23093,27032
50,12,103,Florida,Pinellas County,7,14,41738,19205,22533
50,12,103,Florida,Pinellas County,7,15,41792,18856,22936
50,12,103,Florida,Pinellas County,7,16,42036,17836,24200
50,12,103,Florida,Pinellas County,7,17,35245,13773,21472
50,12,103,Florida,Pinellas County,7,18,33148,10811,22337
50,12,103,Florida,Pinellas County,8,0,924628,443333,481295
50,12,103,Florida,Pinellas County,8,1,46799,24056,22743
50,12,103,Florida,Pinellas County,8,2,45986,23728,22258
50,12,103,Florida,Pinellas County,8,3,51433,26491,24942
50,12,103,Florida,Pinellas County,8,4,50897,26128,24769
50,12,103,Florida,Pinellas County,8,5,47997,24476,23521
50,12,103,Florida,Pinellas County,8,6,51070,25771,25299
50,12,103,Florida,Pinellas County,8,7,51681,25786,25895
50,12,103,Florida,Pinellas County,8,8,58493,29189,29304
50,12,103,Florida,Pinellas County,8,9,71405,35241,36164
50,12,103,Florida,Pinellas County,8,10,73406,35708,37698
50,12,103,Florida,Pinellas County,8,11,68042,32663,35379
50,12,103,Florida,Pinellas County,8,12,63735,30422,33313
50,12,103,Florida,Pinellas County,8,13,51328,23776,27552
50,12,103,Florida,Pinellas County,8,14,41720,19211,22509
50,12,103,Florida,Pinellas County,8,15,39951,17986,21965
50,12,103,Florida,Pinellas County,8,16,41058,17603,23455
50,12,103,Florida,Pinellas County,8,17,35347,13850,21497
50,12,103,Florida,Pinellas County,8,18,34280,11248,23032
50,12,103,Florida,Pinellas County,9,0,918551,440761,477790
50,12,103,Florida,Pinellas County,9,1,46234,23763,22471
50,12,103,Florida,Pinellas County,9,2,45693,23489,22204
50,12,103,Florida,Pinellas County,9,3,49995,25856,24139
50,12,103,Florida,Pinellas County,9,4,50980,26164,24816
50,12,103,Florida,Pinellas County,9,5,47931,24540,23391
50,12,103,Florida,Pinellas County,9,6,52899,26666,26233
50,12,103,Florida,Pinellas County,9,7,49131,24562,24569
50,12,103,Florida,Pinellas County,9,8,57437,28685,28752
50,12,103,Florida,Pinellas County,9,9,68713,33997,34716
50,12,103,Florida,Pinellas County,9,10,73707,35981,37726
50,12,103,Florida,Pinellas County,9,11,69116,33035,36081
50,12,103,Florida,Pinellas County,9,12,66019,31532,34487
50,12,103,Florida,Pinellas County,9,13,52132,24244,27888
50,12,103,Florida,Pinellas County,9,14,41359,18923,22436
50,12,103,Florida,Pinellas County,9,15,38083,17150,20933
50,12,103,Florida,Pinellas County,9,16,39485,17055,22430
50,12,103,Florida,Pinellas County,9,17,34426,13567,20859
50,12,103,Florida,Pinellas County,9,18,35211,11552,23659
50,12,103,Florida,Pinellas County,10,0,912764,438420,474344
50,12,103,Florida,Pinellas County,10,1,46269,23782,22487
50,12,103,Florida,Pinellas County,10,2,45047,23093,21954
50,12,103,Florida,Pinellas County,10,3,48097,24974,23123
50,12,103,Florida,Pinellas County,10,4,50824,26124,24700
50,12,103,Florida,Pinellas County,10,5,47768,24565,23203
50,12,103,Florida,Pinellas County,10,6,53622,27157,26465
50,12,103,Florida,Pinellas County,10,7,48118,24055,24063
50,12,103,Florida,Pinellas County,10,8,56316,28142,28174
50,12,103,Florida,Pinellas County,10,9,65154,32197,32957
50,12,103,Florida,Pinellas County,10,10,73076,35849,37227
50,12,103,Florida,Pinellas County,10,11,70130,33513,36617
50,12,103,Florida,Pinellas County,10,12,65077,30903,34174
50,12,103,Florida,Pinellas County,10,13,55486,26192,29294
50,12,103,Florida,Pinellas County,10,14,42376,19216,23160
50,12,103,Florida,Pinellas County,10,15,36928,16715,20213
50,12,103,Florida,Pinellas County,10,16,38125,16486,21639
50,12,103,Florida,Pinellas County,10,17,33865,13421,20444
50,12,103,Florida,Pinellas County,10,18,36486,12036,24450
50,12,103,Florida,Pinellas County,11,0,910058,437312,472746
50,12,103,Florida,Pinellas County,11,1,45939,23595,22344
50,12,103,Florida,Pinellas County,11,2,44673,22915,21758
50,12,103,Florida,Pinellas County,11,3,46733,24253,22480
50,12,103,Florida,Pinellas County,11,4,50304,26020,24284
50,12,103,Florida,Pinellas County,11,5,47650,24271,23379
50,12,103,Florida,Pinellas County,11,6,54447,27708,26739
50,12,103,Florida,Pinellas County,11,7,48458,24433,24025
50,12,103,Florida,Pinellas County,11,8,54499,27092,27407
50,12,103,Florida,Pinellas County,11,9,61850,30576,31274
50,12,103,Florida,Pinellas County,11,10,72429,35500,36929
50,12,103,Florida,Pinellas County,11,11,71073,34071,37002
50,12,103,Florida,Pinellas County,11,12,64702,30730,33972
50,12,103,Florida,Pinellas County,11,13,57646,27200,30446
50,12,103,Florida,Pinellas County,11,14,44813,20364,24449
50,12,103,Florida,Pinellas County,11,15,36643,16575,20068
50,12,103,Florida,Pinellas County,11,16,36826,16038,20788
50,12,103,Florida,Pinellas County,11,17,33550,13399,20151
50,12,103,Florida,Pinellas County,11,18,37823,12572,25251
50,12,103,Florida,Pinellas County,12,0,909013,437181,471832
50,12,103,Florida,Pinellas County,12,1,45826,23468,22358
50,12,103,Florida,Pinellas County,12,2,44617,22925,21692
50,12,103,Florida,Pinellas County,12,3,45530,23612,21918
50,12,103,Florida,Pinellas County,12,4,49362,25567,23795
50,12,103,Florida,Pinellas County,12,5,48324,24691,23633
50,12,103,Florida,Pinellas County,12,6,54693,28001,26692
50,12,103,Florida,Pinellas County,12,7,49551,24962,24589
50,12,103,Florida,Pinellas County,12,8,52582,26108,26474
50,12,103,Florida,Pinellas County,12,9,59206,29457,29749
50,12,103,Florida,Pinellas County,12,10,71988,35193,36795
50,12,103,Florida,Pinellas County,12,11,71576,34406,37170
50,12,103,Florida,Pinellas County,12,12,65418,31009,34409
50,12,103,Florida,Pinellas County,12,13,59584,28136,31448
50,12,103,Florida,Pinellas County,12,14,46658,21169,25489
50,12,103,Florida,Pinellas County,12,15,36857,16689,20168
50,12,103,Florida,Pinellas County,12,16,35344,15503,19841
50,12,103,Florida,Pinellas County,12,17,33067,13373,19694
50,12,103,Florida,Pinellas County,12,18,38830,12912,25918
50,12,105,Florida,Polk County,1,0,483924,237366,246558
50,12,105,Florida,Polk County,1,1,31186,15994,15192
50,12,105,Florida,Polk County,1,2,33184,17155,16029
50,12,105,Florida,Polk County,1,3,33853,17438,16415
50,12,105,Florida,Polk County,1,4,32604,16958,15646
50,12,105,Florida,Polk County,1,5,27308,13875,13433
50,12,105,Florida,Polk County,1,6,28809,14517,14292
50,12,105,Florida,Polk County,1,7,30527,15331,15196
50,12,105,Florida,Polk County,1,8,34558,17402,17156
50,12,105,Florida,Polk County,1,9,34035,16848,17187
50,12,105,Florida,Polk County,1,10,30593,15064,15529
50,12,105,Florida,Polk County,1,11,28886,13938,14948
50,12,105,Florida,Polk County,1,12,25474,12018,13456
50,12,105,Florida,Polk County,1,13,24169,11411,12758
50,12,105,Florida,Polk County,1,14,24250,11421,12829
50,12,105,Florida,Polk County,1,15,23872,11169,12703
50,12,105,Florida,Polk County,1,16,19644,8918,10726
50,12,105,Florida,Polk County,1,17,11920,4944,6976
50,12,105,Florida,Polk County,1,18,9052,2965,6087
50,12,105,Florida,Polk County,2,0,483924,237366,246558
50,12,105,Florida,Polk County,2,1,31186,15994,15192
50,12,105,Florida,Polk County,2,2,33184,17155,16029
50,12,105,Florida,Polk County,2,3,33853,17438,16415
50,12,105,Florida,Polk County,2,4,32604,16958,15646
50,12,105,Florida,Polk County,2,5,27308,13875,13433
50,12,105,Florida,Polk County,2,6,28809,14517,14292
50,12,105,Florida,Polk County,2,7,30527,15331,15196
50,12,105,Florida,Polk County,2,8,34558,17402,17156
50,12,105,Florida,Polk County,2,9,34035,16848,17187
50,12,105,Florida,Polk County,2,10,30593,15064,15529
50,12,105,Florida,Polk County,2,11,28886,13938,14948
50,12,105,Florida,Polk County,2,12,25474,12018,13456
50,12,105,Florida,Polk County,2,13,24169,11411,12758
50,12,105,Florida,Polk County,2,14,24250,11421,12829
50,12,105,Florida,Polk County,2,15,23872,11169,12703
50,12,105,Florida,Polk County,2,16,19644,8918,10726
50,12,105,Florida,Polk County,2,17,11920,4944,6976
50,12,105,Florida,Polk County,2,18,9052,2965,6087
50,12,105,Florida,Polk County,3,0,485378,238157,247221
50,12,105,Florida,Polk County,3,1,31264,16032,15232
50,12,105,Florida,Polk County,3,2,33096,17112,15984
50,12,105,Florida,Polk County,3,3,34050,17538,16512
50,12,105,Florida,Polk County,3,4,32708,17016,15692
50,12,105,Florida,Polk County,3,5,27597,14034,13563
50,12,105,Florida,Polk County,3,6,28694,14468,14226
50,12,105,Florida,Polk County,3,7,30575,15363,15212
50,12,105,Florida,Polk County,3,8,34493,17373,17120
50,12,105,Florida,Polk County,3,9,34174,16917,17257
50,12,105,Florida,Polk County,3,10,30811,15172,15639
50,12,105,Florida,Polk County,3,11,29219,14099,15120
50,12,105,Florida,Polk County,3,12,25655,12106,13549
50,12,105,Florida,Polk County,3,13,24281,11469,12812
50,12,105,Florida,Polk County,3,14,24143,11375,12768
50,12,105,Florida,Polk County,3,15,23822,11161,12661
50,12,105,Florida,Polk County,3,16,19670,8938,10732
50,12,105,Florida,Polk County,3,17,12011,4993,7018
50,12,105,Florida,Polk County,3,18,9115,2991,6124
50,12,105,Florida,Polk County,4,0,491393,241160,250233
50,12,105,Florida,Polk County,4,1,32295,16514,15781
50,12,105,Florida,Polk County,4,2,32771,16938,15833
50,12,105,Florida,Polk County,4,3,34663,17793,16870
50,12,105,Florida,Polk County,4,4,32697,17092,15605
50,12,105,Florida,Polk County,4,5,29258,14909,14349
50,12,105,Florida,Polk County,4,6,28101,14256,13845
50,12,105,Florida,Polk County,4,7,30930,15497,15433
50,12,105,Florida,Polk County,4,8,33905,17164,16741
50,12,105,Florida,Polk County,4,9,34784,17157,17627
50,12,105,Florida,Polk County,4,10,31706,15576,16130
50,12,105,Florida,Polk County,4,11,30470,14692,15778
50,12,105,Florida,Polk County,4,12,26060,12330,13730
50,12,105,Florida,Polk County,4,13,24555,11568,12987
50,12,105,Florida,Polk County,4,14,23778,11201,12577
50,12,105,Florida,Polk County,4,15,23502,10987,12515
50,12,105,Florida,Polk County,4,16,19889,9098,10791
50,12,105,Florida,Polk County,4,17,12606,5263,7343
50,12,105,Florida,Polk County,4,18,9423,3125,6298
50,12,105,Florida,Polk County,5,0,498428,244726,253702
50,12,105,Florida,Polk County,5,1,33278,17048,16230
50,12,105,Florida,Polk County,5,2,32725,16809,15916
50,12,105,Florida,Polk County,5,3,35124,18067,17057
50,12,105,Florida,Polk County,5,4,32807,17230,15577
50,12,105,Florida,Polk County,5,5,30214,15420,14794
50,12,105,Florida,Polk County,5,6,28265,14339,13926
50,12,105,Florida,Polk County,5,7,31223,15658,15565
50,12,105,Florida,Polk County,5,8,33555,16917,16638
50,12,105,Florida,Polk County,5,9,35095,17436,17659
50,12,105,Florida,Polk County,5,10,32870,16105,16765
50,12,105,Florida,Polk County,5,11,30274,14663,15611
50,12,105,Florida,Polk County,5,12,27881,13144,14737
50,12,105,Florida,Polk County,5,13,25363,11939,13424
50,12,105,Florida,Polk County,5,14,23603,11113,12490
50,12,105,Florida,Polk County,5,15,23004,10679,12325
50,12,105,Florida,Polk County,5,16,19982,9206,10776
50,12,105,Florida,Polk County,5,17,13283,5616,7667
50,12,105,Florida,Polk County,5,18,9882,3337,6545
50,12,105,Florida,Polk County,6,0,508118,249787,258331
50,12,105,Florida,Polk County,6,1,34314,17486,16828
50,12,105,Florida,Polk County,6,2,32848,16853,15995
50,12,105,Florida,Polk County,6,3,35724,18449,17275
50,12,105,Florida,Polk County,6,4,33210,17387,15823
50,12,105,Florida,Polk County,6,5,31431,16126,15305
50,12,105,Florida,Polk County,6,6,29040,14855,14185
50,12,105,Florida,Polk County,6,7,31723,16028,15695
50,12,105,Florida,Polk County,6,8,33248,16705,16543
50,12,105,Florida,Polk County,6,9,35573,17741,17832
50,12,105,Florida,Polk County,6,10,33866,16577,17289
50,12,105,Florida,Polk County,6,11,30739,14934,15805
50,12,105,Florida,Polk County,6,12,29103,13734,15369
50,12,105,Florida,Polk County,6,13,26248,12271,13977
50,12,105,Florida,Polk County,6,14,23946,11299,12647
50,12,105,Florida,Polk County,6,15,22512,10485,12027
50,12,105,Florida,Polk County,6,16,20262,9291,10971
50,12,105,Florida,Polk County,6,17,13894,5896,7998
50,12,105,Florida,Polk County,6,18,10437,3670,6767
50,12,105,Florida,Polk County,7,0,521029,256324,264705
50,12,105,Florida,Polk County,7,1,35542,18044,17498
50,12,105,Florida,Polk County,7,2,33363,17126,16237
50,12,105,Florida,Polk County,7,3,36051,18656,17395
50,12,105,Florida,Polk County,7,4,34106,17806,16300
50,12,105,Florida,Polk County,7,5,32296,16621,15675
50,12,105,Florida,Polk County,7,6,30599,15762,14837
50,12,105,Florida,Polk County,7,7,32100,16199,15901
50,12,105,Florida,Polk County,7,8,32808,16502,16306
50,12,105,Florida,Polk County,7,9,36435,18229,18206
50,12,105,Florida,Polk County,7,10,34898,17157,17741
50,12,105,Florida,Polk County,7,11,31837,15373,16464
50,12,105,Florida,Polk County,7,12,30497,14452,16045
50,12,105,Florida,Polk County,7,13,27656,12940,14716
50,12,105,Florida,Polk County,7,14,24661,11611,13050
50,12,105,Florida,Polk County,7,15,22401,10444,11957
50,12,105,Florida,Polk County,7,16,20275,9257,11018
50,12,105,Florida,Polk County,7,17,14559,6281,8278
50,12,105,Florida,Polk County,7,18,10945,3864,7081
50,12,105,Florida,Polk County,8,0,538638,265246,273392
50,12,105,Florida,Polk County,8,1,37453,19039,18414
50,12,105,Florida,Polk County,8,2,34650,17756,16894
50,12,105,Florida,Polk County,8,3,36065,18643,17422
50,12,105,Florida,Polk County,8,4,35883,18691,17192
50,12,105,Florida,Polk County,8,5,33427,17272,16155
50,12,105,Florida,Polk County,8,6,32896,16935,15961
50,12,105,Florida,Polk County,8,7,32539,16449,16090
50,12,105,Florida,Polk County,8,8,33721,16962,16759
50,12,105,Florida,Polk County,8,9,37143,18646,18497
50,12,105,Florida,Polk County,8,10,36140,17752,18388
50,12,105,Florida,Polk County,8,11,32986,15995,16991
50,12,105,Florida,Polk County,8,12,32376,15390,16986
50,12,105,Florida,Polk County,8,13,28862,13512,15350
50,12,105,Florida,Polk County,8,14,25243,11844,13399
50,12,105,Florida,Polk County,8,15,22249,10329,11920
50,12,105,Florida,Polk County,8,16,20284,9274,11010
50,12,105,Florida,Polk County,8,17,15021,6570,8451
50,12,105,Florida,Polk County,8,18,11700,4187,7513
50,12,105,Florida,Polk County,9,0,557477,274839,282638
50,12,105,Florida,Polk County,9,1,38943,19835,19108
50,12,105,Florida,Polk County,9,2,36874,18837,18037
50,12,105,Florida,Polk County,9,3,36686,18969,17717
50,12,105,Florida,Polk County,9,4,37284,19347,17937
50,12,105,Florida,Polk County,9,5,34258,17732,16526
50,12,105,Florida,Polk County,9,6,35774,18439,17335
50,12,105,Florida,Polk County,9,7,33242,16922,16320
50,12,105,Florida,Polk County,9,8,35268,17751,17517
50,12,105,Florida,Polk County,9,9,37373,18882,18491
50,12,105,Florida,Polk County,9,10,37666,18491,19175
50,12,105,Florida,Polk County,9,11,34121,16536,17585
50,12,105,Florida,Polk County,9,12,34144,16233,17911
50,12,105,Florida,Polk County,9,13,29744,13950,15794
50,12,105,Florida,Polk County,9,14,26059,12201,13858
50,12,105,Florida,Polk County,9,15,22322,10329,11993
50,12,105,Florida,Polk County,9,16,20214,9221,10993
50,12,105,Florida,Polk County,9,17,15091,6648,8443
50,12,105,Florida,Polk County,9,18,12414,4516,7898
50,12,105,Florida,Polk County,10,0,573483,283296,290187
50,12,105,Florida,Polk County,10,1,40597,20783,19814
50,12,105,Florida,Polk County,10,2,38608,19759,18849
50,12,105,Florida,Polk County,10,3,37093,19078,18015
50,12,105,Florida,Polk County,10,4,38399,19981,18418
50,12,105,Florida,Polk County,10,5,34966,18196,16770
50,12,105,Florida,Polk County,10,6,37686,19485,18201
50,12,105,Florida,Polk County,10,7,34229,17467,16762
50,12,105,Florida,Polk County,10,8,36381,18363,18018
50,12,105,Florida,Polk County,10,9,37483,18916,18567
50,12,105,Florida,Polk County,10,10,38348,18979,19369
50,12,105,Florida,Polk County,10,11,35537,17220,18317
50,12,105,Florida,Polk County,10,12,34355,16398,17957
50,12,105,Florida,Polk County,10,13,31899,14914,16985
50,12,105,Florida,Polk County,10,14,27094,12669,14425
50,12,105,Florida,Polk County,10,15,22346,10327,12019
50,12,105,Florida,Polk County,10,16,19815,9007,10808
50,12,105,Florida,Polk County,10,17,15317,6802,8515
50,12,105,Florida,Polk County,10,18,13330,4952,8378
50,12,105,Florida,Polk County,11,0,580282,286624,293658
50,12,105,Florida,Polk County,11,1,40902,20982,19920
50,12,105,Florida,Polk County,11,2,39218,19987,19231
50,12,105,Florida,Polk County,11,3,37068,19049,18019
50,12,105,Florida,Polk County,11,4,38613,20145,18468
50,12,105,Florida,Polk County,11,5,35028,18145,16883
50,12,105,Florida,Polk County,11,6,38340,19807,18533
50,12,105,Florida,Polk County,11,7,34503,17695,16808
50,12,105,Florida,Polk County,11,8,36699,18606,18093
50,12,105,Florida,Polk County,11,9,36986,18610,18376
50,12,105,Florida,Polk County,11,10,38731,19233,19498
50,12,105,Florida,Polk County,11,11,36336,17593,18743
50,12,105,Florida,Polk County,11,12,34383,16471,17912
50,12,105,Florida,Polk County,11,13,32982,15417,17565
50,12,105,Florida,Polk County,11,14,28213,13093,15120
50,12,105,Florida,Polk County,11,15,23075,10676,12399
50,12,105,Florida,Polk County,11,16,19651,8939,10712
50,12,105,Florida,Polk County,11,17,15585,6903,8682
50,12,105,Florida,Polk County,11,18,13969,5273,8696
50,12,105,Florida,Polk County,12,0,583403,288395,295008
50,12,105,Florida,Polk County,12,1,40944,21047,19897
50,12,105,Florida,Polk County,12,2,39544,20090,19454
50,12,105,Florida,Polk County,12,3,36843,18955,17888
50,12,105,Florida,Polk County,12,4,38060,19903,18157
50,12,105,Florida,Polk County,12,5,35029,18134,16895
50,12,105,Florida,Polk County,12,6,38417,19892,18525
50,12,105,Florida,Polk County,12,7,35100,18113,16987
50,12,105,Florida,Polk County,12,8,36630,18578,18052
50,12,105,Florida,Polk County,12,9,35859,18078,17781
50,12,105,Florida,Polk County,12,10,38975,19427,19548
50,12,105,Florida,Polk County,12,11,37015,18013,19002
50,12,105,Florida,Polk County,12,12,34629,16512,18117
50,12,105,Florida,Polk County,12,13,33671,15790,17881
50,12,105,Florida,Polk County,12,14,29390,13663,15727
50,12,105,Florida,Polk County,12,15,23658,10944,12714
50,12,105,Florida,Polk County,12,16,19393,8783,10610
50,12,105,Florida,Polk County,12,17,15595,6860,8735
50,12,105,Florida,Polk County,12,18,14651,5613,9038
50,12,107,Florida,Putnam County,1,0,70423,34791,35632
50,12,107,Florida,Putnam County,1,1,4326,2284,2042
50,12,107,Florida,Putnam County,1,2,4890,2575,2315
50,12,107,Florida,Putnam County,1,3,5123,2668,2455
50,12,107,Florida,Putnam County,1,4,4805,2414,2391
50,12,107,Florida,Putnam County,1,5,3568,1821,1747
50,12,107,Florida,Putnam County,1,6,3508,1711,1797
50,12,107,Florida,Putnam County,1,7,3835,1988,1847
50,12,107,Florida,Putnam County,1,8,4604,2212,2392
50,12,107,Florida,Putnam County,1,9,5112,2544,2568
50,12,107,Florida,Putnam County,1,10,4698,2270,2428
50,12,107,Florida,Putnam County,1,11,4747,2308,2439
50,12,107,Florida,Putnam County,1,12,4198,2010,2188
50,12,107,Florida,Putnam County,1,13,4000,1939,2061
50,12,107,Florida,Putnam County,1,14,3958,1939,2019
50,12,107,Florida,Putnam County,1,15,3670,1785,1885
50,12,107,Florida,Putnam County,1,16,2785,1267,1518
50,12,107,Florida,Putnam County,1,17,1563,703,860
50,12,107,Florida,Putnam County,1,18,1033,353,680
50,12,107,Florida,Putnam County,2,0,70423,34791,35632
50,12,107,Florida,Putnam County,2,1,4326,2284,2042
50,12,107,Florida,Putnam County,2,2,4890,2575,2315
50,12,107,Florida,Putnam County,2,3,5123,2668,2455
50,12,107,Florida,Putnam County,2,4,4805,2414,2391
50,12,107,Florida,Putnam County,2,5,3568,1821,1747
50,12,107,Florida,Putnam County,2,6,3508,1711,1797
50,12,107,Florida,Putnam County,2,7,3835,1988,1847
50,12,107,Florida,Putnam County,2,8,4604,2212,2392
50,12,107,Florida,Putnam County,2,9,5112,2544,2568
50,12,107,Florida,Putnam County,2,10,4698,2270,2428
50,12,107,Florida,Putnam County,2,11,4747,2308,2439
50,12,107,Florida,Putnam County,2,12,4198,2010,2188
50,12,107,Florida,Putnam County,2,13,4000,1939,2061
50,12,107,Florida,Putnam County,2,14,3958,1939,2019
50,12,107,Florida,Putnam County,2,15,3670,1785,1885
50,12,107,Florida,Putnam County,2,16,2785,1267,1518
50,12,107,Florida,Putnam County,2,17,1563,703,860
50,12,107,Florida,Putnam County,2,18,1033,353,680
50,12,107,Florida,Putnam County,3,0,70419,34797,35622
50,12,107,Florida,Putnam County,3,1,4318,2278,2040
50,12,107,Florida,Putnam County,3,2,4859,2559,2300
50,12,107,Florida,Putnam County,3,3,5134,2673,2461
50,12,107,Florida,Putnam County,3,4,4805,2415,2390
50,12,107,Florida,Putnam County,3,5,3599,1839,1760
50,12,107,Florida,Putnam County,3,6,3478,1698,1780
50,12,107,Florida,Putnam County,3,7,3825,1982,1843
50,12,107,Florida,Putnam County,3,8,4581,2202,2379
50,12,107,Florida,Putnam County,3,9,5115,2545,2570
50,12,107,Florida,Putnam County,3,10,4714,2278,2436
50,12,107,Florida,Putnam County,3,11,4785,2326,2459
50,12,107,Florida,Putnam County,3,12,4211,2018,2193
50,12,107,Florida,Putnam County,3,13,4003,1941,2062
50,12,107,Florida,Putnam County,3,14,3937,1928,2009
50,12,107,Florida,Putnam County,3,15,3657,1781,1876
50,12,107,Florida,Putnam County,3,16,2784,1268,1516
50,12,107,Florida,Putnam County,3,17,1575,710,865
50,12,107,Florida,Putnam County,3,18,1039,356,683
50,12,107,Florida,Putnam County,4,0,70401,34807,35594
50,12,107,Florida,Putnam County,4,1,4314,2263,2051
50,12,107,Florida,Putnam County,4,2,4674,2465,2209
50,12,107,Florida,Putnam County,4,3,5210,2747,2463
50,12,107,Florida,Putnam County,4,4,4692,2365,2327
50,12,107,Florida,Putnam County,4,5,3927,2018,1909
50,12,107,Florida,Putnam County,4,6,3394,1682,1712
50,12,107,Florida,Putnam County,4,7,3717,1896,1821
50,12,107,Florida,Putnam County,4,8,4493,2196,2297
50,12,107,Florida,Putnam County,4,9,4946,2400,2546
50,12,107,Florida,Putnam County,4,10,4816,2360,2456
50,12,107,Florida,Putnam County,4,11,4968,2393,2575
50,12,107,Florida,Putnam County,4,12,4259,2034,2225
50,12,107,Florida,Putnam County,4,13,4069,1968,2101
50,12,107,Florida,Putnam County,4,14,3777,1833,1944
50,12,107,Florida,Putnam County,4,15,3553,1734,1819
50,12,107,Florida,Putnam County,4,16,2827,1313,1514
50,12,107,Florida,Putnam County,4,17,1666,751,915
50,12,107,Florida,Putnam County,4,18,1099,389,710
50,12,107,Florida,Putnam County,5,0,71004,35071,35933
50,12,107,Florida,Putnam County,5,1,4454,2300,2154
50,12,107,Florida,Putnam County,5,2,4567,2450,2117
50,12,107,Florida,Putnam County,5,3,5252,2759,2493
50,12,107,Florida,Putnam County,5,4,4655,2388,2267
50,12,107,Florida,Putnam County,5,5,4103,2087,2016
50,12,107,Florida,Putnam County,5,6,3374,1657,1717
50,12,107,Florida,Putnam County,5,7,3822,1970,1852
50,12,107,Florida,Putnam County,5,8,4334,2123,2211
50,12,107,Florida,Putnam County,5,9,4943,2386,2557
50,12,107,Florida,Putnam County,5,10,4940,2421,2519
50,12,107,Florida,Putnam County,5,11,4847,2318,2529
50,12,107,Florida,Putnam County,5,12,4573,2188,2385
50,12,107,Florida,Putnam County,5,13,4125,1986,2139
50,12,107,Florida,Putnam County,5,14,3747,1804,1943
50,12,107,Florida,Putnam County,5,15,3482,1692,1790
50,12,107,Florida,Putnam County,5,16,2848,1341,1507
50,12,107,Florida,Putnam County,5,17,1775,761,1014
50,12,107,Florida,Putnam County,5,18,1163,440,723
50,12,107,Florida,Putnam County,6,0,71248,35215,36033
50,12,107,Florida,Putnam County,6,1,4518,2355,2163
50,12,107,Florida,Putnam County,6,2,4458,2381,2077
50,12,107,Florida,Putnam County,6,3,5212,2744,2468
50,12,107,Florida,Putnam County,6,4,4701,2418,2283
50,12,107,Florida,Putnam County,6,5,4203,2133,2070
50,12,107,Florida,Putnam County,6,6,3419,1746,1673
50,12,107,Florida,Putnam County,6,7,3758,1873,1885
50,12,107,Florida,Putnam County,6,8,4213,2102,2111
50,12,107,Florida,Putnam County,6,9,4934,2387,2547
50,12,107,Florida,Putnam County,6,10,4996,2453,2543
50,12,107,Florida,Putnam County,6,11,4873,2319,2554
50,12,107,Florida,Putnam County,6,12,4642,2210,2432
50,12,107,Florida,Putnam County,6,13,4283,2063,2220
50,12,107,Florida,Putnam County,6,14,3697,1766,1931
50,12,107,Florida,Putnam County,6,15,3412,1659,1753
50,12,107,Florida,Putnam County,6,16,2888,1362,1526
50,12,107,Florida,Putnam County,6,17,1842,780,1062
50,12,107,Florida,Putnam County,6,18,1199,464,735
50,12,107,Florida,Putnam County,7,0,72019,35597,36422
50,12,107,Florida,Putnam County,7,1,4617,2389,2228
50,12,107,Florida,Putnam County,7,2,4409,2370,2039
50,12,107,Florida,Putnam County,7,3,5135,2688,2447
50,12,107,Florida,Putnam County,7,4,4818,2516,2302
50,12,107,Florida,Putnam County,7,5,4324,2190,2134
50,12,107,Florida,Putnam County,7,6,3615,1856,1759
50,12,107,Florida,Putnam County,7,7,3734,1839,1895
50,12,107,Florida,Putnam County,7,8,3952,2019,1933
50,12,107,Florida,Putnam County,7,9,4927,2358,2569
50,12,107,Florida,Putnam County,7,10,5104,2511,2593
50,12,107,Florida,Putnam County,7,11,4902,2322,2580
50,12,107,Florida,Putnam County,7,12,4898,2340,2558
50,12,107,Florida,Putnam County,7,13,4380,2088,2292
50,12,107,Florida,Putnam County,7,14,3750,1799,1951
50,12,107,Florida,Putnam County,7,15,3345,1612,1733
50,12,107,Florida,Putnam County,7,16,2932,1373,1559
50,12,107,Florida,Putnam County,7,17,1903,807,1096
50,12,107,Florida,Putnam County,7,18,1274,520,754
50,12,107,Florida,Putnam County,8,0,72750,35933,36817
50,12,107,Florida,Putnam County,8,1,4794,2485,2309
50,12,107,Florida,Putnam County,8,2,4485,2380,2105
50,12,107,Florida,Putnam County,8,3,5072,2680,2392
50,12,107,Florida,Putnam County,8,4,4781,2491,2290
50,12,107,Florida,Putnam County,8,5,4271,2160,2111
50,12,107,Florida,Putnam County,8,6,3932,2050,1882
50,12,107,Florida,Putnam County,8,7,3620,1756,1864
50,12,107,Florida,Putnam County,8,8,3958,2023,1935
50,12,107,Florida,Putnam County,8,9,4719,2259,2460
50,12,107,Florida,Putnam County,8,10,5350,2634,2716
50,12,107,Florida,Putnam County,8,11,4936,2340,2596
50,12,107,Florida,Putnam County,8,12,5082,2424,2658
50,12,107,Florida,Putnam County,8,13,4368,2056,2312
50,12,107,Florida,Putnam County,8,14,3780,1792,1988
50,12,107,Florida,Putnam County,8,15,3323,1609,1714
50,12,107,Florida,Putnam County,8,16,2874,1360,1514
50,12,107,Florida,Putnam County,8,17,2050,884,1166
50,12,107,Florida,Putnam County,8,18,1355,550,805
50,12,107,Florida,Putnam County,9,0,73411,36215,37196
50,12,107,Florida,Putnam County,9,1,4949,2556,2393
50,12,107,Florida,Putnam County,9,2,4547,2398,2149
50,12,107,Florida,Putnam County,9,3,4862,2571,2291
50,12,107,Florida,Putnam County,9,4,4920,2591,2329
50,12,107,Florida,Putnam County,9,5,4095,2084,2011
50,12,107,Florida,Putnam County,9,6,4287,2235,2052
50,12,107,Florida,Putnam County,9,7,3539,1737,1802
50,12,107,Florida,Putnam County,9,8,3994,2020,1974
50,12,107,Florida,Putnam County,9,9,4701,2289,2412
50,12,107,Florida,Putnam County,9,10,5212,2510,2702
50,12,107,Florida,Putnam County,9,11,5064,2431,2633
50,12,107,Florida,Putnam County,9,12,5282,2499,2783
50,12,107,Florida,Putnam County,9,13,4455,2087,2368
50,12,107,Florida,Putnam County,9,14,3819,1803,2016
50,12,107,Florida,Putnam County,9,15,3269,1548,1721
50,12,107,Florida,Putnam County,9,16,2853,1341,1512
50,12,107,Florida,Putnam County,9,17,2076,923,1153
50,12,107,Florida,Putnam County,9,18,1487,592,895
50,12,107,Florida,Putnam County,10,0,73740,36348,37392
50,12,107,Florida,Putnam County,10,1,5058,2604,2454
50,12,107,Florida,Putnam County,10,2,4582,2380,2202
50,12,107,Florida,Putnam County,10,3,4732,2546,2186
50,12,107,Florida,Putnam County,10,4,4952,2601,2351
50,12,107,Florida,Putnam County,10,5,4102,2127,1975
50,12,107,Florida,Putnam County,10,6,4410,2282,2128
50,12,107,Florida,Putnam County,10,7,3517,1714,1803
50,12,107,Florida,Putnam County,10,8,4008,2049,1959
50,12,107,Florida,Putnam County,10,9,4508,2202,2306
50,12,107,Florida,Putnam County,10,10,5195,2487,2708
50,12,107,Florida,Putnam County,10,11,5139,2470,2669
50,12,107,Florida,Putnam County,10,12,5125,2418,2707
50,12,107,Florida,Putnam County,10,13,4710,2215,2495
50,12,107,Florida,Putnam County,10,14,3890,1819,2071
50,12,107,Florida,Putnam County,10,15,3284,1538,1746
50,12,107,Florida,Putnam County,10,16,2799,1313,1486
50,12,107,Florida,Putnam County,10,17,2136,964,1172
50,12,107,Florida,Putnam County,10,18,1593,619,974
50,12,107,Florida,Putnam County,11,0,73455,36192,37263
50,12,107,Florida,Putnam County,11,1,5099,2640,2459
50,12,107,Florida,Putnam County,11,2,4599,2409,2190
50,12,107,Florida,Putnam County,11,3,4445,2390,2055
50,12,107,Florida,Putnam County,11,4,4849,2548,2301
50,12,107,Florida,Putnam County,11,5,4182,2169,2013
50,12,107,Florida,Putnam County,11,6,4506,2313,2193
50,12,107,Florida,Putnam County,11,7,3478,1758,1720
50,12,107,Florida,Putnam County,11,8,3867,1900,1967
50,12,107,Florida,Putnam County,11,9,4326,2152,2174
50,12,107,Florida,Putnam County,11,10,5112,2445,2667
50,12,107,Florida,Putnam County,11,11,5150,2488,2662
50,12,107,Florida,Putnam County,11,12,5117,2392,2725
50,12,107,Florida,Putnam County,11,13,4778,2235,2543
50,12,107,Florida,Putnam County,11,14,4076,1911,2165
50,12,107,Florida,Putnam County,11,15,3198,1480,1718
50,12,107,Florida,Putnam County,11,16,2795,1307,1488
50,12,107,Florida,Putnam County,11,17,2196,988,1208
50,12,107,Florida,Putnam County,11,18,1682,667,1015
50,12,107,Florida,Putnam County,12,0,72893,35883,37010
50,12,107,Florida,Putnam County,12,1,5025,2598,2427
50,12,107,Florida,Putnam County,12,2,4556,2369,2187
50,12,107,Florida,Putnam County,12,3,4403,2386,2017
50,12,107,Florida,Putnam County,12,4,4654,2438,2216
50,12,107,Florida,Putnam County,12,5,4148,2186,1962
50,12,107,Florida,Putnam County,12,6,4466,2283,2183
50,12,107,Florida,Putnam County,12,7,3526,1793,1733
50,12,107,Florida,Putnam County,12,8,3862,1877,1985
50,12,107,Florida,Putnam County,12,9,3988,2023,1965
50,12,107,Florida,Putnam County,12,10,5029,2384,2645
50,12,107,Florida,Putnam County,12,11,5168,2502,2666
50,12,107,Florida,Putnam County,12,12,4973,2312,2661
50,12,107,Florida,Putnam County,12,13,4957,2315,2642
50,12,107,Florida,Putnam County,12,14,4178,1950,2228
50,12,107,Florida,Putnam County,12,15,3247,1503,1744
50,12,107,Florida,Putnam County,12,16,2748,1283,1465
50,12,107,Florida,Putnam County,12,17,2212,974,1238
50,12,107,Florida,Putnam County,12,18,1753,707,1046
50,12,109,Florida,St. Johns County,1,0,123135,59814,63321
50,12,109,Florida,St. Johns County,1,1,6606,3372,3234
50,12,109,Florida,St. Johns County,1,2,8055,4127,3928
50,12,109,Florida,St. Johns County,1,3,8811,4479,4332
50,12,109,Florida,St. Johns County,1,4,7923,4042,3881
50,12,109,Florida,St. Johns County,1,5,5648,2819,2829
50,12,109,Florida,St. Johns County,1,6,5988,3045,2943
50,12,109,Florida,St. Johns County,1,7,7252,3445,3807
50,12,109,Florida,St. Johns County,1,8,9955,4745,5210
50,12,109,Florida,St. Johns County,1,9,10790,5193,5597
50,12,109,Florida,St. Johns County,1,10,10167,4966,5201
50,12,109,Florida,St. Johns County,1,11,9243,4640,4603
50,12,109,Florida,St. Johns County,1,12,7317,3495,3822
50,12,109,Florida,St. Johns County,1,13,5801,2768,3033
50,12,109,Florida,St. Johns County,1,14,5477,2642,2835
50,12,109,Florida,St. Johns County,1,15,5335,2468,2867
50,12,109,Florida,St. Johns County,1,16,4294,1894,2400
50,12,109,Florida,St. Johns County,1,17,2541,1064,1477
50,12,109,Florida,St. Johns County,1,18,1932,610,1322
50,12,109,Florida,St. Johns County,2,0,123148,59827,63321
50,12,109,Florida,St. Johns County,2,1,6606,3372,3234
50,12,109,Florida,St. Johns County,2,2,8055,4127,3928
50,12,109,Florida,St. Johns County,2,3,8811,4479,4332
50,12,109,Florida,St. Johns County,2,4,7924,4043,3881
50,12,109,Florida,St. Johns County,2,5,5648,2819,2829
50,12,109,Florida,St. Johns County,2,6,5989,3046,2943
50,12,109,Florida,St. Johns County,2,7,7253,3446,3807
50,12,109,Florida,St. Johns County,2,8,9961,4751,5210
50,12,109,Florida,St. Johns County,2,9,10790,5193,5597
50,12,109,Florida,St. Johns County,2,10,10168,4967,5201
50,12,109,Florida,St. Johns County,2,11,9245,4642,4603
50,12,109,Florida,St. Johns County,2,12,7318,3496,3822
50,12,109,Florida,St. Johns County,2,13,5801,2768,3033
50,12,109,Florida,St. Johns County,2,14,5477,2642,2835
50,12,109,Florida,St. Johns County,2,15,5335,2468,2867
50,12,109,Florida,St. Johns County,2,16,4294,1894,2400
50,12,109,Florida,St. Johns County,2,17,2541,1064,1477
50,12,109,Florida,St. Johns County,2,18,1932,610,1322
50,12,109,Florida,St. Johns County,3,0,124478,60488,63990
50,12,109,Florida,St. Johns County,3,1,6669,3404,3265
50,12,109,Florida,St. Johns County,3,2,8092,4146,3946
50,12,109,Florida,St. Johns County,3,3,8930,4538,4392
50,12,109,Florida,St. Johns County,3,4,8016,4093,3923
50,12,109,Florida,St. Johns County,3,5,5757,2875,2882
50,12,109,Florida,St. Johns County,3,6,6006,3054,2952
50,12,109,Florida,St. Johns County,3,7,7322,3478,3844
50,12,109,Florida,St. Johns County,3,8,10024,4782,5242
50,12,109,Florida,St. Johns County,3,9,10919,5255,5664
50,12,109,Florida,St. Johns County,3,10,10333,5047,5286
50,12,109,Florida,St. Johns County,3,11,9427,4733,4694
50,12,109,Florida,St. Johns County,3,12,7438,3554,3884
50,12,109,Florida,St. Johns County,3,13,5880,2807,3073
50,12,109,Florida,St. Johns County,3,14,5476,2642,2834
50,12,109,Florida,St. Johns County,3,15,5349,2478,2871
50,12,109,Florida,St. Johns County,3,16,4316,1905,2411
50,12,109,Florida,St. Johns County,3,17,2572,1079,1493
50,12,109,Florida,St. Johns County,3,18,1952,618,1334
50,12,109,Florida,St. Johns County,4,0,129832,63149,66683
50,12,109,Florida,St. Johns County,4,1,6830,3492,3338
50,12,109,Florida,St. Johns County,4,2,8271,4213,4058
50,12,109,Florida,St. Johns County,4,3,9289,4734,4555
50,12,109,Florida,St. Johns County,4,4,8448,4324,4124
50,12,109,Florida,St. Johns County,4,5,6422,3191,3231
50,12,109,Florida,St. Johns County,4,6,5896,2991,2905
50,12,109,Florida,St. Johns County,4,7,7566,3667,3899
50,12,109,Florida,St. Johns County,4,8,10006,4784,5222
50,12,109,Florida,St. Johns County,4,9,11553,5558,5995
50,12,109,Florida,St. Johns County,4,10,10908,5268,5640
50,12,109,Florida,St. Johns County,4,11,10260,5132,5128
50,12,109,Florida,St. Johns County,4,12,8004,3847,4157
50,12,109,Florida,St. Johns County,4,13,6259,2999,3260
50,12,109,Florida,St. Johns County,4,14,5451,2602,2849
50,12,109,Florida,St. Johns County,4,15,5358,2526,2832
50,12,109,Florida,St. Johns County,4,16,4489,1993,2496
50,12,109,Florida,St. Johns County,4,17,2765,1154,1611
50,12,109,Florida,St. Johns County,4,18,2057,674,1383
50,12,109,Florida,St. Johns County,5,0,135882,66130,69752
50,12,109,Florida,St. Johns County,5,1,7065,3604,3461
50,12,109,Florida,St. Johns County,5,2,8552,4369,4183
50,12,109,Florida,St. Johns County,5,3,9673,4932,4741
50,12,109,Florida,St. Johns County,5,4,8930,4532,4398
50,12,109,Florida,St. Johns County,5,5,6979,3465,3514
50,12,109,Florida,St. Johns County,5,6,6096,3088,3008
50,12,109,Florida,St. Johns County,5,7,7853,3875,3978
50,12,109,Florida,St. Johns County,5,8,10158,4865,5293
50,12,109,Florida,St. Johns County,5,9,12052,5813,6239
50,12,109,Florida,St. Johns County,5,10,11409,5465,5944
50,12,109,Florida,St. Johns County,5,11,10586,5253,5333
50,12,109,Florida,St. Johns County,5,12,9028,4398,4630
50,12,109,Florida,St. Johns County,5,13,6697,3204,3493
50,12,109,Florida,St. Johns County,5,14,5555,2635,2920
50,12,109,Florida,St. Johns County,5,15,5359,2548,2811
50,12,109,Florida,St. Johns County,5,16,4628,2064,2564
50,12,109,Florida,St. Johns County,5,17,3026,1275,1751
50,12,109,Florida,St. Johns County,5,18,2236,745,1491
50,12,109,Florida,St. Johns County,6,0,142313,69399,72914
50,12,109,Florida,St. Johns County,6,1,7589,3944,3645
50,12,109,Florida,St. Johns County,6,2,8737,4457,4280
50,12,109,Florida,St. Johns County,6,3,10102,5151,4951
50,12,109,Florida,St. Johns County,6,4,9327,4717,4610
50,12,109,Florida,St. Johns County,6,5,7447,3724,3723
50,12,109,Florida,St. Johns County,6,6,6578,3357,3221
50,12,109,Florida,St. Johns County,6,7,8156,4048,4108
50,12,109,Florida,St. Johns County,6,8,10172,4902,5270
50,12,109,Florida,St. Johns County,6,9,12456,5987,6469
50,12,109,Florida,St. Johns County,6,10,12129,5814,6315
50,12,109,Florida,St. Johns County,6,11,11006,5404,5602
50,12,109,Florida,St. Johns County,6,12,9645,4704,4941
50,12,109,Florida,St. Johns County,6,13,7442,3593,3849
50,12,109,Florida,St. Johns County,6,14,5767,2740,3027
50,12,109,Florida,St. Johns County,6,15,5427,2579,2848
50,12,109,Florida,St. Johns County,6,16,4650,2098,2552
50,12,109,Florida,St. Johns County,6,17,3274,1350,1924
50,12,109,Florida,St. Johns County,6,18,2409,830,1579
50,12,109,Florida,St. Johns County,7,0,151916,74272,77644
50,12,109,Florida,St. Johns County,7,1,8105,4208,3897
50,12,109,Florida,St. Johns County,7,2,9390,4828,4562
50,12,109,Florida,St. Johns County,7,3,10487,5309,5178
50,12,109,Florida,St. Johns County,7,4,10190,5146,5044
50,12,109,Florida,St. Johns County,7,5,8215,4123,4092
50,12,109,Florida,St. Johns County,7,6,7322,3751,3571
50,12,109,Florida,St. Johns County,7,7,8764,4419,4345
50,12,109,Florida,St. Johns County,7,8,10427,5051,5376
50,12,109,Florida,St. Johns County,7,9,13081,6301,6780
50,12,109,Florida,St. Johns County,7,10,12884,6219,6665
50,12,109,Florida,St. Johns County,7,11,11758,5695,6063
50,12,109,Florida,St. Johns County,7,12,10496,5176,5320
50,12,109,Florida,St. Johns County,7,13,8280,3935,4345
50,12,109,Florida,St. Johns County,7,14,6116,2936,3180
50,12,109,Florida,St. Johns County,7,15,5418,2562,2856
50,12,109,Florida,St. Johns County,7,16,4805,2185,2620
50,12,109,Florida,St. Johns County,7,17,3550,1505,2045
50,12,109,Florida,St. Johns County,7,18,2628,923,1705
50,12,109,Florida,St. Johns County,8,0,160508,78606,81902
50,12,109,Florida,St. Johns County,8,1,8624,4475,4149
50,12,109,Florida,St. Johns County,8,2,9936,5076,4860
50,12,109,Florida,St. Johns County,8,3,10992,5632,5360
50,12,109,Florida,St. Johns County,8,4,10697,5374,5323
50,12,109,Florida,St. Johns County,8,5,8647,4385,4262
50,12,109,Florida,St. Johns County,8,6,8203,4122,4081
50,12,109,Florida,St. Johns County,8,7,9176,4705,4471
50,12,109,Florida,St. Johns County,8,8,10991,5333,5658
50,12,109,Florida,St. Johns County,8,9,13511,6554,6957
50,12,109,Florida,St. Johns County,8,10,13549,6530,7019
50,12,109,Florida,St. Johns County,8,11,12453,5980,6473
50,12,109,Florida,St. Johns County,8,12,11425,5621,5804
50,12,109,Florida,St. Johns County,8,13,8837,4225,4612
50,12,109,Florida,St. Johns County,8,14,6517,3111,3406
50,12,109,Florida,St. Johns County,8,15,5482,2631,2851
50,12,109,Florida,St. Johns County,8,16,4853,2241,2612
50,12,109,Florida,St. Johns County,8,17,3788,1573,2215
50,12,109,Florida,St. Johns County,8,18,2827,1038,1789
50,12,109,Florida,St. Johns County,9,0,168762,82688,86074
50,12,109,Florida,St. Johns County,9,1,9162,4677,4485
50,12,109,Florida,St. Johns County,9,2,10493,5367,5126
50,12,109,Florida,St. Johns County,9,3,11598,5924,5674
50,12,109,Florida,St. Johns County,9,4,11193,5640,5553
50,12,109,Florida,St. Johns County,9,5,8876,4530,4346
50,12,109,Florida,St. Johns County,9,6,8849,4430,4419
50,12,109,Florida,St. Johns County,9,7,9306,4767,4539
50,12,109,Florida,St. Johns County,9,8,11622,5728,5894
50,12,109,Florida,St. Johns County,9,9,13661,6645,7016
50,12,109,Florida,St. Johns County,9,10,14253,6867,7386
50,12,109,Florida,St. Johns County,9,11,12958,6174,6784
50,12,109,Florida,St. Johns County,9,12,12401,6079,6322
50,12,109,Florida,St. Johns County,9,13,9516,4569,4947
50,12,109,Florida,St. Johns County,9,14,7033,3371,3662
50,12,109,Florida,St. Johns County,9,15,5695,2692,3003
50,12,109,Florida,St. Johns County,9,16,5063,2393,2670
50,12,109,Florida,St. Johns County,9,17,3968,1665,2303
50,12,109,Florida,St. Johns County,9,18,3115,1170,1945
50,12,109,Florida,St. Johns County,10,0,175818,86276,89542
50,12,109,Florida,St. Johns County,10,1,9470,4812,4658
50,12,109,Florida,St. Johns County,10,2,10944,5598,5346
50,12,109,Florida,St. Johns County,10,3,11961,6127,5834
50,12,109,Florida,St. Johns County,10,4,11733,5908,5825
50,12,109,Florida,St. Johns County,10,5,9254,4712,4542
50,12,109,Florida,St. Johns County,10,6,9376,4728,4648
50,12,109,Florida,St. Johns County,10,7,9440,4836,4604
50,12,109,Florida,St. Johns County,10,8,12073,6023,6050
50,12,109,Florida,St. Johns County,10,9,13886,6780,7106
50,12,109,Florida,St. Johns County,10,10,14759,7138,7621
50,12,109,Florida,St. Johns County,10,11,13560,6435,7125
50,12,109,Florida,St. Johns County,10,12,12635,6165,6470
50,12,109,Florida,St. Johns County,10,13,10598,5126,5472
50,12,109,Florida,St. Johns County,10,14,7646,3666,3980
50,12,109,Florida,St. Johns County,10,15,5787,2700,3087
50,12,109,Florida,St. Johns County,10,16,5193,2489,2704
50,12,109,Florida,St. Johns County,10,17,4113,1746,2367
50,12,109,Florida,St. Johns County,10,18,3390,1287,2103
50,12,109,Florida,St. Johns County,11,0,182447,89524,92923
50,12,109,Florida,St. Johns County,11,1,9768,4916,4852
50,12,109,Florida,St. Johns County,11,2,11346,5867,5479
50,12,109,Florida,St. Johns County,11,3,12081,6180,5901
50,12,109,Florida,St. Johns County,11,4,12252,6151,6101
50,12,109,Florida,St. Johns County,11,5,9851,4974,4877
50,12,109,Florida,St. Johns County,11,6,9792,4956,4836
50,12,109,Florida,St. Johns County,11,7,9713,4991,4722
50,12,109,Florida,St. Johns County,11,8,12363,6181,6182
50,12,109,Florida,St. Johns County,11,9,13913,6834,7079
50,12,109,Florida,St. Johns County,11,10,15174,7319,7855
50,12,109,Florida,St. Johns County,11,11,14089,6697,7392
50,12,109,Florida,St. Johns County,11,12,12888,6247,6641
50,12,109,Florida,St. Johns County,11,13,11406,5514,5892
50,12,109,Florida,St. Johns County,11,14,8468,4084,4384
50,12,109,Florida,St. Johns County,11,15,6075,2866,3209
50,12,109,Florida,St. Johns County,11,16,5283,2509,2774
50,12,109,Florida,St. Johns County,11,17,4249,1837,2412
50,12,109,Florida,St. Johns County,11,18,3736,1401,2335
50,12,109,Florida,St. Johns County,12,0,187436,92004,95432
50,12,109,Florida,St. Johns County,12,1,9990,5003,4987
50,12,109,Florida,St. Johns County,12,2,11402,5889,5513
50,12,109,Florida,St. Johns County,12,3,12449,6413,6036
50,12,109,Florida,St. Johns County,12,4,12405,6197,6208
50,12,109,Florida,St. Johns County,12,5,10166,5113,5053
50,12,109,Florida,St. Johns County,12,6,10116,5140,4976
50,12,109,Florida,St. Johns County,12,7,9957,5127,4830
50,12,109,Florida,St. Johns County,12,8,12415,6259,6156
50,12,109,Florida,St. Johns County,12,9,13785,6784,7001
50,12,109,Florida,St. Johns County,12,10,15509,7494,8015
50,12,109,Florida,St. Johns County,12,11,14636,6998,7638
50,12,109,Florida,St. Johns County,12,12,13257,6363,6894
50,12,109,Florida,St. Johns County,12,13,11975,5851,6124
50,12,109,Florida,St. Johns County,12,14,9270,4388,4882
50,12,109,Florida,St. Johns County,12,15,6457,3068,3389
50,12,109,Florida,St. Johns County,12,16,5274,2484,2790
50,12,109,Florida,St. Johns County,12,17,4357,1896,2461
50,12,109,Florida,St. Johns County,12,18,4016,1537,2479
50,12,111,Florida,St. Lucie County,1,0,192695,94119,98576
50,12,111,Florida,St. Lucie County,1,1,10750,5498,5252
50,12,111,Florida,St. Lucie County,1,2,12420,6321,6099
50,12,111,Florida,St. Lucie County,1,3,13142,6782,6360
50,12,111,Florida,St. Lucie County,1,4,11487,5958,5529
50,12,111,Florida,St. Lucie County,1,5,8501,4436,4065
50,12,111,Florida,St. Lucie County,1,6,9298,4593,4705
50,12,111,Florida,St. Lucie County,1,7,11142,5495,5647
50,12,111,Florida,St. Lucie County,1,8,13859,6857,7002
50,12,111,Florida,St. Lucie County,1,9,14082,6952,7130
50,12,111,Florida,St. Lucie County,1,10,12349,6124,6225
50,12,111,Florida,St. Lucie County,1,11,11323,5460,5863
50,12,111,Florida,St. Lucie County,1,12,10173,4702,5471
50,12,111,Florida,St. Lucie County,1,13,10416,4827,5589
50,12,111,Florida,St. Lucie County,1,14,11633,5541,6092
50,12,111,Florida,St. Lucie County,1,15,12073,5742,6331
50,12,111,Florida,St. Lucie County,1,16,10084,4659,5425
50,12,111,Florida,St. Lucie County,1,17,6011,2713,3298
50,12,111,Florida,St. Lucie County,1,18,3952,1459,2493
50,12,111,Florida,St. Lucie County,2,0,192695,94119,98576
50,12,111,Florida,St. Lucie County,2,1,10750,5498,5252
50,12,111,Florida,St. Lucie County,2,2,12420,6321,6099
50,12,111,Florida,St. Lucie County,2,3,13142,6782,6360
50,12,111,Florida,St. Lucie County,2,4,11487,5958,5529
50,12,111,Florida,St. Lucie County,2,5,8501,4436,4065
50,12,111,Florida,St. Lucie County,2,6,9298,4593,4705
50,12,111,Florida,St. Lucie County,2,7,11142,5495,5647
50,12,111,Florida,St. Lucie County,2,8,13859,6857,7002
50,12,111,Florida,St. Lucie County,2,9,14082,6952,7130
50,12,111,Florida,St. Lucie County,2,10,12349,6124,6225
50,12,111,Florida,St. Lucie County,2,11,11323,5460,5863
50,12,111,Florida,St. Lucie County,2,12,10173,4702,5471
50,12,111,Florida,St. Lucie County,2,13,10416,4827,5589
50,12,111,Florida,St. Lucie County,2,14,11633,5541,6092
50,12,111,Florida,St. Lucie County,2,15,12073,5742,6331
50,12,111,Florida,St. Lucie County,2,16,10084,4659,5425
50,12,111,Florida,St. Lucie County,2,17,6011,2713,3298
50,12,111,Florida,St. Lucie County,2,18,3952,1459,2493
50,12,111,Florida,St. Lucie County,3,0,193433,94517,98916
50,12,111,Florida,St. Lucie County,3,1,10775,5512,5263
50,12,111,Florida,St. Lucie County,3,2,12386,6304,6082
50,12,111,Florida,St. Lucie County,3,3,13222,6821,6401
50,12,111,Florida,St. Lucie County,3,4,11532,5982,5550
50,12,111,Florida,St. Lucie County,3,5,8601,4493,4108
50,12,111,Florida,St. Lucie County,3,6,9265,4579,4686
50,12,111,Florida,St. Lucie County,3,7,11160,5507,5653
50,12,111,Florida,St. Lucie County,3,8,13838,6848,6990
50,12,111,Florida,St. Lucie County,3,9,14146,6984,7162
50,12,111,Florida,St. Lucie County,3,10,12443,6172,6271
50,12,111,Florida,St. Lucie County,3,11,11460,5529,5931
50,12,111,Florida,St. Lucie County,3,12,10250,4739,5511
50,12,111,Florida,St. Lucie County,3,13,10469,4853,5616
50,12,111,Florida,St. Lucie County,3,14,11611,5531,6080
50,12,111,Florida,St. Lucie County,3,15,12085,5755,6330
50,12,111,Florida,St. Lucie County,3,16,10127,4685,5442
50,12,111,Florida,St. Lucie County,3,17,6074,2747,3327
50,12,111,Florida,St. Lucie County,3,18,3989,1476,2513
50,12,111,Florida,St. Lucie County,4,0,197728,96698,101030
50,12,111,Florida,St. Lucie County,4,1,11079,5681,5398
50,12,111,Florida,St. Lucie County,4,2,12129,6214,5915
50,12,111,Florida,St. Lucie County,4,3,13632,6988,6644
50,12,111,Florida,St. Lucie County,4,4,11857,6152,5705
50,12,111,Florida,St. Lucie County,4,5,9360,4944,4416
50,12,111,Florida,St. Lucie County,4,6,9284,4593,4691
50,12,111,Florida,St. Lucie County,4,7,11080,5481,5599
50,12,111,Florida,St. Lucie County,4,8,13741,6783,6958
50,12,111,Florida,St. Lucie County,4,9,14458,7126,7332
50,12,111,Florida,St. Lucie County,4,10,13210,6574,6636
50,12,111,Florida,St. Lucie County,4,11,12114,5818,6296
50,12,111,Florida,St. Lucie County,4,12,10667,4976,5691
50,12,111,Florida,St. Lucie County,4,13,10600,4890,5710
50,12,111,Florida,St. Lucie County,4,14,11424,5422,6002
50,12,111,Florida,St. Lucie County,4,15,12122,5767,6355
50,12,111,Florida,St. Lucie County,4,16,10308,4747,5561
50,12,111,Florida,St. Lucie County,4,17,6458,2943,3515
50,12,111,Florida,St. Lucie County,4,18,4205,1599,2606
50,12,111,Florida,St. Lucie County,5,0,204349,99917,104432
50,12,111,Florida,St. Lucie County,5,1,11524,5912,5612
50,12,111,Florida,St. Lucie County,5,2,12342,6301,6041
50,12,111,Florida,St. Lucie County,5,3,13816,7064,6752
50,12,111,Florida,St. Lucie County,5,4,12265,6369,5896
50,12,111,Florida,St. Lucie County,5,5,10134,5354,4780
50,12,111,Florida,St. Lucie County,5,6,9643,4811,4832
50,12,111,Florida,St. Lucie County,5,7,11455,5684,5771
50,12,111,Florida,St. Lucie County,5,8,13546,6672,6874
50,12,111,Florida,St. Lucie County,5,9,14902,7348,7554
50,12,111,Florida,St. Lucie County,5,10,13976,6891,7085
50,12,111,Florida,St. Lucie County,5,11,12412,6013,6399
50,12,111,Florida,St. Lucie County,5,12,11745,5515,6230
50,12,111,Florida,St. Lucie County,5,13,11167,5134,6033
50,12,111,Florida,St. Lucie County,5,14,11528,5475,6053
50,12,111,Florida,St. Lucie County,5,15,11868,5640,6228
50,12,111,Florida,St. Lucie County,5,16,10571,4886,5685
50,12,111,Florida,St. Lucie County,5,17,6940,3116,3824
50,12,111,Florida,St. Lucie County,5,18,4515,1732,2783
50,12,111,Florida,St. Lucie County,6,0,212555,104071,108484
50,12,111,Florida,St. Lucie County,6,1,11860,6114,5746
50,12,111,Florida,St. Lucie County,6,2,12768,6513,6255
50,12,111,Florida,St. Lucie County,6,3,14077,7171,6906
50,12,111,Florida,St. Lucie County,6,4,12793,6665,6128
50,12,111,Florida,St. Lucie County,6,5,11024,5782,5242
50,12,111,Florida,St. Lucie County,6,6,10089,5144,4945
50,12,111,Florida,St. Lucie County,6,7,11855,5917,5938
50,12,111,Florida,St. Lucie County,6,8,13624,6689,6935
50,12,111,Florida,St. Lucie County,6,9,15322,7607,7715
50,12,111,Florida,St. Lucie County,6,10,14765,7255,7510
50,12,111,Florida,St. Lucie County,6,11,13071,6350,6721
50,12,111,Florida,St. Lucie County,6,12,12560,5899,6661
50,12,111,Florida,St. Lucie County,6,13,11920,5530,6390
50,12,111,Florida,St. Lucie County,6,14,11766,5516,6250
50,12,111,Florida,St. Lucie County,6,15,11896,5645,6251
50,12,111,Florida,St. Lucie County,6,16,10866,5045,5821
50,12,111,Florida,St. Lucie County,6,17,7322,3295,4027
50,12,111,Florida,St. Lucie County,6,18,4977,1934,3043
50,12,111,Florida,St. Lucie County,7,0,225240,110391,114849
50,12,111,Florida,St. Lucie County,7,1,13072,6728,6344
50,12,111,Florida,St. Lucie County,7,2,13220,6753,6467
50,12,111,Florida,St. Lucie County,7,3,14812,7544,7268
50,12,111,Florida,St. Lucie County,7,4,13560,7041,6519
50,12,111,Florida,St. Lucie County,7,5,11650,6104,5546
50,12,111,Florida,St. Lucie County,7,6,11093,5725,5368
50,12,111,Florida,St. Lucie County,7,7,12632,6303,6329
50,12,111,Florida,St. Lucie County,7,8,14062,6990,7072
50,12,111,Florida,St. Lucie County,7,9,16312,8054,8258
50,12,111,Florida,St. Lucie County,7,10,15933,7827,8106
50,12,111,Florida,St. Lucie County,7,11,13851,6719,7132
50,12,111,Florida,St. Lucie County,7,12,13599,6414,7185
50,12,111,Florida,St. Lucie County,7,13,12794,5969,6825
50,12,111,Florida,St. Lucie County,7,14,12334,5785,6549
50,12,111,Florida,St. Lucie County,7,15,11830,5562,6268
50,12,111,Florida,St. Lucie County,7,16,11217,5211,6006
50,12,111,Florida,St. Lucie County,7,17,7743,3510,4233
50,12,111,Florida,St. Lucie County,7,18,5526,2152,3374
50,12,111,Florida,St. Lucie County,8,0,237569,116649,120920
50,12,111,Florida,St. Lucie County,8,1,14248,7346,6902
50,12,111,Florida,St. Lucie County,8,2,14143,7226,6917
50,12,111,Florida,St. Lucie County,8,3,15228,7756,7472
50,12,111,Florida,St. Lucie County,8,4,14386,7438,6948
50,12,111,Florida,St. Lucie County,8,5,12463,6450,6013
50,12,111,Florida,St. Lucie County,8,6,12384,6509,5875
50,12,111,Florida,St. Lucie County,8,7,13270,6651,6619
50,12,111,Florida,St. Lucie County,8,8,14912,7416,7496
50,12,111,Florida,St. Lucie County,8,9,17074,8459,8615
50,12,111,Florida,St. Lucie County,8,10,16956,8323,8633
50,12,111,Florida,St. Lucie County,8,11,15114,7346,7768
50,12,111,Florida,St. Lucie County,8,12,14477,6867,7610
50,12,111,Florida,St. Lucie County,8,13,13601,6306,7295
50,12,111,Florida,St. Lucie County,8,14,12415,5823,6592
50,12,111,Florida,St. Lucie County,8,15,11937,5627,6310
50,12,111,Florida,St. Lucie County,8,16,10921,5100,5821
50,12,111,Florida,St. Lucie County,8,17,8133,3662,4471
50,12,111,Florida,St. Lucie County,8,18,5907,2344,3563
50,12,111,Florida,St. Lucie County,9,0,249741,122802,126939
50,12,111,Florida,St. Lucie County,9,1,15464,7963,7501
50,12,111,Florida,St. Lucie County,9,2,15456,7905,7551
50,12,111,Florida,St. Lucie County,9,3,15697,8044,7653
50,12,111,Florida,St. Lucie County,9,4,15382,7902,7480
50,12,111,Florida,St. Lucie County,9,5,13240,6810,6430
50,12,111,Florida,St. Lucie County,9,6,13981,7374,6607
50,12,111,Florida,St. Lucie County,9,7,13926,7004,6922
50,12,111,Florida,St. Lucie County,9,8,15871,7937,7934
50,12,111,Florida,St. Lucie County,9,9,17578,8727,8851
50,12,111,Florida,St. Lucie County,9,10,17847,8773,9074
50,12,111,Florida,St. Lucie County,9,11,16108,7863,8245
50,12,111,Florida,St. Lucie County,9,12,15226,7196,8030
50,12,111,Florida,St. Lucie County,9,13,13945,6508,7437
50,12,111,Florida,St. Lucie County,9,14,12657,5907,6750
50,12,111,Florida,St. Lucie County,9,15,11705,5484,6221
50,12,111,Florida,St. Lucie County,9,16,10988,5110,5878
50,12,111,Florida,St. Lucie County,9,17,8277,3724,4553
50,12,111,Florida,St. Lucie County,9,18,6393,2571,3822
50,12,111,Florida,St. Lucie County,10,0,260461,128308,132153
50,12,111,Florida,St. Lucie County,10,1,16831,8705,8126
50,12,111,Florida,St. Lucie County,10,2,16389,8389,8000
50,12,111,Florida,St. Lucie County,10,3,16426,8398,8028
50,12,111,Florida,St. Lucie County,10,4,16111,8255,7856
50,12,111,Florida,St. Lucie County,10,5,13810,7113,6697
50,12,111,Florida,St. Lucie County,10,6,15090,7974,7116
50,12,111,Florida,St. Lucie County,10,7,14725,7467,7258
50,12,111,Florida,St. Lucie County,10,8,16705,8400,8305
50,12,111,Florida,St. Lucie County,10,9,17738,8813,8925
50,12,111,Florida,St. Lucie County,10,10,18512,9123,9389
50,12,111,Florida,St. Lucie County,10,11,16933,8226,8707
50,12,111,Florida,St. Lucie County,10,12,15371,7320,8051
50,12,111,Florida,St. Lucie County,10,13,14705,6889,7816
50,12,111,Florida,St. Lucie County,10,14,13127,6078,7049
50,12,111,Florida,St. Lucie County,10,15,11736,5503,6233
50,12,111,Florida,St. Lucie County,10,16,10835,5012,5823
50,12,111,Florida,St. Lucie County,10,17,8533,3859,4674
50,12,111,Florida,St. Lucie County,10,18,6884,2784,4100
50,12,111,Florida,St. Lucie County,11,0,265646,130864,134782
50,12,111,Florida,St. Lucie County,11,1,17310,8959,8351
50,12,111,Florida,St. Lucie County,11,2,16419,8436,7983
50,12,111,Florida,St. Lucie County,11,3,16892,8631,8261
50,12,111,Florida,St. Lucie County,11,4,16283,8317,7966
50,12,111,Florida,St. Lucie County,11,5,14132,7271,6861
50,12,111,Florida,St. Lucie County,11,6,15672,8194,7478
50,12,111,Florida,St. Lucie County,11,7,14901,7652,7249
50,12,111,Florida,St. Lucie County,11,8,16882,8497,8385
50,12,111,Florida,St. Lucie County,11,9,17523,8691,8832
50,12,111,Florida,St. Lucie County,11,10,18753,9289,9464
50,12,111,Florida,St. Lucie County,11,11,17568,8532,9036
50,12,111,Florida,St. Lucie County,11,12,15434,7371,8063
50,12,111,Florida,St. Lucie County,11,13,14998,7004,7994
50,12,111,Florida,St. Lucie County,11,14,13902,6469,7433
50,12,111,Florida,St. Lucie County,11,15,11920,5519,6401
50,12,111,Florida,St. Lucie County,11,16,10900,5050,5850
50,12,111,Florida,St. Lucie County,11,17,8776,3957,4819
50,12,111,Florida,St. Lucie County,11,18,7381,3025,4356
50,12,111,Florida,St. Lucie County,12,0,266502,131212,135290
50,12,111,Florida,St. Lucie County,12,1,17365,8981,8384
50,12,111,Florida,St. Lucie County,12,2,16147,8296,7851
50,12,111,Florida,St. Lucie County,12,3,16521,8450,8071
50,12,111,Florida,St. Lucie County,12,4,16104,8235,7869
50,12,111,Florida,St. Lucie County,12,5,14003,7196,6807
50,12,111,Florida,St. Lucie County,12,6,15581,8131,7450
50,12,111,Florida,St. Lucie County,12,7,14706,7612,7094
50,12,111,Florida,St. Lucie County,12,8,16331,8202,8129
50,12,111,Florida,St. Lucie County,12,9,17160,8579,8581
50,12,111,Florida,St. Lucie County,12,10,18818,9270,9548
50,12,111,Florida,St. Lucie County,12,11,18131,8804,9327
50,12,111,Florida,St. Lucie County,12,12,15732,7523,8209
50,12,111,Florida,St. Lucie County,12,13,15479,7257,8222
50,12,111,Florida,St. Lucie County,12,14,14444,6731,7713
50,12,111,Florida,St. Lucie County,12,15,12274,5691,6583
50,12,111,Florida,St. Lucie County,12,16,10868,4977,5891
50,12,111,Florida,St. Lucie County,12,17,9011,4081,4930
50,12,111,Florida,St. Lucie County,12,18,7827,3196,4631
50,12,113,Florida,Santa Rosa County,1,0,117743,59059,58684
50,12,113,Florida,Santa Rosa County,1,1,7700,3937,3763
50,12,113,Florida,Santa Rosa County,1,2,8389,4371,4018
50,12,113,Florida,Santa Rosa County,1,3,9592,5039,4553
50,12,113,Florida,Santa Rosa County,1,4,8430,4422,4008
50,12,113,Florida,Santa Rosa County,1,5,5637,2880,2757
50,12,113,Florida,Santa Rosa County,1,6,6910,3546,3364
50,12,113,Florida,Santa Rosa County,1,7,8344,4174,4170
50,12,113,Florida,Santa Rosa County,1,8,10847,5449,5398
50,12,113,Florida,Santa Rosa County,1,9,10565,5305,5260
50,12,113,Florida,Santa Rosa County,1,10,8972,4443,4529
50,12,113,Florida,Santa Rosa County,1,11,7679,3853,3826
50,12,113,Florida,Santa Rosa County,1,12,6302,3007,3295
50,12,113,Florida,Santa Rosa County,1,13,5404,2689,2715
50,12,113,Florida,Santa Rosa County,1,14,4545,2240,2305
50,12,113,Florida,Santa Rosa County,1,15,3579,1731,1848
50,12,113,Florida,Santa Rosa County,1,16,2509,1142,1367
50,12,113,Florida,Santa Rosa County,1,17,1341,548,793
50,12,113,Florida,Santa Rosa County,1,18,998,283,715
50,12,113,Florida,Santa Rosa County,2,0,117743,59059,58684
50,12,113,Florida,Santa Rosa County,2,1,7700,3937,3763
50,12,113,Florida,Santa Rosa County,2,2,8389,4371,4018
50,12,113,Florida,Santa Rosa County,2,3,9592,5039,4553
50,12,113,Florida,Santa Rosa County,2,4,8430,4422,4008
50,12,113,Florida,Santa Rosa County,2,5,5637,2880,2757
50,12,113,Florida,Santa Rosa County,2,6,6910,3546,3364
50,12,113,Florida,Santa Rosa County,2,7,8344,4174,4170
50,12,113,Florida,Santa Rosa County,2,8,10847,5449,5398
50,12,113,Florida,Santa Rosa County,2,9,10565,5305,5260
50,12,113,Florida,Santa Rosa County,2,10,8972,4443,4529
50,12,113,Florida,Santa Rosa County,2,11,7679,3853,3826
50,12,113,Florida,Santa Rosa County,2,12,6302,3007,3295
50,12,113,Florida,Santa Rosa County,2,13,5404,2689,2715
50,12,113,Florida,Santa Rosa County,2,14,4545,2240,2305
50,12,113,Florida,Santa Rosa County,2,15,3579,1731,1848
50,12,113,Florida,Santa Rosa County,2,16,2509,1142,1367
50,12,113,Florida,Santa Rosa County,2,17,1341,548,793
50,12,113,Florida,Santa Rosa County,2,18,998,283,715
50,12,113,Florida,Santa Rosa County,3,0,118387,59371,59016
50,12,113,Florida,Santa Rosa County,3,1,7723,3947,3776
50,12,113,Florida,Santa Rosa County,3,2,8372,4362,4010
50,12,113,Florida,Santa Rosa County,3,3,9652,5068,4584
50,12,113,Florida,Santa Rosa County,3,4,8474,4446,4028
50,12,113,Florida,Santa Rosa County,3,5,5711,2919,2792
50,12,113,Florida,Santa Rosa County,3,6,6878,3531,3347
50,12,113,Florida,Santa Rosa County,3,7,8362,4181,4181
50,12,113,Florida,Santa Rosa County,3,8,10837,5445,5392
50,12,113,Florida,Santa Rosa County,3,9,10617,5330,5287
50,12,113,Florida,Santa Rosa County,3,10,9048,4480,4568
50,12,113,Florida,Santa Rosa County,3,11,7778,3900,3878
50,12,113,Florida,Santa Rosa County,3,12,6356,3033,3323
50,12,113,Florida,Santa Rosa County,3,13,5439,2706,2733
50,12,113,Florida,Santa Rosa County,3,14,4587,2260,2327
50,12,113,Florida,Santa Rosa County,3,15,3620,1752,1868
50,12,113,Florida,Santa Rosa County,3,16,2546,1160,1386
50,12,113,Florida,Santa Rosa County,3,17,1370,562,808
50,12,113,Florida,Santa Rosa County,3,18,1017,289,728
50,12,113,Florida,Santa Rosa County,4,0,121531,60935,60596
50,12,113,Florida,Santa Rosa County,4,1,7792,3962,3830
50,12,113,Florida,Santa Rosa County,4,2,8324,4345,3979
50,12,113,Florida,Santa Rosa County,4,3,9808,5144,4664
50,12,113,Florida,Santa Rosa County,4,4,8749,4615,4134
50,12,113,Florida,Santa Rosa County,4,5,6089,3107,2982
50,12,113,Florida,Santa Rosa County,4,6,6785,3518,3267
50,12,113,Florida,Santa Rosa County,4,7,8389,4202,4187
50,12,113,Florida,Santa Rosa County,4,8,10691,5342,5349
50,12,113,Florida,Santa Rosa County,4,9,10987,5486,5501
50,12,113,Florida,Santa Rosa County,4,10,9507,4718,4789
50,12,113,Florida,Santa Rosa County,4,11,8278,4146,4132
50,12,113,Florida,Santa Rosa County,4,12,6628,3194,3434
50,12,113,Florida,Santa Rosa County,4,13,5669,2774,2895
50,12,113,Florida,Santa Rosa County,4,14,4694,2299,2395
50,12,113,Florida,Santa Rosa County,4,15,3862,1892,1970
50,12,113,Florida,Santa Rosa County,4,16,2658,1232,1426
50,12,113,Florida,Santa Rosa County,4,17,1523,648,875
50,12,113,Florida,Santa Rosa County,4,18,1098,311,787
50,12,113,Florida,Santa Rosa County,5,0,128077,64106,63971
50,12,113,Florida,Santa Rosa County,5,1,8226,4158,4068
50,12,113,Florida,Santa Rosa County,5,2,8621,4530,4091
50,12,113,Florida,Santa Rosa County,5,3,10149,5276,4873
50,12,113,Florida,Santa Rosa County,5,4,9236,4881,4355
50,12,113,Florida,Santa Rosa County,5,5,6816,3444,3372
50,12,113,Florida,Santa Rosa County,5,6,7230,3761,3469
50,12,113,Florida,Santa Rosa County,5,7,8863,4437,4426
50,12,113,Florida,Santa Rosa County,5,8,10495,5204,5291
50,12,113,Florida,Santa Rosa County,5,9,11657,5814,5843
50,12,113,Florida,Santa Rosa County,5,10,10084,4982,5102
50,12,113,Florida,Santa Rosa County,5,11,8658,4320,4338
50,12,113,Florida,Santa Rosa County,5,12,7419,3617,3802
50,12,113,Florida,Santa Rosa County,5,13,5978,2890,3088
50,12,113,Florida,Santa Rosa County,5,14,4994,2436,2558
50,12,113,Florida,Santa Rosa County,5,15,3986,1975,2011
50,12,113,Florida,Santa Rosa County,5,16,2827,1318,1509
50,12,113,Florida,Santa Rosa County,5,17,1691,721,970
50,12,113,Florida,Santa Rosa County,5,18,1147,342,805
50,12,113,Florida,Santa Rosa County,6,0,132549,66053,66496
50,12,113,Florida,Santa Rosa County,6,1,8368,4317,4051
50,12,113,Florida,Santa Rosa County,6,2,8940,4602,4338
50,12,113,Florida,Santa Rosa County,6,3,10381,5441,4940
50,12,113,Florida,Santa Rosa County,6,4,9511,5003,4508
50,12,113,Florida,Santa Rosa County,6,5,7139,3581,3558
50,12,113,Florida,Santa Rosa County,6,6,7237,3674,3563
50,12,113,Florida,Santa Rosa County,6,7,9001,4476,4525
50,12,113,Florida,Santa Rosa County,6,8,10181,4985,5196
50,12,113,Florida,Santa Rosa County,6,9,12218,6078,6140
50,12,113,Florida,Santa Rosa County,6,10,10602,5198,5404
50,12,113,Florida,Santa Rosa County,6,11,9129,4519,4610
50,12,113,Florida,Santa Rosa County,6,12,7941,3878,4063
50,12,113,Florida,Santa Rosa County,6,13,6468,3089,3379
50,12,113,Florida,Santa Rosa County,6,14,5240,2568,2672
50,12,113,Florida,Santa Rosa County,6,15,4100,2035,2065
50,12,113,Florida,Santa Rosa County,6,16,3032,1406,1626
50,12,113,Florida,Santa Rosa County,6,17,1857,816,1041
50,12,113,Florida,Santa Rosa County,6,18,1204,387,817
50,12,113,Florida,Santa Rosa County,7,0,138284,69058,69226
50,12,113,Florida,Santa Rosa County,7,1,8515,4369,4146
50,12,113,Florida,Santa Rosa County,7,2,9245,4757,4488
50,12,113,Florida,Santa Rosa County,7,3,10442,5423,5019
50,12,113,Florida,Santa Rosa County,7,4,9931,5236,4695
50,12,113,Florida,Santa Rosa County,7,5,7838,4037,3801
50,12,113,Florida,Santa Rosa County,7,6,7950,4050,3900
50,12,113,Florida,Santa Rosa County,7,7,9145,4571,4574
50,12,113,Florida,Santa Rosa County,7,8,10092,4986,5106
50,12,113,Florida,Santa Rosa County,7,9,12653,6325,6328
50,12,113,Florida,Santa Rosa County,7,10,11209,5509,5700
50,12,113,Florida,Santa Rosa County,7,11,9626,4725,4901
50,12,113,Florida,Santa Rosa County,7,12,8434,4130,4304
50,12,113,Florida,Santa Rosa County,7,13,6959,3318,3641
50,12,113,Florida,Santa Rosa County,7,14,5534,2718,2816
50,12,113,Florida,Santa Rosa County,7,15,4220,2081,2139
50,12,113,Florida,Santa Rosa County,7,16,3203,1510,1693
50,12,113,Florida,Santa Rosa County,7,17,2017,899,1118
50,12,113,Florida,Santa Rosa County,7,18,1271,414,857
50,12,113,Florida,Santa Rosa County,8,0,142364,71026,71338
50,12,113,Florida,Santa Rosa County,8,1,8698,4466,4232
50,12,113,Florida,Santa Rosa County,8,2,9589,4896,4693
50,12,113,Florida,Santa Rosa County,8,3,10504,5460,5044
50,12,113,Florida,Santa Rosa County,8,4,10251,5428,4823
50,12,113,Florida,Santa Rosa County,8,5,8162,4248,3914
50,12,113,Florida,Santa Rosa County,8,6,8427,4241,4186
50,12,113,Florida,Santa Rosa County,8,7,9175,4584,4591
50,12,113,Florida,Santa Rosa County,8,8,10112,4997,5115
50,12,113,Florida,Santa Rosa County,8,9,12794,6357,6437
50,12,113,Florida,Santa Rosa County,8,10,11805,5827,5978
50,12,113,Florida,Santa Rosa County,8,11,10017,4849,5168
50,12,113,Florida,Santa Rosa County,8,12,9008,4402,4606
50,12,113,Florida,Santa Rosa County,8,13,7250,3460,3790
50,12,113,Florida,Santa Rosa County,8,14,5625,2782,2843
50,12,113,Florida,Santa Rosa County,8,15,4353,2123,2230
50,12,113,Florida,Santa Rosa County,8,16,3222,1525,1697
50,12,113,Florida,Santa Rosa County,8,17,2010,899,1111
50,12,113,Florida,Santa Rosa County,8,18,1362,482,880
50,12,113,Florida,Santa Rosa County,9,0,144279,72151,72128
50,12,113,Florida,Santa Rosa County,9,1,8768,4498,4270
50,12,113,Florida,Santa Rosa County,9,2,9795,4977,4818
50,12,113,Florida,Santa Rosa County,9,3,10292,5357,4935
50,12,113,Florida,Santa Rosa County,9,4,10341,5469,4872
50,12,113,Florida,Santa Rosa County,9,5,8438,4467,3971
50,12,113,Florida,Santa Rosa County,9,6,9021,4566,4455
50,12,113,Florida,Santa Rosa County,9,7,9038,4579,4459
50,12,113,Florida,Santa Rosa County,9,8,10207,5073,5134
50,12,113,Florida,Santa Rosa County,9,9,12389,6147,6242
50,12,113,Florida,Santa Rosa County,9,10,12320,6074,6246
50,12,113,Florida,Santa Rosa County,9,11,10384,5058,5326
50,12,113,Florida,Santa Rosa County,9,12,9289,4549,4740
50,12,113,Florida,Santa Rosa County,9,13,7261,3484,3777
50,12,113,Florida,Santa Rosa County,9,14,5692,2774,2918
50,12,113,Florida,Santa Rosa County,9,15,4246,2067,2179
50,12,113,Florida,Santa Rosa County,9,16,3276,1572,1704
50,12,113,Florida,Santa Rosa County,9,17,2062,926,1136
50,12,113,Florida,Santa Rosa County,9,18,1460,514,946
50,12,113,Florida,Santa Rosa County,10,0,147753,74333,73420
50,12,113,Florida,Santa Rosa County,10,1,9089,4679,4410
50,12,113,Florida,Santa Rosa County,10,2,9811,4967,4844
50,12,113,Florida,Santa Rosa County,10,3,10303,5399,4904
50,12,113,Florida,Santa Rosa County,10,4,10436,5481,4955
50,12,113,Florida,Santa Rosa County,10,5,9102,4894,4208
50,12,113,Florida,Santa Rosa County,10,6,9666,5004,4662
50,12,113,Florida,Santa Rosa County,10,7,9207,4764,4443
50,12,113,Florida,Santa Rosa County,10,8,10454,5267,5187
50,12,113,Florida,Santa Rosa County,10,9,11960,5955,6005
50,12,113,Florida,Santa Rosa County,10,10,12703,6296,6407
50,12,113,Florida,Santa Rosa County,10,11,10677,5201,5476
50,12,113,Florida,Santa Rosa County,10,12,9341,4588,4753
50,12,113,Florida,Santa Rosa County,10,13,7700,3718,3982
50,12,113,Florida,Santa Rosa County,10,14,5834,2792,3042
50,12,113,Florida,Santa Rosa County,10,15,4412,2141,2271
50,12,113,Florida,Santa Rosa County,10,16,3294,1606,1688
50,12,113,Florida,Santa Rosa County,10,17,2177,1001,1176
50,12,113,Florida,Santa Rosa County,10,18,1587,580,1007
50,12,113,Florida,Santa Rosa County,11,0,150356,75650,74706
50,12,113,Florida,Santa Rosa County,11,1,9256,4713,4543
50,12,113,Florida,Santa Rosa County,11,2,9725,5005,4720
50,12,113,Florida,Santa Rosa County,11,3,10433,5379,5054
50,12,113,Florida,Santa Rosa County,11,4,10491,5545,4946
50,12,113,Florida,Santa Rosa County,11,5,9298,4988,4310
50,12,113,Florida,Santa Rosa County,11,6,10239,5362,4877
50,12,113,Florida,Santa Rosa County,11,7,9371,4834,4537
50,12,113,Florida,Santa Rosa County,11,8,10577,5363,5214
50,12,113,Florida,Santa Rosa County,11,9,11466,5699,5767
50,12,113,Florida,Santa Rosa County,11,10,12926,6425,6501
50,12,113,Florida,Santa Rosa County,11,11,11022,5341,5681
50,12,113,Florida,Santa Rosa County,11,12,9338,4577,4761
50,12,113,Florida,Santa Rosa County,11,13,8066,3902,4164
50,12,113,Florida,Santa Rosa County,11,14,6191,2937,3254
50,12,113,Florida,Santa Rosa County,11,15,4597,2229,2368
50,12,113,Florida,Santa Rosa County,11,16,3331,1619,1712
50,12,113,Florida,Santa Rosa County,11,17,2299,1068,1231
50,12,113,Florida,Santa Rosa County,11,18,1730,664,1066
50,12,113,Florida,Santa Rosa County,12,0,151759,76297,75462
50,12,113,Florida,Santa Rosa County,12,1,9315,4773,4542
50,12,113,Florida,Santa Rosa County,12,2,9494,4862,4632
50,12,113,Florida,Santa Rosa County,12,3,10446,5388,5058
50,12,113,Florida,Santa Rosa County,12,4,10210,5368,4842
50,12,113,Florida,Santa Rosa County,12,5,9596,5130,4466
50,12,113,Florida,Santa Rosa County,12,6,10681,5665,5016
50,12,113,Florida,Santa Rosa County,12,7,9543,4892,4651
50,12,113,Florida,Santa Rosa County,12,8,10224,5179,5045
50,12,113,Florida,Santa Rosa County,12,9,11048,5503,5545
50,12,113,Florida,Santa Rosa County,12,10,13063,6495,6568
50,12,113,Florida,Santa Rosa County,12,11,11187,5430,5757
50,12,113,Florida,Santa Rosa County,12,12,9672,4698,4974
50,12,113,Florida,Santa Rosa County,12,13,8365,4054,4311
50,12,113,Florida,Santa Rosa County,12,14,6473,3056,3417
50,12,113,Florida,Santa Rosa County,12,15,4770,2303,2467
50,12,113,Florida,Santa Rosa County,12,16,3421,1647,1774
50,12,113,Florida,Santa Rosa County,12,17,2363,1108,1255
50,12,113,Florida,Santa Rosa County,12,18,1888,746,1142
50,12,115,Florida,Sarasota County,1,0,325957,154418,171539
50,12,115,Florida,Sarasota County,1,1,12797,6492,6305
50,12,115,Florida,Sarasota County,1,2,14867,7659,7208
50,12,115,Florida,Sarasota County,1,3,16021,8255,7766
50,12,115,Florida,Sarasota County,1,4,14343,7449,6894
50,12,115,Florida,Sarasota County,1,5,11190,5854,5336
50,12,115,Florida,Sarasota County,1,6,13182,6673,6509
50,12,115,Florida,Sarasota County,1,7,15987,8016,7971
50,12,115,Florida,Sarasota County,1,8,19877,9820,10057
50,12,115,Florida,Sarasota County,1,9,21639,10552,11087
50,12,115,Florida,Sarasota County,1,10,21116,10007,11109
50,12,115,Florida,Sarasota County,1,11,20691,9603,11088
50,12,115,Florida,Sarasota County,1,12,20537,9146,11391
50,12,115,Florida,Sarasota County,1,13,21127,9475,11652
50,12,115,Florida,Sarasota County,1,14,23463,10946,12517
50,12,115,Florida,Sarasota County,1,15,26117,12037,14080
50,12,115,Florida,Sarasota County,1,16,23842,10775,13067
50,12,115,Florida,Sarasota County,1,17,15981,7004,8977
50,12,115,Florida,Sarasota County,1,18,13180,4655,8525
50,12,115,Florida,Sarasota County,2,0,325966,154421,171545
50,12,115,Florida,Sarasota County,2,1,12797,6492,6305
50,12,115,Florida,Sarasota County,2,2,14868,7659,7209
50,12,115,Florida,Sarasota County,2,3,16021,8255,7766
50,12,115,Florida,Sarasota County,2,4,14343,7449,6894
50,12,115,Florida,Sarasota County,2,5,11190,5854,5336
50,12,115,Florida,Sarasota County,2,6,13182,6673,6509
50,12,115,Florida,Sarasota County,2,7,15988,8016,7972
50,12,115,Florida,Sarasota County,2,8,19877,9820,10057
50,12,115,Florida,Sarasota County,2,9,21640,10552,11088
50,12,115,Florida,Sarasota County,2,10,21117,10008,11109
50,12,115,Florida,Sarasota County,2,11,20692,9604,11088
50,12,115,Florida,Sarasota County,2,12,20537,9146,11391
50,12,115,Florida,Sarasota County,2,13,21127,9475,11652
50,12,115,Florida,Sarasota County,2,14,23465,10947,12518
50,12,115,Florida,Sarasota County,2,15,26117,12037,14080
50,12,115,Florida,Sarasota County,2,16,23843,10775,13068
50,12,115,Florida,Sarasota County,2,17,15982,7004,8978
50,12,115,Florida,Sarasota County,2,18,13180,4655,8525
50,12,115,Florida,Sarasota County,3,0,327041,154995,172046
50,12,115,Florida,Sarasota County,3,1,12834,6510,6324
50,12,115,Florida,Sarasota County,3,2,14832,7641,7191
50,12,115,Florida,Sarasota County,3,3,16105,8297,7808
50,12,115,Florida,Sarasota County,3,4,14405,7484,6921
50,12,115,Florida,Sarasota County,3,5,11322,5927,5395
50,12,115,Florida,Sarasota County,3,6,13123,6646,6477
50,12,115,Florida,Sarasota County,3,7,16019,8033,7986
50,12,115,Florida,Sarasota County,3,8,19841,9803,10038
50,12,115,Florida,Sarasota County,3,9,21730,10594,11136
50,12,115,Florida,Sarasota County,3,10,21288,10090,11198
50,12,115,Florida,Sarasota County,3,11,20955,9730,11225
50,12,115,Florida,Sarasota County,3,12,20704,9225,11479
50,12,115,Florida,Sarasota County,3,13,21248,9533,11715
50,12,115,Florida,Sarasota County,3,14,23340,10892,12448
50,12,115,Florida,Sarasota County,3,15,26048,12022,14026
50,12,115,Florida,Sarasota County,3,16,23867,10797,13070
50,12,115,Florida,Sarasota County,3,17,16101,7071,9030
50,12,115,Florida,Sarasota County,3,18,13279,4700,8579
50,12,115,Florida,Sarasota County,4,0,332874,158185,174689
50,12,115,Florida,Sarasota County,4,1,13291,6754,6537
50,12,115,Florida,Sarasota County,4,2,14844,7647,7197
50,12,115,Florida,Sarasota County,4,3,16726,8572,8154
50,12,115,Florida,Sarasota County,4,4,14971,7829,7142
50,12,115,Florida,Sarasota County,4,5,12171,6339,5832
50,12,115,Florida,Sarasota County,4,6,12781,6575,6206
50,12,115,Florida,Sarasota County,4,7,16456,8198,8258
50,12,115,Florida,Sarasota County,4,8,19709,9774,9935
50,12,115,Florida,Sarasota County,4,9,22092,10790,11302
50,12,115,Florida,Sarasota County,4,10,21931,10412,11519
50,12,115,Florida,Sarasota County,4,11,22214,10367,11847
50,12,115,Florida,Sarasota County,4,12,21319,9568,11751
50,12,115,Florida,Sarasota County,4,13,21678,9707,11971
50,12,115,Florida,Sarasota County,4,14,23000,10708,12292
50,12,115,Florida,Sarasota County,4,15,25411,11721,13690
50,12,115,Florida,Sarasota County,4,16,23629,10776,12853
50,12,115,Florida,Sarasota County,4,17,16976,7500,9476
50,12,115,Florida,Sarasota County,4,18,13675,4948,8727
50,12,115,Florida,Sarasota County,5,0,338940,161377,177563
50,12,115,Florida,Sarasota County,5,1,13786,7040,6746
50,12,115,Florida,Sarasota County,5,2,14933,7675,7258
50,12,115,Florida,Sarasota County,5,3,17139,8786,8353
50,12,115,Florida,Sarasota County,5,4,15568,8074,7494
50,12,115,Florida,Sarasota County,5,5,12915,6770,6145
50,12,115,Florida,Sarasota County,5,6,12833,6598,6235
50,12,115,Florida,Sarasota County,5,7,16389,8255,8134
50,12,115,Florida,Sarasota County,5,8,19616,9723,9893
50,12,115,Florida,Sarasota County,5,9,22373,10984,11389
50,12,115,Florida,Sarasota County,5,10,22598,10705,11893
50,12,115,Florida,Sarasota County,5,11,22261,10404,11857
50,12,115,Florida,Sarasota County,5,12,22976,10415,12561
50,12,115,Florida,Sarasota County,5,13,22457,10077,12380
50,12,115,Florida,Sarasota County,5,14,22949,10628,12321
50,12,115,Florida,Sarasota County,5,15,24829,11507,13322
50,12,115,Florida,Sarasota County,5,16,23570,10809,12761
50,12,115,Florida,Sarasota County,5,17,17535,7732,9803
50,12,115,Florida,Sarasota County,5,18,14213,5195,9018
50,12,115,Florida,Sarasota County,6,0,345161,164823,180338
50,12,115,Florida,Sarasota County,6,1,14438,7407,7031
50,12,115,Florida,Sarasota County,6,2,14915,7643,7272
50,12,115,Florida,Sarasota County,6,3,17381,8931,8450
50,12,115,Florida,Sarasota County,6,4,15996,8260,7736
50,12,115,Florida,Sarasota County,6,5,13789,7300,6489
50,12,115,Florida,Sarasota County,6,6,13213,6887,6326
50,12,115,Florida,Sarasota County,6,7,16283,8215,8068
50,12,115,Florida,Sarasota County,6,8,19210,9562,9648
50,12,115,Florida,Sarasota County,6,9,22620,11123,11497
50,12,115,Florida,Sarasota County,6,10,23039,11015,12024
50,12,115,Florida,Sarasota County,6,11,22771,10651,12120
50,12,115,Florida,Sarasota County,6,12,23745,10839,12906
50,12,115,Florida,Sarasota County,6,13,23749,10686,13063
50,12,115,Florida,Sarasota County,6,14,23026,10549,12477
50,12,115,Florida,Sarasota County,6,15,24308,11253,13055
50,12,115,Florida,Sarasota County,6,16,23660,10904,12756
50,12,115,Florida,Sarasota County,6,17,18085,8033,10052
50,12,115,Florida,Sarasota County,6,18,14933,5565,9368
50,12,115,Florida,Sarasota County,7,0,354095,169506,184589
50,12,115,Florida,Sarasota County,7,1,15260,7852,7408
50,12,115,Florida,Sarasota County,7,2,15163,7752,7411
50,12,115,Florida,Sarasota County,7,3,17610,9009,8601
50,12,115,Florida,Sarasota County,7,4,16785,8691,8094
50,12,115,Florida,Sarasota County,7,5,14649,7730,6919
50,12,115,Florida,Sarasota County,7,6,13960,7377,6583
50,12,115,Florida,Sarasota County,7,7,16298,8260,8038
50,12,115,Florida,Sarasota County,7,8,19093,9554,9539
50,12,115,Florida,Sarasota County,7,9,22980,11312,11668
50,12,115,Florida,Sarasota County,7,10,23603,11356,12247
50,12,115,Florida,Sarasota County,7,11,23436,10966,12470
50,12,115,Florida,Sarasota County,7,12,24664,11292,13372
50,12,115,Florida,Sarasota County,7,13,25002,11285,13717
50,12,115,Florida,Sarasota County,7,14,23713,10821,12892
50,12,115,Florida,Sarasota County,7,15,23637,11047,12590
50,12,115,Florida,Sarasota County,7,16,23726,10907,12819
50,12,115,Florida,Sarasota County,7,17,18743,8310,10433
50,12,115,Florida,Sarasota County,7,18,15773,5985,9788
50,12,115,Florida,Sarasota County,8,0,363146,174223,188923
50,12,115,Florida,Sarasota County,8,1,15651,8061,7590
50,12,115,Florida,Sarasota County,8,2,15687,7960,7727
50,12,115,Florida,Sarasota County,8,3,17790,9165,8625
50,12,115,Florida,Sarasota County,8,4,17552,9040,8512
50,12,115,Florida,Sarasota County,8,5,15210,7988,7222
50,12,115,Florida,Sarasota County,8,6,14982,7975,7007
50,12,115,Florida,Sarasota County,8,7,16113,8197,7916
50,12,115,Florida,Sarasota County,8,8,19291,9680,9611
50,12,115,Florida,Sarasota County,8,9,23160,11424,11736
50,12,115,Florida,Sarasota County,8,10,24465,11847,12618
50,12,115,Florida,Sarasota County,8,11,24413,11430,12983
50,12,115,Florida,Sarasota County,8,12,25828,11903,13925
50,12,115,Florida,Sarasota County,8,13,26216,11859,14357
50,12,115,Florida,Sarasota County,8,14,24172,11088,13084
50,12,115,Florida,Sarasota County,8,15,23161,10845,12316
50,12,115,Florida,Sarasota County,8,16,23696,10874,12822
50,12,115,Florida,Sarasota County,8,17,19169,8486,10683
50,12,115,Florida,Sarasota County,8,18,16590,6401,10189
50,12,115,Florida,Sarasota County,9,0,365613,175743,189870
50,12,115,Florida,Sarasota County,9,1,15817,8182,7635
50,12,115,Florida,Sarasota County,9,2,15829,8041,7788
50,12,115,Florida,Sarasota County,9,3,17537,9038,8499
50,12,115,Florida,Sarasota County,9,4,17946,9199,8747
50,12,115,Florida,Sarasota County,9,5,15807,8360,7447
50,12,115,Florida,Sarasota County,9,6,15689,8316,7373
50,12,115,Florida,Sarasota County,9,7,15632,8063,7569
50,12,115,Florida,Sarasota County,9,8,19225,9600,9625
50,12,115,Florida,Sarasota County,9,9,22837,11311,11526
50,12,115,Florida,Sarasota County,9,10,24801,12037,12764
50,12,115,Florida,Sarasota County,9,11,24787,11651,13136
50,12,115,Florida,Sarasota County,9,12,26699,12360,14339
50,12,115,Florida,Sarasota County,9,13,26449,12000,14449
50,12,115,Florida,Sarasota County,9,14,24360,11176,13184
50,12,115,Florida,Sarasota County,9,15,22673,10591,12082
50,12,115,Florida,Sarasota County,9,16,22932,10467,12465
50,12,115,Florida,Sarasota County,9,17,18964,8478,10486
50,12,115,Florida,Sarasota County,9,18,17629,6873,10756
50,12,115,Florida,Sarasota County,10,0,368841,177608,191233
50,12,115,Florida,Sarasota County,10,1,16079,8317,7762
50,12,115,Florida,Sarasota County,10,2,16020,8174,7846
50,12,115,Florida,Sarasota County,10,3,17502,9015,8487
50,12,115,Florida,Sarasota County,10,4,18071,9260,8811
50,12,115,Florida,Sarasota County,10,5,16372,8584,7788
50,12,115,Florida,Sarasota County,10,6,16386,8789,7597
50,12,115,Florida,Sarasota County,10,7,15196,7841,7355
50,12,115,Florida,Sarasota County,10,8,19180,9685,9495
50,12,115,Florida,Sarasota County,10,9,22326,11074,11252
50,12,115,Florida,Sarasota County,10,10,25008,12200,12808
50,12,115,Florida,Sarasota County,10,11,25108,11807,13301
50,12,115,Florida,Sarasota County,10,12,26009,12055,13954
50,12,115,Florida,Sarasota County,10,13,27582,12584,14998
50,12,115,Florida,Sarasota County,10,14,25130,11495,13635
50,12,115,Florida,Sarasota County,10,15,22657,10507,12150
50,12,115,Florida,Sarasota County,10,16,22510,10338,12172
50,12,115,Florida,Sarasota County,10,17,19105,8602,10503
50,12,115,Florida,Sarasota County,10,18,18600,7281,11319
50,12,115,Florida,Sarasota County,11,0,369867,178169,191698
50,12,115,Florida,Sarasota County,11,1,16057,8255,7802
50,12,115,Florida,Sarasota County,11,2,16173,8285,7888
50,12,115,Florida,Sarasota County,11,3,17100,8786,8314
50,12,115,Florida,Sarasota County,11,4,17942,9212,8730
50,12,115,Florida,Sarasota County,11,5,16197,8438,7759
50,12,115,Florida,Sarasota County,11,6,16813,9041,7772
50,12,115,Florida,Sarasota County,11,7,15116,7877,7239
50,12,115,Florida,Sarasota County,11,8,18430,9295,9135
50,12,115,Florida,Sarasota County,11,9,21507,10707,10800
50,12,115,Florida,Sarasota County,11,10,24950,12198,12752
50,12,115,Florida,Sarasota County,11,11,25219,11956,13263
50,12,115,Florida,Sarasota County,11,12,25903,12019,13884
50,12,115,Florida,Sarasota County,11,13,27819,12758,15061
50,12,115,Florida,Sarasota County,11,14,26573,12136,14437
50,12,115,Florida,Sarasota County,11,15,23033,10568,12465
50,12,115,Florida,Sarasota County,11,16,22265,10203,12062
50,12,115,Florida,Sarasota County,11,17,19306,8717,10589
50,12,115,Florida,Sarasota County,11,18,19464,7718,11746
50,12,115,Florida,Sarasota County,12,0,369765,178221,191544
50,12,115,Florida,Sarasota County,12,1,15934,8191,7743
50,12,115,Florida,Sarasota County,12,2,16180,8313,7867
50,12,115,Florida,Sarasota County,12,3,16816,8623,8193
50,12,115,Florida,Sarasota County,12,4,17507,8970,8537
50,12,115,Florida,Sarasota County,12,5,16005,8358,7647
50,12,115,Florida,Sarasota County,12,6,17101,9158,7943
50,12,115,Florida,Sarasota County,12,7,15227,8039,7188
50,12,115,Florida,Sarasota County,12,8,17657,8937,8720
50,12,115,Florida,Sarasota County,12,9,20663,10335,10328
50,12,115,Florida,Sarasota County,12,10,24685,12077,12608
50,12,115,Florida,Sarasota County,12,11,25274,12049,13225
50,12,115,Florida,Sarasota County,12,12,25836,11976,13860
50,12,115,Florida,Sarasota County,12,13,28043,12873,15170
50,12,115,Florida,Sarasota County,12,14,27715,12647,15068
50,12,115,Florida,Sarasota County,12,15,23739,10843,12896
50,12,115,Florida,Sarasota County,12,16,21644,10017,11627
50,12,115,Florida,Sarasota County,12,17,19626,8823,10803
50,12,115,Florida,Sarasota County,12,18,20113,7992,12121
50,12,117,Florida,Seminole County,1,0,365196,178776,186420
50,12,117,Florida,Seminole County,1,1,23062,11993,11069
50,12,117,Florida,Seminole County,1,2,26208,13324,12884
50,12,117,Florida,Seminole County,1,3,27571,14126,13445
50,12,117,Florida,Seminole County,1,4,24802,12627,12175
50,12,117,Florida,Seminole County,1,5,21559,11057,10502
50,12,117,Florida,Seminole County,1,6,24257,12190,12067
50,12,117,Florida,Seminole County,1,7,27676,13785,13891
50,12,117,Florida,Seminole County,1,8,32450,15959,16491
50,12,117,Florida,Seminole County,1,9,32509,15815,16694
50,12,117,Florida,Seminole County,1,10,28879,13823,15056
50,12,117,Florida,Seminole County,1,11,25757,12607,13150
50,12,117,Florida,Seminole County,1,12,18385,8918,9467
50,12,117,Florida,Seminole County,1,13,13228,6312,6916
50,12,117,Florida,Seminole County,1,14,11423,5224,6199
50,12,117,Florida,Seminole County,1,15,9969,4368,5601
50,12,117,Florida,Seminole County,1,16,8297,3433,4864
50,12,117,Florida,Seminole County,1,17,5171,1985,3186
50,12,117,Florida,Seminole County,1,18,3993,1230,2763
50,12,117,Florida,Seminole County,2,0,365202,178779,186423
50,12,117,Florida,Seminole County,2,1,23064,11994,11070
50,12,117,Florida,Seminole County,2,2,26208,13324,12884
50,12,117,Florida,Seminole County,2,3,27571,14126,13445
50,12,117,Florida,Seminole County,2,4,24802,12627,12175
50,12,117,Florida,Seminole County,2,5,21562,11058,10504
50,12,117,Florida,Seminole County,2,6,24258,12191,12067
50,12,117,Florida,Seminole County,2,7,27676,13785,13891
50,12,117,Florida,Seminole County,2,8,32450,15959,16491
50,12,117,Florida,Seminole County,2,9,32509,15815,16694
50,12,117,Florida,Seminole County,2,10,28879,13823,15056
50,12,117,Florida,Seminole County,2,11,25757,12607,13150
50,12,117,Florida,Seminole County,2,12,18385,8918,9467
50,12,117,Florida,Seminole County,2,13,13228,6312,6916
50,12,117,Florida,Seminole County,2,14,11423,5224,6199
50,12,117,Florida,Seminole County,2,15,9969,4368,5601
50,12,117,Florida,Seminole County,2,16,8297,3433,4864
50,12,117,Florida,Seminole County,2,17,5171,1985,3186
50,12,117,Florida,Seminole County,2,18,3993,1230,2763
50,12,117,Florida,Seminole County,3,0,367089,179735,187354
50,12,117,Florida,Seminole County,3,1,23152,12037,11115
50,12,117,Florida,Seminole County,3,2,26181,13311,12870
50,12,117,Florida,Seminole County,3,3,27769,14229,13540
50,12,117,Florida,Seminole County,3,4,24924,12693,12231
50,12,117,Florida,Seminole County,3,5,21829,11203,10626
50,12,117,Florida,Seminole County,3,6,24188,12156,12032
50,12,117,Florida,Seminole County,3,7,27771,13833,13938
50,12,117,Florida,Seminole County,3,8,32441,15956,16485
50,12,117,Florida,Seminole County,3,9,32703,15910,16793
50,12,117,Florida,Seminole County,3,10,29141,13949,15192
50,12,117,Florida,Seminole County,3,11,26104,12781,13323
50,12,117,Florida,Seminole County,3,12,18549,8998,9551
50,12,117,Florida,Seminole County,3,13,13325,6361,6964
50,12,117,Florida,Seminole County,3,14,11423,5227,6196
50,12,117,Florida,Seminole County,3,15,9987,4384,5603
50,12,117,Florida,Seminole County,3,16,8340,3454,4886
50,12,117,Florida,Seminole County,3,17,5228,2009,3219
50,12,117,Florida,Seminole County,3,18,4034,1244,2790
50,12,117,Florida,Seminole County,4,0,373723,183107,190616
50,12,117,Florida,Seminole County,4,1,23394,12091,11303
50,12,117,Florida,Seminole County,4,2,26265,13428,12837
50,12,117,Florida,Seminole County,4,3,28133,14465,13668
50,12,117,Florida,Seminole County,4,4,25260,12891,12369
50,12,117,Florida,Seminole County,4,5,23490,11927,11563
50,12,117,Florida,Seminole County,4,6,23546,11905,11641
50,12,117,Florida,Seminole County,4,7,28204,14087,14117
50,12,117,Florida,Seminole County,4,8,31821,15602,16219
50,12,117,Florida,Seminole County,4,9,33582,16458,17124
50,12,117,Florida,Seminole County,4,10,29906,14313,15593
50,12,117,Florida,Seminole County,4,11,27159,13145,14014
50,12,117,Florida,Seminole County,4,12,19281,9430,9851
50,12,117,Florida,Seminole County,4,13,13834,6648,7186
50,12,117,Florida,Seminole County,4,14,11344,5182,6162
50,12,117,Florida,Seminole County,4,15,10182,4539,5643
50,12,117,Florida,Seminole County,4,16,8436,3477,4959
50,12,117,Florida,Seminole County,4,17,5672,2225,3447
50,12,117,Florida,Seminole County,4,18,4214,1294,2920
50,12,117,Florida,Seminole County,5,0,381313,186926,194387
50,12,117,Florida,Seminole County,5,1,23637,12168,11469
50,12,117,Florida,Seminole County,5,2,26401,13595,12806
50,12,117,Florida,Seminole County,5,3,28913,14837,14076
50,12,117,Florida,Seminole County,5,4,25597,13115,12482
50,12,117,Florida,Seminole County,5,5,24885,12510,12375
50,12,117,Florida,Seminole County,5,6,24179,12313,11866
50,12,117,Florida,Seminole County,5,7,28087,14025,14062
50,12,117,Florida,Seminole County,5,8,31394,15411,15983
50,12,117,Florida,Seminole County,5,9,34027,16666,17361
50,12,117,Florida,Seminole County,5,10,30992,14935,16057
50,12,117,Florida,Seminole County,5,11,26970,12876,14094
50,12,117,Florida,Seminole County,5,12,21217,10448,10769
50,12,117,Florida,Seminole County,5,13,14407,6867,7540
50,12,117,Florida,Seminole County,5,14,11367,5219,6148
50,12,117,Florida,Seminole County,5,15,10284,4644,5640
50,12,117,Florida,Seminole County,5,16,8488,3536,4952
50,12,117,Florida,Seminole County,5,17,6000,2367,3633
50,12,117,Florida,Seminole County,5,18,4468,1394,3074
50,12,117,Florida,Seminole County,6,0,385706,189378,196328
50,12,117,Florida,Seminole County,6,1,23807,12228,11579
50,12,117,Florida,Seminole County,6,2,26350,13633,12717
50,12,117,Florida,Seminole County,6,3,28955,14842,14113
50,12,117,Florida,Seminole County,6,4,26025,13303,12722
50,12,117,Florida,Seminole County,6,5,25955,13127,12828
50,12,117,Florida,Seminole County,6,6,25097,12869,12228
50,12,117,Florida,Seminole County,6,7,27697,13876,13821
50,12,117,Florida,Seminole County,6,8,30479,15001,15478
50,12,117,Florida,Seminole County,6,9,34017,16660,17357
50,12,117,Florida,Seminole County,6,10,31664,15278,16386
50,12,117,Florida,Seminole County,6,11,27208,12929,14279
50,12,117,Florida,Seminole County,6,12,22055,10859,11196
50,12,117,Florida,Seminole County,6,13,15235,7294,7941
50,12,117,Florida,Seminole County,6,14,11202,5177,6025
50,12,117,Florida,Seminole County,6,15,10251,4635,5616
50,12,117,Florida,Seminole County,6,16,8685,3650,5035
50,12,117,Florida,Seminole County,6,17,6279,2511,3768
50,12,117,Florida,Seminole County,6,18,4745,1506,3239
50,12,117,Florida,Seminole County,7,0,392099,192707,199392
50,12,117,Florida,Seminole County,7,1,23933,12271,11662
50,12,117,Florida,Seminole County,7,2,26608,13767,12841
50,12,117,Florida,Seminole County,7,3,29126,14931,14195
50,12,117,Florida,Seminole County,7,4,26911,13841,13070
50,12,117,Florida,Seminole County,7,5,26369,13342,13027
50,12,117,Florida,Seminole County,7,6,26507,13595,12912
50,12,117,Florida,Seminole County,7,7,27035,13550,13485
50,12,117,Florida,Seminole County,7,8,29809,14757,15052
50,12,117,Florida,Seminole County,7,9,34425,16855,17570
50,12,117,Florida,Seminole County,7,10,32401,15613,16788
50,12,117,Florida,Seminole County,7,11,27459,13079,14380
50,12,117,Florida,Seminole County,7,12,23439,11458,11981
50,12,117,Florida,Seminole County,7,13,15998,7708,8290
50,12,117,Florida,Seminole County,7,14,11402,5287,6115
50,12,117,Florida,Seminole County,7,15,10270,4676,5594
50,12,117,Florida,Seminole County,7,16,8721,3656,5065
50,12,117,Florida,Seminole County,7,17,6576,2625,3951
50,12,117,Florida,Seminole County,7,18,5110,1696,3414
50,12,117,Florida,Seminole County,8,0,402834,198190,204644
50,12,117,Florida,Seminole County,8,1,24528,12582,11946
50,12,117,Florida,Seminole County,8,2,26925,13986,12939
50,12,117,Florida,Seminole County,8,3,29606,15072,14534
50,12,117,Florida,Seminole County,8,4,27872,14373,13499
50,12,117,Florida,Seminole County,8,5,26959,13621,13338
50,12,117,Florida,Seminole County,8,6,28842,14849,13993
50,12,117,Florida,Seminole County,8,7,26917,13500,13417
50,12,117,Florida,Seminole County,8,8,30105,14921,15184
50,12,117,Florida,Seminole County,8,9,34566,16998,17568
50,12,117,Florida,Seminole County,8,10,33511,16210,17301
50,12,117,Florida,Seminole County,8,11,28237,13388,14849
50,12,117,Florida,Seminole County,8,12,24728,12032,12696
50,12,117,Florida,Seminole County,8,13,16807,8098,8709
50,12,117,Florida,Seminole County,8,14,11677,5507,6170
50,12,117,Florida,Seminole County,8,15,10301,4625,5676
50,12,117,Florida,Seminole County,8,16,8890,3832,5058
50,12,117,Florida,Seminole County,8,17,6896,2756,4140
50,12,117,Florida,Seminole County,8,18,5467,1840,3627
50,12,117,Florida,Seminole County,9,0,408464,201097,207367
50,12,117,Florida,Seminole County,9,1,24498,12545,11953
50,12,117,Florida,Seminole County,9,2,27194,14049,13145
50,12,117,Florida,Seminole County,9,3,29601,15145,14456
50,12,117,Florida,Seminole County,9,4,28637,14797,13840
50,12,117,Florida,Seminole County,9,5,27384,13891,13493
50,12,117,Florida,Seminole County,9,6,30550,15559,14991
50,12,117,Florida,Seminole County,9,7,26218,13244,12974
50,12,117,Florida,Seminole County,9,8,30409,15108,15301
50,12,117,Florida,Seminole County,9,9,33647,16524,17123
50,12,117,Florida,Seminole County,9,10,34254,16698,17556
50,12,117,Florida,Seminole County,9,11,29048,13773,15275
50,12,117,Florida,Seminole County,9,12,25681,12367,13314
50,12,117,Florida,Seminole County,9,13,17407,8440,8967
50,12,117,Florida,Seminole County,9,14,12088,5748,6340
50,12,117,Florida,Seminole County,9,15,10052,4509,5543
50,12,117,Florida,Seminole County,9,16,9003,3924,5079
50,12,117,Florida,Seminole County,9,17,6898,2746,4152
50,12,117,Florida,Seminole County,9,18,5895,2030,3865
50,12,117,Florida,Seminole County,10,0,408308,201196,207112
50,12,117,Florida,Seminole County,10,1,24039,12302,11737
50,12,117,Florida,Seminole County,10,2,26374,13584,12790
50,12,117,Florida,Seminole County,10,3,28875,14883,13992
50,12,117,Florida,Seminole County,10,4,28736,14820,13916
50,12,117,Florida,Seminole County,10,5,27584,14061,13523
50,12,117,Florida,Seminole County,10,6,30712,15581,15131
50,12,117,Florida,Seminole County,10,7,26286,13390,12896
50,12,117,Florida,Seminole County,10,8,29599,14716,14883
50,12,117,Florida,Seminole County,10,9,32658,16076,16582
50,12,117,Florida,Seminole County,10,10,34246,16668,17578
50,12,117,Florida,Seminole County,10,11,29816,14244,15572
50,12,117,Florida,Seminole County,10,12,25420,12093,13327
50,12,117,Florida,Seminole County,10,13,19059,9325,9734
50,12,117,Florida,Seminole County,10,14,12570,5903,6667
50,12,117,Florida,Seminole County,10,15,10069,4554,5515
50,12,117,Florida,Seminole County,10,16,8977,3954,5023
50,12,117,Florida,Seminole County,10,17,7020,2854,4166
50,12,117,Florida,Seminole County,10,18,6268,2188,4080
50,12,117,Florida,Seminole County,11,0,410658,202278,208380
50,12,117,Florida,Seminole County,11,1,23988,12269,11719
50,12,117,Florida,Seminole County,11,2,25915,13317,12598
50,12,117,Florida,Seminole County,11,3,28501,14768,13733
50,12,117,Florida,Seminole County,11,4,28641,14726,13915
50,12,117,Florida,Seminole County,11,5,27685,14004,13681
50,12,117,Florida,Seminole County,11,6,31086,15799,15287
50,12,117,Florida,Seminole County,11,7,26688,13638,13050
50,12,117,Florida,Seminole County,11,8,28941,14411,14530
50,12,117,Florida,Seminole County,11,9,31601,15599,16002
50,12,117,Florida,Seminole County,11,10,34338,16722,17616
50,12,117,Florida,Seminole County,11,11,30521,14588,15933
50,12,117,Florida,Seminole County,11,12,25764,12186,13578
50,12,117,Florida,Seminole County,11,13,20287,9933,10354
50,12,117,Florida,Seminole County,11,14,13528,6376,7152
50,12,117,Florida,Seminole County,11,15,10102,4588,5514
50,12,117,Florida,Seminole County,11,16,9108,4012,5096
50,12,117,Florida,Seminole County,11,17,7221,2950,4271
50,12,117,Florida,Seminole County,11,18,6743,2392,4351
50,12,117,Florida,Seminole County,12,0,413204,203516,209688
50,12,117,Florida,Seminole County,12,1,24122,12331,11791
50,12,117,Florida,Seminole County,12,2,25489,13084,12405
50,12,117,Florida,Seminole County,12,3,28078,14561,13517
50,12,117,Florida,Seminole County,12,4,28517,14656,13861
50,12,117,Florida,Seminole County,12,5,27903,14192,13711
50,12,117,Florida,Seminole County,12,6,31063,15732,15331
50,12,117,Florida,Seminole County,12,7,27502,14052,13450
50,12,117,Florida,Seminole County,12,8,28137,14026,14111
50,12,117,Florida,Seminole County,12,9,30668,15230,15438
50,12,117,Florida,Seminole County,12,10,34335,16715,17620
50,12,117,Florida,Seminole County,12,11,31227,14905,16322
50,12,117,Florida,Seminole County,12,12,26213,12404,13809
50,12,117,Florida,Seminole County,12,13,21638,10497,11141
50,12,117,Florida,Seminole County,12,14,14366,6837,7529
50,12,117,Florida,Seminole County,12,15,10236,4662,5574
50,12,117,Florida,Seminole County,12,16,9143,4049,5094
50,12,117,Florida,Seminole County,12,17,7239,2948,4291
50,12,117,Florida,Seminole County,12,18,7328,2635,4693
50,12,119,Florida,Sumter County,1,0,53345,28312,25033
50,12,119,Florida,Sumter County,1,1,2108,1115,993
50,12,119,Florida,Sumter County,1,2,2423,1221,1202
50,12,119,Florida,Sumter County,1,3,2463,1293,1170
50,12,119,Florida,Sumter County,1,4,2467,1316,1151
50,12,119,Florida,Sumter County,1,5,2280,1391,889
50,12,119,Florida,Sumter County,1,6,2792,1803,989
50,12,119,Florida,Sumter County,1,7,2929,1893,1036
50,12,119,Florida,Sumter County,1,8,3447,2112,1335
50,12,119,Florida,Sumter County,1,9,3245,1806,1439
50,12,119,Florida,Sumter County,1,10,2942,1654,1288
50,12,119,Florida,Sumter County,1,11,3065,1547,1518
50,12,119,Florida,Sumter County,1,12,3686,1669,2017
50,12,119,Florida,Sumter County,1,13,4880,2347,2533
50,12,119,Florida,Sumter County,1,14,5319,2666,2653
50,12,119,Florida,Sumter County,1,15,4162,2126,2036
50,12,119,Florida,Sumter County,1,16,2785,1358,1427
50,12,119,Florida,Sumter County,1,17,1481,708,773
50,12,119,Florida,Sumter County,1,18,871,287,584
50,12,119,Florida,Sumter County,2,0,53348,28314,25034
50,12,119,Florida,Sumter County,2,1,2108,1115,993
50,12,119,Florida,Sumter County,2,2,2423,1221,1202
50,12,119,Florida,Sumter County,2,3,2463,1293,1170
50,12,119,Florida,Sumter County,2,4,2467,1316,1151
50,12,119,Florida,Sumter County,2,5,2280,1391,889
50,12,119,Florida,Sumter County,2,6,2792,1803,989
50,12,119,Florida,Sumter County,2,7,2929,1893,1036
50,12,119,Florida,Sumter County,2,8,3447,2112,1335
50,12,119,Florida,Sumter County,2,9,3245,1806,1439
50,12,119,Florida,Sumter County,2,10,2942,1654,1288
50,12,119,Florida,Sumter County,2,11,3065,1547,1518
50,12,119,Florida,Sumter County,2,12,3686,1669,2017
50,12,119,Florida,Sumter County,2,13,4880,2347,2533
50,12,119,Florida,Sumter County,2,14,5321,2667,2654
50,12,119,Florida,Sumter County,2,15,4163,2127,2036
50,12,119,Florida,Sumter County,2,16,2785,1358,1427
50,12,119,Florida,Sumter County,2,17,1481,708,773
50,12,119,Florida,Sumter County,2,18,871,287,584
50,12,119,Florida,Sumter County,3,0,53554,28415,25139
50,12,119,Florida,Sumter County,3,1,2117,1119,998
50,12,119,Florida,Sumter County,3,2,2421,1220,1201
50,12,119,Florida,Sumter County,3,3,2483,1303,1180
50,12,119,Florida,Sumter County,3,4,2481,1323,1158
50,12,119,Florida,Sumter County,3,5,2304,1403,901
50,12,119,Florida,Sumter County,3,6,2785,1800,985
50,12,119,Florida,Sumter County,3,7,2932,1894,1038
50,12,119,Florida,Sumter County,3,8,3448,2112,1336
50,12,119,Florida,Sumter County,3,9,3257,1811,1446
50,12,119,Florida,Sumter County,3,10,2964,1665,1299
50,12,119,Florida,Sumter County,3,11,3104,1565,1539
50,12,119,Florida,Sumter County,3,12,3718,1683,2035
50,12,119,Florida,Sumter County,3,13,4909,2361,2548
50,12,119,Florida,Sumter County,3,14,5307,2660,2647
50,12,119,Florida,Sumter County,3,15,4159,2127,2032
50,12,119,Florida,Sumter County,3,16,2793,1363,1430
50,12,119,Florida,Sumter County,3,17,1494,716,778
50,12,119,Florida,Sumter County,3,18,878,290,588
50,12,119,Florida,Sumter County,4,0,54709,29218,25491
50,12,119,Florida,Sumter County,4,1,2158,1119,1039
50,12,119,Florida,Sumter County,4,2,2380,1193,1187
50,12,119,Florida,Sumter County,4,3,2519,1304,1215
50,12,119,Florida,Sumter County,4,4,2539,1399,1140
50,12,119,Florida,Sumter County,4,5,2476,1504,972
50,12,119,Florida,Sumter County,4,6,2854,1868,986
50,12,119,Florida,Sumter County,4,7,3021,1987,1034
50,12,119,Florida,Sumter County,4,8,3538,2218,1320
50,12,119,Florida,Sumter County,4,9,3409,1935,1474
50,12,119,Florida,Sumter County,4,10,3119,1765,1354
50,12,119,Florida,Sumter County,4,11,3235,1630,1605
50,12,119,Florida,Sumter County,4,12,3702,1718,1984
50,12,119,Florida,Sumter County,4,13,5017,2360,2657
50,12,119,Florida,Sumter County,4,14,5216,2592,2624
50,12,119,Florida,Sumter County,4,15,4213,2161,2052
50,12,119,Florida,Sumter County,4,16,2804,1383,1421
50,12,119,Florida,Sumter County,4,17,1596,769,827
50,12,119,Florida,Sumter County,4,18,913,313,600
50,12,119,Florida,Sumter County,5,0,57482,30998,26484
50,12,119,Florida,Sumter County,5,1,2282,1174,1108
50,12,119,Florida,Sumter County,5,2,2288,1161,1127
50,12,119,Florida,Sumter County,5,3,2644,1366,1278
50,12,119,Florida,Sumter County,5,4,2614,1438,1176
50,12,119,Florida,Sumter County,5,5,2713,1684,1029
50,12,119,Florida,Sumter County,5,6,3038,2046,992
50,12,119,Florida,Sumter County,5,7,3291,2180,1111
50,12,119,Florida,Sumter County,5,8,3724,2409,1315
50,12,119,Florida,Sumter County,5,9,3643,2127,1516
50,12,119,Florida,Sumter County,5,10,3397,1932,1465
50,12,119,Florida,Sumter County,5,11,3386,1733,1653
50,12,119,Florida,Sumter County,5,12,4267,2027,2240
50,12,119,Florida,Sumter County,5,13,5649,2644,3005
50,12,119,Florida,Sumter County,5,14,5109,2508,2601
50,12,119,Florida,Sumter County,5,15,4185,2153,2032
50,12,119,Florida,Sumter County,5,16,2798,1352,1446
50,12,119,Florida,Sumter County,5,17,1540,747,793
50,12,119,Florida,Sumter County,5,18,914,317,597
50,12,119,Florida,Sumter County,6,0,58797,31950,26847
50,12,119,Florida,Sumter County,6,1,2373,1206,1167
50,12,119,Florida,Sumter County,6,2,2327,1192,1135
50,12,119,Florida,Sumter County,6,3,2600,1324,1276
50,12,119,Florida,Sumter County,6,4,2582,1424,1158
50,12,119,Florida,Sumter County,6,5,2916,1863,1053
50,12,119,Florida,Sumter County,6,6,3307,2246,1061
50,12,119,Florida,Sumter County,6,7,3460,2309,1151
50,12,119,Florida,Sumter County,6,8,3785,2495,1290
50,12,119,Florida,Sumter County,6,9,3714,2198,1516
50,12,119,Florida,Sumter County,6,10,3595,2046,1549
50,12,119,Florida,Sumter County,6,11,3342,1753,1589
50,12,119,Florida,Sumter County,6,12,4367,2091,2276
50,12,119,Florida,Sumter County,6,13,5794,2704,3090
50,12,119,Florida,Sumter County,6,14,5231,2562,2669
50,12,119,Florida,Sumter County,6,15,4093,2078,2015
50,12,119,Florida,Sumter County,6,16,2824,1388,1436
50,12,119,Florida,Sumter County,6,17,1543,721,822
50,12,119,Florida,Sumter County,6,18,944,350,594
50,12,119,Florida,Sumter County,7,0,60069,32504,27565
50,12,119,Florida,Sumter County,7,1,2419,1223,1196
50,12,119,Florida,Sumter County,7,2,2322,1199,1123
50,12,119,Florida,Sumter County,7,3,2653,1339,1314
50,12,119,Florida,Sumter County,7,4,2663,1462,1201
50,12,119,Florida,Sumter County,7,5,3038,1907,1131
50,12,119,Florida,Sumter County,7,6,3321,2258,1063
50,12,119,Florida,Sumter County,7,7,3497,2313,1184
50,12,119,Florida,Sumter County,7,8,3718,2489,1229
50,12,119,Florida,Sumter County,7,9,3810,2247,1563
50,12,119,Florida,Sumter County,7,10,3677,2057,1620
50,12,119,Florida,Sumter County,7,11,3474,1810,1664
50,12,119,Florida,Sumter County,7,12,4545,2217,2328
50,12,119,Florida,Sumter County,7,13,6156,2830,3326
50,12,119,Florida,Sumter County,7,14,5478,2675,2803
50,12,119,Florida,Sumter County,7,15,4014,2016,1998
50,12,119,Florida,Sumter County,7,16,2838,1394,1444
50,12,119,Florida,Sumter County,7,17,1525,699,826
50,12,119,Florida,Sumter County,7,18,921,369,552
50,12,119,Florida,Sumter County,8,0,63405,34258,29147
50,12,119,Florida,Sumter County,8,1,2540,1265,1275
50,12,119,Florida,Sumter County,8,2,2395,1258,1137
50,12,119,Florida,Sumter County,8,3,2711,1357,1354
50,12,119,Florida,Sumter County,8,4,2743,1502,1241
50,12,119,Florida,Sumter County,8,5,3273,2062,1211
50,12,119,Florida,Sumter County,8,6,3585,2402,1183
50,12,119,Florida,Sumter County,8,7,3560,2350,1210
50,12,119,Florida,Sumter County,8,8,3788,2554,1234
50,12,119,Florida,Sumter County,8,9,3973,2363,1610
50,12,119,Florida,Sumter County,8,10,3884,2144,1740
50,12,119,Florida,Sumter County,8,11,3741,1974,1767
50,12,119,Florida,Sumter County,8,12,5266,2575,2691
50,12,119,Florida,Sumter County,8,13,7192,3333,3859
50,12,119,Florida,Sumter County,8,14,5746,2802,2944
50,12,119,Florida,Sumter County,8,15,3959,1961,1998
50,12,119,Florida,Sumter County,8,16,2692,1308,1384
50,12,119,Florida,Sumter County,8,17,1480,688,792
50,12,119,Florida,Sumter County,8,18,877,360,517
50,12,119,Florida,Sumter County,9,0,68577,37052,31525
50,12,119,Florida,Sumter County,9,1,2636,1351,1285
50,12,119,Florida,Sumter County,9,2,2537,1308,1229
50,12,119,Florida,Sumter County,9,3,2749,1374,1375
50,12,119,Florida,Sumter County,9,4,2844,1547,1297
50,12,119,Florida,Sumter County,9,5,3507,2250,1257
50,12,119,Florida,Sumter County,9,6,3893,2582,1311
50,12,119,Florida,Sumter County,9,7,3726,2457,1269
50,12,119,Florida,Sumter County,9,8,3968,2695,1273
50,12,119,Florida,Sumter County,9,9,4107,2480,1627
50,12,119,Florida,Sumter County,9,10,4105,2292,1813
50,12,119,Florida,Sumter County,9,11,4144,2179,1965
50,12,119,Florida,Sumter County,9,12,6316,3063,3253
50,12,119,Florida,Sumter County,9,13,8748,4122,4626
50,12,119,Florida,Sumter County,9,14,6427,3107,3320
50,12,119,Florida,Sumter County,9,15,3992,1976,2016
50,12,119,Florida,Sumter County,9,16,2635,1277,1358
50,12,119,Florida,Sumter County,9,17,1392,642,750
50,12,119,Florida,Sumter County,9,18,851,350,501
50,12,119,Florida,Sumter County,10,0,72711,39374,33337
50,12,119,Florida,Sumter County,10,1,2759,1416,1343
50,12,119,Florida,Sumter County,10,2,2668,1367,1301
50,12,119,Florida,Sumter County,10,3,2658,1341,1317
50,12,119,Florida,Sumter County,10,4,3052,1651,1401
50,12,119,Florida,Sumter County,10,5,3780,2416,1364
50,12,119,Florida,Sumter County,10,6,4147,2779,1368
50,12,119,Florida,Sumter County,10,7,3824,2559,1265
50,12,119,Florida,Sumter County,10,8,4259,2878,1381
50,12,119,Florida,Sumter County,10,9,4215,2586,1629
50,12,119,Florida,Sumter County,10,10,4428,2507,1921
50,12,119,Florida,Sumter County,10,11,4448,2334,2114
50,12,119,Florida,Sumter County,10,12,6662,3234,3428
50,12,119,Florida,Sumter County,10,13,10262,4877,5385
50,12,119,Florida,Sumter County,10,14,7031,3374,3657
50,12,119,Florida,Sumter County,10,15,3931,1923,2008
50,12,119,Florida,Sumter County,10,16,2471,1202,1269
50,12,119,Florida,Sumter County,10,17,1340,614,726
50,12,119,Florida,Sumter County,10,18,776,316,460
50,12,119,Florida,Sumter County,11,0,75219,40639,34580
50,12,119,Florida,Sumter County,11,1,2842,1452,1390
50,12,119,Florida,Sumter County,11,2,2745,1391,1354
50,12,119,Florida,Sumter County,11,3,2769,1411,1358
50,12,119,Florida,Sumter County,11,4,3057,1640,1417
50,12,119,Florida,Sumter County,11,5,3844,2433,1411
50,12,119,Florida,Sumter County,11,6,4418,2981,1437
50,12,119,Florida,Sumter County,11,7,4050,2698,1352
50,12,119,Florida,Sumter County,11,8,4372,2937,1435
50,12,119,Florida,Sumter County,11,9,4225,2600,1625
50,12,119,Florida,Sumter County,11,10,4503,2552,1951
50,12,119,Florida,Sumter County,11,11,4710,2452,2258
50,12,119,Florida,Sumter County,11,12,6693,3270,3423
50,12,119,Florida,Sumter County,11,13,11085,5257,5828
50,12,119,Florida,Sumter County,11,14,7798,3744,4054
50,12,119,Florida,Sumter County,11,15,3965,1928,2037
50,12,119,Florida,Sumter County,11,16,2234,1067,1167
50,12,119,Florida,Sumter County,11,17,1225,562,663
50,12,119,Florida,Sumter County,11,18,684,264,420
50,12,119,Florida,Sumter County,12,0,77681,41910,35771
50,12,119,Florida,Sumter County,12,1,2920,1507,1413
50,12,119,Florida,Sumter County,12,2,2898,1459,1439
50,12,119,Florida,Sumter County,12,3,2899,1488,1411
50,12,119,Florida,Sumter County,12,4,3154,1679,1475
50,12,119,Florida,Sumter County,12,5,3968,2510,1458
50,12,119,Florida,Sumter County,12,6,4600,3065,1535
50,12,119,Florida,Sumter County,12,7,4161,2781,1380
50,12,119,Florida,Sumter County,12,8,4556,3033,1523
50,12,119,Florida,Sumter County,12,9,4188,2631,1557
50,12,119,Florida,Sumter County,12,10,4697,2660,2037
50,12,119,Florida,Sumter County,12,11,4857,2506,2351
50,12,119,Florida,Sumter County,12,12,6708,3264,3444
50,12,119,Florida,Sumter County,12,13,11876,5678,6198
50,12,119,Florida,Sumter County,12,14,8368,3984,4384
50,12,119,Florida,Sumter County,12,15,4033,1955,2078
50,12,119,Florida,Sumter County,12,16,2086,985,1101
50,12,119,Florida,Sumter County,12,17,1119,508,611
50,12,119,Florida,Sumter County,12,18,593,217,376
50,12,121,Florida,Suwannee County,1,0,34844,17012,17832
50,12,121,Florida,Suwannee County,1,1,2099,1036,1063
50,12,121,Florida,Suwannee County,1,2,2315,1192,1123
50,12,121,Florida,Suwannee County,1,3,2358,1218,1140
50,12,121,Florida,Suwannee County,1,4,2622,1356,1266
50,12,121,Florida,Suwannee County,1,5,1938,1021,917
50,12,121,Florida,Suwannee County,1,6,1904,1007,897
50,12,121,Florida,Suwannee County,1,7,1974,981,993
50,12,121,Florida,Suwannee County,1,8,2354,1172,1182
50,12,121,Florida,Suwannee County,1,9,2512,1188,1324
50,12,121,Florida,Suwannee County,1,10,2360,1150,1210
50,12,121,Florida,Suwannee County,1,11,2390,1137,1253
50,12,121,Florida,Suwannee County,1,12,2088,1022,1066
50,12,121,Florida,Suwannee County,1,13,2025,1004,1021
50,12,121,Florida,Suwannee County,1,14,1698,810,888
50,12,121,Florida,Suwannee County,1,15,1566,698,868
50,12,121,Florida,Suwannee County,1,16,1178,532,646
50,12,121,Florida,Suwannee County,1,17,753,301,452
50,12,121,Florida,Suwannee County,1,18,710,187,523
50,12,121,Florida,Suwannee County,2,0,34847,17014,17833
50,12,121,Florida,Suwannee County,2,1,2099,1036,1063
50,12,121,Florida,Suwannee County,2,2,2315,1192,1123
50,12,121,Florida,Suwannee County,2,3,2358,1218,1140
50,12,121,Florida,Suwannee County,2,4,2622,1356,1266
50,12,121,Florida,Suwannee County,2,5,1938,1021,917
50,12,121,Florida,Suwannee County,2,6,1905,1008,897
50,12,121,Florida,Suwannee County,2,7,1974,981,993
50,12,121,Florida,Suwannee County,2,8,2354,1172,1182
50,12,121,Florida,Suwannee County,2,9,2512,1188,1324
50,12,121,Florida,Suwannee County,2,10,2360,1150,1210
50,12,121,Florida,Suwannee County,2,11,2390,1137,1253
50,12,121,Florida,Suwannee County,2,12,2090,1023,1067
50,12,121,Florida,Suwannee County,2,13,2025,1004,1021
50,12,121,Florida,Suwannee County,2,14,1698,810,888
50,12,121,Florida,Suwannee County,2,15,1566,698,868
50,12,121,Florida,Suwannee County,2,16,1178,532,646
50,12,121,Florida,Suwannee County,2,17,753,301,452
50,12,121,Florida,Suwannee County,2,18,710,187,523
50,12,121,Florida,Suwannee County,3,0,35024,17106,17918
50,12,121,Florida,Suwannee County,3,1,2108,1041,1067
50,12,121,Florida,Suwannee County,3,2,2310,1189,1121
50,12,121,Florida,Suwannee County,3,3,2374,1226,1148
50,12,121,Florida,Suwannee County,3,4,2635,1364,1271
50,12,121,Florida,Suwannee County,3,5,1968,1038,930
50,12,121,Florida,Suwannee County,3,6,1899,1006,893
50,12,121,Florida,Suwannee County,3,7,1977,982,995
50,12,121,Florida,Suwannee County,3,8,2353,1172,1181
50,12,121,Florida,Suwannee County,3,9,2526,1195,1331
50,12,121,Florida,Suwannee County,3,10,2380,1160,1220
50,12,121,Florida,Suwannee County,3,11,2421,1151,1270
50,12,121,Florida,Suwannee County,3,12,2105,1030,1075
50,12,121,Florida,Suwannee County,3,13,2038,1011,1027
50,12,121,Florida,Suwannee County,3,14,1701,813,888
50,12,121,Florida,Suwannee County,3,15,1569,700,869
50,12,121,Florida,Suwannee County,3,16,1184,535,649
50,12,121,Florida,Suwannee County,3,17,760,304,456
50,12,121,Florida,Suwannee County,3,18,716,189,527
50,12,121,Florida,Suwannee County,4,0,35539,17368,18171
50,12,121,Florida,Suwannee County,4,1,2232,1113,1119
50,12,121,Florida,Suwannee County,4,2,2201,1125,1076
50,12,121,Florida,Suwannee County,4,3,2450,1252,1198
50,12,121,Florida,Suwannee County,4,4,2514,1326,1188
50,12,121,Florida,Suwannee County,4,5,2120,1114,1006
50,12,121,Florida,Suwannee County,4,6,1977,1052,925
50,12,121,Florida,Suwannee County,4,7,1948,952,996
50,12,121,Florida,Suwannee County,4,8,2355,1171,1184
50,12,121,Florida,Suwannee County,4,9,2559,1260,1299
50,12,121,Florida,Suwannee County,4,10,2406,1131,1275
50,12,121,Florida,Suwannee County,4,11,2503,1215,1288
50,12,121,Florida,Suwannee County,4,12,2145,1040,1105
50,12,121,Florida,Suwannee County,4,13,2036,998,1038
50,12,121,Florida,Suwannee County,4,14,1797,853,944
50,12,121,Florida,Suwannee County,4,15,1528,664,864
50,12,121,Florida,Suwannee County,4,16,1230,579,651
50,12,121,Florida,Suwannee County,4,17,812,322,490
50,12,121,Florida,Suwannee County,4,18,726,201,525
50,12,121,Florida,Suwannee County,5,0,35942,17598,18344
50,12,121,Florida,Suwannee County,5,1,2369,1205,1164
50,12,121,Florida,Suwannee County,5,2,2137,1084,1053
50,12,121,Florida,Suwannee County,5,3,2465,1262,1203
50,12,121,Florida,Suwannee County,5,4,2388,1256,1132
50,12,121,Florida,Suwannee County,5,5,2253,1200,1053
50,12,121,Florida,Suwannee County,5,6,1958,1056,902
50,12,121,Florida,Suwannee County,5,7,1944,979,965
50,12,121,Florida,Suwannee County,5,8,2317,1120,1197
50,12,121,Florida,Suwannee County,5,9,2549,1256,1293
50,12,121,Florida,Suwannee County,5,10,2474,1181,1293
50,12,121,Florida,Suwannee County,5,11,2483,1209,1274
50,12,121,Florida,Suwannee County,5,12,2340,1121,1219
50,12,121,Florida,Suwannee County,5,13,2050,987,1063
50,12,121,Florida,Suwannee County,5,14,1817,867,950
50,12,121,Florida,Suwannee County,5,15,1514,666,848
50,12,121,Florida,Suwannee County,5,16,1279,588,691
50,12,121,Florida,Suwannee County,5,17,874,353,521
50,12,121,Florida,Suwannee County,5,18,731,208,523
50,12,121,Florida,Suwannee County,6,0,36440,17864,18576
50,12,121,Florida,Suwannee County,6,1,2363,1193,1170
50,12,121,Florida,Suwannee County,6,2,2169,1102,1067
50,12,121,Florida,Suwannee County,6,3,2489,1262,1227
50,12,121,Florida,Suwannee County,6,4,2325,1226,1099
50,12,121,Florida,Suwannee County,6,5,2352,1250,1102
50,12,121,Florida,Suwannee County,6,6,2025,1095,930
50,12,121,Florida,Suwannee County,6,7,1999,1030,969
50,12,121,Florida,Suwannee County,6,8,2234,1092,1142
50,12,121,Florida,Suwannee County,6,9,2544,1257,1287
50,12,121,Florida,Suwannee County,6,10,2457,1162,1295
50,12,121,Florida,Suwannee County,6,11,2539,1227,1312
50,12,121,Florida,Suwannee County,6,12,2382,1160,1222
50,12,121,Florida,Suwannee County,6,13,2111,1008,1103
50,12,121,Florida,Suwannee County,6,14,1920,933,987
50,12,121,Florida,Suwannee County,6,15,1526,663,863
50,12,121,Florida,Suwannee County,6,16,1327,594,733
50,12,121,Florida,Suwannee County,6,17,912,383,529
50,12,121,Florida,Suwannee County,6,18,766,227,539
50,12,121,Florida,Suwannee County,7,0,37103,18206,18897
50,12,121,Florida,Suwannee County,7,1,2411,1234,1177
50,12,121,Florida,Suwannee County,7,2,2196,1107,1089
50,12,121,Florida,Suwannee County,7,3,2537,1283,1254
50,12,121,Florida,Suwannee County,7,4,2315,1228,1087
50,12,121,Florida,Suwannee County,7,5,2428,1293,1135
50,12,121,Florida,Suwannee County,7,6,2127,1140,987
50,12,121,Florida,Suwannee County,7,7,2022,1069,953
50,12,121,Florida,Suwannee County,7,8,2111,1031,1080
50,12,121,Florida,Suwannee County,7,9,2582,1274,1308
50,12,121,Florida,Suwannee County,7,10,2580,1218,1362
50,12,121,Florida,Suwannee County,7,11,2558,1244,1314
50,12,121,Florida,Suwannee County,7,12,2460,1167,1293
50,12,121,Florida,Suwannee County,7,13,2182,1060,1122
50,12,121,Florida,Suwannee County,7,14,1940,935,1005
50,12,121,Florida,Suwannee County,7,15,1539,681,858
50,12,121,Florida,Suwannee County,7,16,1359,607,752
50,12,121,Florida,Suwannee County,7,17,925,385,540
50,12,121,Florida,Suwannee County,7,18,831,250,581
50,12,121,Florida,Suwannee County,8,0,38055,18683,19372
50,12,121,Florida,Suwannee County,8,1,2476,1262,1214
50,12,121,Florida,Suwannee County,8,2,2270,1128,1142
50,12,121,Florida,Suwannee County,8,3,2508,1283,1225
50,12,121,Florida,Suwannee County,8,4,2403,1266,1137
50,12,121,Florida,Suwannee County,8,5,2343,1227,1116
50,12,121,Florida,Suwannee County,8,6,2307,1240,1067
50,12,121,Florida,Suwannee County,8,7,2037,1097,940
50,12,121,Florida,Suwannee County,8,8,2135,1050,1085
50,12,121,Florida,Suwannee County,8,9,2599,1299,1300
50,12,121,Florida,Suwannee County,8,10,2682,1256,1426
50,12,121,Florida,Suwannee County,8,11,2636,1286,1350
50,12,121,Florida,Suwannee County,8,12,2628,1235,1393
50,12,121,Florida,Suwannee County,8,13,2247,1081,1166
50,12,121,Florida,Suwannee County,8,14,1991,968,1023
50,12,121,Florida,Suwannee County,8,15,1548,708,840
50,12,121,Florida,Suwannee County,8,16,1390,602,788
50,12,121,Florida,Suwannee County,8,17,985,419,566
50,12,121,Florida,Suwannee County,8,18,870,276,594
50,12,121,Florida,Suwannee County,9,0,38773,19043,19730
50,12,121,Florida,Suwannee County,9,1,2450,1249,1201
50,12,121,Florida,Suwannee County,9,2,2413,1209,1204
50,12,121,Florida,Suwannee County,9,3,2403,1221,1182
50,12,121,Florida,Suwannee County,9,4,2533,1317,1216
50,12,121,Florida,Suwannee County,9,5,2226,1199,1027
50,12,121,Florida,Suwannee County,9,6,2403,1282,1121
50,12,121,Florida,Suwannee County,9,7,2104,1136,968
50,12,121,Florida,Suwannee County,9,8,2098,1019,1079
50,12,121,Florida,Suwannee County,9,9,2581,1287,1294
50,12,121,Florida,Suwannee County,9,10,2738,1337,1401
50,12,121,Florida,Suwannee County,9,11,2669,1259,1410
50,12,121,Florida,Suwannee County,9,12,2765,1325,1440
50,12,121,Florida,Suwannee County,9,13,2370,1131,1239
50,12,121,Florida,Suwannee County,9,14,2043,981,1062
50,12,121,Florida,Suwannee County,9,15,1670,769,901
50,12,121,Florida,Suwannee County,9,16,1361,573,788
50,12,121,Florida,Suwannee County,9,17,1046,473,573
50,12,121,Florida,Suwannee County,9,18,900,276,624
50,12,121,Florida,Suwannee County,10,0,39473,19408,20065
50,12,121,Florida,Suwannee County,10,1,2514,1273,1241
50,12,121,Florida,Suwannee County,10,2,2509,1278,1231
50,12,121,Florida,Suwannee County,10,3,2371,1198,1173
50,12,121,Florida,Suwannee County,10,4,2497,1299,1198
50,12,121,Florida,Suwannee County,10,5,2155,1150,1005
50,12,121,Florida,Suwannee County,10,6,2539,1379,1160
50,12,121,Florida,Suwannee County,10,7,2130,1163,967
50,12,121,Florida,Suwannee County,10,8,2150,1075,1075
50,12,121,Florida,Suwannee County,10,9,2542,1236,1306
50,12,121,Florida,Suwannee County,10,10,2819,1375,1444
50,12,121,Florida,Suwannee County,10,11,2756,1319,1437
50,12,121,Florida,Suwannee County,10,12,2772,1333,1439
50,12,121,Florida,Suwannee County,10,13,2518,1197,1321
50,12,121,Florida,Suwannee County,10,14,2101,994,1107
50,12,121,Florida,Suwannee County,10,15,1700,782,918
50,12,121,Florida,Suwannee County,10,16,1373,576,797
50,12,121,Florida,Suwannee County,10,17,1092,482,610
50,12,121,Florida,Suwannee County,10,18,935,299,636
50,12,121,Florida,Suwannee County,11,0,39830,19597,20233
50,12,121,Florida,Suwannee County,11,1,2578,1323,1255
50,12,121,Florida,Suwannee County,11,2,2547,1287,1260
50,12,121,Florida,Suwannee County,11,3,2351,1191,1160
50,12,121,Florida,Suwannee County,11,4,2529,1305,1224
50,12,121,Florida,Suwannee County,11,5,2065,1100,965
50,12,121,Florida,Suwannee County,11,6,2646,1431,1215
50,12,121,Florida,Suwannee County,11,7,2173,1183,990
50,12,121,Florida,Suwannee County,11,8,2183,1115,1068
50,12,121,Florida,Suwannee County,11,9,2440,1196,1244
50,12,121,Florida,Suwannee County,11,10,2779,1355,1424
50,12,121,Florida,Suwannee County,11,11,2764,1318,1446
50,12,121,Florida,Suwannee County,11,12,2807,1341,1466
50,12,121,Florida,Suwannee County,11,13,2589,1244,1345
50,12,121,Florida,Suwannee County,11,14,2146,1006,1140
50,12,121,Florida,Suwannee County,11,15,1745,808,937
50,12,121,Florida,Suwannee County,11,16,1415,597,818
50,12,121,Florida,Suwannee County,11,17,1098,466,632
50,12,121,Florida,Suwannee County,11,18,975,331,644
50,12,121,Florida,Suwannee County,12,0,40149,19859,20290
50,12,121,Florida,Suwannee County,12,1,2644,1346,1298
50,12,121,Florida,Suwannee County,12,2,2596,1326,1270
50,12,121,Florida,Suwannee County,12,3,2332,1175,1157
50,12,121,Florida,Suwannee County,12,4,2511,1305,1206
50,12,121,Florida,Suwannee County,12,5,2099,1145,954
50,12,121,Florida,Suwannee County,12,6,2615,1429,1186
50,12,121,Florida,Suwannee County,12,7,2300,1257,1043
50,12,121,Florida,Suwannee County,12,8,2196,1155,1041
50,12,121,Florida,Suwannee County,12,9,2357,1167,1190
50,12,121,Florida,Suwannee County,12,10,2770,1354,1416
50,12,121,Florida,Suwannee County,12,11,2792,1333,1459
50,12,121,Florida,Suwannee County,12,12,2780,1337,1443
50,12,121,Florida,Suwannee County,12,13,2628,1233,1395
50,12,121,Florida,Suwannee County,12,14,2264,1085,1179
50,12,121,Florida,Suwannee County,12,15,1791,810,981
50,12,121,Florida,Suwannee County,12,16,1406,617,789
50,12,121,Florida,Suwannee County,12,17,1070,454,616
50,12,121,Florida,Suwannee County,12,18,998,331,667
50,12,123,Florida,Taylor County,1,0,19256,9833,9423
50,12,123,Florida,Taylor County,1,1,1139,597,542
50,12,123,Florida,Taylor County,1,2,1289,633,656
50,12,123,Florida,Taylor County,1,3,1437,739,698
50,12,123,Florida,Taylor County,1,4,1378,710,668
50,12,123,Florida,Taylor County,1,5,1076,570,506
50,12,123,Florida,Taylor County,1,6,1281,720,561
50,12,123,Florida,Taylor County,1,7,1213,682,531
50,12,123,Florida,Taylor County,1,8,1484,814,670
50,12,123,Florida,Taylor County,1,9,1475,787,688
50,12,123,Florida,Taylor County,1,10,1419,735,684
50,12,123,Florida,Taylor County,1,11,1330,667,663
50,12,123,Florida,Taylor County,1,12,1125,569,556
50,12,123,Florida,Taylor County,1,13,902,430,472
50,12,123,Florida,Taylor County,1,14,858,386,472
50,12,123,Florida,Taylor County,1,15,742,360,382
50,12,123,Florida,Taylor County,1,16,513,225,288
50,12,123,Florida,Taylor County,1,17,309,122,187
50,12,123,Florida,Taylor County,1,18,286,87,199
50,12,123,Florida,Taylor County,2,0,19254,9832,9422
50,12,123,Florida,Taylor County,2,1,1139,597,542
50,12,123,Florida,Taylor County,2,2,1289,633,656
50,12,123,Florida,Taylor County,2,3,1437,739,698
50,12,123,Florida,Taylor County,2,4,1378,710,668
50,12,123,Florida,Taylor County,2,5,1076,570,506
50,12,123,Florida,Taylor County,2,6,1281,720,561
50,12,123,Florida,Taylor County,2,7,1213,682,531
50,12,123,Florida,Taylor County,2,8,1484,814,670
50,12,123,Florida,Taylor County,2,9,1475,787,688
50,12,123,Florida,Taylor County,2,10,1419,735,684
50,12,123,Florida,Taylor County,2,11,1328,666,662
50,12,123,Florida,Taylor County,2,12,1125,569,556
50,12,123,Florida,Taylor County,2,13,902,430,472
50,12,123,Florida,Taylor County,2,14,858,386,472
50,12,123,Florida,Taylor County,2,15,742,360,382
50,12,123,Florida,Taylor County,2,16,513,225,288
50,12,123,Florida,Taylor County,2,17,309,122,187
50,12,123,Florida,Taylor County,2,18,286,87,199
50,12,123,Florida,Taylor County,3,0,19215,9817,9398
50,12,123,Florida,Taylor County,3,1,1133,594,539
50,12,123,Florida,Taylor County,3,2,1280,628,652
50,12,123,Florida,Taylor County,3,3,1433,737,696
50,12,123,Florida,Taylor County,3,4,1375,710,665
50,12,123,Florida,Taylor County,3,5,1081,573,508
50,12,123,Florida,Taylor County,3,6,1268,713,555
50,12,123,Florida,Taylor County,3,7,1207,679,528
50,12,123,Florida,Taylor County,3,8,1473,809,664
50,12,123,Florida,Taylor County,3,9,1471,785,686
50,12,123,Florida,Taylor County,3,10,1421,736,685
50,12,123,Florida,Taylor County,3,11,1335,670,665
50,12,123,Florida,Taylor County,3,12,1125,570,555
50,12,123,Florida,Taylor County,3,13,900,429,471
50,12,123,Florida,Taylor County,3,14,857,387,470
50,12,123,Florida,Taylor County,3,15,742,360,382
50,12,123,Florida,Taylor County,3,16,514,226,288
50,12,123,Florida,Taylor County,3,17,312,123,189
50,12,123,Florida,Taylor County,3,18,288,88,200
50,12,123,Florida,Taylor County,4,0,19262,9903,9359
50,12,123,Florida,Taylor County,4,1,1217,624,593
50,12,123,Florida,Taylor County,4,2,1220,592,628
50,12,123,Florida,Taylor County,4,3,1389,718,671
50,12,123,Florida,Taylor County,4,4,1314,684,630
50,12,123,Florida,Taylor County,4,5,1181,636,545
50,12,123,Florida,Taylor County,4,6,1228,729,499
50,12,123,Florida,Taylor County,4,7,1262,700,562
50,12,123,Florida,Taylor County,4,8,1389,780,609
50,12,123,Florida,Taylor County,4,9,1480,796,684
50,12,123,Florida,Taylor County,4,10,1464,781,683
50,12,123,Florida,Taylor County,4,11,1382,683,699
50,12,123,Florida,Taylor County,4,12,1145,576,569
50,12,123,Florida,Taylor County,4,13,883,422,461
50,12,123,Florida,Taylor County,4,14,865,383,482
50,12,123,Florida,Taylor County,4,15,719,354,365
50,12,123,Florida,Taylor County,4,16,544,247,297
50,12,123,Florida,Taylor County,4,17,303,110,193
50,12,123,Florida,Taylor County,4,18,277,88,189
50,12,123,Florida,Taylor County,5,0,19222,9909,9313
50,12,123,Florida,Taylor County,5,1,1196,605,591
50,12,123,Florida,Taylor County,5,2,1208,608,600
50,12,123,Florida,Taylor County,5,3,1354,697,657
50,12,123,Florida,Taylor County,5,4,1292,672,620
50,12,123,Florida,Taylor County,5,5,1180,655,525
50,12,123,Florida,Taylor County,5,6,1184,688,496
50,12,123,Florida,Taylor County,5,7,1208,681,527
50,12,123,Florida,Taylor County,5,8,1391,786,605
50,12,123,Florida,Taylor County,5,9,1483,809,674
50,12,123,Florida,Taylor County,5,10,1501,784,717
50,12,123,Florida,Taylor County,5,11,1342,657,685
50,12,123,Florida,Taylor County,5,12,1237,618,619
50,12,123,Florida,Taylor County,5,13,953,473,480
50,12,123,Florida,Taylor County,5,14,845,380,465
50,12,123,Florida,Taylor County,5,15,705,338,367
50,12,123,Florida,Taylor County,5,16,556,255,301
50,12,123,Florida,Taylor County,5,17,301,111,190
50,12,123,Florida,Taylor County,5,18,286,92,194
50,12,123,Florida,Taylor County,6,0,19619,10372,9247
50,12,123,Florida,Taylor County,6,1,1195,627,568
50,12,123,Florida,Taylor County,6,2,1169,573,596
50,12,123,Florida,Taylor County,6,3,1332,676,656
50,12,123,Florida,Taylor County,6,4,1289,689,600
50,12,123,Florida,Taylor County,6,5,1225,707,518
50,12,123,Florida,Taylor County,6,6,1304,801,503
50,12,123,Florida,Taylor County,6,7,1330,787,543
50,12,123,Florida,Taylor County,6,8,1425,850,575
50,12,123,Florida,Taylor County,6,9,1492,840,652
50,12,123,Florida,Taylor County,6,10,1563,829,734
50,12,123,Florida,Taylor County,6,11,1356,689,667
50,12,123,Florida,Taylor County,6,12,1261,628,633
50,12,123,Florida,Taylor County,6,13,981,492,489
50,12,123,Florida,Taylor County,6,14,845,395,450
50,12,123,Florida,Taylor County,6,15,705,332,373
50,12,123,Florida,Taylor County,6,16,555,250,305
50,12,123,Florida,Taylor County,6,17,312,117,195
50,12,123,Florida,Taylor County,6,18,280,90,190
50,12,123,Florida,Taylor County,7,0,19573,10320,9253
50,12,123,Florida,Taylor County,7,1,1176,610,566
50,12,123,Florida,Taylor County,7,2,1169,603,566
50,12,123,Florida,Taylor County,7,3,1292,635,657
50,12,123,Florida,Taylor County,7,4,1307,708,599
50,12,123,Florida,Taylor County,7,5,1262,716,546
50,12,123,Florida,Taylor County,7,6,1289,785,504
50,12,123,Florida,Taylor County,7,7,1319,766,553
50,12,123,Florida,Taylor County,7,8,1343,821,522
50,12,123,Florida,Taylor County,7,9,1457,811,646
50,12,123,Florida,Taylor County,7,10,1523,804,719
50,12,123,Florida,Taylor County,7,11,1345,688,657
50,12,123,Florida,Taylor County,7,12,1324,666,658
50,12,123,Florida,Taylor County,7,13,1018,500,518
50,12,123,Florida,Taylor County,7,14,857,401,456
50,12,123,Florida,Taylor County,7,15,689,306,383
50,12,123,Florida,Taylor County,7,16,576,274,302
50,12,123,Florida,Taylor County,7,17,333,132,201
50,12,123,Florida,Taylor County,7,18,294,94,200
50,12,123,Florida,Taylor County,8,0,19861,10467,9394
50,12,123,Florida,Taylor County,8,1,1178,601,577
50,12,123,Florida,Taylor County,8,2,1157,605,552
50,12,123,Florida,Taylor County,8,3,1288,634,654
50,12,123,Florida,Taylor County,8,4,1318,700,618
50,12,123,Florida,Taylor County,8,5,1344,783,561
50,12,123,Florida,Taylor County,8,6,1300,789,511
50,12,123,Florida,Taylor County,8,7,1321,765,556
50,12,123,Florida,Taylor County,8,8,1344,826,518
50,12,123,Florida,Taylor County,8,9,1453,806,647
50,12,123,Florida,Taylor County,8,10,1513,815,698
50,12,123,Florida,Taylor County,8,11,1404,708,696
50,12,123,Florida,Taylor County,8,12,1332,664,668
50,12,123,Florida,Taylor County,8,13,1070,524,546
50,12,123,Florida,Taylor County,8,14,862,405,457
50,12,123,Florida,Taylor County,8,15,727,316,411
50,12,123,Florida,Taylor County,8,16,586,282,304
50,12,123,Florida,Taylor County,8,17,378,154,224
50,12,123,Florida,Taylor County,8,18,286,90,196
50,12,123,Florida,Taylor County,9,0,20016,10576,9440
50,12,123,Florida,Taylor County,9,1,1180,632,548
50,12,123,Florida,Taylor County,9,2,1191,608,583
50,12,123,Florida,Taylor County,9,3,1234,600,634
50,12,123,Florida,Taylor County,9,4,1314,706,608
50,12,123,Florida,Taylor County,9,5,1330,767,563
50,12,123,Florida,Taylor County,9,6,1372,836,536
50,12,123,Florida,Taylor County,9,7,1250,755,495
50,12,123,Florida,Taylor County,9,8,1380,831,549
50,12,123,Florida,Taylor County,9,9,1447,806,641
50,12,123,Florida,Taylor County,9,10,1499,809,690
50,12,123,Florida,Taylor County,9,11,1423,741,682
50,12,123,Florida,Taylor County,9,12,1390,677,713
50,12,123,Florida,Taylor County,9,13,1099,532,567
50,12,123,Florida,Taylor County,9,14,859,400,459
50,12,123,Florida,Taylor County,9,15,759,332,427
50,12,123,Florida,Taylor County,9,16,587,282,305
50,12,123,Florida,Taylor County,9,17,417,181,236
50,12,123,Florida,Taylor County,9,18,285,81,204
50,12,123,Florida,Taylor County,10,0,20947,11428,9519
50,12,123,Florida,Taylor County,10,1,1225,646,579
50,12,123,Florida,Taylor County,10,2,1221,617,604
50,12,123,Florida,Taylor County,10,3,1222,615,607
50,12,123,Florida,Taylor County,10,4,1328,716,612
50,12,123,Florida,Taylor County,10,5,1401,851,550
50,12,123,Florida,Taylor County,10,6,1591,1037,554
50,12,123,Florida,Taylor County,10,7,1375,856,519
50,12,123,Florida,Taylor County,10,8,1506,973,533
50,12,123,Florida,Taylor County,10,9,1496,880,616
50,12,123,Florida,Taylor County,10,10,1585,897,688
50,12,123,Florida,Taylor County,10,11,1496,778,718
50,12,123,Florida,Taylor County,10,12,1354,669,685
50,12,123,Florida,Taylor County,10,13,1197,579,618
50,12,123,Florida,Taylor County,10,14,888,439,449
50,12,123,Florida,Taylor County,10,15,744,320,424
50,12,123,Florida,Taylor County,10,16,591,274,317
50,12,123,Florida,Taylor County,10,17,421,186,235
50,12,123,Florida,Taylor County,10,18,306,95,211
50,12,123,Florida,Taylor County,11,0,21390,11894,9496
50,12,123,Florida,Taylor County,11,1,1277,670,607
50,12,123,Florida,Taylor County,11,2,1211,635,576
50,12,123,Florida,Taylor County,11,3,1212,594,618
50,12,123,Florida,Taylor County,11,4,1314,707,607
50,12,123,Florida,Taylor County,11,5,1472,921,551
50,12,123,Florida,Taylor County,11,6,1654,1114,540
50,12,123,Florida,Taylor County,11,7,1444,933,511
50,12,123,Florida,Taylor County,11,8,1624,1083,541
50,12,123,Florida,Taylor County,11,9,1501,915,586
50,12,123,Florida,Taylor County,11,10,1562,906,656
50,12,123,Florida,Taylor County,11,11,1502,783,719
50,12,123,Florida,Taylor County,11,12,1359,695,664
50,12,123,Florida,Taylor County,11,13,1245,590,655
50,12,123,Florida,Taylor County,11,14,921,458,463
50,12,123,Florida,Taylor County,11,15,752,335,417
50,12,123,Florida,Taylor County,11,16,613,281,332
50,12,123,Florida,Taylor County,11,17,397,171,226
50,12,123,Florida,Taylor County,11,18,330,103,227
50,12,123,Florida,Taylor County,12,0,21400,11941,9459
50,12,123,Florida,Taylor County,12,1,1297,679,618
50,12,123,Florida,Taylor County,12,2,1178,611,567
50,12,123,Florida,Taylor County,12,3,1185,610,575
50,12,123,Florida,Taylor County,12,4,1293,674,619
50,12,123,Florida,Taylor County,12,5,1434,927,507
50,12,123,Florida,Taylor County,12,6,1741,1150,591
50,12,123,Florida,Taylor County,12,7,1464,947,517
50,12,123,Florida,Taylor County,12,8,1636,1086,550
50,12,123,Florida,Taylor County,12,9,1439,905,534
50,12,123,Florida,Taylor County,12,10,1551,902,649
50,12,123,Florida,Taylor County,12,11,1493,777,716
50,12,123,Florida,Taylor County,12,12,1356,707,649
50,12,123,Florida,Taylor County,12,13,1275,608,667
50,12,123,Florida,Taylor County,12,14,968,470,498
50,12,123,Florida,Taylor County,12,15,755,339,416
50,12,123,Florida,Taylor County,12,16,583,246,337
50,12,123,Florida,Taylor County,12,17,415,186,229
50,12,123,Florida,Taylor County,12,18,337,117,220
50,12,125,Florida,Union County,1,0,13442,8693,4749
50,12,125,Florida,Union County,1,1,737,364,373
50,12,125,Florida,Union County,1,2,757,397,360
50,12,125,Florida,Union County,1,3,875,471,404
50,12,125,Florida,Union County,1,4,914,485,429
50,12,125,Florida,Union County,1,5,823,540,283
50,12,125,Florida,Union County,1,6,1107,804,303
50,12,125,Florida,Union County,1,7,1292,976,316
50,12,125,Florida,Union County,1,8,1580,1176,404
50,12,125,Florida,Union County,1,9,1366,991,375
50,12,125,Florida,Union County,1,10,1122,799,323
50,12,125,Florida,Union County,1,11,853,575,278
50,12,125,Florida,Union County,1,12,590,369,221
50,12,125,Florida,Union County,1,13,423,244,179
50,12,125,Florida,Union County,1,14,365,205,160
50,12,125,Florida,Union County,1,15,273,143,130
50,12,125,Florida,Union County,1,16,177,82,95
50,12,125,Florida,Union County,1,17,110,47,63
50,12,125,Florida,Union County,1,18,78,25,53
50,12,125,Florida,Union County,2,0,13442,8693,4749
50,12,125,Florida,Union County,2,1,737,364,373
50,12,125,Florida,Union County,2,2,757,397,360
50,12,125,Florida,Union County,2,3,875,471,404
50,12,125,Florida,Union County,2,4,914,485,429
50,12,125,Florida,Union County,2,5,823,540,283
50,12,125,Florida,Union County,2,6,1107,804,303
50,12,125,Florida,Union County,2,7,1292,976,316
50,12,125,Florida,Union County,2,8,1580,1176,404
50,12,125,Florida,Union County,2,9,1366,991,375
50,12,125,Florida,Union County,2,10,1122,799,323
50,12,125,Florida,Union County,2,11,853,575,278
50,12,125,Florida,Union County,2,12,590,369,221
50,12,125,Florida,Union County,2,13,423,244,179
50,12,125,Florida,Union County,2,14,365,205,160
50,12,125,Florida,Union County,2,15,273,143,130
50,12,125,Florida,Union County,2,16,177,82,95
50,12,125,Florida,Union County,2,17,110,47,63
50,12,125,Florida,Union County,2,18,78,25,53
50,12,125,Florida,Union County,3,0,13462,8703,4759
50,12,125,Florida,Union County,3,1,737,364,373
50,12,125,Florida,Union County,3,2,754,395,359
50,12,125,Florida,Union County,3,3,875,471,404
50,12,125,Florida,Union County,3,4,915,485,430
50,12,125,Florida,Union County,3,5,831,545,286
50,12,125,Florida,Union County,3,6,1102,802,300
50,12,125,Florida,Union County,3,7,1293,977,316
50,12,125,Florida,Union County,3,8,1577,1174,403
50,12,125,Florida,Union County,3,9,1367,992,375
50,12,125,Florida,Union County,3,10,1126,801,325
50,12,125,Florida,Union County,3,11,859,578,281
50,12,125,Florida,Union County,3,12,593,370,223
50,12,125,Florida,Union County,3,13,423,244,179
50,12,125,Florida,Union County,3,14,368,206,162
50,12,125,Florida,Union County,3,15,273,143,130
50,12,125,Florida,Union County,3,16,178,83,95
50,12,125,Florida,Union County,3,17,111,48,63
50,12,125,Florida,Union County,3,18,80,25,55
50,12,125,Florida,Union County,4,0,13511,8715,4796
50,12,125,Florida,Union County,4,1,741,370,371
50,12,125,Florida,Union County,4,2,720,374,346
50,12,125,Florida,Union County,4,3,883,479,404
50,12,125,Florida,Union County,4,4,877,464,413
50,12,125,Florida,Union County,4,5,884,579,305
50,12,125,Florida,Union County,4,6,1070,776,294
50,12,125,Florida,Union County,4,7,1304,989,315
50,12,125,Florida,Union County,4,8,1555,1164,391
50,12,125,Florida,Union County,4,9,1392,1009,383
50,12,125,Florida,Union County,4,10,1131,794,337
50,12,125,Florida,Union County,4,11,885,596,289
50,12,125,Florida,Union County,4,12,603,369,234
50,12,125,Florida,Union County,4,13,427,253,174
50,12,125,Florida,Union County,4,14,378,198,180
50,12,125,Florida,Union County,4,15,275,142,133
50,12,125,Florida,Union County,4,16,189,87,102
50,12,125,Florida,Union County,4,17,113,48,65
50,12,125,Florida,Union County,4,18,84,24,60
50,12,125,Florida,Union County,5,0,13472,8675,4797
50,12,125,Florida,Union County,5,1,745,380,365
50,12,125,Florida,Union County,5,2,723,364,359
50,12,125,Florida,Union County,5,3,794,430,364
50,12,125,Florida,Union County,5,4,905,494,411
50,12,125,Florida,Union County,5,5,889,574,315
50,12,125,Florida,Union County,5,6,1071,781,290
50,12,125,Florida,Union County,5,7,1305,984,321
50,12,125,Florida,Union County,5,8,1527,1141,386
50,12,125,Florida,Union County,5,9,1373,1003,370
50,12,125,Florida,Union County,5,10,1146,798,348
50,12,125,Florida,Union County,5,11,864,580,284
50,12,125,Florida,Union County,5,12,629,380,249
50,12,125,Florida,Union County,5,13,436,251,185
50,12,125,Florida,Union County,5,14,387,209,178
50,12,125,Florida,Union County,5,15,262,134,128
50,12,125,Florida,Union County,5,16,216,100,116
50,12,125,Florida,Union County,5,17,112,43,69
50,12,125,Florida,Union County,5,18,88,29,59
50,12,125,Florida,Union County,6,0,13462,8594,4868
50,12,125,Florida,Union County,6,1,735,382,353
50,12,125,Florida,Union County,6,2,746,370,376
50,12,125,Florida,Union County,6,3,840,460,380
50,12,125,Florida,Union County,6,4,872,479,393
50,12,125,Florida,Union County,6,5,893,575,318
50,12,125,Florida,Union County,6,6,1090,779,311
50,12,125,Florida,Union County,6,7,1279,974,305
50,12,125,Florida,Union County,6,8,1471,1095,376
50,12,125,Florida,Union County,6,9,1346,960,386
50,12,125,Florida,Union County,6,10,1173,806,367
50,12,125,Florida,Union County,6,11,848,558,290
50,12,125,Florida,Union County,6,12,643,384,259
50,12,125,Florida,Union County,6,13,450,260,190
50,12,125,Florida,Union County,6,14,378,191,187
50,12,125,Florida,Union County,6,15,282,150,132
50,12,125,Florida,Union County,6,16,201,84,117
50,12,125,Florida,Union County,6,17,126,54,72
50,12,125,Florida,Union County,6,18,89,33,56
50,12,125,Florida,Union County,7,0,14086,9202,4884
50,12,125,Florida,Union County,7,1,739,385,354
50,12,125,Florida,Union County,7,2,744,362,382
50,12,125,Florida,Union County,7,3,832,448,384
50,12,125,Florida,Union County,7,4,869,492,377
50,12,125,Florida,Union County,7,5,934,621,313
50,12,125,Florida,Union County,7,6,1197,871,326
50,12,125,Florida,Union County,7,7,1378,1082,296
50,12,125,Florida,Union County,7,8,1547,1207,340
50,12,125,Florida,Union County,7,9,1451,1055,396
50,12,125,Florida,Union County,7,10,1211,850,361
50,12,125,Florida,Union County,7,11,916,612,304
50,12,125,Florida,Union County,7,12,668,401,267
50,12,125,Florida,Union County,7,13,491,288,203
50,12,125,Florida,Union County,7,14,393,203,190
50,12,125,Florida,Union County,7,15,292,156,136
50,12,125,Florida,Union County,7,16,210,86,124
50,12,125,Florida,Union County,7,17,119,51,68
50,12,125,Florida,Union County,7,18,95,32,63
50,12,125,Florida,Union County,8,0,14350,9458,4892
50,12,125,Florida,Union County,8,1,728,377,351
50,12,125,Florida,Union County,8,2,775,383,392
50,12,125,Florida,Union County,8,3,762,400,362
50,12,125,Florida,Union County,8,4,885,514,371
50,12,125,Florida,Union County,8,5,953,639,314
50,12,125,Florida,Union County,8,6,1205,899,306
50,12,125,Florida,Union County,8,7,1440,1127,313
50,12,125,Florida,Union County,8,8,1577,1255,322
50,12,125,Florida,Union County,8,9,1508,1122,386
50,12,125,Florida,Union County,8,10,1203,840,363
50,12,125,Florida,Union County,8,11,964,648,316
50,12,125,Florida,Union County,8,12,710,434,276
50,12,125,Florida,Union County,8,13,495,276,219
50,12,125,Florida,Union County,8,14,388,211,177
50,12,125,Florida,Union County,8,15,305,152,153
50,12,125,Florida,Union County,8,16,221,98,123
50,12,125,Florida,Union County,8,17,128,46,82
50,12,125,Florida,Union County,8,18,103,37,66
50,12,125,Florida,Union County,9,0,14274,9315,4959
50,12,125,Florida,Union County,9,1,737,376,361
50,12,125,Florida,Union County,9,2,784,392,392
50,12,125,Florida,Union County,9,3,762,396,366
50,12,125,Florida,Union County,9,4,852,501,351
50,12,125,Florida,Union County,9,5,908,605,303
50,12,125,Florida,Union County,9,6,1258,922,336
50,12,125,Florida,Union County,9,7,1374,1069,305
50,12,125,Florida,Union County,9,8,1559,1240,319
50,12,125,Florida,Union County,9,9,1463,1094,369
50,12,125,Florida,Union County,9,10,1211,841,370
50,12,125,Florida,Union County,9,11,939,621,318
50,12,125,Florida,Union County,9,12,722,434,288
50,12,125,Florida,Union County,9,13,502,272,230
50,12,125,Florida,Union County,9,14,405,216,189
50,12,125,Florida,Union County,9,15,316,149,167
50,12,125,Florida,Union County,9,16,226,97,129
50,12,125,Florida,Union County,9,17,143,50,93
50,12,125,Florida,Union County,9,18,113,40,73
50,12,125,Florida,Union County,10,0,14727,9689,5038
50,12,125,Florida,Union County,10,1,787,397,390
50,12,125,Florida,Union County,10,2,739,378,361
50,12,125,Florida,Union County,10,3,773,393,380
50,12,125,Florida,Union County,10,4,821,485,336
50,12,125,Florida,Union County,10,5,981,664,317
50,12,125,Florida,Union County,10,6,1270,942,328
50,12,125,Florida,Union County,10,7,1445,1136,309
50,12,125,Florida,Union County,10,8,1663,1325,338
50,12,125,Florida,Union County,10,9,1502,1136,366
50,12,125,Florida,Union County,10,10,1223,870,353
50,12,125,Florida,Union County,10,11,989,657,332
50,12,125,Florida,Union County,10,12,725,438,287
50,12,125,Florida,Union County,10,13,528,279,249
50,12,125,Florida,Union County,10,14,421,218,203
50,12,125,Florida,Union County,10,15,351,176,175
50,12,125,Florida,Union County,10,16,213,91,122
50,12,125,Florida,Union County,10,17,178,69,109
50,12,125,Florida,Union County,10,18,118,35,83
50,12,125,Florida,Union County,11,0,14935,9805,5130
50,12,125,Florida,Union County,11,1,836,419,417
50,12,125,Florida,Union County,11,2,723,377,346
50,12,125,Florida,Union County,11,3,758,378,380
50,12,125,Florida,Union County,11,4,862,512,350
50,12,125,Florida,Union County,11,5,994,670,324
50,12,125,Florida,Union County,11,6,1294,964,330
50,12,125,Florida,Union County,11,7,1467,1150,317
50,12,125,Florida,Union County,11,8,1682,1350,332
50,12,125,Florida,Union County,11,9,1484,1131,353
50,12,125,Florida,Union County,11,10,1229,862,367
50,12,125,Florida,Union County,11,11,1020,676,344
50,12,125,Florida,Union County,11,12,694,417,277
50,12,125,Florida,Union County,11,13,538,287,251
50,12,125,Florida,Union County,11,14,440,228,212
50,12,125,Florida,Union County,11,15,349,160,189
50,12,125,Florida,Union County,11,16,258,117,141
50,12,125,Florida,Union County,11,17,162,57,105
50,12,125,Florida,Union County,11,18,145,50,95
50,12,125,Florida,Union County,12,0,14584,9396,5188
50,12,125,Florida,Union County,12,1,850,434,416
50,12,125,Florida,Union County,12,2,733,383,350
50,12,125,Florida,Union County,12,3,759,373,386
50,12,125,Florida,Union County,12,4,844,492,352
50,12,125,Florida,Union County,12,5,959,646,313
50,12,125,Florida,Union County,12,6,1236,909,327
50,12,125,Florida,Union County,12,7,1429,1095,334
50,12,125,Florida,Union County,12,8,1586,1259,327
50,12,125,Florida,Union County,12,9,1370,1042,328
50,12,125,Florida,Union County,12,10,1206,821,385
50,12,125,Florida,Union County,12,11,977,630,347
50,12,125,Florida,Union County,12,12,709,420,289
50,12,125,Florida,Union County,12,13,518,264,254
50,12,125,Florida,Union County,12,14,464,240,224
50,12,125,Florida,Union County,12,15,352,156,196
50,12,125,Florida,Union County,12,16,269,123,146
50,12,125,Florida,Union County,12,17,173,61,112
50,12,125,Florida,Union County,12,18,150,48,102
50,12,127,Florida,Volusia County,1,0,443343,215361,227982
50,12,127,Florida,Volusia County,1,1,21657,11031,10626
50,12,127,Florida,Volusia County,1,2,25068,12801,12267
50,12,127,Florida,Volusia County,1,3,27076,14024,13052
50,12,127,Florida,Volusia County,1,4,27602,14497,13105
50,12,127,Florida,Volusia County,1,5,24727,13268,11459
50,12,127,Florida,Volusia County,1,6,22757,11731,11026
50,12,127,Florida,Volusia County,1,7,25487,12897,12590
50,12,127,Florida,Volusia County,1,8,31193,15402,15791
50,12,127,Florida,Volusia County,1,9,32658,16110,16548
50,12,127,Florida,Volusia County,1,10,30379,14770,15609
50,12,127,Florida,Volusia County,1,11,28738,13914,14824
50,12,127,Florida,Volusia County,1,12,24566,11525,13041
50,12,127,Florida,Volusia County,1,13,23624,10873,12751
50,12,127,Florida,Volusia County,1,14,24721,11553,13168
50,12,127,Florida,Volusia County,1,15,25296,11494,13802
50,12,127,Florida,Volusia County,1,16,22076,9784,12292
50,12,127,Florida,Volusia County,1,17,14401,5959,8442
50,12,127,Florida,Volusia County,1,18,11317,3728,7589
50,12,127,Florida,Volusia County,2,0,443343,215361,227982
50,12,127,Florida,Volusia County,2,1,21657,11031,10626
50,12,127,Florida,Volusia County,2,2,25068,12801,12267
50,12,127,Florida,Volusia County,2,3,27076,14024,13052
50,12,127,Florida,Volusia County,2,4,27602,14497,13105
50,12,127,Florida,Volusia County,2,5,24727,13268,11459
50,12,127,Florida,Volusia County,2,6,22757,11731,11026
50,12,127,Florida,Volusia County,2,7,25487,12897,12590
50,12,127,Florida,Volusia County,2,8,31193,15402,15791
50,12,127,Florida,Volusia County,2,9,32658,16110,16548
50,12,127,Florida,Volusia County,2,10,30379,14770,15609
50,12,127,Florida,Volusia County,2,11,28738,13914,14824
50,12,127,Florida,Volusia County,2,12,24566,11525,13041
50,12,127,Florida,Volusia County,2,13,23622,10872,12750
50,12,127,Florida,Volusia County,2,14,24722,11553,13169
50,12,127,Florida,Volusia County,2,15,25297,11495,13802
50,12,127,Florida,Volusia County,2,16,22076,9784,12292
50,12,127,Florida,Volusia County,2,17,14401,5959,8442
50,12,127,Florida,Volusia County,2,18,11317,3728,7589
50,12,127,Florida,Volusia County,3,0,445060,216250,228810
50,12,127,Florida,Volusia County,3,1,21719,11059,10660
50,12,127,Florida,Volusia County,3,2,25020,12777,12243
50,12,127,Florida,Volusia County,3,3,27245,14108,13137
50,12,127,Florida,Volusia County,3,4,27702,14552,13150
50,12,127,Florida,Volusia County,3,5,25005,13422,11583
50,12,127,Florida,Volusia County,3,6,22663,11685,10978
50,12,127,Florida,Volusia County,3,7,25539,12923,12616
50,12,127,Florida,Volusia County,3,8,31146,15383,15763
50,12,127,Florida,Volusia County,3,9,32812,16187,16625
50,12,127,Florida,Volusia County,3,10,30622,14890,15732
50,12,127,Florida,Volusia County,3,11,29097,14091,15006
50,12,127,Florida,Volusia County,3,12,24769,11624,13145
50,12,127,Florida,Volusia County,3,13,23759,10938,12821
50,12,127,Florida,Volusia County,3,14,24635,11514,13121
50,12,127,Florida,Volusia County,3,15,25268,11499,13769
50,12,127,Florida,Volusia County,3,16,22126,9814,12312
50,12,127,Florida,Volusia County,3,17,14526,6019,8507
50,12,127,Florida,Volusia County,3,18,11407,3765,7642
50,12,127,Florida,Volusia County,4,0,451291,219582,231709
50,12,127,Florida,Volusia County,4,1,22251,11396,10855
50,12,127,Florida,Volusia County,4,2,24830,12673,12157
50,12,127,Florida,Volusia County,4,3,27717,14226,13491
50,12,127,Florida,Volusia County,4,4,27779,14743,13036
50,12,127,Florida,Volusia County,4,5,26647,14197,12450
50,12,127,Florida,Volusia County,4,6,22363,11603,10760
50,12,127,Florida,Volusia County,4,7,25494,12932,12562
50,12,127,Florida,Volusia County,4,8,30476,15086,15390
50,12,127,Florida,Volusia County,4,9,33626,16596,17030
50,12,127,Florida,Volusia County,4,10,31263,15201,16062
50,12,127,Florida,Volusia County,4,11,30908,14936,15972
50,12,127,Florida,Volusia County,4,12,25628,12118,13510
50,12,127,Florida,Volusia County,4,13,24137,11134,13003
50,12,127,Florida,Volusia County,4,14,24100,11175,12925
50,12,127,Florida,Volusia County,4,15,24846,11311,13535
50,12,127,Florida,Volusia County,4,16,22063,9879,12184
50,12,127,Florida,Volusia County,4,17,15357,6433,8924
50,12,127,Florida,Volusia County,4,18,11806,3943,7863
50,12,127,Florida,Volusia County,5,0,458400,223176,235224
50,12,127,Florida,Volusia County,5,1,22910,11746,11164
50,12,127,Florida,Volusia County,5,2,24448,12503,11945
50,12,127,Florida,Volusia County,5,3,28152,14430,13722
50,12,127,Florida,Volusia County,5,4,28120,14930,13190
50,12,127,Florida,Volusia County,5,5,27566,14559,13007
50,12,127,Florida,Volusia County,5,6,22669,11858,10811
50,12,127,Florida,Volusia County,5,7,25750,13036,12714
50,12,127,Florida,Volusia County,5,8,29643,14829,14814
50,12,127,Florida,Volusia County,5,9,34237,16874,17363
50,12,127,Florida,Volusia County,5,10,32441,15747,16694
50,12,127,Florida,Volusia County,5,11,30812,14795,16017
50,12,127,Florida,Volusia County,5,12,28084,13394,14690
50,12,127,Florida,Volusia County,5,13,24850,11478,13372
50,12,127,Florida,Volusia County,5,14,23977,11102,12875
50,12,127,Florida,Volusia County,5,15,24261,11120,13141
50,12,127,Florida,Volusia County,5,16,22227,9808,12419
50,12,127,Florida,Volusia County,5,17,16012,6752,9260
50,12,127,Florida,Volusia County,5,18,12241,4215,8026
50,12,127,Florida,Volusia County,6,0,465989,227332,238657
50,12,127,Florida,Volusia County,6,1,23509,12087,11422
50,12,127,Florida,Volusia County,6,2,24488,12496,11992
50,12,127,Florida,Volusia County,6,3,28290,14507,13783
50,12,127,Florida,Volusia County,6,4,28966,15384,13582
50,12,127,Florida,Volusia County,6,5,28401,14983,13418
50,12,127,Florida,Volusia County,6,6,24021,12753,11268
50,12,127,Florida,Volusia County,6,7,25648,13063,12585
50,12,127,Florida,Volusia County,6,8,29103,14588,14515
50,12,127,Florida,Volusia County,6,9,34278,16920,17358
50,12,127,Florida,Volusia County,6,10,33505,16317,17188
50,12,127,Florida,Volusia County,6,11,31403,15014,16389
50,12,127,Florida,Volusia County,6,12,29306,14031,15275
50,12,127,Florida,Volusia County,6,13,25917,12001,13916
50,12,127,Florida,Volusia County,6,14,24083,11088,12995
50,12,127,Florida,Volusia County,6,15,23717,10941,12776
50,12,127,Florida,Volusia County,6,16,22290,9801,12489
50,12,127,Florida,Volusia County,6,17,16229,6888,9341
50,12,127,Florida,Volusia County,6,18,12835,4470,8365
50,12,127,Florida,Volusia County,7,0,476695,232724,243971
50,12,127,Florida,Volusia County,7,1,24355,12452,11903
50,12,127,Florida,Volusia County,7,2,24797,12637,12160
50,12,127,Florida,Volusia County,7,3,28366,14559,13807
50,12,127,Florida,Volusia County,7,4,29786,15816,13970
50,12,127,Florida,Volusia County,7,5,28940,15129,13811
50,12,127,Florida,Volusia County,7,6,26120,14045,12075
50,12,127,Florida,Volusia County,7,7,25827,13219,12608
50,12,127,Florida,Volusia County,7,8,28622,14300,14322
50,12,127,Florida,Volusia County,7,9,34519,17137,17382
50,12,127,Florida,Volusia County,7,10,34597,16854,17743
50,12,127,Florida,Volusia County,7,11,32339,15426,16913
50,12,127,Florida,Volusia County,7,12,31096,14948,16148
50,12,127,Florida,Volusia County,7,13,27103,12546,14557
50,12,127,Florida,Volusia County,7,14,24577,11326,13251
50,12,127,Florida,Volusia County,7,15,23261,10680,12581
50,12,127,Florida,Volusia County,7,16,22068,9797,12271
50,12,127,Florida,Volusia County,7,17,16855,7092,9763
50,12,127,Florida,Volusia County,7,18,13467,4761,8706
50,12,127,Florida,Volusia County,8,0,485940,237585,248355
50,12,127,Florida,Volusia County,8,1,25157,12874,12283
50,12,127,Florida,Volusia County,8,2,25024,12768,12256
50,12,127,Florida,Volusia County,8,3,28456,14542,13914
50,12,127,Florida,Volusia County,8,4,30592,16275,14317
50,12,127,Florida,Volusia County,8,5,29198,15199,13999
50,12,127,Florida,Volusia County,8,6,28300,15226,13074
50,12,127,Florida,Volusia County,8,7,25859,13285,12574
50,12,127,Florida,Volusia County,8,8,28783,14576,14207
50,12,127,Florida,Volusia County,8,9,34475,17051,17424
50,12,127,Florida,Volusia County,8,10,35538,17331,18207
50,12,127,Florida,Volusia County,8,11,33401,16004,17397
50,12,127,Florida,Volusia County,8,12,32604,15578,17026
50,12,127,Florida,Volusia County,8,13,28072,13093,14979
50,12,127,Florida,Volusia County,8,14,24676,11362,13314
50,12,127,Florida,Volusia County,8,15,22882,10500,12382
50,12,127,Florida,Volusia County,8,16,21810,9693,12117
50,12,127,Florida,Volusia County,8,17,17069,7219,9850
50,12,127,Florida,Volusia County,8,18,14044,5009,9035
50,12,127,Florida,Volusia County,9,0,494302,241948,252354
50,12,127,Florida,Volusia County,9,1,25800,13140,12660
50,12,127,Florida,Volusia County,9,2,25907,13273,12634
50,12,127,Florida,Volusia County,9,3,28270,14439,13831
50,12,127,Florida,Volusia County,9,4,31258,16536,14722
50,12,127,Florida,Volusia County,9,5,29613,15546,14067
50,12,127,Florida,Volusia County,9,6,30704,16358,14346
50,12,127,Florida,Volusia County,9,7,26074,13491,12583
50,12,127,Florida,Volusia County,9,8,29239,14855,14384
50,12,127,Florida,Volusia County,9,9,33911,16825,17086
50,12,127,Florida,Volusia County,9,10,36564,17860,18704
50,12,127,Florida,Volusia County,9,11,34106,16354,17752
50,12,127,Florida,Volusia County,9,12,34283,16314,17969
50,12,127,Florida,Volusia County,9,13,28584,13416,15168
50,12,127,Florida,Volusia County,9,14,24525,11258,13267
50,12,127,Florida,Volusia County,9,15,22241,10128,12113
50,12,127,Florida,Volusia County,9,16,21349,9531,11818
50,12,127,Florida,Volusia County,9,17,17120,7286,9834
50,12,127,Florida,Volusia County,9,18,14754,5338,9416
50,12,127,Florida,Volusia County,10,0,498769,244434,254335
50,12,127,Florida,Volusia County,10,1,26220,13367,12853
50,12,127,Florida,Volusia County,10,2,26273,13472,12801
50,12,127,Florida,Volusia County,10,3,27820,14245,13575
50,12,127,Florida,Volusia County,10,4,31816,16818,14998
50,12,127,Florida,Volusia County,10,5,30124,15878,14246
50,12,127,Florida,Volusia County,10,6,31337,16643,14694
50,12,127,Florida,Volusia County,10,7,26269,13727,12542
50,12,127,Florida,Volusia County,10,8,29549,15000,14549
50,12,127,Florida,Volusia County,10,9,32745,16434,16311
50,12,127,Florida,Volusia County,10,10,36901,18006,18895
50,12,127,Florida,Volusia County,10,11,35069,16815,18254
50,12,127,Florida,Volusia County,10,12,33869,16031,17838
50,12,127,Florida,Volusia County,10,13,30341,14316,16025
50,12,127,Florida,Volusia County,10,14,25117,11521,13596
50,12,127,Florida,Volusia County,10,15,21925,9956,11969
50,12,127,Florida,Volusia County,10,16,20681,9276,11405
50,12,127,Florida,Volusia County,10,17,17246,7232,10014
50,12,127,Florida,Volusia County,10,18,15467,5697,9770
50,12,127,Florida,Volusia County,11,0,497344,243712,253632
50,12,127,Florida,Volusia County,11,1,26177,13377,12800
50,12,127,Florida,Volusia County,11,2,25880,13310,12570
50,12,127,Florida,Volusia County,11,3,27099,13845,13254
50,12,127,Florida,Volusia County,11,4,31386,16573,14813
50,12,127,Florida,Volusia County,11,5,29841,15680,14161
50,12,127,Florida,Volusia County,11,6,30931,16334,14597
50,12,127,Florida,Volusia County,11,7,26798,14166,12632
50,12,127,Florida,Volusia County,11,8,28660,14597,14063
50,12,127,Florida,Volusia County,11,9,31437,15787,15650
50,12,127,Florida,Volusia County,11,10,36292,17750,18542
50,12,127,Florida,Volusia County,11,11,35575,17118,18457
50,12,127,Florida,Volusia County,11,12,33702,15892,17810
50,12,127,Florida,Volusia County,11,13,31137,14719,16418
50,12,127,Florida,Volusia County,11,14,26233,12068,14165
50,12,127,Florida,Volusia County,11,15,22153,10002,12151
50,12,127,Florida,Volusia County,11,16,20358,9181,11177
50,12,127,Florida,Volusia County,11,17,17481,7325,10156
50,12,127,Florida,Volusia County,11,18,16204,5988,10216
50,12,127,Florida,Volusia County,12,0,495890,243056,252834
50,12,127,Florida,Volusia County,12,1,26097,13384,12713
50,12,127,Florida,Volusia County,12,2,25632,13115,12517
50,12,127,Florida,Volusia County,12,3,26538,13547,12991
50,12,127,Florida,Volusia County,12,4,30579,16183,14396
50,12,127,Florida,Volusia County,12,5,29610,15582,14028
50,12,127,Florida,Volusia County,12,6,30246,15816,14430
50,12,127,Florida,Volusia County,12,7,27550,14763,12787
50,12,127,Florida,Volusia County,12,8,28003,14344,13659
50,12,127,Florida,Volusia County,12,9,30170,15102,15068
50,12,127,Florida,Volusia County,12,10,35666,17533,18133
50,12,127,Florida,Volusia County,12,11,35770,17236,18534
50,12,127,Florida,Volusia County,12,12,33830,15943,17887
50,12,127,Florida,Volusia County,12,13,32185,15268,16917
50,12,127,Florida,Volusia County,12,14,27240,12497,14743
50,12,127,Florida,Volusia County,12,15,22512,10183,12329
50,12,127,Florida,Volusia County,12,16,19994,8969,11025
50,12,127,Florida,Volusia County,12,17,17312,7309,10003
50,12,127,Florida,Volusia County,12,18,16956,6282,10674
50,12,129,Florida,Wakulla County,1,0,22863,11836,11027
50,12,129,Florida,Wakulla County,1,1,1352,699,653
50,12,129,Florida,Wakulla County,1,2,1561,811,750
50,12,129,Florida,Wakulla County,1,3,1851,961,890
50,12,129,Florida,Wakulla County,1,4,1708,906,802
50,12,129,Florida,Wakulla County,1,5,1137,597,540
50,12,129,Florida,Wakulla County,1,6,1380,734,646
50,12,129,Florida,Wakulla County,1,7,1691,902,789
50,12,129,Florida,Wakulla County,1,8,2041,1015,1026
50,12,129,Florida,Wakulla County,1,9,2139,1145,994
50,12,129,Florida,Wakulla County,1,10,1810,952,858
50,12,129,Florida,Wakulla County,1,11,1598,862,736
50,12,129,Florida,Wakulla County,1,12,1235,630,605
50,12,129,Florida,Wakulla County,1,13,1010,493,517
50,12,129,Florida,Wakulla County,1,14,787,413,374
50,12,129,Florida,Wakulla County,1,15,679,345,334
50,12,129,Florida,Wakulla County,1,16,434,196,238
50,12,129,Florida,Wakulla County,1,17,242,90,152
50,12,129,Florida,Wakulla County,1,18,208,85,123
50,12,129,Florida,Wakulla County,2,0,22866,11838,11028
50,12,129,Florida,Wakulla County,2,1,1353,700,653
50,12,129,Florida,Wakulla County,2,2,1561,811,750
50,12,129,Florida,Wakulla County,2,3,1851,961,890
50,12,129,Florida,Wakulla County,2,4,1709,906,803
50,12,129,Florida,Wakulla County,2,5,1138,598,540
50,12,129,Florida,Wakulla County,2,6,1380,734,646
50,12,129,Florida,Wakulla County,2,7,1691,902,789
50,12,129,Florida,Wakulla County,2,8,2041,1015,1026
50,12,129,Florida,Wakulla County,2,9,2139,1145,994
50,12,129,Florida,Wakulla County,2,10,1810,952,858
50,12,129,Florida,Wakulla County,2,11,1598,862,736
50,12,129,Florida,Wakulla County,2,12,1235,630,605
50,12,129,Florida,Wakulla County,2,13,1010,493,517
50,12,129,Florida,Wakulla County,2,14,787,413,374
50,12,129,Florida,Wakulla County,2,15,679,345,334
50,12,129,Florida,Wakulla County,2,16,434,196,238
50,12,129,Florida,Wakulla County,2,17,242,90,152
50,12,129,Florida,Wakulla County,2,18,208,85,123
50,12,129,Florida,Wakulla County,3,0,22989,11899,11090
50,12,129,Florida,Wakulla County,3,1,1358,702,656
50,12,129,Florida,Wakulla County,3,2,1561,811,750
50,12,129,Florida,Wakulla County,3,3,1862,968,894
50,12,129,Florida,Wakulla County,3,4,1722,913,809
50,12,129,Florida,Wakulla County,3,5,1152,605,547
50,12,129,Florida,Wakulla County,3,6,1378,733,645
50,12,129,Florida,Wakulla County,3,7,1695,903,792
50,12,129,Florida,Wakulla County,3,8,2041,1015,1026
50,12,129,Florida,Wakulla County,3,9,2151,1150,1001
50,12,129,Florida,Wakulla County,3,10,1828,961,867
50,12,129,Florida,Wakulla County,3,11,1619,872,747
50,12,129,Florida,Wakulla County,3,12,1246,636,610
50,12,129,Florida,Wakulla County,3,13,1018,497,521
50,12,129,Florida,Wakulla County,3,14,787,413,374
50,12,129,Florida,Wakulla County,3,15,679,345,334
50,12,129,Florida,Wakulla County,3,16,436,197,239
50,12,129,Florida,Wakulla County,3,17,246,92,154
50,12,129,Florida,Wakulla County,3,18,210,86,124
50,12,129,Florida,Wakulla County,4,0,24046,12595,11451
50,12,129,Florida,Wakulla County,4,1,1414,720,694
50,12,129,Florida,Wakulla County,4,2,1577,838,739
50,12,129,Florida,Wakulla County,4,3,1873,957,916
50,12,129,Florida,Wakulla County,4,4,1754,935,819
50,12,129,Florida,Wakulla County,4,5,1315,712,603
50,12,129,Florida,Wakulla County,4,6,1446,784,662
50,12,129,Florida,Wakulla County,4,7,1785,996,789
50,12,129,Florida,Wakulla County,4,8,2117,1115,1002
50,12,129,Florida,Wakulla County,4,9,2269,1211,1058
50,12,129,Florida,Wakulla County,4,10,1971,1034,937
50,12,129,Florida,Wakulla County,4,11,1703,906,797
50,12,129,Florida,Wakulla County,4,12,1304,683,621
50,12,129,Florida,Wakulla County,4,13,1060,522,538
50,12,129,Florida,Wakulla County,4,14,799,418,381
50,12,129,Florida,Wakulla County,4,15,676,347,329
50,12,129,Florida,Wakulla County,4,16,492,228,264
50,12,129,Florida,Wakulla County,4,17,285,107,178
50,12,129,Florida,Wakulla County,4,18,206,82,124
50,12,129,Florida,Wakulla County,5,0,24929,13036,11893
50,12,129,Florida,Wakulla County,5,1,1460,745,715
50,12,129,Florida,Wakulla County,5,2,1565,816,749
50,12,129,Florida,Wakulla County,5,3,1880,990,890
50,12,129,Florida,Wakulla County,5,4,1804,944,860
50,12,129,Florida,Wakulla County,5,5,1483,805,678
50,12,129,Florida,Wakulla County,5,6,1429,771,658
50,12,129,Florida,Wakulla County,5,7,1805,993,812
50,12,129,Florida,Wakulla County,5,8,2117,1146,971
50,12,129,Florida,Wakulla County,5,9,2324,1234,1090
50,12,129,Florida,Wakulla County,5,10,2044,1061,983
50,12,129,Florida,Wakulla County,5,11,1751,936,815
50,12,129,Florida,Wakulla County,5,12,1433,737,696
50,12,129,Florida,Wakulla County,5,13,1106,549,557
50,12,129,Florida,Wakulla County,5,14,892,458,434
50,12,129,Florida,Wakulla County,5,15,753,399,354
50,12,129,Florida,Wakulla County,5,16,515,228,287
50,12,129,Florida,Wakulla County,5,17,346,132,214
50,12,129,Florida,Wakulla County,5,18,222,92,130
50,12,129,Florida,Wakulla County,6,0,25699,13522,12177
50,12,129,Florida,Wakulla County,6,1,1491,773,718
50,12,129,Florida,Wakulla County,6,2,1534,811,723
50,12,129,Florida,Wakulla County,6,3,1866,974,892
50,12,129,Florida,Wakulla County,6,4,1822,941,881
50,12,129,Florida,Wakulla County,6,5,1548,872,676
50,12,129,Florida,Wakulla County,6,6,1507,823,684
50,12,129,Florida,Wakulla County,6,7,1839,1044,795
50,12,129,Florida,Wakulla County,6,8,2204,1203,1001
50,12,129,Florida,Wakulla County,6,9,2316,1211,1105
50,12,129,Florida,Wakulla County,6,10,2110,1108,1002
50,12,129,Florida,Wakulla County,6,11,1783,942,841
50,12,129,Florida,Wakulla County,6,12,1517,796,721
50,12,129,Florida,Wakulla County,6,13,1196,598,598
50,12,129,Florida,Wakulla County,6,14,952,482,470
50,12,129,Florida,Wakulla County,6,15,838,441,397
50,12,129,Florida,Wakulla County,6,16,567,257,310
50,12,129,Florida,Wakulla County,6,17,369,139,230
50,12,129,Florida,Wakulla County,6,18,240,107,133
50,12,129,Florida,Wakulla County,7,0,26691,14050,12641
50,12,129,Florida,Wakulla County,7,1,1537,801,736
50,12,129,Florida,Wakulla County,7,2,1585,831,754
50,12,129,Florida,Wakulla County,7,3,1898,995,903
50,12,129,Florida,Wakulla County,7,4,1869,969,900
50,12,129,Florida,Wakulla County,7,5,1616,921,695
50,12,129,Florida,Wakulla County,7,6,1609,885,724
50,12,129,Florida,Wakulla County,7,7,1881,1069,812
50,12,129,Florida,Wakulla County,7,8,2173,1188,985
50,12,129,Florida,Wakulla County,7,9,2429,1263,1166
50,12,129,Florida,Wakulla County,7,10,2195,1175,1020
50,12,129,Florida,Wakulla County,7,11,1841,959,882
50,12,129,Florida,Wakulla County,7,12,1667,866,801
50,12,129,Florida,Wakulla County,7,13,1224,612,612
50,12,129,Florida,Wakulla County,7,14,1019,505,514
50,12,129,Florida,Wakulla County,7,15,863,447,416
50,12,129,Florida,Wakulla County,7,16,612,291,321
50,12,129,Florida,Wakulla County,7,17,425,167,258
50,12,129,Florida,Wakulla County,7,18,248,106,142
50,12,129,Florida,Wakulla County,8,0,27799,14628,13171
50,12,129,Florida,Wakulla County,8,1,1624,854,770
50,12,129,Florida,Wakulla County,8,2,1696,878,818
50,12,129,Florida,Wakulla County,8,3,1885,979,906
50,12,129,Florida,Wakulla County,8,4,1855,980,875
50,12,129,Florida,Wakulla County,8,5,1693,968,725
50,12,129,Florida,Wakulla County,8,6,1724,957,767
50,12,129,Florida,Wakulla County,8,7,1873,1057,816
50,12,129,Florida,Wakulla County,8,8,2214,1230,984
50,12,129,Florida,Wakulla County,8,9,2428,1253,1175
50,12,129,Florida,Wakulla County,8,10,2369,1250,1119
50,12,129,Florida,Wakulla County,8,11,1955,995,960
50,12,129,Florida,Wakulla County,8,12,1801,954,847
50,12,129,Florida,Wakulla County,8,13,1302,647,655
50,12,129,Florida,Wakulla County,8,14,1082,531,551
50,12,129,Florida,Wakulla County,8,15,871,446,425
50,12,129,Florida,Wakulla County,8,16,705,355,350
50,12,129,Florida,Wakulla County,8,17,436,178,258
50,12,129,Florida,Wakulla County,8,18,286,116,170
50,12,129,Florida,Wakulla County,9,0,29158,15489,13669
50,12,129,Florida,Wakulla County,9,1,1601,863,738
50,12,129,Florida,Wakulla County,9,2,1810,923,887
50,12,129,Florida,Wakulla County,9,3,1956,1033,923
50,12,129,Florida,Wakulla County,9,4,1873,979,894
50,12,129,Florida,Wakulla County,9,5,1700,997,703
50,12,129,Florida,Wakulla County,9,6,1906,1081,825
50,12,129,Florida,Wakulla County,9,7,2018,1149,869
50,12,129,Florida,Wakulla County,9,8,2244,1291,953
50,12,129,Florida,Wakulla County,9,9,2470,1335,1135
50,12,129,Florida,Wakulla County,9,10,2479,1297,1182
50,12,129,Florida,Wakulla County,9,11,2112,1067,1045
50,12,129,Florida,Wakulla County,9,12,1873,974,899
50,12,129,Florida,Wakulla County,9,13,1395,706,689
50,12,129,Florida,Wakulla County,9,14,1190,587,603
50,12,129,Florida,Wakulla County,9,15,941,475,466
50,12,129,Florida,Wakulla County,9,16,735,376,359
50,12,129,Florida,Wakulla County,9,17,521,225,296
50,12,129,Florida,Wakulla County,9,18,334,131,203
50,12,129,Florida,Wakulla County,10,0,30246,15966,14280
50,12,129,Florida,Wakulla County,10,1,1721,930,791
50,12,129,Florida,Wakulla County,10,2,1919,983,936
50,12,129,Florida,Wakulla County,10,3,1946,1013,933
50,12,129,Florida,Wakulla County,10,4,1923,1027,896
50,12,129,Florida,Wakulla County,10,5,1735,1000,735
50,12,129,Florida,Wakulla County,10,6,2040,1146,894
50,12,129,Florida,Wakulla County,10,7,2024,1133,891
50,12,129,Florida,Wakulla County,10,8,2302,1290,1012
50,12,129,Florida,Wakulla County,10,9,2515,1374,1141
50,12,129,Florida,Wakulla County,10,10,2458,1268,1190
50,12,129,Florida,Wakulla County,10,11,2161,1081,1080
50,12,129,Florida,Wakulla County,10,12,1948,1016,932
50,12,129,Florida,Wakulla County,10,13,1501,749,752
50,12,129,Florida,Wakulla County,10,14,1231,607,624
50,12,129,Florida,Wakulla County,10,15,1061,530,531
50,12,129,Florida,Wakulla County,10,16,817,430,387
50,12,129,Florida,Wakulla County,10,17,523,218,305
50,12,129,Florida,Wakulla County,10,18,421,171,250
50,12,129,Florida,Wakulla County,11,0,31142,16393,14749
50,12,129,Florida,Wakulla County,11,1,1781,945,836
50,12,129,Florida,Wakulla County,11,2,1957,1014,943
50,12,129,Florida,Wakulla County,11,3,1931,1014,917
50,12,129,Florida,Wakulla County,11,4,1980,1047,933
50,12,129,Florida,Wakulla County,11,5,1873,1043,830
50,12,129,Florida,Wakulla County,11,6,2133,1216,917
50,12,129,Florida,Wakulla County,11,7,2099,1172,927
50,12,129,Florida,Wakulla County,11,8,2326,1318,1008
50,12,129,Florida,Wakulla County,11,9,2478,1351,1127
50,12,129,Florida,Wakulla County,11,10,2480,1252,1228
50,12,129,Florida,Wakulla County,11,11,2268,1139,1129
50,12,129,Florida,Wakulla County,11,12,1966,1008,958
50,12,129,Florida,Wakulla County,11,13,1608,825,783
50,12,129,Florida,Wakulla County,11,14,1311,645,666
50,12,129,Florida,Wakulla County,11,15,1074,524,550
50,12,129,Florida,Wakulla County,11,16,900,466,434
50,12,129,Florida,Wakulla County,11,17,543,238,305
50,12,129,Florida,Wakulla County,11,18,434,176,258
50,12,129,Florida,Wakulla County,12,0,32815,17743,15072
50,12,129,Florida,Wakulla County,12,1,1769,936,833
50,12,129,Florida,Wakulla County,12,2,2005,1042,963
50,12,129,Florida,Wakulla County,12,3,1975,1031,944
50,12,129,Florida,Wakulla County,12,4,2036,1090,946
50,12,129,Florida,Wakulla County,12,5,2025,1180,845
50,12,129,Florida,Wakulla County,12,6,2341,1411,930
50,12,129,Florida,Wakulla County,12,7,2358,1406,952
50,12,129,Florida,Wakulla County,12,8,2554,1526,1028
50,12,129,Florida,Wakulla County,12,9,2598,1487,1111
50,12,129,Florida,Wakulla County,12,10,2585,1348,1237
50,12,129,Florida,Wakulla County,12,11,2347,1220,1127
50,12,129,Florida,Wakulla County,12,12,2004,1026,978
50,12,129,Florida,Wakulla County,12,13,1749,894,855
50,12,129,Florida,Wakulla County,12,14,1336,655,681
50,12,129,Florida,Wakulla County,12,15,1152,561,591
50,12,129,Florida,Wakulla County,12,16,913,467,446
50,12,129,Florida,Wakulla County,12,17,584,270,314
50,12,129,Florida,Wakulla County,12,18,484,193,291
50,12,131,Florida,Walton County,1,0,40601,20812,19789
50,12,131,Florida,Walton County,1,1,2158,1157,1001
50,12,131,Florida,Walton County,1,2,2520,1304,1216
50,12,131,Florida,Walton County,1,3,2560,1273,1287
50,12,131,Florida,Walton County,1,4,2464,1268,1196
50,12,131,Florida,Walton County,1,5,1992,1072,920
50,12,131,Florida,Walton County,1,6,2428,1351,1077
50,12,131,Florida,Walton County,1,7,2541,1384,1157
50,12,131,Florida,Walton County,1,8,3278,1720,1558
50,12,131,Florida,Walton County,1,9,3315,1779,1536
50,12,131,Florida,Walton County,1,10,3048,1598,1450
50,12,131,Florida,Walton County,1,11,2866,1458,1408
50,12,131,Florida,Walton County,1,12,2603,1241,1362
50,12,131,Florida,Walton County,1,13,2397,1193,1204
50,12,131,Florida,Walton County,1,14,2089,1062,1027
50,12,131,Florida,Walton County,1,15,1798,862,936
50,12,131,Florida,Walton County,1,16,1285,617,668
50,12,131,Florida,Walton County,1,17,696,286,410
50,12,131,Florida,Walton County,1,18,563,187,376
50,12,131,Florida,Walton County,2,0,40602,20813,19789
50,12,131,Florida,Walton County,2,1,2158,1157,1001
50,12,131,Florida,Walton County,2,2,2520,1304,1216
50,12,131,Florida,Walton County,2,3,2560,1273,1287
50,12,131,Florida,Walton County,2,4,2464,1268,1196
50,12,131,Florida,Walton County,2,5,1992,1072,920
50,12,131,Florida,Walton County,2,6,2428,1351,1077
50,12,131,Florida,Walton County,2,7,2541,1384,1157
50,12,131,Florida,Walton County,2,8,3279,1721,1558
50,12,131,Florida,Walton County,2,9,3315,1779,1536
50,12,131,Florida,Walton County,2,10,3048,1598,1450
50,12,131,Florida,Walton County,2,11,2866,1458,1408
50,12,131,Florida,Walton County,2,12,2603,1241,1362
50,12,131,Florida,Walton County,2,13,2397,1193,1204
50,12,131,Florida,Walton County,2,14,2089,1062,1027
50,12,131,Florida,Walton County,2,15,1798,862,936
50,12,131,Florida,Walton County,2,16,1285,617,668
50,12,131,Florida,Walton County,2,17,696,286,410
50,12,131,Florida,Walton County,2,18,563,187,376
50,12,131,Florida,Walton County,3,0,40819,20921,19898
50,12,131,Florida,Walton County,3,1,2167,1161,1006
50,12,131,Florida,Walton County,3,2,2516,1302,1214
50,12,131,Florida,Walton County,3,3,2578,1282,1296
50,12,131,Florida,Walton County,3,4,2477,1275,1202
50,12,131,Florida,Walton County,3,5,2020,1086,934
50,12,131,Florida,Walton County,3,6,2419,1347,1072
50,12,131,Florida,Walton County,3,7,2547,1387,1160
50,12,131,Florida,Walton County,3,8,3277,1721,1556
50,12,131,Florida,Walton County,3,9,3334,1787,1547
50,12,131,Florida,Walton County,3,10,3074,1611,1463
50,12,131,Florida,Walton County,3,11,2903,1477,1426
50,12,131,Florida,Walton County,3,12,2628,1253,1375
50,12,131,Florida,Walton County,3,13,2413,1200,1213
50,12,131,Florida,Walton County,3,14,2093,1064,1029
50,12,131,Florida,Walton County,3,15,1806,867,939
50,12,131,Florida,Walton County,3,16,1294,622,672
50,12,131,Florida,Walton County,3,17,705,290,415
50,12,131,Florida,Walton County,3,18,568,189,379
50,12,131,Florida,Walton County,4,0,42502,21761,20741
50,12,131,Florida,Walton County,4,1,2271,1199,1072
50,12,131,Florida,Walton County,4,2,2467,1300,1167
50,12,131,Florida,Walton County,4,3,2705,1346,1359
50,12,131,Florida,Walton County,4,4,2525,1286,1239
50,12,131,Florida,Walton County,4,5,2217,1206,1011
50,12,131,Florida,Walton County,4,6,2543,1407,1136
50,12,131,Florida,Walton County,4,7,2646,1449,1197
50,12,131,Florida,Walton County,4,8,3283,1714,1569
50,12,131,Florida,Walton County,4,9,3583,1922,1661
50,12,131,Florida,Walton County,4,10,3229,1671,1558
50,12,131,Florida,Walton County,4,11,3149,1593,1556
50,12,131,Florida,Walton County,4,12,2765,1322,1443
50,12,131,Florida,Walton County,4,13,2504,1258,1246
50,12,131,Florida,Walton County,4,14,2112,1056,1056
50,12,131,Florida,Walton County,4,15,1864,905,959
50,12,131,Florida,Walton County,4,16,1289,603,686
50,12,131,Florida,Walton County,4,17,751,329,422
50,12,131,Florida,Walton County,4,18,599,195,404
50,12,131,Florida,Walton County,5,0,44046,22504,21542
50,12,131,Florida,Walton County,5,1,2437,1282,1155
50,12,131,Florida,Walton County,5,2,2489,1330,1159
50,12,131,Florida,Walton County,5,3,2738,1364,1374
50,12,131,Florida,Walton County,5,4,2551,1292,1259
50,12,131,Florida,Walton County,5,5,2418,1284,1134
50,12,131,Florida,Walton County,5,6,2563,1451,1112
50,12,131,Florida,Walton County,5,7,2806,1518,1288
50,12,131,Florida,Walton County,5,8,3238,1675,1563
50,12,131,Florida,Walton County,5,9,3654,1983,1671
50,12,131,Florida,Walton County,5,10,3421,1728,1693
50,12,131,Florida,Walton County,5,11,3235,1640,1595
50,12,131,Florida,Walton County,5,12,3029,1460,1569
50,12,131,Florida,Walton County,5,13,2642,1310,1332
50,12,131,Florida,Walton County,5,14,2200,1091,1109
50,12,131,Florida,Walton County,5,15,1838,913,925
50,12,131,Florida,Walton County,5,16,1359,607,752
50,12,131,Florida,Walton County,5,17,825,378,447
50,12,131,Florida,Walton County,5,18,603,198,405
50,12,131,Florida,Walton County,6,0,45721,23353,22368
50,12,131,Florida,Walton County,6,1,2523,1325,1198
50,12,131,Florida,Walton County,6,2,2447,1277,1170
50,12,131,Florida,Walton County,6,3,2877,1464,1413
50,12,131,Florida,Walton County,6,4,2596,1322,1274
50,12,131,Florida,Walton County,6,5,2565,1379,1186
50,12,131,Florida,Walton County,6,6,2658,1488,1170
50,12,131,Florida,Walton County,6,7,3018,1642,1376
50,12,131,Florida,Walton County,6,8,3279,1698,1581
50,12,131,Florida,Walton County,6,9,3788,2018,1770
50,12,131,Florida,Walton County,6,10,3556,1816,1740
50,12,131,Florida,Walton County,6,11,3305,1698,1607
50,12,131,Florida,Walton County,6,12,3285,1576,1709
50,12,131,Florida,Walton County,6,13,2809,1375,1434
50,12,131,Florida,Walton County,6,14,2257,1100,1157
50,12,131,Florida,Walton County,6,15,1829,925,904
50,12,131,Florida,Walton County,6,16,1409,625,784
50,12,131,Florida,Walton County,6,17,886,412,474
50,12,131,Florida,Walton County,6,18,634,213,421
50,12,131,Florida,Walton County,7,0,47684,24368,23316
50,12,131,Florida,Walton County,7,1,2621,1329,1292
50,12,131,Florida,Walton County,7,2,2516,1346,1170
50,12,131,Florida,Walton County,7,3,2965,1510,1455
50,12,131,Florida,Walton County,7,4,2674,1359,1315
50,12,131,Florida,Walton County,7,5,2820,1518,1302
50,12,131,Florida,Walton County,7,6,2834,1552,1282
50,12,131,Florida,Walton County,7,7,3128,1736,1392
50,12,131,Florida,Walton County,7,8,3210,1696,1514
50,12,131,Florida,Walton County,7,9,4032,2118,1914
50,12,131,Florida,Walton County,7,10,3704,1904,1800
50,12,131,Florida,Walton County,7,11,3568,1823,1745
50,12,131,Florida,Walton County,7,12,3530,1704,1826
50,12,131,Florida,Walton County,7,13,2947,1418,1529
50,12,131,Florida,Walton County,7,14,2343,1140,1203
50,12,131,Florida,Walton County,7,15,1815,924,891
50,12,131,Florida,Walton County,7,16,1407,647,760
50,12,131,Florida,Walton County,7,17,912,410,502
50,12,131,Florida,Walton County,7,18,658,234,424
50,12,131,Florida,Walton County,8,0,49581,25292,24289
50,12,131,Florida,Walton County,8,1,2727,1382,1345
50,12,131,Florida,Walton County,8,2,2637,1398,1239
50,12,131,Florida,Walton County,8,3,2996,1551,1445
50,12,131,Florida,Walton County,8,4,2799,1410,1389
50,12,131,Florida,Walton County,8,5,2876,1501,1375
50,12,131,Florida,Walton County,8,6,3145,1750,1395
50,12,131,Florida,Walton County,8,7,3223,1746,1477
50,12,131,Florida,Walton County,8,8,3256,1765,1491
50,12,131,Florida,Walton County,8,9,3998,2058,1940
50,12,131,Florida,Walton County,8,10,3937,2042,1895
50,12,131,Florida,Walton County,8,11,3774,1909,1865
50,12,131,Florida,Walton County,8,12,3647,1777,1870
50,12,131,Florida,Walton County,8,13,3173,1512,1661
50,12,131,Florida,Walton County,8,14,2406,1171,1235
50,12,131,Florida,Walton County,8,15,1803,910,893
50,12,131,Florida,Walton County,8,16,1508,707,801
50,12,131,Florida,Walton County,8,17,973,443,530
50,12,131,Florida,Walton County,8,18,703,260,443
50,12,131,Florida,Walton County,9,0,51372,26151,25221
50,12,131,Florida,Walton County,9,1,2918,1498,1420
50,12,131,Florida,Walton County,9,2,2784,1455,1329
50,12,131,Florida,Walton County,9,3,2907,1528,1379
50,12,131,Florida,Walton County,9,4,2939,1483,1456
50,12,131,Florida,Walton County,9,5,2901,1497,1404
50,12,131,Florida,Walton County,9,6,3501,1948,1553
50,12,131,Florida,Walton County,9,7,3219,1733,1486
50,12,131,Florida,Walton County,9,8,3391,1838,1553
50,12,131,Florida,Walton County,9,9,3940,2014,1926
50,12,131,Florida,Walton County,9,10,4156,2155,2001
50,12,131,Florida,Walton County,9,11,3933,1968,1965
50,12,131,Florida,Walton County,9,12,3776,1834,1942
50,12,131,Florida,Walton County,9,13,3294,1564,1730
50,12,131,Florida,Walton County,9,14,2462,1216,1246
50,12,131,Florida,Walton County,9,15,1890,928,962
50,12,131,Florida,Walton County,9,16,1556,750,806
50,12,131,Florida,Walton County,9,17,1003,433,570
50,12,131,Florida,Walton County,9,18,802,309,493
50,12,131,Florida,Walton County,10,0,52664,26826,25838
50,12,131,Florida,Walton County,10,1,3065,1574,1491
50,12,131,Florida,Walton County,10,2,2890,1507,1383
50,12,131,Florida,Walton County,10,3,2920,1554,1366
50,12,131,Florida,Walton County,10,4,2931,1478,1453
50,12,131,Florida,Walton County,10,5,2926,1510,1416
50,12,131,Florida,Walton County,10,6,3850,2111,1739
50,12,131,Florida,Walton County,10,7,3216,1779,1437
50,12,131,Florida,Walton County,10,8,3498,1892,1606
50,12,131,Florida,Walton County,10,9,3868,1975,1893
50,12,131,Florida,Walton County,10,10,4187,2203,1984
50,12,131,Florida,Walton County,10,11,4074,1999,2075
50,12,131,Florida,Walton County,10,12,3791,1844,1947
50,12,131,Florida,Walton County,10,13,3478,1664,1814
50,12,131,Florida,Walton County,10,14,2588,1252,1336
50,12,131,Florida,Walton County,10,15,1961,963,998
50,12,131,Florida,Walton County,10,16,1516,742,774
50,12,131,Florida,Walton County,10,17,1040,433,607
50,12,131,Florida,Walton County,10,18,865,346,519
50,12,131,Florida,Walton County,11,0,53920,27435,26485
50,12,131,Florida,Walton County,11,1,3263,1683,1580
50,12,131,Florida,Walton County,11,2,2960,1539,1421
50,12,131,Florida,Walton County,11,3,2836,1479,1357
50,12,131,Florida,Walton County,11,4,2980,1539,1441
50,12,131,Florida,Walton County,11,5,2894,1498,1396
50,12,131,Florida,Walton County,11,6,3989,2192,1797
50,12,131,Florida,Walton County,11,7,3325,1817,1508
50,12,131,Florida,Walton County,11,8,3586,1944,1642
50,12,131,Florida,Walton County,11,9,3768,1921,1847
50,12,131,Florida,Walton County,11,10,4320,2241,2079
50,12,131,Florida,Walton County,11,11,4080,2029,2051
50,12,131,Florida,Walton County,11,12,3810,1883,1927
50,12,131,Florida,Walton County,11,13,3675,1744,1931
50,12,131,Florida,Walton County,11,14,2779,1328,1451
50,12,131,Florida,Walton County,11,15,2072,993,1079
50,12,131,Florida,Walton County,11,16,1523,751,772
50,12,131,Florida,Walton County,11,17,1123,468,655
50,12,131,Florida,Walton County,11,18,937,386,551
50,12,131,Florida,Walton County,12,0,55105,28038,27067
50,12,131,Florida,Walton County,12,1,3427,1786,1641
50,12,131,Florida,Walton County,12,2,2973,1498,1475
50,12,131,Florida,Walton County,12,3,2907,1550,1357
50,12,131,Florida,Walton County,12,4,3043,1574,1469
50,12,131,Florida,Walton County,12,5,2932,1510,1422
50,12,131,Florida,Walton County,12,6,4102,2263,1839
50,12,131,Florida,Walton County,12,7,3436,1839,1597
50,12,131,Florida,Walton County,12,8,3597,1988,1609
50,12,131,Florida,Walton County,12,9,3563,1847,1716
50,12,131,Florida,Walton County,12,10,4382,2243,2139
50,12,131,Florida,Walton County,12,11,4175,2090,2085
50,12,131,Florida,Walton County,12,12,3876,1908,1968
50,12,131,Florida,Walton County,12,13,3828,1835,1993
50,12,131,Florida,Walton County,12,14,2941,1388,1553
50,12,131,Florida,Walton County,12,15,2177,1029,1148
50,12,131,Florida,Walton County,12,16,1566,772,794
50,12,131,Florida,Walton County,12,17,1174,515,659
50,12,131,Florida,Walton County,12,18,1006,403,603
50,12,133,Florida,Washington County,1,0,20973,10783,10190
50,12,133,Florida,Washington County,1,1,1267,659,608
50,12,133,Florida,Washington County,1,2,1339,664,675
50,12,133,Florida,Washington County,1,3,1381,738,643
50,12,133,Florida,Washington County,1,4,1400,726,674
50,12,133,Florida,Washington County,1,5,1135,621,514
50,12,133,Florida,Washington County,1,6,1261,710,551
50,12,133,Florida,Washington County,1,7,1487,855,632
50,12,133,Florida,Washington County,1,8,1604,870,734
50,12,133,Florida,Washington County,1,9,1635,874,761
50,12,133,Florida,Washington County,1,10,1386,741,645
50,12,133,Florida,Washington County,1,11,1428,743,685
50,12,133,Florida,Washington County,1,12,1284,595,689
50,12,133,Florida,Washington County,1,13,1073,540,533
50,12,133,Florida,Washington County,1,14,970,475,495
50,12,133,Florida,Washington County,1,15,789,361,428
50,12,133,Florida,Washington County,1,16,645,284,361
50,12,133,Florida,Washington County,1,17,467,187,280
50,12,133,Florida,Washington County,1,18,422,140,282
50,12,133,Florida,Washington County,2,0,20973,10783,10190
50,12,133,Florida,Washington County,2,1,1267,659,608
50,12,133,Florida,Washington County,2,2,1339,664,675
50,12,133,Florida,Washington County,2,3,1381,738,643
50,12,133,Florida,Washington County,2,4,1400,726,674
50,12,133,Florida,Washington County,2,5,1135,621,514
50,12,133,Florida,Washington County,2,6,1261,710,551
50,12,133,Florida,Washington County,2,7,1487,855,632
50,12,133,Florida,Washington County,2,8,1604,870,734
50,12,133,Florida,Washington County,2,9,1635,874,761
50,12,133,Florida,Washington County,2,10,1386,741,645
50,12,133,Florida,Washington County,2,11,1428,743,685
50,12,133,Florida,Washington County,2,12,1284,595,689
50,12,133,Florida,Washington County,2,13,1073,540,533
50,12,133,Florida,Washington County,2,14,970,475,495
50,12,133,Florida,Washington County,2,15,789,361,428
50,12,133,Florida,Washington County,2,16,645,284,361
50,12,133,Florida,Washington County,2,17,467,187,280
50,12,133,Florida,Washington County,2,18,422,140,282
50,12,133,Florida,Washington County,3,0,21015,10807,10208
50,12,133,Florida,Washington County,3,1,1271,661,610
50,12,133,Florida,Washington County,3,2,1335,663,672
50,12,133,Florida,Washington County,3,3,1389,742,647
50,12,133,Florida,Washington County,3,4,1403,728,675
50,12,133,Florida,Washington County,3,5,1147,627,520
50,12,133,Florida,Washington County,3,6,1257,708,549
50,12,133,Florida,Washington County,3,7,1488,856,632
50,12,133,Florida,Washington County,3,8,1599,867,732
50,12,133,Florida,Washington County,3,9,1640,877,763
50,12,133,Florida,Washington County,3,10,1396,746,650
50,12,133,Florida,Washington County,3,11,1446,753,693
50,12,133,Florida,Washington County,3,12,1291,598,693
50,12,133,Florida,Washington County,3,13,1079,543,536
50,12,133,Florida,Washington County,3,14,960,470,490
50,12,133,Florida,Washington County,3,15,784,359,425
50,12,133,Florida,Washington County,3,16,640,282,358
50,12,133,Florida,Washington County,3,17,468,187,281
50,12,133,Florida,Washington County,3,18,422,140,282
50,12,133,Florida,Washington County,4,0,21251,10988,10263
50,12,133,Florida,Washington County,4,1,1243,648,595
50,12,133,Florida,Washington County,4,2,1328,654,674
50,12,133,Florida,Washington County,4,3,1415,753,662
50,12,133,Florida,Washington County,4,4,1421,735,686
50,12,133,Florida,Washington County,4,5,1179,663,516
50,12,133,Florida,Washington County,4,6,1244,717,527
50,12,133,Florida,Washington County,4,7,1480,851,629
50,12,133,Florida,Washington County,4,8,1694,943,751
50,12,133,Florida,Washington County,4,9,1649,871,778
50,12,133,Florida,Washington County,4,10,1474,801,673
50,12,133,Florida,Washington County,4,11,1496,771,725
50,12,133,Florida,Washington County,4,12,1317,617,700
50,12,133,Florida,Washington County,4,13,1076,540,536
50,12,133,Florida,Washington County,4,14,965,462,503
50,12,133,Florida,Washington County,4,15,745,359,386
50,12,133,Florida,Washington County,4,16,645,281,364
50,12,133,Florida,Washington County,4,17,443,171,272
50,12,133,Florida,Washington County,4,18,437,151,286
50,12,133,Florida,Washington County,5,0,21148,10925,10223
50,12,133,Florida,Washington County,5,1,1186,622,564
50,12,133,Florida,Washington County,5,2,1316,660,656
50,12,133,Florida,Washington County,5,3,1410,744,666
50,12,133,Florida,Washington County,5,4,1399,722,677
50,12,133,Florida,Washington County,5,5,1169,663,506
50,12,133,Florida,Washington County,5,6,1225,692,533
50,12,133,Florida,Washington County,5,7,1441,836,605
50,12,133,Florida,Washington County,5,8,1644,908,736
50,12,133,Florida,Washington County,5,9,1685,897,788
50,12,133,Florida,Washington County,5,10,1506,806,700
50,12,133,Florida,Washington County,5,11,1419,710,709
50,12,133,Florida,Washington County,5,12,1420,718,702
50,12,133,Florida,Washington County,5,13,1100,512,588
50,12,133,Florida,Washington County,5,14,935,453,482
50,12,133,Florida,Washington County,5,15,749,369,380
50,12,133,Florida,Washington County,5,16,632,278,354
50,12,133,Florida,Washington County,5,17,469,186,283
50,12,133,Florida,Washington County,5,18,443,149,294
50,12,133,Florida,Washington County,6,0,21299,11036,10263
50,12,133,Florida,Washington County,6,1,1164,630,534
50,12,133,Florida,Washington County,6,2,1307,659,648
50,12,133,Florida,Washington County,6,3,1444,729,715
50,12,133,Florida,Washington County,6,4,1362,726,636
50,12,133,Florida,Washington County,6,5,1201,697,504
50,12,133,Florida,Washington County,6,6,1255,703,552
50,12,133,Florida,Washington County,6,7,1430,830,600
50,12,133,Florida,Washington County,6,8,1605,903,702
50,12,133,Florida,Washington County,6,9,1709,931,778
50,12,133,Florida,Washington County,6,10,1594,819,775
50,12,133,Florida,Washington County,6,11,1415,726,689
50,12,133,Florida,Washington County,6,12,1426,710,716
50,12,133,Florida,Washington County,6,13,1164,545,619
50,12,133,Florida,Washington County,6,14,928,450,478
50,12,133,Florida,Washington County,6,15,773,380,393
50,12,133,Florida,Washington County,6,16,628,269,359
50,12,133,Florida,Washington County,6,17,456,187,269
50,12,133,Florida,Washington County,6,18,438,142,296
50,12,133,Florida,Washington County,7,0,21651,11247,10404
50,12,133,Florida,Washington County,7,1,1211,660,551
50,12,133,Florida,Washington County,7,2,1349,676,673
50,12,133,Florida,Washington County,7,3,1452,744,708
50,12,133,Florida,Washington County,7,4,1361,723,638
50,12,133,Florida,Washington County,7,5,1291,739,552
50,12,133,Florida,Washington County,7,6,1288,743,545
50,12,133,Florida,Washington County,7,7,1440,824,616
50,12,133,Florida,Washington County,7,8,1634,926,708
50,12,133,Florida,Washington County,7,9,1735,946,789
50,12,133,Florida,Washington County,7,10,1608,829,779
50,12,133,Florida,Washington County,7,11,1367,713,654
50,12,133,Florida,Washington County,7,12,1479,728,751
50,12,133,Florida,Washington County,7,13,1213,577,636
50,12,133,Florida,Washington County,7,14,945,451,494
50,12,133,Florida,Washington County,7,15,777,369,408
50,12,133,Florida,Washington County,7,16,600,262,338
50,12,133,Florida,Washington County,7,17,448,190,258
50,12,133,Florida,Washington County,7,18,453,147,306
50,12,133,Florida,Washington County,8,0,21822,11308,10514
50,12,133,Florida,Washington County,8,1,1216,635,581
50,12,133,Florida,Washington County,8,2,1367,708,659
50,12,133,Florida,Washington County,8,3,1404,703,701
50,12,133,Florida,Washington County,8,4,1393,754,639
50,12,133,Florida,Washington County,8,5,1211,692,519
50,12,133,Florida,Washington County,8,6,1412,797,615
50,12,133,Florida,Washington County,8,7,1367,792,575
50,12,133,Florida,Washington County,8,8,1658,958,700
50,12,133,Florida,Washington County,8,9,1701,899,802
50,12,133,Florida,Washington County,8,10,1694,891,803
50,12,133,Florida,Washington County,8,11,1399,711,688
50,12,133,Florida,Washington County,8,12,1484,752,732
50,12,133,Florida,Washington County,8,13,1280,576,704
50,12,133,Florida,Washington County,8,14,973,475,498
50,12,133,Florida,Washington County,8,15,751,358,393
50,12,133,Florida,Washington County,8,16,593,263,330
50,12,133,Florida,Washington County,8,17,450,192,258
50,12,133,Florida,Washington County,8,18,469,152,317
50,12,133,Florida,Washington County,9,0,22371,11592,10779
50,12,133,Florida,Washington County,9,1,1254,650,604
50,12,133,Florida,Washington County,9,2,1372,710,662
50,12,133,Florida,Washington County,9,3,1428,709,719
50,12,133,Florida,Washington County,9,4,1445,779,666
50,12,133,Florida,Washington County,9,5,1251,705,546
50,12,133,Florida,Washington County,9,6,1443,830,613
50,12,133,Florida,Washington County,9,7,1388,814,574
50,12,133,Florida,Washington County,9,8,1643,944,699
50,12,133,Florida,Washington County,9,9,1728,932,796
50,12,133,Florida,Washington County,9,10,1736,893,843
50,12,133,Florida,Washington County,9,11,1488,771,717
50,12,133,Florida,Washington County,9,12,1524,758,766
50,12,133,Florida,Washington County,9,13,1330,618,712
50,12,133,Florida,Washington County,9,14,1000,487,513
50,12,133,Florida,Washington County,9,15,788,363,425
50,12,133,Florida,Washington County,9,16,589,273,316
50,12,133,Florida,Washington County,9,17,485,199,286
50,12,133,Florida,Washington County,9,18,479,157,322
50,12,133,Florida,Washington County,10,0,22883,11945,10938
50,12,133,Florida,Washington County,10,1,1284,661,623
50,12,133,Florida,Washington County,10,2,1376,714,662
50,12,133,Florida,Washington County,10,3,1477,746,731
50,12,133,Florida,Washington County,10,4,1429,766,663
50,12,133,Florida,Washington County,10,5,1331,758,573
50,12,133,Florida,Washington County,10,6,1497,878,619
50,12,133,Florida,Washington County,10,7,1490,873,617
50,12,133,Florida,Washington County,10,8,1632,965,667
50,12,133,Florida,Washington County,10,9,1739,947,792
50,12,133,Florida,Washington County,10,10,1778,928,850
50,12,133,Florida,Washington County,10,11,1541,793,748
50,12,133,Florida,Washington County,10,12,1455,704,751
50,12,133,Florida,Washington County,10,13,1437,716,721
50,12,133,Florida,Washington County,10,14,1059,478,581
50,12,133,Florida,Washington County,10,15,773,365,408
50,12,133,Florida,Washington County,10,16,597,284,313
50,12,133,Florida,Washington County,10,17,483,198,285
50,12,133,Florida,Washington County,10,18,505,171,334
50,12,133,Florida,Washington County,11,0,23994,12875,11119
50,12,133,Florida,Washington County,11,1,1390,703,687
50,12,133,Florida,Washington County,11,2,1397,744,653
50,12,133,Florida,Washington County,11,3,1486,753,733
50,12,133,Florida,Washington County,11,4,1487,770,717
50,12,133,Florida,Washington County,11,5,1427,873,554
50,12,133,Florida,Washington County,11,6,1718,1064,654
50,12,133,Florida,Washington County,11,7,1675,1028,647
50,12,133,Florida,Washington County,11,8,1802,1119,683
50,12,133,Florida,Washington County,11,9,1764,1020,744
50,12,133,Florida,Washington County,11,10,1832,1008,824
50,12,133,Florida,Washington County,11,11,1623,817,806
50,12,133,Florida,Washington County,11,12,1457,729,728
50,12,133,Florida,Washington County,11,13,1428,700,728
50,12,133,Florida,Washington County,11,14,1134,518,616
50,12,133,Florida,Washington County,11,15,796,392,404
50,12,133,Florida,Washington County,11,16,610,283,327
50,12,133,Florida,Washington County,11,17,461,182,279
50,12,133,Florida,Washington County,11,18,507,172,335
50,12,133,Florida,Washington County,12,0,23916,12828,11088
50,12,133,Florida,Washington County,12,1,1410,702,708
50,12,133,Florida,Washington County,12,2,1325,714,611
50,12,133,Florida,Washington County,12,3,1499,755,744
50,12,133,Florida,Washington County,12,4,1476,773,703
50,12,133,Florida,Washington County,12,5,1409,863,546
50,12,133,Florida,Washington County,12,6,1695,1047,648
50,12,133,Florida,Washington County,12,7,1661,1037,624
50,12,133,Florida,Washington County,12,8,1781,1090,691
50,12,133,Florida,Washington County,12,9,1732,1007,725
50,12,133,Florida,Washington County,12,10,1839,1011,828
50,12,133,Florida,Washington County,12,11,1638,825,813
50,12,133,Florida,Washington County,12,12,1412,716,696
50,12,133,Florida,Washington County,12,13,1468,711,757
50,12,133,Florida,Washington County,12,14,1173,544,629
50,12,133,Florida,Washington County,12,15,828,398,430
50,12,133,Florida,Washington County,12,16,611,284,327
50,12,133,Florida,Washington County,12,17,453,184,269
50,12,133,Florida,Washington County,12,18,506,167,339
