SUMLEV,STATE,COUNTY,STNAME,CTYNAME,YEAR,AGEGRP,TOT_POP,TOT_MALE,TOT_FEMALE
50,6,1,California,Alameda County,1,0,1510271,740573,769698
50,6,1,California,Alameda County,1,1,97652,50259,47393
50,6,1,California,Alameda County,1,2,94546,48145,46401
50,6,1,California,Alameda County,1,3,91070,46403,44667
50,6,1,California,Alameda County,1,4,100394,51445,48949
50,6,1,California,Alameda County,1,5,107049,54515,52534
50,6,1,California,Alameda County,1,6,113597,56185,57412
50,6,1,California,Alameda County,1,7,114607,56256,58351
50,6,1,California,Alameda County,1,8,115275,57062,58213
50,6,1,California,Alameda County,1,9,112216,55959,56257
50,6,1,California,Alameda County,1,10,114111,56168,57943
50,6,1,California,Alameda County,1,11,108506,53431,55075
50,6,1,California,Alameda County,1,12,94648,45580,49068
50,6,1,California,Alameda County,1,13,78854,37509,41345
50,6,1,California,Alameda County,1,14,52663,24568,28095
50,6,1,California,Alameda County,1,15,37774,17060,20714
50,6,1,California,Alameda County,1,16,29185,12617,16568
50,6,1,California,Alameda County,1,17,23391,9144,14247
50,6,1,California,Alameda County,1,18,24733,8267,16466
50,6,1,California,Alameda County,2,0,1510258,740568,769690
50,6,1,California,Alameda County,2,1,97650,50257,47393
50,6,1,California,Alameda County,2,2,94546,48145,46401
50,6,1,California,Alameda County,2,3,91070,46403,44667
50,6,1,California,Alameda County,2,4,100394,51445,48949
50,6,1,California,Alameda County,2,5,107047,54515,52532
50,6,1,California,Alameda County,2,6,113597,56185,57412
50,6,1,California,Alameda County,2,7,114607,56257,58350
50,6,1,California,Alameda County,2,8,115273,57061,58212
50,6,1,California,Alameda County,2,9,112216,55959,56257
50,6,1,California,Alameda County,2,10,114109,56167,57942
50,6,1,California,Alameda County,2,11,108502,53429,55073
50,6,1,California,Alameda County,2,12,94648,45580,49068
50,6,1,California,Alameda County,2,13,78852,37508,41344
50,6,1,California,Alameda County,2,14,52663,24568,28095
50,6,1,California,Alameda County,2,15,37775,17061,20714
50,6,1,California,Alameda County,2,16,29185,12617,16568
50,6,1,California,Alameda County,2,17,23391,9144,14247
50,6,1,California,Alameda County,2,18,24733,8267,16466
50,6,1,California,Alameda County,3,0,1512986,741756,771230
50,6,1,California,Alameda County,3,1,97656,50198,47458
50,6,1,California,Alameda County,3,2,94491,48154,46337
50,6,1,California,Alameda County,3,3,90983,46396,44587
50,6,1,California,Alameda County,3,4,99690,51061,48629
50,6,1,California,Alameda County,3,5,107538,54592,52946
50,6,1,California,Alameda County,3,6,113575,56246,57329
50,6,1,California,Alameda County,3,7,114818,56339,58479
50,6,1,California,Alameda County,3,8,114905,56854,58051
50,6,1,California,Alameda County,3,9,112603,56139,56464
50,6,1,California,Alameda County,3,10,113877,56108,57769
50,6,1,California,Alameda County,3,11,108870,53598,55272
50,6,1,California,Alameda County,3,12,95301,45954,49347
50,6,1,California,Alameda County,3,13,79698,37859,41839
50,6,1,California,Alameda County,3,14,53350,24901,28449
50,6,1,California,Alameda County,3,15,38068,17200,20868
50,6,1,California,Alameda County,3,16,29248,12651,16597
50,6,1,California,Alameda County,3,17,23339,9173,14166
50,6,1,California,Alameda County,3,18,24976,8333,16643
50,6,1,California,Alameda County,4,0,1530915,750107,780808
50,6,1,California,Alameda County,4,1,97776,50116,47660
50,6,1,California,Alameda County,4,2,95091,48566,46525
50,6,1,California,Alameda County,4,3,91096,46527,44569
50,6,1,California,Alameda County,4,4,97340,49771,47569
50,6,1,California,Alameda County,4,5,109986,55355,54631
50,6,1,California,Alameda County,4,6,114835,57103,57732
50,6,1,California,Alameda County,4,7,117136,57516,59620
50,6,1,California,Alameda County,4,8,113912,56325,57587
50,6,1,California,Alameda County,4,9,114469,57012,57457
50,6,1,California,Alameda County,4,10,112966,55779,57187
50,6,1,California,Alameda County,4,11,110387,54271,56116
50,6,1,California,Alameda County,4,12,97845,47351,50494
50,6,1,California,Alameda County,4,13,83636,39559,44077
50,6,1,California,Alameda County,4,14,56094,26288,29806
50,6,1,California,Alameda County,4,15,39327,17701,21626
50,6,1,California,Alameda County,4,16,29814,12916,16898
50,6,1,California,Alameda County,4,17,23210,9240,13970
50,6,1,California,Alameda County,4,18,25995,8711,17284
50,6,1,California,Alameda County,5,0,1553764,760739,793025
50,6,1,California,Alameda County,5,1,97500,49848,47652
50,6,1,California,Alameda County,5,2,96716,49457,47259
50,6,1,California,Alameda County,5,3,91318,46635,44683
50,6,1,California,Alameda County,5,4,96368,49064,47304
50,6,1,California,Alameda County,5,5,110713,55705,55008
50,6,1,California,Alameda County,5,6,117090,58197,58893
50,6,1,California,Alameda County,5,7,121010,59370,61640
50,6,1,California,Alameda County,5,8,114868,56602,58266
50,6,1,California,Alameda County,5,9,116442,57919,58523
50,6,1,California,Alameda County,5,10,111738,55318,56420
50,6,1,California,Alameda County,5,11,111558,54796,56762
50,6,1,California,Alameda County,5,12,100471,48690,51781
50,6,1,California,Alameda County,5,13,84818,40116,44702
50,6,1,California,Alameda County,5,14,61744,28941,32803
50,6,1,California,Alameda County,5,15,41005,18477,22528
50,6,1,California,Alameda County,5,16,30390,13150,17240
50,6,1,California,Alameda County,5,17,23271,9362,13909
50,6,1,California,Alameda County,5,18,26744,9092,17652
50,6,1,California,Alameda County,6,0,1579593,773696,805897
50,6,1,California,Alameda County,6,1,97343,49794,47549
50,6,1,California,Alameda County,6,2,98244,50400,47844
50,6,1,California,Alameda County,6,3,92272,47100,45172
50,6,1,California,Alameda County,6,4,95483,48356,47127
50,6,1,California,Alameda County,6,5,110221,55288,54933
50,6,1,California,Alameda County,6,6,121471,60640,60831
50,6,1,California,Alameda County,6,7,125804,61857,63947
50,6,1,California,Alameda County,6,8,116630,57633,58997
50,6,1,California,Alameda County,6,9,117453,58206,59247
50,6,1,California,Alameda County,6,10,110793,55141,55652
50,6,1,California,Alameda County,6,11,112739,55259,57480
50,6,1,California,Alameda County,6,12,103074,50169,52905
50,6,1,California,Alameda County,6,13,86622,40839,45783
50,6,1,California,Alameda County,6,14,65843,30775,35068
50,6,1,California,Alameda County,6,15,43426,19752,23674
50,6,1,California,Alameda County,6,16,31317,13585,17732
50,6,1,California,Alameda County,6,17,23453,9532,13921
50,6,1,California,Alameda County,6,18,27405,9370,18035
50,6,1,California,Alameda County,7,0,1607792,787690,820102
50,6,1,California,Alameda County,7,1,97784,49975,47809
50,6,1,California,Alameda County,7,2,98734,50619,48115
50,6,1,California,Alameda County,7,3,93637,47593,46044
50,6,1,California,Alameda County,7,4,94535,47746,46789
50,6,1,California,Alameda County,7,5,108781,54624,54157
50,6,1,California,Alameda County,7,6,127951,63949,64002
50,6,1,California,Alameda County,7,7,130277,64057,66220
50,6,1,California,Alameda County,7,8,119580,59415,60165
50,6,1,California,Alameda County,7,9,118063,58393,59670
50,6,1,California,Alameda County,7,10,110570,55198,55372
50,6,1,California,Alameda County,7,11,113955,55825,58130
50,6,1,California,Alameda County,7,12,105038,51191,53847
50,6,1,California,Alameda County,7,13,88763,42025,46738
50,6,1,California,Alameda County,7,14,69840,32568,37272
50,6,1,California,Alameda County,7,15,45794,20899,24895
50,6,1,California,Alameda County,7,16,32518,14230,18288
50,6,1,California,Alameda County,7,17,23864,9728,14136
50,6,1,California,Alameda County,7,18,28108,9655,18453
50,6,1,California,Alameda County,8,0,1634538,801625,832913
50,6,1,California,Alameda County,8,1,98204,50230,47974
50,6,1,California,Alameda County,8,2,99183,50663,48520
50,6,1,California,Alameda County,8,3,94356,48080,46276
50,6,1,California,Alameda County,8,4,94196,47469,46727
50,6,1,California,Alameda County,8,5,105870,53252,52618
50,6,1,California,Alameda County,8,6,134170,67079,67091
50,6,1,California,Alameda County,8,7,134289,66453,67836
50,6,1,California,Alameda County,8,8,124143,61889,62254
50,6,1,California,Alameda County,8,9,117665,58248,59417
50,6,1,California,Alameda County,8,10,112553,56121,56432
50,6,1,California,Alameda County,8,11,113096,55575,57521
50,6,1,California,Alameda County,8,12,106810,52093,54717
50,6,1,California,Alameda County,8,13,91135,43418,47717
50,6,1,California,Alameda County,8,14,73734,34273,39461
50,6,1,California,Alameda County,8,15,48364,22010,26354
50,6,1,California,Alameda County,8,16,33675,14820,18855
50,6,1,California,Alameda County,8,17,24300,10016,14284
50,6,1,California,Alameda County,8,18,28795,9936,18859
50,6,1,California,Alameda County,9,0,1650950,810926,840024
50,6,1,California,Alameda County,9,1,97714,50145,47569
50,6,1,California,Alameda County,9,2,98487,50272,48215
50,6,1,California,Alameda County,9,3,94572,48277,46295
50,6,1,California,Alameda County,9,4,94028,47440,46588
50,6,1,California,Alameda County,9,5,103085,51822,51263
50,6,1,California,Alameda County,9,6,138138,69130,69008
50,6,1,California,Alameda County,9,7,137575,68556,69019
50,6,1,California,Alameda County,9,8,127698,63676,64022
50,6,1,California,Alameda County,9,9,116924,58025,58899
50,6,1,California,Alameda County,9,10,114035,56920,57115
50,6,1,California,Alameda County,9,11,111350,54936,56414
50,6,1,California,Alameda County,9,12,107458,52387,55071
50,6,1,California,Alameda County,9,13,93117,44676,48441
50,6,1,California,Alameda County,9,14,76787,35504,41283
50,6,1,California,Alameda County,9,15,50892,23232,27660
50,6,1,California,Alameda County,9,16,34717,15277,19440
50,6,1,California,Alameda County,9,17,24917,10358,14559
50,6,1,California,Alameda County,9,18,29456,10293,19163
50,6,1,California,Alameda County,10,0,1660196,816390,843806
50,6,1,California,Alameda County,10,1,97417,49956,47461
50,6,1,California,Alameda County,10,2,97027,49523,47504
50,6,1,California,Alameda County,10,3,95423,48797,46626
50,6,1,California,Alameda County,10,4,93698,47363,46335
50,6,1,California,Alameda County,10,5,101025,50638,50387
50,6,1,California,Alameda County,10,6,138556,69664,68892
50,6,1,California,Alameda County,10,7,139161,69745,69416
50,6,1,California,Alameda County,10,8,131046,65371,65675
50,6,1,California,Alameda County,10,9,117039,58117,58922
50,6,1,California,Alameda County,10,10,114668,57186,57482
50,6,1,California,Alameda County,10,11,108953,53975,54978
50,6,1,California,Alameda County,10,12,107469,52451,55018
50,6,1,California,Alameda County,10,13,94573,45562,49011
50,6,1,California,Alameda County,10,14,77261,35709,41552
50,6,1,California,Alameda County,10,15,55347,25227,30120
50,6,1,California,Alameda County,10,16,36201,15955,20246
50,6,1,California,Alameda County,10,17,25369,10601,14768
50,6,1,California,Alameda County,10,18,29963,10550,19413
50,6,1,California,Alameda County,11,0,1666756,820231,846525
50,6,1,California,Alameda County,11,1,96200,49150,47050
50,6,1,California,Alameda County,11,2,95647,48853,46794
50,6,1,California,Alameda County,11,3,95537,48995,46542
50,6,1,California,Alameda County,11,4,93863,47471,46392
50,6,1,California,Alameda County,11,5,98916,49325,49591
50,6,1,California,Alameda County,11,6,136995,69023,67972
50,6,1,California,Alameda County,11,7,141561,71139,70422
50,6,1,California,Alameda County,11,8,134206,67299,66907
50,6,1,California,Alameda County,11,9,117384,58384,59000
50,6,1,California,Alameda County,11,10,114761,57104,57657
50,6,1,California,Alameda County,11,11,106889,53273,53616
50,6,1,California,Alameda County,11,12,107283,52317,54966
50,6,1,California,Alameda County,11,13,95952,46368,49584
50,6,1,California,Alameda County,11,14,78261,36193,42068
50,6,1,California,Alameda County,11,15,58486,26656,31830
50,6,1,California,Alameda County,11,16,38139,16867,21272
50,6,1,California,Alameda County,11,17,26099,10964,15135
50,6,1,California,Alameda County,11,18,30577,10850,19727
50,6,1,California,Alameda County,12,0,1671329,823247,848082
50,6,1,California,Alameda County,12,1,94728,48564,46164
50,6,1,California,Alameda County,12,2,94989,48552,46437
50,6,1,California,Alameda County,12,3,95016,48747,46269
50,6,1,California,Alameda County,12,4,94615,47648,46967
50,6,1,California,Alameda County,12,5,96695,48154,48541
50,6,1,California,Alameda County,12,6,134297,67872,66425
50,6,1,California,Alameda County,12,7,145323,73361,71962
50,6,1,California,Alameda County,12,8,136931,68596,68335
50,6,1,California,Alameda County,12,9,118118,59119,58999
50,6,1,California,Alameda County,12,10,113309,56330,56979
50,6,1,California,Alameda County,12,11,105523,52649,52874
50,6,1,California,Alameda County,12,12,106763,52094,54669
50,6,1,California,Alameda County,12,13,96259,46583,49676
50,6,1,California,Alameda County,12,14,79436,36889,42547
50,6,1,California,Alameda County,12,15,61328,27877,33451
50,6,1,California,Alameda County,12,16,39927,17700,22227
50,6,1,California,Alameda County,12,17,26863,11364,15499
50,6,1,California,Alameda County,12,18,31209,11148,20061
50,6,3,California,Alpine County,1,0,1175,606,569
50,6,3,California,Alpine County,1,1,71,40,31
50,6,3,California,Alpine County,1,2,80,36,44
50,6,3,California,Alpine County,1,3,69,26,43
50,6,3,California,Alpine County,1,4,55,29,26
50,6,3,California,Alpine County,1,5,51,31,20
50,6,3,California,Alpine County,1,6,50,22,28
50,6,3,California,Alpine County,1,7,47,20,27
50,6,3,California,Alpine County,1,8,54,34,20
50,6,3,California,Alpine County,1,9,82,40,42
50,6,3,California,Alpine County,1,10,102,52,50
50,6,3,California,Alpine County,1,11,113,59,54
50,6,3,California,Alpine County,1,12,125,70,55
50,6,3,California,Alpine County,1,13,110,57,53
50,6,3,California,Alpine County,1,14,65,37,28
50,6,3,California,Alpine County,1,15,44,20,24
50,6,3,California,Alpine County,1,16,31,21,10
50,6,3,California,Alpine County,1,17,20,8,12
50,6,3,California,Alpine County,1,18,6,4,2
50,6,3,California,Alpine County,2,0,1175,606,569
50,6,3,California,Alpine County,2,1,71,40,31
50,6,3,California,Alpine County,2,2,80,36,44
50,6,3,California,Alpine County,2,3,69,26,43
50,6,3,California,Alpine County,2,4,55,29,26
50,6,3,California,Alpine County,2,5,51,31,20
50,6,3,California,Alpine County,2,6,50,22,28
50,6,3,California,Alpine County,2,7,47,20,27
50,6,3,California,Alpine County,2,8,54,34,20
50,6,3,California,Alpine County,2,9,82,40,42
50,6,3,California,Alpine County,2,10,102,52,50
50,6,3,California,Alpine County,2,11,113,59,54
50,6,3,California,Alpine County,2,12,125,70,55
50,6,3,California,Alpine County,2,13,110,57,53
50,6,3,California,Alpine County,2,14,65,37,28
50,6,3,California,Alpine County,2,15,44,20,24
50,6,3,California,Alpine County,2,16,31,21,10
50,6,3,California,Alpine County,2,17,20,8,12
50,6,3,California,Alpine County,2,18,6,4,2
50,6,3,California,Alpine County,3,0,1161,600,561
50,6,3,California,Alpine County,3,1,69,39,30
50,6,3,California,Alpine County,3,2,82,38,44
50,6,3,California,Alpine County,3,3,67,25,42
50,6,3,California,Alpine County,3,4,55,28,27
50,6,3,California,Alpine County,3,5,51,31,20
50,6,3,California,Alpine County,3,6,48,21,27
50,6,3,California,Alpine County,3,7,48,22,26
50,6,3,California,Alpine County,3,8,51,31,20
50,6,3,California,Alpine County,3,9,80,40,40
50,6,3,California,Alpine County,3,10,98,50,48
50,6,3,California,Alpine County,3,11,111,57,54
50,6,3,California,Alpine County,3,12,127,73,54
50,6,3,California,Alpine County,3,13,108,54,54
50,6,3,California,Alpine County,3,14,65,37,28
50,6,3,California,Alpine County,3,15,42,21,21
50,6,3,California,Alpine County,3,16,31,20,11
50,6,3,California,Alpine County,3,17,22,9,13
50,6,3,California,Alpine County,3,18,6,4,2
50,6,3,California,Alpine County,4,0,1093,566,527
50,6,3,California,Alpine County,4,1,49,22,27
50,6,3,California,Alpine County,4,2,70,38,32
50,6,3,California,Alpine County,4,3,59,26,33
50,6,3,California,Alpine County,4,4,52,23,29
50,6,3,California,Alpine County,4,5,43,26,17
50,6,3,California,Alpine County,4,6,51,26,25
50,6,3,California,Alpine County,4,7,42,20,22
50,6,3,California,Alpine County,4,8,47,28,19
50,6,3,California,Alpine County,4,9,75,39,36
50,6,3,California,Alpine County,4,10,91,48,43
50,6,3,California,Alpine County,4,11,106,55,51
50,6,3,California,Alpine County,4,12,121,68,53
50,6,3,California,Alpine County,4,13,120,58,62
50,6,3,California,Alpine County,4,14,65,35,30
50,6,3,California,Alpine County,4,15,36,19,17
50,6,3,California,Alpine County,4,16,36,20,16
50,6,3,California,Alpine County,4,17,26,14,12
50,6,3,California,Alpine County,4,18,4,1,3
50,6,3,California,Alpine County,5,0,1110,583,527
50,6,3,California,Alpine County,5,1,47,26,21
50,6,3,California,Alpine County,5,2,86,44,42
50,6,3,California,Alpine County,5,3,72,34,38
50,6,3,California,Alpine County,5,4,54,27,27
50,6,3,California,Alpine County,5,5,45,24,21
50,6,3,California,Alpine County,5,6,52,28,24
50,6,3,California,Alpine County,5,7,41,22,19
50,6,3,California,Alpine County,5,8,55,34,21
50,6,3,California,Alpine County,5,9,69,31,38
50,6,3,California,Alpine County,5,10,85,47,38
50,6,3,California,Alpine County,5,11,97,52,45
50,6,3,California,Alpine County,5,12,116,69,47
50,6,3,California,Alpine County,5,13,106,50,56
50,6,3,California,Alpine County,5,14,77,41,36
50,6,3,California,Alpine County,5,15,35,17,18
50,6,3,California,Alpine County,5,16,43,23,20
50,6,3,California,Alpine County,5,17,21,11,10
50,6,3,California,Alpine County,5,18,9,3,6
50,6,3,California,Alpine County,6,0,1128,590,538
50,6,3,California,Alpine County,6,1,39,22,17
50,6,3,California,Alpine County,6,2,80,36,44
50,6,3,California,Alpine County,6,3,80,45,35
50,6,3,California,Alpine County,6,4,66,33,33
50,6,3,California,Alpine County,6,5,51,30,21
50,6,3,California,Alpine County,6,6,55,28,27
50,6,3,California,Alpine County,6,7,38,21,17
50,6,3,California,Alpine County,6,8,46,25,21
50,6,3,California,Alpine County,6,9,68,36,32
50,6,3,California,Alpine County,6,10,75,33,42
50,6,3,California,Alpine County,6,11,102,61,41
50,6,3,California,Alpine County,6,12,111,63,48
50,6,3,California,Alpine County,6,13,108,52,56
50,6,3,California,Alpine County,6,14,90,44,46
50,6,3,California,Alpine County,6,15,38,21,17
50,6,3,California,Alpine County,6,16,45,23,22
50,6,3,California,Alpine County,6,17,25,14,11
50,6,3,California,Alpine County,6,18,11,3,8
50,6,3,California,Alpine County,7,0,1080,552,528
50,6,3,California,Alpine County,7,1,34,16,18
50,6,3,California,Alpine County,7,2,72,30,42
50,6,3,California,Alpine County,7,3,72,41,31
50,6,3,California,Alpine County,7,4,68,33,35
50,6,3,California,Alpine County,7,5,47,29,18
50,6,3,California,Alpine County,7,6,48,29,19
50,6,3,California,Alpine County,7,7,42,22,20
50,6,3,California,Alpine County,7,8,47,19,28
50,6,3,California,Alpine County,7,9,67,38,29
50,6,3,California,Alpine County,7,10,68,30,38
50,6,3,California,Alpine County,7,11,96,56,40
50,6,3,California,Alpine County,7,12,98,49,49
50,6,3,California,Alpine County,7,13,106,54,52
50,6,3,California,Alpine County,7,14,97,48,49
50,6,3,California,Alpine County,7,15,46,23,23
50,6,3,California,Alpine County,7,16,36,17,19
50,6,3,California,Alpine County,7,17,23,15,8
50,6,3,California,Alpine County,7,18,13,3,10
50,6,3,California,Alpine County,8,0,1077,563,514
50,6,3,California,Alpine County,8,1,39,17,22
50,6,3,California,Alpine County,8,2,62,30,32
50,6,3,California,Alpine County,8,3,68,40,28
50,6,3,California,Alpine County,8,4,63,31,32
50,6,3,California,Alpine County,8,5,54,34,20
50,6,3,California,Alpine County,8,6,60,37,23
50,6,3,California,Alpine County,8,7,36,16,20
50,6,3,California,Alpine County,8,8,42,20,22
50,6,3,California,Alpine County,8,9,58,30,28
50,6,3,California,Alpine County,8,10,76,40,36
50,6,3,California,Alpine County,8,11,97,53,44
50,6,3,California,Alpine County,8,12,92,47,45
50,6,3,California,Alpine County,8,13,106,60,46
50,6,3,California,Alpine County,8,14,96,44,52
50,6,3,California,Alpine County,8,15,55,28,27
50,6,3,California,Alpine County,8,16,32,14,18
50,6,3,California,Alpine County,8,17,24,17,7
50,6,3,California,Alpine County,8,18,17,5,12
50,6,3,California,Alpine County,9,0,1047,554,493
50,6,3,California,Alpine County,9,1,34,21,13
50,6,3,California,Alpine County,9,2,56,22,34
50,6,3,California,Alpine County,9,3,62,37,25
50,6,3,California,Alpine County,9,4,60,28,32
50,6,3,California,Alpine County,9,5,54,31,23
50,6,3,California,Alpine County,9,6,56,33,23
50,6,3,California,Alpine County,9,7,42,20,22
50,6,3,California,Alpine County,9,8,31,14,17
50,6,3,California,Alpine County,9,9,43,25,18
50,6,3,California,Alpine County,9,10,88,47,41
50,6,3,California,Alpine County,9,11,82,47,35
50,6,3,California,Alpine County,9,12,100,51,49
50,6,3,California,Alpine County,9,13,101,60,41
50,6,3,California,Alpine County,9,14,108,53,55
50,6,3,California,Alpine County,9,15,55,26,29
50,6,3,California,Alpine County,9,16,26,14,12
50,6,3,California,Alpine County,9,17,28,17,11
50,6,3,California,Alpine County,9,18,21,8,13
50,6,3,California,Alpine County,10,0,1111,606,505
50,6,3,California,Alpine County,10,1,40,28,12
50,6,3,California,Alpine County,10,2,52,25,27
50,6,3,California,Alpine County,10,3,73,43,30
50,6,3,California,Alpine County,10,4,68,34,34
50,6,3,California,Alpine County,10,5,62,40,22
50,6,3,California,Alpine County,10,6,64,36,28
50,6,3,California,Alpine County,10,7,50,27,23
50,6,3,California,Alpine County,10,8,40,22,18
50,6,3,California,Alpine County,10,9,50,25,25
50,6,3,California,Alpine County,10,10,72,39,33
50,6,3,California,Alpine County,10,11,78,42,36
50,6,3,California,Alpine County,10,12,111,61,50
50,6,3,California,Alpine County,10,13,97,56,41
50,6,3,California,Alpine County,10,14,108,56,52
50,6,3,California,Alpine County,10,15,67,33,34
50,6,3,California,Alpine County,10,16,29,14,15
50,6,3,California,Alpine County,10,17,28,16,12
50,6,3,California,Alpine County,10,18,22,9,13
50,6,3,California,Alpine County,11,0,1089,582,507
50,6,3,California,Alpine County,11,1,44,26,18
50,6,3,California,Alpine County,11,2,36,18,18
50,6,3,California,Alpine County,11,3,67,35,32
50,6,3,California,Alpine County,11,4,68,37,31
50,6,3,California,Alpine County,11,5,60,34,26
50,6,3,California,Alpine County,11,6,54,34,20
50,6,3,California,Alpine County,11,7,51,29,22
50,6,3,California,Alpine County,11,8,35,22,13
50,6,3,California,Alpine County,11,9,46,18,28
50,6,3,California,Alpine County,11,10,62,35,27
50,6,3,California,Alpine County,11,11,69,29,40
50,6,3,California,Alpine County,11,12,115,69,46
50,6,3,California,Alpine County,11,13,104,59,45
50,6,3,California,Alpine County,11,14,115,58,57
50,6,3,California,Alpine County,11,15,74,34,40
50,6,3,California,Alpine County,11,16,35,19,16
50,6,3,California,Alpine County,11,17,26,14,12
50,6,3,California,Alpine County,11,18,28,12,16
50,6,3,California,Alpine County,12,0,1129,609,520
50,6,3,California,Alpine County,12,1,49,27,22
50,6,3,California,Alpine County,12,2,41,17,24
50,6,3,California,Alpine County,12,3,64,38,26
50,6,3,California,Alpine County,12,4,73,42,31
50,6,3,California,Alpine County,12,5,71,34,37
50,6,3,California,Alpine County,12,6,62,42,20
50,6,3,California,Alpine County,12,7,53,28,25
50,6,3,California,Alpine County,12,8,43,25,18
50,6,3,California,Alpine County,12,9,48,25,23
50,6,3,California,Alpine County,12,10,62,28,34
50,6,3,California,Alpine County,12,11,61,25,36
50,6,3,California,Alpine County,12,12,90,63,27
50,6,3,California,Alpine County,12,13,114,58,56
50,6,3,California,Alpine County,12,14,118,68,50
50,6,3,California,Alpine County,12,15,84,42,42
50,6,3,California,Alpine County,12,16,43,20,23
50,6,3,California,Alpine County,12,17,24,13,11
50,6,3,California,Alpine County,12,18,29,14,15
50,6,5,California,Amador County,1,0,38091,20749,17342
50,6,5,California,Amador County,1,1,1431,697,734
50,6,5,California,Amador County,1,2,1655,819,836
50,6,5,California,Amador County,1,3,1881,934,947
50,6,5,California,Amador County,1,4,2288,1341,947
50,6,5,California,Amador County,1,5,1648,996,652
50,6,5,California,Amador County,1,6,1778,1065,713
50,6,5,California,Amador County,1,7,1862,1186,676
50,6,5,California,Amador County,1,8,2048,1267,781
50,6,5,California,Amador County,1,9,2470,1572,898
50,6,5,California,Amador County,1,10,3114,1848,1266
50,6,5,California,Amador County,1,11,3255,1795,1460
50,6,5,California,Amador County,1,12,3405,1731,1674
50,6,5,California,Amador County,1,13,3391,1708,1683
50,6,5,California,Amador County,1,14,2533,1297,1236
50,6,5,California,Amador County,1,15,1922,955,967
50,6,5,California,Amador County,1,16,1312,643,669
50,6,5,California,Amador County,1,17,1096,501,595
50,6,5,California,Amador County,1,18,1002,394,608
50,6,5,California,Amador County,2,0,38091,20749,17342
50,6,5,California,Amador County,2,1,1431,697,734
50,6,5,California,Amador County,2,2,1655,819,836
50,6,5,California,Amador County,2,3,1881,934,947
50,6,5,California,Amador County,2,4,2288,1341,947
50,6,5,California,Amador County,2,5,1648,996,652
50,6,5,California,Amador County,2,6,1778,1065,713
50,6,5,California,Amador County,2,7,1862,1186,676
50,6,5,California,Amador County,2,8,2048,1267,781
50,6,5,California,Amador County,2,9,2470,1572,898
50,6,5,California,Amador County,2,10,3114,1848,1266
50,6,5,California,Amador County,2,11,3255,1795,1460
50,6,5,California,Amador County,2,12,3405,1731,1674
50,6,5,California,Amador County,2,13,3391,1708,1683
50,6,5,California,Amador County,2,14,2533,1297,1236
50,6,5,California,Amador County,2,15,1922,955,967
50,6,5,California,Amador County,2,16,1312,643,669
50,6,5,California,Amador County,2,17,1096,501,595
50,6,5,California,Amador County,2,18,1002,394,608
50,6,5,California,Amador County,3,0,37886,20562,17324
50,6,5,California,Amador County,3,1,1434,697,737
50,6,5,California,Amador County,3,2,1635,812,823
50,6,5,California,Amador County,3,3,1849,918,931
50,6,5,California,Amador County,3,4,2224,1282,942
50,6,5,California,Amador County,3,5,1654,991,663
50,6,5,California,Amador County,3,6,1763,1047,716
50,6,5,California,Amador County,3,7,1859,1181,678
50,6,5,California,Amador County,3,8,2012,1241,771
50,6,5,California,Amador County,3,9,2436,1538,898
50,6,5,California,Amador County,3,10,3064,1818,1246
50,6,5,California,Amador County,3,11,3226,1776,1450
50,6,5,California,Amador County,3,12,3396,1728,1668
50,6,5,California,Amador County,3,13,3400,1710,1690
50,6,5,California,Amador County,3,14,2563,1306,1257
50,6,5,California,Amador County,3,15,1935,963,972
50,6,5,California,Amador County,3,16,1329,649,680
50,6,5,California,Amador County,3,17,1087,499,588
50,6,5,California,Amador County,3,18,1020,406,614
50,6,5,California,Amador County,4,0,37543,20304,17239
50,6,5,California,Amador County,4,1,1376,684,692
50,6,5,California,Amador County,4,2,1611,800,811
50,6,5,California,Amador County,4,3,1778,873,905
50,6,5,California,Amador County,4,4,2135,1216,919
50,6,5,California,Amador County,4,5,1658,983,675
50,6,5,California,Amador County,4,6,1768,1040,728
50,6,5,California,Amador County,4,7,1892,1179,713
50,6,5,California,Amador County,4,8,1936,1199,737
50,6,5,California,Amador County,4,9,2399,1497,902
50,6,5,California,Amador County,4,10,2894,1732,1162
50,6,5,California,Amador County,4,11,3167,1739,1428
50,6,5,California,Amador County,4,12,3364,1722,1642
50,6,5,California,Amador County,4,13,3462,1733,1729
50,6,5,California,Amador County,4,14,2692,1342,1350
50,6,5,California,Amador County,4,15,1960,984,976
50,6,5,California,Amador County,4,16,1358,660,698
50,6,5,California,Amador County,4,17,1064,491,573
50,6,5,California,Amador County,4,18,1029,430,599
50,6,5,California,Amador County,5,0,37104,19955,17149
50,6,5,California,Amador County,5,1,1367,679,688
50,6,5,California,Amador County,5,2,1559,761,798
50,6,5,California,Amador County,5,3,1711,852,859
50,6,5,California,Amador County,5,4,1876,1003,873
50,6,5,California,Amador County,5,5,1670,943,727
50,6,5,California,Amador County,5,6,1750,1067,683
50,6,5,California,Amador County,5,7,1920,1182,738
50,6,5,California,Amador County,5,8,1905,1173,732
50,6,5,California,Amador County,5,9,2293,1434,859
50,6,5,California,Amador County,5,10,2716,1659,1057
50,6,5,California,Amador County,5,11,3149,1728,1421
50,6,5,California,Amador County,5,12,3300,1697,1603
50,6,5,California,Amador County,5,13,3331,1657,1674
50,6,5,California,Amador County,5,14,2984,1478,1506
50,6,5,California,Amador County,5,15,2054,1013,1041
50,6,5,California,Amador County,5,16,1423,705,718
50,6,5,California,Amador County,5,17,1016,464,552
50,6,5,California,Amador County,5,18,1080,460,620
50,6,5,California,Amador County,6,0,36620,19476,17144
50,6,5,California,Amador County,6,1,1356,734,622
50,6,5,California,Amador County,6,2,1521,743,778
50,6,5,California,Amador County,6,3,1689,844,845
50,6,5,California,Amador County,6,4,1773,930,843
50,6,5,California,Amador County,6,5,1707,932,775
50,6,5,California,Amador County,6,6,1703,1016,687
50,6,5,California,Amador County,6,7,1873,1113,760
50,6,5,California,Amador County,6,8,1820,1129,691
50,6,5,California,Amador County,6,9,2179,1319,860
50,6,5,California,Amador County,6,10,2489,1497,992
50,6,5,California,Amador County,6,11,3058,1639,1419
50,6,5,California,Amador County,6,12,3192,1622,1570
50,6,5,California,Amador County,6,13,3386,1647,1739
50,6,5,California,Amador County,6,14,3119,1564,1555
50,6,5,California,Amador County,6,15,2130,1056,1074
50,6,5,California,Amador County,6,16,1512,766,746
50,6,5,California,Amador County,6,17,993,455,538
50,6,5,California,Amador County,6,18,1120,470,650
50,6,5,California,Amador County,7,0,36726,19512,17214
50,6,5,California,Amador County,7,1,1414,760,654
50,6,5,California,Amador County,7,2,1503,728,775
50,6,5,California,Amador County,7,3,1656,831,825
50,6,5,California,Amador County,7,4,1707,893,814
50,6,5,California,Amador County,7,5,1748,951,797
50,6,5,California,Amador County,7,6,1721,1037,684
50,6,5,California,Amador County,7,7,1920,1119,801
50,6,5,California,Amador County,7,8,1850,1156,694
50,6,5,California,Amador County,7,9,2104,1282,822
50,6,5,California,Amador County,7,10,2376,1423,953
50,6,5,California,Amador County,7,11,3002,1634,1368
50,6,5,California,Amador County,7,12,3093,1574,1519
50,6,5,California,Amador County,7,13,3421,1669,1752
50,6,5,California,Amador County,7,14,3237,1587,1650
50,6,5,California,Amador County,7,15,2243,1118,1125
50,6,5,California,Amador County,7,16,1581,783,798
50,6,5,California,Amador County,7,17,1004,484,520
50,6,5,California,Amador County,7,18,1146,483,663
50,6,5,California,Amador County,8,0,37031,19665,17366
50,6,5,California,Amador County,8,1,1479,812,667
50,6,5,California,Amador County,8,2,1487,730,757
50,6,5,California,Amador County,8,3,1665,844,821
50,6,5,California,Amador County,8,4,1714,881,833
50,6,5,California,Amador County,8,5,1663,915,748
50,6,5,California,Amador County,8,6,1865,1103,762
50,6,5,California,Amador County,8,7,1918,1114,804
50,6,5,California,Amador County,8,8,1897,1181,716
50,6,5,California,Amador County,8,9,2057,1265,792
50,6,5,California,Amador County,8,10,2372,1438,934
50,6,5,California,Amador County,8,11,2902,1605,1297
50,6,5,California,Amador County,8,12,3088,1544,1544
50,6,5,California,Amador County,8,13,3377,1655,1722
50,6,5,California,Amador County,8,14,3398,1641,1757
50,6,5,California,Amador County,8,15,2384,1187,1197
50,6,5,California,Amador County,8,16,1644,806,838
50,6,5,California,Amador County,8,17,992,471,521
50,6,5,California,Amador County,8,18,1129,473,656
50,6,5,California,Amador County,9,0,37429,19839,17590
50,6,5,California,Amador County,9,1,1568,826,742
50,6,5,California,Amador County,9,2,1549,778,771
50,6,5,California,Amador County,9,3,1672,859,813
50,6,5,California,Amador County,9,4,1670,861,809
50,6,5,California,Amador County,9,5,1622,901,721
50,6,5,California,Amador County,9,6,1930,1124,806
50,6,5,California,Amador County,9,7,1971,1141,830
50,6,5,California,Amador County,9,8,2033,1241,792
50,6,5,California,Amador County,9,9,2022,1261,761
50,6,5,California,Amador County,9,10,2344,1398,946
50,6,5,California,Amador County,9,11,2802,1556,1246
50,6,5,California,Amador County,9,12,3111,1566,1545
50,6,5,California,Amador County,9,13,3302,1620,1682
50,6,5,California,Amador County,9,14,3542,1702,1840
50,6,5,California,Amador County,9,15,2489,1234,1255
50,6,5,California,Amador County,9,16,1664,829,835
50,6,5,California,Amador County,9,17,1029,477,552
50,6,5,California,Amador County,9,18,1109,465,644
50,6,5,California,Amador County,10,0,38529,20744,17785
50,6,5,California,Amador County,10,1,1595,823,772
50,6,5,California,Amador County,10,2,1552,817,735
50,6,5,California,Amador County,10,3,1647,824,823
50,6,5,California,Amador County,10,4,1686,882,804
50,6,5,California,Amador County,10,5,1646,941,705
50,6,5,California,Amador County,10,6,2050,1222,828
50,6,5,California,Amador County,10,7,2082,1256,826
50,6,5,California,Amador County,10,8,2199,1367,832
50,6,5,California,Amador County,10,9,2163,1384,779
50,6,5,California,Amador County,10,10,2457,1508,949
50,6,5,California,Amador County,10,11,2803,1608,1195
50,6,5,California,Amador County,10,12,3149,1603,1546
50,6,5,California,Amador County,10,13,3302,1643,1659
50,6,5,California,Amador County,10,14,3482,1673,1809
50,6,5,California,Amador County,10,15,2822,1370,1452
50,6,5,California,Amador County,10,16,1727,845,882
50,6,5,California,Amador County,10,17,1091,524,567
50,6,5,California,Amador County,10,18,1076,454,622
50,6,5,California,Amador County,11,0,39405,21435,17970
50,6,5,California,Amador County,11,1,1629,822,807
50,6,5,California,Amador County,11,2,1590,876,714
50,6,5,California,Amador County,11,3,1689,827,862
50,6,5,California,Amador County,11,4,1668,882,786
50,6,5,California,Amador County,11,5,1594,914,680
50,6,5,California,Amador County,11,6,2174,1295,879
50,6,5,California,Amador County,11,7,2137,1320,817
50,6,5,California,Amador County,11,8,2373,1480,893
50,6,5,California,Amador County,11,9,2271,1516,755
50,6,5,California,Amador County,11,10,2504,1558,946
50,6,5,California,Amador County,11,11,2735,1577,1158
50,6,5,California,Amador County,11,12,3149,1657,1492
50,6,5,California,Amador County,11,13,3315,1648,1667
50,6,5,California,Amador County,11,14,3497,1680,1817
50,6,5,California,Amador County,11,15,2980,1453,1527
50,6,5,California,Amador County,11,16,1861,900,961
50,6,5,California,Amador County,11,17,1170,572,598
50,6,5,California,Amador County,11,18,1069,458,611
50,6,5,California,Amador County,12,0,39752,21638,18114
50,6,5,California,Amador County,12,1,1612,814,798
50,6,5,California,Amador County,12,2,1672,921,751
50,6,5,California,Amador County,12,3,1695,829,866
50,6,5,California,Amador County,12,4,1652,893,759
50,6,5,California,Amador County,12,5,1568,888,680
50,6,5,California,Amador County,12,6,2153,1271,882
50,6,5,California,Amador County,12,7,2222,1366,856
50,6,5,California,Amador County,12,8,2358,1455,903
50,6,5,California,Amador County,12,9,2357,1560,797
50,6,5,California,Amador County,12,10,2459,1564,895
50,6,5,California,Amador County,12,11,2595,1507,1088
50,6,5,California,Amador County,12,12,3167,1661,1506
50,6,5,California,Amador County,12,13,3297,1667,1630
50,6,5,California,Amador County,12,14,3457,1665,1792
50,6,5,California,Amador County,12,15,3185,1532,1653
50,6,5,California,Amador County,12,16,1974,957,1017
50,6,5,California,Amador County,12,17,1231,595,636
50,6,5,California,Amador County,12,18,1098,493,605
50,6,7,California,Butte County,1,0,220000,108931,111069
50,6,7,California,Butte County,1,1,12409,6243,6166
50,6,7,California,Butte County,1,2,12439,6320,6119
50,6,7,California,Butte County,1,3,12911,6616,6295
50,6,7,California,Butte County,1,4,17841,9158,8683
50,6,7,California,Butte County,1,5,22818,11905,10913
50,6,7,California,Butte County,1,6,14721,7824,6897
50,6,7,California,Butte County,1,7,11960,6213,5747
50,6,7,California,Butte County,1,8,11482,5864,5618
50,6,7,California,Butte County,1,9,11847,5969,5878
50,6,7,California,Butte County,1,10,13849,6683,7166
50,6,7,California,Butte County,1,11,15028,7405,7623
50,6,7,California,Butte County,1,12,15265,7340,7925
50,6,7,California,Butte County,1,13,13613,6640,6973
50,6,7,California,Butte County,1,14,9805,4647,5158
50,6,7,California,Butte County,1,15,7380,3414,3966
50,6,7,California,Butte County,1,16,5925,2680,3245
50,6,7,California,Butte County,1,17,5037,2052,2985
50,6,7,California,Butte County,1,18,5670,1958,3712
50,6,7,California,Butte County,2,0,220005,108933,111072
50,6,7,California,Butte County,2,1,12410,6243,6167
50,6,7,California,Butte County,2,2,12439,6320,6119
50,6,7,California,Butte County,2,3,12911,6616,6295
50,6,7,California,Butte County,2,4,17841,9158,8683
50,6,7,California,Butte County,2,5,22819,11905,10914
50,6,7,California,Butte County,2,6,14721,7824,6897
50,6,7,California,Butte County,2,7,11960,6213,5747
50,6,7,California,Butte County,2,8,11482,5864,5618
50,6,7,California,Butte County,2,9,11847,5969,5878
50,6,7,California,Butte County,2,10,13850,6684,7166
50,6,7,California,Butte County,2,11,15030,7406,7624
50,6,7,California,Butte County,2,12,15265,7340,7925
50,6,7,California,Butte County,2,13,13613,6640,6973
50,6,7,California,Butte County,2,14,9805,4647,5158
50,6,7,California,Butte County,2,15,7380,3414,3966
50,6,7,California,Butte County,2,16,5925,2680,3245
50,6,7,California,Butte County,2,17,5037,2052,2985
50,6,7,California,Butte County,2,18,5670,1958,3712
50,6,7,California,Butte County,3,0,219949,108855,111094
50,6,7,California,Butte County,3,1,12398,6260,6138
50,6,7,California,Butte County,3,2,12398,6291,6107
50,6,7,California,Butte County,3,3,12867,6586,6281
50,6,7,California,Butte County,3,4,17444,8929,8515
50,6,7,California,Butte County,3,5,23241,12128,11113
50,6,7,California,Butte County,3,6,14690,7755,6935
50,6,7,California,Butte County,3,7,12052,6265,5787
50,6,7,California,Butte County,3,8,11392,5814,5578
50,6,7,California,Butte County,3,9,11826,5959,5867
50,6,7,California,Butte County,3,10,13735,6646,7089
50,6,7,California,Butte County,3,11,14969,7364,7605
50,6,7,California,Butte County,3,12,15257,7350,7907
50,6,7,California,Butte County,3,13,13762,6710,7052
50,6,7,California,Butte County,3,14,9872,4674,5198
50,6,7,California,Butte County,3,15,7440,3443,3997
50,6,7,California,Butte County,3,16,5911,2674,3237
50,6,7,California,Butte County,3,17,5004,2042,2962
50,6,7,California,Butte County,3,18,5691,1965,3726
50,6,7,California,Butte County,4,0,219975,108974,111001
50,6,7,California,Butte County,4,1,12284,6322,5962
50,6,7,California,Butte County,4,2,12443,6247,6196
50,6,7,California,Butte County,4,3,12715,6533,6182
50,6,7,California,Butte County,4,4,16379,8363,8016
50,6,7,California,Butte County,4,5,24806,13004,11802
50,6,7,California,Butte County,4,6,14218,7387,6831
50,6,7,California,Butte County,4,7,12410,6446,5964
50,6,7,California,Butte County,4,8,11083,5637,5446
50,6,7,California,Butte County,4,9,11865,6000,5865
50,6,7,California,Butte County,4,10,13109,6388,6721
50,6,7,California,Butte County,4,11,14733,7210,7523
50,6,7,California,Butte County,4,12,15212,7345,7867
50,6,7,California,Butte County,4,13,14367,6970,7397
50,6,7,California,Butte County,4,14,10144,4838,5306
50,6,7,California,Butte County,4,15,7597,3526,4071
50,6,7,California,Butte County,4,16,5945,2703,3242
50,6,7,California,Butte County,4,17,4899,2033,2866
50,6,7,California,Butte County,4,18,5766,2022,3744
50,6,7,California,Butte County,5,0,220869,109419,111450
50,6,7,California,Butte County,5,1,12126,6223,5903
50,6,7,California,Butte County,5,2,12584,6324,6260
50,6,7,California,Butte County,5,3,12600,6543,6057
50,6,7,California,Butte County,5,4,16156,8181,7975
50,6,7,California,Butte County,5,5,26091,13600,12491
50,6,7,California,Butte County,5,6,13605,7089,6516
50,6,7,California,Butte County,5,7,12684,6615,6069
50,6,7,California,Butte County,5,8,11078,5644,5434
50,6,7,California,Butte County,5,9,11773,5959,5814
50,6,7,California,Butte County,5,10,12623,6176,6447
50,6,7,California,Butte County,5,11,14408,7048,7360
50,6,7,California,Butte County,5,12,15185,7340,7845
50,6,7,California,Butte County,5,13,14270,6875,7395
50,6,7,California,Butte County,5,14,11210,5373,5837
50,6,7,California,Butte County,5,15,7841,3655,4186
50,6,7,California,Butte County,5,16,6009,2683,3326
50,6,7,California,Butte County,5,17,4806,2048,2758
50,6,7,California,Butte County,5,18,5820,2043,3777
50,6,7,California,Butte County,6,0,221641,109707,111934
50,6,7,California,Butte County,6,1,12071,6162,5909
50,6,7,California,Butte County,6,2,12603,6369,6234
50,6,7,California,Butte County,6,3,12617,6529,6088
50,6,7,California,Butte County,6,4,15947,8098,7849
50,6,7,California,Butte County,6,5,26489,13660,12829
50,6,7,California,Butte County,6,6,13543,7149,6394
50,6,7,California,Butte County,6,7,13011,6750,6261
50,6,7,California,Butte County,6,8,11265,5750,5515
50,6,7,California,Butte County,6,9,11671,5903,5768
50,6,7,California,Butte County,6,10,12149,5950,6199
50,6,7,California,Butte County,6,11,14108,6844,7264
50,6,7,California,Butte County,6,12,14982,7280,7702
50,6,7,California,Butte County,6,13,14575,6976,7599
50,6,7,California,Butte County,6,14,11791,5652,6139
50,6,7,California,Butte County,6,15,8233,3840,4393
50,6,7,California,Butte County,6,16,6160,2769,3391
50,6,7,California,Butte County,6,17,4657,2019,2638
50,6,7,California,Butte County,6,18,5769,2007,3762
50,6,7,California,Butte County,7,0,223516,110561,112955
50,6,7,California,Butte County,7,1,12309,6344,5965
50,6,7,California,Butte County,7,2,12532,6377,6155
50,6,7,California,Butte County,7,3,12763,6477,6286
50,6,7,California,Butte County,7,4,15774,8004,7770
50,6,7,California,Butte County,7,5,26426,13553,12873
50,6,7,California,Butte County,7,6,13865,7357,6508
50,6,7,California,Butte County,7,7,13453,6989,6464
50,6,7,California,Butte County,7,8,11592,5892,5700
50,6,7,California,Butte County,7,9,11560,5864,5696
50,6,7,California,Butte County,7,10,11869,5869,6000
50,6,7,California,Butte County,7,11,13839,6665,7174
50,6,7,California,Butte County,7,12,14944,7244,7700
50,6,7,California,Butte County,7,13,14788,7071,7717
50,6,7,California,Butte County,7,14,12468,5990,6478
50,6,7,California,Butte County,7,15,8636,4018,4618
50,6,7,California,Butte County,7,16,6309,2856,3453
50,6,7,California,Butte County,7,17,4653,2013,2640
50,6,7,California,Butte County,7,18,5736,1978,3758
50,6,7,California,Butte County,8,0,224631,111067,113564
50,6,7,California,Butte County,8,1,12398,6448,5950
50,6,7,California,Butte County,8,2,12557,6372,6185
50,6,7,California,Butte County,8,3,12705,6470,6235
50,6,7,California,Butte County,8,4,15706,7916,7790
50,6,7,California,Butte County,8,5,25779,13197,12582
50,6,7,California,Butte County,8,6,14626,7752,6874
50,6,7,California,Butte County,8,7,13458,6926,6532
50,6,7,California,Butte County,8,8,12065,6186,5879
50,6,7,California,Butte County,8,9,11380,5800,5580
50,6,7,California,Butte County,8,10,11764,5828,5936
50,6,7,California,Butte County,8,11,13507,6456,7051
50,6,7,California,Butte County,8,12,14819,7189,7630
50,6,7,California,Butte County,8,13,14876,7069,7807
50,6,7,California,Butte County,8,14,13122,6341,6781
50,6,7,California,Butte County,8,15,9014,4213,4801
50,6,7,California,Butte County,8,16,6417,2900,3517
50,6,7,California,Butte County,8,17,4712,2030,2682
50,6,7,California,Butte County,8,18,5726,1974,3752
50,6,7,California,Butte County,9,0,226231,111821,114410
50,6,7,California,Butte County,9,1,12412,6429,5983
50,6,7,California,Butte County,9,2,12611,6478,6133
50,6,7,California,Butte County,9,3,12682,6408,6274
50,6,7,California,Butte County,9,4,15606,7878,7728
50,6,7,California,Butte County,9,5,25130,12803,12327
50,6,7,California,Butte County,9,6,15691,8352,7339
50,6,7,California,Butte County,9,7,13560,6936,6624
50,6,7,California,Butte County,9,8,12558,6459,6099
50,6,7,California,Butte County,9,9,11268,5722,5546
50,6,7,California,Butte County,9,10,11854,5890,5964
50,6,7,California,Butte County,9,11,13004,6257,6747
50,6,7,California,Butte County,9,12,14584,7039,7545
50,6,7,California,Butte County,9,13,14994,7140,7854
50,6,7,California,Butte County,9,14,13906,6658,7248
50,6,7,California,Butte County,9,15,9312,4340,4972
50,6,7,California,Butte County,9,16,6631,3002,3629
50,6,7,California,Butte County,9,17,4720,2046,2674
50,6,7,California,Butte County,9,18,5708,1984,3724
50,6,7,California,Butte County,10,0,228696,112940,115756
50,6,7,California,Butte County,10,1,12539,6469,6070
50,6,7,California,Butte County,10,2,12720,6538,6182
50,6,7,California,Butte County,10,3,12808,6452,6356
50,6,7,California,Butte County,10,4,15586,7898,7688
50,6,7,California,Butte County,10,5,24998,12618,12380
50,6,7,California,Butte County,10,6,16495,8764,7731
50,6,7,California,Butte County,10,7,13411,6825,6586
50,6,7,California,Butte County,10,8,13149,6773,6376
50,6,7,California,Butte County,10,9,11384,5760,5624
50,6,7,California,Butte County,10,10,11985,5988,5997
50,6,7,California,Butte County,10,11,12635,6138,6497
50,6,7,California,Butte County,10,12,14397,6904,7493
50,6,7,California,Butte County,10,13,15134,7206,7928
50,6,7,California,Butte County,10,14,13953,6614,7339
50,6,7,California,Butte County,10,15,10352,4857,5495
50,6,7,California,Butte County,10,16,6790,3130,3660
50,6,7,California,Butte County,10,17,4744,2031,2713
50,6,7,California,Butte County,10,18,5616,1975,3641
50,6,7,California,Butte County,11,0,230339,113816,116523
50,6,7,California,Butte County,11,1,12669,6552,6117
50,6,7,California,Butte County,11,2,12738,6566,6172
50,6,7,California,Butte County,11,3,12962,6588,6374
50,6,7,California,Butte County,11,4,15631,7885,7746
50,6,7,California,Butte County,11,5,24829,12552,12277
50,6,7,California,Butte County,11,6,16789,8783,8006
50,6,7,California,Butte County,11,7,13393,6889,6504
50,6,7,California,Butte County,11,8,13607,6996,6611
50,6,7,California,Butte County,11,9,11655,5927,5728
50,6,7,California,Butte County,11,10,11917,5947,5970
50,6,7,California,Butte County,11,11,12195,5934,6261
50,6,7,California,Butte County,11,12,14259,6820,7439
50,6,7,California,Butte County,11,13,15007,7135,7872
50,6,7,California,Butte County,11,14,14317,6779,7538
50,6,7,California,Butte County,11,15,10933,5164,5769
50,6,7,California,Butte County,11,16,7079,3250,3829
50,6,7,California,Butte County,11,17,4847,2109,2738
50,6,7,California,Butte County,11,18,5512,1940,3572
50,6,7,California,Butte County,12,0,219186,108473,110713
50,6,7,California,Butte County,12,1,12062,6207,5855
50,6,7,California,Butte County,12,2,12416,6431,5985
50,6,7,California,Butte County,12,3,12407,6306,6101
50,6,7,California,Butte County,12,4,15215,7593,7622
50,6,7,California,Butte County,12,5,23915,12086,11829
50,6,7,California,Butte County,12,6,15943,8299,7644
50,6,7,California,Butte County,12,7,12871,6649,6222
50,6,7,California,Butte County,12,8,13138,6761,6377
50,6,7,California,Butte County,12,9,11578,5860,5718
50,6,7,California,Butte County,12,10,11173,5598,5575
50,6,7,California,Butte County,12,11,11347,5635,5712
50,6,7,California,Butte County,12,12,13159,6286,6873
50,6,7,California,Butte County,12,13,13734,6604,7130
50,6,7,California,Butte County,12,14,13169,6210,6959
50,6,7,California,Butte County,12,15,10594,5037,5557
50,6,7,California,Butte County,12,16,6813,3111,3702
50,6,7,California,Butte County,12,17,4565,2010,2555
50,6,7,California,Butte County,12,18,5087,1790,3297
50,6,9,California,Calaveras County,1,0,45578,22822,22756
50,6,9,California,Calaveras County,1,1,1992,1000,992
50,6,9,California,Calaveras County,1,2,2239,1149,1090
50,6,9,California,Calaveras County,1,3,2770,1429,1341
50,6,9,California,Calaveras County,1,4,2893,1589,1304
50,6,9,California,Calaveras County,1,5,1883,994,889
50,6,9,California,Calaveras County,1,6,1829,972,857
50,6,9,California,Calaveras County,1,7,1779,892,887
50,6,9,California,Calaveras County,1,8,2017,1008,1009
50,6,9,California,Calaveras County,1,9,2588,1258,1330
50,6,9,California,Calaveras County,1,10,3421,1689,1732
50,6,9,California,Calaveras County,1,11,4144,2027,2117
50,6,9,California,Calaveras County,1,12,4233,2031,2202
50,6,9,California,Calaveras County,1,13,4225,2102,2123
50,6,9,California,Calaveras County,1,14,3307,1671,1636
50,6,9,California,Calaveras County,1,15,2502,1268,1234
50,6,9,California,Calaveras County,1,16,1686,849,837
50,6,9,California,Calaveras County,1,17,1098,529,569
50,6,9,California,Calaveras County,1,18,972,365,607
50,6,9,California,Calaveras County,2,0,45578,22822,22756
50,6,9,California,Calaveras County,2,1,1992,1000,992
50,6,9,California,Calaveras County,2,2,2239,1149,1090
50,6,9,California,Calaveras County,2,3,2770,1429,1341
50,6,9,California,Calaveras County,2,4,2893,1589,1304
50,6,9,California,Calaveras County,2,5,1883,994,889
50,6,9,California,Calaveras County,2,6,1829,972,857
50,6,9,California,Calaveras County,2,7,1779,892,887
50,6,9,California,Calaveras County,2,8,2017,1008,1009
50,6,9,California,Calaveras County,2,9,2588,1258,1330
50,6,9,California,Calaveras County,2,10,3421,1689,1732
50,6,9,California,Calaveras County,2,11,4144,2027,2117
50,6,9,California,Calaveras County,2,12,4233,2031,2202
50,6,9,California,Calaveras County,2,13,4225,2102,2123
50,6,9,California,Calaveras County,2,14,3307,1671,1636
50,6,9,California,Calaveras County,2,15,2502,1268,1234
50,6,9,California,Calaveras County,2,16,1686,849,837
50,6,9,California,Calaveras County,2,17,1098,529,569
50,6,9,California,Calaveras County,2,18,972,365,607
50,6,9,California,Calaveras County,3,0,45468,22752,22716
50,6,9,California,Calaveras County,3,1,1966,992,974
50,6,9,California,Calaveras County,3,2,2210,1133,1077
50,6,9,California,Calaveras County,3,3,2747,1416,1331
50,6,9,California,Calaveras County,3,4,2875,1578,1297
50,6,9,California,Calaveras County,3,5,1899,1002,897
50,6,9,California,Calaveras County,3,6,1848,983,865
50,6,9,California,Calaveras County,3,7,1775,889,886
50,6,9,California,Calaveras County,3,8,1991,998,993
50,6,9,California,Calaveras County,3,9,2558,1232,1326
50,6,9,California,Calaveras County,3,10,3375,1677,1698
50,6,9,California,Calaveras County,3,11,4128,2011,2117
50,6,9,California,Calaveras County,3,12,4242,2021,2221
50,6,9,California,Calaveras County,3,13,4225,2109,2116
50,6,9,California,Calaveras County,3,14,3338,1688,1650
50,6,9,California,Calaveras County,3,15,2518,1276,1242
50,6,9,California,Calaveras County,3,16,1691,852,839
50,6,9,California,Calaveras County,3,17,1105,528,577
50,6,9,California,Calaveras County,3,18,977,367,610
50,6,9,California,Calaveras County,4,0,45160,22608,22552
50,6,9,California,Calaveras County,4,1,1897,974,923
50,6,9,California,Calaveras County,4,2,2118,1076,1042
50,6,9,California,Calaveras County,4,3,2653,1377,1276
50,6,9,California,Calaveras County,4,4,2835,1525,1310
50,6,9,California,Calaveras County,4,5,1942,1018,924
50,6,9,California,Calaveras County,4,6,1933,1044,889
50,6,9,California,Calaveras County,4,7,1818,925,893
50,6,9,California,Calaveras County,4,8,1874,939,935
50,6,9,California,Calaveras County,4,9,2451,1160,1291
50,6,9,California,Calaveras County,4,10,3118,1567,1551
50,6,9,California,Calaveras County,4,11,4006,1951,2055
50,6,9,California,Calaveras County,4,12,4235,1981,2254
50,6,9,California,Calaveras County,4,13,4311,2187,2124
50,6,9,California,Calaveras County,4,14,3455,1752,1703
50,6,9,California,Calaveras County,4,15,2625,1315,1310
50,6,9,California,Calaveras County,4,16,1768,902,866
50,6,9,California,Calaveras County,4,17,1127,531,596
50,6,9,California,Calaveras County,4,18,994,384,610
50,6,9,California,Calaveras County,5,0,44815,22456,22359
50,6,9,California,Calaveras County,5,1,1787,933,854
50,6,9,California,Calaveras County,5,2,2138,1077,1061
50,6,9,California,Calaveras County,5,3,2519,1318,1201
50,6,9,California,Calaveras County,5,4,2786,1458,1328
50,6,9,California,Calaveras County,5,5,1954,1025,929
50,6,9,California,Calaveras County,5,6,1850,1008,842
50,6,9,California,Calaveras County,5,7,1841,939,902
50,6,9,California,Calaveras County,5,8,1841,946,895
50,6,9,California,Calaveras County,5,9,2354,1125,1229
50,6,9,California,Calaveras County,5,10,2990,1477,1513
50,6,9,California,Calaveras County,5,11,3810,1863,1947
50,6,9,California,Calaveras County,5,12,4267,2026,2241
50,6,9,California,Calaveras County,5,13,4176,2094,2082
50,6,9,California,Calaveras County,5,14,3758,1909,1849
50,6,9,California,Calaveras County,5,15,2688,1359,1329
50,6,9,California,Calaveras County,5,16,1889,952,937
50,6,9,California,Calaveras County,5,17,1122,532,590
50,6,9,California,Calaveras County,5,18,1045,415,630
50,6,9,California,Calaveras County,6,0,44655,22345,22310
50,6,9,California,Calaveras County,6,1,1742,909,833
50,6,9,California,Calaveras County,6,2,2089,1047,1042
50,6,9,California,Calaveras County,6,3,2421,1253,1168
50,6,9,California,Calaveras County,6,4,2717,1443,1274
50,6,9,California,Calaveras County,6,5,2026,1056,970
50,6,9,California,Calaveras County,6,6,1847,992,855
50,6,9,California,Calaveras County,6,7,1896,957,939
50,6,9,California,Calaveras County,6,8,1844,969,875
50,6,9,California,Calaveras County,6,9,2243,1069,1174
50,6,9,California,Calaveras County,6,10,2781,1373,1408
50,6,9,California,Calaveras County,6,11,3710,1805,1905
50,6,9,California,Calaveras County,6,12,4238,2049,2189
50,6,9,California,Calaveras County,6,13,4204,2052,2152
50,6,9,California,Calaveras County,6,14,3867,1987,1880
50,6,9,California,Calaveras County,6,15,2805,1402,1403
50,6,9,California,Calaveras County,6,16,2022,1007,1015
50,6,9,California,Calaveras County,6,17,1163,554,609
50,6,9,California,Calaveras County,6,18,1040,421,619
50,6,9,California,Calaveras County,7,0,44671,22356,22315
50,6,9,California,Calaveras County,7,1,1767,925,842
50,6,9,California,Calaveras County,7,2,2085,1024,1061
50,6,9,California,Calaveras County,7,3,2332,1223,1109
50,6,9,California,Calaveras County,7,4,2616,1422,1194
50,6,9,California,Calaveras County,7,5,2020,1077,943
50,6,9,California,Calaveras County,7,6,1921,987,934
50,6,9,California,Calaveras County,7,7,1920,994,926
50,6,9,California,Calaveras County,7,8,1909,1001,908
50,6,9,California,Calaveras County,7,9,2153,1050,1103
50,6,9,California,Calaveras County,7,10,2616,1281,1335
50,6,9,California,Calaveras County,7,11,3598,1744,1854
50,6,9,California,Calaveras County,7,12,4167,2016,2151
50,6,9,California,Calaveras County,7,13,4293,2052,2241
50,6,9,California,Calaveras County,7,14,4004,2049,1955
50,6,9,California,Calaveras County,7,15,2963,1487,1476
50,6,9,California,Calaveras County,7,16,2042,1029,1013
50,6,9,California,Calaveras County,7,17,1206,576,630
50,6,9,California,Calaveras County,7,18,1059,419,640
50,6,9,California,Calaveras County,8,0,44965,22450,22515
50,6,9,California,Calaveras County,8,1,1823,950,873
50,6,9,California,Calaveras County,8,2,2065,1018,1047
50,6,9,California,Calaveras County,8,3,2255,1169,1086
50,6,9,California,Calaveras County,8,4,2516,1360,1156
50,6,9,California,Calaveras County,8,5,2067,1133,934
50,6,9,California,Calaveras County,8,6,1952,983,969
50,6,9,California,Calaveras County,8,7,2030,1051,979
50,6,9,California,Calaveras County,8,8,1971,1000,971
50,6,9,California,Calaveras County,8,9,2049,1042,1007
50,6,9,California,Calaveras County,8,10,2575,1242,1333
50,6,9,California,Calaveras County,8,11,3386,1688,1698
50,6,9,California,Calaveras County,8,12,4221,1996,2225
50,6,9,California,Calaveras County,8,13,4342,2045,2297
50,6,9,California,Calaveras County,8,14,4189,2113,2076
50,6,9,California,Calaveras County,8,15,3057,1557,1500
50,6,9,California,Calaveras County,8,16,2098,1049,1049
50,6,9,California,Calaveras County,8,17,1271,621,650
50,6,9,California,Calaveras County,8,18,1098,433,665
50,6,9,California,Calaveras County,9,0,45322,22591,22731
50,6,9,California,Calaveras County,9,1,1873,969,904
50,6,9,California,Calaveras County,9,2,2036,1026,1010
50,6,9,California,Calaveras County,9,3,2244,1146,1098
50,6,9,California,Calaveras County,9,4,2433,1331,1102
50,6,9,California,Calaveras County,9,5,2067,1103,964
50,6,9,California,Calaveras County,9,6,2019,1034,985
50,6,9,California,Calaveras County,9,7,2144,1116,1028
50,6,9,California,Calaveras County,9,8,2098,1066,1032
50,6,9,California,Calaveras County,9,9,1934,982,952
50,6,9,California,Calaveras County,9,10,2613,1245,1368
50,6,9,California,Calaveras County,9,11,3228,1614,1614
50,6,9,California,Calaveras County,9,12,4159,1981,2178
50,6,9,California,Calaveras County,9,13,4422,2034,2388
50,6,9,California,Calaveras County,9,14,4304,2162,2142
50,6,9,California,Calaveras County,9,15,3168,1628,1540
50,6,9,California,Calaveras County,9,16,2158,1079,1079
50,6,9,California,Calaveras County,9,17,1278,620,658
50,6,9,California,Calaveras County,9,18,1144,455,689
50,6,9,California,Calaveras County,10,0,45681,22762,22919
50,6,9,California,Calaveras County,10,1,1953,1013,940
50,6,9,California,Calaveras County,10,2,2017,1048,969
50,6,9,California,Calaveras County,10,3,2251,1142,1109
50,6,9,California,Calaveras County,10,4,2357,1273,1084
50,6,9,California,Calaveras County,10,5,2059,1105,954
50,6,9,California,Calaveras County,10,6,2120,1075,1045
50,6,9,California,Calaveras County,10,7,2276,1172,1104
50,6,9,California,Calaveras County,10,8,2172,1101,1071
50,6,9,California,Calaveras County,10,9,1982,1005,977
50,6,9,California,Calaveras County,10,10,2552,1228,1324
50,6,9,California,Calaveras County,10,11,3101,1532,1569
50,6,9,California,Calaveras County,10,12,4073,1951,2122
50,6,9,California,Calaveras County,10,13,4467,2063,2404
50,6,9,California,Calaveras County,10,14,4158,2051,2107
50,6,9,California,Calaveras County,10,15,3405,1738,1667
50,6,9,California,Calaveras County,10,16,2232,1123,1109
50,6,9,California,Calaveras County,10,17,1373,668,705
50,6,9,California,Calaveras County,10,18,1133,474,659
50,6,9,California,Calaveras County,11,0,45698,22747,22951
50,6,9,California,Calaveras County,11,1,1999,1033,966
50,6,9,California,Calaveras County,11,2,2020,1058,962
50,6,9,California,Calaveras County,11,3,2224,1093,1131
50,6,9,California,Calaveras County,11,4,2303,1256,1047
50,6,9,California,Calaveras County,11,5,2019,1060,959
50,6,9,California,Calaveras County,11,6,2142,1114,1028
50,6,9,California,Calaveras County,11,7,2268,1158,1110
50,6,9,California,Calaveras County,11,8,2289,1181,1108
50,6,9,California,Calaveras County,11,9,2001,1015,986
50,6,9,California,Calaveras County,11,10,2482,1182,1300
50,6,9,California,Calaveras County,11,11,2966,1463,1503
50,6,9,California,Calaveras County,11,12,3887,1853,2034
50,6,9,California,Calaveras County,11,13,4512,2148,2364
50,6,9,California,Calaveras County,11,14,4133,1992,2141
50,6,9,California,Calaveras County,11,15,3479,1763,1716
50,6,9,California,Calaveras County,11,16,2346,1178,1168
50,6,9,California,Calaveras County,11,17,1476,721,755
50,6,9,California,Calaveras County,11,18,1152,479,673
50,6,9,California,Calaveras County,12,0,45905,22847,23058
50,6,9,California,Calaveras County,12,1,2055,1056,999
50,6,9,California,Calaveras County,12,2,2107,1080,1027
50,6,9,California,Calaveras County,12,3,2183,1081,1102
50,6,9,California,Calaveras County,12,4,2285,1252,1033
50,6,9,California,Calaveras County,12,5,1920,1011,909
50,6,9,California,Calaveras County,12,6,2202,1147,1055
50,6,9,California,Calaveras County,12,7,2343,1182,1161
50,6,9,California,Calaveras County,12,8,2342,1228,1114
50,6,9,California,Calaveras County,12,9,2081,1070,1011
50,6,9,California,Calaveras County,12,10,2393,1161,1232
50,6,9,California,Calaveras County,12,11,2871,1384,1487
50,6,9,California,Calaveras County,12,12,3786,1813,1973
50,6,9,California,Calaveras County,12,13,4471,2164,2307
50,6,9,California,Calaveras County,12,14,4168,1980,2188
50,6,9,California,Calaveras County,12,15,3584,1774,1810
50,6,9,California,Calaveras County,12,16,2430,1227,1203
50,6,9,California,Calaveras County,12,17,1513,748,765
50,6,9,California,Calaveras County,12,18,1171,489,682
50,6,11,California,Colusa County,1,0,21419,11012,10407
50,6,11,California,Colusa County,1,1,1841,987,854
50,6,11,California,Colusa County,1,2,1733,914,819
50,6,11,California,Colusa County,1,3,1692,881,811
50,6,11,California,Colusa County,1,4,1773,965,808
50,6,11,California,Colusa County,1,5,1287,691,596
50,6,11,California,Colusa County,1,6,1440,736,704
50,6,11,California,Colusa County,1,7,1340,673,667
50,6,11,California,Colusa County,1,8,1325,660,665
50,6,11,California,Colusa County,1,9,1353,711,642
50,6,11,California,Colusa County,1,10,1356,700,656
50,6,11,California,Colusa County,1,11,1411,713,698
50,6,11,California,Colusa County,1,12,1296,646,650
50,6,11,California,Colusa County,1,13,1077,565,512
50,6,11,California,Colusa County,1,14,812,403,409
50,6,11,California,Colusa County,1,15,555,282,273
50,6,11,California,Colusa County,1,16,422,200,222
50,6,11,California,Colusa County,1,17,357,160,197
50,6,11,California,Colusa County,1,18,349,125,224
50,6,11,California,Colusa County,2,0,21407,11004,10403
50,6,11,California,Colusa County,2,1,1841,987,854
50,6,11,California,Colusa County,2,2,1733,914,819
50,6,11,California,Colusa County,2,3,1692,881,811
50,6,11,California,Colusa County,2,4,1773,965,808
50,6,11,California,Colusa County,2,5,1287,691,596
50,6,11,California,Colusa County,2,6,1440,736,704
50,6,11,California,Colusa County,2,7,1340,673,667
50,6,11,California,Colusa County,2,8,1324,659,665
50,6,11,California,Colusa County,2,9,1352,711,641
50,6,11,California,Colusa County,2,10,1355,699,656
50,6,11,California,Colusa County,2,11,1411,713,698
50,6,11,California,Colusa County,2,12,1294,644,650
50,6,11,California,Colusa County,2,13,1074,563,511
50,6,11,California,Colusa County,2,14,809,402,407
50,6,11,California,Colusa County,2,15,554,281,273
50,6,11,California,Colusa County,2,16,422,200,222
50,6,11,California,Colusa County,2,17,357,160,197
50,6,11,California,Colusa County,2,18,349,125,224
50,6,11,California,Colusa County,3,0,21437,11034,10403
50,6,11,California,Colusa County,3,1,1820,972,848
50,6,11,California,Colusa County,3,2,1731,916,815
50,6,11,California,Colusa County,3,3,1685,874,811
50,6,11,California,Colusa County,3,4,1770,968,802
50,6,11,California,Colusa County,3,5,1302,697,605
50,6,11,California,Colusa County,3,6,1441,744,697
50,6,11,California,Colusa County,3,7,1345,670,675
50,6,11,California,Colusa County,3,8,1321,665,656
50,6,11,California,Colusa County,3,9,1350,710,640
50,6,11,California,Colusa County,3,10,1346,695,651
50,6,11,California,Colusa County,3,11,1423,719,704
50,6,11,California,Colusa County,3,12,1294,648,646
50,6,11,California,Colusa County,3,13,1098,574,524
50,6,11,California,Colusa County,3,14,813,405,408
50,6,11,California,Colusa County,3,15,560,286,274
50,6,11,California,Colusa County,3,16,422,200,222
50,6,11,California,Colusa County,3,17,365,166,199
50,6,11,California,Colusa County,3,18,351,125,226
50,6,11,California,Colusa County,4,0,21323,10976,10347
50,6,11,California,Colusa County,4,1,1765,916,849
50,6,11,California,Colusa County,4,2,1742,932,810
50,6,11,California,Colusa County,4,3,1678,856,822
50,6,11,California,Colusa County,4,4,1748,970,778
50,6,11,California,Colusa County,4,5,1322,720,602
50,6,11,California,Colusa County,4,6,1413,734,679
50,6,11,California,Colusa County,4,7,1318,644,674
50,6,11,California,Colusa County,4,8,1278,648,630
50,6,11,California,Colusa County,4,9,1356,699,657
50,6,11,California,Colusa County,4,10,1305,675,630
50,6,11,California,Colusa County,4,11,1425,720,705
50,6,11,California,Colusa County,4,12,1283,665,618
50,6,11,California,Colusa County,4,13,1155,593,562
50,6,11,California,Colusa County,4,14,823,419,404
50,6,11,California,Colusa County,4,15,597,307,290
50,6,11,California,Colusa County,4,16,405,189,216
50,6,11,California,Colusa County,4,17,362,165,197
50,6,11,California,Colusa County,4,18,348,124,224
50,6,11,California,Colusa County,5,0,21284,10944,10340
50,6,11,California,Colusa County,5,1,1685,881,804
50,6,11,California,Colusa County,5,2,1749,928,821
50,6,11,California,Colusa County,5,3,1652,839,813
50,6,11,California,Colusa County,5,4,1645,903,742
50,6,11,California,Colusa County,5,5,1424,771,653
50,6,11,California,Colusa County,5,6,1389,720,669
50,6,11,California,Colusa County,5,7,1329,693,636
50,6,11,California,Colusa County,5,8,1263,615,648
50,6,11,California,Colusa County,5,9,1315,685,630
50,6,11,California,Colusa County,5,10,1314,672,642
50,6,11,California,Colusa County,5,11,1375,698,677
50,6,11,California,Colusa County,5,12,1370,711,659
50,6,11,California,Colusa County,5,13,1130,578,552
50,6,11,California,Colusa County,5,14,884,445,439
50,6,11,California,Colusa County,5,15,639,323,316
50,6,11,California,Colusa County,5,16,407,192,215
50,6,11,California,Colusa County,5,17,356,164,192
50,6,11,California,Colusa County,5,18,358,126,232
50,6,11,California,Colusa County,6,0,21250,10923,10327
50,6,11,California,Colusa County,6,1,1604,822,782
50,6,11,California,Colusa County,6,2,1789,954,835
50,6,11,California,Colusa County,6,3,1608,828,780
50,6,11,California,Colusa County,6,4,1626,888,738
50,6,11,California,Colusa County,6,5,1471,784,687
50,6,11,California,Colusa County,6,6,1389,722,667
50,6,11,California,Colusa County,6,7,1340,714,626
50,6,11,California,Colusa County,6,8,1253,617,636
50,6,11,California,Colusa County,6,9,1283,662,621
50,6,11,California,Colusa County,6,10,1296,670,626
50,6,11,California,Colusa County,6,11,1357,692,665
50,6,11,California,Colusa County,6,12,1359,704,655
50,6,11,California,Colusa County,6,13,1137,567,570
50,6,11,California,Colusa County,6,14,888,455,433
50,6,11,California,Colusa County,6,15,695,349,346
50,6,11,California,Colusa County,6,16,443,215,228
50,6,11,California,Colusa County,6,17,335,146,189
50,6,11,California,Colusa County,6,18,377,134,243
50,6,11,California,Colusa County,7,0,21176,10844,10332
50,6,11,California,Colusa County,7,1,1571,781,790
50,6,11,California,Colusa County,7,2,1768,932,836
50,6,11,California,Colusa County,7,3,1621,859,762
50,6,11,California,Colusa County,7,4,1593,864,729
50,6,11,California,Colusa County,7,5,1461,774,687
50,6,11,California,Colusa County,7,6,1346,710,636
50,6,11,California,Colusa County,7,7,1407,732,675
50,6,11,California,Colusa County,7,8,1250,624,626
50,6,11,California,Colusa County,7,9,1212,617,595
50,6,11,California,Colusa County,7,10,1281,668,613
50,6,11,California,Colusa County,7,11,1341,679,662
50,6,11,California,Colusa County,7,12,1333,692,641
50,6,11,California,Colusa County,7,13,1169,573,596
50,6,11,California,Colusa County,7,14,925,469,456
50,6,11,California,Colusa County,7,15,719,363,356
50,6,11,California,Colusa County,7,16,468,228,240
50,6,11,California,Colusa County,7,17,317,139,178
50,6,11,California,Colusa County,7,18,394,140,254
50,6,11,California,Colusa County,8,0,21231,10850,10381
50,6,11,California,Colusa County,8,1,1553,770,783
50,6,11,California,Colusa County,8,2,1715,904,811
50,6,11,California,Colusa County,8,3,1606,860,746
50,6,11,California,Colusa County,8,4,1578,836,742
50,6,11,California,Colusa County,8,5,1499,781,718
50,6,11,California,Colusa County,8,6,1315,715,600
50,6,11,California,Colusa County,8,7,1441,733,708
50,6,11,California,Colusa County,8,8,1254,625,629
50,6,11,California,Colusa County,8,9,1199,610,589
50,6,11,California,Colusa County,8,10,1274,660,614
50,6,11,California,Colusa County,8,11,1309,670,639
50,6,11,California,Colusa County,8,12,1365,700,665
50,6,11,California,Colusa County,8,13,1199,595,604
50,6,11,California,Colusa County,8,14,968,496,472
50,6,11,California,Colusa County,8,15,737,366,371
50,6,11,California,Colusa County,8,16,493,242,251
50,6,11,California,Colusa County,8,17,319,142,177
50,6,11,California,Colusa County,8,18,407,145,262
50,6,11,California,Colusa County,9,0,21496,10978,10518
50,6,11,California,Colusa County,9,1,1546,770,776
50,6,11,California,Colusa County,9,2,1720,899,821
50,6,11,California,Colusa County,9,3,1658,884,774
50,6,11,California,Colusa County,9,4,1580,841,739
50,6,11,California,Colusa County,9,5,1478,760,718
50,6,11,California,Colusa County,9,6,1376,755,621
50,6,11,California,Colusa County,9,7,1433,725,708
50,6,11,California,Colusa County,9,8,1338,672,666
50,6,11,California,Colusa County,9,9,1179,588,591
50,6,11,California,Colusa County,9,10,1305,663,642
50,6,11,California,Colusa County,9,11,1259,650,609
50,6,11,California,Colusa County,9,12,1398,719,679
50,6,11,California,Colusa County,9,13,1221,629,592
50,6,11,California,Colusa County,9,14,1015,508,507
50,6,11,California,Colusa County,9,15,728,358,370
50,6,11,California,Colusa County,9,16,520,259,261
50,6,11,California,Colusa County,9,17,322,139,183
50,6,11,California,Colusa County,9,18,420,159,261
50,6,11,California,Colusa County,10,0,21579,11006,10573
50,6,11,California,Colusa County,10,1,1598,811,787
50,6,11,California,Colusa County,10,2,1673,862,811
50,6,11,California,Colusa County,10,3,1711,897,814
50,6,11,California,Colusa County,10,4,1605,865,740
50,6,11,California,Colusa County,10,5,1415,709,706
50,6,11,California,Colusa County,10,6,1428,765,663
50,6,11,California,Colusa County,10,7,1414,721,693
50,6,11,California,Colusa County,10,8,1362,707,655
50,6,11,California,Colusa County,10,9,1209,596,613
50,6,11,California,Colusa County,10,10,1277,650,627
50,6,11,California,Colusa County,10,11,1247,644,603
50,6,11,California,Colusa County,10,12,1310,660,650
50,6,11,California,Colusa County,10,13,1276,673,603
50,6,11,California,Colusa County,10,14,1000,498,502
50,6,11,California,Colusa County,10,15,770,377,393
50,6,11,California,Colusa County,10,16,558,276,282
50,6,11,California,Colusa County,10,17,319,142,177
50,6,11,California,Colusa County,10,18,407,153,254
50,6,11,California,Colusa County,11,0,21418,10925,10493
50,6,11,California,Colusa County,11,1,1499,764,735
50,6,11,California,Colusa County,11,2,1617,830,787
50,6,11,California,Colusa County,11,3,1733,910,823
50,6,11,California,Colusa County,11,4,1595,853,742
50,6,11,California,Colusa County,11,5,1399,722,677
50,6,11,California,Colusa County,11,6,1458,754,704
50,6,11,California,Colusa County,11,7,1398,723,675
50,6,11,California,Colusa County,11,8,1369,697,672
50,6,11,California,Colusa County,11,9,1211,605,606
50,6,11,California,Colusa County,11,10,1241,624,617
50,6,11,California,Colusa County,11,11,1266,650,616
50,6,11,California,Colusa County,11,12,1275,657,618
50,6,11,California,Colusa County,11,13,1240,641,599
50,6,11,California,Colusa County,11,14,1012,503,509
50,6,11,California,Colusa County,11,15,768,386,382
50,6,11,California,Colusa County,11,16,602,295,307
50,6,11,California,Colusa County,11,17,350,167,183
50,6,11,California,Colusa County,11,18,385,144,241
50,6,11,California,Colusa County,12,0,21547,10975,10572
50,6,11,California,Colusa County,12,1,1489,755,734
50,6,11,California,Colusa County,12,2,1588,805,783
50,6,11,California,Colusa County,12,3,1751,924,827
50,6,11,California,Colusa County,12,4,1600,872,728
50,6,11,California,Colusa County,12,5,1352,668,684
50,6,11,California,Colusa County,12,6,1493,765,728
50,6,11,California,Colusa County,12,7,1412,743,669
50,6,11,California,Colusa County,12,8,1444,721,723
50,6,11,California,Colusa County,12,9,1230,629,601
50,6,11,California,Colusa County,12,10,1196,598,598
50,6,11,California,Colusa County,12,11,1248,638,610
50,6,11,California,Colusa County,12,12,1281,669,612
50,6,11,California,Colusa County,12,13,1249,642,607
50,6,11,California,Colusa County,12,14,1053,510,543
50,6,11,California,Colusa County,12,15,789,398,391
50,6,11,California,Colusa County,12,16,632,314,318
50,6,11,California,Colusa County,12,17,368,181,187
50,6,11,California,Colusa County,12,18,372,143,229
50,6,13,California,Contra Costa County,1,0,1049025,511526,537499
50,6,13,California,Contra Costa County,1,1,67018,34004,33014
50,6,13,California,Contra Costa County,1,2,72285,36983,35302
50,6,13,California,Contra Costa County,1,3,74444,38052,36392
50,6,13,California,Contra Costa County,1,4,73766,38187,35579
50,6,13,California,Contra Costa County,1,5,59943,30793,29150
50,6,13,California,Contra Costa County,1,6,64747,32303,32444
50,6,13,California,Contra Costa County,1,7,64896,31637,33259
50,6,13,California,Contra Costa County,1,8,70520,34253,36267
50,6,13,California,Contra Costa County,1,9,78130,38033,40097
50,6,13,California,Contra Costa County,1,10,84006,40737,43269
50,6,13,California,Contra Costa County,1,11,80074,38882,41192
50,6,13,California,Contra Costa County,1,12,69400,33301,36099
50,6,13,California,Contra Costa County,1,13,59358,28062,31296
50,6,13,California,Contra Costa County,1,14,41276,19189,22087
50,6,13,California,Contra Costa County,1,15,29443,13534,15909
50,6,13,California,Contra Costa County,1,16,22383,9761,12622
50,6,13,California,Contra Costa County,1,17,17964,7197,10767
50,6,13,California,Contra Costa County,1,18,19372,6618,12754
50,6,13,California,Contra Costa County,2,0,1049204,511613,537591
50,6,13,California,Contra Costa County,2,1,67020,34005,33015
50,6,13,California,Contra Costa County,2,2,72285,36983,35302
50,6,13,California,Contra Costa County,2,3,74442,38050,36392
50,6,13,California,Contra Costa County,2,4,73766,38187,35579
50,6,13,California,Contra Costa County,2,5,59945,30793,29152
50,6,13,California,Contra Costa County,2,6,64747,32303,32444
50,6,13,California,Contra Costa County,2,7,64897,31637,33260
50,6,13,California,Contra Costa County,2,8,70522,34254,36268
50,6,13,California,Contra Costa County,2,9,78135,38037,40098
50,6,13,California,Contra Costa County,2,10,84011,40741,43270
50,6,13,California,Contra Costa County,2,11,80082,38887,41195
50,6,13,California,Contra Costa County,2,12,69411,33307,36104
50,6,13,California,Contra Costa County,2,13,59370,28070,31300
50,6,13,California,Contra Costa County,2,14,41297,19198,22099
50,6,13,California,Contra Costa County,2,15,29462,13547,15915
50,6,13,California,Contra Costa County,2,16,22412,9774,12638
50,6,13,California,Contra Costa County,2,17,17983,7209,10774
50,6,13,California,Contra Costa County,2,18,19417,6631,12786
50,6,13,California,Contra Costa County,3,0,1052540,513203,539337
50,6,13,California,Contra Costa County,3,1,66918,33961,32957
50,6,13,California,Contra Costa County,3,2,72276,36961,35315
50,6,13,California,Contra Costa County,3,3,74441,38026,36415
50,6,13,California,Contra Costa County,3,4,73786,38163,35623
50,6,13,California,Contra Costa County,3,5,60455,31048,29407
50,6,13,California,Contra Costa County,3,6,64902,32415,32487
50,6,13,California,Contra Costa County,3,7,65331,31842,33489
50,6,13,California,Contra Costa County,3,8,70289,34114,36175
50,6,13,California,Contra Costa County,3,9,78212,38068,40144
50,6,13,California,Contra Costa County,3,10,83883,40699,43184
50,6,13,California,Contra Costa County,3,11,80469,39070,41399
50,6,13,California,Contra Costa County,3,12,69934,33612,36322
50,6,13,California,Contra Costa County,3,13,59952,28340,31612
50,6,13,California,Contra Costa County,3,14,41832,19423,22409
50,6,13,California,Contra Costa County,3,15,29770,13703,16067
50,6,13,California,Contra Costa County,3,16,22454,9809,12645
50,6,13,California,Contra Costa County,3,17,18050,7262,10788
50,6,13,California,Contra Costa County,3,18,19586,6687,12899
50,6,13,California,Contra Costa County,4,0,1065440,519361,546079
50,6,13,California,Contra Costa County,4,1,66368,33690,32678
50,6,13,California,Contra Costa County,4,2,72619,37099,35520
50,6,13,California,Contra Costa County,4,3,74603,38058,36545
50,6,13,California,Contra Costa County,4,4,73582,37929,35653
50,6,13,California,Contra Costa County,4,5,62724,32150,30574
50,6,13,California,Contra Costa County,4,6,65062,32534,32528
50,6,13,California,Contra Costa County,4,7,66738,32524,34214
50,6,13,California,Contra Costa County,4,8,69161,33387,35774
50,6,13,California,Contra Costa County,4,9,78856,38443,40413
50,6,13,California,Contra Costa County,4,10,82799,40285,42514
50,6,13,California,Contra Costa County,4,11,81810,39756,42054
50,6,13,California,Contra Costa County,4,12,72174,34844,37330
50,6,13,California,Contra Costa County,4,13,62563,29528,33035
50,6,13,California,Contra Costa County,4,14,44060,20408,23652
50,6,13,California,Contra Costa County,4,15,31194,14348,16846
50,6,13,California,Contra Costa County,4,16,22840,10070,12770
50,6,13,California,Contra Costa County,4,17,18212,7436,10776
50,6,13,California,Contra Costa County,4,18,20075,6872,13203
50,6,13,California,Contra Costa County,5,0,1077548,525387,552161
50,6,13,California,Contra Costa County,5,1,65179,33188,31991
50,6,13,California,Contra Costa County,5,2,73192,37446,35746
50,6,13,California,Contra Costa County,5,3,74843,38059,36784
50,6,13,California,Contra Costa County,5,4,73058,37646,35412
50,6,13,California,Contra Costa County,5,5,65081,33292,31789
50,6,13,California,Contra Costa County,5,6,64897,32448,32449
50,6,13,California,Contra Costa County,5,7,68196,33537,34659
50,6,13,California,Contra Costa County,5,8,69168,33345,35823
50,6,13,California,Contra Costa County,5,9,78566,38363,40203
50,6,13,California,Contra Costa County,5,10,81574,39718,41856
50,6,13,California,Contra Costa County,5,11,82517,40128,42389
50,6,13,California,Contra Costa County,5,12,74434,35990,38444
50,6,13,California,Contra Costa County,5,13,62785,29506,33279
50,6,13,California,Contra Costa County,5,14,48515,22540,25975
50,6,13,California,Contra Costa County,5,15,32996,15115,17881
50,6,13,California,Contra Costa County,5,16,23529,10403,13126
50,6,13,California,Contra Costa County,5,17,18397,7605,10792
50,6,13,California,Contra Costa County,5,18,20621,7058,13563
50,6,13,California,Contra Costa County,6,0,1093401,533254,560147
50,6,13,California,Contra Costa County,6,1,65061,33042,32019
50,6,13,California,Contra Costa County,6,2,73546,37547,35999
50,6,13,California,Contra Costa County,6,3,75563,38460,37103
50,6,13,California,Contra Costa County,6,4,72740,37481,35259
50,6,13,California,Contra Costa County,6,5,67562,34534,33028
50,6,13,California,Contra Costa County,6,6,65429,32887,32542
50,6,13,California,Contra Costa County,6,7,70041,34447,35594
50,6,13,California,Contra Costa County,6,8,70003,33858,36145
50,6,13,California,Contra Costa County,6,9,78103,38141,39962
50,6,13,California,Contra Costa County,6,10,80819,39380,41439
50,6,13,California,Contra Costa County,6,11,83564,40619,42945
50,6,13,California,Contra Costa County,6,12,76056,36856,39200
50,6,13,California,Contra Costa County,6,13,63965,30051,33914
50,6,13,California,Contra Costa County,6,14,51292,23803,27489
50,6,13,California,Contra Costa County,6,15,35290,16146,19144
50,6,13,California,Contra Costa County,6,16,24571,10912,13659
50,6,13,California,Contra Costa County,6,17,18658,7793,10865
50,6,13,California,Contra Costa County,6,18,21138,7297,13841
50,6,13,California,Contra Costa County,7,0,1108876,541082,567794
50,6,13,California,Contra Costa County,7,1,65360,33273,32087
50,6,13,California,Contra Costa County,7,2,73273,37440,35833
50,6,13,California,Contra Costa County,7,3,76399,38868,37531
50,6,13,California,Contra Costa County,7,4,72433,37209,35224
50,6,13,California,Contra Costa County,7,5,68932,35063,33869
50,6,13,California,Contra Costa County,7,6,66822,33697,33125
50,6,13,California,Contra Costa County,7,7,71898,35475,36423
50,6,13,California,Contra Costa County,7,8,71262,34524,36738
50,6,13,California,Contra Costa County,7,9,77154,37649,39505
50,6,13,California,Contra Costa County,7,10,80442,39312,41130
50,6,13,California,Contra Costa County,7,11,84543,41232,43311
50,6,13,California,Contra Costa County,7,12,77151,37349,39802
50,6,13,California,Contra Costa County,7,13,65631,30967,34664
50,6,13,California,Contra Costa County,7,14,54045,25053,28992
50,6,13,California,Contra Costa County,7,15,37381,17013,20368
50,6,13,California,Contra Costa County,7,16,25681,11484,14197
50,6,13,California,Contra Costa County,7,17,18766,7842,10924
50,6,13,California,Contra Costa County,7,18,21703,7632,14071
50,6,13,California,Contra Costa County,8,0,1124405,548866,575539
50,6,13,California,Contra Costa County,8,1,65780,33483,32297
50,6,13,California,Contra Costa County,8,2,73322,37425,35897
50,6,13,California,Contra Costa County,8,3,76773,39105,37668
50,6,13,California,Contra Costa County,8,4,72809,37387,35422
50,6,13,California,Contra Costa County,8,5,69162,35245,33917
50,6,13,California,Contra Costa County,8,6,68564,34723,33841
50,6,13,California,Contra Costa County,8,7,72957,35999,36958
50,6,13,California,Contra Costa County,8,8,73470,35672,37798
50,6,13,California,Contra Costa County,8,9,75906,37036,38870
50,6,13,California,Contra Costa County,8,10,81107,39680,41427
50,6,13,California,Contra Costa County,8,11,84485,41188,43297
50,6,13,California,Contra Costa County,8,12,78632,38128,40504
50,6,13,California,Contra Costa County,8,13,67333,31862,35471
50,6,13,California,Contra Costa County,8,14,56659,26187,30472
50,6,13,California,Contra Costa County,8,15,39321,17777,21544
50,6,13,California,Contra Costa County,8,16,26840,12059,14781
50,6,13,California,Contra Costa County,8,17,18922,7957,10965
50,6,13,California,Contra Costa County,8,18,22363,7953,14410
50,6,13,California,Contra Costa County,9,0,1137268,555612,581656
50,6,13,California,Contra Costa County,9,1,65921,33614,32307
50,6,13,California,Contra Costa County,9,2,73020,37307,35713
50,6,13,California,Contra Costa County,9,3,76890,39039,37851
50,6,13,California,Contra Costa County,9,4,73004,37434,35570
50,6,13,California,Contra Costa County,9,5,68150,34847,33303
50,6,13,California,Contra Costa County,9,6,71299,36092,35207
50,6,13,California,Contra Costa County,9,7,73967,36741,37226
50,6,13,California,Contra Costa County,9,8,75788,36933,38855
50,6,13,California,Contra Costa County,9,9,75516,36727,38789
50,6,13,California,Contra Costa County,9,10,81462,39840,41622
50,6,13,California,Contra Costa County,9,11,83485,40842,42643
50,6,13,California,Contra Costa County,9,12,79490,38655,40835
50,6,13,California,Contra Costa County,9,13,69146,32899,36247
50,6,13,California,Contra Costa County,9,14,58819,27181,31638
50,6,13,California,Contra Costa County,9,15,41252,18601,22651
50,6,13,California,Contra Costa County,9,16,28112,12602,15510
50,6,13,California,Contra Costa County,9,17,19165,8116,11049
50,6,13,California,Contra Costa County,9,18,22782,8142,14640
50,6,13,California,Contra Costa County,10,0,1145535,559900,585635
50,6,13,California,Contra Costa County,10,1,65694,33318,32376
50,6,13,California,Contra Costa County,10,2,71984,36769,35215
50,6,13,California,Contra Costa County,10,3,77409,39545,37864
50,6,13,California,Contra Costa County,10,4,73135,37321,35814
50,6,13,California,Contra Costa County,10,5,67651,34494,33157
50,6,13,California,Contra Costa County,10,6,72765,36991,35774
50,6,13,California,Contra Costa County,10,7,73528,36443,37085
50,6,13,California,Contra Costa County,10,8,77754,38268,39486
50,6,13,California,Contra Costa County,10,9,75848,36819,39029
50,6,13,California,Contra Costa County,10,10,81446,39938,41508
50,6,13,California,Contra Costa County,10,11,81922,40063,41859
50,6,13,California,Contra Costa County,10,12,79882,38902,40980
50,6,13,California,Contra Costa County,10,13,70704,33760,36944
50,6,13,California,Contra Costa County,10,14,58475,26950,31525
50,6,13,California,Contra Costa County,10,15,45091,20455,24636
50,6,13,California,Contra Costa County,10,16,29592,13210,16382
50,6,13,California,Contra Costa County,10,17,19654,8340,11314
50,6,13,California,Contra Costa County,10,18,23001,8314,14687
50,6,13,California,Contra Costa County,11,0,1150519,562835,587684
50,6,13,California,Contra Costa County,11,1,65209,33314,31895
50,6,13,California,Contra Costa County,11,2,70906,36120,34786
50,6,13,California,Contra Costa County,11,3,77447,39556,37891
50,6,13,California,Contra Costa County,11,4,73421,37613,35808
50,6,13,California,Contra Costa County,11,5,66476,33883,32593
50,6,13,California,Contra Costa County,11,6,72974,37108,35866
50,6,13,California,Contra Costa County,11,7,73839,36798,37041
50,6,13,California,Contra Costa County,11,8,78983,38864,40119
50,6,13,California,Contra Costa County,11,9,76380,37181,39199
50,6,13,California,Contra Costa County,11,10,80575,39525,41050
50,6,13,California,Contra Costa County,11,11,80619,39352,41267
50,6,13,California,Contra Costa County,11,12,80351,39214,41137
50,6,13,California,Contra Costa County,11,13,71675,34362,37313
50,6,13,California,Contra Costa County,11,14,59089,27184,31905
50,6,13,California,Contra Costa County,11,15,47404,21557,25847
50,6,13,California,Contra Costa County,11,16,31446,13941,17505
50,6,13,California,Contra Costa County,11,17,20482,8775,11707
50,6,13,California,Contra Costa County,11,18,23243,8488,14755
50,6,13,California,Contra Costa County,12,0,1153526,564187,589339
50,6,13,California,Contra Costa County,12,1,64624,33004,31620
50,6,13,California,Contra Costa County,12,2,70600,35963,34637
50,6,13,California,Contra Costa County,12,3,76495,39024,37471
50,6,13,California,Contra Costa County,12,4,73741,37825,35916
50,6,13,California,Contra Costa County,12,5,65694,33378,32316
50,6,13,California,Contra Costa County,12,6,72386,36721,35665
50,6,13,California,Contra Costa County,12,7,73916,36928,36988
50,6,13,California,Contra Costa County,12,8,79715,39272,40443
50,6,13,California,Contra Costa County,12,9,77128,37603,39525
50,6,13,California,Contra Costa County,12,10,79182,38683,40499
50,6,13,California,Contra Costa County,12,11,79568,39015,40553
50,6,13,California,Contra Costa County,12,12,80549,39336,41213
50,6,13,California,Contra Costa County,12,13,72224,34515,37709
50,6,13,California,Contra Costa County,12,14,60276,27970,32306
50,6,13,California,Contra Costa County,12,15,49477,22496,26981
50,6,13,California,Contra Costa County,12,16,33204,14673,18531
50,6,13,California,Contra Costa County,12,17,21307,9172,12135
50,6,13,California,Contra Costa County,12,18,23440,8609,14831
50,6,15,California,Del Norte County,1,0,28610,15907,12703
50,6,15,California,Del Norte County,1,1,1703,850,853
50,6,15,California,Del Norte County,1,2,1567,827,740
50,6,15,California,Del Norte County,1,3,1718,872,846
50,6,15,California,Del Norte County,1,4,1870,986,884
50,6,15,California,Del Norte County,1,5,1799,1110,689
50,6,15,California,Del Norte County,1,6,2081,1354,727
50,6,15,California,Del Norte County,1,7,2000,1351,649
50,6,15,California,Del Norte County,1,8,1937,1284,653
50,6,15,California,Del Norte County,1,9,1895,1184,711
50,6,15,California,Del Norte County,1,10,2204,1254,950
50,6,15,California,Del Norte County,1,11,2246,1172,1074
50,6,15,California,Del Norte County,1,12,1975,1003,972
50,6,15,California,Del Norte County,1,13,1742,905,837
50,6,15,California,Del Norte County,1,14,1245,613,632
50,6,15,California,Del Norte County,1,15,908,411,497
50,6,15,California,Del Norte County,1,16,739,332,407
50,6,15,California,Del Norte County,1,17,524,229,295
50,6,15,California,Del Norte County,1,18,457,170,287
50,6,15,California,Del Norte County,2,0,28610,15907,12703
50,6,15,California,Del Norte County,2,1,1703,850,853
50,6,15,California,Del Norte County,2,2,1567,827,740
50,6,15,California,Del Norte County,2,3,1718,872,846
50,6,15,California,Del Norte County,2,4,1870,986,884
50,6,15,California,Del Norte County,2,5,1799,1110,689
50,6,15,California,Del Norte County,2,6,2081,1354,727
50,6,15,California,Del Norte County,2,7,2000,1351,649
50,6,15,California,Del Norte County,2,8,1937,1284,653
50,6,15,California,Del Norte County,2,9,1895,1184,711
50,6,15,California,Del Norte County,2,10,2204,1254,950
50,6,15,California,Del Norte County,2,11,2246,1172,1074
50,6,15,California,Del Norte County,2,12,1975,1003,972
50,6,15,California,Del Norte County,2,13,1742,905,837
50,6,15,California,Del Norte County,2,14,1245,613,632
50,6,15,California,Del Norte County,2,15,908,411,497
50,6,15,California,Del Norte County,2,16,739,332,407
50,6,15,California,Del Norte County,2,17,524,229,295
50,6,15,California,Del Norte County,2,18,457,170,287
50,6,15,California,Del Norte County,3,0,28566,15877,12689
50,6,15,California,Del Norte County,3,1,1714,858,856
50,6,15,California,Del Norte County,3,2,1569,830,739
50,6,15,California,Del Norte County,3,3,1723,869,854
50,6,15,California,Del Norte County,3,4,1841,974,867
50,6,15,California,Del Norte County,3,5,1796,1105,691
50,6,15,California,Del Norte County,3,6,2083,1348,735
50,6,15,California,Del Norte County,3,7,2008,1349,659
50,6,15,California,Del Norte County,3,8,1914,1268,646
50,6,15,California,Del Norte County,3,9,1884,1179,705
50,6,15,California,Del Norte County,3,10,2189,1247,942
50,6,15,California,Del Norte County,3,11,2234,1173,1061
50,6,15,California,Del Norte County,3,12,1973,998,975
50,6,15,California,Del Norte County,3,13,1753,910,843
50,6,15,California,Del Norte County,3,14,1259,617,642
50,6,15,California,Del Norte County,3,15,915,421,494
50,6,15,California,Del Norte County,3,16,727,328,399
50,6,15,California,Del Norte County,3,17,529,231,298
50,6,15,California,Del Norte County,3,18,455,172,283
50,6,15,California,Del Norte County,4,0,28443,15819,12624
50,6,15,California,Del Norte County,4,1,1696,847,849
50,6,15,California,Del Norte County,4,2,1602,844,758
50,6,15,California,Del Norte County,4,3,1686,845,841
50,6,15,California,Del Norte County,4,4,1750,936,814
50,6,15,California,Del Norte County,4,5,1813,1115,698
50,6,15,California,Del Norte County,4,6,2087,1346,741
50,6,15,California,Del Norte County,4,7,2051,1380,671
50,6,15,California,Del Norte County,4,8,1874,1241,633
50,6,15,California,Del Norte County,4,9,1839,1145,694
50,6,15,California,Del Norte County,4,10,2081,1204,877
50,6,15,California,Del Norte County,4,11,2214,1175,1039
50,6,15,California,Del Norte County,4,12,2022,1008,1014
50,6,15,California,Del Norte County,4,13,1807,936,871
50,6,15,California,Del Norte County,4,14,1266,619,647
50,6,15,California,Del Norte County,4,15,953,451,502
50,6,15,California,Del Norte County,4,16,686,313,373
50,6,15,California,Del Norte County,4,17,546,239,307
50,6,15,California,Del Norte County,4,18,470,175,295
50,6,15,California,Del Norte County,5,0,28190,15663,12527
50,6,15,California,Del Norte County,5,1,1644,827,817
50,6,15,California,Del Norte County,5,2,1649,841,808
50,6,15,California,Del Norte County,5,3,1623,814,809
50,6,15,California,Del Norte County,5,4,1708,932,776
50,6,15,California,Del Norte County,5,5,1817,1105,712
50,6,15,California,Del Norte County,5,6,2041,1317,724
50,6,15,California,Del Norte County,5,7,2103,1425,678
50,6,15,California,Del Norte County,5,8,1837,1216,621
50,6,15,California,Del Norte County,5,9,1787,1116,671
50,6,15,California,Del Norte County,5,10,1965,1154,811
50,6,15,California,Del Norte County,5,11,2130,1121,1009
50,6,15,California,Del Norte County,5,12,2014,976,1038
50,6,15,California,Del Norte County,5,13,1809,936,873
50,6,15,California,Del Norte County,5,14,1369,678,691
50,6,15,California,Del Norte County,5,15,1008,486,522
50,6,15,California,Del Norte County,5,16,658,294,364
50,6,15,California,Del Norte County,5,17,574,245,329
50,6,15,California,Del Norte County,5,18,454,180,274
50,6,15,California,Del Norte County,6,0,27816,15407,12409
50,6,15,California,Del Norte County,6,1,1624,834,790
50,6,15,California,Del Norte County,6,2,1684,848,836
50,6,15,California,Del Norte County,6,3,1558,807,751
50,6,15,California,Del Norte County,6,4,1642,896,746
50,6,15,California,Del Norte County,6,5,1750,1064,686
50,6,15,California,Del Norte County,6,6,1962,1238,724
50,6,15,California,Del Norte County,6,7,2098,1399,699
50,6,15,California,Del Norte County,6,8,1823,1207,616
50,6,15,California,Del Norte County,6,9,1707,1045,662
50,6,15,California,Del Norte County,6,10,1854,1090,764
50,6,15,California,Del Norte County,6,11,2056,1104,952
50,6,15,California,Del Norte County,6,12,2064,983,1081
50,6,15,California,Del Norte County,6,13,1827,945,882
50,6,15,California,Del Norte County,6,14,1398,717,681
50,6,15,California,Del Norte County,6,15,1066,504,562
50,6,15,California,Del Norte County,6,16,677,290,387
50,6,15,California,Del Norte County,6,17,557,242,315
50,6,15,California,Del Norte County,6,18,469,194,275
50,6,15,California,Del Norte County,7,0,27175,14858,12317
50,6,15,California,Del Norte County,7,1,1590,774,816
50,6,15,California,Del Norte County,7,2,1663,841,822
50,6,15,California,Del Norte County,7,3,1582,825,757
50,6,15,California,Del Norte County,7,4,1547,841,706
50,6,15,California,Del Norte County,7,5,1617,972,645
50,6,15,California,Del Norte County,7,6,1869,1171,698
50,6,15,California,Del Norte County,7,7,2054,1328,726
50,6,15,California,Del Norte County,7,8,1805,1179,626
50,6,15,California,Del Norte County,7,9,1632,986,646
50,6,15,California,Del Norte County,7,10,1688,986,702
50,6,15,California,Del Norte County,7,11,1990,1062,928
50,6,15,California,Del Norte County,7,12,2035,978,1057
50,6,15,California,Del Norte County,7,13,1827,911,916
50,6,15,California,Del Norte County,7,14,1484,773,711
50,6,15,California,Del Norte County,7,15,1076,502,574
50,6,15,California,Del Norte County,7,16,712,300,412
50,6,15,California,Del Norte County,7,17,537,247,290
50,6,15,California,Del Norte County,7,18,467,182,285
50,6,15,California,Del Norte County,8,0,27190,14883,12307
50,6,15,California,Del Norte County,8,1,1585,816,769
50,6,15,California,Del Norte County,8,2,1649,839,810
50,6,15,California,Del Norte County,8,3,1532,781,751
50,6,15,California,Del Norte County,8,4,1553,853,700
50,6,15,California,Del Norte County,8,5,1591,942,649
50,6,15,California,Del Norte County,8,6,1887,1204,683
50,6,15,California,Del Norte County,8,7,2037,1323,714
50,6,15,California,Del Norte County,8,8,1835,1173,662
50,6,15,California,Del Norte County,8,9,1608,988,620
50,6,15,California,Del Norte County,8,10,1644,952,692
50,6,15,California,Del Norte County,8,11,1892,1005,887
50,6,15,California,Del Norte County,8,12,2061,1018,1043
50,6,15,California,Del Norte County,8,13,1866,904,962
50,6,15,California,Del Norte County,8,14,1625,830,795
50,6,15,California,Del Norte County,8,15,1054,502,552
50,6,15,California,Del Norte County,8,16,753,329,424
50,6,15,California,Del Norte County,8,17,537,242,295
50,6,15,California,Del Norte County,8,18,481,182,299
50,6,15,California,Del Norte County,9,0,27382,14885,12497
50,6,15,California,Del Norte County,9,1,1654,865,789
50,6,15,California,Del Norte County,9,2,1650,828,822
50,6,15,California,Del Norte County,9,3,1562,810,752
50,6,15,California,Del Norte County,9,4,1542,825,717
50,6,15,California,Del Norte County,9,5,1561,938,623
50,6,15,California,Del Norte County,9,6,1880,1196,684
50,6,15,California,Del Norte County,9,7,2007,1250,757
50,6,15,California,Del Norte County,9,8,1899,1215,684
50,6,15,California,Del Norte County,9,9,1581,943,638
50,6,15,California,Del Norte County,9,10,1635,949,686
50,6,15,California,Del Norte County,9,11,1829,992,837
50,6,15,California,Del Norte County,9,12,2039,1003,1036
50,6,15,California,Del Norte County,9,13,1928,920,1008
50,6,15,California,Del Norte County,9,14,1722,866,856
50,6,15,California,Del Norte County,9,15,1099,517,582
50,6,15,California,Del Norte County,9,16,788,358,430
50,6,15,California,Del Norte County,9,17,494,226,268
50,6,15,California,Del Norte County,9,18,512,184,328
50,6,15,California,Del Norte County,10,0,27351,14744,12607
50,6,15,California,Del Norte County,10,1,1606,857,749
50,6,15,California,Del Norte County,10,2,1679,839,840
50,6,15,California,Del Norte County,10,3,1680,872,808
50,6,15,California,Del Norte County,10,4,1516,794,722
50,6,15,California,Del Norte County,10,5,1522,924,598
50,6,15,California,Del Norte County,10,6,1848,1125,723
50,6,15,California,Del Norte County,10,7,1960,1213,747
50,6,15,California,Del Norte County,10,8,1964,1218,746
50,6,15,California,Del Norte County,10,9,1531,899,632
50,6,15,California,Del Norte County,10,10,1586,909,677
50,6,15,California,Del Norte County,10,11,1725,934,791
50,6,15,California,Del Norte County,10,12,1987,984,1003
50,6,15,California,Del Norte County,10,13,1962,915,1047
50,6,15,California,Del Norte County,10,14,1729,874,855
50,6,15,California,Del Norte County,10,15,1202,588,614
50,6,15,California,Del Norte County,10,16,831,378,453
50,6,15,California,Del Norte County,10,17,484,217,267
50,6,15,California,Del Norte County,10,18,539,204,335
50,6,15,California,Del Norte County,11,0,27740,15131,12609
50,6,15,California,Del Norte County,11,1,1519,782,737
50,6,15,California,Del Norte County,11,2,1695,878,817
50,6,15,California,Del Norte County,11,3,1697,866,831
50,6,15,California,Del Norte County,11,4,1474,771,703
50,6,15,California,Del Norte County,11,5,1578,960,618
50,6,15,California,Del Norte County,11,6,1920,1202,718
50,6,15,California,Del Norte County,11,7,2007,1299,708
50,6,15,California,Del Norte County,11,8,2064,1272,792
50,6,15,California,Del Norte County,11,9,1631,991,640
50,6,15,California,Del Norte County,11,10,1624,962,662
50,6,15,California,Del Norte County,11,11,1639,891,748
50,6,15,California,Del Norte County,11,12,1934,988,946
50,6,15,California,Del Norte County,11,13,2003,918,1085
50,6,15,California,Del Norte County,11,14,1747,858,889
50,6,15,California,Del Norte County,11,15,1272,651,621
50,6,15,California,Del Norte County,11,16,873,397,476
50,6,15,California,Del Norte County,11,17,528,239,289
50,6,15,California,Del Norte County,11,18,535,206,329
50,6,15,California,Del Norte County,12,0,27812,15186,12626
50,6,15,California,Del Norte County,12,1,1449,755,694
50,6,15,California,Del Norte County,12,2,1715,871,844
50,6,15,California,Del Norte County,12,3,1710,881,829
50,6,15,California,Del Norte County,12,4,1501,802,699
50,6,15,California,Del Norte County,12,5,1510,914,596
50,6,15,California,Del Norte County,12,6,1891,1196,695
50,6,15,California,Del Norte County,12,7,2002,1305,697
50,6,15,California,Del Norte County,12,8,2082,1282,800
50,6,15,California,Del Norte County,12,9,1706,1032,674
50,6,15,California,Del Norte County,12,10,1602,958,644
50,6,15,California,Del Norte County,12,11,1520,813,707
50,6,15,California,Del Norte County,12,12,1976,994,982
50,6,15,California,Del Norte County,12,13,2025,955,1070
50,6,15,California,Del Norte County,12,14,1756,846,910
50,6,15,California,Del Norte County,12,15,1364,699,665
50,6,15,California,Del Norte County,12,16,899,410,489
50,6,15,California,Del Norte County,12,17,562,253,309
50,6,15,California,Del Norte County,12,18,542,220,322
50,6,17,California,El Dorado County,1,0,181058,90571,90487
50,6,17,California,El Dorado County,1,1,9513,4870,4643
50,6,17,California,El Dorado County,1,2,11126,5664,5462
50,6,17,California,El Dorado County,1,3,12506,6410,6096
50,6,17,California,El Dorado County,1,4,12522,6543,5979
50,6,17,California,El Dorado County,1,5,8958,4889,4069
50,6,17,California,El Dorado County,1,6,8682,4544,4138
50,6,17,California,El Dorado County,1,7,8562,4302,4260
50,6,17,California,El Dorado County,1,8,9993,4954,5039
50,6,17,California,El Dorado County,1,9,12210,5974,6236
50,6,17,California,El Dorado County,1,10,15516,7521,7995
50,6,17,California,El Dorado County,1,11,16830,8310,8520
50,6,17,California,El Dorado County,1,12,15146,7501,7645
50,6,17,California,El Dorado County,1,13,12970,6533,6437
50,6,17,California,El Dorado County,1,14,9141,4519,4622
50,6,17,California,El Dorado County,1,15,6296,3148,3148
50,6,17,California,El Dorado County,1,16,4656,2294,2362
50,6,17,California,El Dorado County,1,17,3313,1432,1881
50,6,17,California,El Dorado County,1,18,3118,1163,1955
50,6,17,California,El Dorado County,2,0,181058,90572,90486
50,6,17,California,El Dorado County,2,1,9513,4870,4643
50,6,17,California,El Dorado County,2,2,11126,5664,5462
50,6,17,California,El Dorado County,2,3,12506,6410,6096
50,6,17,California,El Dorado County,2,4,12522,6543,5979
50,6,17,California,El Dorado County,2,5,8958,4889,4069
50,6,17,California,El Dorado County,2,6,8682,4544,4138
50,6,17,California,El Dorado County,2,7,8562,4302,4260
50,6,17,California,El Dorado County,2,8,9993,4954,5039
50,6,17,California,El Dorado County,2,9,12210,5974,6236
50,6,17,California,El Dorado County,2,10,15516,7521,7995
50,6,17,California,El Dorado County,2,11,16831,8311,8520
50,6,17,California,El Dorado County,2,12,15145,7501,7644
50,6,17,California,El Dorado County,2,13,12970,6533,6437
50,6,17,California,El Dorado County,2,14,9141,4519,4622
50,6,17,California,El Dorado County,2,15,6296,3148,3148
50,6,17,California,El Dorado County,2,16,4656,2294,2362
50,6,17,California,El Dorado County,2,17,3313,1432,1881
50,6,17,California,El Dorado County,2,18,3118,1163,1955
50,6,17,California,El Dorado County,3,0,181136,90588,90548
50,6,17,California,El Dorado County,3,1,9407,4811,4596
50,6,17,California,El Dorado County,3,2,11095,5643,5452
50,6,17,California,El Dorado County,3,3,12432,6374,6058
50,6,17,California,El Dorado County,3,4,12463,6515,5948
50,6,17,California,El Dorado County,3,5,9066,4928,4138
50,6,17,California,El Dorado County,3,6,8705,4557,4148
50,6,17,California,El Dorado County,3,7,8599,4323,4276
50,6,17,California,El Dorado County,3,8,9878,4899,4979
50,6,17,California,El Dorado County,3,9,12156,5958,6198
50,6,17,California,El Dorado County,3,10,15359,7446,7913
50,6,17,California,El Dorado County,3,11,16829,8298,8531
50,6,17,California,El Dorado County,3,12,15209,7525,7684
50,6,17,California,El Dorado County,3,13,13161,6626,6535
50,6,17,California,El Dorado County,3,14,9232,4564,4668
50,6,17,California,El Dorado County,3,15,6382,3191,3191
50,6,17,California,El Dorado County,3,16,4662,2303,2359
50,6,17,California,El Dorado County,3,17,3340,1452,1888
50,6,17,California,El Dorado County,3,18,3161,1175,1986
50,6,17,California,El Dorado County,4,0,180936,90450,90486
50,6,17,California,El Dorado County,4,1,8916,4580,4336
50,6,17,California,El Dorado County,4,2,10996,5607,5389
50,6,17,California,El Dorado County,4,3,12194,6208,5986
50,6,17,California,El Dorado County,4,4,12201,6390,5811
50,6,17,California,El Dorado County,4,5,9565,5100,4465
50,6,17,California,El Dorado County,4,6,8674,4562,4112
50,6,17,California,El Dorado County,4,7,8636,4398,4238
50,6,17,California,El Dorado County,4,8,9264,4619,4645
50,6,17,California,El Dorado County,4,9,11868,5816,6052
50,6,17,California,El Dorado County,4,10,14584,7088,7496
50,6,17,California,El Dorado County,4,11,16837,8247,8590
50,6,17,California,El Dorado County,4,12,15450,7619,7831
50,6,17,California,El Dorado County,4,13,13909,6988,6921
50,6,17,California,El Dorado County,4,14,9646,4764,4882
50,6,17,California,El Dorado County,4,15,6730,3344,3386
50,6,17,California,El Dorado County,4,16,4695,2334,2361
50,6,17,California,El Dorado County,4,17,3439,1549,1890
50,6,17,California,El Dorado County,4,18,3332,1237,2095
50,6,17,California,El Dorado County,5,0,180575,90238,90337
50,6,17,California,El Dorado County,5,1,8578,4390,4188
50,6,17,California,El Dorado County,5,2,10910,5594,5316
50,6,17,California,El Dorado County,5,3,11906,6077,5829
50,6,17,California,El Dorado County,5,4,11937,6233,5704
50,6,17,California,El Dorado County,5,5,9849,5217,4632
50,6,17,California,El Dorado County,5,6,8523,4507,4016
50,6,17,California,El Dorado County,5,7,8835,4484,4351
50,6,17,California,El Dorado County,5,8,8995,4453,4542
50,6,17,California,El Dorado County,5,9,11567,5715,5852
50,6,17,California,El Dorado County,5,10,13615,6610,7005
50,6,17,California,El Dorado County,5,11,16557,8117,8440
50,6,17,California,El Dorado County,5,12,15747,7668,8079
50,6,17,California,El Dorado County,5,13,13859,7020,6839
50,6,17,California,El Dorado County,5,14,10764,5315,5449
50,6,17,California,El Dorado County,5,15,7156,3528,3628
50,6,17,California,El Dorado County,5,16,4848,2415,2433
50,6,17,California,El Dorado County,5,17,3502,1612,1890
50,6,17,California,El Dorado County,5,18,3427,1283,2144
50,6,17,California,El Dorado County,6,0,181481,90703,90778
50,6,17,California,El Dorado County,6,1,8342,4274,4068
50,6,17,California,El Dorado County,6,2,10713,5497,5216
50,6,17,California,El Dorado County,6,3,11889,6105,5784
50,6,17,California,El Dorado County,6,4,11741,6078,5663
50,6,17,California,El Dorado County,6,5,9971,5310,4661
50,6,17,California,El Dorado County,6,6,8539,4526,4013
50,6,17,California,El Dorado County,6,7,9102,4573,4529
50,6,17,California,El Dorado County,6,8,9021,4467,4554
50,6,17,California,El Dorado County,6,9,11367,5646,5721
50,6,17,California,El Dorado County,6,10,12876,6305,6571
50,6,17,California,El Dorado County,6,11,16099,7879,8220
50,6,17,California,El Dorado County,6,12,16151,7897,8254
50,6,17,California,El Dorado County,6,13,14263,7132,7131
50,6,17,California,El Dorado County,6,14,11299,5611,5688
50,6,17,California,El Dorado County,6,15,7785,3818,3967
50,6,17,California,El Dorado County,6,16,5097,2521,2576
50,6,17,California,El Dorado County,6,17,3627,1710,1917
50,6,17,California,El Dorado County,6,18,3599,1354,2245
50,6,17,California,El Dorado County,7,0,183108,91551,91557
50,6,17,California,El Dorado County,7,1,8463,4364,4099
50,6,17,California,El Dorado County,7,2,10591,5430,5161
50,6,17,California,El Dorado County,7,3,11695,6016,5679
50,6,17,California,El Dorado County,7,4,11651,6080,5571
50,6,17,California,El Dorado County,7,5,10164,5396,4768
50,6,17,California,El Dorado County,7,6,8809,4648,4161
50,6,17,California,El Dorado County,7,7,9241,4699,4542
50,6,17,California,El Dorado County,7,8,9260,4578,4682
50,6,17,California,El Dorado County,7,9,10947,5436,5511
50,6,17,California,El Dorado County,7,10,12508,6143,6365
50,6,17,California,El Dorado County,7,11,15641,7645,7996
50,6,17,California,El Dorado County,7,12,16371,8006,8365
50,6,17,California,El Dorado County,7,13,14561,7210,7351
50,6,17,California,El Dorado County,7,14,12096,6047,6049
50,6,17,California,El Dorado County,7,15,8197,3998,4199
50,6,17,California,El Dorado County,7,16,5403,2653,2750
50,6,17,California,El Dorado County,7,17,3745,1775,1970
50,6,17,California,El Dorado County,7,18,3765,1427,2338
50,6,17,California,El Dorado County,8,0,184569,92136,92433
50,6,17,California,El Dorado County,8,1,8691,4468,4223
50,6,17,California,El Dorado County,8,2,10315,5288,5027
50,6,17,California,El Dorado County,8,3,11602,5967,5635
50,6,17,California,El Dorado County,8,4,11461,5964,5497
50,6,17,California,El Dorado County,8,5,10175,5350,4825
50,6,17,California,El Dorado County,8,6,9011,4719,4292
50,6,17,California,El Dorado County,8,7,9403,4818,4585
50,6,17,California,El Dorado County,8,8,9652,4793,4859
50,6,17,California,El Dorado County,8,9,10589,5274,5315
50,6,17,California,El Dorado County,8,10,12413,6083,6330
50,6,17,California,El Dorado County,8,11,15110,7347,7763
50,6,17,California,El Dorado County,8,12,16555,8119,8436
50,6,17,California,El Dorado County,8,13,14729,7253,7476
50,6,17,California,El Dorado County,8,14,12851,6400,6451
50,6,17,California,El Dorado County,8,15,8636,4216,4420
50,6,17,California,El Dorado County,8,16,5682,2792,2890
50,6,17,California,El Dorado County,8,17,3805,1812,1993
50,6,17,California,El Dorado County,8,18,3889,1473,2416
50,6,17,California,El Dorado County,9,0,185976,92659,93317
50,6,17,California,El Dorado County,9,1,8690,4464,4226
50,6,17,California,El Dorado County,9,2,10129,5176,4953
50,6,17,California,El Dorado County,9,3,11677,5970,5707
50,6,17,California,El Dorado County,9,4,11230,5851,5379
50,6,17,California,El Dorado County,9,5,9938,5154,4784
50,6,17,California,El Dorado County,9,6,9136,4785,4351
50,6,17,California,El Dorado County,9,7,9497,4846,4651
50,6,17,California,El Dorado County,9,8,10021,4970,5051
50,6,17,California,El Dorado County,9,9,10227,5126,5101
50,6,17,California,El Dorado County,9,10,12441,6105,6336
50,6,17,California,El Dorado County,9,11,14571,7129,7442
50,6,17,California,El Dorado County,9,12,16675,8151,8524
50,6,17,California,El Dorado County,9,13,15096,7391,7705
50,6,17,California,El Dorado County,9,14,13605,6777,6828
50,6,17,California,El Dorado County,9,15,9117,4425,4692
50,6,17,California,El Dorado County,9,16,6027,2938,3089
50,6,17,California,El Dorado County,9,17,3821,1855,1966
50,6,17,California,El Dorado County,9,18,4078,1546,2532
50,6,17,California,El Dorado County,10,0,188679,93992,94687
50,6,17,California,El Dorado County,10,1,8766,4482,4284
50,6,17,California,El Dorado County,10,2,10119,5162,4957
50,6,17,California,El Dorado County,10,3,11836,6061,5775
50,6,17,California,El Dorado County,10,4,11137,5823,5314
50,6,17,California,El Dorado County,10,5,9698,5020,4678
50,6,17,California,El Dorado County,10,6,9665,5086,4579
50,6,17,California,El Dorado County,10,7,9611,4921,4690
50,6,17,California,El Dorado County,10,8,10580,5235,5345
50,6,17,California,El Dorado County,10,9,10210,5074,5136
50,6,17,California,El Dorado County,10,10,12281,6048,6233
50,6,17,California,El Dorado County,10,11,13959,6864,7095
50,6,17,California,El Dorado County,10,12,16580,8080,8500
50,6,17,California,El Dorado County,10,13,15744,7606,8138
50,6,17,California,El Dorado County,10,14,13673,6874,6799
50,6,17,California,El Dorado County,10,15,10239,4989,5250
50,6,17,California,El Dorado County,10,16,6390,3101,3289
50,6,17,California,El Dorado County,10,17,3946,1914,2032
50,6,17,California,El Dorado County,10,18,4245,1652,2593
50,6,17,California,El Dorado County,11,0,190746,95065,95681
50,6,17,California,El Dorado County,11,1,8767,4458,4309
50,6,17,California,El Dorado County,11,2,10163,5244,4919
50,6,17,California,El Dorado County,11,3,11799,5995,5804
50,6,17,California,El Dorado County,11,4,11100,5802,5298
50,6,17,California,El Dorado County,11,5,9544,4929,4615
50,6,17,California,El Dorado County,11,6,9667,5139,4528
50,6,17,California,El Dorado County,11,7,9769,4985,4784
50,6,17,California,El Dorado County,11,8,10966,5390,5576
50,6,17,California,El Dorado County,11,9,10500,5198,5302
50,6,17,California,El Dorado County,11,10,12175,6092,6083
50,6,17,California,El Dorado County,11,11,13355,6589,6766
50,6,17,California,El Dorado County,11,12,16314,7907,8407
50,6,17,California,El Dorado County,11,13,16164,7833,8331
50,6,17,California,El Dorado County,11,14,14183,7078,7105
50,6,17,California,El Dorado County,11,15,10783,5295,5488
50,6,17,California,El Dorado County,11,16,6924,3377,3547
50,6,17,California,El Dorado County,11,17,4200,2014,2186
50,6,17,California,El Dorado County,11,18,4373,1740,2633
50,6,17,California,El Dorado County,12,0,192843,96158,96685
50,6,17,California,El Dorado County,12,1,8861,4459,4402
50,6,17,California,El Dorado County,12,2,10291,5358,4933
50,6,17,California,El Dorado County,12,3,11693,5963,5730
50,6,17,California,El Dorado County,12,4,11088,5778,5310
50,6,17,California,El Dorado County,12,5,9481,4881,4600
50,6,17,California,El Dorado County,12,6,9722,5153,4569
50,6,17,California,El Dorado County,12,7,9940,5025,4915
50,6,17,California,El Dorado County,12,8,11224,5515,5709
50,6,17,California,El Dorado County,12,9,10953,5468,5485
50,6,17,California,El Dorado County,12,10,11749,5887,5862
50,6,17,California,El Dorado County,12,11,13007,6420,6587
50,6,17,California,El Dorado County,12,12,16077,7812,8265
50,6,17,California,El Dorado County,12,13,16453,7978,8475
50,6,17,California,El Dorado County,12,14,14550,7240,7310
50,6,17,California,El Dorado County,12,15,11509,5722,5787
50,6,17,California,El Dorado County,12,16,7359,3580,3779
50,6,17,California,El Dorado County,12,17,4448,2113,2335
50,6,17,California,El Dorado County,12,18,4438,1806,2632
50,6,19,California,Fresno County,1,0,930450,464811,465639
50,6,19,California,Fresno County,1,1,78980,40476,38504
50,6,19,California,Fresno County,1,2,75040,38161,36879
50,6,19,California,Fresno County,1,3,75409,38453,36956
50,6,19,California,Fresno County,1,4,81306,41878,39428
50,6,19,California,Fresno County,1,5,75290,38646,36644
50,6,19,California,Fresno County,1,6,70495,36186,34309
50,6,19,California,Fresno County,1,7,62234,31790,30444
50,6,19,California,Fresno County,1,8,57710,29033,28677
50,6,19,California,Fresno County,1,9,56659,28663,27996
50,6,19,California,Fresno County,1,10,59046,29446,29600
50,6,19,California,Fresno County,1,11,56006,27908,28098
50,6,19,California,Fresno County,1,12,48907,23911,24996
50,6,19,California,Fresno County,1,13,39947,19497,20450
50,6,19,California,Fresno County,1,14,28529,13580,14949
50,6,19,California,Fresno County,1,15,20970,9670,11300
50,6,19,California,Fresno County,1,16,16700,7145,9555
50,6,19,California,Fresno County,1,17,13604,5512,8092
50,6,19,California,Fresno County,1,18,13618,4856,8762
50,6,19,California,Fresno County,2,0,930507,464842,465665
50,6,19,California,Fresno County,2,1,78986,40479,38507
50,6,19,California,Fresno County,2,2,75044,38162,36882
50,6,19,California,Fresno County,2,3,75414,38456,36958
50,6,19,California,Fresno County,2,4,81315,41884,39431
50,6,19,California,Fresno County,2,5,75299,38651,36648
50,6,19,California,Fresno County,2,6,70498,36188,34310
50,6,19,California,Fresno County,2,7,62238,31791,30447
50,6,19,California,Fresno County,2,8,57716,29036,28680
50,6,19,California,Fresno County,2,9,56658,28662,27996
50,6,19,California,Fresno County,2,10,59046,29447,29599
50,6,19,California,Fresno County,2,11,56008,27909,28099
50,6,19,California,Fresno County,2,12,48909,23913,24996
50,6,19,California,Fresno County,2,13,39950,19499,20451
50,6,19,California,Fresno County,2,14,28528,13579,14949
50,6,19,California,Fresno County,2,15,20972,9671,11301
50,6,19,California,Fresno County,2,16,16704,7147,9557
50,6,19,California,Fresno County,2,17,13604,5512,8092
50,6,19,California,Fresno County,2,18,13618,4856,8762
50,6,19,California,Fresno County,3,0,932039,465306,466733
50,6,19,California,Fresno County,3,1,79109,40477,38632
50,6,19,California,Fresno County,3,2,75183,38269,36914
50,6,19,California,Fresno County,3,3,75251,38345,36906
50,6,19,California,Fresno County,3,4,80415,41391,39024
50,6,19,California,Fresno County,3,5,75936,38934,37002
50,6,19,California,Fresno County,3,6,70698,36267,34431
50,6,19,California,Fresno County,3,7,62648,31960,30688
50,6,19,California,Fresno County,3,8,57655,29024,28631
50,6,19,California,Fresno County,3,9,56722,28636,28086
50,6,19,California,Fresno County,3,10,58800,29333,29467
50,6,19,California,Fresno County,3,11,56224,27983,28241
50,6,19,California,Fresno County,3,12,49153,24029,25124
50,6,19,California,Fresno County,3,13,40382,19668,20714
50,6,19,California,Fresno County,3,14,28771,13709,15062
50,6,19,California,Fresno County,3,15,21103,9719,11384
50,6,19,California,Fresno County,3,16,16654,7147,9507
50,6,19,California,Fresno County,3,17,13636,5516,8120
50,6,19,California,Fresno County,3,18,13699,4899,8800
50,6,19,California,Fresno County,4,0,939406,468448,470958
50,6,19,California,Fresno County,4,1,79738,40640,39098
50,6,19,California,Fresno County,4,2,75978,38803,37175
50,6,19,California,Fresno County,4,3,74839,38189,36650
50,6,19,California,Fresno County,4,4,77214,39673,37541
50,6,19,California,Fresno County,4,5,78226,39946,38280
50,6,19,California,Fresno County,4,6,71377,36738,34639
50,6,19,California,Fresno County,4,7,64161,32564,31597
50,6,19,California,Fresno County,4,8,57433,29091,28342
50,6,19,California,Fresno County,4,9,57026,28543,28483
50,6,19,California,Fresno County,4,10,57699,28816,28883
50,6,19,California,Fresno County,4,11,57116,28278,28838
50,6,19,California,Fresno County,4,12,50004,24405,25599
50,6,19,California,Fresno County,4,13,42468,20616,21852
50,6,19,California,Fresno County,4,14,29878,14310,15568
50,6,19,California,Fresno County,4,15,21697,9957,11740
50,6,19,California,Fresno County,4,16,16818,7299,9519
50,6,19,California,Fresno County,4,17,13636,5520,8116
50,6,19,California,Fresno County,4,18,14098,5060,9038
50,6,19,California,Fresno County,5,0,945045,471053,473992
50,6,19,California,Fresno County,5,1,79583,40571,39012
50,6,19,California,Fresno County,5,2,77392,39728,37664
50,6,19,California,Fresno County,5,3,74173,37884,36289
50,6,19,California,Fresno County,5,4,75002,38367,36635
50,6,19,California,Fresno County,5,5,79294,40374,38920
50,6,19,California,Fresno County,5,6,71652,36967,34685
50,6,19,California,Fresno County,5,7,65706,33260,32446
50,6,19,California,Fresno County,5,8,57693,29311,28382
50,6,19,California,Fresno County,5,9,56990,28389,28601
50,6,19,California,Fresno County,5,10,56786,28411,28375
50,6,19,California,Fresno County,5,11,57164,28235,28929
50,6,19,California,Fresno County,5,12,50923,24874,26049
50,6,19,California,Fresno County,5,13,42983,20807,22176
50,6,19,California,Fresno County,5,14,32162,15405,16757
50,6,19,California,Fresno County,5,15,22556,10323,12233
50,6,19,California,Fresno County,5,16,17035,7471,9564
50,6,19,California,Fresno County,5,17,13570,5562,8008
50,6,19,California,Fresno County,5,18,14381,5114,9267
50,6,19,California,Fresno County,6,0,951514,474402,477112
50,6,19,California,Fresno County,6,1,78915,40188,38727
50,6,19,California,Fresno County,6,2,78674,40413,38261
50,6,19,California,Fresno County,6,3,74216,37715,36501
50,6,19,California,Fresno County,6,4,73625,37672,35953
50,6,19,California,Fresno County,6,5,79067,40306,38761
50,6,19,California,Fresno County,6,6,72474,37371,35103
50,6,19,California,Fresno County,6,7,67158,34089,33069
50,6,19,California,Fresno County,6,8,58642,29815,28827
50,6,19,California,Fresno County,6,9,56727,28319,28408
50,6,19,California,Fresno County,6,10,55985,28081,27904
50,6,19,California,Fresno County,6,11,57316,28385,28931
50,6,19,California,Fresno County,6,12,51924,25394,26530
50,6,19,California,Fresno County,6,13,43887,21221,22666
50,6,19,California,Fresno County,6,14,33794,16117,17677
50,6,19,California,Fresno County,6,15,23809,10971,12838
50,6,19,California,Fresno County,6,16,17367,7665,9702
50,6,19,California,Fresno County,6,17,13458,5513,7945
50,6,19,California,Fresno County,6,18,14476,5167,9309
50,6,19,California,Fresno County,7,0,960567,479305,481262
50,6,19,California,Fresno County,7,1,79500,40550,38950
50,6,19,California,Fresno County,7,2,79045,40531,38514
50,6,19,California,Fresno County,7,3,74711,37982,36729
50,6,19,California,Fresno County,7,4,72497,37012,35485
50,6,19,California,Fresno County,7,5,78473,40136,38337
50,6,19,California,Fresno County,7,6,74517,38385,36132
50,6,19,California,Fresno County,7,7,68213,34754,33459
50,6,19,California,Fresno County,7,8,59862,30372,29490
50,6,19,California,Fresno County,7,9,56487,28323,28164
50,6,19,California,Fresno County,7,10,55389,27786,27603
50,6,19,California,Fresno County,7,11,57523,28546,28977
50,6,19,California,Fresno County,7,12,52768,25898,26870
50,6,19,California,Fresno County,7,13,44971,21733,23238
50,6,19,California,Fresno County,7,14,35520,17016,18504
50,6,19,California,Fresno County,7,15,25020,11516,13504
50,6,19,California,Fresno County,7,16,17921,7974,9947
50,6,19,California,Fresno County,7,17,13343,5476,7867
50,6,19,California,Fresno County,7,18,14807,5315,9492
50,6,19,California,Fresno County,8,0,969488,483620,485868
50,6,19,California,Fresno County,8,1,79593,40571,39022
50,6,19,California,Fresno County,8,2,79539,40715,38824
50,6,19,California,Fresno County,8,3,75210,38279,36931
50,6,19,California,Fresno County,8,4,72303,36714,35589
50,6,19,California,Fresno County,8,5,76474,39091,37383
50,6,19,California,Fresno County,8,6,76968,39520,37448
50,6,19,California,Fresno County,8,7,68869,35256,33613
50,6,19,California,Fresno County,8,8,61645,31198,30447
50,6,19,California,Fresno County,8,9,56492,28372,28120
50,6,19,California,Fresno County,8,10,55451,27941,27510
50,6,19,California,Fresno County,8,11,56830,28229,28601
50,6,19,California,Fresno County,8,12,53589,26419,27170
50,6,19,California,Fresno County,8,13,46124,22097,24027
50,6,19,California,Fresno County,8,14,37449,18010,19439
50,6,19,California,Fresno County,8,15,26073,12078,13995
50,6,19,California,Fresno County,8,16,18514,8295,10219
50,6,19,California,Fresno County,8,17,13225,5374,7851
50,6,19,California,Fresno County,8,18,15140,5461,9679
50,6,19,California,Fresno County,9,0,976830,487152,489678
50,6,19,California,Fresno County,9,1,78840,40227,38613
50,6,19,California,Fresno County,9,2,80362,41023,39339
50,6,19,California,Fresno County,9,3,76425,38988,37437
50,6,19,California,Fresno County,9,4,71894,36540,35354
50,6,19,California,Fresno County,9,5,73449,37495,35954
50,6,19,California,Fresno County,9,6,79152,40529,38623
50,6,19,California,Fresno County,9,7,70078,35893,34185
50,6,19,California,Fresno County,9,8,63232,32014,31218
50,6,19,California,Fresno County,9,9,56416,28504,27912
50,6,19,California,Fresno County,9,10,55823,28058,27765
50,6,19,California,Fresno County,9,11,55762,27768,27994
50,6,19,California,Fresno County,9,12,54426,26736,27690
50,6,19,California,Fresno County,9,13,46811,22449,24362
50,6,19,California,Fresno County,9,14,39227,18784,20443
50,6,19,California,Fresno County,9,15,27025,12583,14442
50,6,19,California,Fresno County,9,16,19013,8415,10598
50,6,19,California,Fresno County,9,17,13388,5568,7820
50,6,19,California,Fresno County,9,18,15507,5578,9929
50,6,19,California,Fresno County,10,0,985238,491409,493829
50,6,19,California,Fresno County,10,1,77797,39673,38124
50,6,19,California,Fresno County,10,2,80812,41222,39590
50,6,19,California,Fresno County,10,3,78204,40070,38134
50,6,19,California,Fresno County,10,4,71458,36333,35125
50,6,19,California,Fresno County,10,5,71549,36422,35127
50,6,19,California,Fresno County,10,6,80728,41296,39432
50,6,19,California,Fresno County,10,7,70884,36380,34504
50,6,19,California,Fresno County,10,8,65204,32989,32215
50,6,19,California,Fresno County,10,9,57265,28993,28272
50,6,19,California,Fresno County,10,10,55905,28015,27890
50,6,19,California,Fresno County,10,11,55073,27515,27558
50,6,19,California,Fresno County,10,12,54706,26830,27876
50,6,19,California,Fresno County,10,13,47858,23066,24792
50,6,19,California,Fresno County,10,14,39776,18984,20792
50,6,19,California,Fresno County,10,15,29114,13533,15581
50,6,19,California,Fresno County,10,16,19703,8719,10984
50,6,19,California,Fresno County,10,17,13696,5791,7905
50,6,19,California,Fresno County,10,18,15506,5578,9928
50,6,19,California,Fresno County,11,0,991950,494736,497214
50,6,19,California,Fresno County,11,1,76934,39282,37652
50,6,19,California,Fresno County,11,2,80682,41065,39617
50,6,19,California,Fresno County,11,3,79658,40949,38709
50,6,19,California,Fresno County,11,4,71749,36414,35335
50,6,19,California,Fresno County,11,5,70463,35844,34619
50,6,19,California,Fresno County,11,6,80411,41076,39335
50,6,19,California,Fresno County,11,7,71767,36886,34881
50,6,19,California,Fresno County,11,8,66883,33868,33015
50,6,19,California,Fresno County,11,9,58273,29548,28725
50,6,19,California,Fresno County,11,10,55638,27846,27792
50,6,19,California,Fresno County,11,11,54556,27327,27229
50,6,19,California,Fresno County,11,12,54837,26840,27997
50,6,19,California,Fresno County,11,13,48653,23448,25205
50,6,19,California,Fresno County,11,14,40527,19326,21201
50,6,19,California,Fresno County,11,15,30592,14251,16341
50,6,19,California,Fresno County,11,16,20802,9210,11592
50,6,19,California,Fresno County,11,17,14042,5977,8065
50,6,19,California,Fresno County,11,18,15483,5579,9904
50,6,19,California,Fresno County,12,0,999101,498648,500453
50,6,19,California,Fresno County,12,1,75551,38665,36886
50,6,19,California,Fresno County,12,2,81223,41423,39800
50,6,19,California,Fresno County,12,3,79976,40907,39069
50,6,19,California,Fresno County,12,4,72385,36821,35564
50,6,19,California,Fresno County,12,5,69466,35225,34241
50,6,19,California,Fresno County,12,6,80130,41137,38993
50,6,19,California,Fresno County,12,7,73831,37852,35979
50,6,19,California,Fresno County,12,8,68169,34608,33561
50,6,19,California,Fresno County,12,9,59589,30112,29477
50,6,19,California,Fresno County,12,10,55359,27835,27524
50,6,19,California,Fresno County,12,11,54000,27120,26880
50,6,19,California,Fresno County,12,12,54749,26875,27874
50,6,19,California,Fresno County,12,13,49238,23811,25427
50,6,19,California,Fresno County,12,14,41432,19685,21747
50,6,19,California,Fresno County,12,15,32299,15137,17162
50,6,19,California,Fresno County,12,16,21766,9625,12141
50,6,19,California,Fresno County,12,17,14497,6216,8281
50,6,19,California,Fresno County,12,18,15441,5594,9847
50,6,21,California,Glenn County,1,0,28122,14191,13931
50,6,21,California,Glenn County,1,1,2178,1116,1062
50,6,21,California,Glenn County,1,2,2115,1050,1065
50,6,21,California,Glenn County,1,3,2227,1163,1064
50,6,21,California,Glenn County,1,4,2156,1123,1033
50,6,21,California,Glenn County,1,5,1770,915,855
50,6,21,California,Glenn County,1,6,1818,966,852
50,6,21,California,Glenn County,1,7,1692,860,832
50,6,21,California,Glenn County,1,8,1635,817,818
50,6,21,California,Glenn County,1,9,1708,869,839
50,6,21,California,Glenn County,1,10,1909,946,963
50,6,21,California,Glenn County,1,11,1926,960,966
50,6,21,California,Glenn County,1,12,1817,943,874
50,6,21,California,Glenn County,1,13,1434,738,696
50,6,21,California,Glenn County,1,14,1165,596,569
50,6,21,California,Glenn County,1,15,881,422,459
50,6,21,California,Glenn County,1,16,673,302,371
50,6,21,California,Glenn County,1,17,512,223,289
50,6,21,California,Glenn County,1,18,506,182,324
50,6,21,California,Glenn County,2,0,28122,14191,13931
50,6,21,California,Glenn County,2,1,2178,1116,1062
50,6,21,California,Glenn County,2,2,2115,1050,1065
50,6,21,California,Glenn County,2,3,2227,1163,1064
50,6,21,California,Glenn County,2,4,2156,1123,1033
50,6,21,California,Glenn County,2,5,1770,915,855
50,6,21,California,Glenn County,2,6,1818,966,852
50,6,21,California,Glenn County,2,7,1692,860,832
50,6,21,California,Glenn County,2,8,1635,817,818
50,6,21,California,Glenn County,2,9,1708,869,839
50,6,21,California,Glenn County,2,10,1909,946,963
50,6,21,California,Glenn County,2,11,1926,960,966
50,6,21,California,Glenn County,2,12,1817,943,874
50,6,21,California,Glenn County,2,13,1434,738,696
50,6,21,California,Glenn County,2,14,1165,596,569
50,6,21,California,Glenn County,2,15,881,422,459
50,6,21,California,Glenn County,2,16,673,302,371
50,6,21,California,Glenn County,2,17,512,223,289
50,6,21,California,Glenn County,2,18,506,182,324
50,6,21,California,Glenn County,3,0,28127,14195,13932
50,6,21,California,Glenn County,3,1,2165,1108,1057
50,6,21,California,Glenn County,3,2,2117,1060,1057
50,6,21,California,Glenn County,3,3,2210,1147,1063
50,6,21,California,Glenn County,3,4,2150,1122,1028
50,6,21,California,Glenn County,3,5,1788,931,857
50,6,21,California,Glenn County,3,6,1798,951,847
50,6,21,California,Glenn County,3,7,1695,865,830
50,6,21,California,Glenn County,3,8,1628,811,817
50,6,21,California,Glenn County,3,9,1709,868,841
50,6,21,California,Glenn County,3,10,1897,943,954
50,6,21,California,Glenn County,3,11,1927,960,967
50,6,21,California,Glenn County,3,12,1826,943,883
50,6,21,California,Glenn County,3,13,1459,749,710
50,6,21,California,Glenn County,3,14,1162,592,570
50,6,21,California,Glenn County,3,15,893,433,460
50,6,21,California,Glenn County,3,16,673,303,370
50,6,21,California,Glenn County,3,17,515,223,292
50,6,21,California,Glenn County,3,18,515,186,329
50,6,21,California,Glenn County,4,0,28139,14210,13929
50,6,21,California,Glenn County,4,1,2165,1126,1039
50,6,21,California,Glenn County,4,2,2103,1071,1032
50,6,21,California,Glenn County,4,3,2161,1119,1042
50,6,21,California,Glenn County,4,4,2135,1113,1022
50,6,21,California,Glenn County,4,5,1830,955,875
50,6,21,California,Glenn County,4,6,1788,924,864
50,6,21,California,Glenn County,4,7,1717,886,831
50,6,21,California,Glenn County,4,8,1600,799,801
50,6,21,California,Glenn County,4,9,1660,829,831
50,6,21,California,Glenn County,4,10,1837,918,919
50,6,21,California,Glenn County,4,11,1920,966,954
50,6,21,California,Glenn County,4,12,1880,959,921
50,6,21,California,Glenn County,4,13,1546,791,755
50,6,21,California,Glenn County,4,14,1139,577,562
50,6,21,California,Glenn County,4,15,930,458,472
50,6,21,California,Glenn County,4,16,685,318,367
50,6,21,California,Glenn County,4,17,524,210,314
50,6,21,California,Glenn County,4,18,519,191,328
50,6,21,California,Glenn County,5,0,27851,14043,13808
50,6,21,California,Glenn County,5,1,2082,1074,1008
50,6,21,California,Glenn County,5,2,2083,1087,996
50,6,21,California,Glenn County,5,3,2111,1081,1030
50,6,21,California,Glenn County,5,4,2122,1108,1014
50,6,21,California,Glenn County,5,5,1813,935,878
50,6,21,California,Glenn County,5,6,1704,905,799
50,6,21,California,Glenn County,5,7,1741,876,865
50,6,21,California,Glenn County,5,8,1600,785,815
50,6,21,California,Glenn County,5,9,1586,796,790
50,6,21,California,Glenn County,5,10,1749,859,890
50,6,21,California,Glenn County,5,11,1911,973,938
50,6,21,California,Glenn County,5,12,1871,948,923
50,6,21,California,Glenn County,5,13,1587,799,788
50,6,21,California,Glenn County,5,14,1184,597,587
50,6,21,California,Glenn County,5,15,964,478,486
50,6,21,California,Glenn County,5,16,695,326,369
50,6,21,California,Glenn County,5,17,529,223,306
50,6,21,California,Glenn County,5,18,519,193,326
50,6,21,California,Glenn County,6,0,27809,14043,13766
50,6,21,California,Glenn County,6,1,2031,1048,983
50,6,21,California,Glenn County,6,2,2106,1097,1009
50,6,21,California,Glenn County,6,3,2064,1071,993
50,6,21,California,Glenn County,6,4,2085,1082,1003
50,6,21,California,Glenn County,6,5,1802,942,860
50,6,21,California,Glenn County,6,6,1735,910,825
50,6,21,California,Glenn County,6,7,1724,877,847
50,6,21,California,Glenn County,6,8,1607,788,819
50,6,21,California,Glenn County,6,9,1573,789,784
50,6,21,California,Glenn County,6,10,1661,818,843
50,6,21,California,Glenn County,6,11,1917,962,955
50,6,21,California,Glenn County,6,12,1895,959,936
50,6,21,California,Glenn County,6,13,1581,802,779
50,6,21,California,Glenn County,6,14,1215,628,587
50,6,21,California,Glenn County,6,15,1014,497,517
50,6,21,California,Glenn County,6,16,711,334,377
50,6,21,California,Glenn County,6,17,545,236,309
50,6,21,California,Glenn County,6,18,543,203,340
50,6,21,California,Glenn County,7,0,27831,14046,13785
50,6,21,California,Glenn County,7,1,2012,1068,944
50,6,21,California,Glenn County,7,2,2173,1118,1055
50,6,21,California,Glenn County,7,3,2014,1021,993
50,6,21,California,Glenn County,7,4,2101,1084,1017
50,6,21,California,Glenn County,7,5,1770,918,852
50,6,21,California,Glenn County,7,6,1789,922,867
50,6,21,California,Glenn County,7,7,1728,885,843
50,6,21,California,Glenn County,7,8,1620,812,808
50,6,21,California,Glenn County,7,9,1557,762,795
50,6,21,California,Glenn County,7,10,1564,803,761
50,6,21,California,Glenn County,7,11,1915,936,979
50,6,21,California,Glenn County,7,12,1863,941,922
50,6,21,California,Glenn County,7,13,1627,839,788
50,6,21,California,Glenn County,7,14,1258,632,626
50,6,21,California,Glenn County,7,15,1032,521,511
50,6,21,California,Glenn County,7,16,742,346,396
50,6,21,California,Glenn County,7,17,537,234,303
50,6,21,California,Glenn County,7,18,529,204,325
50,6,21,California,Glenn County,8,0,27753,13998,13755
50,6,21,California,Glenn County,8,1,1971,1042,929
50,6,21,California,Glenn County,8,2,2154,1100,1054
50,6,21,California,Glenn County,8,3,2053,1016,1037
50,6,21,California,Glenn County,8,4,2044,1058,986
50,6,21,California,Glenn County,8,5,1834,968,866
50,6,21,California,Glenn County,8,6,1741,895,846
50,6,21,California,Glenn County,8,7,1738,909,829
50,6,21,California,Glenn County,8,8,1644,811,833
50,6,21,California,Glenn County,8,9,1532,752,780
50,6,21,California,Glenn County,8,10,1539,792,747
50,6,21,California,Glenn County,8,11,1821,900,921
50,6,21,California,Glenn County,8,12,1858,928,930
50,6,21,California,Glenn County,8,13,1674,851,823
50,6,21,California,Glenn County,8,14,1312,668,644
50,6,21,California,Glenn County,8,15,1032,520,512
50,6,21,California,Glenn County,8,16,752,353,399
50,6,21,California,Glenn County,8,17,527,234,293
50,6,21,California,Glenn County,8,18,527,201,326
50,6,21,California,Glenn County,9,0,27840,14115,13725
50,6,21,California,Glenn County,9,1,1973,1025,948
50,6,21,California,Glenn County,9,2,2136,1128,1008
50,6,21,California,Glenn County,9,3,2048,1022,1026
50,6,21,California,Glenn County,9,4,2047,1066,981
50,6,21,California,Glenn County,9,5,1843,959,884
50,6,21,California,Glenn County,9,6,1791,932,859
50,6,21,California,Glenn County,9,7,1699,887,812
50,6,21,California,Glenn County,9,8,1678,839,839
50,6,21,California,Glenn County,9,9,1504,747,757
50,6,21,California,Glenn County,9,10,1532,786,746
50,6,21,California,Glenn County,9,11,1761,877,884
50,6,21,California,Glenn County,9,12,1826,923,903
50,6,21,California,Glenn County,9,13,1734,884,850
50,6,21,California,Glenn County,9,14,1401,703,698
50,6,21,California,Glenn County,9,15,1028,519,509
50,6,21,California,Glenn County,9,16,782,386,396
50,6,21,California,Glenn County,9,17,524,232,292
50,6,21,California,Glenn County,9,18,533,200,333
50,6,21,California,Glenn County,10,0,27926,14175,13751
50,6,21,California,Glenn County,10,1,2014,1058,956
50,6,21,California,Glenn County,10,2,2111,1101,1010
50,6,21,California,Glenn County,10,3,2106,1069,1037
50,6,21,California,Glenn County,10,4,1980,1023,957
50,6,21,California,Glenn County,10,5,1804,940,864
50,6,21,California,Glenn County,10,6,1867,982,885
50,6,21,California,Glenn County,10,7,1662,872,790
50,6,21,California,Glenn County,10,8,1739,882,857
50,6,21,California,Glenn County,10,9,1523,749,774
50,6,21,California,Glenn County,10,10,1500,771,729
50,6,21,California,Glenn County,10,11,1696,835,861
50,6,21,California,Glenn County,10,12,1842,951,891
50,6,21,California,Glenn County,10,13,1743,871,872
50,6,21,California,Glenn County,10,14,1406,705,701
50,6,21,California,Glenn County,10,15,1069,538,531
50,6,21,California,Glenn County,10,16,800,391,409
50,6,21,California,Glenn County,10,17,547,243,304
50,6,21,California,Glenn County,10,18,517,194,323
50,6,21,California,Glenn County,11,0,27967,14217,13750
50,6,21,California,Glenn County,11,1,2006,1062,944
50,6,21,California,Glenn County,11,2,2113,1108,1005
50,6,21,California,Glenn County,11,3,2183,1107,1076
50,6,21,California,Glenn County,11,4,1933,1008,925
50,6,21,California,Glenn County,11,5,1808,936,872
50,6,21,California,Glenn County,11,6,1871,992,879
50,6,21,California,Glenn County,11,7,1734,897,837
50,6,21,California,Glenn County,11,8,1723,876,847
50,6,21,California,Glenn County,11,9,1510,748,762
50,6,21,California,Glenn County,11,10,1520,779,741
50,6,21,California,Glenn County,11,11,1616,800,816
50,6,21,California,Glenn County,11,12,1824,926,898
50,6,21,California,Glenn County,11,13,1743,874,869
50,6,21,California,Glenn County,11,14,1416,721,695
50,6,21,California,Glenn County,11,15,1093,557,536
50,6,21,California,Glenn County,11,16,820,395,425
50,6,21,California,Glenn County,11,17,527,232,295
50,6,21,California,Glenn County,11,18,527,199,328
50,6,21,California,Glenn County,12,0,28393,14462,13931
50,6,21,California,Glenn County,12,1,1986,1054,932
50,6,21,California,Glenn County,12,2,2134,1137,997
50,6,21,California,Glenn County,12,3,2213,1120,1093
50,6,21,California,Glenn County,12,4,1972,1012,960
50,6,21,California,Glenn County,12,5,1856,968,888
50,6,21,California,Glenn County,12,6,1882,994,888
50,6,21,California,Glenn County,12,7,1841,972,869
50,6,21,California,Glenn County,12,8,1750,902,848
50,6,21,California,Glenn County,12,9,1555,797,758
50,6,21,California,Glenn County,12,10,1526,745,781
50,6,21,California,Glenn County,12,11,1556,798,758
50,6,21,California,Glenn County,12,12,1882,918,964
50,6,21,California,Glenn County,12,13,1764,883,881
50,6,21,California,Glenn County,12,14,1468,763,705
50,6,21,California,Glenn County,12,15,1109,550,559
50,6,21,California,Glenn County,12,16,841,412,429
50,6,21,California,Glenn County,12,17,544,244,300
50,6,21,California,Glenn County,12,18,514,193,321
50,6,23,California,Humboldt County,1,0,134623,67595,67028
50,6,23,California,Humboldt County,1,1,7738,3977,3761
50,6,23,California,Humboldt County,1,2,7324,3699,3625
50,6,23,California,Humboldt County,1,3,7242,3721,3521
50,6,23,California,Humboldt County,1,4,9531,4807,4724
50,6,23,California,Humboldt County,1,5,11878,6064,5814
50,6,23,California,Humboldt County,1,6,10743,5686,5057
50,6,23,California,Humboldt County,1,7,9252,4899,4353
50,6,23,California,Humboldt County,1,8,7989,4323,3666
50,6,23,California,Humboldt County,1,9,7079,3701,3378
50,6,23,California,Humboldt County,1,10,8771,4401,4370
50,6,23,California,Humboldt County,1,11,9978,4846,5132
50,6,23,California,Humboldt County,1,12,10339,5060,5279
50,6,23,California,Humboldt County,1,13,9034,4538,4496
50,6,23,California,Humboldt County,1,14,5691,2773,2918
50,6,23,California,Humboldt County,1,15,3980,1888,2092
50,6,23,California,Humboldt County,1,16,3040,1337,1703
50,6,23,California,Humboldt County,1,17,2449,1021,1428
50,6,23,California,Humboldt County,1,18,2565,854,1711
50,6,23,California,Humboldt County,2,0,134611,67589,67022
50,6,23,California,Humboldt County,2,1,7738,3977,3761
50,6,23,California,Humboldt County,2,2,7324,3699,3625
50,6,23,California,Humboldt County,2,3,7242,3721,3521
50,6,23,California,Humboldt County,2,4,9531,4807,4724
50,6,23,California,Humboldt County,2,5,11878,6064,5814
50,6,23,California,Humboldt County,2,6,10743,5686,5057
50,6,23,California,Humboldt County,2,7,9252,4899,4353
50,6,23,California,Humboldt County,2,8,7989,4323,3666
50,6,23,California,Humboldt County,2,9,7079,3701,3378
50,6,23,California,Humboldt County,2,10,8771,4401,4370
50,6,23,California,Humboldt County,2,11,9978,4846,5132
50,6,23,California,Humboldt County,2,12,10338,5060,5278
50,6,23,California,Humboldt County,2,13,9032,4536,4496
50,6,23,California,Humboldt County,2,14,5691,2773,2918
50,6,23,California,Humboldt County,2,15,3979,1888,2091
50,6,23,California,Humboldt County,2,16,3038,1335,1703
50,6,23,California,Humboldt County,2,17,2446,1020,1426
50,6,23,California,Humboldt County,2,18,2562,853,1709
50,6,23,California,Humboldt County,3,0,135009,67792,67217
50,6,23,California,Humboldt County,3,1,7737,3975,3762
50,6,23,California,Humboldt County,3,2,7330,3711,3619
50,6,23,California,Humboldt County,3,3,7234,3723,3511
50,6,23,California,Humboldt County,3,4,9635,4850,4785
50,6,23,California,Humboldt County,3,5,12141,6175,5966
50,6,23,California,Humboldt County,3,6,10606,5620,4986
50,6,23,California,Humboldt County,3,7,9376,4961,4415
50,6,23,California,Humboldt County,3,8,7988,4322,3666
50,6,23,California,Humboldt County,3,9,7130,3738,3392
50,6,23,California,Humboldt County,3,10,8641,4337,4304
50,6,23,California,Humboldt County,3,11,9899,4808,5091
50,6,23,California,Humboldt County,3,12,10345,5053,5292
50,6,23,California,Humboldt County,3,13,9148,4597,4551
50,6,23,California,Humboldt County,3,14,5755,2810,2945
50,6,23,California,Humboldt County,3,15,4019,1915,2104
50,6,23,California,Humboldt County,3,16,3013,1324,1689
50,6,23,California,Humboldt County,3,17,2446,1017,1429
50,6,23,California,Humboldt County,3,18,2566,856,1710
50,6,23,California,Humboldt County,4,0,135243,67846,67397
50,6,23,California,Humboldt County,4,1,7640,3932,3708
50,6,23,California,Humboldt County,4,2,7315,3753,3562
50,6,23,California,Humboldt County,4,3,7220,3705,3515
50,6,23,California,Humboldt County,4,4,9495,4807,4688
50,6,23,California,Humboldt County,4,5,12652,6304,6348
50,6,23,California,Humboldt County,4,6,9909,5265,4644
50,6,23,California,Humboldt County,4,7,9701,5080,4621
50,6,23,California,Humboldt County,4,8,8000,4315,3685
50,6,23,California,Humboldt County,4,9,7317,3872,3445
50,6,23,California,Humboldt County,4,10,8082,4067,4015
50,6,23,California,Humboldt County,4,11,9657,4714,4943
50,6,23,California,Humboldt County,4,12,10305,4987,5318
50,6,23,California,Humboldt County,4,13,9703,4877,4826
50,6,23,California,Humboldt County,4,14,5996,2935,3061
50,6,23,California,Humboldt County,4,15,4207,2040,2167
50,6,23,California,Humboldt County,4,16,2975,1305,1670
50,6,23,California,Humboldt County,4,17,2420,991,1429
50,6,23,California,Humboldt County,4,18,2649,897,1752
50,6,23,California,Humboldt County,5,0,134572,67351,67221
50,6,23,California,Humboldt County,5,1,7338,3741,3597
50,6,23,California,Humboldt County,5,2,7395,3775,3620
50,6,23,California,Humboldt County,5,3,7191,3666,3525
50,6,23,California,Humboldt County,5,4,9254,4671,4583
50,6,23,California,Humboldt County,5,5,13046,6456,6590
50,6,23,California,Humboldt County,5,6,9144,4840,4304
50,6,23,California,Humboldt County,5,7,9796,5134,4662
50,6,23,California,Humboldt County,5,8,8223,4398,3825
50,6,23,California,Humboldt County,5,9,7374,3948,3426
50,6,23,California,Humboldt County,5,10,7623,3828,3795
50,6,23,California,Humboldt County,5,11,9286,4551,4735
50,6,23,California,Humboldt County,5,12,10116,4859,5257
50,6,23,California,Humboldt County,5,13,9664,4786,4878
50,6,23,California,Humboldt County,5,14,6688,3318,3370
50,6,23,California,Humboldt County,5,15,4345,2120,2225
50,6,23,California,Humboldt County,5,16,3044,1375,1669
50,6,23,California,Humboldt County,5,17,2379,967,1412
50,6,23,California,Humboldt County,5,18,2666,918,1748
50,6,23,California,Humboldt County,6,0,134403,67164,67239
50,6,23,California,Humboldt County,6,1,7389,3757,3632
50,6,23,California,Humboldt County,6,2,7489,3826,3663
50,6,23,California,Humboldt County,6,3,7057,3577,3480
50,6,23,California,Humboldt County,6,4,9109,4587,4522
50,6,23,California,Humboldt County,6,5,13238,6491,6747
50,6,23,California,Humboldt County,6,6,8717,4599,4118
50,6,23,California,Humboldt County,6,7,9764,5110,4654
50,6,23,California,Humboldt County,6,8,8342,4465,3877
50,6,23,California,Humboldt County,6,9,7493,3987,3506
50,6,23,California,Humboldt County,6,10,7220,3643,3577
50,6,23,California,Humboldt County,6,11,9038,4463,4575
50,6,23,California,Humboldt County,6,12,9863,4761,5102
50,6,23,California,Humboldt County,6,13,9846,4783,5063
50,6,23,California,Humboldt County,6,14,7143,3576,3567
50,6,23,California,Humboldt County,6,15,4575,2224,2351
50,6,23,California,Humboldt County,6,16,3084,1417,1667
50,6,23,California,Humboldt County,6,17,2342,939,1403
50,6,23,California,Humboldt County,6,18,2694,959,1735
50,6,23,California,Humboldt County,7,0,134494,67210,67284
50,6,23,California,Humboldt County,7,1,7411,3781,3630
50,6,23,California,Humboldt County,7,2,7437,3844,3593
50,6,23,California,Humboldt County,7,3,7047,3536,3511
50,6,23,California,Humboldt County,7,4,8938,4496,4442
50,6,23,California,Humboldt County,7,5,13394,6610,6784
50,6,23,California,Humboldt County,7,6,8730,4615,4115
50,6,23,California,Humboldt County,7,7,9539,4948,4591
50,6,23,California,Humboldt County,7,8,8467,4473,3994
50,6,23,California,Humboldt County,7,9,7640,4027,3613
50,6,23,California,Humboldt County,7,10,6997,3580,3417
50,6,23,California,Humboldt County,7,11,8706,4330,4376
50,6,23,California,Humboldt County,7,12,9590,4625,4965
50,6,23,California,Humboldt County,7,13,9827,4752,5075
50,6,23,California,Humboldt County,7,14,7809,3861,3948
50,6,23,California,Humboldt County,7,15,4770,2303,2467
50,6,23,California,Humboldt County,7,16,3188,1490,1698
50,6,23,California,Humboldt County,7,17,2268,919,1349
50,6,23,California,Humboldt County,7,18,2736,1020,1716
50,6,23,California,Humboldt County,8,0,135102,67439,67663
50,6,23,California,Humboldt County,8,1,7481,3865,3616
50,6,23,California,Humboldt County,8,2,7393,3799,3594
50,6,23,California,Humboldt County,8,3,7148,3642,3506
50,6,23,California,Humboldt County,8,4,8839,4414,4425
50,6,23,California,Humboldt County,8,5,13273,6583,6690
50,6,23,California,Humboldt County,8,6,8899,4597,4302
50,6,23,California,Humboldt County,8,7,9265,4788,4477
50,6,23,California,Humboldt County,8,8,8778,4600,4178
50,6,23,California,Humboldt County,8,9,7728,4111,3617
50,6,23,California,Humboldt County,8,10,6968,3620,3348
50,6,23,California,Humboldt County,8,11,8279,4120,4159
50,6,23,California,Humboldt County,8,12,9476,4538,4938
50,6,23,California,Humboldt County,8,13,9749,4642,5107
50,6,23,California,Humboldt County,8,14,8462,4190,4272
50,6,23,California,Humboldt County,8,15,5041,2409,2632
50,6,23,California,Humboldt County,8,16,3349,1572,1777
50,6,23,California,Humboldt County,8,17,2242,948,1294
50,6,23,California,Humboldt County,8,18,2732,1001,1731
50,6,23,California,Humboldt County,9,0,136290,67998,68292
50,6,23,California,Humboldt County,9,1,7471,3885,3586
50,6,23,California,Humboldt County,9,2,7422,3787,3635
50,6,23,California,Humboldt County,9,3,7233,3693,3540
50,6,23,California,Humboldt County,9,4,8997,4478,4519
50,6,23,California,Humboldt County,9,5,13033,6450,6583
50,6,23,California,Humboldt County,9,6,9309,4795,4514
50,6,23,California,Humboldt County,9,7,9025,4683,4342
50,6,23,California,Humboldt County,9,8,9256,4804,4452
50,6,23,California,Humboldt County,9,9,7787,4147,3640
50,6,23,California,Humboldt County,9,10,7219,3793,3426
50,6,23,California,Humboldt County,9,11,7779,3858,3921
50,6,23,California,Humboldt County,9,12,9313,4488,4825
50,6,23,California,Humboldt County,9,13,9653,4581,5072
50,6,23,California,Humboldt County,9,14,8980,4399,4581
50,6,23,California,Humboldt County,9,15,5282,2530,2752
50,6,23,California,Humboldt County,9,16,3534,1687,1847
50,6,23,California,Humboldt County,9,17,2227,943,1284
50,6,23,California,Humboldt County,9,18,2770,997,1773
50,6,23,California,Humboldt County,10,0,136507,67987,68520
50,6,23,California,Humboldt County,10,1,7442,3854,3588
50,6,23,California,Humboldt County,10,2,7202,3667,3535
50,6,23,California,Humboldt County,10,3,7283,3725,3558
50,6,23,California,Humboldt County,10,4,8946,4453,4493
50,6,23,California,Humboldt County,10,5,12897,6391,6506
50,6,23,California,Humboldt County,10,6,9662,4941,4721
50,6,23,California,Humboldt County,10,7,8635,4489,4146
50,6,23,California,Humboldt County,10,8,9441,4866,4575
50,6,23,California,Humboldt County,10,9,8094,4308,3786
50,6,23,California,Humboldt County,10,10,7315,3846,3469
50,6,23,California,Humboldt County,10,11,7469,3710,3759
50,6,23,California,Humboldt County,10,12,8983,4352,4631
50,6,23,California,Humboldt County,10,13,9512,4478,5034
50,6,23,California,Humboldt County,10,14,8899,4293,4606
50,6,23,California,Humboldt County,10,15,6010,2916,3094
50,6,23,California,Humboldt County,10,16,3675,1732,1943
50,6,23,California,Humboldt County,10,17,2300,996,1304
50,6,23,California,Humboldt County,10,18,2742,970,1772
50,6,23,California,Humboldt County,11,0,136244,67786,68458
50,6,23,California,Humboldt County,11,1,7159,3702,3457
50,6,23,California,Humboldt County,11,2,7217,3692,3525
50,6,23,California,Humboldt County,11,3,7370,3768,3602
50,6,23,California,Humboldt County,11,4,8873,4423,4450
50,6,23,California,Humboldt County,11,5,12659,6249,6410
50,6,23,California,Humboldt County,11,6,9808,5039,4769
50,6,23,California,Humboldt County,11,7,8307,4278,4029
50,6,23,California,Humboldt County,11,8,9462,4866,4596
50,6,23,California,Humboldt County,11,9,8354,4410,3944
50,6,23,California,Humboldt County,11,10,7415,3911,3504
50,6,23,California,Humboldt County,11,11,7082,3541,3541
50,6,23,California,Humboldt County,11,12,8787,4260,4527
50,6,23,California,Humboldt County,11,13,9305,4417,4888
50,6,23,California,Humboldt County,11,14,9055,4288,4767
50,6,23,California,Humboldt County,11,15,6382,3084,3298
50,6,23,California,Humboldt County,11,16,3864,1825,2039
50,6,23,California,Humboldt County,11,17,2386,1054,1332
50,6,23,California,Humboldt County,11,18,2759,979,1780
50,6,23,California,Humboldt County,12,0,135558,67241,68317
50,6,23,California,Humboldt County,12,1,6922,3542,3380
50,6,23,California,Humboldt County,12,2,7174,3660,3514
50,6,23,California,Humboldt County,12,3,7284,3728,3556
50,6,23,California,Humboldt County,12,4,8787,4399,4388
50,6,23,California,Humboldt County,12,5,12493,6155,6338
50,6,23,California,Humboldt County,12,6,9831,4974,4857
50,6,23,California,Humboldt County,12,7,8286,4315,3971
50,6,23,California,Humboldt County,12,8,9125,4665,4460
50,6,23,California,Humboldt County,12,9,8450,4420,4030
50,6,23,California,Humboldt County,12,10,7583,3962,3621
50,6,23,California,Humboldt County,12,11,6943,3506,3437
50,6,23,California,Humboldt County,12,12,8423,4125,4298
50,6,23,California,Humboldt County,12,13,9068,4300,4768
50,6,23,California,Humboldt County,12,14,9002,4231,4771
50,6,23,California,Humboldt County,12,15,6935,3301,3634
50,6,23,California,Humboldt County,12,16,4034,1865,2169
50,6,23,California,Humboldt County,12,17,2448,1087,1361
50,6,23,California,Humboldt County,12,18,2770,1006,1764
50,6,25,California,Imperial County,1,0,174528,89646,84882
50,6,25,California,Imperial County,1,1,13526,6874,6652
50,6,25,California,Imperial County,1,2,13841,7028,6813
50,6,25,California,Imperial County,1,3,14536,7593,6943
50,6,25,California,Imperial County,1,4,15047,7721,7326
50,6,25,California,Imperial County,1,5,13188,7235,5953
50,6,25,California,Imperial County,1,6,12511,7042,5469
50,6,25,California,Imperial County,1,7,11686,6558,5128
50,6,25,California,Imperial County,1,8,11374,6069,5305
50,6,25,California,Imperial County,1,9,11567,6057,5510
50,6,25,California,Imperial County,1,10,11413,5750,5663
50,6,25,California,Imperial County,1,11,11084,5518,5566
50,6,25,California,Imperial County,1,12,9236,4440,4796
50,6,25,California,Imperial County,1,13,7367,3526,3841
50,6,25,California,Imperial County,1,14,5371,2452,2919
50,6,25,California,Imperial County,1,15,4420,2099,2321
50,6,25,California,Imperial County,1,16,3618,1631,1987
50,6,25,California,Imperial County,1,17,2738,1247,1491
50,6,25,California,Imperial County,1,18,2005,806,1199
50,6,25,California,Imperial County,2,0,174524,89645,84879
50,6,25,California,Imperial County,2,1,13525,6874,6651
50,6,25,California,Imperial County,2,2,13841,7028,6813
50,6,25,California,Imperial County,2,3,14536,7593,6943
50,6,25,California,Imperial County,2,4,15047,7721,7326
50,6,25,California,Imperial County,2,5,13188,7235,5953
50,6,25,California,Imperial County,2,6,12510,7042,5468
50,6,25,California,Imperial County,2,7,11686,6558,5128
50,6,25,California,Imperial County,2,8,11374,6069,5305
50,6,25,California,Imperial County,2,9,11567,6057,5510
50,6,25,California,Imperial County,2,10,11413,5750,5663
50,6,25,California,Imperial County,2,11,11083,5517,5566
50,6,25,California,Imperial County,2,12,9236,4440,4796
50,6,25,California,Imperial County,2,13,7366,3526,3840
50,6,25,California,Imperial County,2,14,5371,2452,2919
50,6,25,California,Imperial County,2,15,4420,2099,2321
50,6,25,California,Imperial County,2,16,3618,1631,1987
50,6,25,California,Imperial County,2,17,2738,1247,1491
50,6,25,California,Imperial County,2,18,2005,806,1199
50,6,25,California,Imperial County,3,0,174716,89652,85064
50,6,25,California,Imperial County,3,1,13585,6897,6688
50,6,25,California,Imperial County,3,2,13844,7014,6830
50,6,25,California,Imperial County,3,3,14494,7566,6928
50,6,25,California,Imperial County,3,4,14982,7685,7297
50,6,25,California,Imperial County,3,5,13347,7321,6026
50,6,25,California,Imperial County,3,6,12574,7062,5512
50,6,25,California,Imperial County,3,7,11705,6560,5145
50,6,25,California,Imperial County,3,8,11301,6009,5292
50,6,25,California,Imperial County,3,9,11522,6021,5501
50,6,25,California,Imperial County,3,10,11361,5725,5636
50,6,25,California,Imperial County,3,11,11023,5483,5540
50,6,25,California,Imperial County,3,12,9298,4459,4839
50,6,25,California,Imperial County,3,13,7422,3555,3867
50,6,25,California,Imperial County,3,14,5394,2469,2925
50,6,25,California,Imperial County,3,15,4425,2094,2331
50,6,25,California,Imperial County,3,16,3629,1646,1983
50,6,25,California,Imperial County,3,17,2757,1256,1501
50,6,25,California,Imperial County,3,18,2053,830,1223
50,6,25,California,Imperial County,4,0,175786,90216,85570
50,6,25,California,Imperial County,4,1,14029,7162,6867
50,6,25,California,Imperial County,4,2,13740,6914,6826
50,6,25,California,Imperial County,4,3,14305,7444,6861
50,6,25,California,Imperial County,4,4,14705,7584,7121
50,6,25,California,Imperial County,4,5,13921,7653,6268
50,6,25,California,Imperial County,4,6,12721,7190,5531
50,6,25,California,Imperial County,4,7,11853,6641,5212
50,6,25,California,Imperial County,4,8,11065,5854,5211
50,6,25,California,Imperial County,4,9,11388,5948,5440
50,6,25,California,Imperial County,4,10,11188,5641,5547
50,6,25,California,Imperial County,4,11,10814,5374,5440
50,6,25,California,Imperial County,4,12,9673,4646,5027
50,6,25,California,Imperial County,4,13,7712,3703,4009
50,6,25,California,Imperial County,4,14,5508,2541,2967
50,6,25,California,Imperial County,4,15,4475,2056,2419
50,6,25,California,Imperial County,4,16,3686,1695,1991
50,6,25,California,Imperial County,4,17,2813,1279,1534
50,6,25,California,Imperial County,4,18,2190,891,1299
50,6,25,California,Imperial County,5,0,176575,90625,85950
50,6,25,California,Imperial County,5,1,14371,7389,6982
50,6,25,California,Imperial County,5,2,13807,6880,6927
50,6,25,California,Imperial County,5,3,13970,7232,6738
50,6,25,California,Imperial County,5,4,14369,7455,6914
50,6,25,California,Imperial County,5,5,14298,7897,6401
50,6,25,California,Imperial County,5,6,12765,7217,5548
50,6,25,California,Imperial County,5,7,12076,6751,5325
50,6,25,California,Imperial County,5,8,11052,5907,5145
50,6,25,California,Imperial County,5,9,11108,5763,5345
50,6,25,California,Imperial County,5,10,10985,5558,5427
50,6,25,California,Imperial County,5,11,10800,5380,5420
50,6,25,California,Imperial County,5,12,9822,4691,5131
50,6,25,California,Imperial County,5,13,7806,3764,4042
50,6,25,California,Imperial County,5,14,5875,2723,3152
50,6,25,California,Imperial County,5,15,4577,2066,2511
50,6,25,California,Imperial County,5,16,3708,1711,1997
50,6,25,California,Imperial County,5,17,2798,1267,1531
50,6,25,California,Imperial County,5,18,2388,974,1414
50,6,25,California,Imperial County,6,0,176438,89989,86449
50,6,25,California,Imperial County,6,1,14632,7530,7102
50,6,25,California,Imperial County,6,2,13802,6875,6927
50,6,25,California,Imperial County,6,3,13935,7157,6778
50,6,25,California,Imperial County,6,4,14103,7309,6794
50,6,25,California,Imperial County,6,5,14365,7837,6528
50,6,25,California,Imperial County,6,6,12647,7131,5516
50,6,25,California,Imperial County,6,7,12125,6665,5460
50,6,25,California,Imperial County,6,8,10811,5816,4995
50,6,25,California,Imperial County,6,9,10735,5501,5234
50,6,25,California,Imperial County,6,10,10733,5374,5359
50,6,25,California,Imperial County,6,11,10639,5278,5361
50,6,25,California,Imperial County,6,12,9954,4728,5226
50,6,25,California,Imperial County,6,13,7922,3778,4144
50,6,25,California,Imperial County,6,14,6192,2892,3300
50,6,25,California,Imperial County,6,15,4717,2136,2581
50,6,25,California,Imperial County,6,16,3776,1713,2063
50,6,25,California,Imperial County,6,17,2810,1239,1571
50,6,25,California,Imperial County,6,18,2540,1030,1510
50,6,25,California,Imperial County,7,0,177974,90872,87102
50,6,25,California,Imperial County,7,1,14979,7692,7287
50,6,25,California,Imperial County,7,2,13955,7038,6917
50,6,25,California,Imperial County,7,3,13910,7092,6818
50,6,25,California,Imperial County,7,4,13914,7278,6636
50,6,25,California,Imperial County,7,5,14436,7858,6578
50,6,25,California,Imperial County,7,6,12992,7339,5653
50,6,25,California,Imperial County,7,7,12304,6798,5506
50,6,25,California,Imperial County,7,8,10888,5890,4998
50,6,25,California,Imperial County,7,9,10575,5416,5159
50,6,25,California,Imperial County,7,10,10640,5363,5277
50,6,25,California,Imperial County,7,11,10569,5218,5351
50,6,25,California,Imperial County,7,12,9976,4757,5219
50,6,25,California,Imperial County,7,13,8121,3835,4286
50,6,25,California,Imperial County,7,14,6516,3099,3417
50,6,25,California,Imperial County,7,15,4821,2135,2686
50,6,25,California,Imperial County,7,16,3845,1733,2112
50,6,25,California,Imperial County,7,17,2850,1241,1609
50,6,25,California,Imperial County,7,18,2683,1090,1593
50,6,25,California,Imperial County,8,0,178937,91405,87532
50,6,25,California,Imperial County,8,1,15407,7857,7550
50,6,25,California,Imperial County,8,2,13854,7024,6830
50,6,25,California,Imperial County,8,3,13837,7001,6836
50,6,25,California,Imperial County,8,4,13864,7260,6604
50,6,25,California,Imperial County,8,5,14045,7628,6417
50,6,25,California,Imperial County,8,6,13452,7607,5845
50,6,25,California,Imperial County,8,7,12333,6859,5474
50,6,25,California,Imperial County,8,8,11092,6082,5010
50,6,25,California,Imperial County,8,9,10396,5298,5098
50,6,25,California,Imperial County,8,10,10582,5405,5177
50,6,25,California,Imperial County,8,11,10371,5077,5294
50,6,25,California,Imperial County,8,12,9921,4784,5137
50,6,25,California,Imperial County,8,13,8395,3937,4458
50,6,25,California,Imperial County,8,14,6794,3238,3556
50,6,25,California,Imperial County,8,15,4983,2212,2771
50,6,25,California,Imperial County,8,16,3852,1709,2143
50,6,25,California,Imperial County,8,17,2890,1261,1629
50,6,25,California,Imperial County,8,18,2869,1166,1703
50,6,25,California,Imperial County,9,0,180179,92077,88102
50,6,25,California,Imperial County,9,1,15386,7779,7607
50,6,25,California,Imperial County,9,2,14240,7246,6994
50,6,25,California,Imperial County,9,3,13875,6972,6903
50,6,25,California,Imperial County,9,4,13804,7205,6599
50,6,25,California,Imperial County,9,5,13719,7455,6264
50,6,25,California,Imperial County,9,6,13800,7793,6007
50,6,25,California,Imperial County,9,7,12536,7062,5474
50,6,25,California,Imperial County,9,8,11357,6212,5145
50,6,25,California,Imperial County,9,9,10305,5300,5005
50,6,25,California,Imperial County,9,10,10437,5290,5147
50,6,25,California,Imperial County,9,11,10221,5056,5165
50,6,25,California,Imperial County,9,12,9836,4761,5075
50,6,25,California,Imperial County,9,13,8647,4063,4584
50,6,25,California,Imperial County,9,14,7073,3370,3703
50,6,25,California,Imperial County,9,15,5120,2298,2822
50,6,25,California,Imperial County,9,16,3913,1699,2214
50,6,25,California,Imperial County,9,17,2977,1320,1657
50,6,25,California,Imperial County,9,18,2933,1196,1737
50,6,25,California,Imperial County,10,0,181649,93254,88395
50,6,25,California,Imperial County,10,1,15251,7718,7533
50,6,25,California,Imperial County,10,2,14520,7434,7086
50,6,25,California,Imperial County,10,3,13957,6977,6980
50,6,25,California,Imperial County,10,4,13555,7055,6500
50,6,25,California,Imperial County,10,5,13530,7465,6065
50,6,25,California,Imperial County,10,6,14257,8100,6157
50,6,25,California,Imperial County,10,7,12691,7193,5498
50,6,25,California,Imperial County,10,8,11679,6411,5268
50,6,25,California,Imperial County,10,9,10374,5456,4918
50,6,25,California,Imperial County,10,10,10312,5242,5070
50,6,25,California,Imperial County,10,11,10057,5006,5051
50,6,25,California,Imperial County,10,12,9813,4759,5054
50,6,25,California,Imperial County,10,13,8871,4162,4709
50,6,25,California,Imperial County,10,14,7189,3461,3728
50,6,25,California,Imperial County,10,15,5470,2451,3019
50,6,25,California,Imperial County,10,16,4049,1766,2283
50,6,25,California,Imperial County,10,17,3019,1353,1666
50,6,25,California,Imperial County,10,18,3055,1245,1810
50,6,25,California,Imperial County,11,0,181523,93119,88404
50,6,25,California,Imperial County,11,1,14950,7569,7381
50,6,25,California,Imperial County,11,2,14652,7581,7071
50,6,25,California,Imperial County,11,3,14000,6964,7036
50,6,25,California,Imperial County,11,4,13589,7016,6573
50,6,25,California,Imperial County,11,5,13093,7186,5907
50,6,25,California,Imperial County,11,6,14261,8055,6206
50,6,25,California,Imperial County,11,7,12684,7249,5435
50,6,25,California,Imperial County,11,8,11971,6522,5449
50,6,25,California,Imperial County,11,9,10203,5424,4779
50,6,25,California,Imperial County,11,10,10064,5089,4975
50,6,25,California,Imperial County,11,11,9908,4933,4975
50,6,25,California,Imperial County,11,12,9735,4723,5012
50,6,25,California,Imperial County,11,13,9002,4256,4746
50,6,25,California,Imperial County,11,14,7249,3433,3816
50,6,25,California,Imperial County,11,15,5763,2630,3133
50,6,25,California,Imperial County,11,16,4220,1871,2349
50,6,25,California,Imperial County,11,17,3038,1348,1690
50,6,25,California,Imperial County,11,18,3141,1270,1871
50,6,25,California,Imperial County,12,0,181215,92878,88337
50,6,25,California,Imperial County,12,1,14525,7267,7258
50,6,25,California,Imperial County,12,2,14818,7637,7181
50,6,25,California,Imperial County,12,3,14027,7048,6979
50,6,25,California,Imperial County,12,4,13410,6881,6529
50,6,25,California,Imperial County,12,5,12818,7049,5769
50,6,25,California,Imperial County,12,6,13996,7870,6126
50,6,25,California,Imperial County,12,7,12929,7388,5541
50,6,25,California,Imperial County,12,8,12022,6570,5452
50,6,25,California,Imperial County,12,9,10259,5511,4748
50,6,25,California,Imperial County,12,10,9832,4971,4861
50,6,25,California,Imperial County,12,11,9788,4888,4900
50,6,25,California,Imperial County,12,12,9638,4648,4990
50,6,25,California,Imperial County,12,13,9016,4293,4723
50,6,25,California,Imperial County,12,14,7425,3475,3950
50,6,25,California,Imperial County,12,15,6049,2819,3230
50,6,25,California,Imperial County,12,16,4300,1860,2440
50,6,25,California,Imperial County,12,17,3129,1388,1741
50,6,25,California,Imperial County,12,18,3234,1315,1919
50,6,27,California,Inyo County,1,0,18546,9354,9192
50,6,27,California,Inyo County,1,1,1070,560,510
50,6,27,California,Inyo County,1,2,985,529,456
50,6,27,California,Inyo County,1,3,1134,580,554
50,6,27,California,Inyo County,1,4,1087,549,538
50,6,27,California,Inyo County,1,5,865,465,400
50,6,27,California,Inyo County,1,6,1041,519,522
50,6,27,California,Inyo County,1,7,979,522,457
50,6,27,California,Inyo County,1,8,977,506,471
50,6,27,California,Inyo County,1,9,992,494,498
50,6,27,California,Inyo County,1,10,1367,673,694
50,6,27,California,Inyo County,1,11,1594,821,773
50,6,27,California,Inyo County,1,12,1581,810,771
50,6,27,California,Inyo County,1,13,1339,678,661
50,6,27,California,Inyo County,1,14,1035,527,508
50,6,27,California,Inyo County,1,15,783,396,387
50,6,27,California,Inyo County,1,16,676,315,361
50,6,27,California,Inyo County,1,17,520,216,304
50,6,27,California,Inyo County,1,18,521,194,327
50,6,27,California,Inyo County,2,0,18542,9351,9191
50,6,27,California,Inyo County,2,1,1070,560,510
50,6,27,California,Inyo County,2,2,985,529,456
50,6,27,California,Inyo County,2,3,1134,580,554
50,6,27,California,Inyo County,2,4,1087,549,538
50,6,27,California,Inyo County,2,5,864,465,399
50,6,27,California,Inyo County,2,6,1040,518,522
50,6,27,California,Inyo County,2,7,979,522,457
50,6,27,California,Inyo County,2,8,977,506,471
50,6,27,California,Inyo County,2,9,992,494,498
50,6,27,California,Inyo County,2,10,1367,673,694
50,6,27,California,Inyo County,2,11,1594,821,773
50,6,27,California,Inyo County,2,12,1580,809,771
50,6,27,California,Inyo County,2,13,1339,678,661
50,6,27,California,Inyo County,2,14,1035,527,508
50,6,27,California,Inyo County,2,15,782,395,387
50,6,27,California,Inyo County,2,16,676,315,361
50,6,27,California,Inyo County,2,17,520,216,304
50,6,27,California,Inyo County,2,18,521,194,327
50,6,27,California,Inyo County,3,0,18511,9338,9173
50,6,27,California,Inyo County,3,1,1060,555,505
50,6,27,California,Inyo County,3,2,992,531,461
50,6,27,California,Inyo County,3,3,1115,573,542
50,6,27,California,Inyo County,3,4,1096,558,538
50,6,27,California,Inyo County,3,5,863,464,399
50,6,27,California,Inyo County,3,6,1029,512,517
50,6,27,California,Inyo County,3,7,987,526,461
50,6,27,California,Inyo County,3,8,960,496,464
50,6,27,California,Inyo County,3,9,996,502,494
50,6,27,California,Inyo County,3,10,1342,657,685
50,6,27,California,Inyo County,3,11,1586,814,772
50,6,27,California,Inyo County,3,12,1575,802,773
50,6,27,California,Inyo County,3,13,1361,692,669
50,6,27,California,Inyo County,3,14,1039,528,511
50,6,27,California,Inyo County,3,15,786,398,388
50,6,27,California,Inyo County,3,16,675,317,358
50,6,27,California,Inyo County,3,17,519,216,303
50,6,27,California,Inyo County,3,18,530,197,333
50,6,27,California,Inyo County,4,0,18392,9264,9128
50,6,27,California,Inyo County,4,1,1042,532,510
50,6,27,California,Inyo County,4,2,1016,534,482
50,6,27,California,Inyo County,4,3,1060,547,513
50,6,27,California,Inyo County,4,4,1134,586,548
50,6,27,California,Inyo County,4,5,871,466,405
50,6,27,California,Inyo County,4,6,1000,504,496
50,6,27,California,Inyo County,4,7,1015,536,479
50,6,27,California,Inyo County,4,8,911,475,436
50,6,27,California,Inyo County,4,9,1022,511,511
50,6,27,California,Inyo County,4,10,1238,621,617
50,6,27,California,Inyo County,4,11,1533,776,757
50,6,27,California,Inyo County,4,12,1581,780,801
50,6,27,California,Inyo County,4,13,1408,723,685
50,6,27,California,Inyo County,4,14,1054,533,521
50,6,27,California,Inyo County,4,15,787,404,383
50,6,27,California,Inyo County,4,16,665,317,348
50,6,27,California,Inyo County,4,17,502,218,284
50,6,27,California,Inyo County,4,18,553,201,352
50,6,27,California,Inyo County,5,0,18351,9224,9127
50,6,27,California,Inyo County,5,1,1066,543,523
50,6,27,California,Inyo County,5,2,1017,528,489
50,6,27,California,Inyo County,5,3,1034,542,492
50,6,27,California,Inyo County,5,4,1122,584,538
50,6,27,California,Inyo County,5,5,887,460,427
50,6,27,California,Inyo County,5,6,974,495,479
50,6,27,California,Inyo County,5,7,1050,545,505
50,6,27,California,Inyo County,5,8,938,496,442
50,6,27,California,Inyo County,5,9,1022,511,511
50,6,27,California,Inyo County,5,10,1109,550,559
50,6,27,California,Inyo County,5,11,1514,744,770
50,6,27,California,Inyo County,5,12,1588,785,803
50,6,27,California,Inyo County,5,13,1390,712,678
50,6,27,California,Inyo County,5,14,1112,572,540
50,6,27,California,Inyo County,5,15,803,406,397
50,6,27,California,Inyo County,5,16,656,318,338
50,6,27,California,Inyo County,5,17,498,224,274
50,6,27,California,Inyo County,5,18,571,209,362
50,6,27,California,Inyo County,6,0,18357,9202,9155
50,6,27,California,Inyo County,6,1,1088,558,530
50,6,27,California,Inyo County,6,2,1046,540,506
50,6,27,California,Inyo County,6,3,1031,548,483
50,6,27,California,Inyo County,6,4,1093,550,543
50,6,27,California,Inyo County,6,5,900,447,453
50,6,27,California,Inyo County,6,6,924,481,443
50,6,27,California,Inyo County,6,7,1084,563,521
50,6,27,California,Inyo County,6,8,957,507,450
50,6,27,California,Inyo County,6,9,971,491,480
50,6,27,California,Inyo County,6,10,1029,490,539
50,6,27,California,Inyo County,6,11,1475,742,733
50,6,27,California,Inyo County,6,12,1616,801,815
50,6,27,California,Inyo County,6,13,1408,711,697
50,6,27,California,Inyo County,6,14,1139,592,547
50,6,27,California,Inyo County,6,15,847,422,425
50,6,27,California,Inyo County,6,16,651,313,338
50,6,27,California,Inyo County,6,17,524,240,284
50,6,27,California,Inyo County,6,18,574,206,368
50,6,27,California,Inyo County,7,0,18292,9170,9122
50,6,27,California,Inyo County,7,1,1093,558,535
50,6,27,California,Inyo County,7,2,1056,537,519
50,6,27,California,Inyo County,7,3,992,525,467
50,6,27,California,Inyo County,7,4,1067,540,527
50,6,27,California,Inyo County,7,5,877,437,440
50,6,27,California,Inyo County,7,6,924,486,438
50,6,27,California,Inyo County,7,7,1079,558,521
50,6,27,California,Inyo County,7,8,995,525,470
50,6,27,California,Inyo County,7,9,950,481,469
50,6,27,California,Inyo County,7,10,1004,492,512
50,6,27,California,Inyo County,7,11,1395,698,697
50,6,27,California,Inyo County,7,12,1594,796,798
50,6,27,California,Inyo County,7,13,1433,720,713
50,6,27,California,Inyo County,7,14,1178,605,573
50,6,27,California,Inyo County,7,15,891,441,450
50,6,27,California,Inyo County,7,16,667,316,351
50,6,27,California,Inyo County,7,17,523,249,274
50,6,27,California,Inyo County,7,18,574,206,368
50,6,27,California,Inyo County,8,0,18108,9066,9042
50,6,27,California,Inyo County,8,1,1075,541,534
50,6,27,California,Inyo County,8,2,1068,548,520
50,6,27,California,Inyo County,8,3,959,512,447
50,6,27,California,Inyo County,8,4,1054,549,505
50,6,27,California,Inyo County,8,5,845,411,434
50,6,27,California,Inyo County,8,6,879,458,421
50,6,27,California,Inyo County,8,7,1082,549,533
50,6,27,California,Inyo County,8,8,987,534,453
50,6,27,California,Inyo County,8,9,925,463,462
50,6,27,California,Inyo County,8,10,979,485,494
50,6,27,California,Inyo County,8,11,1286,632,654
50,6,27,California,Inyo County,8,12,1556,787,769
50,6,27,California,Inyo County,8,13,1476,724,752
50,6,27,California,Inyo County,8,14,1237,622,615
50,6,27,California,Inyo County,8,15,913,458,455
50,6,27,California,Inyo County,8,16,675,328,347
50,6,27,California,Inyo County,8,17,547,251,296
50,6,27,California,Inyo County,8,18,565,214,351
50,6,27,California,Inyo County,9,0,17922,8998,8924
50,6,27,California,Inyo County,9,1,1055,537,518
50,6,27,California,Inyo County,9,2,1037,540,497
50,6,27,California,Inyo County,9,3,970,506,464
50,6,27,California,Inyo County,9,4,993,528,465
50,6,27,California,Inyo County,9,5,843,437,406
50,6,27,California,Inyo County,9,6,878,455,423
50,6,27,California,Inyo County,9,7,1076,548,528
50,6,27,California,Inyo County,9,8,1003,530,473
50,6,27,California,Inyo County,9,9,907,467,440
50,6,27,California,Inyo County,9,10,951,466,485
50,6,27,California,Inyo County,9,11,1173,578,595
50,6,27,California,Inyo County,9,12,1510,751,759
50,6,27,California,Inyo County,9,13,1524,745,779
50,6,27,California,Inyo County,9,14,1272,648,624
50,6,27,California,Inyo County,9,15,907,446,461
50,6,27,California,Inyo County,9,16,696,336,360
50,6,27,California,Inyo County,9,17,531,249,282
50,6,27,California,Inyo County,9,18,596,231,365
50,6,27,California,Inyo County,10,0,17868,9011,8857
50,6,27,California,Inyo County,10,1,1039,540,499
50,6,27,California,Inyo County,10,2,1045,556,489
50,6,27,California,Inyo County,10,3,997,502,495
50,6,27,California,Inyo County,10,4,945,509,436
50,6,27,California,Inyo County,10,5,850,448,402
50,6,27,California,Inyo County,10,6,884,446,438
50,6,27,California,Inyo County,10,7,1056,544,512
50,6,27,California,Inyo County,10,8,1038,549,489
50,6,27,California,Inyo County,10,9,917,485,432
50,6,27,California,Inyo County,10,10,996,495,501
50,6,27,California,Inyo County,10,11,1049,516,533
50,6,27,California,Inyo County,10,12,1516,730,786
50,6,27,California,Inyo County,10,13,1483,729,754
50,6,27,California,Inyo County,10,14,1273,657,616
50,6,27,California,Inyo County,10,15,977,491,486
50,6,27,California,Inyo County,10,16,684,325,359
50,6,27,California,Inyo County,10,17,516,245,271
50,6,27,California,Inyo County,10,18,603,244,359
50,6,27,California,Inyo County,11,0,17946,9016,8930
50,6,27,California,Inyo County,11,1,1041,512,529
50,6,27,California,Inyo County,11,2,1079,571,508
50,6,27,California,Inyo County,11,3,1020,520,500
50,6,27,California,Inyo County,11,4,932,502,430
50,6,27,California,Inyo County,11,5,831,432,399
50,6,27,California,Inyo County,11,6,887,435,452
50,6,27,California,Inyo County,11,7,1063,550,513
50,6,27,California,Inyo County,11,8,1108,581,527
50,6,27,California,Inyo County,11,9,911,476,435
50,6,27,California,Inyo County,11,10,963,489,474
50,6,27,California,Inyo County,11,11,989,471,518
50,6,27,California,Inyo County,11,12,1467,724,743
50,6,27,California,Inyo County,11,13,1517,747,770
50,6,27,California,Inyo County,11,14,1307,665,642
50,6,27,California,Inyo County,11,15,988,514,474
50,6,27,California,Inyo County,11,16,708,324,384
50,6,27,California,Inyo County,11,17,525,251,274
50,6,27,California,Inyo County,11,18,610,252,358
50,6,27,California,Inyo County,12,0,18039,9036,9003
50,6,27,California,Inyo County,12,1,998,490,508
50,6,27,California,Inyo County,12,2,1102,562,540
50,6,27,California,Inyo County,12,3,1056,549,507
50,6,27,California,Inyo County,12,4,921,489,432
50,6,27,California,Inyo County,12,5,814,399,415
50,6,27,California,Inyo County,12,6,924,448,476
50,6,27,California,Inyo County,12,7,1022,523,499
50,6,27,California,Inyo County,12,8,1202,645,557
50,6,27,California,Inyo County,12,9,966,509,457
50,6,27,California,Inyo County,12,10,936,472,464
50,6,27,California,Inyo County,12,11,964,476,488
50,6,27,California,Inyo County,12,12,1362,664,698
50,6,27,California,Inyo County,12,13,1544,771,773
50,6,27,California,Inyo County,12,14,1338,663,675
50,6,27,California,Inyo County,12,15,1012,525,487
50,6,27,California,Inyo County,12,16,750,350,400
50,6,27,California,Inyo County,12,17,518,242,276
50,6,27,California,Inyo County,12,18,610,259,351
50,6,29,California,Kern County,1,0,839631,433108,406523
50,6,29,California,Kern County,1,1,72885,36952,35933
50,6,29,California,Kern County,1,2,68694,35022,33672
50,6,29,California,Kern County,1,3,68473,34899,33574
50,6,29,California,Kern County,1,4,72493,37862,34631
50,6,29,California,Kern County,1,5,65339,35895,29444
50,6,29,California,Kern County,1,6,63630,34949,28681
50,6,29,California,Kern County,1,7,58416,31585,26831
50,6,29,California,Kern County,1,8,54558,28846,25712
50,6,29,California,Kern County,1,9,53942,28542,25400
50,6,29,California,Kern County,1,10,55879,28993,26886
50,6,29,California,Kern County,1,11,52600,26980,25620
50,6,29,California,Kern County,1,12,43233,21756,21477
50,6,29,California,Kern County,1,13,34052,16807,17245
50,6,29,California,Kern County,1,14,25040,12058,12982
50,6,29,California,Kern County,1,15,18462,8752,9710
50,6,29,California,Kern County,1,16,13555,6076,7479
50,6,29,California,Kern County,1,17,9918,4109,5809
50,6,29,California,Kern County,1,18,8462,3025,5437
50,6,29,California,Kern County,2,0,839621,433103,406518
50,6,29,California,Kern County,2,1,72885,36952,35933
50,6,29,California,Kern County,2,2,68694,35022,33672
50,6,29,California,Kern County,2,3,68471,34898,33573
50,6,29,California,Kern County,2,4,72489,37860,34629
50,6,29,California,Kern County,2,5,65339,35895,29444
50,6,29,California,Kern County,2,6,63630,34949,28681
50,6,29,California,Kern County,2,7,58416,31585,26831
50,6,29,California,Kern County,2,8,54558,28846,25712
50,6,29,California,Kern County,2,9,53940,28541,25399
50,6,29,California,Kern County,2,10,55876,28992,26884
50,6,29,California,Kern County,2,11,52599,26979,25620
50,6,29,California,Kern County,2,12,43235,21757,21478
50,6,29,California,Kern County,2,13,34052,16807,17245
50,6,29,California,Kern County,2,14,25040,12058,12982
50,6,29,California,Kern County,2,15,18462,8752,9710
50,6,29,California,Kern County,2,16,13555,6076,7479
50,6,29,California,Kern County,2,17,9918,4109,5809
50,6,29,California,Kern County,2,18,8462,3025,5437
50,6,29,California,Kern County,3,0,840996,433447,407549
50,6,29,California,Kern County,3,1,72900,36967,35933
50,6,29,California,Kern County,3,2,68843,35060,33783
50,6,29,California,Kern County,3,3,68466,34898,33568
50,6,29,California,Kern County,3,4,71928,37582,34346
50,6,29,California,Kern County,3,5,65852,36059,29793
50,6,29,California,Kern County,3,6,63762,35003,28759
50,6,29,California,Kern County,3,7,58590,31639,26951
50,6,29,California,Kern County,3,8,54520,28773,25747
50,6,29,California,Kern County,3,9,53864,28424,25440
50,6,29,California,Kern County,3,10,55646,28869,26777
50,6,29,California,Kern County,3,11,52771,27023,25748
50,6,29,California,Kern County,3,12,43657,21995,21662
50,6,29,California,Kern County,3,13,34391,16942,17449
50,6,29,California,Kern County,3,14,25149,12106,13043
50,6,29,California,Kern County,3,15,18594,8824,9770
50,6,29,California,Kern County,3,16,13614,6120,7494
50,6,29,California,Kern County,3,17,9905,4110,5795
50,6,29,California,Kern County,3,18,8544,3053,5491
50,6,29,California,Kern County,4,0,847970,436331,411639
50,6,29,California,Kern County,4,1,72981,36953,36028
50,6,29,California,Kern County,4,2,69638,35366,34272
50,6,29,California,Kern County,4,3,68381,34828,33553
50,6,29,California,Kern County,4,4,69867,36510,33357
50,6,29,California,Kern County,4,5,68276,37159,31117
50,6,29,California,Kern County,4,6,64725,35513,29212
50,6,29,California,Kern County,4,7,59579,32108,27471
50,6,29,California,Kern County,4,8,54425,28689,25736
50,6,29,California,Kern County,4,9,53713,28170,25543
50,6,29,California,Kern County,4,10,54406,28264,26142
50,6,29,California,Kern County,4,11,53326,27205,26121
50,6,29,California,Kern County,4,12,45164,22825,22339
50,6,29,California,Kern County,4,13,35935,17590,18345
50,6,29,California,Kern County,4,14,25750,12400,13350
50,6,29,California,Kern County,4,15,19250,9184,10066
50,6,29,California,Kern County,4,16,13882,6292,7590
50,6,29,California,Kern County,4,17,9808,4070,5738
50,6,29,California,Kern County,4,18,8864,3205,5659
50,6,29,California,Kern County,5,0,853606,437247,416359
50,6,29,California,Kern County,5,1,72863,36873,35990
50,6,29,California,Kern County,5,2,71394,36178,35216
50,6,29,California,Kern County,5,3,68373,34799,33574
50,6,29,California,Kern County,5,4,68354,35535,32819
50,6,29,California,Kern County,5,5,69711,37600,32111
50,6,29,California,Kern County,5,6,64959,35391,29568
50,6,29,California,Kern County,5,7,60226,32285,27941
50,6,29,California,Kern County,5,8,54246,28421,25825
50,6,29,California,Kern County,5,9,53101,27568,25533
50,6,29,California,Kern County,5,10,53160,27446,25714
50,6,29,California,Kern County,5,11,53461,27140,26321
50,6,29,California,Kern County,5,12,46599,23506,23093
50,6,29,California,Kern County,5,13,36366,17836,18530
50,6,29,California,Kern County,5,14,27670,13227,14443
50,6,29,California,Kern County,5,15,19958,9530,10428
50,6,29,California,Kern County,5,16,14160,6473,7687
50,6,29,California,Kern County,5,17,9916,4136,5780
50,6,29,California,Kern County,5,18,9089,3303,5786
50,6,29,California,Kern County,6,0,862000,441128,420872
50,6,29,California,Kern County,6,1,72905,36884,36021
50,6,29,California,Kern County,6,2,73133,37049,36084
50,6,29,California,Kern County,6,3,68744,34989,33755
50,6,29,California,Kern County,6,4,67237,34847,32390
50,6,29,California,Kern County,6,5,70729,38003,32726
50,6,29,California,Kern County,6,6,66032,35923,30109
50,6,29,California,Kern County,6,7,61678,33013,28665
50,6,29,California,Kern County,6,8,54625,28667,25958
50,6,29,California,Kern County,6,9,52972,27427,25545
50,6,29,California,Kern County,6,10,52030,26813,25217
50,6,29,California,Kern County,6,11,53553,27019,26534
50,6,29,California,Kern County,6,12,47580,24090,23490
50,6,29,California,Kern County,6,13,37326,18479,18847
50,6,29,California,Kern County,6,14,28647,13644,15003
50,6,29,California,Kern County,6,15,20999,9972,11027
50,6,29,California,Kern County,6,16,14544,6696,7848
50,6,29,California,Kern County,6,17,10041,4259,5782
50,6,29,California,Kern County,6,18,9225,3354,5871
50,6,29,California,Kern County,7,0,869176,445355,423821
50,6,29,California,Kern County,7,1,72459,36818,35641
50,6,29,California,Kern County,7,2,73833,37476,36357
50,6,29,California,Kern County,7,3,69169,35145,34024
50,6,29,California,Kern County,7,4,66390,34370,32020
50,6,29,California,Kern County,7,5,71121,38307,32814
50,6,29,California,Kern County,7,6,67443,36526,30917
50,6,29,California,Kern County,7,7,62936,33972,28964
50,6,29,California,Kern County,7,8,55450,29235,26215
50,6,29,California,Kern County,7,9,52678,27311,25367
50,6,29,California,Kern County,7,10,51235,26473,24762
50,6,29,California,Kern County,7,11,53149,26743,26406
50,6,29,California,Kern County,7,12,48567,24587,23980
50,6,29,California,Kern County,7,13,38726,19154,19572
50,6,29,California,Kern County,7,14,29733,14240,15493
50,6,29,California,Kern County,7,15,21788,10321,11467
50,6,29,California,Kern County,7,16,15024,6939,8085
50,6,29,California,Kern County,7,17,10046,4259,5787
50,6,29,California,Kern County,7,18,9429,3479,5950
50,6,29,California,Kern County,8,0,876031,449123,426908
50,6,29,California,Kern County,8,1,72008,36724,35284
50,6,29,California,Kern County,8,2,74344,37622,36722
50,6,29,California,Kern County,8,3,69592,35345,34247
50,6,29,California,Kern County,8,4,65917,34092,31825
50,6,29,California,Kern County,8,5,70594,37979,32615
50,6,29,California,Kern County,8,6,69264,37589,31675
50,6,29,California,Kern County,8,7,63909,34492,29417
50,6,29,California,Kern County,8,8,56514,29934,26580
50,6,29,California,Kern County,8,9,52432,27195,25237
50,6,29,California,Kern County,8,10,51176,26456,24720
50,6,29,California,Kern County,8,11,52062,26226,25836
50,6,29,California,Kern County,8,12,49488,24994,24494
50,6,29,California,Kern County,8,13,40122,19785,20337
50,6,29,California,Kern County,8,14,30977,14942,16035
50,6,29,California,Kern County,8,15,22242,10501,11741
50,6,29,California,Kern County,8,16,15591,7270,8321
50,6,29,California,Kern County,8,17,10192,4383,5809
50,6,29,California,Kern County,8,18,9607,3594,6013
50,6,29,California,Kern County,9,0,880856,451394,429462
50,6,29,California,Kern County,9,1,71006,36188,34818
50,6,29,California,Kern County,9,2,74290,37597,36693
50,6,29,California,Kern County,9,3,70516,35677,34839
50,6,29,California,Kern County,9,4,65885,34139,31746
50,6,29,California,Kern County,9,5,68419,36808,31611
50,6,29,California,Kern County,9,6,71248,38505,32743
50,6,29,California,Kern County,9,7,64597,34881,29716
50,6,29,California,Kern County,9,8,57630,30571,27059
50,6,29,California,Kern County,9,9,52283,27220,25063
50,6,29,California,Kern County,9,10,51084,26325,24759
50,6,29,California,Kern County,9,11,50893,25677,25216
50,6,29,California,Kern County,9,12,50134,25202,24932
50,6,29,California,Kern County,9,13,41283,20530,20753
50,6,29,California,Kern County,9,14,32358,15499,16859
50,6,29,California,Kern County,9,15,22904,10796,12108
50,6,29,California,Kern County,9,16,16153,7560,8593
50,6,29,California,Kern County,9,17,10449,4564,5885
50,6,29,California,Kern County,9,18,9724,3655,6069
50,6,29,California,Kern County,10,0,887356,454692,432664
50,6,29,California,Kern County,10,1,70515,35964,34551
50,6,29,California,Kern County,10,2,74177,37599,36578
50,6,29,California,Kern County,10,3,72074,36416,35658
50,6,29,California,Kern County,10,4,65727,34006,31721
50,6,29,California,Kern County,10,5,66876,35947,30929
50,6,29,California,Kern County,10,6,72632,39201,33431
50,6,29,California,Kern County,10,7,65250,35273,29977
50,6,29,California,Kern County,10,8,59090,31385,27705
50,6,29,California,Kern County,10,9,52749,27677,25072
50,6,29,California,Kern County,10,10,50920,26139,24781
50,6,29,California,Kern County,10,11,49865,25191,24674
50,6,29,California,Kern County,10,12,50271,25188,25083
50,6,29,California,Kern County,10,13,42649,21258,21391
50,6,29,California,Kern County,10,14,32655,15723,16932
50,6,29,California,Kern County,10,15,24496,11472,13024
50,6,29,California,Kern County,10,16,16787,7782,9005
50,6,29,California,Kern County,10,17,10591,4669,5922
50,6,29,California,Kern County,10,18,10032,3802,6230
50,6,29,California,Kern County,11,0,893758,457823,435935
50,6,29,California,Kern County,11,1,69407,35440,33967
50,6,29,California,Kern County,11,2,74002,37523,36479
50,6,29,California,Kern County,11,3,73678,37323,36355
50,6,29,California,Kern County,11,4,66373,34301,32072
50,6,29,California,Kern County,11,5,65564,35180,30384
50,6,29,California,Kern County,11,6,73259,39592,33667
50,6,29,California,Kern County,11,7,66009,35606,30403
50,6,29,California,Kern County,11,8,60800,32250,28550
50,6,29,California,Kern County,11,9,53173,27989,25184
50,6,29,California,Kern County,11,10,50960,26116,24844
50,6,29,California,Kern County,11,11,48905,24735,24170
50,6,29,California,Kern County,11,12,50161,24959,25202
50,6,29,California,Kern County,11,13,43716,21869,21847
50,6,29,California,Kern County,11,14,33668,16300,17368
50,6,29,California,Kern County,11,15,25310,11808,13502
50,6,29,California,Kern County,11,16,17671,8165,9506
50,6,29,California,Kern County,11,17,10862,4813,6049
50,6,29,California,Kern County,11,18,10240,3854,6386
50,6,29,California,Kern County,12,0,900202,461034,439168
50,6,29,California,Kern County,12,1,68439,34926,33513
50,6,29,California,Kern County,12,2,74200,37785,36415
50,6,29,California,Kern County,12,3,74460,37767,36693
50,6,29,California,Kern County,12,4,67037,34574,32463
50,6,29,California,Kern County,12,5,64704,34678,30026
50,6,29,California,Kern County,12,6,73670,39869,33801
50,6,29,California,Kern County,12,7,66958,35940,31018
50,6,29,California,Kern County,12,8,61974,32858,29116
50,6,29,California,Kern County,12,9,54212,28567,25645
50,6,29,California,Kern County,12,10,50691,26072,24619
50,6,29,California,Kern County,12,11,48297,24452,23845
50,6,29,California,Kern County,12,12,49920,24742,25178
50,6,29,California,Kern County,12,13,44485,22285,22200
50,6,29,California,Kern County,12,14,34927,16860,18067
50,6,29,California,Kern County,12,15,26346,12359,13987
50,6,29,California,Kern County,12,16,18278,8420,9858
50,6,29,California,Kern County,12,17,11233,4973,6260
50,6,29,California,Kern County,12,18,10371,3907,6464
50,6,31,California,Kings County,1,0,152982,86344,66638
50,6,31,California,Kings County,1,1,12877,6543,6334
50,6,31,California,Kings County,1,2,11564,5904,5660
50,6,31,California,Kings County,1,3,11324,5749,5575
50,6,31,California,Kings County,1,4,11356,5947,5409
50,6,31,California,Kings County,1,5,13158,7927,5231
50,6,31,California,Kings County,1,6,13424,8282,5142
50,6,31,California,Kings County,1,7,12165,7435,4730
50,6,31,California,Kings County,1,8,11183,6962,4221
50,6,31,California,Kings County,1,9,10695,6699,3996
50,6,31,California,Kings County,1,10,10909,6683,4226
50,6,31,California,Kings County,1,11,9373,5547,3826
50,6,31,California,Kings County,1,12,7321,4194,3127
50,6,31,California,Kings County,1,13,5603,2940,2663
50,6,31,California,Kings County,1,14,3857,1997,1860
50,6,31,California,Kings County,1,15,2987,1412,1575
50,6,31,California,Kings County,1,16,2255,995,1260
50,6,31,California,Kings County,1,17,1554,643,911
50,6,31,California,Kings County,1,18,1377,485,892
50,6,31,California,Kings County,2,0,152974,86340,66634
50,6,31,California,Kings County,2,1,12877,6543,6334
50,6,31,California,Kings County,2,2,11563,5904,5659
50,6,31,California,Kings County,2,3,11322,5747,5575
50,6,31,California,Kings County,2,4,11354,5947,5407
50,6,31,California,Kings County,2,5,13158,7927,5231
50,6,31,California,Kings County,2,6,13424,8282,5142
50,6,31,California,Kings County,2,7,12165,7435,4730
50,6,31,California,Kings County,2,8,11181,6961,4220
50,6,31,California,Kings County,2,9,10695,6699,3996
50,6,31,California,Kings County,2,10,10909,6683,4226
50,6,31,California,Kings County,2,11,9373,5547,3826
50,6,31,California,Kings County,2,12,7321,4194,3127
50,6,31,California,Kings County,2,13,5603,2940,2663
50,6,31,California,Kings County,2,14,3856,1996,1860
50,6,31,California,Kings County,2,15,2987,1412,1575
50,6,31,California,Kings County,2,16,2255,995,1260
50,6,31,California,Kings County,2,17,1554,643,911
50,6,31,California,Kings County,2,18,1377,485,892
50,6,31,California,Kings County,3,0,152370,85708,66662
50,6,31,California,Kings County,3,1,12800,6514,6286
50,6,31,California,Kings County,3,2,11563,5889,5674
50,6,31,California,Kings County,3,3,11298,5730,5568
50,6,31,California,Kings County,3,4,11298,5914,5384
50,6,31,California,Kings County,3,5,13117,7863,5254
50,6,31,California,Kings County,3,6,13371,8212,5159
50,6,31,California,Kings County,3,7,12083,7360,4723
50,6,31,California,Kings County,3,8,11085,6871,4214
50,6,31,California,Kings County,3,9,10598,6615,3983
50,6,31,California,Kings County,3,10,10774,6573,4201
50,6,31,California,Kings County,3,11,9352,5498,3854
50,6,31,California,Kings County,3,12,7323,4176,3147
50,6,31,California,Kings County,3,13,5616,2948,2668
50,6,31,California,Kings County,3,14,3867,1986,1881
50,6,31,California,Kings County,3,15,2987,1415,1572
50,6,31,California,Kings County,3,16,2273,998,1275
50,6,31,California,Kings County,3,17,1572,651,921
50,6,31,California,Kings County,3,18,1393,495,898
50,6,31,California,Kings County,4,0,151868,85082,66786
50,6,31,California,Kings County,4,1,12709,6505,6204
50,6,31,California,Kings County,4,2,11642,5882,5760
50,6,31,California,Kings County,4,3,11187,5713,5474
50,6,31,California,Kings County,4,4,11004,5715,5289
50,6,31,California,Kings County,4,5,13140,7806,5334
50,6,31,California,Kings County,4,6,13322,8148,5174
50,6,31,California,Kings County,4,7,12018,7270,4748
50,6,31,California,Kings County,4,8,10908,6729,4179
50,6,31,California,Kings County,4,9,10425,6507,3918
50,6,31,California,Kings County,4,10,10510,6388,4122
50,6,31,California,Kings County,4,11,9356,5454,3902
50,6,31,California,Kings County,4,12,7446,4242,3204
50,6,31,California,Kings County,4,13,5778,3043,2735
50,6,31,California,Kings County,4,14,4003,2019,1984
50,6,31,California,Kings County,4,15,3035,1436,1599
50,6,31,California,Kings County,4,16,2320,1026,1294
50,6,31,California,Kings County,4,17,1623,673,950
50,6,31,California,Kings County,4,18,1442,526,916
50,6,31,California,Kings County,5,0,150991,84409,66582
50,6,31,California,Kings County,5,1,12184,6237,5947
50,6,31,California,Kings County,5,2,11737,5946,5791
50,6,31,California,Kings County,5,3,11029,5598,5431
50,6,31,California,Kings County,5,4,10734,5568,5166
50,6,31,California,Kings County,5,5,13188,7779,5409
50,6,31,California,Kings County,5,6,13208,8092,5116
50,6,31,California,Kings County,5,7,11985,7273,4712
50,6,31,California,Kings County,5,8,10889,6660,4229
50,6,31,California,Kings County,5,9,10259,6390,3869
50,6,31,California,Kings County,5,10,10179,6181,3998
50,6,31,California,Kings County,5,11,9289,5408,3881
50,6,31,California,Kings County,5,12,7610,4273,3337
50,6,31,California,Kings County,5,13,5780,3056,2724
50,6,31,California,Kings County,5,14,4266,2166,2100
50,6,31,California,Kings County,5,15,3162,1482,1680
50,6,31,California,Kings County,5,16,2357,1066,1291
50,6,31,California,Kings County,5,17,1645,678,967
50,6,31,California,Kings County,5,18,1490,556,934
50,6,31,California,Kings County,6,0,150337,83599,66738
50,6,31,California,Kings County,6,1,12066,6136,5930
50,6,31,California,Kings County,6,2,11987,6146,5841
50,6,31,California,Kings County,6,3,10806,5411,5395
50,6,31,California,Kings County,6,4,10684,5595,5089
50,6,31,California,Kings County,6,5,13207,7798,5409
50,6,31,California,Kings County,6,6,13078,7920,5158
50,6,31,California,Kings County,6,7,11907,7147,4760
50,6,31,California,Kings County,6,8,10677,6508,4169
50,6,31,California,Kings County,6,9,10011,6164,3847
50,6,31,California,Kings County,6,10,9786,5937,3849
50,6,31,California,Kings County,6,11,9232,5342,3890
50,6,31,California,Kings County,6,12,7652,4236,3416
50,6,31,California,Kings County,6,13,5905,3110,2795
50,6,31,California,Kings County,6,14,4448,2237,2211
50,6,31,California,Kings County,6,15,3245,1525,1720
50,6,31,California,Kings County,6,16,2401,1097,1304
50,6,31,California,Kings County,6,17,1668,699,969
50,6,31,California,Kings County,6,18,1577,591,986
50,6,31,California,Kings County,7,0,149495,82588,66907
50,6,31,California,Kings County,7,1,11826,6036,5790
50,6,31,California,Kings County,7,2,12030,6108,5922
50,6,31,California,Kings County,7,3,10815,5465,5350
50,6,31,California,Kings County,7,4,10597,5535,5062
50,6,31,California,Kings County,7,5,13190,7817,5373
50,6,31,California,Kings County,7,6,12943,7781,5162
50,6,31,California,Kings County,7,7,11948,7052,4896
50,6,31,California,Kings County,7,8,10513,6306,4207
50,6,31,California,Kings County,7,9,9746,5922,3824
50,6,31,California,Kings County,7,10,9353,5640,3713
50,6,31,California,Kings County,7,11,9072,5157,3915
50,6,31,California,Kings County,7,12,7686,4238,3448
50,6,31,California,Kings County,7,13,5999,3191,2808
50,6,31,California,Kings County,7,14,4617,2286,2331
50,6,31,California,Kings County,7,15,3296,1577,1719
50,6,31,California,Kings County,7,16,2488,1125,1363
50,6,31,California,Kings County,7,17,1753,751,1002
50,6,31,California,Kings County,7,18,1623,601,1022
50,6,31,California,Kings County,8,0,150085,82865,67220
50,6,31,California,Kings County,8,1,11855,6009,5846
50,6,31,California,Kings County,8,2,11991,6034,5957
50,6,31,California,Kings County,8,3,10814,5495,5319
50,6,31,California,Kings County,8,4,10537,5511,5026
50,6,31,California,Kings County,8,5,13170,7813,5357
50,6,31,California,Kings County,8,6,12994,7846,5148
50,6,31,California,Kings County,8,7,11908,7064,4844
50,6,31,California,Kings County,8,8,10783,6454,4329
50,6,31,California,Kings County,8,9,9663,5812,3851
50,6,31,California,Kings County,8,10,9276,5640,3636
50,6,31,California,Kings County,8,11,8996,5114,3882
50,6,31,California,Kings County,8,12,7750,4238,3512
50,6,31,California,Kings County,8,13,6120,3275,2845
50,6,31,California,Kings County,8,14,4810,2379,2431
50,6,31,California,Kings County,8,15,3354,1615,1739
50,6,31,California,Kings County,8,16,2570,1159,1411
50,6,31,California,Kings County,8,17,1798,765,1033
50,6,31,California,Kings County,8,18,1696,642,1054
50,6,31,California,Kings County,9,0,149382,82312,67070
50,6,31,California,Kings County,9,1,11578,5867,5711
50,6,31,California,Kings County,9,2,11890,5997,5893
50,6,31,California,Kings County,9,3,10817,5492,5325
50,6,31,California,Kings County,9,4,10440,5427,5013
50,6,31,California,Kings County,9,5,12808,7635,5173
50,6,31,California,Kings County,9,6,13095,7904,5191
50,6,31,California,Kings County,9,7,12008,7096,4912
50,6,31,California,Kings County,9,8,10747,6425,4322
50,6,31,California,Kings County,9,9,9491,5727,3764
50,6,31,California,Kings County,9,10,9153,5520,3633
50,6,31,California,Kings County,9,11,8750,4961,3789
50,6,31,California,Kings County,9,12,7764,4197,3567
50,6,31,California,Kings County,9,13,6227,3337,2890
50,6,31,California,Kings County,9,14,4956,2451,2505
50,6,31,California,Kings County,9,15,3490,1673,1817
50,6,31,California,Kings County,9,16,2547,1139,1408
50,6,31,California,Kings County,9,17,1858,812,1046
50,6,31,California,Kings County,9,18,1763,652,1111
50,6,31,California,Kings County,10,0,149665,82065,67600
50,6,31,California,Kings County,10,1,11561,5930,5631
50,6,31,California,Kings County,10,2,11835,5945,5890
50,6,31,California,Kings County,10,3,11097,5650,5447
50,6,31,California,Kings County,10,4,10353,5372,4981
50,6,31,California,Kings County,10,5,12716,7508,5208
50,6,31,California,Kings County,10,6,13235,7905,5330
50,6,31,California,Kings County,10,7,12067,7106,4961
50,6,31,California,Kings County,10,8,10748,6332,4416
50,6,31,California,Kings County,10,9,9493,5693,3800
50,6,31,California,Kings County,10,10,8901,5364,3537
50,6,31,California,Kings County,10,11,8446,4772,3674
50,6,31,California,Kings County,10,12,7775,4195,3580
50,6,31,California,Kings County,10,13,6391,3385,3006
50,6,31,California,Kings County,10,14,4980,2448,2532
50,6,31,California,Kings County,10,15,3707,1772,1935
50,6,31,California,Kings County,10,16,2655,1173,1482
50,6,31,California,Kings County,10,17,1874,830,1044
50,6,31,California,Kings County,10,18,1831,685,1146
50,6,31,California,Kings County,11,0,151382,83208,68174
50,6,31,California,Kings County,11,1,11553,5925,5628
50,6,31,California,Kings County,11,2,11864,5932,5932
50,6,31,California,Kings County,11,3,11473,5840,5633
50,6,31,California,Kings County,11,4,10158,5278,4880
50,6,31,California,Kings County,11,5,12679,7515,5164
50,6,31,California,Kings County,11,6,13397,7979,5418
50,6,31,California,Kings County,11,7,12288,7283,5005
50,6,31,California,Kings County,11,8,11125,6587,4538
50,6,31,California,Kings County,11,9,9685,5879,3806
50,6,31,California,Kings County,11,10,8954,5400,3554
50,6,31,California,Kings County,11,11,8367,4773,3594
50,6,31,California,Kings County,11,12,7785,4215,3570
50,6,31,California,Kings County,11,13,6501,3444,3057
50,6,31,California,Kings County,11,14,5091,2496,2595
50,6,31,California,Kings County,11,15,3900,1853,2047
50,6,31,California,Kings County,11,16,2730,1219,1511
50,6,31,California,Kings County,11,17,1949,861,1088
50,6,31,California,Kings County,11,18,1883,729,1154
50,6,31,California,Kings County,12,0,152940,84342,68598
50,6,31,California,Kings County,12,1,11682,5987,5695
50,6,31,California,Kings County,12,2,11758,5975,5783
50,6,31,California,Kings County,12,3,11675,5937,5738
50,6,31,California,Kings County,12,4,10251,5380,4871
50,6,31,California,Kings County,12,5,12547,7460,5087
50,6,31,California,Kings County,12,6,13553,8061,5492
50,6,31,California,Kings County,12,7,12447,7415,5032
50,6,31,California,Kings County,12,8,11597,6891,4706
50,6,31,California,Kings County,12,9,9794,5936,3858
50,6,31,California,Kings County,12,10,8928,5416,3512
50,6,31,California,Kings County,12,11,8206,4742,3464
50,6,31,California,Kings County,12,12,7830,4202,3628
50,6,31,California,Kings County,12,13,6644,3529,3115
50,6,31,California,Kings County,12,14,5210,2622,2588
50,6,31,California,Kings County,12,15,4069,1892,2177
50,6,31,California,Kings County,12,16,2821,1275,1546
50,6,31,California,Kings County,12,17,1987,864,1123
50,6,31,California,Kings County,12,18,1941,758,1183
50,6,33,California,Lake County,1,0,64665,32469,32196
50,6,33,California,Lake County,1,1,3633,1873,1760
50,6,33,California,Lake County,1,2,3574,1841,1733
50,6,33,California,Lake County,1,3,3888,2044,1844
50,6,33,California,Lake County,1,4,4190,2190,2000
50,6,33,California,Lake County,1,5,3362,1745,1617
50,6,33,California,Lake County,1,6,3346,1763,1583
50,6,33,California,Lake County,1,7,3257,1717,1540
50,6,33,California,Lake County,1,8,3255,1601,1654
50,6,33,California,Lake County,1,9,3840,1925,1915
50,6,33,California,Lake County,1,10,4725,2301,2424
50,6,33,California,Lake County,1,11,5530,2744,2786
50,6,33,California,Lake County,1,12,5468,2658,2810
50,6,33,California,Lake County,1,13,5157,2638,2519
50,6,33,California,Lake County,1,14,3791,1858,1933
50,6,33,California,Lake County,1,15,2762,1376,1386
50,6,33,California,Lake County,1,16,2007,989,1018
50,6,33,California,Lake County,1,17,1495,662,833
50,6,33,California,Lake County,1,18,1385,544,841
50,6,33,California,Lake County,2,0,64662,32467,32195
50,6,33,California,Lake County,2,1,3633,1873,1760
50,6,33,California,Lake County,2,2,3574,1841,1733
50,6,33,California,Lake County,2,3,3888,2044,1844
50,6,33,California,Lake County,2,4,4190,2190,2000
50,6,33,California,Lake County,2,5,3362,1745,1617
50,6,33,California,Lake County,2,6,3346,1763,1583
50,6,33,California,Lake County,2,7,3257,1717,1540
50,6,33,California,Lake County,2,8,3255,1601,1654
50,6,33,California,Lake County,2,9,3840,1925,1915
50,6,33,California,Lake County,2,10,4725,2301,2424
50,6,33,California,Lake County,2,11,5530,2744,2786
50,6,33,California,Lake County,2,12,5468,2658,2810
50,6,33,California,Lake County,2,13,5156,2637,2519
50,6,33,California,Lake County,2,14,3789,1857,1932
50,6,33,California,Lake County,2,15,2762,1376,1386
50,6,33,California,Lake County,2,16,2007,989,1018
50,6,33,California,Lake County,2,17,1495,662,833
50,6,33,California,Lake County,2,18,1385,544,841
50,6,33,California,Lake County,3,0,64735,32471,32264
50,6,33,California,Lake County,3,1,3631,1871,1760
50,6,33,California,Lake County,3,2,3575,1843,1732
50,6,33,California,Lake County,3,3,3853,2018,1835
50,6,33,California,Lake County,3,4,4141,2165,1976
50,6,33,California,Lake County,3,5,3421,1777,1644
50,6,33,California,Lake County,3,6,3380,1783,1597
50,6,33,California,Lake County,3,7,3261,1717,1544
50,6,33,California,Lake County,3,8,3225,1590,1635
50,6,33,California,Lake County,3,9,3830,1907,1923
50,6,33,California,Lake County,3,10,4693,2281,2412
50,6,33,California,Lake County,3,11,5529,2749,2780
50,6,33,California,Lake County,3,12,5489,2659,2830
50,6,33,California,Lake County,3,13,5203,2651,2552
50,6,33,California,Lake County,3,14,3830,1886,1944
50,6,33,California,Lake County,3,15,2776,1379,1397
50,6,33,California,Lake County,3,16,2017,990,1027
50,6,33,California,Lake County,3,17,1484,662,822
50,6,33,California,Lake County,3,18,1397,543,854
50,6,33,California,Lake County,4,0,64251,32167,32084
50,6,33,California,Lake County,4,1,3604,1886,1718
50,6,33,California,Lake County,4,2,3557,1838,1719
50,6,33,California,Lake County,4,3,3635,1882,1753
50,6,33,California,Lake County,4,4,3935,2053,1882
50,6,33,California,Lake County,4,5,3502,1839,1663
50,6,33,California,Lake County,4,6,3366,1768,1598
50,6,33,California,Lake County,4,7,3272,1728,1544
50,6,33,California,Lake County,4,8,3033,1498,1535
50,6,33,California,Lake County,4,9,3735,1818,1917
50,6,33,California,Lake County,4,10,4463,2151,2312
50,6,33,California,Lake County,4,11,5414,2685,2729
50,6,33,California,Lake County,4,12,5507,2640,2867
50,6,33,California,Lake County,4,13,5439,2749,2690
50,6,33,California,Lake County,4,14,3961,1979,1982
50,6,33,California,Lake County,4,15,2842,1409,1433
50,6,33,California,Lake County,4,16,2095,1022,1073
50,6,33,California,Lake County,4,17,1463,671,792
50,6,33,California,Lake County,4,18,1428,551,877
50,6,33,California,Lake County,5,0,63954,32032,31922
50,6,33,California,Lake County,5,1,3614,1881,1733
50,6,33,California,Lake County,5,2,3563,1838,1725
50,6,33,California,Lake County,5,3,3605,1841,1764
50,6,33,California,Lake County,5,4,3747,1995,1752
50,6,33,California,Lake County,5,5,3575,1870,1705
50,6,33,California,Lake County,5,6,3317,1727,1590
50,6,33,California,Lake County,5,7,3336,1772,1564
50,6,33,California,Lake County,5,8,3070,1557,1513
50,6,33,California,Lake County,5,9,3522,1680,1842
50,6,33,California,Lake County,5,10,4293,2105,2188
50,6,33,California,Lake County,5,11,5127,2502,2625
50,6,33,California,Lake County,5,12,5554,2663,2891
50,6,33,California,Lake County,5,13,5326,2655,2671
50,6,33,California,Lake County,5,14,4337,2186,2151
50,6,33,California,Lake County,5,15,2948,1479,1469
50,6,33,California,Lake County,5,16,2102,1033,1069
50,6,33,California,Lake County,5,17,1470,672,798
50,6,33,California,Lake County,5,18,1448,576,872
50,6,33,California,Lake County,6,0,63796,31867,31929
50,6,33,California,Lake County,6,1,3580,1825,1755
50,6,33,California,Lake County,6,2,3552,1869,1683
50,6,33,California,Lake County,6,3,3599,1821,1778
50,6,33,California,Lake County,6,4,3628,1974,1654
50,6,33,California,Lake County,6,5,3517,1826,1691
50,6,33,California,Lake County,6,6,3339,1712,1627
50,6,33,California,Lake County,6,7,3319,1760,1559
50,6,33,California,Lake County,6,8,3096,1573,1523
50,6,33,California,Lake County,6,9,3531,1684,1847
50,6,33,California,Lake County,6,10,4008,1938,2070
50,6,33,California,Lake County,6,11,4908,2380,2528
50,6,33,California,Lake County,6,12,5564,2691,2873
50,6,33,California,Lake County,6,13,5384,2652,2732
50,6,33,California,Lake County,6,14,4493,2265,2228
50,6,33,California,Lake County,6,15,3162,1582,1580
50,6,33,California,Lake County,6,16,2174,1063,1111
50,6,33,California,Lake County,6,17,1452,666,786
50,6,33,California,Lake County,6,18,1490,586,904
50,6,33,California,Lake County,7,0,64044,31950,32094
50,6,33,California,Lake County,7,1,3661,1825,1836
50,6,33,California,Lake County,7,2,3617,1904,1713
50,6,33,California,Lake County,7,3,3578,1815,1763
50,6,33,California,Lake County,7,4,3556,1902,1654
50,6,33,California,Lake County,7,5,3451,1783,1668
50,6,33,California,Lake County,7,6,3492,1832,1660
50,6,33,California,Lake County,7,7,3392,1750,1642
50,6,33,California,Lake County,7,8,3185,1649,1536
50,6,33,California,Lake County,7,9,3368,1623,1745
50,6,33,California,Lake County,7,10,3891,1890,2001
50,6,33,California,Lake County,7,11,4730,2302,2428
50,6,33,California,Lake County,7,12,5487,2632,2855
50,6,33,California,Lake County,7,13,5344,2609,2735
50,6,33,California,Lake County,7,14,4772,2418,2354
50,6,33,California,Lake County,7,15,3306,1630,1676
50,6,33,California,Lake County,7,16,2255,1106,1149
50,6,33,California,Lake County,7,17,1462,686,776
50,6,33,California,Lake County,7,18,1497,594,903
50,6,33,California,Lake County,8,0,64260,32004,32256
50,6,33,California,Lake County,8,1,3708,1857,1851
50,6,33,California,Lake County,8,2,3668,1881,1787
50,6,33,California,Lake County,8,3,3598,1840,1758
50,6,33,California,Lake County,8,4,3461,1813,1648
50,6,33,California,Lake County,8,5,3322,1754,1568
50,6,33,California,Lake County,8,6,3595,1871,1724
50,6,33,California,Lake County,8,7,3446,1782,1664
50,6,33,California,Lake County,8,8,3266,1665,1601
50,6,33,California,Lake County,8,9,3181,1553,1628
50,6,33,California,Lake County,8,10,3771,1862,1909
50,6,33,California,Lake County,8,11,4564,2189,2375
50,6,33,California,Lake County,8,12,5501,2656,2845
50,6,33,California,Lake County,8,13,5385,2568,2817
50,6,33,California,Lake County,8,14,5013,2563,2450
50,6,33,California,Lake County,8,15,3447,1687,1760
50,6,33,California,Lake County,8,16,2307,1135,1172
50,6,33,California,Lake County,8,17,1549,735,814
50,6,33,California,Lake County,8,18,1478,593,885
50,6,33,California,Lake County,9,0,63903,31850,32053
50,6,33,California,Lake County,9,1,3664,1832,1832
50,6,33,California,Lake County,9,2,3714,1931,1783
50,6,33,California,Lake County,9,3,3645,1884,1761
50,6,33,California,Lake County,9,4,3450,1783,1667
50,6,33,California,Lake County,9,5,3110,1679,1431
50,6,33,California,Lake County,9,6,3672,1908,1764
50,6,33,California,Lake County,9,7,3486,1808,1678
50,6,33,California,Lake County,9,8,3324,1697,1627
50,6,33,California,Lake County,9,9,3059,1508,1551
50,6,33,California,Lake County,9,10,3678,1781,1897
50,6,33,California,Lake County,9,11,4433,2136,2297
50,6,33,California,Lake County,9,12,5285,2568,2717
50,6,33,California,Lake County,9,13,5331,2497,2834
50,6,33,California,Lake County,9,14,5131,2616,2515
50,6,33,California,Lake County,9,15,3518,1729,1789
50,6,33,California,Lake County,9,16,2353,1153,1200
50,6,33,California,Lake County,9,17,1570,736,834
50,6,33,California,Lake County,9,18,1480,604,876
50,6,33,California,Lake County,10,0,64111,31924,32187
50,6,33,California,Lake County,10,1,3758,1865,1893
50,6,33,California,Lake County,10,2,3746,1911,1835
50,6,33,California,Lake County,10,3,3689,1912,1777
50,6,33,California,Lake County,10,4,3404,1752,1652
50,6,33,California,Lake County,10,5,3035,1634,1401
50,6,33,California,Lake County,10,6,3738,1942,1796
50,6,33,California,Lake County,10,7,3541,1814,1727
50,6,33,California,Lake County,10,8,3438,1788,1650
50,6,33,California,Lake County,10,9,3168,1595,1573
50,6,33,California,Lake County,10,10,3579,1677,1902
50,6,33,California,Lake County,10,11,4292,2126,2166
50,6,33,California,Lake County,10,12,5062,2418,2644
50,6,33,California,Lake County,10,13,5366,2527,2839
50,6,33,California,Lake County,10,14,4937,2506,2431
50,6,33,California,Lake County,10,15,3875,1908,1967
50,6,33,California,Lake County,10,16,2443,1208,1235
50,6,33,California,Lake County,10,17,1574,736,838
50,6,33,California,Lake County,10,18,1466,605,861
50,6,33,California,Lake County,11,0,64317,32086,32231
50,6,33,California,Lake County,11,1,3798,1896,1902
50,6,33,California,Lake County,11,2,3768,1925,1843
50,6,33,California,Lake County,11,3,3733,1949,1784
50,6,33,California,Lake County,11,4,3425,1765,1660
50,6,33,California,Lake County,11,5,3010,1628,1382
50,6,33,California,Lake County,11,6,3664,1908,1756
50,6,33,California,Lake County,11,7,3685,1867,1818
50,6,33,California,Lake County,11,8,3497,1804,1693
50,6,33,California,Lake County,11,9,3219,1644,1575
50,6,33,California,Lake County,11,10,3597,1703,1894
50,6,33,California,Lake County,11,11,4080,1994,2086
50,6,33,California,Lake County,11,12,4847,2344,2503
50,6,33,California,Lake County,11,13,5356,2542,2814
50,6,33,California,Lake County,11,14,4940,2449,2491
50,6,33,California,Lake County,11,15,4017,2005,2012
50,6,33,California,Lake County,11,16,2624,1303,1321
50,6,33,California,Lake County,11,17,1584,753,831
50,6,33,California,Lake County,11,18,1473,607,866
50,6,33,California,Lake County,12,0,64386,32194,32192
50,6,33,California,Lake County,12,1,3797,1937,1860
50,6,33,California,Lake County,12,2,3853,1940,1913
50,6,33,California,Lake County,12,3,3800,1971,1829
50,6,33,California,Lake County,12,4,3410,1764,1646
50,6,33,California,Lake County,12,5,3001,1612,1389
50,6,33,California,Lake County,12,6,3579,1860,1719
50,6,33,California,Lake County,12,7,3747,1918,1829
50,6,33,California,Lake County,12,8,3597,1847,1750
50,6,33,California,Lake County,12,9,3287,1691,1596
50,6,33,California,Lake County,12,10,3463,1667,1796
50,6,33,California,Lake County,12,11,3956,1926,2030
50,6,33,California,Lake County,12,12,4758,2303,2455
50,6,33,California,Lake County,12,13,5289,2500,2789
50,6,33,California,Lake County,12,14,4878,2399,2479
50,6,33,California,Lake County,12,15,4208,2150,2058
50,6,33,California,Lake County,12,16,2715,1332,1383
50,6,33,California,Lake County,12,17,1594,750,844
50,6,33,California,Lake County,12,18,1454,627,827
50,6,35,California,Lassen County,1,0,34895,22416,12479
50,6,35,California,Lassen County,1,1,1625,866,759
50,6,35,California,Lassen County,1,2,1595,850,745
50,6,35,California,Lassen County,1,3,1853,933,920
50,6,35,California,Lassen County,1,4,2107,1203,904
50,6,35,California,Lassen County,1,5,2831,2199,632
50,6,35,California,Lassen County,1,6,3343,2635,708
50,6,35,California,Lassen County,1,7,2994,2335,659
50,6,35,California,Lassen County,1,8,2807,2031,776
50,6,35,California,Lassen County,1,9,2706,1933,773
50,6,35,California,Lassen County,1,10,2853,1895,958
50,6,35,California,Lassen County,1,11,2594,1558,1036
50,6,35,California,Lassen County,1,12,2281,1258,1023
50,6,35,California,Lassen County,1,13,1832,1000,832
50,6,35,California,Lassen County,1,14,1190,634,556
50,6,35,California,Lassen County,1,15,794,410,384
50,6,35,California,Lassen County,1,16,584,304,280
50,6,35,California,Lassen County,1,17,457,209,248
50,6,35,California,Lassen County,1,18,449,163,286
50,6,35,California,Lassen County,2,0,34895,22416,12479
50,6,35,California,Lassen County,2,1,1625,866,759
50,6,35,California,Lassen County,2,2,1595,850,745
50,6,35,California,Lassen County,2,3,1853,933,920
50,6,35,California,Lassen County,2,4,2107,1203,904
50,6,35,California,Lassen County,2,5,2831,2199,632
50,6,35,California,Lassen County,2,6,3343,2635,708
50,6,35,California,Lassen County,2,7,2994,2335,659
50,6,35,California,Lassen County,2,8,2807,2031,776
50,6,35,California,Lassen County,2,9,2706,1933,773
50,6,35,California,Lassen County,2,10,2853,1895,958
50,6,35,California,Lassen County,2,11,2594,1558,1036
50,6,35,California,Lassen County,2,12,2281,1258,1023
50,6,35,California,Lassen County,2,13,1832,1000,832
50,6,35,California,Lassen County,2,14,1190,634,556
50,6,35,California,Lassen County,2,15,794,410,384
50,6,35,California,Lassen County,2,16,584,304,280
50,6,35,California,Lassen County,2,17,457,209,248
50,6,35,California,Lassen County,2,18,449,163,286
50,6,35,California,Lassen County,3,0,34831,22405,12426
50,6,35,California,Lassen County,3,1,1617,853,764
50,6,35,California,Lassen County,3,2,1587,848,739
50,6,35,California,Lassen County,3,3,1839,933,906
50,6,35,California,Lassen County,3,4,2072,1181,891
50,6,35,California,Lassen County,3,5,2860,2219,641
50,6,35,California,Lassen County,3,6,3359,2652,707
50,6,35,California,Lassen County,3,7,2994,2328,666
50,6,35,California,Lassen County,3,8,2797,2045,752
50,6,35,California,Lassen County,3,9,2704,1933,771
50,6,35,California,Lassen County,3,10,2824,1875,949
50,6,35,California,Lassen County,3,11,2580,1555,1025
50,6,35,California,Lassen County,3,12,2269,1246,1023
50,6,35,California,Lassen County,3,13,1861,1018,843
50,6,35,California,Lassen County,3,14,1186,630,556
50,6,35,California,Lassen County,3,15,798,411,387
50,6,35,California,Lassen County,3,16,583,304,279
50,6,35,California,Lassen County,3,17,452,210,242
50,6,35,California,Lassen County,3,18,449,164,285
50,6,35,California,Lassen County,4,0,34246,22082,12164
50,6,35,California,Lassen County,4,1,1546,776,770
50,6,35,California,Lassen County,4,2,1527,821,706
50,6,35,California,Lassen County,4,3,1731,889,842
50,6,35,California,Lassen County,4,4,1952,1121,831
50,6,35,California,Lassen County,4,5,2867,2213,654
50,6,35,California,Lassen County,4,6,3369,2664,705
50,6,35,California,Lassen County,4,7,2934,2276,658
50,6,35,California,Lassen County,4,8,2742,2051,691
50,6,35,California,Lassen County,4,9,2640,1894,746
50,6,35,California,Lassen County,4,10,2719,1813,906
50,6,35,California,Lassen County,4,11,2534,1553,981
50,6,35,California,Lassen County,4,12,2213,1201,1012
50,6,35,California,Lassen County,4,13,1936,1067,869
50,6,35,California,Lassen County,4,14,1207,631,576
50,6,35,California,Lassen County,4,15,809,411,398
50,6,35,California,Lassen County,4,16,585,303,282
50,6,35,California,Lassen County,4,17,474,223,251
50,6,35,California,Lassen County,4,18,461,175,286
50,6,35,California,Lassen County,5,0,33629,21664,11965
50,6,35,California,Lassen County,5,1,1550,771,779
50,6,35,California,Lassen County,5,2,1526,809,717
50,6,35,California,Lassen County,5,3,1625,858,767
50,6,35,California,Lassen County,5,4,1916,1074,842
50,6,35,California,Lassen County,5,5,2792,2153,639
50,6,35,California,Lassen County,5,6,3295,2610,685
50,6,35,California,Lassen County,5,7,2912,2252,660
50,6,35,California,Lassen County,5,8,2632,1997,635
50,6,35,California,Lassen County,5,9,2594,1827,767
50,6,35,California,Lassen County,5,10,2629,1764,865
50,6,35,California,Lassen County,5,11,2448,1529,919
50,6,35,California,Lassen County,5,12,2178,1160,1018
50,6,35,California,Lassen County,5,13,1878,1053,825
50,6,35,California,Lassen County,5,14,1317,693,624
50,6,35,California,Lassen County,5,15,853,433,420
50,6,35,California,Lassen County,5,16,563,286,277
50,6,35,California,Lassen County,5,17,466,216,250
50,6,35,California,Lassen County,5,18,455,179,276
50,6,35,California,Lassen County,6,0,32129,20368,11761
50,6,35,California,Lassen County,6,1,1498,735,763
50,6,35,California,Lassen County,6,2,1490,781,709
50,6,35,California,Lassen County,6,3,1581,831,750
50,6,35,California,Lassen County,6,4,1881,1058,823
50,6,35,California,Lassen County,6,5,2587,1956,631
50,6,35,California,Lassen County,6,6,3012,2370,642
50,6,35,California,Lassen County,6,7,2759,2088,671
50,6,35,California,Lassen County,6,8,2441,1827,614
50,6,35,California,Lassen County,6,9,2397,1666,731
50,6,35,California,Lassen County,6,10,2381,1596,785
50,6,35,California,Lassen County,6,11,2318,1422,896
50,6,35,California,Lassen County,6,12,2107,1130,977
50,6,35,California,Lassen County,6,13,1838,1016,822
50,6,35,California,Lassen County,6,14,1416,728,688
50,6,35,California,Lassen County,6,15,904,452,452
50,6,35,California,Lassen County,6,16,577,298,279
50,6,35,California,Lassen County,6,17,467,223,244
50,6,35,California,Lassen County,6,18,475,191,284
50,6,35,California,Lassen County,7,0,31664,20183,11481
50,6,35,California,Lassen County,7,1,1421,695,726
50,6,35,California,Lassen County,7,2,1436,738,698
50,6,35,California,Lassen County,7,3,1477,782,695
50,6,35,California,Lassen County,7,4,1789,994,795
50,6,35,California,Lassen County,7,5,2585,1966,619
50,6,35,California,Lassen County,7,6,2996,2378,618
50,6,35,California,Lassen County,7,7,2783,2118,665
50,6,35,California,Lassen County,7,8,2374,1791,583
50,6,35,California,Lassen County,7,9,2349,1645,704
50,6,35,California,Lassen County,7,10,2293,1575,718
50,6,35,California,Lassen County,7,11,2275,1396,879
50,6,35,California,Lassen County,7,12,2031,1129,902
50,6,35,California,Lassen County,7,13,1884,1024,860
50,6,35,California,Lassen County,7,14,1481,755,726
50,6,35,California,Lassen County,7,15,944,488,456
50,6,35,California,Lassen County,7,16,611,291,320
50,6,35,California,Lassen County,7,17,448,222,226
50,6,35,California,Lassen County,7,18,487,196,291
50,6,35,California,Lassen County,8,0,31256,19743,11513
50,6,35,California,Lassen County,8,1,1449,705,744
50,6,35,California,Lassen County,8,2,1427,757,670
50,6,35,California,Lassen County,8,3,1440,744,696
50,6,35,California,Lassen County,8,4,1728,948,780
50,6,35,California,Lassen County,8,5,2568,1924,644
50,6,35,California,Lassen County,8,6,3006,2336,670
50,6,35,California,Lassen County,8,7,2712,2052,660
50,6,35,California,Lassen County,8,8,2336,1730,606
50,6,35,California,Lassen County,8,9,2253,1580,673
50,6,35,California,Lassen County,8,10,2195,1511,684
50,6,35,California,Lassen County,8,11,2153,1319,834
50,6,35,California,Lassen County,8,12,1997,1099,898
50,6,35,California,Lassen County,8,13,1913,1015,898
50,6,35,California,Lassen County,8,14,1527,794,733
50,6,35,California,Lassen County,8,15,1001,511,490
50,6,35,California,Lassen County,8,16,626,300,326
50,6,35,California,Lassen County,8,17,436,220,216
50,6,35,California,Lassen County,8,18,489,198,291
50,6,35,California,Lassen County,9,0,30721,19142,11579
50,6,35,California,Lassen County,9,1,1503,750,753
50,6,35,California,Lassen County,9,2,1437,717,720
50,6,35,California,Lassen County,9,3,1432,758,674
50,6,35,California,Lassen County,9,4,1678,942,736
50,6,35,California,Lassen County,9,5,2467,1815,652
50,6,35,California,Lassen County,9,6,2949,2242,707
50,6,35,California,Lassen County,9,7,2638,1964,674
50,6,35,California,Lassen County,9,8,2266,1635,631
50,6,35,California,Lassen County,9,9,2149,1516,633
50,6,35,California,Lassen County,9,10,2121,1429,692
50,6,35,California,Lassen County,9,11,2090,1266,824
50,6,35,California,Lassen County,9,12,1961,1090,871
50,6,35,California,Lassen County,9,13,1852,941,911
50,6,35,California,Lassen County,9,14,1577,833,744
50,6,35,California,Lassen County,9,15,1025,518,507
50,6,35,California,Lassen County,9,16,648,310,338
50,6,35,California,Lassen County,9,17,431,215,216
50,6,35,California,Lassen County,9,18,497,201,296
50,6,35,California,Lassen County,10,0,30920,19377,11543
50,6,35,California,Lassen County,10,1,1553,820,733
50,6,35,California,Lassen County,10,2,1447,699,748
50,6,35,California,Lassen County,10,3,1473,784,689
50,6,35,California,Lassen County,10,4,1537,875,662
50,6,35,California,Lassen County,10,5,2447,1821,626
50,6,35,California,Lassen County,10,6,3040,2322,718
50,6,35,California,Lassen County,10,7,2677,1986,691
50,6,35,California,Lassen County,10,8,2351,1702,649
50,6,35,California,Lassen County,10,9,2143,1540,603
50,6,35,California,Lassen County,10,10,2108,1412,696
50,6,35,California,Lassen County,10,11,2008,1218,790
50,6,35,California,Lassen County,10,12,1949,1108,841
50,6,35,California,Lassen County,10,13,1837,922,915
50,6,35,California,Lassen County,10,14,1566,841,725
50,6,35,California,Lassen County,10,15,1152,572,580
50,6,35,California,Lassen County,10,16,687,328,359
50,6,35,California,Lassen County,10,17,448,221,227
50,6,35,California,Lassen County,10,18,497,206,291
50,6,35,California,Lassen County,11,0,30618,19086,11532
50,6,35,California,Lassen County,11,1,1538,813,725
50,6,35,California,Lassen County,11,2,1462,704,758
50,6,35,California,Lassen County,11,3,1443,759,684
50,6,35,California,Lassen County,11,4,1511,865,646
50,6,35,California,Lassen County,11,5,2352,1756,596
50,6,35,California,Lassen County,11,6,2982,2260,722
50,6,35,California,Lassen County,11,7,2700,2006,694
50,6,35,California,Lassen County,11,8,2356,1673,683
50,6,35,California,Lassen County,11,9,2130,1521,609
50,6,35,California,Lassen County,11,10,2042,1355,687
50,6,35,California,Lassen County,11,11,1873,1149,724
50,6,35,California,Lassen County,11,12,1836,1032,804
50,6,35,California,Lassen County,11,13,1831,922,909
50,6,35,California,Lassen County,11,14,1619,869,750
50,6,35,California,Lassen County,11,15,1237,612,625
50,6,35,California,Lassen County,11,16,719,340,379
50,6,35,California,Lassen County,11,17,448,224,224
50,6,35,California,Lassen County,11,18,539,226,313
50,6,35,California,Lassen County,12,0,30573,19026,11547
50,6,35,California,Lassen County,12,1,1469,776,693
50,6,35,California,Lassen County,12,2,1505,753,752
50,6,35,California,Lassen County,12,3,1462,750,712
50,6,35,California,Lassen County,12,4,1460,841,619
50,6,35,California,Lassen County,12,5,2315,1733,582
50,6,35,California,Lassen County,12,6,2958,2248,710
50,6,35,California,Lassen County,12,7,2737,2027,710
50,6,35,California,Lassen County,12,8,2381,1688,693
50,6,35,California,Lassen County,12,9,2114,1507,607
50,6,35,California,Lassen County,12,10,2014,1332,682
50,6,35,California,Lassen County,12,11,1832,1146,686
50,6,35,California,Lassen County,12,12,1806,995,811
50,6,35,California,Lassen County,12,13,1782,905,877
50,6,35,California,Lassen County,12,14,1662,865,797
50,6,35,California,Lassen County,12,15,1300,633,667
50,6,35,California,Lassen County,12,16,759,370,389
50,6,35,California,Lassen County,12,17,469,226,243
50,6,35,California,Lassen County,12,18,548,231,317
50,6,37,California,Los Angeles County,1,0,9818605,4839654,4978951
50,6,37,California,Los Angeles County,1,1,645793,330265,315528
50,6,37,California,Los Angeles County,1,2,633690,323676,310014
50,6,37,California,Los Angeles County,1,3,678845,347102,331743
50,6,37,California,Los Angeles County,1,4,753630,385012,368618
50,6,37,California,Los Angeles County,1,5,752788,385393,367395
50,6,37,California,Los Angeles County,1,6,759602,386393,373209
50,6,37,California,Los Angeles County,1,7,716129,360263,355866
50,6,37,California,Los Angeles County,1,8,715635,356358,359277
50,6,37,California,Los Angeles County,1,9,714691,357282,357409
50,6,37,California,Los Angeles County,1,10,706742,349671,357071
50,6,37,California,Los Angeles County,1,11,662205,323330,338875
50,6,37,California,Los Angeles County,1,12,560920,269289,291631
50,6,37,California,Los Angeles County,1,13,452236,212254,239982
50,6,37,California,Los Angeles County,1,14,323287,148148,175139
50,6,37,California,Los Angeles County,1,15,245183,109338,135845
50,6,37,California,Los Angeles County,1,16,192881,82327,110554
50,6,37,California,Los Angeles County,1,17,152722,60853,91869
50,6,37,California,Los Angeles County,1,18,151626,52700,98926
50,6,37,California,Los Angeles County,2,0,9819968,4840321,4979647
50,6,37,California,Los Angeles County,2,1,645920,330310,315610
50,6,37,California,Los Angeles County,2,2,633820,323736,310084
50,6,37,California,Los Angeles County,2,3,678969,347160,331809
50,6,37,California,Los Angeles County,2,4,753755,385088,368667
50,6,37,California,Los Angeles County,2,5,752889,385448,367441
50,6,37,California,Los Angeles County,2,6,759741,386461,373280
50,6,37,California,Los Angeles County,2,7,716250,360326,355924
50,6,37,California,Los Angeles County,2,8,715751,356416,359335
50,6,37,California,Los Angeles County,2,9,714794,357334,357460
50,6,37,California,Los Angeles County,2,10,706814,349708,357106
50,6,37,California,Los Angeles County,2,11,662273,323365,338908
50,6,37,California,Los Angeles County,2,12,560956,269308,291648
50,6,37,California,Los Angeles County,2,13,452276,212274,240002
50,6,37,California,Los Angeles County,2,14,323309,148157,175152
50,6,37,California,Los Angeles County,2,15,245197,109346,135851
50,6,37,California,Los Angeles County,2,16,192888,82326,110562
50,6,37,California,Los Angeles County,2,17,152733,60857,91876
50,6,37,California,Los Angeles County,2,18,151633,52701,98932
50,6,37,California,Los Angeles County,3,0,9823246,4840919,4982327
50,6,37,California,Los Angeles County,3,1,644801,329774,315027
50,6,37,California,Los Angeles County,3,2,631554,322503,309051
50,6,37,California,Los Angeles County,3,3,674628,344732,329896
50,6,37,California,Los Angeles County,3,4,748648,382458,366190
50,6,37,California,Los Angeles County,3,5,756079,386579,369500
50,6,37,California,Los Angeles County,3,6,759975,386558,373417
50,6,37,California,Los Angeles County,3,7,717479,361120,356359
50,6,37,California,Los Angeles County,3,8,711882,354313,357569
50,6,37,California,Los Angeles County,3,9,715134,357345,357789
50,6,37,California,Los Angeles County,3,10,705469,349127,356342
50,6,37,California,Los Angeles County,3,11,664092,324483,339609
50,6,37,California,Los Angeles County,3,12,564877,271262,293615
50,6,37,California,Los Angeles County,3,13,456654,214323,242331
50,6,37,California,Los Angeles County,3,14,326057,149455,176602
50,6,37,California,Los Angeles County,3,15,246535,110009,136526
50,6,37,California,Los Angeles County,3,16,192949,82385,110564
50,6,37,California,Los Angeles County,3,17,153131,61174,91957
50,6,37,California,Los Angeles County,3,18,153302,53319,99983
50,6,37,California,Los Angeles County,4,0,9876482,4864731,5011751
50,6,37,California,Los Angeles County,4,1,646167,330598,315569
50,6,37,California,Los Angeles County,4,2,627771,320713,307058
50,6,37,California,Los Angeles County,4,3,660650,337281,323369
50,6,37,California,Los Angeles County,4,4,729509,372456,357053
50,6,37,California,Los Angeles County,4,5,772783,393272,379511
50,6,37,California,Los Angeles County,4,6,767948,391176,376772
50,6,37,California,Los Angeles County,4,7,725823,366071,359752
50,6,37,California,Los Angeles County,4,8,697012,346340,350672
50,6,37,California,Los Angeles County,4,9,720798,359464,361334
50,6,37,California,Los Angeles County,4,10,700507,346915,353592
50,6,37,California,Los Angeles County,4,11,670761,328515,342246
50,6,37,California,Los Angeles County,4,12,581489,279347,302142
50,6,37,California,Los Angeles County,4,13,477242,224163,253079
50,6,37,California,Los Angeles County,4,14,337228,154681,182547
50,6,37,California,Los Angeles County,4,15,252386,112624,139762
50,6,37,California,Los Angeles County,4,16,195479,83683,111796
50,6,37,California,Los Angeles County,4,17,153889,61962,91927
50,6,37,California,Los Angeles County,4,18,159040,55470,103570
50,6,37,California,Los Angeles County,5,0,9935375,4893409,5041966
50,6,37,California,Los Angeles County,5,1,641721,328125,313596
50,6,37,California,Los Angeles County,5,2,630323,322245,308078
50,6,37,California,Los Angeles County,5,3,647098,330332,316766
50,6,37,California,Los Angeles County,5,4,711916,362917,348999
50,6,37,California,Los Angeles County,5,5,783007,397325,385682
50,6,37,California,Los Angeles County,5,6,776533,396397,380136
50,6,37,California,Los Angeles County,5,7,736230,371901,364329
50,6,37,California,Los Angeles County,5,8,692089,344173,347916
50,6,37,California,Los Angeles County,5,9,722144,359564,362580
50,6,37,California,Los Angeles County,5,10,695991,344873,351118
50,6,37,California,Los Angeles County,5,11,675576,331576,344000
50,6,37,California,Los Angeles County,5,12,598665,288012,310653
50,6,37,California,Los Angeles County,5,13,483989,227306,256683
50,6,37,California,Los Angeles County,5,14,361709,166527,195182
50,6,37,California,Los Angeles County,5,15,260681,116458,144223
50,6,37,California,Los Angeles County,5,16,199043,85292,113751
50,6,37,California,Los Angeles County,5,17,154177,62573,91604
50,6,37,California,Los Angeles County,5,18,164483,57813,106670
50,6,37,California,Los Angeles County,6,0,9992484,4922493,5069991
50,6,37,California,Los Angeles County,6,1,638482,326455,312027
50,6,37,California,Los Angeles County,6,2,631978,323040,308938
50,6,37,California,Los Angeles County,6,3,635942,324439,311503
50,6,37,California,Los Angeles County,6,4,696840,354804,342036
50,6,37,California,Los Angeles County,6,5,781929,396583,385346
50,6,37,California,Los Angeles County,6,6,791568,404331,387237
50,6,37,California,Los Angeles County,6,7,747685,378667,369018
50,6,37,California,Los Angeles County,6,8,691200,344709,346491
50,6,37,California,Los Angeles County,6,9,716228,355808,360420
50,6,37,California,Los Angeles County,6,10,691945,343822,348123
50,6,37,California,Los Angeles County,6,11,681177,334796,346381
50,6,37,California,Los Angeles County,6,12,613518,295568,317950
50,6,37,California,Los Angeles County,6,13,495715,233171,262544
50,6,37,California,Los Angeles County,6,14,378776,174742,204034
50,6,37,California,Los Angeles County,6,15,271972,121398,150574
50,6,37,California,Los Angeles County,6,16,203966,87644,116322
50,6,37,California,Los Angeles County,6,17,154748,62960,91788
50,6,37,California,Los Angeles County,6,18,168815,59556,109259
50,6,37,California,Los Angeles County,7,0,10040072,4946445,5093627
50,6,37,California,Los Angeles County,7,1,638880,327066,311814
50,6,37,California,Los Angeles County,7,2,627994,321398,306596
50,6,37,California,Los Angeles County,7,3,628165,320350,307815
50,6,37,California,Los Angeles County,7,4,680381,345995,334386
50,6,37,California,Los Angeles County,7,5,775500,392525,382975
50,6,37,California,Los Angeles County,7,6,810659,414126,396533
50,6,37,California,Los Angeles County,7,7,754500,382856,371644
50,6,37,California,Los Angeles County,7,8,691705,345875,345830
50,6,37,California,Los Angeles County,7,9,705326,349806,355520
50,6,37,California,Los Angeles County,7,10,688780,342584,346196
50,6,37,California,Los Angeles County,7,11,685731,337411,348320
50,6,37,California,Los Angeles County,7,12,623868,301292,322576
50,6,37,California,Los Angeles County,7,13,510591,241178,269413
50,6,37,California,Los Angeles County,7,14,396598,182716,213882
50,6,37,California,Los Angeles County,7,15,281966,125635,156331
50,6,37,California,Los Angeles County,7,16,209585,90306,119279
50,6,37,California,Los Angeles County,7,17,155766,63554,92212
50,6,37,California,Los Angeles County,7,18,174077,61772,112305
50,6,37,California,Los Angeles County,8,0,10085416,4969812,5115604
50,6,37,California,Los Angeles County,8,1,637461,326660,310801
50,6,37,California,Los Angeles County,8,2,623405,319114,304291
50,6,37,California,Los Angeles County,8,3,619698,316135,303563
50,6,37,California,Los Angeles County,8,4,668909,340102,328807
50,6,37,California,Los Angeles County,8,5,758917,383828,375089
50,6,37,California,Los Angeles County,8,6,831553,424525,407028
50,6,37,California,Los Angeles County,8,7,758852,385198,373654
50,6,37,California,Los Angeles County,8,8,697722,350284,347438
50,6,37,California,Los Angeles County,8,9,691147,342496,348651
50,6,37,California,Los Angeles County,8,10,693937,345342,348595
50,6,37,California,Los Angeles County,8,11,682409,335943,346466
50,6,37,California,Los Angeles County,8,12,634353,307264,327089
50,6,37,California,Los Angeles County,8,13,527283,250039,277244
50,6,37,California,Los Angeles County,8,14,415090,191080,224010
50,6,37,California,Los Angeles County,8,15,292950,130709,162241
50,6,37,California,Los Angeles County,8,16,214871,92739,122132
50,6,37,California,Los Angeles County,8,17,156998,64135,92863
50,6,37,California,Los Angeles County,8,18,179861,64219,115642
50,6,37,California,Los Angeles County,9,0,10105708,4980373,5125335
50,6,37,California,Los Angeles County,9,1,627145,321516,305629
50,6,37,California,Los Angeles County,9,2,621301,318047,303254
50,6,37,California,Los Angeles County,9,3,613279,312950,300329
50,6,37,California,Los Angeles County,9,4,655023,332995,322028
50,6,37,California,Los Angeles County,9,5,736990,372273,364717
50,6,37,California,Los Angeles County,9,6,851085,433564,417521
50,6,37,California,Los Angeles County,9,7,766878,391007,375871
50,6,37,California,Los Angeles County,9,8,705295,354921,350374
50,6,37,California,Los Angeles County,9,9,675965,334814,341151
50,6,37,California,Los Angeles County,9,10,697764,346798,350966
50,6,37,California,Los Angeles County,9,11,676220,333585,342635
50,6,37,California,Los Angeles County,9,12,639703,310666,329037
50,6,37,California,Los Angeles County,9,13,541460,257127,284333
50,6,37,California,Los Angeles County,9,14,432934,199367,233567
50,6,37,California,Los Angeles County,9,15,302193,134940,167253
50,6,37,California,Los Angeles County,9,16,219542,94856,124686
50,6,37,California,Los Angeles County,9,17,159107,65086,94021
50,6,37,California,Los Angeles County,9,18,183824,65861,117963
50,6,37,California,Los Angeles County,10,0,10103711,4980981,5122730
50,6,37,California,Los Angeles County,10,1,615983,316106,299877
50,6,37,California,Los Angeles County,10,2,612890,313528,299362
50,6,37,California,Los Angeles County,10,3,612035,312978,299057
50,6,37,California,Los Angeles County,10,4,640239,325478,314761
50,6,37,California,Los Angeles County,10,5,716672,361349,355323
50,6,37,California,Los Angeles County,10,6,859329,437380,421949
50,6,37,California,Los Angeles County,10,7,773045,395708,377337
50,6,37,California,Los Angeles County,10,8,711409,359070,352339
50,6,37,California,Los Angeles County,10,9,667491,330711,336780
50,6,37,California,Los Angeles County,10,10,694703,344881,349822
50,6,37,California,Los Angeles County,10,11,668075,329887,338188
50,6,37,California,Los Angeles County,10,12,641305,312334,328971
50,6,37,California,Los Angeles County,10,13,555344,264143,291201
50,6,37,California,Los Angeles County,10,14,437355,201572,235783
50,6,37,California,Los Angeles County,10,15,322761,144649,178112
50,6,37,California,Los Angeles County,10,16,225941,97609,128332
50,6,37,California,Los Angeles County,10,17,161980,66334,95646
50,6,37,California,Los Angeles County,10,18,187154,67264,119890
50,6,37,California,Los Angeles County,11,0,10073906,4966715,5107191
50,6,37,California,Los Angeles County,11,1,596912,306454,290458
50,6,37,California,Los Angeles County,11,2,604590,309371,295219
50,6,37,California,Los Angeles County,11,3,609526,311873,297653
50,6,37,California,Los Angeles County,11,4,627409,318710,308699
50,6,37,California,Los Angeles County,11,5,697484,351044,346440
50,6,37,California,Los Angeles County,11,6,854436,434797,419639
50,6,37,California,Los Angeles County,11,7,782375,400741,381634
50,6,37,California,Los Angeles County,11,8,716164,362272,353892
50,6,37,California,Los Angeles County,11,9,660556,328343,332213
50,6,37,California,Los Angeles County,11,10,684114,338805,345309
50,6,37,California,Los Angeles County,11,11,659077,326141,332936
50,6,37,California,Los Angeles County,11,12,642322,313550,328772
50,6,37,California,Los Angeles County,11,13,565342,269102,296240
50,6,37,California,Los Angeles County,11,14,445968,206164,239804
50,6,37,California,Los Angeles County,11,15,336614,151198,185416
50,6,37,California,Los Angeles County,11,16,235066,101525,133541
50,6,37,California,Los Angeles County,11,17,165502,67958,97544
50,6,37,California,Los Angeles County,11,18,190449,68667,121782
50,6,37,California,Los Angeles County,12,0,10039107,4949041,5090066
50,6,37,California,Los Angeles County,12,1,579856,296988,282868
50,6,37,California,Los Angeles County,12,2,600191,307401,292790
50,6,37,California,Los Angeles County,12,3,601542,308064,293478
50,6,37,California,Los Angeles County,12,4,617516,313585,303931
50,6,37,California,Los Angeles County,12,5,678389,341107,337282
50,6,37,California,Los Angeles County,12,6,842380,427975,414405
50,6,37,California,Los Angeles County,12,7,796305,408037,388268
50,6,37,California,Los Angeles County,12,8,718185,364089,354096
50,6,37,California,Los Angeles County,12,9,655154,326660,328494
50,6,37,California,Los Angeles County,12,10,669764,331019,338745
50,6,37,California,Los Angeles County,12,11,652018,322893,329125
50,6,37,California,Los Angeles County,12,12,642586,313997,328589
50,6,37,California,Los Angeles County,12,13,571468,272701,298767
50,6,37,California,Los Angeles County,12,14,457396,212397,244999
50,6,37,California,Los Angeles County,12,15,350926,157619,193307
50,6,37,California,Los Angeles County,12,16,242783,104751,138032
50,6,37,California,Los Angeles County,12,17,169561,69870,99691
50,6,37,California,Los Angeles County,12,18,193087,69888,123199
50,6,39,California,Madera County,1,0,150865,72682,78183
50,6,39,California,Madera County,1,1,11983,6052,5931
50,6,39,California,Madera County,1,2,11756,5899,5857
50,6,39,California,Madera County,1,3,11755,6093,5662
50,6,39,California,Madera County,1,4,12224,6515,5709
50,6,39,California,Madera County,1,5,11032,5547,5485
50,6,39,California,Madera County,1,6,10541,4846,5695
50,6,39,California,Madera County,1,7,10021,4524,5497
50,6,39,California,Madera County,1,8,9661,4368,5293
50,6,39,California,Madera County,1,9,9506,4325,5181
50,6,39,California,Madera County,1,10,9893,4473,5420
50,6,39,California,Madera County,1,11,9398,4378,5020
50,6,39,California,Madera County,1,12,8467,3996,4471
50,6,39,California,Madera County,1,13,7366,3598,3768
50,6,39,California,Madera County,1,14,5642,2714,2928
50,6,39,California,Madera County,1,15,4226,2049,2177
50,6,39,California,Madera County,1,16,3240,1557,1683
50,6,39,California,Madera County,1,17,2228,988,1240
50,6,39,California,Madera County,1,18,1926,760,1166
50,6,39,California,Madera County,2,0,150834,72665,78169
50,6,39,California,Madera County,2,1,11977,6050,5927
50,6,39,California,Madera County,2,2,11755,5898,5857
50,6,39,California,Madera County,2,3,11753,6092,5661
50,6,39,California,Madera County,2,4,12220,6512,5708
50,6,39,California,Madera County,2,5,11024,5542,5482
50,6,39,California,Madera County,2,6,10538,4845,5693
50,6,39,California,Madera County,2,7,10019,4523,5496
50,6,39,California,Madera County,2,8,9661,4368,5293
50,6,39,California,Madera County,2,9,9505,4325,5180
50,6,39,California,Madera County,2,10,9893,4473,5420
50,6,39,California,Madera County,2,11,9397,4377,5020
50,6,39,California,Madera County,2,12,8466,3995,4471
50,6,39,California,Madera County,2,13,7366,3598,3768
50,6,39,California,Madera County,2,14,5642,2714,2928
50,6,39,California,Madera County,2,15,4226,2049,2177
50,6,39,California,Madera County,2,16,3238,1556,1682
50,6,39,California,Madera County,2,17,2228,988,1240
50,6,39,California,Madera County,2,18,1926,760,1166
50,6,39,California,Madera County,3,0,150986,72765,78221
50,6,39,California,Madera County,3,1,11978,6041,5937
50,6,39,California,Madera County,3,2,11800,5920,5880
50,6,39,California,Madera County,3,3,11746,6092,5654
50,6,39,California,Madera County,3,4,12136,6440,5696
50,6,39,California,Madera County,3,5,11093,5571,5522
50,6,39,California,Madera County,3,6,10551,4873,5678
50,6,39,California,Madera County,3,7,10045,4545,5500
50,6,39,California,Madera County,3,8,9632,4375,5257
50,6,39,California,Madera County,3,9,9491,4315,5176
50,6,39,California,Madera County,3,10,9853,4464,5389
50,6,39,California,Madera County,3,11,9408,4377,5031
50,6,39,California,Madera County,3,12,8489,4014,4475
50,6,39,California,Madera County,3,13,7456,3649,3807
50,6,39,California,Madera County,3,14,5640,2715,2925
50,6,39,California,Madera County,3,15,4268,2067,2201
50,6,39,California,Madera County,3,16,3224,1548,1676
50,6,39,California,Madera County,3,17,2234,994,1240
50,6,39,California,Madera County,3,18,1942,765,1177
50,6,39,California,Madera County,4,0,151675,73116,78559
50,6,39,California,Madera County,4,1,11943,6038,5905
50,6,39,California,Madera County,4,2,11859,5961,5898
50,6,39,California,Madera County,4,3,11751,6080,5671
50,6,39,California,Madera County,4,4,11819,6183,5636
50,6,39,California,Madera County,4,5,11346,5726,5620
50,6,39,California,Madera County,4,6,10661,4965,5696
50,6,39,California,Madera County,4,7,10165,4607,5558
50,6,39,California,Madera County,4,8,9448,4292,5156
50,6,39,California,Madera County,4,9,9514,4328,5186
50,6,39,California,Madera County,4,10,9663,4379,5284
50,6,39,California,Madera County,4,11,9435,4402,5033
50,6,39,California,Madera County,4,12,8572,4062,4510
50,6,39,California,Madera County,4,13,7830,3820,4010
50,6,39,California,Madera County,4,14,5756,2774,2982
50,6,39,California,Madera County,4,15,4435,2142,2293
50,6,39,California,Madera County,4,16,3224,1551,1673
50,6,39,California,Madera County,4,17,2294,1032,1262
50,6,39,California,Madera County,4,18,1960,774,1186
50,6,39,California,Madera County,5,0,151527,73482,78045
50,6,39,California,Madera County,5,1,11981,6053,5928
50,6,39,California,Madera County,5,2,11975,6023,5952
50,6,39,California,Madera County,5,3,11679,6020,5659
50,6,39,California,Madera County,5,4,11578,6054,5524
50,6,39,California,Madera County,5,5,11339,5723,5616
50,6,39,California,Madera County,5,6,10577,4992,5585
50,6,39,California,Madera County,5,7,10203,4714,5489
50,6,39,California,Madera County,5,8,9290,4264,5026
50,6,39,California,Madera County,5,9,9377,4334,5043
50,6,39,California,Madera County,5,10,9370,4310,5060
50,6,39,California,Madera County,5,11,9309,4377,4932
50,6,39,California,Madera County,5,12,8647,4132,4515
50,6,39,California,Madera County,5,13,7783,3788,3995
50,6,39,California,Madera County,5,14,6207,3029,3178
50,6,39,California,Madera County,5,15,4595,2239,2356
50,6,39,California,Madera County,5,16,3235,1544,1691
50,6,39,California,Madera County,5,17,2375,1085,1290
50,6,39,California,Madera County,5,18,2007,801,1206
50,6,39,California,Madera County,6,0,151370,73544,77826
50,6,39,California,Madera County,6,1,11788,5970,5818
50,6,39,California,Madera County,6,2,12159,6090,6069
50,6,39,California,Madera County,6,3,11575,5935,5640
50,6,39,California,Madera County,6,4,11397,5894,5503
50,6,39,California,Madera County,6,5,11333,5691,5642
50,6,39,California,Madera County,6,6,10366,4983,5383
50,6,39,California,Madera County,6,7,10257,4756,5501
50,6,39,California,Madera County,6,8,9317,4298,5019
50,6,39,California,Madera County,6,9,9338,4382,4956
50,6,39,California,Madera County,6,10,9125,4262,4863
50,6,39,California,Madera County,6,11,9249,4330,4919
50,6,39,California,Madera County,6,12,8632,4154,4478
50,6,39,California,Madera County,6,13,7954,3846,4108
50,6,39,California,Madera County,6,14,6389,3101,3288
50,6,39,California,Madera County,6,15,4746,2325,2421
50,6,39,California,Madera County,6,16,3304,1580,1724
50,6,39,California,Madera County,6,17,2345,1115,1230
50,6,39,California,Madera County,6,18,2096,832,1264
50,6,39,California,Madera County,7,0,153456,73844,79612
50,6,39,California,Madera County,7,1,11807,6031,5776
50,6,39,California,Madera County,7,2,12245,6150,6095
50,6,39,California,Madera County,7,3,11588,5875,5713
50,6,39,California,Madera County,7,4,11242,5799,5443
50,6,39,California,Madera County,7,5,11499,5680,5819
50,6,39,California,Madera County,7,6,10680,4983,5697
50,6,39,California,Madera County,7,7,10469,4787,5682
50,6,39,California,Madera County,7,8,9638,4389,5249
50,6,39,California,Madera County,7,9,9515,4326,5189
50,6,39,California,Madera County,7,10,9137,4229,4908
50,6,39,California,Madera County,7,11,9319,4286,5033
50,6,39,California,Madera County,7,12,8723,4186,4537
50,6,39,California,Madera County,7,13,8093,3906,4187
50,6,39,California,Madera County,7,14,6714,3256,3458
50,6,39,California,Madera County,7,15,4872,2334,2538
50,6,39,California,Madera County,7,16,3400,1639,1761
50,6,39,California,Madera County,7,17,2351,1109,1242
50,6,39,California,Madera County,7,18,2164,879,1285
50,6,39,California,Madera County,8,0,153576,74036,79540
50,6,39,California,Madera County,8,1,11824,6010,5814
50,6,39,California,Madera County,8,2,12146,6122,6024
50,6,39,California,Madera County,8,3,11642,5858,5784
50,6,39,California,Madera County,8,4,11084,5772,5312
50,6,39,California,Madera County,8,5,11239,5500,5739
50,6,39,California,Madera County,8,6,10841,5118,5723
50,6,39,California,Madera County,8,7,10376,4816,5560
50,6,39,California,Madera County,8,8,9774,4448,5326
50,6,39,California,Madera County,8,9,9335,4245,5090
50,6,39,California,Madera County,8,10,9077,4189,4888
50,6,39,California,Madera County,8,11,9119,4251,4868
50,6,39,California,Madera County,8,12,8870,4250,4620
50,6,39,California,Madera County,8,13,8141,3932,4209
50,6,39,California,Madera County,8,14,7058,3436,3622
50,6,39,California,Madera County,8,15,5024,2434,2590
50,6,39,California,Madera County,8,16,3503,1683,1820
50,6,39,California,Madera County,8,17,2333,1085,1248
50,6,39,California,Madera County,8,18,2190,887,1303
50,6,39,California,Madera County,9,0,153956,74383,79573
50,6,39,California,Madera County,9,1,11679,5899,5780
50,6,39,California,Madera County,9,2,12204,6183,6021
50,6,39,California,Madera County,9,3,11744,5903,5841
50,6,39,California,Madera County,9,4,11106,5785,5321
50,6,39,California,Madera County,9,5,10907,5308,5599
50,6,39,California,Madera County,9,6,11005,5283,5722
50,6,39,California,Madera County,9,7,10336,4855,5481
50,6,39,California,Madera County,9,8,9863,4485,5378
50,6,39,California,Madera County,9,9,9157,4166,4991
50,6,39,California,Madera County,9,10,9168,4260,4908
50,6,39,California,Madera County,9,11,8984,4253,4731
50,6,39,California,Madera County,9,12,8909,4239,4670
50,6,39,California,Madera County,9,13,8172,3956,4216
50,6,39,California,Madera County,9,14,7353,3565,3788
50,6,39,California,Madera County,9,15,5135,2504,2631
50,6,39,California,Madera County,9,16,3669,1746,1923
50,6,39,California,Madera County,9,17,2325,1064,1261
50,6,39,California,Madera County,9,18,2240,929,1311
50,6,39,California,Madera County,10,0,155423,74914,80509
50,6,39,California,Madera County,10,1,11661,5909,5752
50,6,39,California,Madera County,10,2,12227,6180,6047
50,6,39,California,Madera County,10,3,11994,6034,5960
50,6,39,California,Madera County,10,4,11066,5751,5315
50,6,39,California,Madera County,10,5,10779,5195,5584
50,6,39,California,Madera County,10,6,11366,5430,5936
50,6,39,California,Madera County,10,7,10414,4854,5560
50,6,39,California,Madera County,10,8,10118,4600,5518
50,6,39,California,Madera County,10,9,9186,4186,5000
50,6,39,California,Madera County,10,10,9204,4217,4987
50,6,39,California,Madera County,10,11,8846,4201,4645
50,6,39,California,Madera County,10,12,8903,4250,4653
50,6,39,California,Madera County,10,13,8392,4047,4345
50,6,39,California,Madera County,10,14,7299,3549,3750
50,6,39,California,Madera County,10,15,5544,2692,2852
50,6,39,California,Madera County,10,16,3772,1807,1965
50,6,39,California,Madera County,10,17,2312,1040,1272
50,6,39,California,Madera County,10,18,2340,972,1368
50,6,39,California,Madera County,11,0,156882,75596,81286
50,6,39,California,Madera County,11,1,11589,5885,5704
50,6,39,California,Madera County,11,2,12236,6255,5981
50,6,39,California,Madera County,11,3,12305,6166,6139
50,6,39,California,Madera County,11,4,11078,5719,5359
50,6,39,California,Madera County,11,5,10716,5154,5562
50,6,39,California,Madera County,11,6,11533,5472,6061
50,6,39,California,Madera County,11,7,10413,4888,5525
50,6,39,California,Madera County,11,8,10413,4757,5656
50,6,39,California,Madera County,11,9,9329,4153,5176
50,6,39,California,Madera County,11,10,9263,4266,4997
50,6,39,California,Madera County,11,11,8777,4167,4610
50,6,39,California,Madera County,11,12,8881,4275,4606
50,6,39,California,Madera County,11,13,8401,4031,4370
50,6,39,California,Madera County,11,14,7481,3671,3810
50,6,39,California,Madera County,11,15,5766,2771,2995
50,6,39,California,Madera County,11,16,3940,1887,2053
50,6,39,California,Madera County,11,17,2380,1062,1318
50,6,39,California,Madera County,11,18,2381,1017,1364
50,6,39,California,Madera County,12,0,157327,75885,81442
50,6,39,California,Madera County,12,1,11462,5826,5636
50,6,39,California,Madera County,12,2,12314,6255,6059
50,6,39,California,Madera County,12,3,12383,6231,6152
50,6,39,California,Madera County,12,4,11126,5631,5495
50,6,39,California,Madera County,12,5,10463,5073,5390
50,6,39,California,Madera County,12,6,11388,5409,5979
50,6,39,California,Madera County,12,7,10538,4931,5607
50,6,39,California,Madera County,12,8,10424,4852,5572
50,6,39,California,Madera County,12,9,9441,4259,5182
50,6,39,California,Madera County,12,10,9263,4248,5015
50,6,39,California,Madera County,12,11,8616,4153,4463
50,6,39,California,Madera County,12,12,8859,4267,4592
50,6,39,California,Madera County,12,13,8477,4073,4404
50,6,39,California,Madera County,12,14,7550,3700,3850
50,6,39,California,Madera County,12,15,6001,2877,3124
50,6,39,California,Madera County,12,16,4091,1926,2165
50,6,39,California,Madera County,12,17,2540,1165,1375
50,6,39,California,Madera County,12,18,2391,1009,1382
50,6,41,California,Marin County,1,0,252409,124072,128337
50,6,41,California,Marin County,1,1,13932,7118,6814
50,6,41,California,Marin County,1,2,15481,7919,7562
50,6,41,California,Marin County,1,3,14241,7153,7088
50,6,41,California,Marin County,1,4,12798,6758,6040
50,6,41,California,Marin County,1,5,10308,5707,4601
50,6,41,California,Marin County,1,6,11960,6449,5511
50,6,41,California,Marin County,1,7,12876,6598,6278
50,6,41,California,Marin County,1,8,16376,8226,8150
50,6,41,California,Marin County,1,9,20102,9988,10114
50,6,41,California,Marin County,1,10,20971,10411,10560
50,6,41,California,Marin County,1,11,21084,10185,10899
50,6,41,California,Marin County,1,12,20826,9873,10953
50,6,41,California,Marin County,1,13,19262,9031,10231
50,6,41,California,Marin County,1,14,14037,6784,7253
50,6,41,California,Marin County,1,15,9174,4278,4896
50,6,41,California,Marin County,1,16,6837,3124,3713
50,6,41,California,Marin County,1,17,5588,2275,3313
50,6,41,California,Marin County,1,18,6556,2195,4361
50,6,41,California,Marin County,2,0,252430,124084,128346
50,6,41,California,Marin County,2,1,13932,7118,6814
50,6,41,California,Marin County,2,2,15479,7918,7561
50,6,41,California,Marin County,2,3,14240,7153,7087
50,6,41,California,Marin County,2,4,12797,6758,6039
50,6,41,California,Marin County,2,5,10312,5710,4602
50,6,41,California,Marin County,2,6,11961,6449,5512
50,6,41,California,Marin County,2,7,12877,6599,6278
50,6,41,California,Marin County,2,8,16376,8226,8150
50,6,41,California,Marin County,2,9,20102,9988,10114
50,6,41,California,Marin County,2,10,20973,10411,10562
50,6,41,California,Marin County,2,11,21091,10190,10901
50,6,41,California,Marin County,2,12,20826,9873,10953
50,6,41,California,Marin County,2,13,19266,9033,10233
50,6,41,California,Marin County,2,14,14036,6783,7253
50,6,41,California,Marin County,2,15,9175,4278,4897
50,6,41,California,Marin County,2,16,6841,3125,3716
50,6,41,California,Marin County,2,17,5589,2276,3313
50,6,41,California,Marin County,2,18,6557,2196,4361
50,6,41,California,Marin County,3,0,252904,124353,128551
50,6,41,California,Marin County,3,1,13847,7071,6776
50,6,41,California,Marin County,3,2,15509,7944,7565
50,6,41,California,Marin County,3,3,14314,7191,7123
50,6,41,California,Marin County,3,4,12981,6837,6144
50,6,41,California,Marin County,3,5,10243,5678,4565
50,6,41,California,Marin County,3,6,11929,6434,5495
50,6,41,California,Marin County,3,7,12883,6618,6265
50,6,41,California,Marin County,3,8,16195,8131,8064
50,6,41,California,Marin County,3,9,20102,10007,10095
50,6,41,California,Marin County,3,10,20950,10406,10544
50,6,41,California,Marin County,3,11,21114,10199,10915
50,6,41,California,Marin County,3,12,20853,9886,10967
50,6,41,California,Marin County,3,13,19378,9098,10280
50,6,41,California,Marin County,3,14,14300,6895,7405
50,6,41,California,Marin County,3,15,9267,4316,4951
50,6,41,California,Marin County,3,16,6832,3137,3695
50,6,41,California,Marin County,3,17,5609,2300,3309
50,6,41,California,Marin County,3,18,6598,2205,4393
50,6,41,California,Marin County,4,0,255376,125515,129861
50,6,41,California,Marin County,4,1,13663,6995,6668
50,6,41,California,Marin County,4,2,15704,8026,7678
50,6,41,California,Marin County,4,3,14719,7384,7335
50,6,41,California,Marin County,4,4,13527,7046,6481
50,6,41,California,Marin County,4,5,10207,5668,4539
50,6,41,California,Marin County,4,6,11602,6266,5336
50,6,41,California,Marin County,4,7,12991,6681,6310
50,6,41,California,Marin County,4,8,15502,7771,7731
50,6,41,California,Marin County,4,9,20150,10081,10069
50,6,41,California,Marin County,4,10,20906,10397,10509
50,6,41,California,Marin County,4,11,21278,10286,10992
50,6,41,California,Marin County,4,12,20864,9910,10954
50,6,41,California,Marin County,4,13,19989,9412,10577
50,6,41,California,Marin County,4,14,15124,7201,7923
50,6,41,California,Marin County,4,15,9731,4526,5205
50,6,41,California,Marin County,4,16,6896,3176,3720
50,6,41,California,Marin County,4,17,5726,2408,3318
50,6,41,California,Marin County,4,18,6797,2281,4516
50,6,41,California,Marin County,5,0,256061,125304,130757
50,6,41,California,Marin County,5,1,13259,6809,6450
50,6,41,California,Marin County,5,2,15843,8065,7778
50,6,41,California,Marin County,5,3,15087,7588,7499
50,6,41,California,Marin County,5,4,13678,7039,6639
50,6,41,California,Marin County,5,5,10376,5711,4665
50,6,41,California,Marin County,5,6,11145,6004,5141
50,6,41,California,Marin County,5,7,12754,6540,6214
50,6,41,California,Marin County,5,8,15080,7478,7602
50,6,41,California,Marin County,5,9,19812,9899,9913
50,6,41,California,Marin County,5,10,20659,10150,10509
50,6,41,California,Marin County,5,11,21122,10239,10883
50,6,41,California,Marin County,5,12,20664,9740,10924
50,6,41,California,Marin County,5,13,19712,9246,10466
50,6,41,California,Marin County,5,14,16444,7780,8664
50,6,41,California,Marin County,5,15,10531,4900,5631
50,6,41,California,Marin County,5,16,7161,3293,3868
50,6,41,California,Marin County,5,17,5782,2471,3311
50,6,41,California,Marin County,5,18,6952,2352,4600
50,6,41,California,Marin County,6,0,258409,126127,132282
50,6,41,California,Marin County,6,1,12807,6487,6320
50,6,41,California,Marin County,6,2,15988,8175,7813
50,6,41,California,Marin County,6,3,15712,7919,7793
50,6,41,California,Marin County,6,4,13712,6952,6760
50,6,41,California,Marin County,6,5,10949,5904,5045
50,6,41,California,Marin County,6,6,10934,5939,4995
50,6,41,California,Marin County,6,7,12713,6506,6207
50,6,41,California,Marin County,6,8,14885,7364,7521
50,6,41,California,Marin County,6,9,19504,9648,9856
50,6,41,California,Marin County,6,10,20687,10231,10456
50,6,41,California,Marin County,6,11,21062,10277,10785
50,6,41,California,Marin County,6,12,20529,9652,10877
50,6,41,California,Marin County,6,13,19888,9301,10587
50,6,41,California,Marin County,6,14,16966,7936,9030
50,6,41,California,Marin County,6,15,11626,5411,6215
50,6,41,California,Marin County,6,16,7508,3473,4035
50,6,41,California,Marin County,6,17,5789,2482,3307
50,6,41,California,Marin County,6,18,7150,2470,4680
50,6,41,California,Marin County,7,0,260359,127077,133282
50,6,41,California,Marin County,7,1,12696,6449,6247
50,6,41,California,Marin County,7,2,15827,8056,7771
50,6,41,California,Marin County,7,3,16177,8175,8002
50,6,41,California,Marin County,7,4,13783,6904,6879
50,6,41,California,Marin County,7,5,11521,6165,5356
50,6,41,California,Marin County,7,6,10662,5816,4846
50,6,41,California,Marin County,7,7,12745,6560,6185
50,6,41,California,Marin County,7,8,14726,7267,7459
50,6,41,California,Marin County,7,9,18903,9376,9527
50,6,41,California,Marin County,7,10,20804,10342,10462
50,6,41,California,Marin County,7,11,21056,10312,10744
50,6,41,California,Marin County,7,12,20391,9645,10746
50,6,41,California,Marin County,7,13,20000,9356,10644
50,6,41,California,Marin County,7,14,17560,8118,9442
50,6,41,California,Marin County,7,15,12327,5747,6580
50,6,41,California,Marin County,7,16,8034,3731,4303
50,6,41,California,Marin County,7,17,5772,2488,3284
50,6,41,California,Marin County,7,18,7375,2570,4805
50,6,41,California,Marin County,8,0,260916,127406,133510
50,6,41,California,Marin County,8,1,12560,6361,6199
50,6,41,California,Marin County,8,2,15452,7875,7577
50,6,41,California,Marin County,8,3,16433,8365,8068
50,6,41,California,Marin County,8,4,14027,6988,7039
50,6,41,California,Marin County,8,5,11881,6365,5516
50,6,41,California,Marin County,8,6,10496,5715,4781
50,6,41,California,Marin County,8,7,12436,6462,5974
50,6,41,California,Marin County,8,8,14679,7239,7440
50,6,41,California,Marin County,8,9,17924,8964,8960
50,6,41,California,Marin County,8,10,20978,10352,10626
50,6,41,California,Marin County,8,11,20791,10238,10553
50,6,41,California,Marin County,8,12,20533,9781,10752
50,6,41,California,Marin County,8,13,19811,9192,10619
50,6,41,California,Marin County,8,14,18078,8296,9782
50,6,41,California,Marin County,8,15,13151,6182,6969
50,6,41,California,Marin County,8,16,8382,3803,4579
50,6,41,California,Marin County,8,17,5785,2572,3213
50,6,41,California,Marin County,8,18,7519,2656,4863
50,6,41,California,Marin County,9,0,260562,127096,133466
50,6,41,California,Marin County,9,1,12450,6302,6148
50,6,41,California,Marin County,9,2,14898,7565,7333
50,6,41,California,Marin County,9,3,16647,8493,8154
50,6,41,California,Marin County,9,4,14291,7124,7167
50,6,41,California,Marin County,9,5,11911,6310,5601
50,6,41,California,Marin County,9,6,10308,5617,4691
50,6,41,California,Marin County,9,7,12142,6318,5824
50,6,41,California,Marin County,9,8,14678,7217,7461
50,6,41,California,Marin County,9,9,17059,8517,8542
50,6,41,California,Marin County,9,10,20909,10383,10526
50,6,41,California,Marin County,9,11,20607,10122,10485
50,6,41,California,Marin County,9,12,20497,9769,10728
50,6,41,California,Marin County,9,13,19717,9162,10555
50,6,41,California,Marin County,9,14,18380,8447,9933
50,6,41,California,Marin County,9,15,13763,6399,7364
50,6,41,California,Marin County,9,16,8766,3971,4795
50,6,41,California,Marin County,9,17,5820,2604,3216
50,6,41,California,Marin County,9,18,7719,2776,4943
50,6,41,California,Marin County,10,0,259749,126875,132874
50,6,41,California,Marin County,10,1,12196,6150,6046
50,6,41,California,Marin County,10,2,14403,7341,7062
50,6,41,California,Marin County,10,3,16588,8447,8141
50,6,41,California,Marin County,10,4,14586,7316,7270
50,6,41,California,Marin County,10,5,11819,6157,5662
50,6,41,California,Marin County,10,6,10414,5749,4665
50,6,41,California,Marin County,10,7,11878,6218,5660
50,6,41,California,Marin County,10,8,14350,7183,7167
50,6,41,California,Marin County,10,9,16615,8276,8339
50,6,41,California,Marin County,10,10,20581,10249,10332
50,6,41,California,Marin County,10,11,20456,10049,10407
50,6,41,California,Marin County,10,12,20286,9711,10575
50,6,41,California,Marin County,10,13,19441,9111,10330
50,6,41,California,Marin County,10,14,18043,8217,9826
50,6,41,California,Marin County,10,15,14941,6922,8019
50,6,41,California,Marin County,10,16,9366,4285,5081
50,6,41,California,Marin County,10,17,6047,2663,3384
50,6,41,California,Marin County,10,18,7739,2831,4908
50,6,41,California,Marin County,11,0,259662,126961,132701
50,6,41,California,Marin County,11,1,11984,6037,5947
50,6,41,California,Marin County,11,2,13884,7020,6864
50,6,41,California,Marin County,11,3,16423,8355,8068
50,6,41,California,Marin County,11,4,15137,7656,7481
50,6,41,California,Marin County,11,5,11823,6087,5736
50,6,41,California,Marin County,11,6,10642,5831,4811
50,6,41,California,Marin County,11,7,11724,6222,5502
50,6,41,California,Marin County,11,8,14238,7181,7057
50,6,41,California,Marin County,11,9,16160,8108,8052
50,6,41,California,Marin County,11,10,19978,9889,10089
50,6,41,California,Marin County,11,11,20285,10051,10234
50,6,41,California,Marin County,11,12,20159,9738,10421
50,6,41,California,Marin County,11,13,19362,9066,10296
50,6,41,California,Marin County,11,14,18053,8220,9833
50,6,41,California,Marin County,11,15,15379,7105,8274
50,6,41,California,Marin County,11,16,10277,4704,5573
50,6,41,California,Marin County,11,17,6329,2809,3520
50,6,41,California,Marin County,11,18,7825,2882,4943
50,6,41,California,Marin County,12,0,258826,126617,132209
50,6,41,California,Marin County,12,1,11626,5892,5734
50,6,41,California,Marin County,12,2,13541,6878,6663
50,6,41,California,Marin County,12,3,16094,8165,7929
50,6,41,California,Marin County,12,4,15508,7862,7646
50,6,41,California,Marin County,12,5,11652,5931,5721
50,6,41,California,Marin County,12,6,10715,5846,4869
50,6,41,California,Marin County,12,7,11540,6146,5394
50,6,41,California,Marin County,12,8,14260,7200,7060
50,6,41,California,Marin County,12,9,15758,7947,7811
50,6,41,California,Marin County,12,10,19256,9541,9715
50,6,41,California,Marin County,12,11,20435,10114,10321
50,6,41,California,Marin County,12,12,19952,9725,10227
50,6,41,California,Marin County,12,13,19085,8983,10102
50,6,41,California,Marin County,12,14,18035,8172,9863
50,6,41,California,Marin County,12,15,15820,7261,8559
50,6,41,California,Marin County,12,16,10913,5024,5889
50,6,41,California,Marin County,12,17,6753,3004,3749
50,6,41,California,Marin County,12,18,7883,2926,4957
50,6,43,California,Mariposa County,1,0,18251,9269,8982
50,6,43,California,Mariposa County,1,1,775,381,394
50,6,43,California,Mariposa County,1,2,821,426,395
50,6,43,California,Mariposa County,1,3,987,495,492
50,6,43,California,Mariposa County,1,4,1026,517,509
50,6,43,California,Mariposa County,1,5,827,450,377
50,6,43,California,Mariposa County,1,6,828,427,401
50,6,43,California,Mariposa County,1,7,823,423,400
50,6,43,California,Mariposa County,1,8,840,447,393
50,6,43,California,Mariposa County,1,9,988,494,494
50,6,43,California,Mariposa County,1,10,1456,739,717
50,6,43,California,Mariposa County,1,11,1776,890,886
50,6,43,California,Mariposa County,1,12,1693,822,871
50,6,43,California,Mariposa County,1,13,1590,872,718
50,6,43,California,Mariposa County,1,14,1304,654,650
50,6,43,California,Mariposa County,1,15,949,499,450
50,6,43,California,Mariposa County,1,16,707,339,368
50,6,43,California,Mariposa County,1,17,479,250,229
50,6,43,California,Mariposa County,1,18,382,144,238
50,6,43,California,Mariposa County,2,0,18247,9267,8980
50,6,43,California,Mariposa County,2,1,775,381,394
50,6,43,California,Mariposa County,2,2,820,425,395
50,6,43,California,Mariposa County,2,3,987,495,492
50,6,43,California,Mariposa County,2,4,1026,517,509
50,6,43,California,Mariposa County,2,5,827,450,377
50,6,43,California,Mariposa County,2,6,828,427,401
50,6,43,California,Mariposa County,2,7,822,422,400
50,6,43,California,Mariposa County,2,8,840,447,393
50,6,43,California,Mariposa County,2,9,987,494,493
50,6,43,California,Mariposa County,2,10,1456,739,717
50,6,43,California,Mariposa County,2,11,1775,890,885
50,6,43,California,Mariposa County,2,12,1693,822,871
50,6,43,California,Mariposa County,2,13,1590,872,718
50,6,43,California,Mariposa County,2,14,1304,654,650
50,6,43,California,Mariposa County,2,15,949,499,450
50,6,43,California,Mariposa County,2,16,707,339,368
50,6,43,California,Mariposa County,2,17,479,250,229
50,6,43,California,Mariposa County,2,18,382,144,238
50,6,43,California,Mariposa County,3,0,18277,9294,8983
50,6,43,California,Mariposa County,3,1,771,381,390
50,6,43,California,Mariposa County,3,2,817,421,396
50,6,43,California,Mariposa County,3,3,974,493,481
50,6,43,California,Mariposa County,3,4,1014,507,507
50,6,43,California,Mariposa County,3,5,844,460,384
50,6,43,California,Mariposa County,3,6,846,437,409
50,6,43,California,Mariposa County,3,7,820,420,400
50,6,43,California,Mariposa County,3,8,840,447,393
50,6,43,California,Mariposa County,3,9,976,493,483
50,6,43,California,Mariposa County,3,10,1442,731,711
50,6,43,California,Mariposa County,3,11,1766,881,885
50,6,43,California,Mariposa County,3,12,1698,829,869
50,6,43,California,Mariposa County,3,13,1617,885,732
50,6,43,California,Mariposa County,3,14,1304,657,647
50,6,43,California,Mariposa County,3,15,956,505,451
50,6,43,California,Mariposa County,3,16,715,347,368
50,6,43,California,Mariposa County,3,17,487,252,235
50,6,43,California,Mariposa County,3,18,390,148,242
50,6,43,California,Mariposa County,4,0,18170,9237,8933
50,6,43,California,Mariposa County,4,1,777,397,380
50,6,43,California,Mariposa County,4,2,835,420,415
50,6,43,California,Mariposa County,4,3,938,486,452
50,6,43,California,Mariposa County,4,4,977,478,499
50,6,43,California,Mariposa County,4,5,875,457,418
50,6,43,California,Mariposa County,4,6,890,471,419
50,6,43,California,Mariposa County,4,7,846,437,409
50,6,43,California,Mariposa County,4,8,807,419,388
50,6,43,California,Mariposa County,4,9,939,480,459
50,6,43,California,Mariposa County,4,10,1324,690,634
50,6,43,California,Mariposa County,4,11,1701,823,878
50,6,43,California,Mariposa County,4,12,1689,845,844
50,6,43,California,Mariposa County,4,13,1666,876,790
50,6,43,California,Mariposa County,4,14,1293,663,630
50,6,43,California,Mariposa County,4,15,987,519,468
50,6,43,California,Mariposa County,4,16,711,358,353
50,6,43,California,Mariposa County,4,17,498,257,241
50,6,43,California,Mariposa County,4,18,417,161,256
50,6,43,California,Mariposa County,5,0,17881,9112,8769
50,6,43,California,Mariposa County,5,1,748,376,372
50,6,43,California,Mariposa County,5,2,798,403,395
50,6,43,California,Mariposa County,5,3,899,480,419
50,6,43,California,Mariposa County,5,4,969,478,491
50,6,43,California,Mariposa County,5,5,832,440,392
50,6,43,California,Mariposa County,5,6,862,454,408
50,6,43,California,Mariposa County,5,7,812,428,384
50,6,43,California,Mariposa County,5,8,786,413,373
50,6,43,California,Mariposa County,5,9,904,463,441
50,6,43,California,Mariposa County,5,10,1192,625,567
50,6,43,California,Mariposa County,5,11,1638,793,845
50,6,43,California,Mariposa County,5,12,1689,858,831
50,6,43,California,Mariposa County,5,13,1598,805,793
50,6,43,California,Mariposa County,5,14,1417,743,674
50,6,43,California,Mariposa County,5,15,1059,548,511
50,6,43,California,Mariposa County,5,16,716,368,348
50,6,43,California,Mariposa County,5,17,518,259,259
50,6,43,California,Mariposa County,5,18,444,178,266
50,6,43,California,Mariposa County,6,0,17809,9061,8748
50,6,43,California,Mariposa County,6,1,757,381,376
50,6,43,California,Mariposa County,6,2,789,402,387
50,6,43,California,Mariposa County,6,3,848,457,391
50,6,43,California,Mariposa County,6,4,958,486,472
50,6,43,California,Mariposa County,6,5,864,436,428
50,6,43,California,Mariposa County,6,6,860,454,406
50,6,43,California,Mariposa County,6,7,837,451,386
50,6,43,California,Mariposa County,6,8,781,398,383
50,6,43,California,Mariposa County,6,9,870,458,412
50,6,43,California,Mariposa County,6,10,1107,553,554
50,6,43,California,Mariposa County,6,11,1546,772,774
50,6,43,California,Mariposa County,6,12,1707,855,852
50,6,43,California,Mariposa County,6,13,1592,794,798
50,6,43,California,Mariposa County,6,14,1479,792,687
50,6,43,California,Mariposa County,6,15,1096,558,538
50,6,43,California,Mariposa County,6,16,740,384,356
50,6,43,California,Mariposa County,6,17,506,240,266
50,6,43,California,Mariposa County,6,18,472,190,282
50,6,43,California,Mariposa County,7,0,17714,9035,8679
50,6,43,California,Mariposa County,7,1,762,402,360
50,6,43,California,Mariposa County,7,2,788,392,396
50,6,43,California,Mariposa County,7,3,816,445,371
50,6,43,California,Mariposa County,7,4,892,449,443
50,6,43,California,Mariposa County,7,5,883,468,415
50,6,43,California,Mariposa County,7,6,885,467,418
50,6,43,California,Mariposa County,7,7,853,454,399
50,6,43,California,Mariposa County,7,8,736,375,361
50,6,43,California,Mariposa County,7,9,824,429,395
50,6,43,California,Mariposa County,7,10,1006,502,504
50,6,43,California,Mariposa County,7,11,1491,757,734
50,6,43,California,Mariposa County,7,12,1720,856,864
50,6,43,California,Mariposa County,7,13,1640,809,831
50,6,43,California,Mariposa County,7,14,1494,808,686
50,6,43,California,Mariposa County,7,15,1130,564,566
50,6,43,California,Mariposa County,7,16,800,422,378
50,6,43,California,Mariposa County,7,17,504,239,265
50,6,43,California,Mariposa County,7,18,490,197,293
50,6,43,California,Mariposa County,8,0,17622,8933,8689
50,6,43,California,Mariposa County,8,1,742,389,353
50,6,43,California,Mariposa County,8,2,764,356,408
50,6,43,California,Mariposa County,8,3,822,443,379
50,6,43,California,Mariposa County,8,4,873,464,409
50,6,43,California,Mariposa County,8,5,880,471,409
50,6,43,California,Mariposa County,8,6,902,478,424
50,6,43,California,Mariposa County,8,7,841,416,425
50,6,43,California,Mariposa County,8,8,815,416,399
50,6,43,California,Mariposa County,8,9,800,404,396
50,6,43,California,Mariposa County,8,10,961,495,466
50,6,43,California,Mariposa County,8,11,1370,692,678
50,6,43,California,Mariposa County,8,12,1683,816,867
50,6,43,California,Mariposa County,8,13,1637,804,833
50,6,43,California,Mariposa County,8,14,1539,820,719
50,6,43,California,Mariposa County,8,15,1168,593,575
50,6,43,California,Mariposa County,8,16,817,426,391
50,6,43,California,Mariposa County,8,17,520,250,270
50,6,43,California,Mariposa County,8,18,488,200,288
50,6,43,California,Mariposa County,9,0,17456,8879,8577
50,6,43,California,Mariposa County,9,1,772,388,384
50,6,43,California,Mariposa County,9,2,740,372,368
50,6,43,California,Mariposa County,9,3,832,423,409
50,6,43,California,Mariposa County,9,4,811,451,360
50,6,43,California,Mariposa County,9,5,838,449,389
50,6,43,California,Mariposa County,9,6,930,499,431
50,6,43,California,Mariposa County,9,7,888,462,426
50,6,43,California,Mariposa County,9,8,833,429,404
50,6,43,California,Mariposa County,9,9,781,391,390
50,6,43,California,Mariposa County,9,10,896,464,432
50,6,43,California,Mariposa County,9,11,1232,637,595
50,6,43,California,Mariposa County,9,12,1646,785,861
50,6,43,California,Mariposa County,9,13,1660,833,827
50,6,43,California,Mariposa County,9,14,1571,803,768
50,6,43,California,Mariposa County,9,15,1169,580,589
50,6,43,California,Mariposa County,9,16,834,444,390
50,6,43,California,Mariposa County,9,17,528,260,268
50,6,43,California,Mariposa County,9,18,495,209,286
50,6,43,California,Mariposa County,10,0,17414,8874,8540
50,6,43,California,Mariposa County,10,1,758,390,368
50,6,43,California,Mariposa County,10,2,773,389,384
50,6,43,California,Mariposa County,10,3,787,404,383
50,6,43,California,Mariposa County,10,4,782,420,362
50,6,43,California,Mariposa County,10,5,840,460,380
50,6,43,California,Mariposa County,10,6,963,508,455
50,6,43,California,Mariposa County,10,7,906,484,422
50,6,43,California,Mariposa County,10,8,845,430,415
50,6,43,California,Mariposa County,10,9,767,396,371
50,6,43,California,Mariposa County,10,10,894,448,446
50,6,43,California,Mariposa County,10,11,1107,579,528
50,6,43,California,Mariposa County,10,12,1607,777,830
50,6,43,California,Mariposa County,10,13,1670,837,833
50,6,43,California,Mariposa County,10,14,1541,768,773
50,6,43,California,Mariposa County,10,15,1255,651,604
50,6,43,California,Mariposa County,10,16,867,443,424
50,6,43,California,Mariposa County,10,17,535,277,258
50,6,43,California,Mariposa County,10,18,517,213,304
50,6,43,California,Mariposa County,11,0,17405,8846,8559
50,6,43,California,Mariposa County,11,1,747,399,348
50,6,43,California,Mariposa County,11,2,789,391,398
50,6,43,California,Mariposa County,11,3,788,387,401
50,6,43,California,Mariposa County,11,4,762,408,354
50,6,43,California,Mariposa County,11,5,824,453,371
50,6,43,California,Mariposa County,11,6,992,512,480
50,6,43,California,Mariposa County,11,7,878,466,412
50,6,43,California,Mariposa County,11,8,886,438,448
50,6,43,California,Mariposa County,11,9,777,404,373
50,6,43,California,Mariposa County,11,10,878,463,415
50,6,43,California,Mariposa County,11,11,1077,526,551
50,6,43,California,Mariposa County,11,12,1494,743,751
50,6,43,California,Mariposa County,11,13,1664,830,834
50,6,43,California,Mariposa County,11,14,1541,763,778
50,6,43,California,Mariposa County,11,15,1284,696,588
50,6,43,California,Mariposa County,11,16,922,456,466
50,6,43,California,Mariposa County,11,17,566,293,273
50,6,43,California,Mariposa County,11,18,536,218,318
50,6,43,California,Mariposa County,12,0,17203,8764,8439
50,6,43,California,Mariposa County,12,1,729,371,358
50,6,43,California,Mariposa County,12,2,775,397,378
50,6,43,California,Mariposa County,12,3,789,391,398
50,6,43,California,Mariposa County,12,4,767,407,360
50,6,43,California,Mariposa County,12,5,732,398,334
50,6,43,California,Mariposa County,12,6,977,519,458
50,6,43,California,Mariposa County,12,7,909,480,429
50,6,43,California,Mariposa County,12,8,865,443,422
50,6,43,California,Mariposa County,12,9,789,396,393
50,6,43,California,Mariposa County,12,10,858,458,400
50,6,43,California,Mariposa County,12,11,963,475,488
50,6,43,California,Mariposa County,12,12,1398,703,695
50,6,43,California,Mariposa County,12,13,1678,828,850
50,6,43,California,Mariposa County,12,14,1559,763,796
50,6,43,California,Mariposa County,12,15,1318,733,585
50,6,43,California,Mariposa County,12,16,953,460,493
50,6,43,California,Mariposa County,12,17,607,326,281
50,6,43,California,Mariposa County,12,18,537,216,321
50,6,45,California,Mendocino County,1,0,87841,43983,43858
50,6,45,California,Mendocino County,1,1,5347,2786,2561
50,6,45,California,Mendocino County,1,2,5259,2656,2603
50,6,45,California,Mendocino County,1,3,5390,2735,2655
50,6,45,California,Mendocino County,1,4,5613,2991,2622
50,6,45,California,Mendocino County,1,5,4874,2635,2239
50,6,45,California,Mendocino County,1,6,5485,2833,2652
50,6,45,California,Mendocino County,1,7,5219,2724,2495
50,6,45,California,Mendocino County,1,8,5097,2647,2450
50,6,45,California,Mendocino County,1,9,5171,2688,2483
50,6,45,California,Mendocino County,1,10,5759,2838,2921
50,6,45,California,Mendocino County,1,11,6717,3289,3428
50,6,45,California,Mendocino County,1,12,7283,3487,3796
50,6,45,California,Mendocino County,1,13,7134,3540,3594
50,6,45,California,Mendocino County,1,14,4632,2287,2345
50,6,45,California,Mendocino County,1,15,2924,1427,1497
50,6,45,California,Mendocino County,1,16,2178,1010,1168
50,6,45,California,Mendocino County,1,17,1805,759,1046
50,6,45,California,Mendocino County,1,18,1954,651,1303
50,6,45,California,Mendocino County,2,0,87850,43987,43863
50,6,45,California,Mendocino County,2,1,5347,2786,2561
50,6,45,California,Mendocino County,2,2,5259,2656,2603
50,6,45,California,Mendocino County,2,3,5390,2735,2655
50,6,45,California,Mendocino County,2,4,5613,2991,2622
50,6,45,California,Mendocino County,2,5,4874,2635,2239
50,6,45,California,Mendocino County,2,6,5485,2833,2652
50,6,45,California,Mendocino County,2,7,5219,2724,2495
50,6,45,California,Mendocino County,2,8,5097,2647,2450
50,6,45,California,Mendocino County,2,9,5171,2688,2483
50,6,45,California,Mendocino County,2,10,5758,2837,2921
50,6,45,California,Mendocino County,2,11,6717,3289,3428
50,6,45,California,Mendocino County,2,12,7284,3487,3797
50,6,45,California,Mendocino County,2,13,7135,3542,3593
50,6,45,California,Mendocino County,2,14,4631,2286,2345
50,6,45,California,Mendocino County,2,15,2925,1427,1498
50,6,45,California,Mendocino County,2,16,2180,1012,1168
50,6,45,California,Mendocino County,2,17,1808,760,1048
50,6,45,California,Mendocino County,2,18,1957,652,1305
50,6,45,California,Mendocino County,3,0,87799,43937,43862
50,6,45,California,Mendocino County,3,1,5360,2797,2563
50,6,45,California,Mendocino County,3,2,5262,2645,2617
50,6,45,California,Mendocino County,3,3,5384,2739,2645
50,6,45,California,Mendocino County,3,4,5559,2969,2590
50,6,45,California,Mendocino County,3,5,4859,2617,2242
50,6,45,California,Mendocino County,3,6,5453,2809,2644
50,6,45,California,Mendocino County,3,7,5233,2726,2507
50,6,45,California,Mendocino County,3,8,5071,2631,2440
50,6,45,California,Mendocino County,3,9,5187,2699,2488
50,6,45,California,Mendocino County,3,10,5699,2819,2880
50,6,45,California,Mendocino County,3,11,6679,3269,3410
50,6,45,California,Mendocino County,3,12,7249,3468,3781
50,6,45,California,Mendocino County,3,13,7218,3573,3645
50,6,45,California,Mendocino County,3,14,4682,2312,2370
50,6,45,California,Mendocino County,3,15,2943,1435,1508
50,6,45,California,Mendocino County,3,16,2189,1021,1168
50,6,45,California,Mendocino County,3,17,1796,755,1041
50,6,45,California,Mendocino County,3,18,1976,653,1323
50,6,45,California,Mendocino County,4,0,87334,43584,43750
50,6,45,California,Mendocino County,4,1,5279,2723,2556
50,6,45,California,Mendocino County,4,2,5286,2660,2626
50,6,45,California,Mendocino County,4,3,5353,2735,2618
50,6,45,California,Mendocino County,4,4,5397,2890,2507
50,6,45,California,Mendocino County,4,5,4824,2540,2284
50,6,45,California,Mendocino County,4,6,5229,2699,2530
50,6,45,California,Mendocino County,4,7,5287,2737,2550
50,6,45,California,Mendocino County,4,8,4932,2550,2382
50,6,45,California,Mendocino County,4,9,5228,2703,2525
50,6,45,California,Mendocino County,4,10,5380,2683,2697
50,6,45,California,Mendocino County,4,11,6488,3175,3313
50,6,45,California,Mendocino County,4,12,7078,3398,3680
50,6,45,California,Mendocino County,4,13,7500,3664,3836
50,6,45,California,Mendocino County,4,14,4949,2456,2493
50,6,45,California,Mendocino County,4,15,3075,1518,1557
50,6,45,California,Mendocino County,4,16,2270,1066,1204
50,6,45,California,Mendocino County,4,17,1741,733,1008
50,6,45,California,Mendocino County,4,18,2038,654,1384
50,6,45,California,Mendocino County,5,0,87288,43522,43766
50,6,45,California,Mendocino County,5,1,5321,2769,2552
50,6,45,California,Mendocino County,5,2,5292,2679,2613
50,6,45,California,Mendocino County,5,3,5313,2712,2601
50,6,45,California,Mendocino County,5,4,5280,2752,2528
50,6,45,California,Mendocino County,5,5,4788,2514,2274
50,6,45,California,Mendocino County,5,6,4999,2600,2399
50,6,45,California,Mendocino County,5,7,5329,2785,2544
50,6,45,California,Mendocino County,5,8,4987,2588,2399
50,6,45,California,Mendocino County,5,9,5219,2671,2548
50,6,45,California,Mendocino County,5,10,5131,2577,2554
50,6,45,California,Mendocino County,5,11,6272,3069,3203
50,6,45,California,Mendocino County,5,12,7018,3365,3653
50,6,45,California,Mendocino County,5,13,7302,3519,3783
50,6,45,California,Mendocino County,5,14,5638,2809,2829
50,6,45,California,Mendocino County,5,15,3317,1609,1708
50,6,45,California,Mendocino County,5,16,2317,1105,1212
50,6,45,California,Mendocino County,5,17,1685,712,973
50,6,45,California,Mendocino County,5,18,2080,687,1393
50,6,45,California,Mendocino County,6,0,87054,43334,43720
50,6,45,California,Mendocino County,6,1,5297,2728,2569
50,6,45,California,Mendocino County,6,2,5270,2718,2552
50,6,45,California,Mendocino County,6,3,5244,2675,2569
50,6,45,California,Mendocino County,6,4,5200,2662,2538
50,6,45,California,Mendocino County,6,5,4775,2527,2248
50,6,45,California,Mendocino County,6,6,4983,2600,2383
50,6,45,California,Mendocino County,6,7,5297,2726,2571
50,6,45,California,Mendocino County,6,8,4991,2585,2406
50,6,45,California,Mendocino County,6,9,5134,2587,2547
50,6,45,California,Mendocino County,6,10,5033,2553,2480
50,6,45,California,Mendocino County,6,11,5989,2886,3103
50,6,45,California,Mendocino County,6,12,6824,3307,3517
50,6,45,California,Mendocino County,6,13,7215,3439,3776
50,6,45,California,Mendocino County,6,14,6029,3017,3012
50,6,45,California,Mendocino County,6,15,3652,1800,1852
50,6,45,California,Mendocino County,6,16,2351,1123,1228
50,6,45,California,Mendocino County,6,17,1708,730,978
50,6,45,California,Mendocino County,6,18,2062,671,1391
50,6,45,California,Mendocino County,7,0,87225,43387,43838
50,6,45,California,Mendocino County,7,1,5310,2708,2602
50,6,45,California,Mendocino County,7,2,5347,2761,2586
50,6,45,California,Mendocino County,7,3,5205,2620,2585
50,6,45,California,Mendocino County,7,4,5162,2670,2492
50,6,45,California,Mendocino County,7,5,4838,2557,2281
50,6,45,California,Mendocino County,7,6,4875,2536,2339
50,6,45,California,Mendocino County,7,7,5290,2729,2561
50,6,45,California,Mendocino County,7,8,5083,2591,2492
50,6,45,California,Mendocino County,7,9,5038,2558,2480
50,6,45,California,Mendocino County,7,10,4962,2541,2421
50,6,45,California,Mendocino County,7,11,5847,2817,3030
50,6,45,California,Mendocino County,7,12,6576,3202,3374
50,6,45,California,Mendocino County,7,13,7129,3364,3765
50,6,45,California,Mendocino County,7,14,6426,3213,3213
50,6,45,California,Mendocino County,7,15,3965,1954,2011
50,6,45,California,Mendocino County,7,16,2408,1145,1263
50,6,45,California,Mendocino County,7,17,1687,741,946
50,6,45,California,Mendocino County,7,18,2077,680,1397
50,6,45,California,Mendocino County,8,0,87107,43311,43796
50,6,45,California,Mendocino County,8,1,5235,2684,2551
50,6,45,California,Mendocino County,8,2,5343,2744,2599
50,6,45,California,Mendocino County,8,3,5130,2580,2550
50,6,45,California,Mendocino County,8,4,5042,2592,2450
50,6,45,California,Mendocino County,8,5,4844,2589,2255
50,6,45,California,Mendocino County,8,6,4741,2490,2251
50,6,45,California,Mendocino County,8,7,5255,2658,2597
50,6,45,California,Mendocino County,8,8,5139,2640,2499
50,6,45,California,Mendocino County,8,9,5005,2574,2431
50,6,45,California,Mendocino County,8,10,5011,2549,2462
50,6,45,California,Mendocino County,8,11,5568,2686,2882
50,6,45,California,Mendocino County,8,12,6445,3159,3286
50,6,45,California,Mendocino County,8,13,6978,3296,3682
50,6,45,California,Mendocino County,8,14,6838,3348,3490
50,6,45,California,Mendocino County,8,15,4221,2086,2135
50,6,45,California,Mendocino County,8,16,2528,1220,1308
50,6,45,California,Mendocino County,8,17,1708,744,964
50,6,45,California,Mendocino County,8,18,2076,672,1404
50,6,45,California,Mendocino County,9,0,87285,43319,43966
50,6,45,California,Mendocino County,9,1,5277,2682,2595
50,6,45,California,Mendocino County,9,2,5203,2703,2500
50,6,45,California,Mendocino County,9,3,5195,2590,2605
50,6,45,California,Mendocino County,9,4,5080,2662,2418
50,6,45,California,Mendocino County,9,5,4645,2452,2193
50,6,45,California,Mendocino County,9,6,4820,2486,2334
50,6,45,California,Mendocino County,9,7,5126,2605,2521
50,6,45,California,Mendocino County,9,8,5249,2714,2535
50,6,45,California,Mendocino County,9,9,4974,2529,2445
50,6,45,California,Mendocino County,9,10,5109,2604,2505
50,6,45,California,Mendocino County,9,11,5371,2612,2759
50,6,45,California,Mendocino County,9,12,6308,3089,3219
50,6,45,California,Mendocino County,9,13,6927,3261,3666
50,6,45,California,Mendocino County,9,14,7112,3441,3671
50,6,45,California,Mendocino County,9,15,4451,2189,2262
50,6,45,California,Mendocino County,9,16,2573,1250,1323
50,6,45,California,Mendocino County,9,17,1760,780,980
50,6,45,California,Mendocino County,9,18,2105,670,1435
50,6,45,California,Mendocino County,10,0,87576,43398,44178
50,6,45,California,Mendocino County,10,1,5169,2574,2595
50,6,45,California,Mendocino County,10,2,5282,2771,2511
50,6,45,California,Mendocino County,10,3,5204,2644,2560
50,6,45,California,Mendocino County,10,4,5048,2636,2412
50,6,45,California,Mendocino County,10,5,4525,2339,2186
50,6,45,California,Mendocino County,10,6,4906,2481,2425
50,6,45,California,Mendocino County,10,7,5052,2594,2458
50,6,45,California,Mendocino County,10,8,5381,2737,2644
50,6,45,California,Mendocino County,10,9,5043,2604,2439
50,6,45,California,Mendocino County,10,10,5101,2543,2558
50,6,45,California,Mendocino County,10,11,5168,2575,2593
50,6,45,California,Mendocino County,10,12,6169,3019,3150
50,6,45,California,Mendocino County,10,13,6836,3243,3593
50,6,45,California,Mendocino County,10,14,6914,3299,3615
50,6,45,California,Mendocino County,10,15,5104,2509,2595
50,6,45,California,Mendocino County,10,16,2803,1346,1457
50,6,45,California,Mendocino County,10,17,1754,784,970
50,6,45,California,Mendocino County,10,18,2117,700,1417
50,6,45,California,Mendocino County,11,0,87401,43322,44079
50,6,45,California,Mendocino County,11,1,5098,2545,2553
50,6,45,California,Mendocino County,11,2,5205,2679,2526
50,6,45,California,Mendocino County,11,3,5216,2696,2520
50,6,45,California,Mendocino County,11,4,4956,2561,2395
50,6,45,California,Mendocino County,11,5,4490,2290,2200
50,6,45,California,Mendocino County,11,6,4893,2538,2355
50,6,45,California,Mendocino County,11,7,4958,2537,2421
50,6,45,California,Mendocino County,11,8,5367,2728,2639
50,6,45,California,Mendocino County,11,9,5083,2607,2476
50,6,45,California,Mendocino County,11,10,5134,2552,2582
50,6,45,California,Mendocino County,11,11,5036,2530,2506
50,6,45,California,Mendocino County,11,12,5904,2862,3042
50,6,45,California,Mendocino County,11,13,6678,3205,3473
50,6,45,California,Mendocino County,11,14,6863,3228,3635
50,6,45,California,Mendocino County,11,15,5510,2731,2779
50,6,45,California,Mendocino County,11,16,3086,1490,1596
50,6,45,California,Mendocino County,11,17,1779,819,960
50,6,45,California,Mendocino County,11,18,2145,724,1421
50,6,45,California,Mendocino County,12,0,86749,43021,43728
50,6,45,California,Mendocino County,12,1,4949,2500,2449
50,6,45,California,Mendocino County,12,2,5123,2600,2523
50,6,45,California,Mendocino County,12,3,5167,2681,2486
50,6,45,California,Mendocino County,12,4,4874,2473,2401
50,6,45,California,Mendocino County,12,5,4328,2244,2084
50,6,45,California,Mendocino County,12,6,4893,2544,2349
50,6,45,California,Mendocino County,12,7,4871,2489,2382
50,6,45,California,Mendocino County,12,8,5338,2733,2605
50,6,45,California,Mendocino County,12,9,5061,2562,2499
50,6,45,California,Mendocino County,12,10,5025,2501,2524
50,6,45,California,Mendocino County,12,11,4914,2485,2429
50,6,45,California,Mendocino County,12,12,5757,2786,2971
50,6,45,California,Mendocino County,12,13,6424,3091,3333
50,6,45,California,Mendocino County,12,14,6796,3187,3609
50,6,45,California,Mendocino County,12,15,5860,2906,2954
50,6,45,California,Mendocino County,12,16,3381,1646,1735
50,6,45,California,Mendocino County,12,17,1825,848,977
50,6,45,California,Mendocino County,12,18,2163,745,1418
50,6,47,California,Merced County,1,0,255793,128737,127056
50,6,47,California,Merced County,1,1,22226,11407,10819
50,6,47,California,Merced County,1,2,22167,11312,10855
50,6,47,California,Merced County,1,3,22115,11387,10728
50,6,47,California,Merced County,1,4,24451,12722,11729
50,6,47,California,Merced County,1,5,20195,10513,9682
50,6,47,California,Merced County,1,6,18190,9413,8777
50,6,47,California,Merced County,1,7,16870,8580,8290
50,6,47,California,Merced County,1,8,16243,8130,8113
50,6,47,California,Merced County,1,9,15724,7975,7749
50,6,47,California,Merced County,1,10,16146,8018,8128
50,6,47,California,Merced County,1,11,14861,7452,7409
50,6,47,California,Merced County,1,12,12363,6132,6231
50,6,47,California,Merced County,1,13,10282,5093,5189
50,6,47,California,Merced County,1,14,7606,3606,4000
50,6,47,California,Merced County,1,15,5599,2589,3010
50,6,47,California,Merced County,1,16,4470,1993,2477
50,6,47,California,Merced County,1,17,3247,1334,1913
50,6,47,California,Merced County,1,18,3038,1081,1957
50,6,47,California,Merced County,2,0,255796,128738,127058
50,6,47,California,Merced County,2,1,22226,11407,10819
50,6,47,California,Merced County,2,2,22167,11312,10855
50,6,47,California,Merced County,2,3,22116,11388,10728
50,6,47,California,Merced County,2,4,24451,12722,11729
50,6,47,California,Merced County,2,5,20194,10512,9682
50,6,47,California,Merced County,2,6,18189,9412,8777
50,6,47,California,Merced County,2,7,16870,8580,8290
50,6,47,California,Merced County,2,8,16243,8130,8113
50,6,47,California,Merced County,2,9,15724,7975,7749
50,6,47,California,Merced County,2,10,16149,8020,8129
50,6,47,California,Merced County,2,11,14862,7452,7410
50,6,47,California,Merced County,2,12,12363,6132,6231
50,6,47,California,Merced County,2,13,10282,5093,5189
50,6,47,California,Merced County,2,14,7606,3606,4000
50,6,47,California,Merced County,2,15,5599,2589,3010
50,6,47,California,Merced County,2,16,4470,1993,2477
50,6,47,California,Merced County,2,17,3247,1334,1913
50,6,47,California,Merced County,2,18,3038,1081,1957
50,6,47,California,Merced County,3,0,256721,129163,127558
50,6,47,California,Merced County,3,1,22228,11396,10832
50,6,47,California,Merced County,3,2,22222,11336,10886
50,6,47,California,Merced County,3,3,22081,11357,10724
50,6,47,California,Merced County,3,4,24400,12678,11722
50,6,47,California,Merced County,3,5,20520,10669,9851
50,6,47,California,Merced County,3,6,18309,9486,8823
50,6,47,California,Merced County,3,7,17001,8647,8354
50,6,47,California,Merced County,3,8,16243,8134,8109
50,6,47,California,Merced County,3,9,15728,7977,7751
50,6,47,California,Merced County,3,10,16138,8035,8103
50,6,47,California,Merced County,3,11,14929,7469,7460
50,6,47,California,Merced County,3,12,12446,6169,6277
50,6,47,California,Merced County,3,13,10371,5126,5245
50,6,47,California,Merced County,3,14,7646,3634,4012
50,6,47,California,Merced County,3,15,5646,2611,3035
50,6,47,California,Merced County,3,16,4506,2013,2493
50,6,47,California,Merced County,3,17,3256,1341,1915
50,6,47,California,Merced County,3,18,3051,1085,1966
50,6,47,California,Merced County,4,0,259297,130553,128744
50,6,47,California,Merced County,4,1,21939,11277,10662
50,6,47,California,Merced County,4,2,22235,11354,10881
50,6,47,California,Merced County,4,3,22093,11352,10741
50,6,47,California,Merced County,4,4,23884,12400,11484
50,6,47,California,Merced County,4,5,21595,11245,10350
50,6,47,California,Merced County,4,6,18466,9572,8894
50,6,47,California,Merced County,4,7,17283,8781,8502
50,6,47,California,Merced County,4,8,16120,8088,8032
50,6,47,California,Merced County,4,9,15852,8006,7846
50,6,47,California,Merced County,4,10,16061,8094,7967
50,6,47,California,Merced County,4,11,15196,7565,7631
50,6,47,California,Merced County,4,12,12848,6385,6463
50,6,47,California,Merced County,4,13,10850,5366,5484
50,6,47,California,Merced County,4,14,7919,3800,4119
50,6,47,California,Merced County,4,15,5846,2710,3136
50,6,47,California,Merced County,4,16,4627,2060,2567
50,6,47,California,Merced County,4,17,3303,1369,1934
50,6,47,California,Merced County,4,18,3180,1129,2051
50,6,47,California,Merced County,5,0,260867,131539,129328
50,6,47,California,Merced County,5,1,21626,11145,10481
50,6,47,California,Merced County,5,2,22544,11479,11065
50,6,47,California,Merced County,5,3,22056,11270,10786
50,6,47,California,Merced County,5,4,23111,12063,11048
50,6,47,California,Merced County,5,5,21998,11433,10565
50,6,47,California,Merced County,5,6,18651,9720,8931
50,6,47,California,Merced County,5,7,17635,9077,8558
50,6,47,California,Merced County,5,8,15979,8025,7954
50,6,47,California,Merced County,5,9,15952,8058,7894
50,6,47,California,Merced County,5,10,15751,8004,7747
50,6,47,California,Merced County,5,11,15393,7640,7753
50,6,47,California,Merced County,5,12,13290,6619,6671
50,6,47,California,Merced County,5,13,10980,5415,5565
50,6,47,California,Merced County,5,14,8509,4097,4412
50,6,47,California,Merced County,5,15,6109,2861,3248
50,6,47,California,Merced County,5,16,4623,2062,2561
50,6,47,California,Merced County,5,17,3378,1420,1958
50,6,47,California,Merced County,5,18,3282,1151,2131
50,6,47,California,Merced County,6,0,262026,132177,129849
50,6,47,California,Merced County,6,1,21490,10990,10500
50,6,47,California,Merced County,6,2,22553,11587,10966
50,6,47,California,Merced County,6,3,22139,11308,10831
50,6,47,California,Merced County,6,4,22665,11826,10839
50,6,47,California,Merced County,6,5,21919,11357,10562
50,6,47,California,Merced County,6,6,18892,9959,8933
50,6,47,California,Merced County,6,7,17833,9222,8611
50,6,47,California,Merced County,6,8,16029,8028,8001
50,6,47,California,Merced County,6,9,15943,7971,7972
50,6,47,California,Merced County,6,10,15581,7935,7646
50,6,47,California,Merced County,6,11,15404,7672,7732
50,6,47,California,Merced County,6,12,13714,6834,6880
50,6,47,California,Merced County,6,13,11124,5481,5643
50,6,47,California,Merced County,6,14,8874,4256,4618
50,6,47,California,Merced County,6,15,6366,3010,3356
50,6,47,California,Merced County,6,16,4753,2133,2620
50,6,47,California,Merced County,6,17,3382,1416,1966
50,6,47,California,Merced County,6,18,3365,1192,2173
50,6,47,California,Merced County,7,0,264419,133474,130945
50,6,47,California,Merced County,7,1,21547,11047,10500
50,6,47,California,Merced County,7,2,22555,11563,10992
50,6,47,California,Merced County,7,3,22290,11325,10965
50,6,47,California,Merced County,7,4,22759,11785,10974
50,6,47,California,Merced County,7,5,21935,11492,10443
50,6,47,California,Merced County,7,6,19251,10072,9179
50,6,47,California,Merced County,7,7,18001,9403,8598
50,6,47,California,Merced County,7,8,16375,8267,8108
50,6,47,California,Merced County,7,9,15847,7917,7930
50,6,47,California,Merced County,7,10,15457,7858,7599
50,6,47,California,Merced County,7,11,15487,7703,7784
50,6,47,California,Merced County,7,12,13957,7006,6951
50,6,47,California,Merced County,7,13,11307,5538,5769
50,6,47,California,Merced County,7,14,9273,4500,4773
50,6,47,California,Merced County,7,15,6687,3143,3544
50,6,47,California,Merced County,7,16,4801,2155,2646
50,6,47,California,Merced County,7,17,3448,1462,1986
50,6,47,California,Merced County,7,18,3442,1238,2204
50,6,47,California,Merced County,8,0,266353,134406,131947
50,6,47,California,Merced County,8,1,21497,11064,10433
50,6,47,California,Merced County,8,2,22623,11644,10979
50,6,47,California,Merced County,8,3,22345,11290,11055
50,6,47,California,Merced County,8,4,22880,11814,11066
50,6,47,California,Merced County,8,5,21261,11127,10134
50,6,47,California,Merced County,8,6,19980,10445,9535
50,6,47,California,Merced County,8,7,18109,9452,8657
50,6,47,California,Merced County,8,8,16740,8480,8260
50,6,47,California,Merced County,8,9,15760,7826,7934
50,6,47,California,Merced County,8,10,15335,7839,7496
50,6,47,California,Merced County,8,11,15448,7695,7753
50,6,47,California,Merced County,8,12,14235,7078,7157
50,6,47,California,Merced County,8,13,11683,5744,5939
50,6,47,California,Merced County,8,14,9579,4666,4913
50,6,47,California,Merced County,8,15,6935,3273,3662
50,6,47,California,Merced County,8,16,4909,2219,2690
50,6,47,California,Merced County,8,17,3515,1484,2031
50,6,47,California,Merced County,8,18,3519,1266,2253
50,6,47,California,Merced County,9,0,267628,134757,132871
50,6,47,California,Merced County,9,1,21279,10886,10393
50,6,47,California,Merced County,9,2,22680,11704,10976
50,6,47,California,Merced County,9,3,22538,11440,11098
50,6,47,California,Merced County,9,4,22870,11743,11127
50,6,47,California,Merced County,9,5,20592,10693,9899
50,6,47,California,Merced County,9,6,20592,10757,9835
50,6,47,California,Merced County,9,7,18177,9512,8665
50,6,47,California,Merced County,9,8,16869,8489,8380
50,6,47,California,Merced County,9,9,15680,7790,7890
50,6,47,California,Merced County,9,10,15422,7786,7636
50,6,47,California,Merced County,9,11,15197,7623,7574
50,6,47,California,Merced County,9,12,14461,7175,7286
50,6,47,California,Merced County,9,13,11967,5872,6095
50,6,47,California,Merced County,9,14,9861,4800,5061
50,6,47,California,Merced County,9,15,7177,3349,3828
50,6,47,California,Merced County,9,16,5098,2312,2786
50,6,47,California,Merced County,9,17,3576,1515,2061
50,6,47,California,Merced County,9,18,3592,1311,2281
50,6,47,California,Merced County,10,0,271096,136752,134344
50,6,47,California,Merced County,10,1,21488,11009,10479
50,6,47,California,Merced County,10,2,22614,11605,11009
50,6,47,California,Merced County,10,3,22977,11748,11229
50,6,47,California,Merced County,10,4,23457,12021,11436
50,6,47,California,Merced County,10,5,20500,10739,9761
50,6,47,California,Merced County,10,6,20887,10936,9951
50,6,47,California,Merced County,10,7,18567,9771,8796
50,6,47,California,Merced County,10,8,17265,8725,8540
50,6,47,California,Merced County,10,9,15716,7855,7861
50,6,47,California,Merced County,10,10,15584,7784,7800
50,6,47,California,Merced County,10,11,14941,7575,7366
50,6,47,California,Merced County,10,12,14639,7263,7376
50,6,47,California,Merced County,10,13,12508,6122,6386
50,6,47,California,Merced County,10,14,9935,4817,5118
50,6,47,California,Merced County,10,15,7584,3539,4045
50,6,47,California,Merced County,10,16,5246,2402,2844
50,6,47,California,Merced County,10,17,3570,1519,2051
50,6,47,California,Merced County,10,18,3618,1322,2296
50,6,47,California,Merced County,11,0,274151,138267,135884
50,6,47,California,Merced County,11,1,21336,10963,10373
50,6,47,California,Merced County,11,2,22581,11552,11029
50,6,47,California,Merced County,11,3,23173,11882,11291
50,6,47,California,Merced County,11,4,23827,12149,11678
50,6,47,California,Merced County,11,5,20469,10733,9736
50,6,47,California,Merced County,11,6,21192,11027,10165
50,6,47,California,Merced County,11,7,18953,10034,8919
50,6,47,California,Merced County,11,8,17865,9055,8810
50,6,47,California,Merced County,11,9,15814,7912,7902
50,6,47,California,Merced County,11,10,15653,7731,7922
50,6,47,California,Merced County,11,11,14941,7589,7352
50,6,47,California,Merced County,11,12,14718,7365,7353
50,6,47,California,Merced County,11,13,12862,6314,6548
50,6,47,California,Merced County,11,14,10078,4852,5226
50,6,47,California,Merced County,11,15,7973,3717,4256
50,6,47,California,Merced County,11,16,5387,2478,2909
50,6,47,California,Merced County,11,17,3646,1541,2105
50,6,47,California,Merced County,11,18,3683,1373,2310
50,6,47,California,Merced County,12,0,277680,140185,137495
50,6,47,California,Merced County,12,1,21268,10933,10335
50,6,47,California,Merced County,12,2,22923,11751,11172
50,6,47,California,Merced County,12,3,23301,11945,11356
50,6,47,California,Merced County,12,4,24486,12448,12038
50,6,47,California,Merced County,12,5,20284,10586,9698
50,6,47,California,Merced County,12,6,21519,11296,10223
50,6,47,California,Merced County,12,7,19254,10125,9129
50,6,47,California,Merced County,12,8,18182,9332,8850
50,6,47,California,Merced County,12,9,16211,8167,8044
50,6,47,California,Merced County,12,10,15686,7709,7977
50,6,47,California,Merced County,12,11,14933,7568,7365
50,6,47,California,Merced County,12,12,14785,7416,7369
50,6,47,California,Merced County,12,13,13212,6541,6671
50,6,47,California,Merced County,12,14,10311,4912,5399
50,6,47,California,Merced County,12,15,8250,3909,4341
50,6,47,California,Merced County,12,16,5675,2606,3069
50,6,47,California,Merced County,12,17,3646,1519,2127
50,6,47,California,Merced County,12,18,3754,1422,2332
50,6,49,California,Modoc County,1,0,9686,4878,4808
50,6,49,California,Modoc County,1,1,545,271,274
50,6,49,California,Modoc County,1,2,564,297,267
50,6,49,California,Modoc County,1,3,602,298,304
50,6,49,California,Modoc County,1,4,604,311,293
50,6,49,California,Modoc County,1,5,422,215,207
50,6,49,California,Modoc County,1,6,446,242,204
50,6,49,California,Modoc County,1,7,458,219,239
50,6,49,California,Modoc County,1,8,506,295,211
50,6,49,California,Modoc County,1,9,556,275,281
50,6,49,California,Modoc County,1,10,708,344,364
50,6,49,California,Modoc County,1,11,736,351,385
50,6,49,California,Modoc County,1,12,807,396,411
50,6,49,California,Modoc County,1,13,827,418,409
50,6,49,California,Modoc County,1,14,634,329,305
50,6,49,California,Modoc County,1,15,474,243,231
50,6,49,California,Modoc County,1,16,351,175,176
50,6,49,California,Modoc County,1,17,219,98,121
50,6,49,California,Modoc County,1,18,227,101,126
50,6,49,California,Modoc County,2,0,9682,4876,4806
50,6,49,California,Modoc County,2,1,543,270,273
50,6,49,California,Modoc County,2,2,564,297,267
50,6,49,California,Modoc County,2,3,602,298,304
50,6,49,California,Modoc County,2,4,604,311,293
50,6,49,California,Modoc County,2,5,422,215,207
50,6,49,California,Modoc County,2,6,446,242,204
50,6,49,California,Modoc County,2,7,457,219,238
50,6,49,California,Modoc County,2,8,505,294,211
50,6,49,California,Modoc County,2,9,556,275,281
50,6,49,California,Modoc County,2,10,708,344,364
50,6,49,California,Modoc County,2,11,736,351,385
50,6,49,California,Modoc County,2,12,807,396,411
50,6,49,California,Modoc County,2,13,827,418,409
50,6,49,California,Modoc County,2,14,634,329,305
50,6,49,California,Modoc County,2,15,474,243,231
50,6,49,California,Modoc County,2,16,351,175,176
50,6,49,California,Modoc County,2,17,219,98,121
50,6,49,California,Modoc County,2,18,227,101,126
50,6,49,California,Modoc County,3,0,9694,4881,4813
50,6,49,California,Modoc County,3,1,548,274,274
50,6,49,California,Modoc County,3,2,561,296,265
50,6,49,California,Modoc County,3,3,596,296,300
50,6,49,California,Modoc County,3,4,609,316,293
50,6,49,California,Modoc County,3,5,421,212,209
50,6,49,California,Modoc County,3,6,453,243,210
50,6,49,California,Modoc County,3,7,460,221,239
50,6,49,California,Modoc County,3,8,498,288,210
50,6,49,California,Modoc County,3,9,556,278,278
50,6,49,California,Modoc County,3,10,697,338,359
50,6,49,California,Modoc County,3,11,739,351,388
50,6,49,California,Modoc County,3,12,805,396,409
50,6,49,California,Modoc County,3,13,834,419,415
50,6,49,California,Modoc County,3,14,632,325,307
50,6,49,California,Modoc County,3,15,484,251,233
50,6,49,California,Modoc County,3,16,348,168,180
50,6,49,California,Modoc County,3,17,229,108,121
50,6,49,California,Modoc County,3,18,224,101,123
50,6,49,California,Modoc County,4,0,9509,4803,4706
50,6,49,California,Modoc County,4,1,492,251,241
50,6,49,California,Modoc County,4,2,540,287,253
50,6,49,California,Modoc County,4,3,568,281,287
50,6,49,California,Modoc County,4,4,624,337,287
50,6,49,California,Modoc County,4,5,390,202,188
50,6,49,California,Modoc County,4,6,442,237,205
50,6,49,California,Modoc County,4,7,464,219,245
50,6,49,California,Modoc County,4,8,474,271,203
50,6,49,California,Modoc County,4,9,550,285,265
50,6,49,California,Modoc County,4,10,632,292,340
50,6,49,California,Modoc County,4,11,741,351,390
50,6,49,California,Modoc County,4,12,782,392,390
50,6,49,California,Modoc County,4,13,858,432,426
50,6,49,California,Modoc County,4,14,619,307,312
50,6,49,California,Modoc County,4,15,513,278,235
50,6,49,California,Modoc County,4,16,332,156,176
50,6,49,California,Modoc County,4,17,260,126,134
50,6,49,California,Modoc County,4,18,228,99,129
50,6,49,California,Modoc County,5,0,9351,4734,4617
50,6,49,California,Modoc County,5,1,464,239,225
50,6,49,California,Modoc County,5,2,525,276,249
50,6,49,California,Modoc County,5,3,566,296,270
50,6,49,California,Modoc County,5,4,610,318,292
50,6,49,California,Modoc County,5,5,404,215,189
50,6,49,California,Modoc County,5,6,417,215,202
50,6,49,California,Modoc County,5,7,448,221,227
50,6,49,California,Modoc County,5,8,468,247,221
50,6,49,California,Modoc County,5,9,545,291,254
50,6,49,California,Modoc County,5,10,562,258,304
50,6,49,California,Modoc County,5,11,725,352,373
50,6,49,California,Modoc County,5,12,774,388,386
50,6,49,California,Modoc County,5,13,816,415,401
50,6,49,California,Modoc County,5,14,681,337,344
50,6,49,California,Modoc County,5,15,528,282,246
50,6,49,California,Modoc County,5,16,326,157,169
50,6,49,California,Modoc County,5,17,256,122,134
50,6,49,California,Modoc County,5,18,236,105,131
50,6,49,California,Modoc County,6,0,9145,4635,4510
50,6,49,California,Modoc County,6,1,455,236,219
50,6,49,California,Modoc County,6,2,499,265,234
50,6,49,California,Modoc County,6,3,530,289,241
50,6,49,California,Modoc County,6,4,559,294,265
50,6,49,California,Modoc County,6,5,400,212,188
50,6,49,California,Modoc County,6,6,400,205,195
50,6,49,California,Modoc County,6,7,463,236,227
50,6,49,California,Modoc County,6,8,455,233,222
50,6,49,California,Modoc County,6,9,508,278,230
50,6,49,California,Modoc County,6,10,520,241,279
50,6,49,California,Modoc County,6,11,683,331,352
50,6,49,California,Modoc County,6,12,755,370,385
50,6,49,California,Modoc County,6,13,803,396,407
50,6,49,California,Modoc County,6,14,722,363,359
50,6,49,California,Modoc County,6,15,564,296,268
50,6,49,California,Modoc County,6,16,329,163,166
50,6,49,California,Modoc County,6,17,254,120,134
50,6,49,California,Modoc County,6,18,246,107,139
50,6,49,California,Modoc County,7,0,9068,4573,4495
50,6,49,California,Modoc County,7,1,453,227,226
50,6,49,California,Modoc County,7,2,491,252,239
50,6,49,California,Modoc County,7,3,534,293,241
50,6,49,California,Modoc County,7,4,505,256,249
50,6,49,California,Modoc County,7,5,415,227,188
50,6,49,California,Modoc County,7,6,409,202,207
50,6,49,California,Modoc County,7,7,458,245,213
50,6,49,California,Modoc County,7,8,451,221,230
50,6,49,California,Modoc County,7,9,491,269,222
50,6,49,California,Modoc County,7,10,504,242,262
50,6,49,California,Modoc County,7,11,677,335,342
50,6,49,California,Modoc County,7,12,719,335,384
50,6,49,California,Modoc County,7,13,786,388,398
50,6,49,California,Modoc County,7,14,737,371,366
50,6,49,California,Modoc County,7,15,591,314,277
50,6,49,California,Modoc County,7,16,343,171,172
50,6,49,California,Modoc County,7,17,262,122,140
50,6,49,California,Modoc County,7,18,242,103,139
50,6,49,California,Modoc County,8,0,9056,4584,4472
50,6,49,California,Modoc County,8,1,454,226,228
50,6,49,California,Modoc County,8,2,493,254,239
50,6,49,California,Modoc County,8,3,528,296,232
50,6,49,California,Modoc County,8,4,494,253,241
50,6,49,California,Modoc County,8,5,431,230,201
50,6,49,California,Modoc County,8,6,404,208,196
50,6,49,California,Modoc County,8,7,457,237,220
50,6,49,California,Modoc County,8,8,477,236,241
50,6,49,California,Modoc County,8,9,461,251,210
50,6,49,California,Modoc County,8,10,501,251,250
50,6,49,California,Modoc County,8,11,665,313,352
50,6,49,California,Modoc County,8,12,676,318,358
50,6,49,California,Modoc County,8,13,771,391,380
50,6,49,California,Modoc County,8,14,770,392,378
50,6,49,California,Modoc County,8,15,590,313,277
50,6,49,California,Modoc County,8,16,372,182,190
50,6,49,California,Modoc County,8,17,268,118,150
50,6,49,California,Modoc County,8,18,244,115,129
50,6,49,California,Modoc County,9,0,8961,4526,4435
50,6,49,California,Modoc County,9,1,462,214,248
50,6,49,California,Modoc County,9,2,518,275,243
50,6,49,California,Modoc County,9,3,508,276,232
50,6,49,California,Modoc County,9,4,451,230,221
50,6,49,California,Modoc County,9,5,417,227,190
50,6,49,California,Modoc County,9,6,437,220,217
50,6,49,California,Modoc County,9,7,455,229,226
50,6,49,California,Modoc County,9,8,477,245,232
50,6,49,California,Modoc County,9,9,441,228,213
50,6,49,California,Modoc County,9,10,490,250,240
50,6,49,California,Modoc County,9,11,593,274,319
50,6,49,California,Modoc County,9,12,679,321,358
50,6,49,California,Modoc County,9,13,750,389,361
50,6,49,California,Modoc County,9,14,789,402,387
50,6,49,California,Modoc County,9,15,576,295,281
50,6,49,California,Modoc County,9,16,413,216,197
50,6,49,California,Modoc County,9,17,249,111,138
50,6,49,California,Modoc County,9,18,256,124,132
50,6,49,California,Modoc County,10,0,8876,4446,4430
50,6,49,California,Modoc County,10,1,458,221,237
50,6,49,California,Modoc County,10,2,503,256,247
50,6,49,California,Modoc County,10,3,498,261,237
50,6,49,California,Modoc County,10,4,429,222,207
50,6,49,California,Modoc County,10,5,404,213,191
50,6,49,California,Modoc County,10,6,463,240,223
50,6,49,California,Modoc County,10,7,440,205,235
50,6,49,California,Modoc County,10,8,438,216,222
50,6,49,California,Modoc County,10,9,439,210,229
50,6,49,California,Modoc County,10,10,488,263,225
50,6,49,California,Modoc County,10,11,543,252,291
50,6,49,California,Modoc County,10,12,704,334,370
50,6,49,California,Modoc County,10,13,752,377,375
50,6,49,California,Modoc County,10,14,748,387,361
50,6,49,California,Modoc County,10,15,623,329,294
50,6,49,California,Modoc County,10,16,430,228,202
50,6,49,California,Modoc County,10,17,256,117,139
50,6,49,California,Modoc County,10,18,260,115,145
50,6,49,California,Modoc County,11,0,8800,4396,4404
50,6,49,California,Modoc County,11,1,434,194,240
50,6,49,California,Modoc County,11,2,500,257,243
50,6,49,California,Modoc County,11,3,478,246,232
50,6,49,California,Modoc County,11,4,438,237,201
50,6,49,California,Modoc County,11,5,396,207,189
50,6,49,California,Modoc County,11,6,450,236,214
50,6,49,California,Modoc County,11,7,437,200,237
50,6,49,California,Modoc County,11,8,459,231,228
50,6,49,California,Modoc County,11,9,431,198,233
50,6,49,California,Modoc County,11,10,467,256,211
50,6,49,California,Modoc County,11,11,502,231,271
50,6,49,California,Modoc County,11,12,669,331,338
50,6,49,California,Modoc County,11,13,761,375,386
50,6,49,California,Modoc County,11,14,759,381,378
50,6,49,California,Modoc County,11,15,640,339,301
50,6,49,California,Modoc County,11,16,458,244,214
50,6,49,California,Modoc County,11,17,259,121,138
50,6,49,California,Modoc County,11,18,262,112,150
50,6,49,California,Modoc County,12,0,8841,4448,4393
50,6,49,California,Modoc County,12,1,425,207,218
50,6,49,California,Modoc County,12,2,497,241,256
50,6,49,California,Modoc County,12,3,476,239,237
50,6,49,California,Modoc County,12,4,469,256,213
50,6,49,California,Modoc County,12,5,378,205,173
50,6,49,California,Modoc County,12,6,468,253,215
50,6,49,California,Modoc County,12,7,444,206,238
50,6,49,California,Modoc County,12,8,473,254,219
50,6,49,California,Modoc County,12,9,430,203,227
50,6,49,California,Modoc County,12,10,473,268,205
50,6,49,California,Modoc County,12,11,490,223,267
50,6,49,California,Modoc County,12,12,658,316,342
50,6,49,California,Modoc County,12,13,729,358,371
50,6,49,California,Modoc County,12,14,769,383,386
50,6,49,California,Modoc County,12,15,648,343,305
50,6,49,California,Modoc County,12,16,481,258,223
50,6,49,California,Modoc County,12,17,267,124,143
50,6,49,California,Modoc County,12,18,266,111,155
50,6,51,California,Mono County,1,0,14202,7548,6654
50,6,51,California,Mono County,1,1,893,439,454
50,6,51,California,Mono County,1,2,828,427,401
50,6,51,California,Mono County,1,3,770,380,390
50,6,51,California,Mono County,1,4,820,425,395
50,6,51,California,Mono County,1,5,1118,628,490
50,6,51,California,Mono County,1,6,1277,706,571
50,6,51,California,Mono County,1,7,976,546,430
50,6,51,California,Mono County,1,8,967,538,429
50,6,51,California,Mono County,1,9,942,510,432
50,6,51,California,Mono County,1,10,1130,560,570
50,6,51,California,Mono County,1,11,1212,652,560
50,6,51,California,Mono County,1,12,1079,570,509
50,6,51,California,Mono County,1,13,813,441,372
50,6,51,California,Mono County,1,14,534,293,241
50,6,51,California,Mono County,1,15,388,178,210
50,6,51,California,Mono County,1,16,236,143,93
50,6,51,California,Mono County,1,17,140,82,58
50,6,51,California,Mono County,1,18,79,30,49
50,6,51,California,Mono County,2,0,14206,7551,6655
50,6,51,California,Mono County,2,1,893,439,454
50,6,51,California,Mono County,2,2,828,427,401
50,6,51,California,Mono County,2,3,770,380,390
50,6,51,California,Mono County,2,4,820,425,395
50,6,51,California,Mono County,2,5,1119,628,491
50,6,51,California,Mono County,2,6,1278,707,571
50,6,51,California,Mono County,2,7,976,546,430
50,6,51,California,Mono County,2,8,967,538,429
50,6,51,California,Mono County,2,9,942,510,432
50,6,51,California,Mono County,2,10,1130,560,570
50,6,51,California,Mono County,2,11,1212,652,560
50,6,51,California,Mono County,2,12,1080,571,509
50,6,51,California,Mono County,2,13,813,441,372
50,6,51,California,Mono County,2,14,534,293,241
50,6,51,California,Mono County,2,15,389,179,210
50,6,51,California,Mono County,2,16,236,143,93
50,6,51,California,Mono County,2,17,140,82,58
50,6,51,California,Mono County,2,18,79,30,49
50,6,51,California,Mono County,3,0,14257,7593,6664
50,6,51,California,Mono County,3,1,868,424,444
50,6,51,California,Mono County,3,2,830,427,403
50,6,51,California,Mono County,3,3,770,381,389
50,6,51,California,Mono County,3,4,827,435,392
50,6,51,California,Mono County,3,5,1132,638,494
50,6,51,California,Mono County,3,6,1293,718,575
50,6,51,California,Mono County,3,7,983,551,432
50,6,51,California,Mono County,3,8,959,533,426
50,6,51,California,Mono County,3,9,945,515,430
50,6,51,California,Mono County,3,10,1124,559,565
50,6,51,California,Mono County,3,11,1223,658,565
50,6,51,California,Mono County,3,12,1081,567,514
50,6,51,California,Mono County,3,13,826,451,375
50,6,51,California,Mono County,3,14,545,300,245
50,6,51,California,Mono County,3,15,393,184,209
50,6,51,California,Mono County,3,16,232,137,95
50,6,51,California,Mono County,3,17,144,85,59
50,6,51,California,Mono County,3,18,82,30,52
50,6,51,California,Mono County,4,0,14422,7679,6743
50,6,51,California,Mono County,4,1,847,411,436
50,6,51,California,Mono County,4,2,843,417,426
50,6,51,California,Mono County,4,3,792,401,391
50,6,51,California,Mono County,4,4,842,448,394
50,6,51,California,Mono County,4,5,1073,607,466
50,6,51,California,Mono County,4,6,1315,744,571
50,6,51,California,Mono County,4,7,1032,542,490
50,6,51,California,Mono County,4,8,940,525,415
50,6,51,California,Mono County,4,9,954,530,424
50,6,51,California,Mono County,4,10,1088,561,527
50,6,51,California,Mono County,4,11,1230,654,576
50,6,51,California,Mono County,4,12,1106,573,533
50,6,51,California,Mono County,4,13,898,491,407
50,6,51,California,Mono County,4,14,591,328,263
50,6,51,California,Mono County,4,15,389,188,201
50,6,51,California,Mono County,4,16,228,125,103
50,6,51,California,Mono County,4,17,161,98,63
50,6,51,California,Mono County,4,18,93,36,57
50,6,51,California,Mono County,5,0,14331,7674,6657
50,6,51,California,Mono County,5,1,803,377,426
50,6,51,California,Mono County,5,2,837,428,409
50,6,51,California,Mono County,5,3,767,395,372
50,6,51,California,Mono County,5,4,834,445,389
50,6,51,California,Mono County,5,5,1013,581,432
50,6,51,California,Mono County,5,6,1299,745,554
50,6,51,California,Mono County,5,7,1078,567,511
50,6,51,California,Mono County,5,8,908,513,395
50,6,51,California,Mono County,5,9,940,507,433
50,6,51,California,Mono County,5,10,1025,545,480
50,6,51,California,Mono County,5,11,1230,653,577
50,6,51,California,Mono County,5,12,1099,593,506
50,6,51,California,Mono County,5,13,942,497,445
50,6,51,California,Mono County,5,14,634,358,276
50,6,51,California,Mono County,5,15,390,185,205
50,6,51,California,Mono County,5,16,251,133,118
50,6,51,California,Mono County,5,17,181,112,69
50,6,51,California,Mono County,5,18,100,40,60
50,6,51,California,Mono County,6,0,14067,7491,6576
50,6,51,California,Mono County,6,1,752,358,394
50,6,51,California,Mono County,6,2,828,404,424
50,6,51,California,Mono County,6,3,736,376,360
50,6,51,California,Mono County,6,4,793,428,365
50,6,51,California,Mono County,6,5,996,571,425
50,6,51,California,Mono County,6,6,1180,652,528
50,6,51,California,Mono County,6,7,1117,572,545
50,6,51,California,Mono County,6,8,852,489,363
50,6,51,California,Mono County,6,9,942,516,426
50,6,51,California,Mono County,6,10,939,511,428
50,6,51,California,Mono County,6,11,1197,621,576
50,6,51,California,Mono County,6,12,1102,604,498
50,6,51,California,Mono County,6,13,1001,527,474
50,6,51,California,Mono County,6,14,635,343,292
50,6,51,California,Mono County,6,15,430,224,206
50,6,51,California,Mono County,6,16,258,125,133
50,6,51,California,Mono County,6,17,192,119,73
50,6,51,California,Mono County,6,18,117,51,66
50,6,51,California,Mono County,7,0,14134,7517,6617
50,6,51,California,Mono County,7,1,746,355,391
50,6,51,California,Mono County,7,2,820,390,430
50,6,51,California,Mono County,7,3,752,372,380
50,6,51,California,Mono County,7,4,768,406,362
50,6,51,California,Mono County,7,5,1052,601,451
50,6,51,California,Mono County,7,6,1151,651,500
50,6,51,California,Mono County,7,7,1156,602,554
50,6,51,California,Mono County,7,8,842,459,383
50,6,51,California,Mono County,7,9,919,509,410
50,6,51,California,Mono County,7,10,905,496,409
50,6,51,California,Mono County,7,11,1147,583,564
50,6,51,California,Mono County,7,12,1123,635,488
50,6,51,California,Mono County,7,13,1005,534,471
50,6,51,California,Mono County,7,14,678,357,321
50,6,51,California,Mono County,7,15,465,250,215
50,6,51,California,Mono County,7,16,286,139,147
50,6,51,California,Mono County,7,17,189,111,78
50,6,51,California,Mono County,7,18,130,67,63
50,6,51,California,Mono County,8,0,14077,7485,6592
50,6,51,California,Mono County,8,1,719,359,360
50,6,51,California,Mono County,8,2,793,382,411
50,6,51,California,Mono County,8,3,757,376,381
50,6,51,California,Mono County,8,4,730,374,356
50,6,51,California,Mono County,8,5,1005,566,439
50,6,51,California,Mono County,8,6,1114,618,496
50,6,51,California,Mono County,8,7,1139,585,554
50,6,51,California,Mono County,8,8,879,478,401
50,6,51,California,Mono County,8,9,853,464,389
50,6,51,California,Mono County,8,10,884,490,394
50,6,51,California,Mono County,8,11,1106,580,526
50,6,51,California,Mono County,8,12,1159,640,519
50,6,51,California,Mono County,8,13,1031,545,486
50,6,51,California,Mono County,8,14,773,422,351
50,6,51,California,Mono County,8,15,502,279,223
50,6,51,California,Mono County,8,16,301,143,158
50,6,51,California,Mono County,8,17,180,103,77
50,6,51,California,Mono County,8,18,152,81,71
50,6,51,California,Mono County,9,0,14273,7558,6715
50,6,51,California,Mono County,9,1,704,365,339
50,6,51,California,Mono County,9,2,761,362,399
50,6,51,California,Mono County,9,3,785,379,406
50,6,51,California,Mono County,9,4,754,403,351
50,6,51,California,Mono County,9,5,982,534,448
50,6,51,California,Mono County,9,6,1074,610,464
50,6,51,California,Mono County,9,7,1147,565,582
50,6,51,California,Mono County,9,8,918,488,430
50,6,51,California,Mono County,9,9,876,469,407
50,6,51,California,Mono County,9,10,922,517,405
50,6,51,California,Mono County,9,11,1070,571,499
50,6,51,California,Mono County,9,12,1169,637,532
50,6,51,California,Mono County,9,13,1070,566,504
50,6,51,California,Mono County,9,14,840,450,390
50,6,51,California,Mono County,9,15,550,308,242
50,6,51,California,Mono County,9,16,308,151,157
50,6,51,California,Mono County,9,17,172,96,76
50,6,51,California,Mono County,9,18,171,87,84
50,6,51,California,Mono County,10,0,14354,7614,6740
50,6,51,California,Mono County,10,1,718,384,334
50,6,51,California,Mono County,10,2,723,339,384
50,6,51,California,Mono County,10,3,771,392,379
50,6,51,California,Mono County,10,4,755,390,365
50,6,51,California,Mono County,10,5,1041,579,462
50,6,51,California,Mono County,10,6,1026,584,442
50,6,51,California,Mono County,10,7,1176,578,598
50,6,51,California,Mono County,10,8,969,512,457
50,6,51,California,Mono County,10,9,864,471,393
50,6,51,California,Mono County,10,10,915,487,428
50,6,51,California,Mono County,10,11,994,544,450
50,6,51,California,Mono County,10,12,1172,634,538
50,6,51,California,Mono County,10,13,1087,574,513
50,6,51,California,Mono County,10,14,863,455,408
50,6,51,California,Mono County,10,15,579,335,244
50,6,51,California,Mono County,10,16,327,164,163
50,6,51,California,Mono County,10,17,183,93,90
50,6,51,California,Mono County,10,18,191,99,92
50,6,51,California,Mono County,11,0,14403,7635,6768
50,6,51,California,Mono County,11,1,707,373,334
50,6,51,California,Mono County,11,2,704,331,373
50,6,51,California,Mono County,11,3,778,393,385
50,6,51,California,Mono County,11,4,751,392,359
50,6,51,California,Mono County,11,5,1024,593,431
50,6,51,California,Mono County,11,6,1029,577,452
50,6,51,California,Mono County,11,7,1141,533,608
50,6,51,California,Mono County,11,8,985,515,470
50,6,51,California,Mono County,11,9,872,483,389
50,6,51,California,Mono County,11,10,945,516,429
50,6,51,California,Mono County,11,11,942,531,411
50,6,51,California,Mono County,11,12,1158,594,564
50,6,51,California,Mono County,11,13,1112,600,512
50,6,51,California,Mono County,11,14,895,478,417
50,6,51,California,Mono County,11,15,572,322,250
50,6,51,California,Mono County,11,16,385,201,184
50,6,51,California,Mono County,11,17,198,96,102
50,6,51,California,Mono County,11,18,205,107,98
50,6,51,California,Mono County,12,0,14444,7658,6786
50,6,51,California,Mono County,12,1,687,380,307
50,6,51,California,Mono County,12,2,679,328,351
50,6,51,California,Mono County,12,3,745,360,385
50,6,51,California,Mono County,12,4,775,398,377
50,6,51,California,Mono County,12,5,993,590,403
50,6,51,California,Mono County,12,6,1078,588,490
50,6,51,California,Mono County,12,7,1162,542,620
50,6,51,California,Mono County,12,8,986,514,472
50,6,51,California,Mono County,12,9,870,450,420
50,6,51,California,Mono County,12,10,953,531,422
50,6,51,California,Mono County,12,11,895,495,400
50,6,51,California,Mono County,12,12,1122,587,535
50,6,51,California,Mono County,12,13,1169,657,512
50,6,51,California,Mono County,12,14,885,474,411
50,6,51,California,Mono County,12,15,596,325,271
50,6,51,California,Mono County,12,16,409,218,191
50,6,51,California,Mono County,12,17,231,118,113
50,6,51,California,Mono County,12,18,209,103,106
50,6,53,California,Monterey County,1,0,415057,213431,201626
50,6,53,California,Monterey County,1,1,32547,16723,15824
50,6,53,California,Monterey County,1,2,30577,15797,14780
50,6,53,California,Monterey County,1,3,29037,14861,14176
50,6,53,California,Monterey County,1,4,32624,16940,15684
50,6,53,California,Monterey County,1,5,32481,17714,14767
50,6,53,California,Monterey County,1,6,32063,17292,14771
50,6,53,California,Monterey County,1,7,30014,16248,13766
50,6,53,California,Monterey County,1,8,27767,14862,12905
50,6,53,California,Monterey County,1,9,27053,14550,12503
50,6,53,California,Monterey County,1,10,26678,13946,12732
50,6,53,California,Monterey County,1,11,26576,13483,13093
50,6,53,California,Monterey County,1,12,23558,11799,11759
50,6,53,California,Monterey County,1,13,19660,9784,9876
50,6,53,California,Monterey County,1,14,13390,6413,6977
50,6,53,California,Monterey County,1,15,9531,4447,5084
50,6,53,California,Monterey County,1,16,8090,3499,4591
50,6,53,California,Monterey County,1,17,6654,2725,3929
50,6,53,California,Monterey County,1,18,6757,2348,4409
50,6,53,California,Monterey County,2,0,415059,213431,201628
50,6,53,California,Monterey County,2,1,32548,16723,15825
50,6,53,California,Monterey County,2,2,30579,15797,14782
50,6,53,California,Monterey County,2,3,29038,14862,14176
50,6,53,California,Monterey County,2,4,32625,16940,15685
50,6,53,California,Monterey County,2,5,32482,17715,14767
50,6,53,California,Monterey County,2,6,32062,17292,14770
50,6,53,California,Monterey County,2,7,30014,16248,13766
50,6,53,California,Monterey County,2,8,27769,14862,12907
50,6,53,California,Monterey County,2,9,27054,14551,12503
50,6,53,California,Monterey County,2,10,26677,13946,12731
50,6,53,California,Monterey County,2,11,26575,13482,13093
50,6,53,California,Monterey County,2,12,23556,11798,11758
50,6,53,California,Monterey County,2,13,19660,9784,9876
50,6,53,California,Monterey County,2,14,13390,6413,6977
50,6,53,California,Monterey County,2,15,9530,4447,5083
50,6,53,California,Monterey County,2,16,8090,3499,4591
50,6,53,California,Monterey County,2,17,6654,2725,3929
50,6,53,California,Monterey County,2,18,6756,2347,4409
50,6,53,California,Monterey County,3,0,416373,214195,202178
50,6,53,California,Monterey County,3,1,32696,16803,15893
50,6,53,California,Monterey County,3,2,30683,15833,14850
50,6,53,California,Monterey County,3,3,28995,14848,14147
50,6,53,California,Monterey County,3,4,32470,16846,15624
50,6,53,California,Monterey County,3,5,32595,17785,14810
50,6,53,California,Monterey County,3,6,32145,17347,14798
50,6,53,California,Monterey County,3,7,30272,16394,13878
50,6,53,California,Monterey County,3,8,27779,14879,12900
50,6,53,California,Monterey County,3,9,27138,14625,12513
50,6,53,California,Monterey County,3,10,26704,13985,12719
50,6,53,California,Monterey County,3,11,26616,13485,13131
50,6,53,California,Monterey County,3,12,23661,11886,11775
50,6,53,California,Monterey County,3,13,19925,9894,10031
50,6,53,California,Monterey County,3,14,13540,6497,7043
50,6,53,California,Monterey County,3,15,9608,4484,5124
50,6,53,California,Monterey County,3,16,8036,3485,4551
50,6,53,California,Monterey County,3,17,6691,2751,3940
50,6,53,California,Monterey County,3,18,6819,2368,4451
50,6,53,California,Monterey County,4,0,420456,216011,204445
50,6,53,California,Monterey County,4,1,33416,17158,16258
50,6,53,California,Monterey County,4,2,31373,16100,15273
50,6,53,California,Monterey County,4,3,28994,14849,14145
50,6,53,California,Monterey County,4,4,31697,16399,15298
50,6,53,California,Monterey County,4,5,32967,17879,15088
50,6,53,California,Monterey County,4,6,32320,17343,14977
50,6,53,California,Monterey County,4,7,30976,16702,14274
50,6,53,California,Monterey County,4,8,27634,14811,12823
50,6,53,California,Monterey County,4,9,27405,14753,12652
50,6,53,California,Monterey County,4,10,26421,13901,12520
50,6,53,California,Monterey County,4,11,26672,13470,13202
50,6,53,California,Monterey County,4,12,23973,12084,11889
50,6,53,California,Monterey County,4,13,20803,10293,10510
50,6,53,California,Monterey County,4,14,14159,6845,7314
50,6,53,California,Monterey County,4,15,9919,4654,5265
50,6,53,California,Monterey County,4,16,7907,3471,4436
50,6,53,California,Monterey County,4,17,6805,2851,3954
50,6,53,California,Monterey County,4,18,7015,2448,4567
50,6,53,California,Monterey County,5,0,424788,217995,206793
50,6,53,California,Monterey County,5,1,33499,17206,16293
50,6,53,California,Monterey County,5,2,32175,16556,15619
50,6,53,California,Monterey County,5,3,29317,14942,14375
50,6,53,California,Monterey County,5,4,31074,15974,15100
50,6,53,California,Monterey County,5,5,33430,18159,15271
50,6,53,California,Monterey County,5,6,32343,17272,15071
50,6,53,California,Monterey County,5,7,31532,16930,14602
50,6,53,California,Monterey County,5,8,27873,14934,12939
50,6,53,California,Monterey County,5,9,27544,14782,12762
50,6,53,California,Monterey County,5,10,26135,13861,12274
50,6,53,California,Monterey County,5,11,26623,13470,13153
50,6,53,California,Monterey County,5,12,24508,12272,12236
50,6,53,California,Monterey County,5,13,20923,10360,10563
50,6,53,California,Monterey County,5,14,15566,7531,8035
50,6,53,California,Monterey County,5,15,10343,4859,5484
50,6,53,California,Monterey County,5,16,7921,3487,4434
50,6,53,California,Monterey County,5,17,6750,2860,3890
50,6,53,California,Monterey County,5,18,7232,2540,4692
50,6,53,California,Monterey County,6,0,426712,218434,208278
50,6,53,California,Monterey County,6,1,33355,17048,16307
50,6,53,California,Monterey County,6,2,32867,16884,15983
50,6,53,California,Monterey County,6,3,29611,15114,14497
50,6,53,California,Monterey County,6,4,30477,15619,14858
50,6,53,California,Monterey County,6,5,33238,17861,15377
50,6,53,California,Monterey County,6,6,32062,17097,14965
50,6,53,California,Monterey County,6,7,31770,17043,14727
50,6,53,California,Monterey County,6,8,28047,15012,13035
50,6,53,California,Monterey County,6,9,27338,14606,12732
50,6,53,California,Monterey County,6,10,26017,13860,12157
50,6,53,California,Monterey County,6,11,26283,13296,12987
50,6,53,California,Monterey County,6,12,24813,12260,12553
50,6,53,California,Monterey County,6,13,21310,10597,10713
50,6,53,California,Monterey County,6,14,16410,7888,8522
50,6,53,California,Monterey County,6,15,10969,5176,5793
50,6,53,California,Monterey County,6,16,7984,3552,4432
50,6,53,California,Monterey County,6,17,6690,2841,3849
50,6,53,California,Monterey County,6,18,7471,2680,4791
50,6,53,California,Monterey County,7,0,428475,218646,209829
50,6,53,California,Monterey County,7,1,33293,17007,16286
50,6,53,California,Monterey County,7,2,33106,16911,16195
50,6,53,California,Monterey County,7,3,29995,15301,14694
50,6,53,California,Monterey County,7,4,30009,15358,14651
50,6,53,California,Monterey County,7,5,33140,17571,15569
50,6,53,California,Monterey County,7,6,31725,16838,14887
50,6,53,California,Monterey County,7,7,31871,17030,14841
50,6,53,California,Monterey County,7,8,28049,14967,13082
50,6,53,California,Monterey County,7,9,27164,14501,12663
50,6,53,California,Monterey County,7,10,25788,13721,12067
50,6,53,California,Monterey County,7,11,26006,13165,12841
50,6,53,California,Monterey County,7,12,25045,12335,12710
50,6,53,California,Monterey County,7,13,21813,10766,11047
50,6,53,California,Monterey County,7,14,17362,8391,8971
50,6,53,California,Monterey County,7,15,11622,5480,6142
50,6,53,California,Monterey County,7,16,8128,3686,4442
50,6,53,California,Monterey County,7,17,6620,2801,3819
50,6,53,California,Monterey County,7,18,7739,2817,4922
50,6,53,California,Monterey County,8,0,430552,219525,211027
50,6,53,California,Monterey County,8,1,33057,16806,16251
50,6,53,California,Monterey County,8,2,33140,16963,16177
50,6,53,California,Monterey County,8,3,30443,15638,14805
50,6,53,California,Monterey County,8,4,30131,15314,14817
50,6,53,California,Monterey County,8,5,32664,17261,15403
50,6,53,California,Monterey County,8,6,31530,16721,14809
50,6,53,California,Monterey County,8,7,31641,16886,14755
50,6,53,California,Monterey County,8,8,28718,15285,13433
50,6,53,California,Monterey County,8,9,26646,14237,12409
50,6,53,California,Monterey County,8,10,26049,13805,12244
50,6,53,California,Monterey County,8,11,25519,12988,12531
50,6,53,California,Monterey County,8,12,25296,12436,12860
50,6,53,California,Monterey County,8,13,22272,10997,11275
50,6,53,California,Monterey County,8,14,18238,8837,9401
50,6,53,California,Monterey County,8,15,12300,5795,6505
50,6,53,California,Monterey County,8,16,8386,3848,4538
50,6,53,California,Monterey County,8,17,6612,2816,3796
50,6,53,California,Monterey County,8,18,7910,2892,5018
50,6,53,California,Monterey County,9,0,433953,221571,212382
50,6,53,California,Monterey County,9,1,32367,16551,15816
50,6,53,California,Monterey County,9,2,33382,17068,16314
50,6,53,California,Monterey County,9,3,31022,15887,15135
50,6,53,California,Monterey County,9,4,30406,15396,15010
50,6,53,California,Monterey County,9,5,32100,16958,15142
50,6,53,California,Monterey County,9,6,31709,16827,14882
50,6,53,California,Monterey County,9,7,31798,17109,14689
50,6,53,California,Monterey County,9,8,29204,15501,13703
50,6,53,California,Monterey County,9,9,26588,14284,12304
50,6,53,California,Monterey County,9,10,26377,14018,12359
50,6,53,California,Monterey County,9,11,25327,13006,12321
50,6,53,California,Monterey County,9,12,25496,12479,13017
50,6,53,California,Monterey County,9,13,22671,11254,11417
50,6,53,California,Monterey County,9,14,19212,9285,9927
50,6,53,California,Monterey County,9,15,12953,6140,6813
50,6,53,California,Monterey County,9,16,8719,4011,4708
50,6,53,California,Monterey County,9,17,6487,2770,3717
50,6,53,California,Monterey County,9,18,8135,3027,5108
50,6,53,California,Monterey County,10,0,434534,221680,212854
50,6,53,California,Monterey County,10,1,31459,16019,15440
50,6,53,California,Monterey County,10,2,33209,17037,16172
50,6,53,California,Monterey County,10,3,31717,16240,15477
50,6,53,California,Monterey County,10,4,30451,15282,15169
50,6,53,California,Monterey County,10,5,31143,16348,14795
50,6,53,California,Monterey County,10,6,31707,16795,14912
50,6,53,California,Monterey County,10,7,31289,16786,14503
50,6,53,California,Monterey County,10,8,29594,15730,13864
50,6,53,California,Monterey County,10,9,26741,14383,12358
50,6,53,California,Monterey County,10,10,26394,14016,12378
50,6,53,California,Monterey County,10,11,25055,12994,12061
50,6,53,California,Monterey County,10,12,25386,12480,12906
50,6,53,California,Monterey County,10,13,23215,11459,11756
50,6,53,California,Monterey County,10,14,19331,9356,9975
50,6,53,California,Monterey County,10,15,14108,6682,7426
50,6,53,California,Monterey County,10,16,9032,4217,4815
50,6,53,California,Monterey County,10,17,6422,2742,3680
50,6,53,California,Monterey County,10,18,8281,3114,5167
50,6,53,California,Monterey County,11,0,433950,220969,212981
50,6,53,California,Monterey County,11,1,30682,15648,15034
50,6,53,California,Monterey County,11,2,32682,16749,15933
50,6,53,California,Monterey County,11,3,32156,16455,15701
50,6,53,California,Monterey County,11,4,30734,15416,15318
50,6,53,California,Monterey County,11,5,30409,15802,14607
50,6,53,California,Monterey County,11,6,31284,16479,14805
50,6,53,California,Monterey County,11,7,30862,16601,14261
50,6,53,California,Monterey County,11,8,29709,15754,13955
50,6,53,California,Monterey County,11,9,26973,14477,12496
50,6,53,California,Monterey County,11,10,26104,13835,12269
50,6,53,California,Monterey County,11,11,24893,12999,11894
50,6,53,California,Monterey County,11,12,25089,12371,12718
50,6,53,California,Monterey County,11,13,23476,11412,12064
50,6,53,California,Monterey County,11,14,19680,9542,10138
50,6,53,California,Monterey County,11,15,14843,7009,7834
50,6,53,California,Monterey County,11,16,9536,4466,5070
50,6,53,California,Monterey County,11,17,6517,2832,3685
50,6,53,California,Monterey County,11,18,8321,3122,5199
50,6,53,California,Monterey County,12,0,434061,221129,212932
50,6,53,California,Monterey County,12,1,29933,15315,14618
50,6,53,California,Monterey County,12,2,32389,16618,15771
50,6,53,California,Monterey County,12,3,32076,16375,15701
50,6,53,California,Monterey County,12,4,31185,15671,15514
50,6,53,California,Monterey County,12,5,30002,15590,14412
50,6,53,California,Monterey County,12,6,31440,16547,14893
50,6,53,California,Monterey County,12,7,30550,16495,14055
50,6,53,California,Monterey County,12,8,29844,15937,13907
50,6,53,California,Monterey County,12,9,26929,14339,12590
50,6,53,California,Monterey County,12,10,26087,13850,12237
50,6,53,California,Monterey County,12,11,24584,12810,11774
50,6,53,California,Monterey County,12,12,24728,12259,12469
50,6,53,California,Monterey County,12,13,23583,11476,12107
50,6,53,California,Monterey County,12,14,20044,9670,10374
50,6,53,California,Monterey County,12,15,15669,7440,8229
50,6,53,California,Monterey County,12,16,10048,4698,5350
50,6,53,California,Monterey County,12,17,6594,2921,3673
50,6,53,California,Monterey County,12,18,8376,3118,5258
50,6,55,California,Napa County,1,0,136484,68159,68325
50,6,55,California,Napa County,1,1,8131,4196,3935
50,6,55,California,Napa County,1,2,8576,4411,4165
50,6,55,California,Napa County,1,3,9040,4639,4401
50,6,55,California,Napa County,1,4,9473,4836,4637
50,6,55,California,Napa County,1,5,8289,4461,3828
50,6,55,California,Napa County,1,6,8519,4511,4008
50,6,55,California,Napa County,1,7,8236,4255,3981
50,6,55,California,Napa County,1,8,8526,4363,4163
50,6,55,California,Napa County,1,9,9325,4614,4711
50,6,55,California,Napa County,1,10,9937,4960,4977
50,6,55,California,Napa County,1,11,9995,4995,5000
50,6,55,California,Napa County,1,12,9423,4544,4879
50,6,55,California,Napa County,1,13,8420,4144,4276
50,6,55,California,Napa County,1,14,6161,2976,3185
50,6,55,California,Napa County,1,15,4361,2065,2296
50,6,55,California,Napa County,1,16,3628,1671,1957
50,6,55,California,Napa County,1,17,2948,1252,1696
50,6,55,California,Napa County,1,18,3496,1266,2230
50,6,55,California,Napa County,2,0,136535,68199,68336
50,6,55,California,Napa County,2,1,8131,4196,3935
50,6,55,California,Napa County,2,2,8576,4411,4165
50,6,55,California,Napa County,2,3,9040,4639,4401
50,6,55,California,Napa County,2,4,9473,4836,4637
50,6,55,California,Napa County,2,5,8291,4463,3828
50,6,55,California,Napa County,2,6,8526,4517,4009
50,6,55,California,Napa County,2,7,8238,4256,3982
50,6,55,California,Napa County,2,8,8532,4369,4163
50,6,55,California,Napa County,2,9,9335,4622,4713
50,6,55,California,Napa County,2,10,9947,4968,4979
50,6,55,California,Napa County,2,11,10001,4999,5002
50,6,55,California,Napa County,2,12,9427,4548,4879
50,6,55,California,Napa County,2,13,8419,4143,4276
50,6,55,California,Napa County,2,14,6163,2977,3186
50,6,55,California,Napa County,2,15,4363,2065,2298
50,6,55,California,Napa County,2,16,3628,1671,1957
50,6,55,California,Napa County,2,17,2948,1252,1696
50,6,55,California,Napa County,2,18,3497,1267,2230
50,6,55,California,Napa County,3,0,136759,68288,68471
50,6,55,California,Napa County,3,1,8132,4199,3933
50,6,55,California,Napa County,3,2,8594,4425,4169
50,6,55,California,Napa County,3,3,9052,4641,4411
50,6,55,California,Napa County,3,4,9444,4815,4629
50,6,55,California,Napa County,3,5,8345,4489,3856
50,6,55,California,Napa County,3,6,8545,4526,4019
50,6,55,California,Napa County,3,7,8253,4260,3993
50,6,55,California,Napa County,3,8,8518,4357,4161
50,6,55,California,Napa County,3,9,9306,4616,4690
50,6,55,California,Napa County,3,10,9925,4957,4968
50,6,55,California,Napa County,3,11,10026,4999,5027
50,6,55,California,Napa County,3,12,9441,4549,4892
50,6,55,California,Napa County,3,13,8489,4186,4303
50,6,55,California,Napa County,3,14,6214,2996,3218
50,6,55,California,Napa County,3,15,4405,2085,2320
50,6,55,California,Napa County,3,16,3635,1680,1955
50,6,55,California,Napa County,3,17,2937,1252,1685
50,6,55,California,Napa County,3,18,3498,1256,2242
50,6,55,California,Napa County,4,0,137691,68686,69005
50,6,55,California,Napa County,4,1,8048,4137,3911
50,6,55,California,Napa County,4,2,8642,4472,4170
50,6,55,California,Napa County,4,3,9051,4619,4432
50,6,55,California,Napa County,4,4,9354,4770,4584
50,6,55,California,Napa County,4,5,8464,4550,3914
50,6,55,California,Napa County,4,6,8531,4464,4067
50,6,55,California,Napa County,4,7,8476,4358,4118
50,6,55,California,Napa County,4,8,8454,4291,4163
50,6,55,California,Napa County,4,9,9252,4614,4638
50,6,55,California,Napa County,4,10,9779,4918,4861
50,6,55,California,Napa County,4,11,10099,5021,5078
50,6,55,California,Napa County,4,12,9491,4566,4925
50,6,55,California,Napa County,4,13,8832,4367,4465
50,6,55,California,Napa County,4,14,6435,3100,3335
50,6,55,California,Napa County,4,15,4597,2184,2413
50,6,55,California,Napa County,4,16,3688,1710,1978
50,6,55,California,Napa County,4,17,2925,1263,1662
50,6,55,California,Napa County,4,18,3573,1282,2291
50,6,55,California,Napa County,5,0,138538,69104,69434
50,6,55,California,Napa County,5,1,7932,4102,3830
50,6,55,California,Napa County,5,2,8667,4483,4184
50,6,55,California,Napa County,5,3,8921,4517,4404
50,6,55,California,Napa County,5,4,9247,4730,4517
50,6,55,California,Napa County,5,5,8702,4644,4058
50,6,55,California,Napa County,5,6,8484,4434,4050
50,6,55,California,Napa County,5,7,8575,4405,4170
50,6,55,California,Napa County,5,8,8497,4319,4178
50,6,55,California,Napa County,5,9,9210,4581,4629
50,6,55,California,Napa County,5,10,9615,4831,4784
50,6,55,California,Napa County,5,11,10010,4992,5018
50,6,55,California,Napa County,5,12,9682,4663,5019
50,6,55,California,Napa County,5,13,8800,4336,4464
50,6,55,California,Napa County,5,14,7073,3402,3671
50,6,55,California,Napa County,5,15,4840,2326,2514
50,6,55,California,Napa County,5,16,3725,1711,2014
50,6,55,California,Napa County,5,17,2975,1336,1639
50,6,55,California,Napa County,5,18,3583,1292,2291
50,6,55,California,Napa County,6,0,139580,69539,70041
50,6,55,California,Napa County,6,1,7807,4035,3772
50,6,55,California,Napa County,6,2,8642,4475,4167
50,6,55,California,Napa County,6,3,8904,4447,4457
50,6,55,California,Napa County,6,4,9262,4739,4523
50,6,55,California,Napa County,6,5,8952,4692,4260
50,6,55,California,Napa County,6,6,8346,4383,3963
50,6,55,California,Napa County,6,7,8768,4490,4278
50,6,55,California,Napa County,6,8,8530,4354,4176
50,6,55,California,Napa County,6,9,9240,4587,4653
50,6,55,California,Napa County,6,10,9449,4730,4719
50,6,55,California,Napa County,6,11,9949,5024,4925
50,6,55,California,Napa County,6,12,9752,4711,5041
50,6,55,California,Napa County,6,13,8965,4353,4612
50,6,55,California,Napa County,6,14,7417,3600,3817
50,6,55,California,Napa County,6,15,5175,2443,2732
50,6,55,California,Napa County,6,16,3870,1812,2058
50,6,55,California,Napa County,6,17,2958,1360,1598
50,6,55,California,Napa County,6,18,3594,1304,2290
50,6,55,California,Napa County,7,0,140405,70016,70389
50,6,55,California,Napa County,7,1,7626,3971,3655
50,6,55,California,Napa County,7,2,8590,4429,4161
50,6,55,California,Napa County,7,3,8935,4476,4459
50,6,55,California,Napa County,7,4,9192,4705,4487
50,6,55,California,Napa County,7,5,9056,4708,4348
50,6,55,California,Napa County,7,6,8427,4397,4030
50,6,55,California,Napa County,7,7,8865,4550,4315
50,6,55,California,Napa County,7,8,8629,4399,4230
50,6,55,California,Napa County,7,9,9169,4602,4567
50,6,55,California,Napa County,7,10,9368,4676,4692
50,6,55,California,Napa County,7,11,10027,5066,4961
50,6,55,California,Napa County,7,12,9683,4776,4907
50,6,55,California,Napa County,7,13,9105,4328,4777
50,6,55,California,Napa County,7,14,7671,3759,3912
50,6,55,California,Napa County,7,15,5499,2599,2900
50,6,55,California,Napa County,7,16,3976,1861,2115
50,6,55,California,Napa County,7,17,2978,1398,1580
50,6,55,California,Napa County,7,18,3609,1316,2293
50,6,55,California,Napa County,8,0,140862,70247,70615
50,6,55,California,Napa County,8,1,7524,3944,3580
50,6,55,California,Napa County,8,2,8465,4336,4129
50,6,55,California,Napa County,8,3,8927,4537,4390
50,6,55,California,Napa County,8,4,9096,4646,4450
50,6,55,California,Napa County,8,5,9021,4560,4461
50,6,55,California,Napa County,8,6,8518,4470,4048
50,6,55,California,Napa County,8,7,8729,4480,4249
50,6,55,California,Napa County,8,8,8825,4475,4350
50,6,55,California,Napa County,8,9,8932,4582,4350
50,6,55,California,Napa County,8,10,9424,4626,4798
50,6,55,California,Napa County,8,11,9870,5018,4852
50,6,55,California,Napa County,8,12,9746,4804,4942
50,6,55,California,Napa County,8,13,9208,4391,4817
50,6,55,California,Napa County,8,14,8015,3932,4083
50,6,55,California,Napa County,8,15,5777,2730,3047
50,6,55,California,Napa County,8,16,4105,1948,2157
50,6,55,California,Napa County,8,17,2996,1404,1592
50,6,55,California,Napa County,8,18,3684,1364,2320
50,6,55,California,Napa County,9,0,140840,70115,70725
50,6,55,California,Napa County,9,1,7363,3835,3528
50,6,55,California,Napa County,9,2,8251,4247,4004
50,6,55,California,Napa County,9,3,8874,4562,4312
50,6,55,California,Napa County,9,4,8993,4548,4445
50,6,55,California,Napa County,9,5,8785,4425,4360
50,6,55,California,Napa County,9,6,8593,4425,4168
50,6,55,California,Napa County,9,7,8724,4497,4227
50,6,55,California,Napa County,9,8,8919,4504,4415
50,6,55,California,Napa County,9,9,8798,4473,4325
50,6,55,California,Napa County,9,10,9407,4667,4740
50,6,55,California,Napa County,9,11,9670,4906,4764
50,6,55,California,Napa County,9,12,9766,4779,4987
50,6,55,California,Napa County,9,13,9315,4444,4871
50,6,55,California,Napa County,9,14,8404,4127,4277
50,6,55,California,Napa County,9,15,5902,2793,3109
50,6,55,California,Napa County,9,16,4313,2047,2266
50,6,55,California,Napa County,9,17,3113,1467,1646
50,6,55,California,Napa County,9,18,3650,1369,2281
50,6,55,California,Napa County,10,0,139878,69695,70183
50,6,55,California,Napa County,10,1,7069,3652,3417
50,6,55,California,Napa County,10,2,8030,4148,3882
50,6,55,California,Napa County,10,3,8780,4558,4222
50,6,55,California,Napa County,10,4,8843,4491,4352
50,6,55,California,Napa County,10,5,8633,4381,4252
50,6,55,California,Napa County,10,6,8572,4372,4200
50,6,55,California,Napa County,10,7,8617,4412,4205
50,6,55,California,Napa County,10,8,8878,4501,4377
50,6,55,California,Napa County,10,9,8694,4436,4258
50,6,55,California,Napa County,10,10,9351,4648,4703
50,6,55,California,Napa County,10,11,9480,4778,4702
50,6,55,California,Napa County,10,12,9659,4780,4879
50,6,55,California,Napa County,10,13,9285,4451,4834
50,6,55,California,Napa County,10,14,8304,4033,4271
50,6,55,California,Napa County,10,15,6427,3040,3387
50,6,55,California,Napa County,10,16,4457,2142,2315
50,6,55,California,Napa County,10,17,3156,1490,1666
50,6,55,California,Napa County,10,18,3643,1382,2261
50,6,55,California,Napa County,11,0,138789,69089,69700
50,6,55,California,Napa County,11,1,6922,3542,3380
50,6,55,California,Napa County,11,2,7772,4023,3749
50,6,55,California,Napa County,11,3,8549,4443,4106
50,6,55,California,Napa County,11,4,8681,4365,4316
50,6,55,California,Napa County,11,5,8424,4277,4147
50,6,55,California,Napa County,11,6,8634,4414,4220
50,6,55,California,Napa County,11,7,8411,4276,4135
50,6,55,California,Napa County,11,8,8888,4558,4330
50,6,55,California,Napa County,11,9,8641,4398,4243
50,6,55,California,Napa County,11,10,9137,4542,4595
50,6,55,California,Napa County,11,11,9214,4583,4631
50,6,55,California,Napa County,11,12,9665,4829,4836
50,6,55,California,Napa County,11,13,9212,4469,4743
50,6,55,California,Napa County,11,14,8401,4018,4383
50,6,55,California,Napa County,11,15,6670,3178,3492
50,6,55,California,Napa County,11,16,4690,2244,2446
50,6,55,California,Napa County,11,17,3231,1534,1697
50,6,55,California,Napa County,11,18,3647,1396,2251
50,6,55,California,Napa County,12,0,137744,68535,69209
50,6,55,California,Napa County,12,1,6632,3429,3203
50,6,55,California,Napa County,12,2,7537,3857,3680
50,6,55,California,Napa County,12,3,8328,4312,4016
50,6,55,California,Napa County,12,4,8621,4342,4279
50,6,55,California,Napa County,12,5,8277,4233,4044
50,6,55,California,Napa County,12,6,8631,4375,4256
50,6,55,California,Napa County,12,7,8370,4259,4111
50,6,55,California,Napa County,12,8,8840,4557,4283
50,6,55,California,Napa County,12,9,8506,4293,4213
50,6,55,California,Napa County,12,10,8936,4460,4476
50,6,55,California,Napa County,12,11,9017,4488,4529
50,6,55,California,Napa County,12,12,9683,4824,4859
50,6,55,California,Napa County,12,13,9209,4540,4669
50,6,55,California,Napa County,12,14,8471,3954,4517
50,6,55,California,Napa County,12,15,6891,3334,3557
50,6,55,California,Napa County,12,16,4856,2310,2546
50,6,55,California,Napa County,12,17,3290,1557,1733
50,6,55,California,Napa County,12,18,3649,1411,2238
50,6,57,California,Nevada County,1,0,98764,48835,49929
50,6,57,California,Nevada County,1,1,4365,2260,2105
50,6,57,California,Nevada County,1,2,4950,2510,2440
50,6,57,California,Nevada County,1,3,5798,3016,2782
50,6,57,California,Nevada County,1,4,6091,3134,2957
50,6,57,California,Nevada County,1,5,4439,2375,2064
50,6,57,California,Nevada County,1,6,4839,2589,2250
50,6,57,California,Nevada County,1,7,4815,2474,2341
50,6,57,California,Nevada County,1,8,4830,2517,2313
50,6,57,California,Nevada County,1,9,5655,2820,2835
50,6,57,California,Nevada County,1,10,7257,3455,3802
50,6,57,California,Nevada County,1,11,8569,4033,4536
50,6,57,California,Nevada County,1,12,9156,4329,4827
50,6,57,California,Nevada County,1,13,8826,4472,4354
50,6,57,California,Nevada County,1,14,6243,3043,3200
50,6,57,California,Nevada County,1,15,4355,2171,2184
50,6,57,California,Nevada County,1,16,3170,1508,1662
50,6,57,California,Nevada County,1,17,2647,1147,1500
50,6,57,California,Nevada County,1,18,2759,982,1777
50,6,57,California,Nevada County,2,0,98747,48826,49921
50,6,57,California,Nevada County,2,1,4362,2259,2103
50,6,57,California,Nevada County,2,2,4948,2508,2440
50,6,57,California,Nevada County,2,3,5798,3016,2782
50,6,57,California,Nevada County,2,4,6091,3134,2957
50,6,57,California,Nevada County,2,5,4435,2373,2062
50,6,57,California,Nevada County,2,6,4839,2589,2250
50,6,57,California,Nevada County,2,7,4815,2474,2341
50,6,57,California,Nevada County,2,8,4826,2515,2311
50,6,57,California,Nevada County,2,9,5653,2819,2834
50,6,57,California,Nevada County,2,10,7257,3455,3802
50,6,57,California,Nevada County,2,11,8569,4033,4536
50,6,57,California,Nevada County,2,12,9154,4328,4826
50,6,57,California,Nevada County,2,13,8825,4471,4354
50,6,57,California,Nevada County,2,14,6243,3043,3200
50,6,57,California,Nevada County,2,15,4356,2172,2184
50,6,57,California,Nevada County,2,16,3170,1508,1662
50,6,57,California,Nevada County,2,17,2647,1147,1500
50,6,57,California,Nevada County,2,18,2759,982,1777
50,6,57,California,Nevada County,3,0,98790,48843,49947
50,6,57,California,Nevada County,3,1,4356,2247,2109
50,6,57,California,Nevada County,3,2,4917,2494,2423
50,6,57,California,Nevada County,3,3,5764,2999,2765
50,6,57,California,Nevada County,3,4,6070,3121,2949
50,6,57,California,Nevada County,3,5,4480,2387,2093
50,6,57,California,Nevada County,3,6,4840,2585,2255
50,6,57,California,Nevada County,3,7,4836,2497,2339
50,6,57,California,Nevada County,3,8,4789,2498,2291
50,6,57,California,Nevada County,3,9,5653,2820,2833
50,6,57,California,Nevada County,3,10,7145,3408,3737
50,6,57,California,Nevada County,3,11,8530,4009,4521
50,6,57,California,Nevada County,3,12,9144,4321,4823
50,6,57,California,Nevada County,3,13,8931,4514,4417
50,6,57,California,Nevada County,3,14,6312,3077,3235
50,6,57,California,Nevada County,3,15,4418,2199,2219
50,6,57,California,Nevada County,3,16,3173,1523,1650
50,6,57,California,Nevada County,3,17,2633,1144,1489
50,6,57,California,Nevada County,3,18,2799,1000,1799
50,6,57,California,Nevada County,4,0,98701,48763,49938
50,6,57,California,Nevada County,4,1,4294,2192,2102
50,6,57,California,Nevada County,4,2,4834,2475,2359
50,6,57,California,Nevada County,4,3,5609,2895,2714
50,6,57,California,Nevada County,4,4,5932,3089,2843
50,6,57,California,Nevada County,4,5,4617,2439,2178
50,6,57,California,Nevada County,4,6,4779,2541,2238
50,6,57,California,Nevada County,4,7,4912,2566,2346
50,6,57,California,Nevada County,4,8,4658,2425,2233
50,6,57,California,Nevada County,4,9,5633,2802,2831
50,6,57,California,Nevada County,4,10,6683,3221,3462
50,6,57,California,Nevada County,4,11,8336,3884,4452
50,6,57,California,Nevada County,4,12,9067,4281,4786
50,6,57,California,Nevada County,4,13,9390,4695,4695
50,6,57,California,Nevada County,4,14,6595,3239,3356
50,6,57,California,Nevada County,4,15,4696,2301,2395
50,6,57,California,Nevada County,4,16,3191,1559,1632
50,6,57,California,Nevada County,4,17,2586,1137,1449
50,6,57,California,Nevada County,4,18,2889,1022,1867
50,6,57,California,Nevada County,5,0,98137,48441,49696
50,6,57,California,Nevada County,5,1,4200,2143,2057
50,6,57,California,Nevada County,5,2,4778,2423,2355
50,6,57,California,Nevada County,5,3,5385,2769,2616
50,6,57,California,Nevada County,5,4,5701,2999,2702
50,6,57,California,Nevada County,5,5,4623,2440,2183
50,6,57,California,Nevada County,5,6,4687,2474,2213
50,6,57,California,Nevada County,5,7,5008,2630,2378
50,6,57,California,Nevada County,5,8,4735,2435,2300
50,6,57,California,Nevada County,5,9,5407,2723,2684
50,6,57,California,Nevada County,5,10,6334,3098,3236
50,6,57,California,Nevada County,5,11,7911,3632,4279
50,6,57,California,Nevada County,5,12,9110,4309,4801
50,6,57,California,Nevada County,5,13,9214,4545,4669
50,6,57,California,Nevada County,5,14,7330,3627,3703
50,6,57,California,Nevada County,5,15,4976,2420,2556
50,6,57,California,Nevada County,5,16,3210,1579,1631
50,6,57,California,Nevada County,5,17,2566,1158,1408
50,6,57,California,Nevada County,5,18,2962,1037,1925
50,6,57,California,Nevada County,6,0,97938,48349,49589
50,6,57,California,Nevada County,6,1,4211,2176,2035
50,6,57,California,Nevada County,6,2,4769,2420,2349
50,6,57,California,Nevada County,6,3,5229,2670,2559
50,6,57,California,Nevada County,6,4,5422,2861,2561
50,6,57,California,Nevada County,6,5,4707,2454,2253
50,6,57,California,Nevada County,6,6,4584,2426,2158
50,6,57,California,Nevada County,6,7,5107,2661,2446
50,6,57,California,Nevada County,6,8,4879,2507,2372
50,6,57,California,Nevada County,6,9,5259,2680,2579
50,6,57,California,Nevada County,6,10,5911,2893,3018
50,6,57,California,Nevada County,6,11,7645,3569,4076
50,6,57,California,Nevada County,6,12,8967,4213,4754
50,6,57,California,Nevada County,6,13,9290,4500,4790
50,6,57,California,Nevada County,6,14,7819,3891,3928
50,6,57,California,Nevada County,6,15,5265,2534,2731
50,6,57,California,Nevada County,6,16,3441,1710,1731
50,6,57,California,Nevada County,6,17,2493,1135,1358
50,6,57,California,Nevada County,6,18,2940,1049,1891
50,6,57,California,Nevada County,7,0,98572,48546,50026
50,6,57,California,Nevada County,7,1,4234,2195,2039
50,6,57,California,Nevada County,7,2,4782,2391,2391
50,6,57,California,Nevada County,7,3,5178,2638,2540
50,6,57,California,Nevada County,7,4,5326,2825,2501
50,6,57,California,Nevada County,7,5,4774,2458,2316
50,6,57,California,Nevada County,7,6,4615,2432,2183
50,6,57,California,Nevada County,7,7,5164,2627,2537
50,6,57,California,Nevada County,7,8,5094,2623,2471
50,6,57,California,Nevada County,7,9,5126,2653,2473
50,6,57,California,Nevada County,7,10,5627,2785,2842
50,6,57,California,Nevada County,7,11,7416,3478,3938
50,6,57,California,Nevada County,7,12,8785,4062,4723
50,6,57,California,Nevada County,7,13,9376,4477,4899
50,6,57,California,Nevada County,7,14,8364,4163,4201
50,6,57,California,Nevada County,7,15,5577,2707,2870
50,6,57,California,Nevada County,7,16,3671,1820,1851
50,6,57,California,Nevada County,7,17,2463,1133,1330
50,6,57,California,Nevada County,7,18,3000,1079,1921
50,6,57,California,Nevada County,8,0,98676,48598,50078
50,6,57,California,Nevada County,8,1,4224,2191,2033
50,6,57,California,Nevada County,8,2,4739,2407,2332
50,6,57,California,Nevada County,8,3,5080,2593,2487
50,6,57,California,Nevada County,8,4,5209,2748,2461
50,6,57,California,Nevada County,8,5,4599,2376,2223
50,6,57,California,Nevada County,8,6,4592,2404,2188
50,6,57,California,Nevada County,8,7,5157,2622,2535
50,6,57,California,Nevada County,8,8,5422,2778,2644
50,6,57,California,Nevada County,8,9,4927,2537,2390
50,6,57,California,Nevada County,8,10,5582,2823,2759
50,6,57,California,Nevada County,8,11,7062,3318,3744
50,6,57,California,Nevada County,8,12,8521,3946,4575
50,6,57,California,Nevada County,8,13,9380,4371,5009
50,6,57,California,Nevada County,8,14,8944,4433,4511
50,6,57,California,Nevada County,8,15,5873,2864,3009
50,6,57,California,Nevada County,8,16,3829,1892,1937
50,6,57,California,Nevada County,8,17,2532,1191,1341
50,6,57,California,Nevada County,8,18,3004,1104,1900
50,6,57,California,Nevada County,9,0,98913,48639,50274
50,6,57,California,Nevada County,9,1,4231,2148,2083
50,6,57,California,Nevada County,9,2,4709,2426,2283
50,6,57,California,Nevada County,9,3,5061,2576,2485
50,6,57,California,Nevada County,9,4,5046,2657,2389
50,6,57,California,Nevada County,9,5,4450,2358,2092
50,6,57,California,Nevada County,9,6,4576,2344,2232
50,6,57,California,Nevada County,9,7,5160,2585,2575
50,6,57,California,Nevada County,9,8,5516,2860,2656
50,6,57,California,Nevada County,9,9,4888,2527,2361
50,6,57,California,Nevada County,9,10,5606,2828,2778
50,6,57,California,Nevada County,9,11,6661,3185,3476
50,6,57,California,Nevada County,9,12,8443,3833,4610
50,6,57,California,Nevada County,9,13,9333,4353,4980
50,6,57,California,Nevada County,9,14,9423,4624,4799
50,6,57,California,Nevada County,9,15,6207,3023,3184
50,6,57,California,Nevada County,9,16,4056,1974,2082
50,6,57,California,Nevada County,9,17,2527,1211,1316
50,6,57,California,Nevada County,9,18,3020,1127,1893
50,6,57,California,Nevada County,10,0,99367,48848,50519
50,6,57,California,Nevada County,10,1,4293,2166,2127
50,6,57,California,Nevada County,10,2,4633,2408,2225
50,6,57,California,Nevada County,10,3,5022,2532,2490
50,6,57,California,Nevada County,10,4,4964,2596,2368
50,6,57,California,Nevada County,10,5,4375,2322,2053
50,6,57,California,Nevada County,10,6,4627,2356,2271
50,6,57,California,Nevada County,10,7,5075,2578,2497
50,6,57,California,Nevada County,10,8,5708,2927,2781
50,6,57,California,Nevada County,10,9,5060,2621,2439
50,6,57,California,Nevada County,10,10,5510,2757,2753
50,6,57,California,Nevada County,10,11,6404,3113,3291
50,6,57,California,Nevada County,10,12,8096,3655,4441
50,6,57,California,Nevada County,10,13,9395,4386,5009
50,6,57,California,Nevada County,10,14,9316,4504,4812
50,6,57,California,Nevada County,10,15,6994,3461,3533
50,6,57,California,Nevada County,10,16,4294,2078,2216
50,6,57,California,Nevada County,10,17,2574,1249,1325
50,6,57,California,Nevada County,10,18,3027,1139,1888
50,6,57,California,Nevada County,11,0,99508,48868,50640
50,6,57,California,Nevada County,11,1,4332,2219,2113
50,6,57,California,Nevada County,11,2,4626,2388,2238
50,6,57,California,Nevada County,11,3,4990,2544,2446
50,6,57,California,Nevada County,11,4,4838,2510,2328
50,6,57,California,Nevada County,11,5,4227,2207,2020
50,6,57,California,Nevada County,11,6,4582,2341,2241
50,6,57,California,Nevada County,11,7,5027,2537,2490
50,6,57,California,Nevada County,11,8,5769,2935,2834
50,6,57,California,Nevada County,11,9,5249,2691,2558
50,6,57,California,Nevada County,11,10,5470,2771,2699
50,6,57,California,Nevada County,11,11,5960,2881,3079
50,6,57,California,Nevada County,11,12,7956,3642,4314
50,6,57,California,Nevada County,11,13,9241,4307,4934
50,6,57,California,Nevada County,11,14,9388,4500,4888
50,6,57,California,Nevada County,11,15,7494,3697,3797
50,6,57,California,Nevada County,11,16,4590,2217,2373
50,6,57,California,Nevada County,11,17,2765,1355,1410
50,6,57,California,Nevada County,11,18,3004,1126,1878
50,6,57,California,Nevada County,12,0,99755,49003,50752
50,6,57,California,Nevada County,12,1,4211,2174,2037
50,6,57,California,Nevada County,12,2,4640,2434,2206
50,6,57,California,Nevada County,12,3,4957,2488,2469
50,6,57,California,Nevada County,12,4,4750,2477,2273
50,6,57,California,Nevada County,12,5,4118,2151,1967
50,6,57,California,Nevada County,12,6,4623,2362,2261
50,6,57,California,Nevada County,12,7,5044,2526,2518
50,6,57,California,Nevada County,12,8,5703,2852,2851
50,6,57,California,Nevada County,12,9,5532,2828,2704
50,6,57,California,Nevada County,12,10,5366,2786,2580
50,6,57,California,Nevada County,12,11,5742,2794,2948
50,6,57,California,Nevada County,12,12,7730,3565,4165
50,6,57,California,Nevada County,12,13,9033,4153,4880
50,6,57,California,Nevada County,12,14,9478,4507,4971
50,6,57,California,Nevada County,12,15,8028,4012,4016
50,6,57,California,Nevada County,12,16,4809,2321,2488
50,6,57,California,Nevada County,12,17,2958,1422,1536
50,6,57,California,Nevada County,12,18,3033,1151,1882
50,6,59,California,Orange County,1,0,3010232,1488780,1521452
50,6,59,California,Orange County,1,1,191691,98332,93359
50,6,59,California,Orange County,1,2,198769,101577,97192
50,6,59,California,Orange County,1,3,210195,107446,102749
50,6,59,California,Orange County,1,4,227689,117278,110411
50,6,59,California,Orange County,1,5,213601,110168,103433
50,6,59,California,Orange County,1,6,215362,110805,104557
50,6,59,California,Orange County,1,7,198166,100050,98116
50,6,59,California,Orange County,1,8,213605,105316,108289
50,6,59,California,Orange County,1,9,225438,111325,114113
50,6,59,California,Orange County,1,10,230596,114473,116123
50,6,59,California,Orange County,1,11,213589,105810,107779
50,6,59,California,Orange County,1,12,175127,84699,90428
50,6,59,California,Orange County,1,13,146727,70010,76717
50,6,59,California,Orange County,1,14,107421,50153,57268
50,6,59,California,Orange County,1,15,80033,36704,43329
50,6,59,California,Orange County,1,16,63133,27713,35420
50,6,59,California,Orange County,1,17,49570,19952,29618
50,6,59,California,Orange County,1,18,49520,16969,32551
50,6,59,California,Orange County,2,0,3008989,1488175,1520814
50,6,59,California,Orange County,2,1,191564,98287,93277
50,6,59,California,Orange County,2,2,198643,101517,97126
50,6,59,California,Orange County,2,3,210075,107390,102685
50,6,59,California,Orange County,2,4,227587,117222,110365
50,6,59,California,Orange County,2,5,213500,110114,103386
50,6,59,California,Orange County,2,6,215220,110735,104485
50,6,59,California,Orange County,2,7,198048,99987,98061
50,6,59,California,Orange County,2,8,213487,105257,108230
50,6,59,California,Orange County,2,9,225346,111276,114070
50,6,59,California,Orange County,2,10,230537,114443,116094
50,6,59,California,Orange County,2,11,213532,105784,107748
50,6,59,California,Orange County,2,12,175100,84684,90416
50,6,59,California,Orange County,2,13,146703,69998,76705
50,6,59,California,Orange County,2,14,107415,50148,57267
50,6,59,California,Orange County,2,15,80025,36701,43324
50,6,59,California,Orange County,2,16,63130,27714,35416
50,6,59,California,Orange County,2,17,49563,19950,29613
50,6,59,California,Orange County,2,18,49514,16968,32546
50,6,59,California,Orange County,3,0,3015171,1490948,1524223
50,6,59,California,Orange County,3,1,191385,98174,93211
50,6,59,California,Orange County,3,2,198279,101325,96954
50,6,59,California,Orange County,3,3,209631,107083,102548
50,6,59,California,Orange County,3,4,225995,116306,109689
50,6,59,California,Orange County,3,5,215665,111138,104527
50,6,59,California,Orange County,3,6,215402,110874,104528
50,6,59,California,Orange County,3,7,198821,100396,98425
50,6,59,California,Orange County,3,8,211984,104460,107524
50,6,59,California,Orange County,3,9,225938,111567,114371
50,6,59,California,Orange County,3,10,230207,114267,115940
50,6,59,California,Orange County,3,11,214944,106527,108417
50,6,59,California,Orange County,3,12,176931,85649,91282
50,6,59,California,Orange County,3,13,147984,70578,77406
50,6,59,California,Orange County,3,14,108369,50623,57746
50,6,59,California,Orange County,3,15,80638,36999,43639
50,6,59,California,Orange County,3,16,63162,27712,35450
50,6,59,California,Orange County,3,17,49789,20118,29671
50,6,59,California,Orange County,3,18,50047,17152,32895
50,6,59,California,Orange County,4,0,3049271,1506866,1542405
50,6,59,California,Orange County,4,1,191868,98323,93545
50,6,59,California,Orange County,4,2,198445,101459,96986
50,6,59,California,Orange County,4,3,208889,106557,102332
50,6,59,California,Orange County,4,4,220640,113349,107291
50,6,59,California,Orange County,4,5,223517,114593,108924
50,6,59,California,Orange County,4,6,216929,111929,105000
50,6,59,California,Orange County,4,7,203450,102714,100736
50,6,59,California,Orange County,4,8,206369,101682,104687
50,6,59,California,Orange County,4,9,228811,112683,116128
50,6,59,California,Orange County,4,10,229067,113698,115369
50,6,59,California,Orange County,4,11,219999,109077,110922
50,6,59,California,Orange County,4,12,184210,89481,94729
50,6,59,California,Orange County,4,13,154284,73453,80831
50,6,59,California,Orange County,4,14,112590,52667,59923
50,6,59,California,Orange County,4,15,83574,38327,45247
50,6,59,California,Orange County,4,16,64167,28200,35967
50,6,59,California,Orange County,4,17,50533,20688,29845
50,6,59,California,Orange County,4,18,51929,17986,33943
50,6,59,California,Orange County,5,0,3078068,1520504,1557564
50,6,59,California,Orange County,5,1,190881,97613,93268
50,6,59,California,Orange County,5,2,199706,102226,97480
50,6,59,California,Orange County,5,3,206654,105496,101158
50,6,59,California,Orange County,5,4,218002,111641,106361
50,6,59,California,Orange County,5,5,228604,116869,111735
50,6,59,California,Orange County,5,6,217490,112450,105040
50,6,59,California,Orange County,5,7,207726,105007,102719
50,6,59,California,Orange County,5,8,202902,99982,102920
50,6,59,California,Orange County,5,9,228810,112614,116196
50,6,59,California,Orange County,5,10,227875,112879,114996
50,6,59,California,Orange County,5,11,222877,110417,112460
50,6,59,California,Orange County,5,12,191491,93355,98136
50,6,59,California,Orange County,5,13,154782,73769,81013
50,6,59,California,Orange County,5,14,122180,57104,65076
50,6,59,California,Orange County,5,15,87219,40005,47214
50,6,59,California,Orange County,5,16,65930,29065,36865
50,6,59,California,Orange County,5,17,51121,21179,29942
50,6,59,California,Orange County,5,18,53818,18833,34985
50,6,59,California,Orange County,6,0,3104950,1533763,1571187
50,6,59,California,Orange County,6,1,189299,96778,92521
50,6,59,California,Orange County,6,2,200421,102681,97740
50,6,59,California,Orange County,6,3,205954,105150,100804
50,6,59,California,Orange County,6,4,215093,109908,105185
50,6,59,California,Orange County,6,5,229640,117198,112442
50,6,59,California,Orange County,6,6,220438,114056,106382
50,6,59,California,Orange County,6,7,212034,107397,104637
50,6,59,California,Orange County,6,8,202153,99964,102189
50,6,59,California,Orange County,6,9,225913,110918,114995
50,6,59,California,Orange County,6,10,226766,112164,114602
50,6,59,California,Orange County,6,11,225851,111907,113944
50,6,59,California,Orange County,6,12,197935,96862,101073
50,6,59,California,Orange County,6,13,158773,75751,83022
50,6,59,California,Orange County,6,14,127365,59435,67930
50,6,59,California,Orange County,6,15,92384,42378,50006
50,6,59,California,Orange County,6,16,68133,30237,37896
50,6,59,California,Orange County,6,17,51495,21425,30070
50,6,59,California,Orange County,6,18,55303,19554,35749
50,6,59,California,Orange County,7,0,3126537,1544050,1582487
50,6,59,California,Orange County,7,1,189308,96985,92323
50,6,59,California,Orange County,7,2,198401,101619,96782
50,6,59,California,Orange County,7,3,204939,104509,100430
50,6,59,California,Orange County,7,4,211832,107916,103916
50,6,59,California,Orange County,7,5,228599,116823,111776
50,6,59,California,Orange County,7,6,225142,116357,108785
50,6,59,California,Orange County,7,7,214720,108994,105726
50,6,59,California,Orange County,7,8,200973,99614,101359
50,6,59,California,Orange County,7,9,221504,108396,113108
50,6,59,California,Orange County,7,10,225694,111474,114220
50,6,59,California,Orange County,7,11,228296,113033,115263
50,6,59,California,Orange County,7,12,203298,99851,103447
50,6,59,California,Orange County,7,13,164059,78291,85768
50,6,59,California,Orange County,7,14,133139,62202,70937
50,6,59,California,Orange County,7,15,97151,44398,52753
50,6,59,California,Orange County,7,16,70330,31370,38960
50,6,59,California,Orange County,7,17,52282,21830,30452
50,6,59,California,Orange County,7,18,56870,20388,36482
50,6,59,California,Orange County,8,0,3149280,1555379,1593901
50,6,59,California,Orange County,8,1,189914,97415,92499
50,6,59,California,Orange County,8,2,196259,100567,95692
50,6,59,California,Orange County,8,3,203237,103532,99705
50,6,59,California,Orange County,8,4,210922,107413,103509
50,6,59,California,Orange County,8,5,223432,114179,109253
50,6,59,California,Orange County,8,6,232207,119876,112331
50,6,59,California,Orange County,8,7,215438,109534,105904
50,6,59,California,Orange County,8,8,202063,100484,101579
50,6,59,California,Orange County,8,9,215560,105364,110196
50,6,59,California,Orange County,8,10,227310,111941,115369
50,6,59,California,Orange County,8,11,228206,112961,115245
50,6,59,California,Orange County,8,12,209342,103261,106081
50,6,59,California,Orange County,8,13,169723,81146,88577
50,6,59,California,Orange County,8,14,139174,65002,74172
50,6,59,California,Orange County,8,15,101456,46295,55161
50,6,59,California,Orange County,8,16,72811,32593,40218
50,6,59,California,Orange County,8,17,53162,22319,30843
50,6,59,California,Orange County,8,18,59064,21497,37567
50,6,59,California,Orange County,9,0,3164986,1562493,1602493
50,6,59,California,Orange County,9,1,189206,96875,92331
50,6,59,California,Orange County,9,2,194259,99617,94642
50,6,59,California,Orange County,9,3,201552,102709,98843
50,6,59,California,Orange County,9,4,209236,106342,102894
50,6,59,California,Orange County,9,5,217233,110754,106479
50,6,59,California,Orange County,9,6,239036,123376,115660
50,6,59,California,Orange County,9,7,216617,110536,106081
50,6,59,California,Orange County,9,8,204229,101869,102360
50,6,59,California,Orange County,9,9,208482,101632,106850
50,6,59,California,Orange County,9,10,229266,112581,116685
50,6,59,California,Orange County,9,11,226320,112076,114244
50,6,59,California,Orange County,9,12,213566,105381,108185
50,6,59,California,Orange County,9,13,175973,84471,91502
50,6,59,California,Orange County,9,14,144571,67459,77112
50,6,59,California,Orange County,9,15,105144,47912,57232
50,6,59,California,Orange County,9,16,75583,33802,41781
50,6,59,California,Orange County,9,17,54068,22843,31225
50,6,59,California,Orange County,9,18,60645,22258,38387
50,6,59,California,Orange County,10,0,3174289,1567002,1607287
50,6,59,California,Orange County,10,1,188458,96591,91867
50,6,59,California,Orange County,10,2,190906,97588,93318
50,6,59,California,Orange County,10,3,201017,102786,98231
50,6,59,California,Orange County,10,4,206672,104975,101697
50,6,59,California,Orange County,10,5,213254,108347,104907
50,6,59,California,Orange County,10,6,243272,125480,117792
50,6,59,California,Orange County,10,7,215626,110411,105215
50,6,59,California,Orange County,10,8,206845,103251,103594
50,6,59,California,Orange County,10,9,203879,99490,104389
50,6,59,California,Orange County,10,10,228179,111915,116264
50,6,59,California,Orange County,10,11,223998,110705,113293
50,6,59,California,Orange County,10,12,215617,106559,109058
50,6,59,California,Orange County,10,13,181995,87688,94307
50,6,59,California,Orange County,10,14,144795,67658,77137
50,6,59,California,Orange County,10,15,113256,51560,61696
50,6,59,California,Orange County,10,16,79141,35356,43785
50,6,59,California,Orange County,10,17,55559,23685,31874
50,6,59,California,Orange County,10,18,61820,22957,38863
50,6,59,California,Orange County,11,0,3175973,1567487,1608486
50,6,59,California,Orange County,11,1,186887,95826,91061
50,6,59,California,Orange County,11,2,187897,95984,91913
50,6,59,California,Orange County,11,3,199816,102268,97548
50,6,59,California,Orange County,11,4,204573,103840,100733
50,6,59,California,Orange County,11,5,208698,105705,102993
50,6,59,California,Orange County,11,6,242725,125124,117601
50,6,59,California,Orange County,11,7,215983,110594,105389
50,6,59,California,Orange County,11,8,209926,105296,104630
50,6,59,California,Orange County,11,9,200936,98212,102724
50,6,59,California,Orange County,11,10,223515,109250,114265
50,6,59,California,Orange County,11,11,221423,109332,112091
50,6,59,California,Orange County,11,12,216869,107076,109793
50,6,59,California,Orange County,11,13,187000,90550,96450
50,6,59,California,Orange County,11,14,147816,69287,78529
50,6,59,California,Orange County,11,15,117594,53481,64113
50,6,59,California,Orange County,11,16,83802,37416,46386
50,6,59,California,Orange County,11,17,57484,24761,32723
50,6,59,California,Orange County,11,18,63029,23485,39544
50,6,59,California,Orange County,12,0,3175692,1566825,1608867
50,6,59,California,Orange County,12,1,184632,94505,90127
50,6,59,California,Orange County,12,2,186979,95705,91274
50,6,59,California,Orange County,12,3,196973,100764,96209
50,6,59,California,Orange County,12,4,201919,102432,99487
50,6,59,California,Orange County,12,5,204168,103150,101018
50,6,59,California,Orange County,12,6,240818,124043,116775
50,6,59,California,Orange County,12,7,218568,111869,106699
50,6,59,California,Orange County,12,8,211434,106329,105105
50,6,59,California,Orange County,12,9,198911,97462,101449
50,6,59,California,Orange County,12,10,217438,106021,111417
50,6,59,California,Orange County,12,11,219555,108287,111268
50,6,59,California,Orange County,12,12,217747,107482,110265
50,6,59,California,Orange County,12,13,190982,92885,98097
50,6,59,California,Orange County,12,14,151712,71081,80631
50,6,59,California,Orange County,12,15,122603,55920,66683
50,6,59,California,Orange County,12,16,87845,39069,48776
50,6,59,California,Orange County,12,17,59318,25803,33515
50,6,59,California,Orange County,12,18,64090,24018,40072
50,6,61,California,Placer County,1,0,348432,170151,178281
50,6,61,California,Placer County,1,1,20851,10613,10238
50,6,61,California,Placer County,1,2,23604,12077,11527
50,6,61,California,Placer County,1,3,24986,12686,12300
50,6,61,California,Placer County,1,4,24298,12512,11786
50,6,61,California,Placer County,1,5,17936,9326,8610
50,6,61,California,Placer County,1,6,19560,9849,9711
50,6,61,California,Placer County,1,7,19613,9737,9876
50,6,61,California,Placer County,1,8,21871,10623,11248
50,6,61,California,Placer County,1,9,24694,11977,12717
50,6,61,California,Placer County,1,10,27232,13344,13888
50,6,61,California,Placer County,1,11,26107,12712,13395
50,6,61,California,Placer County,1,12,22972,11047,11925
50,6,61,California,Placer County,1,13,21146,9985,11161
50,6,61,California,Placer County,1,14,16459,7605,8854
50,6,61,California,Placer County,1,15,12531,5837,6694
50,6,61,California,Placer County,1,16,10019,4551,5468
50,6,61,California,Placer County,1,17,7299,3116,4183
50,6,61,California,Placer County,1,18,7254,2554,4700
50,6,61,California,Placer County,2,0,348502,170190,178312
50,6,61,California,Placer County,2,1,20855,10615,10240
50,6,61,California,Placer County,2,2,23610,12082,11528
50,6,61,California,Placer County,2,3,24995,12689,12306
50,6,61,California,Placer County,2,4,24305,12518,11787
50,6,61,California,Placer County,2,5,17942,9330,8612
50,6,61,California,Placer County,2,6,19561,9850,9711
50,6,61,California,Placer County,2,7,19614,9737,9877
50,6,61,California,Placer County,2,8,21879,10627,11252
50,6,61,California,Placer County,2,9,24701,11979,12722
50,6,61,California,Placer County,2,10,27238,13349,13889
50,6,61,California,Placer County,2,11,26111,12715,13396
50,6,61,California,Placer County,2,12,22974,11048,11926
50,6,61,California,Placer County,2,13,21151,9988,11163
50,6,61,California,Placer County,2,14,16461,7606,8855
50,6,61,California,Placer County,2,15,12530,5836,6694
50,6,61,California,Placer County,2,16,10019,4551,5468
50,6,61,California,Placer County,2,17,7300,3116,4184
50,6,61,California,Placer County,2,18,7256,2554,4702
50,6,61,California,Placer County,3,0,350021,170922,179099
50,6,61,California,Placer County,3,1,20860,10617,10243
50,6,61,California,Placer County,3,2,23632,12081,11551
50,6,61,California,Placer County,3,3,25036,12726,12310
50,6,61,California,Placer County,3,4,24269,12490,11779
50,6,61,California,Placer County,3,5,18231,9479,8752
50,6,61,California,Placer County,3,6,19625,9873,9752
50,6,61,California,Placer County,3,7,19819,9842,9977
50,6,61,California,Placer County,3,8,21787,10600,11187
50,6,61,California,Placer County,3,9,24760,11991,12769
50,6,61,California,Placer County,3,10,27160,13305,13855
50,6,61,California,Placer County,3,11,26334,12822,13512
50,6,61,California,Placer County,3,12,23143,11131,12012
50,6,61,California,Placer County,3,13,21394,10110,11284
50,6,61,California,Placer County,3,14,16620,7688,8932
50,6,61,California,Placer County,3,15,12659,5879,6780
50,6,61,California,Placer County,3,16,10017,4553,5464
50,6,61,California,Placer County,3,17,7364,3159,4205
50,6,61,California,Placer County,3,18,7311,2576,4735
50,6,61,California,Placer County,4,0,356328,174056,182272
50,6,61,California,Placer County,4,1,20855,10568,10287
50,6,61,California,Placer County,4,2,23863,12203,11660
50,6,61,California,Placer County,4,3,25317,12977,12340
50,6,61,California,Placer County,4,4,24365,12487,11878
50,6,61,California,Placer County,4,5,19204,9975,9229
50,6,61,California,Placer County,4,6,19557,9804,9753
50,6,61,California,Placer County,4,7,20680,10323,10357
50,6,61,California,Placer County,4,8,21391,10452,10939
50,6,61,California,Placer County,4,9,25133,12138,12995
50,6,61,California,Placer County,4,10,26601,13010,13591
50,6,61,California,Placer County,4,11,27041,13187,13854
50,6,61,California,Placer County,4,12,23719,11405,12314
50,6,61,California,Placer County,4,13,22574,10690,11884
50,6,61,California,Placer County,4,14,17374,8066,9308
50,6,61,California,Placer County,4,15,13283,6137,7146
50,6,61,California,Placer County,4,16,10257,4688,5569
50,6,61,California,Placer County,4,17,7578,3306,4272
50,6,61,California,Placer County,4,18,7536,2640,4896
50,6,61,California,Placer County,5,0,360263,176243,184020
50,6,61,California,Placer County,5,1,20464,10370,10094
50,6,61,California,Placer County,5,2,23860,12253,11607
50,6,61,California,Placer County,5,3,25340,12954,12386
50,6,61,California,Placer County,5,4,24341,12473,11868
50,6,61,California,Placer County,5,5,19804,10333,9471
50,6,61,California,Placer County,5,6,19148,9691,9457
50,6,61,California,Placer County,5,7,21095,10529,10566
50,6,61,California,Placer County,5,8,21419,10518,10901
50,6,61,California,Placer County,5,9,25203,12178,13025
50,6,61,California,Placer County,5,10,26210,12888,13322
50,6,61,California,Placer County,5,11,27140,13280,13860
50,6,61,California,Placer County,5,12,24508,11700,12808
50,6,61,California,Placer County,5,13,22372,10552,11820
50,6,61,California,Placer County,5,14,19152,8941,10211
50,6,61,California,Placer County,5,15,13925,6464,7461
50,6,61,California,Placer County,5,16,10593,4866,5727
50,6,61,California,Placer County,5,17,7817,3434,4383
50,6,61,California,Placer County,5,18,7872,2819,5053
50,6,61,California,Placer County,6,0,365398,178541,186857
50,6,61,California,Placer County,6,1,20338,10288,10050
50,6,61,California,Placer County,6,2,23841,12211,11630
50,6,61,California,Placer County,6,3,25380,12986,12394
50,6,61,California,Placer County,6,4,24214,12436,11778
50,6,61,California,Placer County,6,5,20307,10540,9767
50,6,61,California,Placer County,6,6,19119,9735,9384
50,6,61,California,Placer County,6,7,21780,10823,10957
50,6,61,California,Placer County,6,8,21886,10786,11100
50,6,61,California,Placer County,6,9,25216,12210,13006
50,6,61,California,Placer County,6,10,25630,12518,13112
50,6,61,California,Placer County,6,11,27455,13438,14017
50,6,61,California,Placer County,6,12,25261,12064,13197
50,6,61,California,Placer County,6,13,22552,10631,11921
50,6,61,California,Placer County,6,14,20292,9479,10813
50,6,61,California,Placer County,6,15,14931,6872,8059
50,6,61,California,Placer County,6,16,11008,5085,5923
50,6,61,California,Placer County,6,17,8069,3521,4548
50,6,61,California,Placer County,6,18,8119,2918,5201
50,6,61,California,Placer County,7,0,369217,180355,188862
50,6,61,California,Placer County,7,1,20063,10185,9878
50,6,61,California,Placer County,7,2,23704,12060,11644
50,6,61,California,Placer County,7,3,25390,13042,12348
50,6,61,California,Placer County,7,4,24186,12493,11693
50,6,61,California,Placer County,7,5,20525,10532,9993
50,6,61,California,Placer County,7,6,19182,9791,9391
50,6,61,California,Placer County,7,7,21807,10833,10974
50,6,61,California,Placer County,7,8,22489,11121,11368
50,6,61,California,Placer County,7,9,24660,12023,12637
50,6,61,California,Placer County,7,10,25425,12404,13021
50,6,61,California,Placer County,7,11,27620,13462,14158
50,6,61,California,Placer County,7,12,25710,12352,13358
50,6,61,California,Placer County,7,13,23218,10911,12307
50,6,61,California,Placer County,7,14,21275,9949,11326
50,6,61,California,Placer County,7,15,15757,7220,8537
50,6,61,California,Placer County,7,16,11452,5257,6195
50,6,61,California,Placer County,7,17,8255,3619,4636
50,6,61,California,Placer County,7,18,8499,3101,5398
50,6,61,California,Placer County,8,0,372841,181938,190903
50,6,61,California,Placer County,8,1,19963,10234,9729
50,6,61,California,Placer County,8,2,23572,11847,11725
50,6,61,California,Placer County,8,3,25478,13040,12438
50,6,61,California,Placer County,8,4,24060,12395,11665
50,6,61,California,Placer County,8,5,20517,10466,10051
50,6,61,California,Placer County,8,6,19288,9953,9335
50,6,61,California,Placer County,8,7,21718,10698,11020
50,6,61,California,Placer County,8,8,23218,11541,11677
50,6,61,California,Placer County,8,9,23935,11698,12237
50,6,61,California,Placer County,8,10,25790,12545,13245
50,6,61,California,Placer County,8,11,27242,13316,13926
50,6,61,California,Placer County,8,12,26178,12593,13585
50,6,61,California,Placer County,8,13,23714,11153,12561
50,6,61,California,Placer County,8,14,22213,10376,11837
50,6,61,California,Placer County,8,15,16672,7606,9066
50,6,61,California,Placer County,8,16,11901,5438,6463
50,6,61,California,Placer County,8,17,8583,3793,4790
50,6,61,California,Placer County,8,18,8799,3246,5553
50,6,61,California,Placer County,9,0,378943,184811,194132
50,6,61,California,Placer County,9,1,20247,10358,9889
50,6,61,California,Placer County,9,2,23704,11976,11728
50,6,61,California,Placer County,9,3,25656,13105,12551
50,6,61,California,Placer County,9,4,24172,12488,11684
50,6,61,California,Placer County,9,5,20140,10298,9842
50,6,61,California,Placer County,9,6,19979,10220,9759
50,6,61,California,Placer County,9,7,21825,10728,11097
50,6,61,California,Placer County,9,8,24246,12063,12183
50,6,61,California,Placer County,9,9,23683,11630,12053
50,6,61,California,Placer County,9,10,26439,12815,13624
50,6,61,California,Placer County,9,11,26756,13027,13729
50,6,61,California,Placer County,9,12,26788,12959,13829
50,6,61,California,Placer County,9,13,24292,11424,12868
50,6,61,California,Placer County,9,14,23279,10889,12390
50,6,61,California,Placer County,9,15,17389,7900,9489
50,6,61,California,Placer County,9,16,12496,5680,6816
50,6,61,California,Placer County,9,17,8718,3863,4855
50,6,61,California,Placer County,9,18,9134,3388,5746
50,6,61,California,Placer County,10,0,385115,187925,197190
50,6,61,California,Placer County,10,1,20684,10543,10141
50,6,61,California,Placer County,10,2,23727,11971,11756
50,6,61,California,Placer County,10,3,25938,13239,12699
50,6,61,California,Placer County,10,4,24263,12546,11717
50,6,61,California,Placer County,10,5,20356,10410,9946
50,6,61,California,Placer County,10,6,20441,10461,9980
50,6,61,California,Placer County,10,7,21809,10791,11018
50,6,61,California,Placer County,10,8,25118,12455,12663
50,6,61,California,Placer County,10,9,24123,11900,12223
50,6,61,California,Placer County,10,10,26499,12928,13571
50,6,61,California,Placer County,10,11,26402,12960,13442
50,6,61,California,Placer County,10,12,27119,13101,14018
50,6,61,California,Placer County,10,13,24951,11671,13280
50,6,61,California,Placer County,10,14,23002,10676,12326
50,6,61,California,Placer County,10,15,19196,8788,10408
50,6,61,California,Placer County,10,16,13193,6010,7183
50,6,61,California,Placer County,10,17,8936,3957,4979
50,6,61,California,Placer County,10,18,9358,3518,5840
50,6,61,California,Placer County,11,0,392330,191765,200565
50,6,61,California,Placer County,11,1,20979,10753,10226
50,6,61,California,Placer County,11,2,24205,12240,11965
50,6,61,California,Placer County,11,3,26240,13427,12813
50,6,61,California,Placer County,11,4,24428,12665,11763
50,6,61,California,Placer County,11,5,20268,10430,9838
50,6,61,California,Placer County,11,6,21033,10865,10168
50,6,61,California,Placer County,11,7,22023,10908,11115
50,6,61,California,Placer County,11,8,26176,12906,13270
50,6,61,California,Placer County,11,9,24969,12369,12600
50,6,61,California,Placer County,11,10,26725,13140,13585
50,6,61,California,Placer County,11,11,25928,12658,13270
50,6,61,California,Placer County,11,12,27400,13269,14131
50,6,61,California,Placer County,11,13,25417,11898,13519
50,6,61,California,Placer County,11,14,23314,10830,12484
50,6,61,California,Placer County,11,15,20196,9272,10924
50,6,61,California,Placer County,11,16,14087,6342,7745
50,6,61,California,Placer County,11,17,9343,4135,5208
50,6,61,California,Placer County,11,18,9599,3658,5941
50,6,61,California,Placer County,12,0,398329,194488,203841
50,6,61,California,Placer County,12,1,21092,10796,10296
50,6,61,California,Placer County,12,2,24514,12403,12111
50,6,61,California,Placer County,12,3,26252,13296,12956
50,6,61,California,Placer County,12,4,24649,12803,11846
50,6,61,California,Placer County,12,5,20423,10469,9954
50,6,61,California,Placer County,12,6,21050,10759,10291
50,6,61,California,Placer County,12,7,22434,11228,11206
50,6,61,California,Placer County,12,8,26712,13102,13610
50,6,61,California,Placer County,12,9,25862,12920,12942
50,6,61,California,Placer County,12,10,26552,13054,13498
50,6,61,California,Placer County,12,11,25715,12584,13131
50,6,61,California,Placer County,12,12,27728,13419,14309
50,6,61,California,Placer County,12,13,25956,12207,13749
50,6,61,California,Placer County,12,14,23932,11065,12867
50,6,61,California,Placer County,12,15,21111,9683,11428
50,6,61,California,Placer County,12,16,14758,6597,8161
50,6,61,California,Placer County,12,17,9710,4267,5443
50,6,61,California,Placer County,12,18,9879,3836,6043
50,6,63,California,Plumas County,1,0,20007,10003,10004
50,6,63,California,Plumas County,1,1,883,463,420
50,6,63,California,Plumas County,1,2,968,473,495
50,6,63,California,Plumas County,1,3,1022,536,486
50,6,63,California,Plumas County,1,4,1293,666,627
50,6,63,California,Plumas County,1,5,930,500,430
50,6,63,California,Plumas County,1,6,847,445,402
50,6,63,California,Plumas County,1,7,851,420,431
50,6,63,California,Plumas County,1,8,863,449,414
50,6,63,California,Plumas County,1,9,1045,509,536
50,6,63,California,Plumas County,1,10,1433,693,740
50,6,63,California,Plumas County,1,11,1793,838,955
50,6,63,California,Plumas County,1,12,1995,977,1018
50,6,63,California,Plumas County,1,13,1930,992,938
50,6,63,California,Plumas County,1,14,1467,759,708
50,6,63,California,Plumas County,1,15,1067,559,508
50,6,63,California,Plumas County,1,16,676,333,343
50,6,63,California,Plumas County,1,17,520,241,279
50,6,63,California,Plumas County,1,18,424,150,274
50,6,63,California,Plumas County,2,0,20007,10003,10004
50,6,63,California,Plumas County,2,1,883,463,420
50,6,63,California,Plumas County,2,2,968,473,495
50,6,63,California,Plumas County,2,3,1022,536,486
50,6,63,California,Plumas County,2,4,1293,666,627
50,6,63,California,Plumas County,2,5,930,500,430
50,6,63,California,Plumas County,2,6,847,445,402
50,6,63,California,Plumas County,2,7,851,420,431
50,6,63,California,Plumas County,2,8,863,449,414
50,6,63,California,Plumas County,2,9,1045,509,536
50,6,63,California,Plumas County,2,10,1433,693,740
50,6,63,California,Plumas County,2,11,1793,838,955
50,6,63,California,Plumas County,2,12,1995,977,1018
50,6,63,California,Plumas County,2,13,1930,992,938
50,6,63,California,Plumas County,2,14,1467,759,708
50,6,63,California,Plumas County,2,15,1067,559,508
50,6,63,California,Plumas County,2,16,676,333,343
50,6,63,California,Plumas County,2,17,520,241,279
50,6,63,California,Plumas County,2,18,424,150,274
50,6,63,California,Plumas County,3,0,19914,9945,9969
50,6,63,California,Plumas County,3,1,887,464,423
50,6,63,California,Plumas County,3,2,957,468,489
50,6,63,California,Plumas County,3,3,1011,528,483
50,6,63,California,Plumas County,3,4,1265,653,612
50,6,63,California,Plumas County,3,5,942,498,444
50,6,63,California,Plumas County,3,6,845,443,402
50,6,63,California,Plumas County,3,7,853,421,432
50,6,63,California,Plumas County,3,8,855,445,410
50,6,63,California,Plumas County,3,9,1025,499,526
50,6,63,California,Plumas County,3,10,1402,677,725
50,6,63,California,Plumas County,3,11,1783,835,948
50,6,63,California,Plumas County,3,12,1983,975,1008
50,6,63,California,Plumas County,3,13,1934,990,944
50,6,63,California,Plumas County,3,14,1478,769,709
50,6,63,California,Plumas County,3,15,1070,554,516
50,6,63,California,Plumas County,3,16,675,332,343
50,6,63,California,Plumas County,3,17,518,243,275
50,6,63,California,Plumas County,3,18,431,151,280
50,6,63,California,Plumas County,4,0,19719,9883,9836
50,6,63,California,Plumas County,4,1,918,494,424
50,6,63,California,Plumas County,4,2,944,460,484
50,6,63,California,Plumas County,4,3,971,509,462
50,6,63,California,Plumas County,4,4,1181,620,561
50,6,63,California,Plumas County,4,5,981,517,464
50,6,63,California,Plumas County,4,6,819,434,385
50,6,63,California,Plumas County,4,7,916,460,456
50,6,63,California,Plumas County,4,8,812,418,394
50,6,63,California,Plumas County,4,9,958,468,490
50,6,63,California,Plumas County,4,10,1267,620,647
50,6,63,California,Plumas County,4,11,1760,830,930
50,6,63,California,Plumas County,4,12,1927,930,997
50,6,63,California,Plumas County,4,13,2000,1020,980
50,6,63,California,Plumas County,4,14,1539,802,737
50,6,63,California,Plumas County,4,15,1090,558,532
50,6,63,California,Plumas County,4,16,685,345,340
50,6,63,California,Plumas County,4,17,509,252,257
50,6,63,California,Plumas County,4,18,442,146,296
50,6,63,California,Plumas County,5,0,19377,9686,9691
50,6,63,California,Plumas County,5,1,873,472,401
50,6,63,California,Plumas County,5,2,978,493,485
50,6,63,California,Plumas County,5,3,923,469,454
50,6,63,California,Plumas County,5,4,1097,580,517
50,6,63,California,Plumas County,5,5,952,495,457
50,6,63,California,Plumas County,5,6,798,415,383
50,6,63,California,Plumas County,5,7,910,457,453
50,6,63,California,Plumas County,5,8,824,421,403
50,6,63,California,Plumas County,5,9,918,451,467
50,6,63,California,Plumas County,5,10,1167,572,595
50,6,63,California,Plumas County,5,11,1603,742,861
50,6,63,California,Plumas County,5,12,1885,908,977
50,6,63,California,Plumas County,5,13,1959,991,968
50,6,63,California,Plumas County,5,14,1661,846,815
50,6,63,California,Plumas County,5,15,1141,589,552
50,6,63,California,Plumas County,5,16,728,385,343
50,6,63,California,Plumas County,5,17,497,238,259
50,6,63,California,Plumas County,5,18,463,162,301
50,6,63,California,Plumas County,6,0,18895,9446,9449
50,6,63,California,Plumas County,6,1,806,443,363
50,6,63,California,Plumas County,6,2,940,470,470
50,6,63,California,Plumas County,6,3,913,459,454
50,6,63,California,Plumas County,6,4,1044,564,480
50,6,63,California,Plumas County,6,5,932,484,448
50,6,63,California,Plumas County,6,6,764,383,381
50,6,63,California,Plumas County,6,7,873,452,421
50,6,63,California,Plumas County,6,8,833,419,414
50,6,63,California,Plumas County,6,9,863,437,426
50,6,63,California,Plumas County,6,10,1060,529,531
50,6,63,California,Plumas County,6,11,1519,714,805
50,6,63,California,Plumas County,6,12,1845,860,985
50,6,63,California,Plumas County,6,13,1916,976,940
50,6,63,California,Plumas County,6,14,1684,840,844
50,6,63,California,Plumas County,6,15,1204,637,567
50,6,63,California,Plumas County,6,16,783,404,379
50,6,63,California,Plumas County,6,17,466,217,249
50,6,63,California,Plumas County,6,18,450,158,292
50,6,63,California,Plumas County,7,0,18622,9323,9299
50,6,63,California,Plumas County,7,1,794,428,366
50,6,63,California,Plumas County,7,2,906,470,436
50,6,63,California,Plumas County,7,3,906,447,459
50,6,63,California,Plumas County,7,4,959,515,444
50,6,63,California,Plumas County,7,5,918,487,431
50,6,63,California,Plumas County,7,6,820,421,399
50,6,63,California,Plumas County,7,7,832,412,420
50,6,63,California,Plumas County,7,8,856,431,425
50,6,63,California,Plumas County,7,9,828,425,403
50,6,63,California,Plumas County,7,10,975,489,486
50,6,63,California,Plumas County,7,11,1433,686,747
50,6,63,California,Plumas County,7,12,1769,805,964
50,6,63,California,Plumas County,7,13,1941,989,952
50,6,63,California,Plumas County,7,14,1684,853,831
50,6,63,California,Plumas County,7,15,1256,661,595
50,6,63,California,Plumas County,7,16,828,425,403
50,6,63,California,Plumas County,7,17,455,208,247
50,6,63,California,Plumas County,7,18,462,171,291
50,6,63,California,Plumas County,8,0,18427,9210,9217
50,6,63,California,Plumas County,8,1,766,397,369
50,6,63,California,Plumas County,8,2,852,459,393
50,6,63,California,Plumas County,8,3,921,441,480
50,6,63,California,Plumas County,8,4,931,506,425
50,6,63,California,Plumas County,8,5,839,444,395
50,6,63,California,Plumas County,8,6,859,444,415
50,6,63,California,Plumas County,8,7,832,407,425
50,6,63,California,Plumas County,8,8,870,427,443
50,6,63,California,Plumas County,8,9,781,405,376
50,6,63,California,Plumas County,8,10,977,486,491
50,6,63,California,Plumas County,8,11,1324,643,681
50,6,63,California,Plumas County,8,12,1711,788,923
50,6,63,California,Plumas County,8,13,1940,962,978
50,6,63,California,Plumas County,8,14,1743,891,852
50,6,63,California,Plumas County,8,15,1284,664,620
50,6,63,California,Plumas County,8,16,851,442,409
50,6,63,California,Plumas County,8,17,480,220,260
50,6,63,California,Plumas County,8,18,466,184,282
50,6,63,California,Plumas County,9,0,18665,9329,9336
50,6,63,California,Plumas County,9,1,812,385,427
50,6,63,California,Plumas County,9,2,903,486,417
50,6,63,California,Plumas County,9,3,918,453,465
50,6,63,California,Plumas County,9,4,929,483,446
50,6,63,California,Plumas County,9,5,810,429,381
50,6,63,California,Plumas County,9,6,915,461,454
50,6,63,California,Plumas County,9,7,867,449,418
50,6,63,California,Plumas County,9,8,919,432,487
50,6,63,California,Plumas County,9,9,796,409,387
50,6,63,California,Plumas County,9,10,929,480,449
50,6,63,California,Plumas County,9,11,1234,599,635
50,6,63,California,Plumas County,9,12,1709,812,897
50,6,63,California,Plumas County,9,13,1936,944,992
50,6,63,California,Plumas County,9,14,1827,936,891
50,6,63,California,Plumas County,9,15,1319,702,617
50,6,63,California,Plumas County,9,16,862,438,424
50,6,63,California,Plumas County,9,17,505,227,278
50,6,63,California,Plumas County,9,18,475,204,271
50,6,63,California,Plumas County,10,0,18660,9294,9366
50,6,63,California,Plumas County,10,1,842,383,459
50,6,63,California,Plumas County,10,2,867,473,394
50,6,63,California,Plumas County,10,3,959,473,486
50,6,63,California,Plumas County,10,4,908,460,448
50,6,63,California,Plumas County,10,5,744,394,350
50,6,63,California,Plumas County,10,6,941,482,459
50,6,63,California,Plumas County,10,7,915,468,447
50,6,63,California,Plumas County,10,8,882,423,459
50,6,63,California,Plumas County,10,9,843,428,415
50,6,63,California,Plumas County,10,10,869,449,420
50,6,63,California,Plumas County,10,11,1169,561,608
50,6,63,California,Plumas County,10,12,1613,765,848
50,6,63,California,Plumas County,10,13,1943,930,1013
50,6,63,California,Plumas County,10,14,1821,932,889
50,6,63,California,Plumas County,10,15,1429,745,684
50,6,63,California,Plumas County,10,16,924,482,442
50,6,63,California,Plumas County,10,17,518,255,263
50,6,63,California,Plumas County,10,18,473,191,282
50,6,63,California,Plumas County,11,0,18741,9330,9411
50,6,63,California,Plumas County,11,1,890,410,480
50,6,63,California,Plumas County,11,2,831,450,381
50,6,63,California,Plumas County,11,3,948,464,484
50,6,63,California,Plumas County,11,4,925,484,441
50,6,63,California,Plumas County,11,5,725,377,348
50,6,63,California,Plumas County,11,6,909,466,443
50,6,63,California,Plumas County,11,7,954,471,483
50,6,63,California,Plumas County,11,8,939,472,467
50,6,63,California,Plumas County,11,9,849,434,415
50,6,63,California,Plumas County,11,10,867,442,425
50,6,63,California,Plumas County,11,11,1111,546,565
50,6,63,California,Plumas County,11,12,1577,739,838
50,6,63,California,Plumas County,11,13,1899,889,1010
50,6,63,California,Plumas County,11,14,1849,958,891
50,6,63,California,Plumas County,11,15,1478,747,731
50,6,63,California,Plumas County,11,16,970,523,447
50,6,63,California,Plumas County,11,17,547,272,275
50,6,63,California,Plumas County,11,18,473,186,287
50,6,63,California,Plumas County,12,0,18807,9357,9450
50,6,63,California,Plumas County,12,1,908,421,487
50,6,63,California,Plumas County,12,2,860,467,393
50,6,63,California,Plumas County,12,3,958,487,471
50,6,63,California,Plumas County,12,4,932,475,457
50,6,63,California,Plumas County,12,5,693,363,330
50,6,63,California,Plumas County,12,6,902,460,442
50,6,63,California,Plumas County,12,7,1001,498,503
50,6,63,California,Plumas County,12,8,965,479,486
50,6,63,California,Plumas County,12,9,899,456,443
50,6,63,California,Plumas County,12,10,860,438,422
50,6,63,California,Plumas County,12,11,1017,489,528
50,6,63,California,Plumas County,12,12,1514,733,781
50,6,63,California,Plumas County,12,13,1861,852,1009
50,6,63,California,Plumas County,12,14,1884,975,909
50,6,63,California,Plumas County,12,15,1503,767,736
50,6,63,California,Plumas County,12,16,1031,535,496
50,6,63,California,Plumas County,12,17,574,289,285
50,6,63,California,Plumas County,12,18,445,173,272
50,6,65,California,Riverside County,1,0,2189641,1089576,1100065
50,6,65,California,Riverside County,1,1,162438,82754,79684
50,6,65,California,Riverside County,1,2,167065,85020,82045
50,6,65,California,Riverside County,1,3,177644,90683,86961
50,6,65,California,Riverside County,1,4,187125,96221,90904
50,6,65,California,Riverside County,1,5,154572,79533,75039
50,6,65,California,Riverside County,1,6,143992,72905,71087
50,6,65,California,Riverside County,1,7,138437,68750,69687
50,6,65,California,Riverside County,1,8,143926,71002,72924
50,6,65,California,Riverside County,1,9,149379,75432,73947
50,6,65,California,Riverside County,1,10,152722,77080,75642
50,6,65,California,Riverside County,1,11,140016,70586,69430
50,6,65,California,Riverside County,1,12,114765,55964,58801
50,6,65,California,Riverside County,1,13,98974,47377,51597
50,6,65,California,Riverside County,1,14,78495,36730,41765
50,6,65,California,Riverside County,1,15,62103,28958,33145
50,6,65,California,Riverside County,1,16,49003,22422,26581
50,6,65,California,Riverside County,1,17,36793,15918,20875
50,6,65,California,Riverside County,1,18,32192,12241,19951
50,6,65,California,Riverside County,2,0,2189765,1089614,1100151
50,6,65,California,Riverside County,2,1,162439,82754,79685
50,6,65,California,Riverside County,2,2,167067,85021,82046
50,6,65,California,Riverside County,2,3,177643,90683,86960
50,6,65,California,Riverside County,2,4,187124,96219,90905
50,6,65,California,Riverside County,2,5,154573,79534,75039
50,6,65,California,Riverside County,2,6,143993,72906,71087
50,6,65,California,Riverside County,2,7,138437,68750,69687
50,6,65,California,Riverside County,2,8,143928,71003,72925
50,6,65,California,Riverside County,2,9,149380,75433,73947
50,6,65,California,Riverside County,2,10,152723,77081,75642
50,6,65,California,Riverside County,2,11,140017,70587,69430
50,6,65,California,Riverside County,2,12,114771,55968,58803
50,6,65,California,Riverside County,2,13,98981,47381,51600
50,6,65,California,Riverside County,2,14,78499,36731,41768
50,6,65,California,Riverside County,2,15,62112,28962,33150
50,6,65,California,Riverside County,2,16,49022,22428,26594
50,6,65,California,Riverside County,2,17,36814,15923,20891
50,6,65,California,Riverside County,2,18,32242,12250,19992
50,6,65,California,Riverside County,3,0,2201576,1095284,1106292
50,6,65,California,Riverside County,3,1,162443,82831,79612
50,6,65,California,Riverside County,3,2,167370,85169,82201
50,6,65,California,Riverside County,3,3,177708,90628,87080
50,6,65,California,Riverside County,3,4,186544,95888,90656
50,6,65,California,Riverside County,3,5,157422,80893,76529
50,6,65,California,Riverside County,3,6,145433,73731,71702
50,6,65,California,Riverside County,3,7,139823,69480,70343
50,6,65,California,Riverside County,3,8,143925,70959,72966
50,6,65,California,Riverside County,3,9,149892,75589,74303
50,6,65,California,Riverside County,3,10,152832,77084,75748
50,6,65,California,Riverside County,3,11,141306,71192,70114
50,6,65,California,Riverside County,3,12,116209,56725,59484
50,6,65,California,Riverside County,3,13,100163,47921,52242
50,6,65,California,Riverside County,3,14,79168,37073,42095
50,6,65,California,Riverside County,3,15,62536,29143,33393
50,6,65,California,Riverside County,3,16,49135,22487,26648
50,6,65,California,Riverside County,3,17,37005,16088,20917
50,6,65,California,Riverside County,3,18,32662,12403,20259
50,6,65,California,Riverside County,4,0,2234070,1111532,1122538
50,6,65,California,Riverside County,4,1,161637,82720,78917
50,6,65,California,Riverside County,4,2,167870,85459,82411
50,6,65,California,Riverside County,4,3,177121,90129,86992
50,6,65,California,Riverside County,4,4,183510,94208,89302
50,6,65,California,Riverside County,4,5,165538,85007,80531
50,6,65,California,Riverside County,4,6,148373,75555,72818
50,6,65,California,Riverside County,4,7,144040,71756,72284
50,6,65,California,Riverside County,4,8,142295,69939,72356
50,6,65,California,Riverside County,4,9,151485,76028,75457
50,6,65,California,Riverside County,4,10,152039,76662,75377
50,6,65,California,Riverside County,4,11,145332,73201,72131
50,6,65,California,Riverside County,4,12,121341,59515,61826
50,6,65,California,Riverside County,4,13,105182,50274,54908
50,6,65,California,Riverside County,4,14,82209,38645,43564
50,6,65,California,Riverside County,4,15,64503,29911,34592
50,6,65,California,Riverside County,4,16,50072,23001,27071
50,6,65,California,Riverside County,4,17,37609,16589,21020
50,6,65,California,Riverside County,4,18,33914,12933,20981
50,6,65,California,Riverside County,5,0,2261204,1125284,1135920
50,6,65,California,Riverside County,5,1,159068,81319,77749
50,6,65,California,Riverside County,5,2,169880,86560,83320
50,6,65,California,Riverside County,5,3,175727,89270,86457
50,6,65,California,Riverside County,5,4,181393,92948,88445
50,6,65,California,Riverside County,5,5,170399,87337,83062
50,6,65,California,Riverside County,5,6,150464,76972,73492
50,6,65,California,Riverside County,5,7,147887,74177,73710
50,6,65,California,Riverside County,5,8,142418,70041,72377
50,6,65,California,Riverside County,5,9,152152,75932,76220
50,6,65,California,Riverside County,5,10,150788,76225,74563
50,6,65,California,Riverside County,5,11,147536,74270,73266
50,6,65,California,Riverside County,5,12,126987,62583,64404
50,6,65,California,Riverside County,5,13,105572,50435,55137
50,6,65,California,Riverside County,5,14,89046,42045,47001
50,6,65,California,Riverside County,5,15,67072,31164,35908
50,6,65,California,Riverside County,5,16,51323,23511,27812
50,6,65,California,Riverside County,5,17,38491,17175,21316
50,6,65,California,Riverside County,5,18,35001,13320,21681
50,6,65,California,Riverside County,6,0,2286755,1137977,1148778
50,6,65,California,Riverside County,6,1,156947,80298,76649
50,6,65,California,Riverside County,6,2,171342,87602,83740
50,6,65,California,Riverside County,6,3,175060,88925,86135
50,6,65,California,Riverside County,6,4,179756,91994,87762
50,6,65,California,Riverside County,6,5,172065,88179,83886
50,6,65,California,Riverside County,6,6,153401,78555,74846
50,6,65,California,Riverside County,6,7,151907,76242,75665
50,6,65,California,Riverside County,6,8,143185,70540,72645
50,6,65,California,Riverside County,6,9,151221,74995,76226
50,6,65,California,Riverside County,6,10,149607,75599,74008
50,6,65,California,Riverside County,6,11,149609,75187,74422
50,6,65,California,Riverside County,6,12,132037,65313,66724
50,6,65,California,Riverside County,6,13,107773,51562,56211
50,6,65,California,Riverside County,6,14,93111,44115,48996
50,6,65,California,Riverside County,6,15,71133,32926,38207
50,6,65,California,Riverside County,6,16,53226,24423,28803
50,6,65,California,Riverside County,6,17,39175,17566,21609
50,6,65,California,Riverside County,6,18,36200,13956,22244
50,6,65,California,Riverside County,7,0,2316162,1151701,1164461
50,6,65,California,Riverside County,7,1,157219,80216,77003
50,6,65,California,Riverside County,7,2,171208,87412,83796
50,6,65,California,Riverside County,7,3,174999,88938,86061
50,6,65,California,Riverside County,7,4,178366,90904,87462
50,6,65,California,Riverside County,7,5,172788,88463,84325
50,6,65,California,Riverside County,7,6,158244,81273,76971
50,6,65,California,Riverside County,7,7,155123,77863,77260
50,6,65,California,Riverside County,7,8,145806,72018,73788
50,6,65,California,Riverside County,7,9,149576,73962,75614
50,6,65,California,Riverside County,7,10,149115,75176,73939
50,6,65,California,Riverside County,7,11,151603,76030,75573
50,6,65,California,Riverside County,7,12,135956,67508,68448
50,6,65,California,Riverside County,7,13,111756,53489,58267
50,6,65,California,Riverside County,7,14,97358,46208,51150
50,6,65,California,Riverside County,7,15,74403,34336,40067
50,6,65,California,Riverside County,7,16,55351,25404,29947
50,6,65,California,Riverside County,7,17,39588,17799,21789
50,6,65,California,Riverside County,7,18,37703,14702,23001
50,6,65,California,Riverside County,8,0,2345816,1166571,1179245
50,6,65,California,Riverside County,8,1,157504,80381,77123
50,6,65,California,Riverside County,8,2,171270,87444,83826
50,6,65,California,Riverside County,8,3,174242,88642,85600
50,6,65,California,Riverside County,8,4,178036,90818,87218
50,6,65,California,Riverside County,8,5,171536,87679,83857
50,6,65,California,Riverside County,8,6,163821,84168,79653
50,6,65,California,Riverside County,8,7,157097,79150,77947
50,6,65,California,Riverside County,8,8,149335,74157,75178
50,6,65,California,Riverside County,8,9,147873,72724,75149
50,6,65,California,Riverside County,8,10,150408,75640,74768
50,6,65,California,Riverside County,8,11,151913,76074,75839
50,6,65,California,Riverside County,8,12,140092,69752,70340
50,6,65,California,Riverside County,8,13,116417,55935,60482
50,6,65,California,Riverside County,8,14,101703,48156,53547
50,6,65,California,Riverside County,8,15,77789,35979,41810
50,6,65,California,Riverside County,8,16,57345,26270,31075
50,6,65,California,Riverside County,8,17,40336,18161,22175
50,6,65,California,Riverside County,8,18,39099,15441,23658
50,6,65,California,Riverside County,9,0,2380081,1184681,1195400
50,6,65,California,Riverside County,9,1,157858,80490,77368
50,6,65,California,Riverside County,9,2,171531,87755,83776
50,6,65,California,Riverside County,9,3,175052,89221,85831
50,6,65,California,Riverside County,9,4,177638,90251,87387
50,6,65,California,Riverside County,9,5,169382,86496,82886
50,6,65,California,Riverside County,9,6,170694,87793,82901
50,6,65,California,Riverside County,9,7,159250,80923,78327
50,6,65,California,Riverside County,9,8,153897,76626,77271
50,6,65,California,Riverside County,9,9,147263,72666,74597
50,6,65,California,Riverside County,9,10,152549,76475,76074
50,6,65,California,Riverside County,9,11,151283,75868,75415
50,6,65,California,Riverside County,9,12,144278,71894,72384
50,6,65,California,Riverside County,9,13,121242,58608,62634
50,6,65,California,Riverside County,9,14,106159,50209,55950
50,6,65,California,Riverside County,9,15,80830,37525,43305
50,6,65,California,Riverside County,9,16,59187,26992,32195
50,6,65,California,Riverside County,9,17,41515,18677,22838
50,6,65,California,Riverside County,9,18,40473,16212,24261
50,6,65,California,Riverside County,10,0,2414964,1202904,1212060
50,6,65,California,Riverside County,10,1,158477,81010,77467
50,6,65,California,Riverside County,10,2,170398,87400,82998
50,6,65,California,Riverside County,10,3,178324,90837,87487
50,6,65,California,Riverside County,10,4,177123,89945,87178
50,6,65,California,Riverside County,10,5,168067,85672,82395
50,6,65,California,Riverside County,10,6,175219,90082,85137
50,6,65,California,Riverside County,10,7,161253,82246,79007
50,6,65,California,Riverside County,10,8,158839,79560,79279
50,6,65,California,Riverside County,10,9,148599,73362,75237
50,6,65,California,Riverside County,10,10,153858,76781,77077
50,6,65,California,Riverside County,10,11,151050,75918,75132
50,6,65,California,Riverside County,10,12,146548,73051,73497
50,6,65,California,Riverside County,10,13,127116,61859,65257
50,6,65,California,Riverside County,10,14,106357,50174,56183
50,6,65,California,Riverside County,10,15,87582,40809,46773
50,6,65,California,Riverside County,10,16,61532,28049,33483
50,6,65,California,Riverside County,10,17,42776,19203,23573
50,6,65,California,Riverside County,10,18,41846,16946,24900
50,6,65,California,Riverside County,11,0,2445789,1219025,1226764
50,6,65,California,Riverside County,11,1,157861,80714,77147
50,6,65,California,Riverside County,11,2,169475,86760,82715
50,6,65,California,Riverside County,11,3,180397,92092,88305
50,6,65,California,Riverside County,11,4,176946,89902,87044
50,6,65,California,Riverside County,11,5,167365,85295,82070
50,6,65,California,Riverside County,11,6,177256,91461,85795
50,6,65,California,Riverside County,11,7,164392,84027,80365
50,6,65,California,Riverside County,11,8,163931,82253,81678
50,6,65,California,Riverside County,11,9,150871,74847,76024
50,6,65,California,Riverside County,11,10,153765,76372,77393
50,6,65,California,Riverside County,11,11,150605,75919,74686
50,6,65,California,Riverside County,11,12,148496,73994,74502
50,6,65,California,Riverside County,11,13,132008,64521,67487
50,6,65,California,Riverside County,11,14,108880,51360,57520
50,6,65,California,Riverside County,11,15,91225,42603,48622
50,6,65,California,Riverside County,11,16,65331,29682,35649
50,6,65,California,Riverside County,11,17,44153,19798,24355
50,6,65,California,Riverside County,11,18,42832,17425,25407
50,6,65,California,Riverside County,12,0,2470546,1232012,1238534
50,6,65,California,Riverside County,12,1,156301,80139,76162
50,6,65,California,Riverside County,12,2,170016,86893,83123
50,6,65,California,Riverside County,12,3,180402,92192,88210
50,6,65,California,Riverside County,12,4,176791,89860,86931
50,6,65,California,Riverside County,12,5,165881,84294,81587
50,6,65,California,Riverside County,12,6,178277,92092,86185
50,6,65,California,Riverside County,12,7,167345,85715,81630
50,6,65,California,Riverside County,12,8,167210,84224,82986
50,6,65,California,Riverside County,12,9,153535,76286,77249
50,6,65,California,Riverside County,12,10,152553,75669,76884
50,6,65,California,Riverside County,12,11,150002,75609,74393
50,6,65,California,Riverside County,12,12,150741,75109,75632
50,6,65,California,Riverside County,12,13,135550,66625,68925
50,6,65,California,Riverside County,12,14,112614,53250,59364
50,6,65,California,Riverside County,12,15,95341,44564,50777
50,6,65,California,Riverside County,12,16,68372,31037,37335
50,6,65,California,Riverside County,12,17,45851,20567,25284
50,6,65,California,Riverside County,12,18,43764,17887,25877
50,6,67,California,Sacramento County,1,0,1418788,694793,723995
50,6,67,California,Sacramento County,1,1,101063,51669,49394
50,6,67,California,Sacramento County,1,2,98112,50022,48090
50,6,67,California,Sacramento County,1,3,99820,51128,48692
50,6,67,California,Sacramento County,1,4,105680,54270,51410
50,6,67,California,Sacramento County,1,5,101908,51147,50761
50,6,67,California,Sacramento County,1,6,107922,53768,54154
50,6,67,California,Sacramento County,1,7,98724,49407,49317
50,6,67,California,Sacramento County,1,8,95195,47276,47919
50,6,67,California,Sacramento County,1,9,95640,47744,47896
50,6,67,California,Sacramento County,1,10,102072,50392,51680
50,6,67,California,Sacramento County,1,11,98464,47467,50997
50,6,67,California,Sacramento County,1,12,85332,40354,44978
50,6,67,California,Sacramento County,1,13,70305,33113,37192
50,6,67,California,Sacramento County,1,14,47404,21567,25837
50,6,67,California,Sacramento County,1,15,35891,15718,20173
50,6,67,California,Sacramento County,1,16,29328,12821,16507
50,6,67,California,Sacramento County,1,17,22865,9060,13805
50,6,67,California,Sacramento County,1,18,23063,7870,15193
50,6,67,California,Sacramento County,2,0,1418735,694763,723972
50,6,67,California,Sacramento County,2,1,101062,51668,49394
50,6,67,California,Sacramento County,2,2,98108,50019,48089
50,6,67,California,Sacramento County,2,3,99811,51125,48686
50,6,67,California,Sacramento County,2,4,105673,54264,51409
50,6,67,California,Sacramento County,2,5,101906,51145,50761
50,6,67,California,Sacramento County,2,6,107921,53767,54154
50,6,67,California,Sacramento County,2,7,98723,49407,49316
50,6,67,California,Sacramento County,2,8,95191,47274,47917
50,6,67,California,Sacramento County,2,9,95635,47743,47892
50,6,67,California,Sacramento County,2,10,102066,50387,51679
50,6,67,California,Sacramento County,2,11,98459,47463,50996
50,6,67,California,Sacramento County,2,12,85332,40354,44978
50,6,67,California,Sacramento County,2,13,70302,33112,37190
50,6,67,California,Sacramento County,2,14,47402,21566,25836
50,6,67,California,Sacramento County,2,15,35891,15718,20173
50,6,67,California,Sacramento County,2,16,29328,12821,16507
50,6,67,California,Sacramento County,2,17,22864,9060,13804
50,6,67,California,Sacramento County,2,18,23061,7870,15191
50,6,67,California,Sacramento County,3,0,1421383,695963,725420
50,6,67,California,Sacramento County,3,1,100985,51635,49350
50,6,67,California,Sacramento County,3,2,98293,50152,48141
50,6,67,California,Sacramento County,3,3,99590,50997,48593
50,6,67,California,Sacramento County,3,4,104620,53797,50823
50,6,67,California,Sacramento County,3,5,102672,51470,51202
50,6,67,California,Sacramento County,3,6,108164,53838,54326
50,6,67,California,Sacramento County,3,7,99307,49677,49630
50,6,67,California,Sacramento County,3,8,94837,47103,47734
50,6,67,California,Sacramento County,3,9,95823,47761,48062
50,6,67,California,Sacramento County,3,10,101575,50171,51404
50,6,67,California,Sacramento County,3,11,98970,47727,51243
50,6,67,California,Sacramento County,3,12,85929,40639,45290
50,6,67,California,Sacramento County,3,13,71210,33526,37684
50,6,67,California,Sacramento County,3,14,47870,21802,26068
50,6,67,California,Sacramento County,3,15,36090,15826,20264
50,6,67,California,Sacramento County,3,16,29279,12770,16509
50,6,67,California,Sacramento County,3,17,22928,9134,13794
50,6,67,California,Sacramento County,3,18,23241,7938,15303
50,6,67,California,Sacramento County,4,0,1433730,701697,732033
50,6,67,California,Sacramento County,4,1,100551,51454,49097
50,6,67,California,Sacramento County,4,2,99214,50593,48621
50,6,67,California,Sacramento County,4,3,98841,50529,48312
50,6,67,California,Sacramento County,4,4,100906,52130,48776
50,6,67,California,Sacramento County,4,5,105864,53013,52851
50,6,67,California,Sacramento County,4,6,109164,54415,54749
50,6,67,California,Sacramento County,4,7,101614,50736,50878
50,6,67,California,Sacramento County,4,8,93326,46441,46885
50,6,67,California,Sacramento County,4,9,96952,48095,48857
50,6,67,California,Sacramento County,4,10,99143,48971,50172
50,6,67,California,Sacramento County,4,11,100738,48632,52106
50,6,67,California,Sacramento County,4,12,88447,41872,46575
50,6,67,California,Sacramento County,4,13,75165,35294,39871
50,6,67,California,Sacramento County,4,14,50002,22896,27106
50,6,67,California,Sacramento County,4,15,37052,16245,20807
50,6,67,California,Sacramento County,4,16,29501,12719,16782
50,6,67,California,Sacramento County,4,17,23147,9424,13723
50,6,67,California,Sacramento County,4,18,24103,8238,15865
50,6,67,California,Sacramento County,5,0,1444852,706838,738014
50,6,67,California,Sacramento County,5,1,99457,51034,48423
50,6,67,California,Sacramento County,5,2,100566,51226,49340
50,6,67,California,Sacramento County,5,3,98339,50253,48086
50,6,67,California,Sacramento County,5,4,98411,50791,47620
50,6,67,California,Sacramento County,5,5,106800,53781,53019
50,6,67,California,Sacramento County,5,6,109904,54810,55094
50,6,67,California,Sacramento County,5,7,104111,51912,52199
50,6,67,California,Sacramento County,5,8,93322,46336,46986
50,6,67,California,Sacramento County,5,9,96756,47820,48936
50,6,67,California,Sacramento County,5,10,97109,47840,49269
50,6,67,California,Sacramento County,5,11,101230,49032,52198
50,6,67,California,Sacramento County,5,12,91271,43288,47983
50,6,67,California,Sacramento County,5,13,75933,35539,40394
50,6,67,California,Sacramento County,5,14,55445,25542,29903
50,6,67,California,Sacramento County,5,15,38335,16772,21563
50,6,67,California,Sacramento County,5,16,30001,12812,17189
50,6,67,California,Sacramento County,5,17,23286,9640,13646
50,6,67,California,Sacramento County,5,18,24576,8410,16166
50,6,67,California,Sacramento County,6,0,1457341,712009,745332
50,6,67,California,Sacramento County,6,1,98648,50452,48196
50,6,67,California,Sacramento County,6,2,101944,52128,49816
50,6,67,California,Sacramento County,6,3,98260,50004,48256
50,6,67,California,Sacramento County,6,4,96820,49970,46850
50,6,67,California,Sacramento County,6,5,106081,53238,52843
50,6,67,California,Sacramento County,6,6,111418,55574,55844
50,6,67,California,Sacramento County,6,7,106671,53090,53581
50,6,67,California,Sacramento County,6,8,93927,46579,47348
50,6,67,California,Sacramento County,6,9,96382,47427,48955
50,6,67,California,Sacramento County,6,10,95496,47114,48382
50,6,67,California,Sacramento County,6,11,101491,49249,52242
50,6,67,California,Sacramento County,6,12,93209,44292,48917
50,6,67,California,Sacramento County,6,13,77839,36257,41582
50,6,67,California,Sacramento County,6,14,59355,27388,31967
50,6,67,California,Sacramento County,6,15,40610,17807,22803
50,6,67,California,Sacramento County,6,16,30422,12943,17479
50,6,67,California,Sacramento County,6,17,23599,9866,13733
50,6,67,California,Sacramento County,6,18,25169,8631,16538
50,6,67,California,Sacramento County,7,0,1474917,720583,754334
50,6,67,California,Sacramento County,7,1,99261,50745,48516
50,6,67,California,Sacramento County,7,2,102201,52258,49943
50,6,67,California,Sacramento County,7,3,99102,50360,48742
50,6,67,California,Sacramento County,7,4,95446,48991,46455
50,6,67,California,Sacramento County,7,5,104946,52933,52013
50,6,67,California,Sacramento County,7,6,114538,57217,57321
50,6,67,California,Sacramento County,7,7,109206,54428,54778
50,6,67,California,Sacramento County,7,8,96284,47877,48407
50,6,67,California,Sacramento County,7,9,95674,46948,48726
50,6,67,California,Sacramento County,7,10,94651,46805,47846
50,6,67,California,Sacramento County,7,11,101899,49511,52388
50,6,67,California,Sacramento County,7,12,94880,45163,49717
50,6,67,California,Sacramento County,7,13,79952,37209,42743
50,6,67,California,Sacramento County,7,14,63586,29237,34349
50,6,67,California,Sacramento County,7,15,42629,18745,23884
50,6,67,California,Sacramento County,7,16,31322,13340,17982
50,6,67,California,Sacramento County,7,17,23476,9809,13667
50,6,67,California,Sacramento County,7,18,25864,9007,16857
50,6,67,California,Sacramento County,8,0,1493674,729669,764005
50,6,67,California,Sacramento County,8,1,99684,50791,48893
50,6,67,California,Sacramento County,8,2,102115,52357,49758
50,6,67,California,Sacramento County,8,3,100009,50714,49295
50,6,67,California,Sacramento County,8,4,94911,48731,46180
50,6,67,California,Sacramento County,8,5,102341,51648,50693
50,6,67,California,Sacramento County,8,6,118183,59035,59148
50,6,67,California,Sacramento County,8,7,111781,55707,56074
50,6,67,California,Sacramento County,8,8,99359,49556,49803
50,6,67,California,Sacramento County,8,9,94314,46173,48141
50,6,67,California,Sacramento County,8,10,95416,47139,48277
50,6,67,California,Sacramento County,8,11,101002,49093,51909
50,6,67,California,Sacramento County,8,12,97034,46367,50667
50,6,67,California,Sacramento County,8,13,82913,38461,44452
50,6,67,California,Sacramento County,8,14,67656,31188,36468
50,6,67,California,Sacramento County,8,15,44786,19778,25008
50,6,67,California,Sacramento County,8,16,32112,13724,18388
50,6,67,California,Sacramento County,8,17,23685,9860,13825
50,6,67,California,Sacramento County,8,18,26373,9347,17026
50,6,67,California,Sacramento County,9,0,1510987,738114,772873
50,6,67,California,Sacramento County,9,1,99348,50439,48909
50,6,67,California,Sacramento County,9,2,102414,52437,49977
50,6,67,California,Sacramento County,9,3,101240,51440,49800
50,6,67,California,Sacramento County,9,4,94746,48614,46132
50,6,67,California,Sacramento County,9,5,99693,50512,49181
50,6,67,California,Sacramento County,9,6,121756,60950,60806
50,6,67,California,Sacramento County,9,7,114006,56773,57233
50,6,67,California,Sacramento County,9,8,102801,51191,51610
50,6,67,California,Sacramento County,9,9,93543,45887,47656
50,6,67,California,Sacramento County,9,10,96656,47635,49021
50,6,67,California,Sacramento County,9,11,98654,48011,50643
50,6,67,California,Sacramento County,9,12,98868,47247,51621
50,6,67,California,Sacramento County,9,13,85141,39654,45487
50,6,67,California,Sacramento County,9,14,71276,32740,38536
50,6,67,California,Sacramento County,9,15,46842,20823,26019
50,6,67,California,Sacramento County,9,16,33130,14143,18987
50,6,67,California,Sacramento County,9,17,23966,9862,14104
50,6,67,California,Sacramento County,9,18,26907,9756,17151
50,6,67,California,Sacramento County,10,0,1527301,746291,781010
50,6,67,California,Sacramento County,10,1,99353,50430,48923
50,6,67,California,Sacramento County,10,2,101720,52117,49603
50,6,67,California,Sacramento County,10,3,102849,52192,50657
50,6,67,California,Sacramento County,10,4,94573,48553,46020
50,6,67,California,Sacramento County,10,5,97505,49479,48026
50,6,67,California,Sacramento County,10,6,124366,62310,62056
50,6,67,California,Sacramento County,10,7,116091,57925,58166
50,6,67,California,Sacramento County,10,8,106709,53264,53445
50,6,67,California,Sacramento County,10,9,93944,46115,47829
50,6,67,California,Sacramento County,10,10,97341,47842,49499
50,6,67,California,Sacramento County,10,11,96809,47037,49772
50,6,67,California,Sacramento County,10,12,99123,47652,51471
50,6,67,California,Sacramento County,10,13,87457,40740,46717
50,6,67,California,Sacramento County,10,14,71868,32932,38936
50,6,67,California,Sacramento County,10,15,51673,23098,28575
50,6,67,California,Sacramento County,10,16,34333,14633,19700
50,6,67,California,Sacramento County,10,17,24315,9929,14386
50,6,67,California,Sacramento County,10,18,27272,10043,17229
50,6,67,California,Sacramento County,11,0,1538746,752017,786729
50,6,67,California,Sacramento County,11,1,98841,50245,48596
50,6,67,California,Sacramento County,11,2,100944,51668,49276
50,6,67,California,Sacramento County,11,3,103784,53033,50751
50,6,67,California,Sacramento County,11,4,94784,48582,46202
50,6,67,California,Sacramento County,11,5,96070,48623,47447
50,6,67,California,Sacramento County,11,6,124476,62329,62147
50,6,67,California,Sacramento County,11,7,118387,59385,59002
50,6,67,California,Sacramento County,11,8,109888,54853,55035
50,6,67,California,Sacramento County,11,9,94966,46632,48334
50,6,67,California,Sacramento County,11,10,96904,47347,49557
50,6,67,California,Sacramento County,11,11,94897,46297,48600
50,6,67,California,Sacramento County,11,12,98930,47512,51418
50,6,67,California,Sacramento County,11,13,88952,41579,47373
50,6,67,California,Sacramento County,11,14,73273,33408,39865
50,6,67,California,Sacramento County,11,15,55121,24722,30399
50,6,67,California,Sacramento County,11,16,36292,15480,20812
50,6,67,California,Sacramento County,11,17,24593,10081,14512
50,6,67,California,Sacramento County,11,18,27644,10241,17403
50,6,67,California,Sacramento County,12,0,1552058,758897,793161
50,6,67,California,Sacramento County,12,1,98152,50087,48065
50,6,67,California,Sacramento County,12,2,101075,51555,49520
50,6,67,California,Sacramento County,12,3,103643,53080,50563
50,6,67,California,Sacramento County,12,4,95290,48668,46622
50,6,67,California,Sacramento County,12,5,94782,47885,46897
50,6,67,California,Sacramento County,12,6,123819,62281,61538
50,6,67,California,Sacramento County,12,7,121763,61272,60491
50,6,67,California,Sacramento County,12,8,112560,56225,56335
50,6,67,California,Sacramento County,12,9,97176,47849,49327
50,6,67,California,Sacramento County,12,10,96094,46824,49270
50,6,67,California,Sacramento County,12,11,94043,46039,48004
50,6,67,California,Sacramento County,12,12,98791,47477,51314
50,6,67,California,Sacramento County,12,13,89988,42194,47794
50,6,67,California,Sacramento County,12,14,75105,34256,40849
50,6,67,California,Sacramento County,12,15,58812,26319,32493
50,6,67,California,Sacramento County,12,16,37891,16170,21721
50,6,67,California,Sacramento County,12,17,25191,10390,14801
50,6,67,California,Sacramento County,12,18,27883,10326,17557
50,6,69,California,San Benito County,1,0,55269,27629,27640
50,6,69,California,San Benito County,1,1,4092,2068,2024
50,6,69,California,San Benito County,1,2,4326,2202,2124
50,6,69,California,San Benito County,1,3,4709,2462,2247
50,6,69,California,San Benito County,1,4,4534,2346,2188
50,6,69,California,San Benito County,1,5,3507,1804,1703
50,6,69,California,San Benito County,1,6,3409,1718,1691
50,6,69,California,San Benito County,1,7,3522,1745,1777
50,6,69,California,San Benito County,1,8,3585,1775,1810
50,6,69,California,San Benito County,1,9,4036,1981,2055
50,6,69,California,San Benito County,1,10,4279,2141,2138
50,6,69,California,San Benito County,1,11,3970,1969,2001
50,6,69,California,San Benito County,1,12,3367,1669,1698
50,6,69,California,San Benito County,1,13,2573,1295,1278
50,6,69,California,San Benito County,1,14,1810,877,933
50,6,69,California,San Benito County,1,15,1168,588,580
50,6,69,California,San Benito County,1,16,935,432,503
50,6,69,California,San Benito County,1,17,749,287,462
50,6,69,California,San Benito County,1,18,698,270,428
50,6,69,California,San Benito County,2,0,55265,27627,27638
50,6,69,California,San Benito County,2,1,4092,2068,2024
50,6,69,California,San Benito County,2,2,4325,2201,2124
50,6,69,California,San Benito County,2,3,4709,2462,2247
50,6,69,California,San Benito County,2,4,4533,2346,2187
50,6,69,California,San Benito County,2,5,3507,1804,1703
50,6,69,California,San Benito County,2,6,3409,1718,1691
50,6,69,California,San Benito County,2,7,3520,1744,1776
50,6,69,California,San Benito County,2,8,3585,1775,1810
50,6,69,California,San Benito County,2,9,4036,1981,2055
50,6,69,California,San Benito County,2,10,4279,2141,2138
50,6,69,California,San Benito County,2,11,3970,1969,2001
50,6,69,California,San Benito County,2,12,3367,1669,1698
50,6,69,California,San Benito County,2,13,2573,1295,1278
50,6,69,California,San Benito County,2,14,1810,877,933
50,6,69,California,San Benito County,2,15,1168,588,580
50,6,69,California,San Benito County,2,16,935,432,503
50,6,69,California,San Benito County,2,17,749,287,462
50,6,69,California,San Benito County,2,18,698,270,428
50,6,69,California,San Benito County,3,0,55516,27765,27751
50,6,69,California,San Benito County,3,1,4090,2076,2014
50,6,69,California,San Benito County,3,2,4338,2199,2139
50,6,69,California,San Benito County,3,3,4691,2457,2234
50,6,69,California,San Benito County,3,4,4546,2342,2204
50,6,69,California,San Benito County,3,5,3535,1830,1705
50,6,69,California,San Benito County,3,6,3467,1752,1715
50,6,69,California,San Benito County,3,7,3545,1756,1789
50,6,69,California,San Benito County,3,8,3572,1769,1803
50,6,69,California,San Benito County,3,9,4032,1976,2056
50,6,69,California,San Benito County,3,10,4269,2135,2134
50,6,69,California,San Benito County,3,11,3991,1983,2008
50,6,69,California,San Benito County,3,12,3391,1677,1714
50,6,69,California,San Benito County,3,13,2621,1323,1298
50,6,69,California,San Benito County,3,14,1828,885,943
50,6,69,California,San Benito County,3,15,1200,603,597
50,6,69,California,San Benito County,3,16,928,432,496
50,6,69,California,San Benito County,3,17,762,295,467
50,6,69,California,San Benito County,3,18,710,275,435
50,6,69,California,San Benito County,4,0,55977,27968,28009
50,6,69,California,San Benito County,4,1,4050,2053,1997
50,6,69,California,San Benito County,4,2,4328,2185,2143
50,6,69,California,San Benito County,4,3,4639,2427,2212
50,6,69,California,San Benito County,4,4,4582,2333,2249
50,6,69,California,San Benito County,4,5,3627,1906,1721
50,6,69,California,San Benito County,4,6,3487,1769,1718
50,6,69,California,San Benito County,4,7,3574,1767,1807
50,6,69,California,San Benito County,4,8,3450,1719,1731
50,6,69,California,San Benito County,4,9,4015,1959,2056
50,6,69,California,San Benito County,4,10,4230,2098,2132
50,6,69,California,San Benito County,4,11,4063,2033,2030
50,6,69,California,San Benito County,4,12,3510,1743,1767
50,6,69,California,San Benito County,4,13,2806,1406,1400
50,6,69,California,San Benito County,4,14,1888,896,992
50,6,69,California,San Benito County,4,15,1285,639,646
50,6,69,California,San Benito County,4,16,908,441,467
50,6,69,California,San Benito County,4,17,791,312,479
50,6,69,California,San Benito County,4,18,744,282,462
50,6,69,California,San Benito County,5,0,56599,28246,28353
50,6,69,California,San Benito County,5,1,3999,2030,1969
50,6,69,California,San Benito County,5,2,4363,2178,2185
50,6,69,California,San Benito County,5,3,4608,2418,2190
50,6,69,California,San Benito County,5,4,4555,2281,2274
50,6,69,California,San Benito County,5,5,3747,1975,1772
50,6,69,California,San Benito County,5,6,3616,1867,1749
50,6,69,California,San Benito County,5,7,3645,1812,1833
50,6,69,California,San Benito County,5,8,3459,1717,1742
50,6,69,California,San Benito County,5,9,3886,1919,1967
50,6,69,California,San Benito County,5,10,4156,2042,2114
50,6,69,California,San Benito County,5,11,4091,2047,2044
50,6,69,California,San Benito County,5,12,3639,1809,1830
50,6,69,California,San Benito County,5,13,2905,1421,1484
50,6,69,California,San Benito County,5,14,2028,969,1059
50,6,69,California,San Benito County,5,15,1367,670,697
50,6,69,California,San Benito County,5,16,950,480,470
50,6,69,California,San Benito County,5,17,796,315,481
50,6,69,California,San Benito County,5,18,789,296,493
50,6,69,California,San Benito County,6,0,57239,28554,28685
50,6,69,California,San Benito County,6,1,3943,2028,1915
50,6,69,California,San Benito County,6,2,4390,2179,2211
50,6,69,California,San Benito County,6,3,4534,2370,2164
50,6,69,California,San Benito County,6,4,4517,2282,2235
50,6,69,California,San Benito County,6,5,3938,2035,1903
50,6,69,California,San Benito County,6,6,3634,1887,1747
50,6,69,California,San Benito County,6,7,3717,1856,1861
50,6,69,California,San Benito County,6,8,3586,1787,1799
50,6,69,California,San Benito County,6,9,3805,1897,1908
50,6,69,California,San Benito County,6,10,4038,1979,2059
50,6,69,California,San Benito County,6,11,4134,2058,2076
50,6,69,California,San Benito County,6,12,3716,1852,1864
50,6,69,California,San Benito County,6,13,3025,1475,1550
50,6,69,California,San Benito County,6,14,2189,1068,1121
50,6,69,California,San Benito County,6,15,1486,709,777
50,6,69,California,San Benito County,6,16,970,476,494
50,6,69,California,San Benito County,6,17,788,324,464
50,6,69,California,San Benito County,6,18,829,292,537
50,6,69,California,San Benito County,7,0,57825,28910,28915
50,6,69,California,San Benito County,7,1,3941,2011,1930
50,6,69,California,San Benito County,7,2,4374,2170,2204
50,6,69,California,San Benito County,7,3,4485,2312,2173
50,6,69,California,San Benito County,7,4,4470,2307,2163
50,6,69,California,San Benito County,7,5,4001,2049,1952
50,6,69,California,San Benito County,7,6,3647,1890,1757
50,6,69,California,San Benito County,7,7,3875,1994,1881
50,6,69,California,San Benito County,7,8,3683,1833,1850
50,6,69,California,San Benito County,7,9,3696,1852,1844
50,6,69,California,San Benito County,7,10,3989,1957,2032
50,6,69,California,San Benito County,7,11,4177,2060,2117
50,6,69,California,San Benito County,7,12,3721,1870,1851
50,6,69,California,San Benito County,7,13,3156,1554,1602
50,6,69,California,San Benito County,7,14,2323,1159,1164
50,6,69,California,San Benito County,7,15,1597,745,852
50,6,69,California,San Benito County,7,16,1005,496,509
50,6,69,California,San Benito County,7,17,837,357,480
50,6,69,California,San Benito County,7,18,848,294,554
50,6,69,California,San Benito County,8,0,58216,29092,29124
50,6,69,California,San Benito County,8,1,3875,1958,1917
50,6,69,California,San Benito County,8,2,4319,2155,2164
50,6,69,California,San Benito County,8,3,4471,2259,2212
50,6,69,California,San Benito County,8,4,4435,2316,2119
50,6,69,California,San Benito County,8,5,3983,2057,1926
50,6,69,California,San Benito County,8,6,3731,1905,1826
50,6,69,California,San Benito County,8,7,3922,2025,1897
50,6,69,California,San Benito County,8,8,3722,1853,1869
50,6,69,California,San Benito County,8,9,3681,1884,1797
50,6,69,California,San Benito County,8,10,3920,1895,2025
50,6,69,California,San Benito County,8,11,4145,2055,2090
50,6,69,California,San Benito County,8,12,3810,1903,1907
50,6,69,California,San Benito County,8,13,3239,1615,1624
50,6,69,California,San Benito County,8,14,2489,1227,1262
50,6,69,California,San Benito County,8,15,1687,785,902
50,6,69,California,San Benito County,8,16,1071,517,554
50,6,69,California,San Benito County,8,17,814,368,446
50,6,69,California,San Benito County,8,18,902,315,587
50,6,69,California,San Benito County,9,0,59225,29667,29558
50,6,69,California,San Benito County,9,1,3902,1959,1943
50,6,69,California,San Benito County,9,2,4291,2170,2121
50,6,69,California,San Benito County,9,3,4498,2278,2220
50,6,69,California,San Benito County,9,4,4461,2317,2144
50,6,69,California,San Benito County,9,5,4036,2043,1993
50,6,69,California,San Benito County,9,6,3809,2013,1796
50,6,69,California,San Benito County,9,7,4085,2128,1957
50,6,69,California,San Benito County,9,8,3828,1905,1923
50,6,69,California,San Benito County,9,9,3669,1893,1776
50,6,69,California,San Benito County,9,10,3924,1907,2017
50,6,69,California,San Benito County,9,11,4185,2072,2113
50,6,69,California,San Benito County,9,12,3901,1959,1942
50,6,69,California,San Benito County,9,13,3336,1675,1661
50,6,69,California,San Benito County,9,14,2641,1298,1343
50,6,69,California,San Benito County,9,15,1780,820,960
50,6,69,California,San Benito County,9,16,1155,541,614
50,6,69,California,San Benito County,9,17,780,358,422
50,6,69,California,San Benito County,9,18,944,331,613
50,6,69,California,San Benito County,10,0,60164,30121,30043
50,6,69,California,San Benito County,10,1,3938,1948,1990
50,6,69,California,San Benito County,10,2,4273,2151,2122
50,6,69,California,San Benito County,10,3,4594,2292,2302
50,6,69,California,San Benito County,10,4,4430,2322,2108
50,6,69,California,San Benito County,10,5,4042,2039,2003
50,6,69,California,San Benito County,10,6,3953,2061,1892
50,6,69,California,San Benito County,10,7,4182,2199,1983
50,6,69,California,San Benito County,10,8,4001,2020,1981
50,6,69,California,San Benito County,10,9,3758,1930,1828
50,6,69,California,San Benito County,10,10,3896,1928,1968
50,6,69,California,San Benito County,10,11,4086,1990,2096
50,6,69,California,San Benito County,10,12,4019,2020,1999
50,6,69,California,San Benito County,10,13,3434,1743,1691
50,6,69,California,San Benito County,10,14,2686,1286,1400
50,6,69,California,San Benito County,10,15,1887,891,996
50,6,69,California,San Benito County,10,16,1247,582,665
50,6,69,California,San Benito County,10,17,797,377,420
50,6,69,California,San Benito County,10,18,941,342,599
50,6,69,California,San Benito County,11,0,61467,30793,30674
50,6,69,California,San Benito County,11,1,4021,1985,2036
50,6,69,California,San Benito County,11,2,4310,2211,2099
50,6,69,California,San Benito County,11,3,4728,2317,2411
50,6,69,California,San Benito County,11,4,4443,2311,2132
50,6,69,California,San Benito County,11,5,4053,2040,2013
50,6,69,California,San Benito County,11,6,4131,2157,1974
50,6,69,California,San Benito County,11,7,4281,2239,2042
50,6,69,California,San Benito County,11,8,4176,2155,2021
50,6,69,California,San Benito County,11,9,3952,2036,1916
50,6,69,California,San Benito County,11,10,3878,1933,1945
50,6,69,California,San Benito County,11,11,4065,2011,2054
50,6,69,California,San Benito County,11,12,4087,2034,2053
50,6,69,California,San Benito County,11,13,3464,1721,1743
50,6,69,California,San Benito County,11,14,2749,1322,1427
50,6,69,California,San Benito County,11,15,1991,971,1020
50,6,69,California,San Benito County,11,16,1336,606,730
50,6,69,California,San Benito County,11,17,852,385,467
50,6,69,California,San Benito County,11,18,950,359,591
50,6,69,California,San Benito County,12,0,62808,31448,31360
50,6,69,California,San Benito County,12,1,4103,2018,2085
50,6,69,California,San Benito County,12,2,4369,2225,2144
50,6,69,California,San Benito County,12,3,4791,2359,2432
50,6,69,California,San Benito County,12,4,4406,2292,2114
50,6,69,California,San Benito County,12,5,4083,2096,1987
50,6,69,California,San Benito County,12,6,4209,2155,2054
50,6,69,California,San Benito County,12,7,4396,2272,2124
50,6,69,California,San Benito County,12,8,4528,2380,2148
50,6,69,California,San Benito County,12,9,4118,2118,2000
50,6,69,California,San Benito County,12,10,3845,1925,1920
50,6,69,California,San Benito County,12,11,4076,2024,2052
50,6,69,California,San Benito County,12,12,4052,1978,2074
50,6,69,California,San Benito County,12,13,3580,1774,1806
50,6,69,California,San Benito County,12,14,2863,1366,1497
50,6,69,California,San Benito County,12,15,2082,1045,1037
50,6,69,California,San Benito County,12,16,1435,651,784
50,6,69,California,San Benito County,12,17,894,390,504
50,6,69,California,San Benito County,12,18,978,380,598
50,6,71,California,San Bernardino County,1,0,2035210,1011507,1023703
50,6,71,California,San Bernardino County,1,1,158790,81204,77586
50,6,71,California,San Bernardino County,1,2,157368,80826,76542
50,6,71,California,San Bernardino County,1,3,168792,86488,82304
50,6,71,California,San Bernardino County,1,4,179627,92559,87068
50,6,71,California,San Bernardino County,1,5,159908,82686,77222
50,6,71,California,San Bernardino County,1,6,146477,74035,72442
50,6,71,California,San Bernardino County,1,7,135614,67251,68363
50,6,71,California,San Bernardino County,1,8,135711,66568,69143
50,6,71,California,San Bernardino County,1,9,137238,68259,68979
50,6,71,California,San Bernardino County,1,10,142691,70145,72546
50,6,71,California,San Bernardino County,1,11,134603,65998,68605
50,6,71,California,San Bernardino County,1,12,110620,53760,56860
50,6,71,California,San Bernardino County,1,13,86423,42112,44311
50,6,71,California,San Bernardino County,1,14,60089,28481,31608
50,6,71,California,San Bernardino County,1,15,43406,19885,23521
50,6,71,California,San Bernardino County,1,16,33065,14482,18583
50,6,71,California,San Bernardino County,1,17,23914,9643,14271
50,6,71,California,San Bernardino County,1,18,20874,7125,13749
50,6,71,California,San Bernardino County,2,0,2035183,1011496,1023687
50,6,71,California,San Bernardino County,2,1,158789,81204,77585
50,6,71,California,San Bernardino County,2,2,157362,80824,76538
50,6,71,California,San Bernardino County,2,3,168790,86486,82304
50,6,71,California,San Bernardino County,2,4,179627,92559,87068
50,6,71,California,San Bernardino County,2,5,159907,82685,77222
50,6,71,California,San Bernardino County,2,6,146476,74035,72441
50,6,71,California,San Bernardino County,2,7,135614,67251,68363
50,6,71,California,San Bernardino County,2,8,135709,66567,69142
50,6,71,California,San Bernardino County,2,9,137239,68261,68978
50,6,71,California,San Bernardino County,2,10,142687,70143,72544
50,6,71,California,San Bernardino County,2,11,134604,65999,68605
50,6,71,California,San Bernardino County,2,12,110615,53757,56858
50,6,71,California,San Bernardino County,2,13,86421,42111,44310
50,6,71,California,San Bernardino County,2,14,60088,28481,31607
50,6,71,California,San Bernardino County,2,15,43405,19884,23521
50,6,71,California,San Bernardino County,2,16,33065,14482,18583
50,6,71,California,San Bernardino County,2,17,23912,9642,14270
50,6,71,California,San Bernardino County,2,18,20873,7125,13748
50,6,71,California,San Bernardino County,3,0,2040848,1014385,1026463
50,6,71,California,San Bernardino County,3,1,158526,81087,77439
50,6,71,California,San Bernardino County,3,2,157495,80850,76645
50,6,71,California,San Bernardino County,3,3,168279,86265,82014
50,6,71,California,San Bernardino County,3,4,178637,92103,86534
50,6,71,California,San Bernardino County,3,5,161697,83536,78161
50,6,71,California,San Bernardino County,3,6,147258,74475,72783
50,6,71,California,San Bernardino County,3,7,136593,67834,68759
50,6,71,California,San Bernardino County,3,8,135451,66459,68992
50,6,71,California,San Bernardino County,3,9,137520,68310,69210
50,6,71,California,San Bernardino County,3,10,142380,70048,72332
50,6,71,California,San Bernardino County,3,11,135210,66314,68896
50,6,71,California,San Bernardino County,3,12,111626,54230,57396
50,6,71,California,San Bernardino County,3,13,87571,42631,44940
50,6,71,California,San Bernardino County,3,14,60681,28774,31907
50,6,71,California,San Bernardino County,3,15,43720,20063,23657
50,6,71,California,San Bernardino County,3,16,33096,14484,18612
50,6,71,California,San Bernardino County,3,17,24035,9727,14308
50,6,71,California,San Bernardino County,3,18,21073,7195,13878
50,6,71,California,San Bernardino County,4,0,2060827,1024252,1036575
50,6,71,California,San Bernardino County,4,1,158429,80971,77458
50,6,71,California,San Bernardino County,4,2,158271,81054,77217
50,6,71,California,San Bernardino County,4,3,166018,85121,80897
50,6,71,California,San Bernardino County,4,4,175059,90301,84758
50,6,71,California,San Bernardino County,4,5,167958,86652,81306
50,6,71,California,San Bernardino County,4,6,149719,75938,73781
50,6,71,California,San Bernardino County,4,7,139739,69842,69897
50,6,71,California,San Bernardino County,4,8,133739,65756,67983
50,6,71,California,San Bernardino County,4,9,138427,68443,69984
50,6,71,California,San Bernardino County,4,10,140130,69039,71091
50,6,71,California,San Bernardino County,4,11,137046,67219,69827
50,6,71,California,San Bernardino County,4,12,115378,55779,59599
50,6,71,California,San Bernardino County,4,13,92396,44924,47472
50,6,71,California,San Bernardino County,4,14,63335,30185,33150
50,6,71,California,San Bernardino County,4,15,45149,20777,24372
50,6,71,California,San Bernardino County,4,16,33700,14710,18990
50,6,71,California,San Bernardino County,4,17,24560,10109,14451
50,6,71,California,San Bernardino County,4,18,21774,7432,14342
50,6,71,California,San Bernardino County,5,0,2073512,1031682,1041830
50,6,71,California,San Bernardino County,5,1,156078,79848,76230
50,6,71,California,San Bernardino County,5,2,159597,81709,77888
50,6,71,California,San Bernardino County,5,3,162931,83574,79357
50,6,71,California,San Bernardino County,5,4,171167,88281,82886
50,6,71,California,San Bernardino County,5,5,172754,89600,83154
50,6,71,California,San Bernardino County,5,6,151633,77382,74251
50,6,71,California,San Bernardino County,5,7,142419,71545,70874
50,6,71,California,San Bernardino County,5,8,133486,65732,67754
50,6,71,California,San Bernardino County,5,9,137659,68029,69630
50,6,71,California,San Bernardino County,5,10,137024,67673,69351
50,6,71,California,San Bernardino County,5,11,137597,67399,70198
50,6,71,California,San Bernardino County,5,12,119506,57739,61767
50,6,71,California,San Bernardino County,5,13,93562,45242,48320
50,6,71,California,San Bernardino County,5,14,68933,33046,35887
50,6,71,California,San Bernardino County,5,15,47183,21699,25484
50,6,71,California,San Bernardino County,5,16,34451,15059,19392
50,6,71,California,San Bernardino County,5,17,24955,10364,14591
50,6,71,California,San Bernardino County,5,18,22577,7761,14816
50,6,71,California,San Bernardino County,6,0,2082738,1035673,1047065
50,6,71,California,San Bernardino County,6,1,153655,78187,75468
50,6,71,California,San Bernardino County,6,2,160345,82224,78121
50,6,71,California,San Bernardino County,6,3,160913,82498,78415
50,6,71,California,San Bernardino County,6,4,167326,86209,81117
50,6,71,California,San Bernardino County,6,5,174329,90684,83645
50,6,71,California,San Bernardino County,6,6,153707,78469,75238
50,6,71,California,San Bernardino County,6,7,144640,72722,71918
50,6,71,California,San Bernardino County,6,8,133657,65952,67705
50,6,71,California,San Bernardino County,6,9,136422,67127,69295
50,6,71,California,San Bernardino County,6,10,134768,66605,68163
50,6,71,California,San Bernardino County,6,11,137340,67255,70085
50,6,71,California,San Bernardino County,6,12,122649,59326,63323
50,6,71,California,San Bernardino County,6,13,96296,46380,49916
50,6,71,California,San Bernardino County,6,14,72561,34620,37941
50,6,71,California,San Bernardino County,6,15,50046,23092,26954
50,6,71,California,San Bernardino County,6,16,35522,15643,19879
50,6,71,California,San Bernardino County,6,17,25223,10526,14697
50,6,71,California,San Bernardino County,6,18,23339,8154,15185
50,6,71,California,San Bernardino County,7,0,2099181,1044576,1054605
50,6,71,California,San Bernardino County,7,1,153757,78298,75459
50,6,71,California,San Bernardino County,7,2,160276,82125,78151
50,6,71,California,San Bernardino County,7,3,159808,81927,77881
50,6,71,California,San Bernardino County,7,4,163603,84316,79287
50,6,71,California,San Bernardino County,7,5,175174,91444,83730
50,6,71,California,San Bernardino County,7,6,158391,80808,77583
50,6,71,California,San Bernardino County,7,7,147342,74420,72922
50,6,71,California,San Bernardino County,7,8,134527,66787,67740
50,6,71,California,San Bernardino County,7,9,135102,66298,68804
50,6,71,California,San Bernardino County,7,10,133360,66176,67184
50,6,71,California,San Bernardino County,7,11,137498,67358,70140
50,6,71,California,San Bernardino County,7,12,124941,60552,64389
50,6,71,California,San Bernardino County,7,13,100091,47955,52136
50,6,71,California,San Bernardino County,7,14,76299,36305,39994
50,6,71,California,San Bernardino County,7,15,52695,24369,28326
50,6,71,California,San Bernardino County,7,16,36572,16224,20348
50,6,71,California,San Bernardino County,7,17,25546,10635,14911
50,6,71,California,San Bernardino County,7,18,24199,8579,15620
50,6,71,California,San Bernardino County,8,0,2115411,1052822,1062589
50,6,71,California,San Bernardino County,8,1,154633,78866,75767
50,6,71,California,San Bernardino County,8,2,159680,81664,78016
50,6,71,California,San Bernardino County,8,3,158762,81249,77513
50,6,71,California,San Bernardino County,8,4,161503,83387,78116
50,6,71,California,San Bernardino County,8,5,172428,89887,82541
50,6,71,California,San Bernardino County,8,6,163742,83790,79952
50,6,71,California,San Bernardino County,8,7,148518,75237,73281
50,6,71,California,San Bernardino County,8,8,136940,68207,68733
50,6,71,California,San Bernardino County,8,9,133327,65385,67942
50,6,71,California,San Bernardino County,8,10,133398,66219,67179
50,6,71,California,San Bernardino County,8,11,136115,66611,69504
50,6,71,California,San Bernardino County,8,12,127564,61925,65639
50,6,71,California,San Bernardino County,8,13,104123,49846,54277
50,6,71,California,San Bernardino County,8,14,80638,38396,42242
50,6,71,California,San Bernardino County,8,15,55425,25682,29743
50,6,71,California,San Bernardino County,8,16,37650,16734,20916
50,6,71,California,San Bernardino County,8,17,25898,10782,15116
50,6,71,California,San Bernardino County,8,18,25067,8955,16112
50,6,71,California,San Bernardino County,9,0,2131960,1060947,1071013
50,6,71,California,San Bernardino County,9,1,154342,78842,75500
50,6,71,California,San Bernardino County,9,2,159857,81605,78252
50,6,71,California,San Bernardino County,9,3,159375,81580,77795
50,6,71,California,San Bernardino County,9,4,159874,82657,77217
50,6,71,California,San Bernardino County,9,5,168722,87943,80779
50,6,71,California,San Bernardino County,9,6,169333,86549,82784
50,6,71,California,San Bernardino County,9,7,150277,76305,73972
50,6,71,California,San Bernardino County,9,8,139484,69588,69896
50,6,71,California,San Bernardino County,9,9,132202,65046,67156
50,6,71,California,San Bernardino County,9,10,134315,66283,68032
50,6,71,California,San Bernardino County,9,11,133751,65520,68231
50,6,71,California,San Bernardino County,9,12,129528,62978,66550
50,6,71,California,San Bernardino County,9,13,107522,51301,56221
50,6,71,California,San Bernardino County,9,14,84817,40326,44491
50,6,71,California,San Bernardino County,9,15,57508,26690,30818
50,6,71,California,San Bernardino County,9,16,38911,17362,21549
50,6,71,California,San Bernardino County,9,17,26426,11028,15398
50,6,71,California,San Bernardino County,9,18,25716,9344,16372
50,6,71,California,San Bernardino County,10,0,2150945,1070810,1080135
50,6,71,California,San Bernardino County,10,1,154650,78998,75652
50,6,71,California,San Bernardino County,10,2,158687,80921,77766
50,6,71,California,San Bernardino County,10,3,161268,82441,78827
50,6,71,California,San Bernardino County,10,4,157755,81518,76237
50,6,71,California,San Bernardino County,10,5,166464,86829,79635
50,6,71,California,San Bernardino County,10,6,173950,89160,84790
50,6,71,California,San Bernardino County,10,7,152347,77632,74715
50,6,71,California,San Bernardino County,10,8,143033,71678,71355
50,6,71,California,San Bernardino County,10,9,132806,65548,67258
50,6,71,California,San Bernardino County,10,10,134491,66242,68249
50,6,71,California,San Bernardino County,10,11,131689,64735,66954
50,6,71,California,San Bernardino County,10,12,130476,63315,67161
50,6,71,California,San Bernardino County,10,13,111686,53322,58364
50,6,71,California,San Bernardino County,10,14,85705,40425,45280
50,6,71,California,San Bernardino County,10,15,62086,28993,33093
50,6,71,California,San Bernardino County,10,16,40538,18105,22433
50,6,71,California,San Bernardino County,10,17,27061,11298,15763
50,6,71,California,San Bernardino County,10,18,26253,9650,16603
50,6,71,California,San Bernardino County,11,0,2166753,1078997,1087756
50,6,71,California,San Bernardino County,11,1,154104,78797,75307
50,6,71,California,San Bernardino County,11,2,157992,80393,77599
50,6,71,California,San Bernardino County,11,3,162693,83449,79244
50,6,71,California,San Bernardino County,11,4,156596,81050,75546
50,6,71,California,San Bernardino County,11,5,163453,84846,78607
50,6,71,California,San Bernardino County,11,6,176336,90638,85698
50,6,71,California,San Bernardino County,11,7,155660,79592,76068
50,6,71,California,San Bernardino County,11,8,146305,73474,72831
50,6,71,California,San Bernardino County,11,9,133373,66063,67310
50,6,71,California,San Bernardino County,11,10,134012,65714,68298
50,6,71,California,San Bernardino County,11,11,130372,64216,66156
50,6,71,California,San Bernardino County,11,12,131032,63611,67421
50,6,71,California,San Bernardino County,11,13,114366,54689,59677
50,6,71,California,San Bernardino County,11,14,88116,41455,46661
50,6,71,California,San Bernardino County,11,15,64941,30300,34641
50,6,71,California,San Bernardino County,11,16,42833,19072,23761
50,6,71,California,San Bernardino County,11,17,27891,11793,16098
50,6,71,California,San Bernardino County,11,18,26678,9845,16833
50,6,71,California,San Bernardino County,12,0,2180085,1085607,1094478
50,6,71,California,San Bernardino County,12,1,152436,78190,74246
50,6,71,California,San Bernardino County,12,2,158121,80326,77795
50,6,71,California,San Bernardino County,12,3,163374,83752,79622
50,6,71,California,San Bernardino County,12,4,155664,80487,75177
50,6,71,California,San Bernardino County,12,5,159471,82600,76871
50,6,71,California,San Bernardino County,12,6,176802,90894,85908
50,6,71,California,San Bernardino County,12,7,160320,81802,78518
50,6,71,California,San Bernardino County,12,8,149035,75251,73784
50,6,71,California,San Bernardino County,12,9,134960,67087,67873
50,6,71,California,San Bernardino County,12,10,133092,65146,67946
50,6,71,California,San Bernardino County,12,11,128948,63701,65247
50,6,71,California,San Bernardino County,12,12,131079,63761,67318
50,6,71,California,San Bernardino County,12,13,116263,55565,60698
50,6,71,California,San Bernardino County,12,14,91744,43067,48677
50,6,71,California,San Bernardino County,12,15,68207,31807,36400
50,6,71,California,San Bernardino County,12,16,44728,19918,24810
50,6,71,California,San Bernardino County,12,17,28619,12121,16498
50,6,71,California,San Bernardino County,12,18,27222,10132,17090
50,6,73,California,San Diego County,1,0,3095313,1553679,1541634
50,6,73,California,San Diego County,1,1,203423,103833,99590
50,6,73,California,San Diego County,1,2,194029,99321,94708
50,6,73,California,San Diego County,1,3,198716,101903,96813
50,6,73,California,San Diego County,1,4,225095,118308,106787
50,6,73,California,San Diego County,1,5,270750,148641,122109
50,6,73,California,San Diego County,1,6,250737,131078,119659
50,6,73,California,San Diego County,1,7,220185,112648,107537
50,6,73,California,San Diego County,1,8,211012,106391,104621
50,6,73,California,San Diego County,1,9,209551,105283,104268
50,6,73,California,San Diego County,1,10,219795,110118,109677
50,6,73,California,San Diego County,1,11,210979,104346,106633
50,6,73,California,San Diego County,1,12,180305,87501,92804
50,6,73,California,San Diego County,1,13,149311,71683,77628
50,6,73,California,San Diego County,1,14,103241,48409,54832
50,6,73,California,San Diego County,1,15,77313,34739,42574
50,6,73,California,San Diego County,1,16,64347,28190,36157
50,6,73,California,San Diego County,1,17,52564,21706,30858
50,6,73,California,San Diego County,1,18,53960,19581,34379
50,6,73,California,San Diego County,2,0,3095349,1553693,1541656
50,6,73,California,San Diego County,2,1,203425,103833,99592
50,6,73,California,San Diego County,2,2,194032,99321,94711
50,6,73,California,San Diego County,2,3,198718,101905,96813
50,6,73,California,San Diego County,2,4,225099,118310,106789
50,6,73,California,San Diego County,2,5,270753,148642,122111
50,6,73,California,San Diego County,2,6,250739,131079,119660
50,6,73,California,San Diego County,2,7,220189,112649,107540
50,6,73,California,San Diego County,2,8,211013,106392,104621
50,6,73,California,San Diego County,2,9,209552,105283,104269
50,6,73,California,San Diego County,2,10,219798,110120,109678
50,6,73,California,San Diego County,2,11,210982,104346,106636
50,6,73,California,San Diego County,2,12,180306,87501,92805
50,6,73,California,San Diego County,2,13,149314,71684,77630
50,6,73,California,San Diego County,2,14,103243,48411,54832
50,6,73,California,San Diego County,2,15,77314,34740,42574
50,6,73,California,San Diego County,2,16,64347,28190,36157
50,6,73,California,San Diego County,2,17,52564,21706,30858
50,6,73,California,San Diego County,2,18,53961,19581,34380
50,6,73,California,San Diego County,3,0,3103212,1557270,1545942
50,6,73,California,San Diego County,3,1,204065,104106,99959
50,6,73,California,San Diego County,3,2,194238,99406,94832
50,6,73,California,San Diego County,3,3,198047,101515,96532
50,6,73,California,San Diego County,3,4,224342,117973,106369
50,6,73,California,San Diego County,3,5,271342,148514,122828
50,6,73,California,San Diego County,3,6,251679,131603,120076
50,6,73,California,San Diego County,3,7,222018,113670,108348
50,6,73,California,San Diego County,3,8,210535,106175,104360
50,6,73,California,San Diego County,3,9,210117,105536,104581
50,6,73,California,San Diego County,3,10,218996,109707,109289
50,6,73,California,San Diego County,3,11,211733,104764,106969
50,6,73,California,San Diego County,3,12,181787,88246,93541
50,6,73,California,San Diego County,3,13,150952,72458,78494
50,6,73,California,San Diego County,3,14,104419,49012,55407
50,6,73,California,San Diego County,3,15,77752,34955,42797
50,6,73,California,San Diego County,3,16,64157,28076,36081
50,6,73,California,San Diego County,3,17,52644,21832,30812
50,6,73,California,San Diego County,3,18,54389,19722,34667
50,6,73,California,San Diego County,4,0,3137156,1573405,1563751
50,6,73,California,San Diego County,4,1,207507,105740,101767
50,6,73,California,San Diego County,4,2,196070,100310,95760
50,6,73,California,San Diego County,4,3,196566,100667,95899
50,6,73,California,San Diego County,4,4,219489,115744,103745
50,6,73,California,San Diego County,4,5,274449,149345,125104
50,6,73,California,San Diego County,4,6,256201,134065,122136
50,6,73,California,San Diego County,4,7,229124,117380,111744
50,6,73,California,San Diego County,4,8,207644,104826,102818
50,6,73,California,San Diego County,4,9,212670,106551,106119
50,6,73,California,San Diego County,4,10,214892,107514,107378
50,6,73,California,San Diego County,4,11,214477,106309,108168
50,6,73,California,San Diego County,4,12,187457,90964,96493
50,6,73,California,San Diego County,4,13,158200,75890,82310
50,6,73,California,San Diego County,4,14,109440,51476,57964
50,6,73,California,San Diego County,4,15,79983,36052,43931
50,6,73,California,San Diego County,4,16,64344,28095,36249
50,6,73,California,San Diego County,4,17,52690,22139,30551
50,6,73,California,San Diego County,4,18,55953,20338,35615
50,6,73,California,San Diego County,5,0,3174335,1594263,1580072
50,6,73,California,San Diego County,5,1,208627,106621,102006
50,6,73,California,San Diego County,5,2,198878,101552,97326
50,6,73,California,San Diego County,5,3,194955,99698,95257
50,6,73,California,San Diego County,5,4,217119,114339,102780
50,6,73,California,San Diego County,5,5,276153,150975,125178
50,6,73,California,San Diego County,5,6,260882,137217,123665
50,6,73,California,San Diego County,5,7,236393,121431,114962
50,6,73,California,San Diego County,5,8,209075,105781,103294
50,6,73,California,San Diego County,5,9,213502,107117,106385
50,6,73,California,San Diego County,5,10,211336,105692,105644
50,6,73,California,San Diego County,5,11,215563,107136,108427
50,6,73,California,San Diego County,5,12,193782,94055,99727
50,6,73,California,San Diego County,5,13,159390,76543,82847
50,6,73,California,San Diego County,5,14,120490,56804,63686
50,6,73,California,San Diego County,5,15,83154,37691,45463
50,6,73,California,San Diego County,5,16,64922,28351,36571
50,6,73,California,San Diego County,5,17,52760,22356,30404
50,6,73,California,San Diego County,5,18,57354,20904,36450
50,6,73,California,San Diego County,6,0,3209768,1611493,1598275
50,6,73,California,San Diego County,6,1,210328,107546,102782
50,6,73,California,San Diego County,6,2,201030,102588,98442
50,6,73,California,San Diego County,6,3,194316,99300,95016
50,6,73,California,San Diego County,6,4,214212,112017,102195
50,6,73,California,San Diego County,6,5,273181,149611,123570
50,6,73,California,San Diego County,6,6,267578,140645,126933
50,6,73,California,San Diego County,6,7,243908,125715,118193
50,6,73,California,San Diego County,6,8,212125,107511,104614
50,6,73,California,San Diego County,6,9,212833,106490,106343
50,6,73,California,San Diego County,6,10,208772,104413,104359
50,6,73,California,San Diego County,6,11,216360,107503,108857
50,6,73,California,San Diego County,6,12,198533,96721,101812
50,6,73,California,San Diego County,6,13,163250,78386,84864
50,6,73,California,San Diego County,6,14,127805,60165,67640
50,6,73,California,San Diego County,6,15,88370,40271,48099
50,6,73,California,San Diego County,6,16,66133,28987,37146
50,6,73,California,San Diego County,6,17,52693,22355,30338
50,6,73,California,San Diego County,6,18,58341,21269,37072
50,6,73,California,San Diego County,7,0,3248877,1633309,1615568
50,6,73,California,San Diego County,7,1,213141,109127,104014
50,6,73,California,San Diego County,7,2,200859,102407,98452
50,6,73,California,San Diego County,7,3,194184,99128,95056
50,6,73,California,San Diego County,7,4,212125,110977,101148
50,6,73,California,San Diego County,7,5,272024,151068,120956
50,6,73,California,San Diego County,7,6,275914,144701,131213
50,6,73,California,San Diego County,7,7,249905,129066,120839
50,6,73,California,San Diego County,7,8,216072,109906,106166
50,6,73,California,San Diego County,7,9,211498,105968,105530
50,6,73,California,San Diego County,7,10,206780,103274,103506
50,6,73,California,San Diego County,7,11,216991,107895,109096
50,6,73,California,San Diego County,7,12,201587,98372,103215
50,6,73,California,San Diego County,7,13,168773,80994,87779
50,6,73,California,San Diego County,7,14,135886,64094,71792
50,6,73,California,San Diego County,7,15,92705,42420,50285
50,6,73,California,San Diego County,7,16,68031,29826,38205
50,6,73,California,San Diego County,7,17,52677,22254,30423
50,6,73,California,San Diego County,7,18,59725,21832,37893
50,6,73,California,San Diego County,8,0,3280850,1651711,1629139
50,6,73,California,San Diego County,8,1,214607,110065,104542
50,6,73,California,San Diego County,8,2,199902,101930,97972
50,6,73,California,San Diego County,8,3,193819,99019,94800
50,6,73,California,San Diego County,8,4,211253,110494,100759
50,6,73,California,San Diego County,8,5,267929,150233,117696
50,6,73,California,San Diego County,8,6,282575,147987,134588
50,6,73,California,San Diego County,8,7,253299,131169,122130
50,6,73,California,San Diego County,8,8,221681,113194,108487
50,6,73,California,San Diego County,8,9,208788,104774,104014
50,6,73,California,San Diego County,8,10,207825,103656,104169
50,6,73,California,San Diego County,8,11,215033,106959,108074
50,6,73,California,San Diego County,8,12,205143,100646,104497
50,6,73,California,San Diego County,8,13,174288,83541,90747
50,6,73,California,San Diego County,8,14,143270,67678,75592
50,6,73,California,San Diego County,8,15,97638,44822,52816
50,6,73,California,San Diego County,8,16,69626,30520,39106
50,6,73,California,San Diego County,8,17,52680,22177,30503
50,6,73,California,San Diego County,8,18,61494,22847,38647
50,6,73,California,San Diego County,9,0,3306089,1664729,1641360
50,6,73,California,San Diego County,9,1,213032,109447,103585
50,6,73,California,San Diego County,9,2,200586,102152,98434
50,6,73,California,San Diego County,9,3,194401,99417,94984
50,6,73,California,San Diego County,9,4,209387,109420,99967
50,6,73,California,San Diego County,9,5,262475,147226,115249
50,6,73,California,San Diego County,9,6,287556,150513,137043
50,6,73,California,San Diego County,9,7,257114,133687,123427
50,6,73,California,San Diego County,9,8,228322,116745,111577
50,6,73,California,San Diego County,9,9,206296,103660,102636
50,6,73,California,San Diego County,9,10,210152,104661,105491
50,6,73,California,San Diego County,9,11,210599,104690,105909
50,6,73,California,San Diego County,9,12,207440,102130,105310
50,6,73,California,San Diego County,9,13,179449,85900,93549
50,6,73,California,San Diego County,9,14,149944,70832,79112
50,6,73,California,San Diego County,9,15,102322,47105,55217
50,6,73,California,San Diego County,9,16,71461,31413,40048
50,6,73,California,San Diego County,9,17,52885,22294,30591
50,6,73,California,San Diego County,9,18,62668,23437,39231
50,6,73,California,San Diego County,10,0,3321237,1672189,1649048
50,6,73,California,San Diego County,10,1,210565,107924,102641
50,6,73,California,San Diego County,10,2,200421,102428,97993
50,6,73,California,San Diego County,10,3,196147,99971,96176
50,6,73,California,San Diego County,10,4,206884,108133,98751
50,6,73,California,San Diego County,10,5,255126,142549,112577
50,6,73,California,San Diego County,10,6,288488,151295,137193
50,6,73,California,San Diego County,10,7,260528,135757,124771
50,6,73,California,San Diego County,10,8,233955,120034,113921
50,6,73,California,San Diego County,10,9,206820,104014,102806
50,6,73,California,San Diego County,10,10,210097,104796,105301
50,6,73,California,San Diego County,10,11,206753,102724,104029
50,6,73,California,San Diego County,10,12,207755,102400,105355
50,6,73,California,San Diego County,10,13,184176,88229,95947
50,6,73,California,San Diego County,10,14,150405,70977,79428
50,6,73,California,San Diego County,10,15,112065,51707,60358
50,6,73,California,San Diego County,10,16,74272,32912,41360
50,6,73,California,San Diego County,10,17,53432,22490,30942
50,6,73,California,San Diego County,10,18,63348,23849,39499
50,6,73,California,San Diego County,11,0,3333861,1678934,1654927
50,6,73,California,San Diego County,11,1,207026,106070,100956
50,6,73,California,San Diego County,11,2,200196,102461,97735
50,6,73,California,San Diego County,11,3,196531,100248,96283
50,6,73,California,San Diego County,11,4,206402,107716,98686
50,6,73,California,San Diego County,11,5,250628,139506,111122
50,6,73,California,San Diego County,11,6,285945,150315,135630
50,6,73,California,San Diego County,11,7,264129,137739,126390
50,6,73,California,San Diego County,11,8,239762,123576,116186
50,6,73,California,San Diego County,11,9,208080,104783,103297
50,6,73,California,San Diego County,11,10,208311,103777,104534
50,6,73,California,San Diego County,11,11,203213,101078,102135
50,6,73,California,San Diego County,11,12,207802,102460,105342
50,6,73,California,San Diego County,11,13,187322,90187,97135
50,6,73,California,San Diego County,11,14,152966,72068,80898
50,6,73,California,San Diego County,11,15,118414,54655,63759
50,6,73,California,San Diego County,11,16,78794,35200,43594
50,6,73,California,San Diego County,11,17,54355,23033,31322
50,6,73,California,San Diego County,11,18,63985,24062,39923
50,6,73,California,San Diego County,12,0,3338330,1680017,1658313
50,6,73,California,San Diego County,12,1,203165,103970,99195
50,6,73,California,San Diego County,12,2,201311,103048,98263
50,6,73,California,San Diego County,12,3,195022,99590,95432
50,6,73,California,San Diego County,12,4,205987,107109,98878
50,6,73,California,San Diego County,12,5,244673,135358,109315
50,6,73,California,San Diego County,12,6,281148,148473,132675
50,6,73,California,San Diego County,12,7,268417,139551,128866
50,6,73,California,San Diego County,12,8,242776,125204,117572
50,6,73,California,San Diego County,12,9,210016,106172,103844
50,6,73,California,San Diego County,12,10,205606,102642,102964
50,6,73,California,San Diego County,12,11,199802,99153,100649
50,6,73,California,San Diego County,12,12,206946,102111,104835
50,6,73,California,San Diego County,12,13,189009,91272,97737
50,6,73,California,San Diego County,12,14,156864,73854,83010
50,6,73,California,San Diego County,12,15,124821,57458,67363
50,6,73,California,San Diego County,12,16,82334,37075,45259
50,6,73,California,San Diego County,12,17,55843,23675,32168
50,6,73,California,San Diego County,12,18,64590,24302,40288
50,6,75,California,San Francisco County,1,0,805235,408462,396773
50,6,75,California,San Francisco County,1,1,35203,17963,17240
50,6,75,California,San Francisco County,1,2,28462,14466,13996
50,6,75,California,San Francisco County,1,3,26299,13467,12832
50,6,75,California,San Francisco County,1,4,34606,16888,17718
50,6,75,California,San Francisco County,1,5,60618,29269,31349
50,6,75,California,San Francisco County,1,6,88156,44178,43978
50,6,75,California,San Francisco County,1,7,79964,41351,38613
50,6,75,California,San Francisco County,1,8,70813,38264,32549
50,6,75,California,San Francisco County,1,9,62869,34906,27963
50,6,75,California,San Francisco County,1,10,57577,31783,25794
50,6,75,California,San Francisco County,1,11,54230,28957,25273
50,6,75,California,San Francisco County,1,12,51708,26777,24931
50,6,75,California,San Francisco County,1,13,44888,22455,22433
50,6,75,California,San Francisco County,1,14,29780,14318,15462
50,6,75,California,San Francisco County,1,15,24542,11274,13268
50,6,75,California,San Francisco County,1,16,20839,9294,11545
50,6,75,California,San Francisco County,1,17,17190,6878,10312
50,6,75,California,San Francisco County,1,18,17491,5974,11517
50,6,75,California,San Francisco County,2,0,805184,408436,396748
50,6,75,California,San Francisco County,2,1,35198,17958,17240
50,6,75,California,San Francisco County,2,2,28462,14466,13996
50,6,75,California,San Francisco County,2,3,26301,13468,12833
50,6,75,California,San Francisco County,2,4,34603,16888,17715
50,6,75,California,San Francisco County,2,5,60614,29267,31347
50,6,75,California,San Francisco County,2,6,88148,44176,43972
50,6,75,California,San Francisco County,2,7,79959,41347,38612
50,6,75,California,San Francisco County,2,8,70808,38260,32548
50,6,75,California,San Francisco County,2,9,62865,34903,27962
50,6,75,California,San Francisco County,2,10,57579,31783,25796
50,6,75,California,San Francisco County,2,11,54226,28956,25270
50,6,75,California,San Francisco County,2,12,51707,26776,24931
50,6,75,California,San Francisco County,2,13,44887,22456,22431
50,6,75,California,San Francisco County,2,14,29779,14319,15460
50,6,75,California,San Francisco County,2,15,24536,11272,13264
50,6,75,California,San Francisco County,2,16,20833,9291,11542
50,6,75,California,San Francisco County,2,17,17189,6877,10312
50,6,75,California,San Francisco County,2,18,17490,5973,11517
50,6,75,California,San Francisco County,3,0,805505,408599,396906
50,6,75,California,San Francisco County,3,1,35388,18099,17289
50,6,75,California,San Francisco County,3,2,28500,14439,14061
50,6,75,California,San Francisco County,3,3,26307,13469,12838
50,6,75,California,San Francisco County,3,4,33990,16624,17366
50,6,75,California,San Francisco County,3,5,59804,28905,30899
50,6,75,California,San Francisco County,3,6,88150,44116,44034
50,6,75,California,San Francisco County,3,7,80363,41522,38841
50,6,75,California,San Francisco County,3,8,70436,37982,32454
50,6,75,California,San Francisco County,3,9,63195,35030,28165
50,6,75,California,San Francisco County,3,10,57694,31871,25823
50,6,75,California,San Francisco County,3,11,54217,29028,25189
50,6,75,California,San Francisco County,3,12,51719,26756,24963
50,6,75,California,San Francisco County,3,13,45439,22754,22685
50,6,75,California,San Francisco County,3,14,30036,14452,15584
50,6,75,California,San Francisco County,3,15,24628,11322,13306
50,6,75,California,San Francisco County,3,16,20760,9266,11494
50,6,75,California,San Francisco County,3,17,17228,6937,10291
50,6,75,California,San Francisco County,3,18,17651,6027,11624
50,6,75,California,San Francisco County,4,0,815650,413943,401707
50,6,75,California,San Francisco County,4,1,36582,18784,17798
50,6,75,California,San Francisco County,4,2,29024,14632,14392
50,6,75,California,San Francisco County,4,3,26645,13501,13144
50,6,75,California,San Francisco County,4,4,32138,15791,16347
50,6,75,California,San Francisco County,4,5,57496,27888,29608
50,6,75,California,San Francisco County,4,6,91220,45806,45414
50,6,75,California,San Francisco County,4,7,83324,43052,40272
50,6,75,California,San Francisco County,4,8,69501,37178,32323
50,6,75,California,San Francisco County,4,9,64995,35784,29211
50,6,75,California,San Francisco County,4,10,58214,32211,26003
50,6,75,California,San Francisco County,4,11,54164,29229,24935
50,6,75,California,San Francisco County,4,12,52275,26998,25277
50,6,75,California,San Francisco County,4,13,47871,23942,23929
50,6,75,California,San Francisco County,4,14,31154,15063,16091
50,6,75,California,San Francisco County,4,15,24818,11459,13359
50,6,75,California,San Francisco County,4,16,20758,9297,11461
50,6,75,California,San Francisco County,4,17,17316,7094,10222
50,6,75,California,San Francisco County,4,18,18155,6234,11921
50,6,75,California,San Francisco County,5,0,828876,421275,407601
50,6,75,California,San Francisco County,5,1,37593,19294,18299
50,6,75,California,San Francisco County,5,2,29964,15221,14743
50,6,75,California,San Francisco County,5,3,26733,13478,13255
50,6,75,California,San Francisco County,5,4,31328,15313,16015
50,6,75,California,San Francisco County,5,5,55552,26997,28555
50,6,75,California,San Francisco County,5,6,93957,47573,46384
50,6,75,California,San Francisco County,5,7,87060,45084,41976
50,6,75,California,San Francisco County,5,8,70379,37440,32939
50,6,75,California,San Francisco County,5,9,65984,36187,29797
50,6,75,California,San Francisco County,5,10,58570,32517,26053
50,6,75,California,San Francisco County,5,11,54395,29336,25059
50,6,75,California,San Francisco County,5,12,52927,27531,25396
50,6,75,California,San Francisco County,5,13,48423,24234,24189
50,6,75,California,San Francisco County,5,14,34047,16501,17546
50,6,75,California,San Francisco County,5,15,25033,11549,13484
50,6,75,California,San Francisco County,5,16,20909,9378,11531
50,6,75,California,San Francisco County,5,17,17177,7095,10082
50,6,75,California,San Francisco County,5,18,18845,6547,12298
50,6,75,California,San Francisco County,6,0,839572,427426,412146
50,6,75,California,San Francisco County,6,1,38481,19750,18731
50,6,75,California,San Francisco County,6,2,30570,15521,15049
50,6,75,California,San Francisco County,6,3,27234,13773,13461
50,6,75,California,San Francisco County,6,4,30767,15034,15733
50,6,75,California,San Francisco County,6,5,53150,25842,27308
50,6,75,California,San Francisco County,6,6,96662,49152,47510
50,6,75,California,San Francisco County,6,7,90747,47327,43420
50,6,75,California,San Francisco County,6,8,70599,37491,33108
50,6,75,California,San Francisco County,6,9,65889,35890,29999
50,6,75,California,San Francisco County,6,10,58651,32505,26146
50,6,75,California,San Francisco County,6,11,54963,29771,25192
50,6,75,California,San Francisco County,6,12,53230,27786,25444
50,6,75,California,San Francisco County,6,13,48879,24494,24385
50,6,75,California,San Francisco County,6,14,36561,17767,18794
50,6,75,California,San Francisco County,6,15,25444,11836,13608
50,6,75,California,San Francisco County,6,16,21127,9430,11697
50,6,75,California,San Francisco County,6,17,17068,7178,9890
50,6,75,California,San Francisco County,6,18,19550,6879,12671
50,6,75,California,San Francisco County,7,0,850750,433767,416983
50,6,75,California,San Francisco County,7,1,39011,20062,18949
50,6,75,California,San Francisco County,7,2,30990,15774,15216
50,6,75,California,San Francisco County,7,3,27894,14215,13679
50,6,75,California,San Francisco County,7,4,30489,14844,15645
50,6,75,California,San Francisco County,7,5,51521,25151,26370
50,6,75,California,San Francisco County,7,6,99565,50962,48603
50,6,75,California,San Francisco County,7,7,94369,49378,44991
50,6,75,California,San Francisco County,7,8,71132,37661,33471
50,6,75,California,San Francisco County,7,9,65120,35322,29798
50,6,75,California,San Francisco County,7,10,59004,32522,26482
50,6,75,California,San Francisco County,7,11,55666,30256,25410
50,6,75,California,San Francisco County,7,12,52983,27714,25269
50,6,75,California,San Francisco County,7,13,49274,24769,24505
50,6,75,California,San Francisco County,7,14,39096,19040,20056
50,6,75,California,San Francisco County,7,15,26018,12127,13891
50,6,75,California,San Francisco County,7,16,21288,9498,11790
50,6,75,California,San Francisco County,7,17,17105,7280,9825
50,6,75,California,San Francisco County,7,18,20225,7192,13033
50,6,75,California,San Francisco County,8,0,863010,440323,422687
50,6,75,California,San Francisco County,8,1,40055,20659,19396
50,6,75,California,San Francisco County,8,2,31087,15848,15239
50,6,75,California,San Francisco County,8,3,28292,14274,14018
50,6,75,California,San Francisco County,8,4,30146,14754,15392
50,6,75,California,San Francisco County,8,5,50495,24818,25677
50,6,75,California,San Francisco County,8,6,102509,52759,49750
50,6,75,California,San Francisco County,8,7,97833,51139,46694
50,6,75,California,San Francisco County,8,8,72614,38315,34299
50,6,75,California,San Francisco County,8,9,63686,34296,29390
50,6,75,California,San Francisco County,8,10,60224,33068,27156
50,6,75,California,San Francisco County,8,11,55997,30548,25449
50,6,75,California,San Francisco County,8,12,52895,27797,25098
50,6,75,California,San Francisco County,8,13,49089,24724,24365
50,6,75,California,San Francisco County,8,14,41779,20340,21439
50,6,75,California,San Francisco County,8,15,26850,12577,14273
50,6,75,California,San Francisco County,8,16,21530,9605,11925
50,6,75,California,San Francisco County,8,17,17017,7253,9764
50,6,75,California,San Francisco County,8,18,20912,7549,13363
50,6,75,California,San Francisco County,9,0,871512,444409,427103
50,6,75,California,San Francisco County,9,1,39990,20466,19524
50,6,75,California,San Francisco County,9,2,31739,16271,15468
50,6,75,California,San Francisco County,9,3,28670,14413,14257
50,6,75,California,San Francisco County,9,4,30205,14709,15496
50,6,75,California,San Francisco County,9,5,49098,24259,24839
50,6,75,California,San Francisco County,9,6,104805,53902,50903
50,6,75,California,San Francisco County,9,7,100756,52599,48157
50,6,75,California,San Francisco County,9,8,74189,39302,34887
50,6,75,California,San Francisco County,9,9,62032,33110,28922
50,6,75,California,San Francisco County,9,10,60797,33082,27715
50,6,75,California,San Francisco County,9,11,55949,30609,25340
50,6,75,California,San Francisco County,9,12,52484,27753,24731
50,6,75,California,San Francisco County,9,13,49279,24868,24411
50,6,75,California,San Francisco County,9,14,43547,21188,22359
50,6,75,California,San Francisco County,9,15,27750,13053,14697
50,6,75,California,San Francisco County,9,16,21754,9745,12009
50,6,75,California,San Francisco County,9,17,17008,7286,9722
50,6,75,California,San Francisco County,9,18,21460,7794,13666
50,6,75,California,San Francisco County,10,0,878040,447916,430124
50,6,75,California,San Francisco County,10,1,40064,20467,19597
50,6,75,California,San Francisco County,10,2,31931,16456,15475
50,6,75,California,San Francisco County,10,3,29355,14811,14544
50,6,75,California,San Francisco County,10,4,30334,14754,15580
50,6,75,California,San Francisco County,10,5,48103,23635,24468
50,6,75,California,San Francisco County,10,6,105114,54232,50882
50,6,75,California,San Francisco County,10,7,102794,53855,48939
50,6,75,California,San Francisco County,10,8,76358,40576,35782
50,6,75,California,San Francisco County,10,9,61177,32391,28786
50,6,75,California,San Francisco County,10,10,60768,32992,27776
50,6,75,California,San Francisco County,10,11,55516,30353,25163
50,6,75,California,San Francisco County,10,12,52103,27497,24606
50,6,75,California,San Francisco County,10,13,49367,25012,24355
50,6,75,California,San Francisco County,10,14,43908,21360,22548
50,6,75,California,San Francisco County,10,15,30289,14352,15937
50,6,75,California,San Francisco County,10,16,21731,9720,12011
50,6,75,California,San Francisco County,10,17,17313,7419,9894
50,6,75,California,San Francisco County,10,18,21815,8034,13781
50,6,75,California,San Francisco County,11,0,880696,449090,431606
50,6,75,California,San Francisco County,11,1,39692,20264,19428
50,6,75,California,San Francisco County,11,2,32146,16539,15607
50,6,75,California,San Francisco County,11,3,29585,14967,14618
50,6,75,California,San Francisco County,11,4,30699,14905,15794
50,6,75,California,San Francisco County,11,5,47130,23097,24033
50,6,75,California,San Francisco County,11,6,103156,53232,49924
50,6,75,California,San Francisco County,11,7,104668,54857,49811
50,6,75,California,San Francisco County,11,8,78449,41785,36664
50,6,75,California,San Francisco County,11,9,60542,32029,28513
50,6,75,California,San Francisco County,11,10,59725,32167,27558
50,6,75,California,San Francisco County,11,11,54951,30000,24951
50,6,75,California,San Francisco County,11,12,52217,27569,24648
50,6,75,California,San Francisco County,11,13,49347,25124,24223
50,6,75,California,San Francisco County,11,14,44202,21495,22707
50,6,75,California,San Francisco County,11,15,32501,15373,17128
50,6,75,California,San Francisco County,11,16,22019,9936,12083
50,6,75,California,San Francisco County,11,17,17515,7454,10061
50,6,75,California,San Francisco County,11,18,22152,8297,13855
50,6,75,California,San Francisco County,12,0,881549,449221,432328
50,6,75,California,San Francisco County,12,1,39353,20055,19298
50,6,75,California,San Francisco County,12,2,32076,16424,15652
50,6,75,California,San Francisco County,12,3,29750,15115,14635
50,6,75,California,San Francisco County,12,4,30978,15040,15938
50,6,75,California,San Francisco County,12,5,46364,22642,23722
50,6,75,California,San Francisco County,12,6,100792,51910,48882
50,6,75,California,San Francisco County,12,7,106193,55869,50324
50,6,75,California,San Francisco County,12,8,80021,42683,37338
50,6,75,California,San Francisco County,12,9,60192,31706,28486
50,6,75,California,San Francisco County,12,10,58162,31041,27121
50,6,75,California,San Francisco County,12,11,54783,29758,25025
50,6,75,California,San Francisco County,12,12,52337,27841,24496
50,6,75,California,San Francisco County,12,13,48778,24793,23985
50,6,75,California,San Francisco County,12,14,44385,21655,22730
50,6,75,California,San Francisco County,12,15,34828,16503,18325
50,6,75,California,San Francisco County,12,16,22503,10150,12353
50,6,75,California,San Francisco County,12,17,17601,7505,10096
50,6,75,California,San Francisco County,12,18,22453,8531,13922
50,6,77,California,San Joaquin County,1,0,685306,341230,344076
50,6,77,California,San Joaquin County,1,1,54228,27820,26408
50,6,77,California,San Joaquin County,1,2,54810,27980,26830
50,6,77,California,San Joaquin County,1,3,56165,28769,27396
50,6,77,California,San Joaquin County,1,4,58382,30397,27985
50,6,77,California,San Joaquin County,1,5,48451,25280,23171
50,6,77,California,San Joaquin County,1,6,46230,23660,22570
50,6,77,California,San Joaquin County,1,7,44585,22160,22425
50,6,77,California,San Joaquin County,1,8,44909,22159,22750
50,6,77,California,San Joaquin County,1,9,45829,23110,22719
50,6,77,California,San Joaquin County,1,10,47474,23753,23721
50,6,77,California,San Joaquin County,1,11,44365,22143,22222
50,6,77,California,San Joaquin County,1,12,37649,18270,19379
50,6,77,California,San Joaquin County,1,13,31048,15023,16025
50,6,77,California,San Joaquin County,1,14,22389,10432,11957
50,6,77,California,San Joaquin County,1,15,16141,7361,8780
50,6,77,California,San Joaquin County,1,16,12575,5435,7140
50,6,77,California,San Joaquin County,1,17,10134,4051,6083
50,6,77,California,San Joaquin County,1,18,9942,3427,6515
50,6,77,California,San Joaquin County,2,0,685306,341231,344075
50,6,77,California,San Joaquin County,2,1,54228,27820,26408
50,6,77,California,San Joaquin County,2,2,54810,27980,26830
50,6,77,California,San Joaquin County,2,3,56165,28769,27396
50,6,77,California,San Joaquin County,2,4,58382,30397,27985
50,6,77,California,San Joaquin County,2,5,48451,25280,23171
50,6,77,California,San Joaquin County,2,6,46230,23660,22570
50,6,77,California,San Joaquin County,2,7,44585,22160,22425
50,6,77,California,San Joaquin County,2,8,44909,22159,22750
50,6,77,California,San Joaquin County,2,9,45829,23110,22719
50,6,77,California,San Joaquin County,2,10,47474,23753,23721
50,6,77,California,San Joaquin County,2,11,44365,22143,22222
50,6,77,California,San Joaquin County,2,12,37651,18272,19379
50,6,77,California,San Joaquin County,2,13,31048,15023,16025
50,6,77,California,San Joaquin County,2,14,22387,10431,11956
50,6,77,California,San Joaquin County,2,15,16141,7361,8780
50,6,77,California,San Joaquin County,2,16,12575,5435,7140
50,6,77,California,San Joaquin County,2,17,10134,4051,6083
50,6,77,California,San Joaquin County,2,18,9942,3427,6515
50,6,77,California,San Joaquin County,3,0,687127,342072,345055
50,6,77,California,San Joaquin County,3,1,54169,27758,26411
50,6,77,California,San Joaquin County,3,2,54839,27993,26846
50,6,77,California,San Joaquin County,3,3,56154,28775,27379
50,6,77,California,San Joaquin County,3,4,58008,30204,27804
50,6,77,California,San Joaquin County,3,5,49036,25556,23480
50,6,77,California,San Joaquin County,3,6,46307,23693,22614
50,6,77,California,San Joaquin County,3,7,44811,22284,22527
50,6,77,California,San Joaquin County,3,8,44840,22120,22720
50,6,77,California,San Joaquin County,3,9,45914,23105,22809
50,6,77,California,San Joaquin County,3,10,47389,23720,23669
50,6,77,California,San Joaquin County,3,11,44647,22291,22356
50,6,77,California,San Joaquin County,3,12,37956,18437,19519
50,6,77,California,San Joaquin County,3,13,31429,15169,16260
50,6,77,California,San Joaquin County,3,14,22583,10557,12026
50,6,77,California,San Joaquin County,3,15,16286,7425,8861
50,6,77,California,San Joaquin County,3,16,12590,5451,7139
50,6,77,California,San Joaquin County,3,17,10135,4060,6075
50,6,77,California,San Joaquin County,3,18,10034,3474,6560
50,6,77,California,San Joaquin County,4,0,694354,345463,348891
50,6,77,California,San Joaquin County,4,1,53816,27458,26358
50,6,77,California,San Joaquin County,4,2,55130,28178,26952
50,6,77,California,San Joaquin County,4,3,56135,28815,27320
50,6,77,California,San Joaquin County,4,4,56718,29452,27266
50,6,77,California,San Joaquin County,4,5,51047,26502,24545
50,6,77,California,San Joaquin County,4,6,46798,24080,22718
50,6,77,California,San Joaquin County,4,7,45632,22683,22949
50,6,77,California,San Joaquin County,4,8,44339,21907,22432
50,6,77,California,San Joaquin County,4,9,46276,23044,23232
50,6,77,California,San Joaquin County,4,10,46892,23586,23306
50,6,77,California,San Joaquin County,4,11,45472,22693,22779
50,6,77,California,San Joaquin County,4,12,39121,19112,20009
50,6,77,California,San Joaquin County,4,13,33110,15816,17294
50,6,77,California,San Joaquin County,4,14,23510,11100,12410
50,6,77,California,San Joaquin County,4,15,16944,7710,9234
50,6,77,California,San Joaquin County,4,16,12840,5582,7258
50,6,77,California,San Joaquin County,4,17,10096,4071,6025
50,6,77,California,San Joaquin County,4,18,10478,3674,6804
50,6,77,California,San Joaquin County,5,0,699593,347804,351789
50,6,77,California,San Joaquin County,5,1,53152,27239,25913
50,6,77,California,San Joaquin County,5,2,55760,28438,27322
50,6,77,California,San Joaquin County,5,3,55891,28771,27120
50,6,77,California,San Joaquin County,5,4,55742,28909,26833
50,6,77,California,San Joaquin County,5,5,52230,26962,25268
50,6,77,California,San Joaquin County,5,6,46956,24023,22933
50,6,77,California,San Joaquin County,5,7,46609,23189,23420
50,6,77,California,San Joaquin County,5,8,44017,21785,22232
50,6,77,California,San Joaquin County,5,9,46226,22917,23309
50,6,77,California,San Joaquin County,5,10,46193,23336,22857
50,6,77,California,San Joaquin County,5,11,45852,22677,23175
50,6,77,California,San Joaquin County,5,12,40340,19855,20485
50,6,77,California,San Joaquin County,5,13,33374,15902,17472
50,6,77,California,San Joaquin County,5,14,25685,12134,13551
50,6,77,California,San Joaquin County,5,15,17778,8100,9678
50,6,77,California,San Joaquin County,5,16,13087,5731,7356
50,6,77,California,San Joaquin County,5,17,9921,4039,5882
50,6,77,California,San Joaquin County,5,18,10780,3797,6983
50,6,77,California,San Joaquin County,6,0,702046,348551,353495
50,6,77,California,San Joaquin County,6,1,52426,27008,25418
50,6,77,California,San Joaquin County,6,2,56039,28560,27479
50,6,77,California,San Joaquin County,6,3,55448,28447,27001
50,6,77,California,San Joaquin County,6,4,54909,28327,26582
50,6,77,California,San Joaquin County,6,5,52229,26836,25393
50,6,77,California,San Joaquin County,6,6,46986,23949,23037
50,6,77,California,San Joaquin County,6,7,46947,23472,23475
50,6,77,California,San Joaquin County,6,8,44134,21757,22377
50,6,77,California,San Joaquin County,6,9,45872,22566,23306
50,6,77,California,San Joaquin County,6,10,45393,22958,22435
50,6,77,California,San Joaquin County,6,11,46041,22798,23243
50,6,77,California,San Joaquin County,6,12,41290,20360,20930
50,6,77,California,San Joaquin County,6,13,34039,16261,17778
50,6,77,California,San Joaquin County,6,14,27005,12764,14241
50,6,77,California,San Joaquin County,6,15,18851,8589,10262
50,6,77,California,San Joaquin County,6,16,13428,5916,7512
50,6,77,California,San Joaquin County,6,17,9995,4113,5882
50,6,77,California,San Joaquin County,6,18,11014,3870,7144
50,6,77,California,San Joaquin County,7,0,711579,353785,357794
50,6,77,California,San Joaquin County,7,1,52466,26924,25542
50,6,77,California,San Joaquin County,7,2,56375,28879,27496
50,6,77,California,San Joaquin County,7,3,55907,28537,27370
50,6,77,California,San Joaquin County,7,4,54447,28077,26370
50,6,77,California,San Joaquin County,7,5,52685,27127,25558
50,6,77,California,San Joaquin County,7,6,48295,24745,23550
50,6,77,California,San Joaquin County,7,7,48154,24276,23878
50,6,77,California,San Joaquin County,7,8,45376,22545,22831
50,6,77,California,San Joaquin County,7,9,45546,22449,23097
50,6,77,California,San Joaquin County,7,10,45370,22884,22486
50,6,77,California,San Joaquin County,7,11,46373,23077,23296
50,6,77,California,San Joaquin County,7,12,42136,20849,21287
50,6,77,California,San Joaquin County,7,13,35130,16864,18266
50,6,77,California,San Joaquin County,7,14,28367,13340,15027
50,6,77,California,San Joaquin County,7,15,19934,9038,10896
50,6,77,California,San Joaquin County,7,16,13819,6111,7708
50,6,77,California,San Joaquin County,7,17,10021,4133,5888
50,6,77,California,San Joaquin County,7,18,11178,3930,7248
50,6,77,California,San Joaquin County,8,0,722271,359616,362655
50,6,77,California,San Joaquin County,8,1,52381,26942,25439
50,6,77,California,San Joaquin County,8,2,56930,29223,27707
50,6,77,California,San Joaquin County,8,3,56483,28799,27684
50,6,77,California,San Joaquin County,8,4,54732,28285,26447
50,6,77,California,San Joaquin County,8,5,52189,26913,25276
50,6,77,California,San Joaquin County,8,6,50316,25915,24401
50,6,77,California,San Joaquin County,8,7,48866,24736,24130
50,6,77,California,San Joaquin County,8,8,46789,23209,23580
50,6,77,California,San Joaquin County,8,9,45526,22548,22978
50,6,77,California,San Joaquin County,8,10,45669,22997,22672
50,6,77,California,San Joaquin County,8,11,46296,23132,23164
50,6,77,California,San Joaquin County,8,12,43191,21409,21782
50,6,77,California,San Joaquin County,8,13,36278,17422,18856
50,6,77,California,San Joaquin County,8,14,29920,14055,15865
50,6,77,California,San Joaquin County,8,15,20822,9483,11339
50,6,77,California,San Joaquin County,8,16,14262,6305,7957
50,6,77,California,San Joaquin County,8,17,10188,4221,5967
50,6,77,California,San Joaquin County,8,18,11433,4022,7411
50,6,77,California,San Joaquin County,9,0,732809,365315,367494
50,6,77,California,San Joaquin County,9,1,52382,27041,25341
50,6,77,California,San Joaquin County,9,2,57301,29312,27989
50,6,77,California,San Joaquin County,9,3,57216,29246,27970
50,6,77,California,San Joaquin County,9,4,55149,28544,26605
50,6,77,California,San Joaquin County,9,5,51687,26634,25053
50,6,77,California,San Joaquin County,9,6,52319,27114,25205
50,6,77,California,San Joaquin County,9,7,49542,25120,24422
50,6,77,California,San Joaquin County,9,8,48396,24118,24278
50,6,77,California,San Joaquin County,9,9,45292,22569,22723
50,6,77,California,San Joaquin County,9,10,46273,23182,23091
50,6,77,California,San Joaquin County,9,11,46025,23115,22910
50,6,77,California,San Joaquin County,9,12,43928,21730,22198
50,6,77,California,San Joaquin County,9,13,37445,18028,19417
50,6,77,California,San Joaquin County,9,14,31260,14614,16646
50,6,77,California,San Joaquin County,9,15,21693,9972,11721
50,6,77,California,San Joaquin County,9,16,14993,6587,8406
50,6,77,California,San Joaquin County,9,17,10281,4262,6019
50,6,77,California,San Joaquin County,9,18,11627,4127,7500
50,6,77,California,San Joaquin County,10,0,743296,370464,372832
50,6,77,California,San Joaquin County,10,1,52859,27195,25664
50,6,77,California,San Joaquin County,10,2,57232,29300,27932
50,6,77,California,San Joaquin County,10,3,58533,29843,28690
50,6,77,California,San Joaquin County,10,4,55402,28746,26656
50,6,77,California,San Joaquin County,10,5,51044,26305,24739
50,6,77,California,San Joaquin County,10,6,54061,27917,26144
50,6,77,California,San Joaquin County,10,7,50080,25348,24732
50,6,77,California,San Joaquin County,10,8,50152,25178,24974
50,6,77,California,San Joaquin County,10,9,45686,22741,22945
50,6,77,California,San Joaquin County,10,10,46654,23380,23274
50,6,77,California,San Joaquin County,10,11,45498,22950,22548
50,6,77,California,San Joaquin County,10,12,44474,21785,22689
50,6,77,California,San Joaquin County,10,13,38758,18830,19928
50,6,77,California,San Joaquin County,10,14,31263,14551,16712
50,6,77,California,San Joaquin County,10,15,23674,10907,12767
50,6,77,California,San Joaquin County,10,16,15792,6982,8810
50,6,77,California,San Joaquin County,10,17,10492,4376,6116
50,6,77,California,San Joaquin County,10,18,11642,4130,7512
50,6,77,California,San Joaquin County,11,0,752491,375009,377482
50,6,77,California,San Joaquin County,11,1,52876,27118,25758
50,6,77,California,San Joaquin County,11,2,57121,29325,27796
50,6,77,California,San Joaquin County,11,3,59427,30369,29058
50,6,77,California,San Joaquin County,11,4,55686,28798,26888
50,6,77,California,San Joaquin County,11,5,51092,26230,24862
50,6,77,California,San Joaquin County,11,6,55035,28404,26631
50,6,77,California,San Joaquin County,11,7,50805,25745,25060
50,6,77,California,San Joaquin County,11,8,51394,25971,25423
50,6,77,California,San Joaquin County,11,9,46452,23187,23265
50,6,77,California,San Joaquin County,11,10,46835,23246,23589
50,6,77,California,San Joaquin County,11,11,45203,22871,22332
50,6,77,California,San Joaquin County,11,12,44761,21964,22797
50,6,77,California,San Joaquin County,11,13,39632,19289,20343
50,6,77,California,San Joaquin County,11,14,32020,14948,17072
50,6,77,California,San Joaquin County,11,15,24790,11393,13397
50,6,77,California,San Joaquin County,11,16,16742,7402,9340
50,6,77,California,San Joaquin County,11,17,10792,4552,6240
50,6,77,California,San Joaquin County,11,18,11828,4197,7631
50,6,77,California,San Joaquin County,12,0,762148,380193,381955
50,6,77,California,San Joaquin County,12,1,52655,27101,25554
50,6,77,California,San Joaquin County,12,2,57406,29360,28046
50,6,77,California,San Joaquin County,12,3,59773,30699,29074
50,6,77,California,San Joaquin County,12,4,56230,28955,27275
50,6,77,California,San Joaquin County,12,5,51323,26435,24888
50,6,77,California,San Joaquin County,12,6,55336,28541,26795
50,6,77,California,San Joaquin County,12,7,52066,26520,25546
50,6,77,California,San Joaquin County,12,8,52487,26555,25932
50,6,77,California,San Joaquin County,12,9,48050,24134,23916
50,6,77,California,San Joaquin County,12,10,46496,23150,23346
50,6,77,California,San Joaquin County,12,11,45019,22618,22401
50,6,77,California,San Joaquin County,12,12,45203,22236,22967
50,6,77,California,San Joaquin County,12,13,40323,19710,20613
50,6,77,California,San Joaquin County,12,14,33037,15454,17583
50,6,77,California,San Joaquin County,12,15,25987,11897,14090
50,6,77,California,San Joaquin County,12,16,17618,7799,9819
50,6,77,California,San Joaquin County,12,17,11173,4751,6422
50,6,77,California,San Joaquin County,12,18,11966,4278,7688
50,6,79,California,San Luis Obispo County,1,0,269637,137999,131638
50,6,79,California,San Luis Obispo County,1,1,13343,6829,6514
50,6,79,California,San Luis Obispo County,1,2,13773,6945,6828
50,6,79,California,San Luis Obispo County,1,3,14201,7259,6942
50,6,79,California,San Luis Obispo County,1,4,21727,11465,10262
50,6,79,California,San Luis Obispo County,1,5,27342,15455,11887
50,6,79,California,San Luis Obispo County,1,6,17368,9510,7858
50,6,79,California,San Luis Obispo County,1,7,14740,8029,6711
50,6,79,California,San Luis Obispo County,1,8,14140,7568,6572
50,6,79,California,San Luis Obispo County,1,9,15612,8398,7214
50,6,79,California,San Luis Obispo County,1,10,18583,9571,9012
50,6,79,California,San Luis Obispo County,1,11,20670,10169,10501
50,6,79,California,San Luis Obispo County,1,12,20045,9885,10160
50,6,79,California,San Luis Obispo County,1,13,17071,8543,8528
50,6,79,California,San Luis Obispo County,1,14,12364,5923,6441
50,6,79,California,San Luis Obispo County,1,15,8823,4131,4692
50,6,79,California,San Luis Obispo County,1,16,7334,3346,3988
50,6,79,California,San Luis Obispo County,1,17,6197,2647,3550
50,6,79,California,San Luis Obispo County,1,18,6304,2326,3978
50,6,79,California,San Luis Obispo County,2,0,269597,137979,131618
50,6,79,California,San Luis Obispo County,2,1,13341,6827,6514
50,6,79,California,San Luis Obispo County,2,2,13768,6943,6825
50,6,79,California,San Luis Obispo County,2,3,14198,7258,6940
50,6,79,California,San Luis Obispo County,2,4,21721,11463,10258
50,6,79,California,San Luis Obispo County,2,5,27337,15450,11887
50,6,79,California,San Luis Obispo County,2,6,17366,9509,7857
50,6,79,California,San Luis Obispo County,2,7,14741,8030,6711
50,6,79,California,San Luis Obispo County,2,8,14137,7567,6570
50,6,79,California,San Luis Obispo County,2,9,15612,8398,7214
50,6,79,California,San Luis Obispo County,2,10,18575,9567,9008
50,6,79,California,San Luis Obispo County,2,11,20669,10169,10500
50,6,79,California,San Luis Obispo County,2,12,20045,9886,10159
50,6,79,California,San Luis Obispo County,2,13,17071,8543,8528
50,6,79,California,San Luis Obispo County,2,14,12359,5920,6439
50,6,79,California,San Luis Obispo County,2,15,8824,4131,4693
50,6,79,California,San Luis Obispo County,2,16,7333,3346,3987
50,6,79,California,San Luis Obispo County,2,17,6195,2645,3550
50,6,79,California,San Luis Obispo County,2,18,6305,2327,3978
50,6,79,California,San Luis Obispo County,3,0,269802,137916,131886
50,6,79,California,San Luis Obispo County,3,1,13394,6838,6556
50,6,79,California,San Luis Obispo County,3,2,13765,6961,6804
50,6,79,California,San Luis Obispo County,3,3,14180,7242,6938
50,6,79,California,San Luis Obispo County,3,4,21939,11509,10430
50,6,79,California,San Luis Obispo County,3,5,27726,15622,12104
50,6,79,California,San Luis Obispo County,3,6,17149,9386,7763
50,6,79,California,San Luis Obispo County,3,7,14814,8059,6755
50,6,79,California,San Luis Obispo County,3,8,14018,7505,6513
50,6,79,California,San Luis Obispo County,3,9,15529,8337,7192
50,6,79,California,San Luis Obispo County,3,10,18299,9435,8864
50,6,79,California,San Luis Obispo County,3,11,20464,10059,10405
50,6,79,California,San Luis Obispo County,3,12,20046,9853,10193
50,6,79,California,San Luis Obispo County,3,13,17223,8614,8609
50,6,79,California,San Luis Obispo County,3,14,12475,5980,6495
50,6,79,California,San Luis Obispo County,3,15,8921,4191,4730
50,6,79,California,San Luis Obispo County,3,16,7310,3336,3974
50,6,79,California,San Luis Obispo County,3,17,6194,2641,3553
50,6,79,California,San Luis Obispo County,3,18,6356,2348,4008
50,6,79,California,San Luis Obispo County,4,0,271058,138465,132593
50,6,79,California,San Luis Obispo County,4,1,13452,6918,6534
50,6,79,California,San Luis Obispo County,4,2,13821,7021,6800
50,6,79,California,San Luis Obispo County,4,3,14098,7190,6908
50,6,79,California,San Luis Obispo County,4,4,22063,11475,10588
50,6,79,California,San Luis Obispo County,4,5,28487,16055,12432
50,6,79,California,San Luis Obispo County,4,6,16380,8925,7455
50,6,79,California,San Luis Obispo County,4,7,15285,8228,7057
50,6,79,California,San Luis Obispo County,4,8,13793,7425,6368
50,6,79,California,San Luis Obispo County,4,9,15511,8301,7210
50,6,79,California,San Luis Obispo County,4,10,17316,8990,8326
50,6,79,California,San Luis Obispo County,4,11,20010,9877,10133
50,6,79,California,San Luis Obispo County,4,12,20274,9854,10420
50,6,79,California,San Luis Obispo County,4,13,18271,9118,9153
50,6,79,California,San Luis Obispo County,4,14,12983,6259,6724
50,6,79,California,San Luis Obispo County,4,15,9319,4420,4899
50,6,79,California,San Luis Obispo County,4,16,7374,3364,4010
50,6,79,California,San Luis Obispo County,4,17,6117,2620,3497
50,6,79,California,San Luis Obispo County,4,18,6504,2425,4079
50,6,79,California,San Luis Obispo County,5,0,274160,140057,134103
50,6,79,California,San Luis Obispo County,5,1,13412,6871,6541
50,6,79,California,San Luis Obispo County,5,2,14120,7197,6923
50,6,79,California,San Luis Obispo County,5,3,14009,7111,6898
50,6,79,California,San Luis Obispo County,5,4,22208,11485,10723
50,6,79,California,San Luis Obispo County,5,5,29987,16991,12996
50,6,79,California,San Luis Obispo County,5,6,15725,8511,7214
50,6,79,California,San Luis Obispo County,5,7,15852,8549,7303
50,6,79,California,San Luis Obispo County,5,8,14025,7564,6461
50,6,79,California,San Luis Obispo County,5,9,15379,8238,7141
50,6,79,California,San Luis Obispo County,5,10,16633,8710,7923
50,6,79,California,San Luis Obispo County,5,11,19553,9742,9811
50,6,79,California,San Luis Obispo County,5,12,20340,9759,10581
50,6,79,California,San Luis Obispo County,5,13,18516,9165,9351
50,6,79,California,San Luis Obispo County,5,14,14324,6972,7352
50,6,79,California,San Luis Obispo County,5,15,9855,4682,5173
50,6,79,California,San Luis Obispo County,5,16,7494,3386,4108
50,6,79,California,San Luis Obispo County,5,17,6057,2630,3427
50,6,79,California,San Luis Obispo County,5,18,6671,2494,4177
50,6,79,California,San Luis Obispo County,6,0,275696,140436,135260
50,6,79,California,San Luis Obispo County,6,1,13499,6954,6545
50,6,79,California,San Luis Obispo County,6,2,14194,7192,7002
50,6,79,California,San Luis Obispo County,6,3,13955,7072,6883
50,6,79,California,San Luis Obispo County,6,4,21812,11244,10568
50,6,79,California,San Luis Obispo County,6,5,30406,17128,13278
50,6,79,California,San Luis Obispo County,6,6,15432,8374,7058
50,6,79,California,San Luis Obispo County,6,7,16326,8686,7640
50,6,79,California,San Luis Obispo County,6,8,14302,7726,6576
50,6,79,California,San Luis Obispo County,6,9,15142,8061,7081
50,6,79,California,San Luis Obispo County,6,10,15966,8362,7604
50,6,79,California,San Luis Obispo County,6,11,18995,9496,9499
50,6,79,California,San Luis Obispo County,6,12,20248,9653,10595
50,6,79,California,San Luis Obispo County,6,13,19007,9279,9728
50,6,79,California,San Luis Obispo County,6,14,15249,7479,7770
50,6,79,California,San Luis Obispo County,6,15,10717,5106,5611
50,6,79,California,San Luis Obispo County,6,16,7673,3444,4229
50,6,79,California,San Luis Obispo County,6,17,5988,2641,3347
50,6,79,California,San Luis Obispo County,6,18,6785,2539,4246
50,6,79,California,San Luis Obispo County,7,0,278227,141405,136822
50,6,79,California,San Luis Obispo County,7,1,13633,6917,6716
50,6,79,California,San Luis Obispo County,7,2,14121,7193,6928
50,6,79,California,San Luis Obispo County,7,3,14005,7117,6888
50,6,79,California,San Luis Obispo County,7,4,21866,11262,10604
50,6,79,California,San Luis Obispo County,7,5,30786,17175,13611
50,6,79,California,San Luis Obispo County,7,6,15701,8569,7132
50,6,79,California,San Luis Obispo County,7,7,16751,8869,7882
50,6,79,California,San Luis Obispo County,7,8,14707,7911,6796
50,6,79,California,San Luis Obispo County,7,9,14714,7855,6859
50,6,79,California,San Luis Obispo County,7,10,15468,8162,7306
50,6,79,California,San Luis Obispo County,7,11,18492,9223,9269
50,6,79,California,San Luis Obispo County,7,12,19964,9470,10494
50,6,79,California,San Luis Obispo County,7,13,19441,9428,10013
50,6,79,California,San Luis Obispo County,7,14,16337,8009,8328
50,6,79,California,San Luis Obispo County,7,15,11433,5416,6017
50,6,79,California,San Luis Obispo County,7,16,7891,3591,4300
50,6,79,California,San Luis Obispo County,7,17,5987,2667,3320
50,6,79,California,San Luis Obispo County,7,18,6930,2571,4359
50,6,79,California,San Luis Obispo County,8,0,280077,142006,138071
50,6,79,California,San Luis Obispo County,8,1,13536,6948,6588
50,6,79,California,San Luis Obispo County,8,2,14303,7369,6934
50,6,79,California,San Luis Obispo County,8,3,14131,7116,7015
50,6,79,California,San Luis Obispo County,8,4,21578,11053,10525
50,6,79,California,San Luis Obispo County,8,5,30804,17089,13715
50,6,79,California,San Luis Obispo County,8,6,15822,8709,7113
50,6,79,California,San Luis Obispo County,8,7,16745,8742,8003
50,6,79,California,San Luis Obispo County,8,8,15243,8140,7103
50,6,79,California,San Luis Obispo County,8,9,14304,7580,6724
50,6,79,California,San Luis Obispo County,8,10,15472,8150,7322
50,6,79,California,San Luis Obispo County,8,11,17750,8867,8883
50,6,79,California,San Luis Obispo County,8,12,19871,9394,10477
50,6,79,California,San Luis Obispo County,8,13,19807,9500,10307
50,6,79,California,San Luis Obispo County,8,14,17454,8532,8922
50,6,79,California,San Luis Obispo County,8,15,12125,5789,6336
50,6,79,California,San Luis Obispo County,8,16,8108,3714,4394
50,6,79,California,San Luis Obispo County,8,17,5997,2666,3331
50,6,79,California,San Luis Obispo County,8,18,7027,2648,4379
50,6,79,California,San Luis Obispo County,9,0,281803,142929,138874
50,6,79,California,San Luis Obispo County,9,1,13422,6854,6568
50,6,79,California,San Luis Obispo County,9,2,14242,7384,6858
50,6,79,California,San Luis Obispo County,9,3,14247,7239,7008
50,6,79,California,San Luis Obispo County,9,4,21565,11093,10472
50,6,79,California,San Luis Obispo County,9,5,30745,16991,13754
50,6,79,California,San Luis Obispo County,9,6,16242,8926,7316
50,6,79,California,San Luis Obispo County,9,7,16485,8664,7821
50,6,79,California,San Luis Obispo County,9,8,15803,8384,7419
50,6,79,California,San Luis Obispo County,9,9,14189,7535,6654
50,6,79,California,San Luis Obispo County,9,10,15454,8091,7363
50,6,79,California,San Luis Obispo County,9,11,16978,8507,8471
50,6,79,California,San Luis Obispo County,9,12,19569,9318,10251
50,6,79,California,San Luis Obispo County,9,13,20054,9484,10570
50,6,79,California,San Luis Obispo County,9,14,18544,9072,9472
50,6,79,California,San Luis Obispo County,9,15,12577,6024,6553
50,6,79,California,San Luis Obispo County,9,16,8494,3935,4559
50,6,79,California,San Luis Obispo County,9,17,6093,2718,3375
50,6,79,California,San Luis Obispo County,9,18,7100,2710,4390
50,6,79,California,San Luis Obispo County,10,0,282481,143284,139197
50,6,79,California,San Luis Obispo County,10,1,13218,6762,6456
50,6,79,California,San Luis Obispo County,10,2,14042,7262,6780
50,6,79,California,San Luis Obispo County,10,3,14389,7357,7032
50,6,79,California,San Luis Obispo County,10,4,21122,10835,10287
50,6,79,California,San Luis Obispo County,10,5,30334,16642,13692
50,6,79,California,San Luis Obispo County,10,6,16572,9117,7455
50,6,79,California,San Luis Obispo County,10,7,16236,8505,7731
50,6,79,California,San Luis Obispo County,10,8,16398,8759,7639
50,6,79,California,San Luis Obispo County,10,9,14301,7610,6691
50,6,79,California,San Luis Obispo County,10,10,15320,8055,7265
50,6,79,California,San Luis Obispo County,10,11,16391,8280,8111
50,6,79,California,San Luis Obispo County,10,12,19160,9215,9945
50,6,79,California,San Luis Obispo County,10,13,20229,9419,10810
50,6,79,California,San Luis Obispo County,10,14,18639,9105,9534
50,6,79,California,San Luis Obispo County,10,15,13920,6700,7220
50,6,79,California,San Luis Obispo County,10,16,8994,4213,4781
50,6,79,California,San Luis Obispo County,10,17,6170,2715,3455
50,6,79,California,San Luis Obispo County,10,18,7046,2733,4313
50,6,79,California,San Luis Obispo County,11,0,283354,143696,139658
50,6,79,California,San Luis Obispo County,11,1,13005,6635,6370
50,6,79,California,San Luis Obispo County,11,2,13921,7221,6700
50,6,79,California,San Luis Obispo County,11,3,14409,7322,7087
50,6,79,California,San Luis Obispo County,11,4,21432,11012,10420
50,6,79,California,San Luis Obispo County,11,5,30101,16472,13629
50,6,79,California,San Luis Obispo County,11,6,16643,9105,7538
50,6,79,California,San Luis Obispo County,11,7,15896,8436,7460
50,6,79,California,San Luis Obispo County,11,8,16812,8887,7925
50,6,79,California,San Luis Obispo County,11,9,14614,7860,6754
50,6,79,California,San Luis Obispo County,11,10,15086,7970,7116
50,6,79,California,San Luis Obispo County,11,11,15672,7954,7718
50,6,79,California,San Luis Obispo County,11,12,18753,9045,9708
50,6,79,California,San Luis Obispo County,11,13,20115,9316,10799
50,6,79,California,San Luis Obispo County,11,14,19059,9165,9894
50,6,79,California,San Luis Obispo County,11,15,14787,7169,7618
50,6,79,California,San Luis Obispo County,11,16,9708,4589,5119
50,6,79,California,San Luis Obispo County,11,17,6282,2772,3510
50,6,79,California,San Luis Obispo County,11,18,7059,2766,4293
50,6,79,California,San Luis Obispo County,12,0,283111,143377,139734
50,6,79,California,San Luis Obispo County,12,1,12754,6504,6250
50,6,79,California,San Luis Obispo County,12,2,14001,7223,6778
50,6,79,California,San Luis Obispo County,12,3,14213,7260,6953
50,6,79,California,San Luis Obispo County,12,4,21451,11068,10383
50,6,79,California,San Luis Obispo County,12,5,29566,16142,13424
50,6,79,California,San Luis Obispo County,12,6,16568,8994,7574
50,6,79,California,San Luis Obispo County,12,7,15770,8371,7399
50,6,79,California,San Luis Obispo County,12,8,16943,8910,8033
50,6,79,California,San Luis Obispo County,12,9,14970,8063,6907
50,6,79,California,San Luis Obispo County,12,10,14695,7737,6958
50,6,79,California,San Luis Obispo County,12,11,15167,7730,7437
50,6,79,California,San Luis Obispo County,12,12,18206,8789,9417
50,6,79,California,San Luis Obispo County,12,13,19756,9148,10608
50,6,79,California,San Luis Obispo County,12,14,19484,9277,10207
50,6,79,California,San Luis Obispo County,12,15,15644,7544,8100
50,6,79,California,San Luis Obispo County,12,16,10334,4901,5433
50,6,79,California,San Luis Obispo County,12,17,6437,2892,3545
50,6,79,California,San Luis Obispo County,12,18,7152,2824,4328
50,6,81,California,San Mateo County,1,0,718451,353168,365283
50,6,81,California,San Mateo County,1,1,46360,23652,22708
50,6,81,California,San Mateo County,1,2,44729,22820,21909
50,6,81,California,San Mateo County,1,3,42463,21750,20713
50,6,81,California,San Mateo County,1,4,41249,21346,19903
50,6,81,California,San Mateo County,1,5,40098,21328,18770
50,6,81,California,San Mateo County,1,6,48320,24734,23586
50,6,81,California,San Mateo County,1,7,51014,25735,25279
50,6,81,California,San Mateo County,1,8,53358,26799,26559
50,6,81,California,San Mateo County,1,9,54742,26912,27830
50,6,81,California,San Mateo County,1,10,56424,27732,28692
50,6,81,California,San Mateo County,1,11,54245,26604,27641
50,6,81,California,San Mateo County,1,12,47865,23192,24673
50,6,81,California,San Mateo County,1,13,41322,19651,21671
50,6,81,California,San Mateo County,1,14,28485,13045,15440
50,6,81,California,San Mateo County,1,15,21500,9647,11853
50,6,81,California,San Mateo County,1,16,16888,7340,9548
50,6,81,California,San Mateo County,1,17,14085,5643,8442
50,6,81,California,San Mateo County,1,18,15304,5238,10066
50,6,81,California,San Mateo County,2,0,718517,353204,365313
50,6,81,California,San Mateo County,2,1,46365,23657,22708
50,6,81,California,San Mateo County,2,2,44729,22820,21909
50,6,81,California,San Mateo County,2,3,42461,21749,20712
50,6,81,California,San Mateo County,2,4,41253,21347,19906
50,6,81,California,San Mateo County,2,5,40102,21331,18771
50,6,81,California,San Mateo County,2,6,48328,24736,23592
50,6,81,California,San Mateo County,2,7,51019,25739,25280
50,6,81,California,San Mateo County,2,8,53363,26803,26560
50,6,81,California,San Mateo County,2,9,54746,26915,27831
50,6,81,California,San Mateo County,2,10,56423,27732,28691
50,6,81,California,San Mateo County,2,11,54250,26606,27644
50,6,81,California,San Mateo County,2,12,47871,23196,24675
50,6,81,California,San Mateo County,2,13,41326,19652,21674
50,6,81,California,San Mateo County,2,14,28490,13046,15444
50,6,81,California,San Mateo County,2,15,21506,9649,11857
50,6,81,California,San Mateo County,2,16,16894,7343,9551
50,6,81,California,San Mateo County,2,17,14086,5644,8442
50,6,81,California,San Mateo County,2,18,15305,5239,10066
50,6,81,California,San Mateo County,3,0,719699,353701,365998
50,6,81,California,San Mateo County,3,1,46292,23629,22663
50,6,81,California,San Mateo County,3,2,44842,22873,21969
50,6,81,California,San Mateo County,3,3,42554,21787,20767
50,6,81,California,San Mateo County,3,4,41286,21346,19940
50,6,81,California,San Mateo County,3,5,40036,21298,18738
50,6,81,California,San Mateo County,3,6,48328,24726,23602
50,6,81,California,San Mateo County,3,7,51075,25739,25336
50,6,81,California,San Mateo County,3,8,53128,26654,26474
50,6,81,California,San Mateo County,3,9,54800,26966,27834
50,6,81,California,San Mateo County,3,10,56247,27645,28602
50,6,81,California,San Mateo County,3,11,54452,26723,27729
50,6,81,California,San Mateo County,3,12,48099,23284,24815
50,6,81,California,San Mateo County,3,13,41745,19862,21883
50,6,81,California,San Mateo County,3,14,28741,13148,15593
50,6,81,California,San Mateo County,3,15,21692,9757,11935
50,6,81,California,San Mateo County,3,16,16835,7309,9526
50,6,81,California,San Mateo County,3,17,14127,5674,8453
50,6,81,California,San Mateo County,3,18,15420,5281,10139
50,6,81,California,San Mateo County,4,0,728344,357776,370568
50,6,81,California,San Mateo County,4,1,46321,23600,22721
50,6,81,California,San Mateo County,4,2,45615,23286,22329
50,6,81,California,San Mateo County,4,3,42910,22015,20895
50,6,81,California,San Mateo County,4,4,41185,21144,20041
50,6,81,California,San Mateo County,4,5,40205,21296,18909
50,6,81,California,San Mateo County,4,6,48750,25006,23744
50,6,81,California,San Mateo County,4,7,52059,26141,25918
50,6,81,California,San Mateo County,4,8,52510,26247,26263
50,6,81,California,San Mateo County,4,9,55584,27491,28093
50,6,81,California,San Mateo County,4,10,55721,27465,28256
50,6,81,California,San Mateo County,4,11,54950,27006,27944
50,6,81,California,San Mateo County,4,12,49302,23793,25509
50,6,81,California,San Mateo County,4,13,43637,20774,22863
50,6,81,California,San Mateo County,4,14,29984,13714,16270
50,6,81,California,San Mateo County,4,15,22459,10125,12334
50,6,81,California,San Mateo County,4,16,16973,7400,9573
50,6,81,California,San Mateo County,4,17,14265,5825,8440
50,6,81,California,San Mateo County,4,18,15914,5448,10466
50,6,81,California,San Mateo County,5,0,739224,363176,376048
50,6,81,California,San Mateo County,5,1,46364,23563,22801
50,6,81,California,San Mateo County,5,2,46454,23643,22811
50,6,81,California,San Mateo County,5,3,43478,22301,21177
50,6,81,California,San Mateo County,5,4,41004,20958,20046
50,6,81,California,San Mateo County,5,5,40858,21366,19492
50,6,81,California,San Mateo County,5,6,49485,25546,23939
50,6,81,California,San Mateo County,5,7,53651,27067,26584
50,6,81,California,San Mateo County,5,8,52786,26351,26435
50,6,81,California,San Mateo County,5,9,56252,27834,28418
50,6,81,California,San Mateo County,5,10,55285,27379,27906
50,6,81,California,San Mateo County,5,11,55419,27131,28288
50,6,81,California,San Mateo County,5,12,50800,24614,26186
50,6,81,California,San Mateo County,5,13,43608,20811,22797
50,6,81,California,San Mateo County,5,14,32745,15065,17680
50,6,81,California,San Mateo County,5,15,23200,10418,12782
50,6,81,California,San Mateo County,5,16,17347,7633,9714
50,6,81,California,San Mateo County,5,17,14157,5895,8262
50,6,81,California,San Mateo County,5,18,16331,5601,10730
50,6,81,California,San Mateo County,6,0,748661,368198,380463
50,6,81,California,San Mateo County,6,1,46190,23423,22767
50,6,81,California,San Mateo County,6,2,46676,23883,22793
50,6,81,California,San Mateo County,6,3,44081,22515,21566
50,6,81,California,San Mateo County,6,4,40817,20881,19936
50,6,81,California,San Mateo County,6,5,41856,21784,20072
50,6,81,California,San Mateo County,6,6,49884,25951,23933
50,6,81,California,San Mateo County,6,7,55547,28033,27514
50,6,81,California,San Mateo County,6,8,53502,26873,26629
50,6,81,California,San Mateo County,6,9,56269,27959,28310
50,6,81,California,San Mateo County,6,10,54619,27049,27570
50,6,81,California,San Mateo County,6,11,55826,27282,28544
50,6,81,California,San Mateo County,6,12,51624,25077,26547
50,6,81,California,San Mateo County,6,13,44378,21192,23186
50,6,81,California,San Mateo County,6,14,34481,15918,18563
50,6,81,California,San Mateo County,6,15,24245,10765,13480
50,6,81,California,San Mateo County,6,16,17855,7880,9975
50,6,81,California,San Mateo County,6,17,14157,5969,8188
50,6,81,California,San Mateo County,6,18,16654,5764,10890
50,6,81,California,San Mateo County,7,0,757204,372551,384653
50,6,81,California,San Mateo County,7,1,46027,23453,22574
50,6,81,California,San Mateo County,7,2,46470,23718,22752
50,6,81,California,San Mateo County,7,3,44705,22825,21880
50,6,81,California,San Mateo County,7,4,40572,20792,19780
50,6,81,California,San Mateo County,7,5,42759,22120,20639
50,6,81,California,San Mateo County,7,6,50921,26654,24267
50,6,81,California,San Mateo County,7,7,56704,28714,27990
50,6,81,California,San Mateo County,7,8,54539,27207,27332
50,6,81,California,San Mateo County,7,9,55638,27867,27771
50,6,81,California,San Mateo County,7,10,54249,26752,27497
50,6,81,California,San Mateo County,7,11,55995,27310,28685
50,6,81,California,San Mateo County,7,12,52427,25495,26932
50,6,81,California,San Mateo County,7,13,44876,21534,23342
50,6,81,California,San Mateo County,7,14,36280,16785,19495
50,6,81,California,San Mateo County,7,15,25258,11236,14022
50,6,81,California,San Mateo County,7,16,18483,8090,10393
50,6,81,California,San Mateo County,7,17,14232,5992,8240
50,6,81,California,San Mateo County,7,18,17069,6007,11062
50,6,81,California,San Mateo County,8,0,765055,376907,388148
50,6,81,California,San Mateo County,8,1,45783,23386,22397
50,6,81,California,San Mateo County,8,2,46259,23632,22627
50,6,81,California,San Mateo County,8,3,44939,22797,22142
50,6,81,California,San Mateo County,8,4,40767,21026,19741
50,6,81,California,San Mateo County,8,5,42941,22090,20851
50,6,81,California,San Mateo County,8,6,52142,27461,24681
50,6,81,California,San Mateo County,8,7,57728,29293,28435
50,6,81,California,San Mateo County,8,8,55974,28007,27967
50,6,81,California,San Mateo County,8,9,54593,27469,27124
50,6,81,California,San Mateo County,8,10,54596,26862,27734
50,6,81,California,San Mateo County,8,11,55827,27271,28556
50,6,81,California,San Mateo County,8,12,52962,25889,27073
50,6,81,California,San Mateo County,8,13,45693,21913,23780
50,6,81,California,San Mateo County,8,14,37960,17705,20255
50,6,81,California,San Mateo County,8,15,26089,11609,14480
50,6,81,California,San Mateo County,8,16,19239,8325,10914
50,6,81,California,San Mateo County,8,17,14074,5901,8173
50,6,81,California,San Mateo County,8,18,17489,6271,11218
50,6,81,California,San Mateo County,9,0,767906,379087,388819
50,6,81,California,San Mateo County,9,1,44690,23000,21690
50,6,81,California,San Mateo County,9,2,45502,23242,22260
50,6,81,California,San Mateo County,9,3,45087,22853,22234
50,6,81,California,San Mateo County,9,4,40877,21130,19747
50,6,81,California,San Mateo County,9,5,42684,21879,20805
50,6,81,California,San Mateo County,9,6,54261,28797,25464
50,6,81,California,San Mateo County,9,7,58315,29802,28513
50,6,81,California,San Mateo County,9,8,56471,28223,28248
50,6,81,California,San Mateo County,9,9,53349,26823,26526
50,6,81,California,San Mateo County,9,10,54906,27204,27702
50,6,81,California,San Mateo County,9,11,54528,26683,27845
50,6,81,California,San Mateo County,9,12,53047,25976,27071
50,6,81,California,San Mateo County,9,13,46277,22159,24118
50,6,81,California,San Mateo County,9,14,39172,18293,20879
50,6,81,California,San Mateo County,9,15,26963,12001,14962
50,6,81,California,San Mateo County,9,16,19782,8577,11205
50,6,81,California,San Mateo County,9,17,14136,5952,8184
50,6,81,California,San Mateo County,9,18,17859,6493,11366
50,6,81,California,San Mateo County,10,0,768901,379940,388961
50,6,81,California,San Mateo County,10,1,43944,22627,21317
50,6,81,California,San Mateo County,10,2,44515,22842,21673
50,6,81,California,San Mateo County,10,3,44890,22845,22045
50,6,81,California,San Mateo County,10,4,40883,21080,19803
50,6,81,California,San Mateo County,10,5,42000,21452,20548
50,6,81,California,San Mateo County,10,6,55581,29385,26196
50,6,81,California,San Mateo County,10,7,59040,30334,28706
50,6,81,California,San Mateo County,10,8,56757,28467,28290
50,6,81,California,San Mateo County,10,9,52885,26618,26267
50,6,81,California,San Mateo County,10,10,54600,27114,27486
50,6,81,California,San Mateo County,10,11,53234,26151,27083
50,6,81,California,San Mateo County,10,12,52819,25806,27013
50,6,81,California,San Mateo County,10,13,46886,22478,24408
50,6,81,California,San Mateo County,10,14,39030,18224,20806
50,6,81,California,San Mateo County,10,15,29021,13015,16006
50,6,81,California,San Mateo County,10,16,20468,8853,11615
50,6,81,California,San Mateo County,10,17,14369,6114,8255
50,6,81,California,San Mateo County,10,18,17979,6535,11444
50,6,81,California,San Mateo County,11,0,768681,380484,388197
50,6,81,California,San Mateo County,11,1,43179,22289,20890
50,6,81,California,San Mateo County,11,2,43435,22221,21214
50,6,81,California,San Mateo County,11,3,44662,22792,21870
50,6,81,California,San Mateo County,11,4,41148,21175,19973
50,6,81,California,San Mateo County,11,5,41430,21346,20084
50,6,81,California,San Mateo County,11,6,55913,29537,26376
50,6,81,California,San Mateo County,11,7,59096,30728,28368
50,6,81,California,San Mateo County,11,8,57473,28920,28553
50,6,81,California,San Mateo County,11,9,52690,26530,26160
50,6,81,California,San Mateo County,11,10,54098,26926,27172
50,6,81,California,San Mateo County,11,11,51875,25458,26417
50,6,81,California,San Mateo County,11,12,52586,25643,26943
50,6,81,California,San Mateo County,11,13,47188,22704,24484
50,6,81,California,San Mateo County,11,14,39186,18375,20811
50,6,81,California,San Mateo County,11,15,30324,13622,16702
50,6,81,California,San Mateo County,11,16,21327,9192,12135
50,6,81,California,San Mateo County,11,17,14866,6324,8542
50,6,81,California,San Mateo County,11,18,18205,6702,11503
50,6,81,California,San Mateo County,12,0,766573,379508,387065
50,6,81,California,San Mateo County,12,1,42526,21891,20635
50,6,81,California,San Mateo County,12,2,42445,21767,20678
50,6,81,California,San Mateo County,12,3,43774,22321,21453
50,6,81,California,San Mateo County,12,4,41154,21221,19933
50,6,81,California,San Mateo County,12,5,40861,21066,19795
50,6,81,California,San Mateo County,12,6,55741,29362,26379
50,6,81,California,San Mateo County,12,7,59942,31252,28690
50,6,81,California,San Mateo County,12,8,57775,29313,28462
50,6,81,California,San Mateo County,12,9,52444,26197,26247
50,6,81,California,San Mateo County,12,10,52705,26431,26274
50,6,81,California,San Mateo County,12,11,50847,24846,26001
50,6,81,California,San Mateo County,12,12,52204,25335,26869
50,6,81,California,San Mateo County,12,13,47278,22820,24458
50,6,81,California,San Mateo County,12,14,39333,18561,20772
50,6,81,California,San Mateo County,12,15,31719,14355,17364
50,6,81,California,San Mateo County,12,16,22066,9516,12550
50,6,81,California,San Mateo County,12,17,15348,6486,8862
50,6,81,California,San Mateo County,12,18,18411,6768,11643
50,6,83,California,Santa Barbara County,1,0,423895,212786,211109
50,6,83,California,Santa Barbara County,1,1,27350,13873,13477
50,6,83,California,Santa Barbara County,1,2,26303,13397,12906
50,6,83,California,Santa Barbara County,1,3,26626,13717,12909
50,6,83,California,Santa Barbara County,1,4,38009,19284,18725
50,6,83,California,Santa Barbara County,1,5,43026,22782,20244
50,6,83,California,Santa Barbara County,1,6,31100,16572,14528
50,6,83,California,Santa Barbara County,1,7,26592,14006,12586
50,6,83,California,Santa Barbara County,1,8,25092,13105,11987
50,6,83,California,Santa Barbara County,1,9,25386,12935,12451
50,6,83,California,Santa Barbara County,1,10,27577,13807,13770
50,6,83,California,Santa Barbara County,1,11,27421,13618,13803
50,6,83,California,Santa Barbara County,1,12,24418,11960,12458
50,6,83,California,Santa Barbara County,1,13,20597,10055,10542
50,6,83,California,Santa Barbara County,1,14,15014,7040,7974
50,6,83,California,Santa Barbara County,1,15,11762,5400,6362
50,6,83,California,Santa Barbara County,1,16,10052,4518,5534
50,6,83,California,Santa Barbara County,1,17,8480,3478,5002
50,6,83,California,Santa Barbara County,1,18,9090,3239,5851
50,6,83,California,Santa Barbara County,2,0,423947,212812,211135
50,6,83,California,Santa Barbara County,2,1,27353,13875,13478
50,6,83,California,Santa Barbara County,2,2,26309,13400,12909
50,6,83,California,Santa Barbara County,2,3,26629,13718,12911
50,6,83,California,Santa Barbara County,2,4,38015,19286,18729
50,6,83,California,Santa Barbara County,2,5,43031,22787,20244
50,6,83,California,Santa Barbara County,2,6,31102,16573,14529
50,6,83,California,Santa Barbara County,2,7,26593,14006,12587
50,6,83,California,Santa Barbara County,2,8,25096,13107,11989
50,6,83,California,Santa Barbara County,2,9,25387,12935,12452
50,6,83,California,Santa Barbara County,2,10,27585,13811,13774
50,6,83,California,Santa Barbara County,2,11,27422,13618,13804
50,6,83,California,Santa Barbara County,2,12,24420,11960,12460
50,6,83,California,Santa Barbara County,2,13,20597,10055,10542
50,6,83,California,Santa Barbara County,2,14,15020,7043,7977
50,6,83,California,Santa Barbara County,2,15,11763,5401,6362
50,6,83,California,Santa Barbara County,2,16,10053,4518,5535
50,6,83,California,Santa Barbara County,2,17,8482,3480,5002
50,6,83,California,Santa Barbara County,2,18,9090,3239,5851
50,6,83,California,Santa Barbara County,3,0,424231,212790,211441
50,6,83,California,Santa Barbara County,3,1,27529,13977,13552
50,6,83,California,Santa Barbara County,3,2,26330,13383,12947
50,6,83,California,Santa Barbara County,3,3,26547,13660,12887
50,6,83,California,Santa Barbara County,3,4,37861,19173,18688
50,6,83,California,Santa Barbara County,3,5,43542,22985,20557
50,6,83,California,Santa Barbara County,3,6,30885,16483,14402
50,6,83,California,Santa Barbara County,3,7,26648,14044,12604
50,6,83,California,Santa Barbara County,3,8,24954,13000,11954
50,6,83,California,Santa Barbara County,3,9,25287,12889,12398
50,6,83,California,Santa Barbara County,3,10,27357,13674,13683
50,6,83,California,Santa Barbara County,3,11,27406,13594,13812
50,6,83,California,Santa Barbara County,3,12,24558,12033,12525
50,6,83,California,Santa Barbara County,3,13,20751,10122,10629
50,6,83,California,Santa Barbara County,3,14,15130,7110,8020
50,6,83,California,Santa Barbara County,3,15,11798,5423,6375
50,6,83,California,Santa Barbara County,3,16,10022,4491,5531
50,6,83,California,Santa Barbara County,3,17,8474,3493,4981
50,6,83,California,Santa Barbara County,3,18,9152,3256,5896
50,6,83,California,Santa Barbara County,4,0,425453,213053,212400
50,6,83,California,Santa Barbara County,4,1,27832,14175,13657
50,6,83,California,Santa Barbara County,4,2,26506,13361,13145
50,6,83,California,Santa Barbara County,4,3,26195,13444,12751
50,6,83,California,Santa Barbara County,4,4,37113,18734,18379
50,6,83,California,Santa Barbara County,4,5,45666,23881,21785
50,6,83,California,Santa Barbara County,4,6,29777,15970,13807
50,6,83,California,Santa Barbara County,4,7,26949,14227,12722
50,6,83,California,Santa Barbara County,4,8,24290,12590,11700
50,6,83,California,Santa Barbara County,4,9,25126,12847,12279
50,6,83,California,Santa Barbara County,4,10,26477,13216,13261
50,6,83,California,Santa Barbara County,4,11,27394,13547,13847
50,6,83,California,Santa Barbara County,4,12,25012,12269,12743
50,6,83,California,Santa Barbara County,4,13,21663,10542,11121
50,6,83,California,Santa Barbara County,4,14,15567,7385,8182
50,6,83,California,Santa Barbara County,4,15,12074,5575,6499
50,6,83,California,Santa Barbara County,4,16,9967,4405,5562
50,6,83,California,Santa Barbara County,4,17,8453,3544,4909
50,6,83,California,Santa Barbara County,4,18,9392,3341,6051
50,6,83,California,Santa Barbara County,5,0,429699,215457,214242
50,6,83,California,Santa Barbara County,5,1,27978,14228,13750
50,6,83,California,Santa Barbara County,5,2,27113,13677,13436
50,6,83,California,Santa Barbara County,5,3,25901,13267,12634
50,6,83,California,Santa Barbara County,5,4,36590,18460,18130
50,6,83,California,Santa Barbara County,5,5,48063,25087,22976
50,6,83,California,Santa Barbara County,5,6,28887,15575,13312
50,6,83,California,Santa Barbara County,5,7,27888,14750,13138
50,6,83,California,Santa Barbara County,5,8,24320,12630,11690
50,6,83,California,Santa Barbara County,5,9,25086,12921,12165
50,6,83,California,Santa Barbara County,5,10,25729,12914,12815
50,6,83,California,Santa Barbara County,5,11,27415,13574,13841
50,6,83,California,Santa Barbara County,5,12,25541,12554,12987
50,6,83,California,Santa Barbara County,5,13,21753,10465,11288
50,6,83,California,Santa Barbara County,5,14,16964,8157,8807
50,6,83,California,Santa Barbara County,5,15,12403,5701,6702
50,6,83,California,Santa Barbara County,5,16,9948,4406,5542
50,6,83,California,Santa Barbara County,5,17,8488,3604,4884
50,6,83,California,Santa Barbara County,5,18,9632,3487,6145
50,6,83,California,Santa Barbara County,6,0,434601,217884,216717
50,6,83,California,Santa Barbara County,6,1,28219,14402,13817
50,6,83,California,Santa Barbara County,6,2,27711,13947,13764
50,6,83,California,Santa Barbara County,6,3,25953,13282,12671
50,6,83,California,Santa Barbara County,6,4,36401,18285,18116
50,6,83,California,Santa Barbara County,6,5,50137,26135,24002
50,6,83,California,Santa Barbara County,6,6,28673,15378,13295
50,6,83,California,Santa Barbara County,6,7,28490,15111,13379
50,6,83,California,Santa Barbara County,6,8,24663,12843,11820
50,6,83,California,Santa Barbara County,6,9,24855,12779,12076
50,6,83,California,Santa Barbara County,6,10,24963,12605,12358
50,6,83,California,Santa Barbara County,6,11,27208,13420,13788
50,6,83,California,Santa Barbara County,6,12,25764,12714,13050
50,6,83,California,Santa Barbara County,6,13,22381,10750,11631
50,6,83,California,Santa Barbara County,6,14,17808,8566,9242
50,6,83,California,Santa Barbara County,6,15,12991,5971,7020
50,6,83,California,Santa Barbara County,6,16,10161,4495,5666
50,6,83,California,Santa Barbara County,6,17,8425,3629,4796
50,6,83,California,Santa Barbara County,6,18,9798,3572,6226
50,6,83,California,Santa Barbara County,7,0,439045,220078,218967
50,6,83,California,Santa Barbara County,7,1,28616,14676,13940
50,6,83,California,Santa Barbara County,7,2,27872,14070,13802
50,6,83,California,Santa Barbara County,7,3,26061,13219,12842
50,6,83,California,Santa Barbara County,7,4,36336,18169,18167
50,6,83,California,Santa Barbara County,7,5,50978,26498,24480
50,6,83,California,Santa Barbara County,7,6,28972,15630,13342
50,6,83,California,Santa Barbara County,7,7,28921,15321,13600
50,6,83,California,Santa Barbara County,7,8,25055,13102,11953
50,6,83,California,Santa Barbara County,7,9,24592,12621,11971
50,6,83,California,Santa Barbara County,7,10,24552,12431,12121
50,6,83,California,Santa Barbara County,7,11,27107,13359,13748
50,6,83,California,Santa Barbara County,7,12,26102,12862,13240
50,6,83,California,Santa Barbara County,7,13,22814,11004,11810
50,6,83,California,Santa Barbara County,7,14,18725,8998,9727
50,6,83,California,Santa Barbara County,7,15,13556,6195,7361
50,6,83,California,Santa Barbara County,7,16,10400,4647,5753
50,6,83,California,Santa Barbara County,7,17,8400,3630,4770
50,6,83,California,Santa Barbara County,7,18,9986,3646,6340
50,6,83,California,Santa Barbara County,8,0,442229,221615,220614
50,6,83,California,Santa Barbara County,8,1,28945,14878,14067
50,6,83,California,Santa Barbara County,8,2,27880,14043,13837
50,6,83,California,Santa Barbara County,8,3,26347,13326,13021
50,6,83,California,Santa Barbara County,8,4,36292,18075,18217
50,6,83,California,Santa Barbara County,8,5,51360,26561,24799
50,6,83,California,Santa Barbara County,8,6,29702,16046,13656
50,6,83,California,Santa Barbara County,8,7,28536,15144,13392
50,6,83,California,Santa Barbara County,8,8,25545,13300,12245
50,6,83,California,Santa Barbara County,8,9,24230,12487,11743
50,6,83,California,Santa Barbara County,8,10,24489,12407,12082
50,6,83,California,Santa Barbara County,8,11,26298,13046,13252
50,6,83,California,Santa Barbara County,8,12,26316,12939,13377
50,6,83,California,Santa Barbara County,8,13,23332,11249,12083
50,6,83,California,Santa Barbara County,8,14,19658,9503,10155
50,6,83,California,Santa Barbara County,8,15,14087,6462,7625
50,6,83,California,Santa Barbara County,8,16,10648,4769,5879
50,6,83,California,Santa Barbara County,8,17,8325,3619,4706
50,6,83,California,Santa Barbara County,8,18,10239,3761,6478
50,6,83,California,Santa Barbara County,9,0,444340,222450,221890
50,6,83,California,Santa Barbara County,9,1,28619,14778,13841
50,6,83,California,Santa Barbara County,9,2,28129,14164,13965
50,6,83,California,Santa Barbara County,9,3,26625,13463,13162
50,6,83,California,Santa Barbara County,9,4,36297,17984,18313
50,6,83,California,Santa Barbara County,9,5,50881,26284,24597
50,6,83,California,Santa Barbara County,9,6,31089,16635,14454
50,6,83,California,Santa Barbara County,9,7,28185,15014,13171
50,6,83,California,Santa Barbara County,9,8,25977,13524,12453
50,6,83,California,Santa Barbara County,9,9,23697,12143,11554
50,6,83,California,Santa Barbara County,9,10,24569,12462,12107
50,6,83,California,Santa Barbara County,9,11,25538,12700,12838
50,6,83,California,Santa Barbara County,9,12,26369,12930,13439
50,6,83,California,Santa Barbara County,9,13,23763,11460,12303
50,6,83,California,Santa Barbara County,9,14,20521,9835,10686
50,6,83,California,Santa Barbara County,9,15,14549,6793,7756
50,6,83,California,Santa Barbara County,9,16,10836,4843,5993
50,6,83,California,Santa Barbara County,9,17,8351,3584,4767
50,6,83,California,Santa Barbara County,9,18,10345,3854,6491
50,6,83,California,Santa Barbara County,10,0,445298,222867,222431
50,6,83,California,Santa Barbara County,10,1,28153,14518,13635
50,6,83,California,Santa Barbara County,10,2,28088,14229,13859
50,6,83,California,Santa Barbara County,10,3,27056,13681,13375
50,6,83,California,Santa Barbara County,10,4,36226,17826,18400
50,6,83,California,Santa Barbara County,10,5,50343,25894,24449
50,6,83,California,Santa Barbara County,10,6,32364,17320,15044
50,6,83,California,Santa Barbara County,10,7,27211,14560,12651
50,6,83,California,Santa Barbara County,10,8,26486,13833,12653
50,6,83,California,Santa Barbara County,10,9,23563,12043,11520
50,6,83,California,Santa Barbara County,10,10,24358,12402,11956
50,6,83,California,Santa Barbara County,10,11,24640,12281,12359
50,6,83,California,Santa Barbara County,10,12,26254,12806,13448
50,6,83,California,Santa Barbara County,10,13,24193,11732,12461
50,6,83,California,Santa Barbara County,10,14,20585,9775,10810
50,6,83,California,Santa Barbara County,10,15,15891,7483,8408
50,6,83,California,Santa Barbara County,10,16,11150,5007,6143
50,6,83,California,Santa Barbara County,10,17,8345,3529,4816
50,6,83,California,Santa Barbara County,10,18,10392,3948,6444
50,6,83,California,Santa Barbara County,11,0,445780,222850,222930
50,6,83,California,Santa Barbara County,11,1,27805,14255,13550
50,6,83,California,Santa Barbara County,11,2,27964,14231,13733
50,6,83,California,Santa Barbara County,11,3,27419,13809,13610
50,6,83,California,Santa Barbara County,11,4,36374,17914,18460
50,6,83,California,Santa Barbara County,11,5,49565,25399,24166
50,6,83,California,Santa Barbara County,11,6,32665,17477,15188
50,6,83,California,Santa Barbara County,11,7,26834,14231,12603
50,6,83,California,Santa Barbara County,11,8,26825,14020,12805
50,6,83,California,Santa Barbara County,11,9,23733,12176,11557
50,6,83,California,Santa Barbara County,11,10,23867,12109,11758
50,6,83,California,Santa Barbara County,11,11,23963,12012,11951
50,6,83,California,Santa Barbara County,11,12,26102,12717,13385
50,6,83,California,Santa Barbara County,11,13,24382,11883,12499
50,6,83,California,Santa Barbara County,11,14,21049,9940,11109
50,6,83,California,Santa Barbara County,11,15,16584,7825,8759
50,6,83,California,Santa Barbara County,11,16,11735,5264,6471
50,6,83,California,Santa Barbara County,11,17,8467,3564,4903
50,6,83,California,Santa Barbara County,11,18,10447,4024,6423
50,6,83,California,Santa Barbara County,12,0,446499,223245,223254
50,6,83,California,Santa Barbara County,12,1,27356,14019,13337
50,6,83,California,Santa Barbara County,12,2,28070,14332,13738
50,6,83,California,Santa Barbara County,12,3,27408,13841,13567
50,6,83,California,Santa Barbara County,12,4,36332,17812,18520
50,6,83,California,Santa Barbara County,12,5,48901,25010,23891
50,6,83,California,Santa Barbara County,12,6,33102,17591,15511
50,6,83,California,Santa Barbara County,12,7,27028,14434,12594
50,6,83,California,Santa Barbara County,12,8,27189,14200,12989
50,6,83,California,Santa Barbara County,12,9,23813,12266,11547
50,6,83,California,Santa Barbara County,12,10,23394,11918,11476
50,6,83,California,Santa Barbara County,12,11,23476,11844,11632
50,6,83,California,Santa Barbara County,12,12,25743,12490,13253
50,6,83,California,Santa Barbara County,12,13,24562,11934,12628
50,6,83,California,Santa Barbara County,12,14,21365,10146,11219
50,6,83,California,Santa Barbara County,12,15,17405,8221,9184
50,6,83,California,Santa Barbara County,12,16,12219,5447,6772
50,6,83,California,Santa Barbara County,12,17,8661,3689,4972
50,6,83,California,Santa Barbara County,12,18,10475,4051,6424
50,6,85,California,Santa Clara County,1,0,1781642,893851,887791
50,6,85,California,Santa Clara County,1,1,124464,63660,60804
50,6,85,California,Santa Clara County,1,2,121928,62320,59608
50,6,85,California,Santa Clara County,1,3,113570,58180,55390
50,6,85,California,Santa Clara County,1,4,114544,59564,54980
50,6,85,California,Santa Clara County,1,5,113117,60070,53047
50,6,85,California,Santa Clara County,1,6,133544,68924,64620
50,6,85,California,Santa Clara County,1,7,136022,69295,66727
50,6,85,California,Santa Clara County,1,8,140750,71298,69452
50,6,85,California,Santa Clara County,1,9,137619,69926,67693
50,6,85,California,Santa Clara County,1,10,138118,70721,67397
50,6,85,California,Santa Clara County,1,11,125476,63598,61878
50,6,85,California,Santa Clara County,1,12,102413,50394,52019
50,6,85,California,Santa Clara County,1,13,83133,39897,43236
50,6,85,California,Santa Clara County,1,14,60577,28245,32332
50,6,85,California,Santa Clara County,1,15,45944,20889,25055
50,6,85,California,Santa Clara County,1,16,35666,15797,19869
50,6,85,California,Santa Clara County,1,17,27282,11270,16012
50,6,85,California,Santa Clara County,1,18,27475,9803,17672
50,6,85,California,Santa Clara County,2,0,1781686,893868,887818
50,6,85,California,Santa Clara County,2,1,124467,63661,60806
50,6,85,California,Santa Clara County,2,2,121931,62323,59608
50,6,85,California,Santa Clara County,2,3,113572,58181,55391
50,6,85,California,Santa Clara County,2,4,114545,59564,54981
50,6,85,California,Santa Clara County,2,5,113120,60070,53050
50,6,85,California,Santa Clara County,2,6,133550,68925,64625
50,6,85,California,Santa Clara County,2,7,136026,69295,66731
50,6,85,California,Santa Clara County,2,8,140751,71299,69452
50,6,85,California,Santa Clara County,2,9,137620,69927,67693
50,6,85,California,Santa Clara County,2,10,138123,70723,67400
50,6,85,California,Santa Clara County,2,11,125489,63605,61884
50,6,85,California,Santa Clara County,2,12,102414,50394,52020
50,6,85,California,Santa Clara County,2,13,83135,39897,43238
50,6,85,California,Santa Clara County,2,14,60576,28245,32331
50,6,85,California,Santa Clara County,2,15,45944,20889,25055
50,6,85,California,Santa Clara County,2,16,35666,15797,19869
50,6,85,California,Santa Clara County,2,17,27282,11270,16012
50,6,85,California,Santa Clara County,2,18,27475,9803,17672
50,6,85,California,Santa Clara County,3,0,1786040,895857,890183
50,6,85,California,Santa Clara County,3,1,124323,63596,60727
50,6,85,California,Santa Clara County,3,2,122185,62422,59763
50,6,85,California,Santa Clara County,3,3,114040,58391,55649
50,6,85,California,Santa Clara County,3,4,114344,59374,54970
50,6,85,California,Santa Clara County,3,5,113092,59945,53147
50,6,85,California,Santa Clara County,3,6,133593,69082,64511
50,6,85,California,Santa Clara County,3,7,136018,69209,66809
50,6,85,California,Santa Clara County,3,8,140518,71203,69315
50,6,85,California,Santa Clara County,3,9,137970,70045,67925
50,6,85,California,Santa Clara County,3,10,137976,70652,67324
50,6,85,California,Santa Clara County,3,11,126229,63994,62235
50,6,85,California,Santa Clara County,3,12,103320,50894,52426
50,6,85,California,Santa Clara County,3,13,83988,40253,43735
50,6,85,California,Santa Clara County,3,14,61164,28593,32571
50,6,85,California,Santa Clara County,3,15,46281,21024,25257
50,6,85,California,Santa Clara County,3,16,35727,15840,19887
50,6,85,California,Santa Clara County,3,17,27431,11379,16052
50,6,85,California,Santa Clara County,3,18,27841,9961,17880
50,6,85,California,Santa Clara County,4,0,1812054,909220,902834
50,6,85,California,Santa Clara County,4,1,124124,63676,60448
50,6,85,California,Santa Clara County,4,2,123725,63135,60590
50,6,85,California,Santa Clara County,4,3,116016,59381,56635
50,6,85,California,Santa Clara County,4,4,113729,58745,54984
50,6,85,California,Santa Clara County,4,5,114735,60644,54091
50,6,85,California,Santa Clara County,4,6,135105,70401,64704
50,6,85,California,Santa Clara County,4,7,137973,70171,67802
50,6,85,California,Santa Clara County,4,8,139742,71072,68670
50,6,85,California,Santa Clara County,4,9,140051,70837,69214
50,6,85,California,Santa Clara County,4,10,137240,70286,66954
50,6,85,California,Santa Clara County,4,11,129217,65594,63623
50,6,85,California,Santa Clara County,4,12,107373,53155,54218
50,6,85,California,Santa Clara County,4,13,87904,42050,45854
50,6,85,California,Santa Clara County,4,14,63642,29888,33754
50,6,85,California,Santa Clara County,4,15,47857,21644,26213
50,6,85,California,Santa Clara County,4,16,36456,16237,20219
50,6,85,California,Santa Clara County,4,17,27926,11767,16159
50,6,85,California,Santa Clara County,4,18,29239,10537,18702
50,6,85,California,Santa Clara County,5,0,1837853,923098,914755
50,6,85,California,Santa Clara County,5,1,122560,62708,59852
50,6,85,California,Santa Clara County,5,2,125718,64285,61433
50,6,85,California,Santa Clara County,5,3,117147,59980,57167
50,6,85,California,Santa Clara County,5,4,113560,58448,55112
50,6,85,California,Santa Clara County,5,5,116904,61801,55103
50,6,85,California,Santa Clara County,5,6,136669,71855,64814
50,6,85,California,Santa Clara County,5,7,140764,71752,69012
50,6,85,California,Santa Clara County,5,8,139601,71365,68236
50,6,85,California,Santa Clara County,5,9,142234,71873,70361
50,6,85,California,Santa Clara County,5,10,136077,69492,66585
50,6,85,California,Santa Clara County,5,11,131418,66863,64555
50,6,85,California,Santa Clara County,5,12,111690,55486,56204
50,6,85,California,Santa Clara County,5,13,88712,42563,46149
50,6,85,California,Santa Clara County,5,14,68407,32123,36284
50,6,85,California,Santa Clara County,5,15,49891,22626,27265
50,6,85,California,Santa Clara County,5,16,37576,16748,20828
50,6,85,California,Santa Clara County,5,17,28471,12081,16390
50,6,85,California,Santa Clara County,5,18,30454,11049,19405
50,6,85,California,Santa Clara County,6,0,1866425,938111,928314
50,6,85,California,Santa Clara County,6,1,121851,62444,59407
50,6,85,California,Santa Clara County,6,2,127074,64987,62087
50,6,85,California,Santa Clara County,6,3,119313,61075,58238
50,6,85,California,Santa Clara County,6,4,113261,58110,55151
50,6,85,California,Santa Clara County,6,5,119580,63270,56310
50,6,85,California,Santa Clara County,6,6,138611,73182,65429
50,6,85,California,Santa Clara County,6,7,144732,74449,70283
50,6,85,California,Santa Clara County,6,8,139813,71313,68500
50,6,85,California,Santa Clara County,6,9,143075,72358,70717
50,6,85,California,Santa Clara County,6,10,135580,69006,66574
50,6,85,California,Santa Clara County,6,11,133551,67832,65719
50,6,85,California,Santa Clara County,6,12,115473,57727,57746
50,6,85,California,Santa Clara County,6,13,91193,43790,47403
50,6,85,California,Santa Clara County,6,14,71347,33493,37854
50,6,85,California,Santa Clara County,6,15,52319,23818,28501
50,6,85,California,Santa Clara County,6,16,38952,17335,21617
50,6,85,California,Santa Clara County,6,17,29130,12459,16671
50,6,85,California,Santa Clara County,6,18,31570,11463,20107
50,6,85,California,Santa Clara County,7,0,1891753,952395,939358
50,6,85,California,Santa Clara County,7,1,120992,62059,58933
50,6,85,California,Santa Clara County,7,2,126451,64772,61679
50,6,85,California,Santa Clara County,7,3,121211,61996,59215
50,6,85,California,Santa Clara County,7,4,113102,58074,55028
50,6,85,California,Santa Clara County,7,5,122204,64748,57456
50,6,85,California,Santa Clara County,7,6,142091,75363,66728
50,6,85,California,Santa Clara County,7,7,148849,77120,71729
50,6,85,California,Santa Clara County,7,8,140224,71793,68431
50,6,85,California,Santa Clara County,7,9,142176,71868,70308
50,6,85,California,Santa Clara County,7,10,135504,68698,66806
50,6,85,California,Santa Clara County,7,11,135101,68776,66325
50,6,85,California,Santa Clara County,7,12,118233,59448,58785
50,6,85,California,Santa Clara County,7,13,94085,45259,48826
50,6,85,California,Santa Clara County,7,14,74376,34868,39508
50,6,85,California,Santa Clara County,7,15,54345,24755,29590
50,6,85,California,Santa Clara County,7,16,40625,18113,22512
50,6,85,California,Santa Clara County,7,17,29602,12753,16849
50,6,85,California,Santa Clara County,7,18,32582,11932,20650
50,6,85,California,Santa Clara County,8,0,1916285,966167,950118
50,6,85,California,Santa Clara County,8,1,120840,61986,58854
50,6,85,California,Santa Clara County,8,2,125202,64118,61084
50,6,85,California,Santa Clara County,8,3,122155,62499,59656
50,6,85,California,Santa Clara County,8,4,113473,58228,55245
50,6,85,California,Santa Clara County,8,5,123204,65093,58111
50,6,85,California,Santa Clara County,8,6,147444,78798,68646
50,6,85,California,Santa Clara County,8,7,152562,79468,73094
50,6,85,California,Santa Clara County,8,8,141455,72739,68716
50,6,85,California,Santa Clara County,8,9,140466,70934,69532
50,6,85,California,Santa Clara County,8,10,136780,69239,67541
50,6,85,California,Santa Clara County,8,11,134581,68703,65878
50,6,85,California,Santa Clara County,8,12,121239,61054,60185
50,6,85,California,Santa Clara County,8,13,97000,46913,50087
50,6,85,California,Santa Clara County,8,14,77675,36421,41254
50,6,85,California,Santa Clara County,8,15,56417,25769,30648
50,6,85,California,Santa Clara County,8,16,41920,18713,23207
50,6,85,California,Santa Clara County,8,17,30081,12887,17194
50,6,85,California,Santa Clara County,8,18,33791,12605,21186
50,6,85,California,Santa Clara County,9,0,1928368,973257,955111
50,6,85,California,Santa Clara County,9,1,119192,61050,58142
50,6,85,California,Santa Clara County,9,2,122861,62898,59963
50,6,85,California,Santa Clara County,9,3,122450,62599,59851
50,6,85,California,Santa Clara County,9,4,114131,58581,55550
50,6,85,California,Santa Clara County,9,5,121755,64100,57655
50,6,85,California,Santa Clara County,9,6,152309,81910,70399
50,6,85,California,Santa Clara County,9,7,155246,81643,73603
50,6,85,California,Santa Clara County,9,8,142257,73154,69103
50,6,85,California,Santa Clara County,9,9,138155,70011,68144
50,6,85,California,Santa Clara County,9,10,137423,69319,68104
50,6,85,California,Santa Clara County,9,11,132907,67841,65066
50,6,85,California,Santa Clara County,9,12,122902,62021,60881
50,6,85,California,Santa Clara County,9,13,99525,48357,51168
50,6,85,California,Santa Clara County,9,14,80482,37706,42776
50,6,85,California,Santa Clara County,9,15,58121,26643,31478
50,6,85,California,Santa Clara County,9,16,43005,19051,23954
50,6,85,California,Santa Clara County,9,17,30727,13244,17483
50,6,85,California,Santa Clara County,9,18,34920,13129,21791
50,6,85,California,Santa Clara County,10,0,1932510,977117,955393
50,6,85,California,Santa Clara County,10,1,117561,60456,57105
50,6,85,California,Santa Clara County,10,2,119455,61057,58398
50,6,85,California,Santa Clara County,10,3,122666,62836,59830
50,6,85,California,Santa Clara County,10,4,114221,58649,55572
50,6,85,California,Santa Clara County,10,5,120060,63245,56815
50,6,85,California,Santa Clara County,10,6,155912,84291,71621
50,6,85,California,Santa Clara County,10,7,155573,82565,73008
50,6,85,California,Santa Clara County,10,8,143244,73950,69294
50,6,85,California,Santa Clara County,10,9,135699,68777,66922
50,6,85,California,Santa Clara County,10,10,137769,69490,68279
50,6,85,California,Santa Clara County,10,11,130427,66322,64105
50,6,85,California,Santa Clara County,10,12,123415,62446,60969
50,6,85,California,Santa Clara County,10,13,102252,49919,52333
50,6,85,California,Santa Clara County,10,14,80614,37912,42702
50,6,85,California,Santa Clara County,10,15,61780,28251,33529
50,6,85,California,Santa Clara County,10,16,44518,19745,24773
50,6,85,California,Santa Clara County,10,17,31506,13576,17930
50,6,85,California,Santa Clara County,10,18,35838,13630,22208
50,6,85,California,Santa Clara County,11,0,1932337,978212,954125
50,6,85,California,Santa Clara County,11,1,114431,58804,55627
50,6,85,California,Santa Clara County,11,2,116342,59393,56949
50,6,85,California,Santa Clara County,11,3,122112,62707,59405
50,6,85,California,Santa Clara County,11,4,114921,58904,56017
50,6,85,California,Santa Clara County,11,5,118392,62243,56149
50,6,85,California,Santa Clara County,11,6,157745,85629,72116
50,6,85,California,Santa Clara County,11,7,156291,83438,72853
50,6,85,California,Santa Clara County,11,8,145137,75463,69674
50,6,85,California,Santa Clara County,11,9,133215,67634,65581
50,6,85,California,Santa Clara County,11,10,136036,68499,67537
50,6,85,California,Santa Clara County,11,11,128274,65123,63151
50,6,85,California,Santa Clara County,11,12,123887,62593,61294
50,6,85,California,Santa Clara County,11,13,104308,51348,52960
50,6,85,California,Santa Clara County,11,14,82059,38712,43347
50,6,85,California,Santa Clara County,11,15,63529,28999,34530
50,6,85,California,Santa Clara County,11,16,46382,20656,25726
50,6,85,California,Santa Clara County,11,17,32500,13988,18512
50,6,85,California,Santa Clara County,11,18,36776,14079,22697
50,6,85,California,Santa Clara County,12,0,1927852,976847,951005
50,6,85,California,Santa Clara County,12,1,111866,57357,54509
50,6,85,California,Santa Clara County,12,2,113691,58082,55609
50,6,85,California,Santa Clara County,12,3,119633,61449,58184
50,6,85,California,Santa Clara County,12,4,115515,59220,56295
50,6,85,California,Santa Clara County,12,5,116421,61026,55395
50,6,85,California,Santa Clara County,12,6,158543,86319,72224
50,6,85,California,Santa Clara County,12,7,157267,84333,72934
50,6,85,California,Santa Clara County,12,8,146423,76672,69751
50,6,85,California,Santa Clara County,12,9,130935,66523,64412
50,6,85,California,Santa Clara County,12,10,133446,67128,66318
50,6,85,California,Santa Clara County,12,11,126575,64009,62566
50,6,85,California,Santa Clara County,12,12,123815,62674,61141
50,6,85,California,Santa Clara County,12,13,105515,52329,53186
50,6,85,California,Santa Clara County,12,14,83628,39615,44013
50,6,85,California,Santa Clara County,12,15,65660,29883,35777
50,6,85,California,Santa Clara County,12,16,47887,21323,26564
50,6,85,California,Santa Clara County,12,17,33589,14440,19149
50,6,85,California,Santa Clara County,12,18,37443,14465,22978
50,6,87,California,Santa Cruz County,1,0,262382,130913,131469
50,6,87,California,Santa Cruz County,1,1,15045,7744,7301
50,6,87,California,Santa Cruz County,1,2,15071,7700,7371
50,6,87,California,Santa Cruz County,1,3,15347,7916,7431
50,6,87,California,Santa Cruz County,1,4,21834,10966,10868
50,6,87,California,Santa Cruz County,1,5,24391,12735,11656
50,6,87,California,Santa Cruz County,1,6,17597,9155,8442
50,6,87,California,Santa Cruz County,1,7,16152,8228,7924
50,6,87,California,Santa Cruz County,1,8,15918,8161,7757
50,6,87,California,Santa Cruz County,1,9,17157,8598,8559
50,6,87,California,Santa Cruz County,1,10,18712,9244,9468
50,6,87,California,Santa Cruz County,1,11,20065,9840,10225
50,6,87,California,Santa Cruz County,1,12,19781,9800,9981
50,6,87,California,Santa Cruz County,1,13,16154,8155,7999
50,6,87,California,Santa Cruz County,1,14,9699,4713,4986
50,6,87,California,Santa Cruz County,1,15,6175,2882,3293
50,6,87,California,Santa Cruz County,1,16,4591,1933,2658
50,6,87,California,Santa Cruz County,1,17,4077,1586,2491
50,6,87,California,Santa Cruz County,1,18,4616,1557,3059
50,6,87,California,Santa Cruz County,2,0,262350,130902,131448
50,6,87,California,Santa Cruz County,2,1,15041,7743,7298
50,6,87,California,Santa Cruz County,2,2,15067,7698,7369
50,6,87,California,Santa Cruz County,2,3,15345,7915,7430
50,6,87,California,Santa Cruz County,2,4,21833,10966,10867
50,6,87,California,Santa Cruz County,2,5,24389,12734,11655
50,6,87,California,Santa Cruz County,2,6,17595,9155,8440
50,6,87,California,Santa Cruz County,2,7,16150,8229,7921
50,6,87,California,Santa Cruz County,2,8,15917,8161,7756
50,6,87,California,Santa Cruz County,2,9,17155,8596,8559
50,6,87,California,Santa Cruz County,2,10,18709,9242,9467
50,6,87,California,Santa Cruz County,2,11,20058,9837,10221
50,6,87,California,Santa Cruz County,2,12,19780,9800,9980
50,6,87,California,Santa Cruz County,2,13,16152,8155,7997
50,6,87,California,Santa Cruz County,2,14,9700,4713,4987
50,6,87,California,Santa Cruz County,2,15,6175,2882,3293
50,6,87,California,Santa Cruz County,2,16,4591,1933,2658
50,6,87,California,Santa Cruz County,2,17,4077,1586,2491
50,6,87,California,Santa Cruz County,2,18,4616,1557,3059
50,6,87,California,Santa Cruz County,3,0,263147,131208,131939
50,6,87,California,Santa Cruz County,3,1,15142,7793,7349
50,6,87,California,Santa Cruz County,3,2,15046,7691,7355
50,6,87,California,Santa Cruz County,3,3,15305,7887,7418
50,6,87,California,Santa Cruz County,3,4,22237,11114,11123
50,6,87,California,Santa Cruz County,3,5,24817,12916,11901
50,6,87,California,Santa Cruz County,3,6,17367,9048,8319
50,6,87,California,Santa Cruz County,3,7,16192,8241,7951
50,6,87,California,Santa Cruz County,3,8,15829,8120,7709
50,6,87,California,Santa Cruz County,3,9,17118,8579,8539
50,6,87,California,Santa Cruz County,3,10,18545,9180,9365
50,6,87,California,Santa Cruz County,3,11,19957,9782,10175
50,6,87,California,Santa Cruz County,3,12,19811,9790,10021
50,6,87,California,Santa Cruz County,3,13,16382,8285,8097
50,6,87,California,Santa Cruz County,3,14,9872,4789,5083
50,6,87,California,Santa Cruz County,3,15,6213,2895,3318
50,6,87,California,Santa Cruz County,3,16,4625,1954,2671
50,6,87,California,Santa Cruz County,3,17,4048,1576,2472
50,6,87,California,Santa Cruz County,3,18,4641,1568,3073
50,6,87,California,Santa Cruz County,4,0,264858,131858,133000
50,6,87,California,Santa Cruz County,4,1,15258,7816,7442
50,6,87,California,Santa Cruz County,4,2,15081,7669,7412
50,6,87,California,Santa Cruz County,4,3,15196,7864,7332
50,6,87,California,Santa Cruz County,4,4,22432,11123,11309
50,6,87,California,Santa Cruz County,4,5,26047,13531,12516
50,6,87,California,Santa Cruz County,4,6,16624,8731,7893
50,6,87,California,Santa Cruz County,4,7,16299,8183,8116
50,6,87,California,Santa Cruz County,4,8,15445,7883,7562
50,6,87,California,Santa Cruz County,4,9,17084,8594,8490
50,6,87,California,Santa Cruz County,4,10,17891,8865,9026
50,6,87,California,Santa Cruz County,4,11,19648,9633,10015
50,6,87,California,Santa Cruz County,4,12,19864,9749,10115
50,6,87,California,Santa Cruz County,4,13,17434,8812,8622
50,6,87,California,Santa Cruz County,4,14,10587,5122,5465
50,6,87,California,Santa Cruz County,4,15,6526,3057,3469
50,6,87,California,Santa Cruz County,4,16,4774,2069,2705
50,6,87,California,Santa Cruz County,4,17,3977,1550,2427
50,6,87,California,Santa Cruz County,4,18,4691,1607,3084
50,6,87,California,Santa Cruz County,5,0,266340,132463,133877
50,6,87,California,Santa Cruz County,5,1,15229,7735,7494
50,6,87,California,Santa Cruz County,5,2,15205,7739,7466
50,6,87,California,Santa Cruz County,5,3,15003,7796,7207
50,6,87,California,Santa Cruz County,5,4,22301,10952,11349
50,6,87,California,Santa Cruz County,5,5,27129,13985,13144
50,6,87,California,Santa Cruz County,5,6,15873,8356,7517
50,6,87,California,Santa Cruz County,5,7,16312,8257,8055
50,6,87,California,Santa Cruz County,5,8,15500,7835,7665
50,6,87,California,Santa Cruz County,5,9,16855,8557,8298
50,6,87,California,Santa Cruz County,5,10,17468,8633,8835
50,6,87,California,Santa Cruz County,5,11,19199,9495,9704
50,6,87,California,Santa Cruz County,5,12,19892,9650,10242
50,6,87,California,Santa Cruz County,5,13,17639,8883,8756
50,6,87,California,Santa Cruz County,5,14,12032,5897,6135
50,6,87,California,Santa Cruz County,5,15,7086,3335,3751
50,6,87,California,Santa Cruz County,5,16,4852,2146,2706
50,6,87,California,Santa Cruz County,5,17,3948,1569,2379
50,6,87,California,Santa Cruz County,5,18,4817,1643,3174
50,6,87,California,Santa Cruz County,6,0,268816,133584,135232
50,6,87,California,Santa Cruz County,6,1,15115,7717,7398
50,6,87,California,Santa Cruz County,6,2,15365,7853,7512
50,6,87,California,Santa Cruz County,6,3,14864,7631,7233
50,6,87,California,Santa Cruz County,6,4,22368,10997,11371
50,6,87,California,Santa Cruz County,6,5,28126,14396,13730
50,6,87,California,Santa Cruz County,6,6,15687,8229,7458
50,6,87,California,Santa Cruz County,6,7,16413,8348,8065
50,6,87,California,Santa Cruz County,6,8,15701,7936,7765
50,6,87,California,Santa Cruz County,6,9,16571,8379,8192
50,6,87,California,Santa Cruz County,6,10,17157,8499,8658
50,6,87,California,Santa Cruz County,6,11,18834,9335,9499
50,6,87,California,Santa Cruz County,6,12,19699,9529,10170
50,6,87,California,Santa Cruz County,6,13,18202,9143,9059
50,6,87,California,Santa Cruz County,6,14,13045,6402,6643
50,6,87,California,Santa Cruz County,6,15,7831,3690,4141
50,6,87,California,Santa Cruz County,6,16,5003,2279,2724
50,6,87,California,Santa Cruz County,6,17,3932,1563,2369
50,6,87,California,Santa Cruz County,6,18,4903,1658,3245
50,6,87,California,Santa Cruz County,7,0,270861,134487,136374
50,6,87,California,Santa Cruz County,7,1,15023,7672,7351
50,6,87,California,Santa Cruz County,7,2,15134,7716,7418
50,6,87,California,Santa Cruz County,7,3,14999,7709,7290
50,6,87,California,Santa Cruz County,7,4,22202,10889,11313
50,6,87,California,Santa Cruz County,7,5,28354,14478,13876
50,6,87,California,Santa Cruz County,7,6,16154,8518,7636
50,6,87,California,Santa Cruz County,7,7,16442,8337,8105
50,6,87,California,Santa Cruz County,7,8,15847,7947,7900
50,6,87,California,Santa Cruz County,7,9,16227,8265,7962
50,6,87,California,Santa Cruz County,7,10,16928,8400,8528
50,6,87,California,Santa Cruz County,7,11,18665,9222,9443
50,6,87,California,Santa Cruz County,7,12,19494,9463,10031
50,6,87,California,Santa Cruz County,7,13,18600,9192,9408
50,6,87,California,Santa Cruz County,7,14,14153,7016,7137
50,6,87,California,Santa Cruz County,7,15,8483,4026,4457
50,6,87,California,Santa Cruz County,7,16,5281,2413,2868
50,6,87,California,Santa Cruz County,7,17,3886,1553,2333
50,6,87,California,Santa Cruz County,7,18,4989,1671,3318
50,6,87,California,Santa Cruz County,8,0,273503,135754,137749
50,6,87,California,Santa Cruz County,8,1,14977,7715,7262
50,6,87,California,Santa Cruz County,8,2,15039,7699,7340
50,6,87,California,Santa Cruz County,8,3,15042,7634,7408
50,6,87,California,Santa Cruz County,8,4,22426,11055,11371
50,6,87,California,Santa Cruz County,8,5,28582,14349,14233
50,6,87,California,Santa Cruz County,8,6,16672,8860,7812
50,6,87,California,Santa Cruz County,8,7,16242,8196,8046
50,6,87,California,Santa Cruz County,8,8,16078,8094,7984
50,6,87,California,Santa Cruz County,8,9,15795,7975,7820
50,6,87,California,Santa Cruz County,8,10,17114,8587,8527
50,6,87,California,Santa Cruz County,8,11,18380,9065,9315
50,6,87,California,Santa Cruz County,8,12,19318,9419,9899
50,6,87,California,Santa Cruz County,8,13,18889,9289,9600
50,6,87,California,Santa Cruz County,8,14,15225,7586,7639
50,6,87,California,Santa Cruz County,8,15,9145,4321,4824
50,6,87,California,Santa Cruz County,8,16,5606,2585,3021
50,6,87,California,Santa Cruz County,8,17,3884,1573,2311
50,6,87,California,Santa Cruz County,8,18,5089,1752,3337
50,6,87,California,Santa Cruz County,9,0,274396,136089,138307
50,6,87,California,Santa Cruz County,9,1,14613,7534,7079
50,6,87,California,Santa Cruz County,9,2,15038,7700,7338
50,6,87,California,Santa Cruz County,9,3,15058,7585,7473
50,6,87,California,Santa Cruz County,9,4,22394,11054,11340
50,6,87,California,Santa Cruz County,9,5,28339,14172,14167
50,6,87,California,Santa Cruz County,9,6,17288,9152,8136
50,6,87,California,Santa Cruz County,9,7,15960,8133,7827
50,6,87,California,Santa Cruz County,9,8,16285,8134,8151
50,6,87,California,Santa Cruz County,9,9,15512,7789,7723
50,6,87,California,Santa Cruz County,9,10,17229,8710,8519
50,6,87,California,Santa Cruz County,9,11,17722,8756,8966
50,6,87,California,Santa Cruz County,9,12,19011,9274,9737
50,6,87,California,Santa Cruz County,9,13,18899,9244,9655
50,6,87,California,Santa Cruz County,9,14,16309,8130,8179
50,6,87,California,Santa Cruz County,9,15,9816,4630,5186
50,6,87,California,Santa Cruz County,9,16,5836,2658,3178
50,6,87,California,Santa Cruz County,9,17,4030,1699,2331
50,6,87,California,Santa Cruz County,9,18,5057,1735,3322
50,6,87,California,Santa Cruz County,10,0,274856,136220,138636
50,6,87,California,Santa Cruz County,10,1,14263,7328,6935
50,6,87,California,Santa Cruz County,10,2,14844,7535,7309
50,6,87,California,Santa Cruz County,10,3,15158,7688,7470
50,6,87,California,Santa Cruz County,10,4,22509,11152,11357
50,6,87,California,Santa Cruz County,10,5,27958,13858,14100
50,6,87,California,Santa Cruz County,10,6,17724,9448,8276
50,6,87,California,Santa Cruz County,10,7,15598,7969,7629
50,6,87,California,Santa Cruz County,10,8,16361,8177,8184
50,6,87,California,Santa Cruz County,10,9,15638,7782,7856
50,6,87,California,Santa Cruz County,10,10,16995,8619,8376
50,6,87,California,Santa Cruz County,10,11,17250,8550,8700
50,6,87,California,Santa Cruz County,10,12,18608,9098,9510
50,6,87,California,Santa Cruz County,10,13,18821,9103,9718
50,6,87,California,Santa Cruz County,10,14,16444,8168,8276
50,6,87,California,Santa Cruz County,10,15,11196,5348,5848
50,6,87,California,Santa Cruz County,10,16,6364,2908,3456
50,6,87,California,Santa Cruz County,10,17,4099,1746,2353
50,6,87,California,Santa Cruz County,10,18,5026,1743,3283
50,6,87,California,Santa Cruz County,11,0,273841,135527,138314
50,6,87,California,Santa Cruz County,11,1,13768,7097,6671
50,6,87,California,Santa Cruz County,11,2,14677,7468,7209
50,6,87,California,Santa Cruz County,11,3,15084,7710,7374
50,6,87,California,Santa Cruz County,11,4,22386,11009,11377
50,6,87,California,Santa Cruz County,11,5,27442,13604,13838
50,6,87,California,Santa Cruz County,11,6,17843,9400,8443
50,6,87,California,Santa Cruz County,11,7,15413,7879,7534
50,6,87,California,Santa Cruz County,11,8,16209,8093,8116
50,6,87,California,Santa Cruz County,11,9,15624,7777,7847
50,6,87,California,Santa Cruz County,11,10,16584,8384,8200
50,6,87,California,Santa Cruz County,11,11,16907,8400,8507
50,6,87,California,Santa Cruz County,11,12,18128,8838,9290
50,6,87,California,Santa Cruz County,11,13,18510,8957,9553
50,6,87,California,Santa Cruz County,11,14,16823,8305,8518
50,6,87,California,Santa Cruz County,11,15,12078,5787,6291
50,6,87,California,Santa Cruz County,11,16,6995,3191,3804
50,6,87,California,Santa Cruz County,11,17,4227,1846,2381
50,6,87,California,Santa Cruz County,11,18,5143,1782,3361
50,6,87,California,Santa Cruz County,12,0,273213,135176,138037
50,6,87,California,Santa Cruz County,12,1,13446,6867,6579
50,6,87,California,Santa Cruz County,12,2,14458,7427,7031
50,6,87,California,Santa Cruz County,12,3,14806,7568,7238
50,6,87,California,Santa Cruz County,12,4,22730,11181,11549
50,6,87,California,Santa Cruz County,12,5,27076,13445,13631
50,6,87,California,Santa Cruz County,12,6,17571,9285,8286
50,6,87,California,Santa Cruz County,12,7,15531,7927,7604
50,6,87,California,Santa Cruz County,12,8,16138,8078,8060
50,6,87,California,Santa Cruz County,12,9,15542,7711,7831
50,6,87,California,Santa Cruz County,12,10,16115,8184,7931
50,6,87,California,Santa Cruz County,12,11,16520,8224,8296
50,6,87,California,Santa Cruz County,12,12,17825,8664,9161
50,6,87,California,Santa Cruz County,12,13,18238,8805,9433
50,6,87,California,Santa Cruz County,12,14,17078,8348,8730
50,6,87,California,Santa Cruz County,12,15,12971,6247,6724
50,6,87,California,Santa Cruz County,12,16,7536,3460,4076
50,6,87,California,Santa Cruz County,12,17,4440,1934,2506
50,6,87,California,Santa Cruz County,12,18,5192,1821,3371
50,6,89,California,Shasta County,1,0,177223,87130,90093
50,6,89,California,Shasta County,1,1,10268,5307,4961
50,6,89,California,Shasta County,1,2,10537,5375,5162
50,6,89,California,Shasta County,1,3,11394,5967,5427
50,6,89,California,Shasta County,1,4,12439,6403,6036
50,6,89,California,Shasta County,1,5,11003,5667,5336
50,6,89,California,Shasta County,1,6,10526,5303,5223
50,6,89,California,Shasta County,1,7,9431,4788,4643
50,6,89,California,Shasta County,1,8,9198,4528,4670
50,6,89,California,Shasta County,1,9,10369,5106,5263
50,6,89,California,Shasta County,1,10,12895,6175,6720
50,6,89,California,Shasta County,1,11,13690,6627,7063
50,6,89,California,Shasta County,1,12,13367,6434,6933
50,6,89,California,Shasta County,1,13,12139,5929,6210
50,6,89,California,Shasta County,1,14,9576,4619,4957
50,6,89,California,Shasta County,1,15,6975,3332,3643
50,6,89,California,Shasta County,1,16,5333,2433,2900
50,6,89,California,Shasta County,1,17,4113,1719,2394
50,6,89,California,Shasta County,1,18,3970,1418,2552
50,6,89,California,Shasta County,2,0,177221,87129,90092
50,6,89,California,Shasta County,2,1,10268,5307,4961
50,6,89,California,Shasta County,2,2,10537,5375,5162
50,6,89,California,Shasta County,2,3,11394,5967,5427
50,6,89,California,Shasta County,2,4,12439,6403,6036
50,6,89,California,Shasta County,2,5,11003,5667,5336
50,6,89,California,Shasta County,2,6,10526,5303,5223
50,6,89,California,Shasta County,2,7,9431,4788,4643
50,6,89,California,Shasta County,2,8,9198,4528,4670
50,6,89,California,Shasta County,2,9,10369,5106,5263
50,6,89,California,Shasta County,2,10,12895,6175,6720
50,6,89,California,Shasta County,2,11,13690,6627,7063
50,6,89,California,Shasta County,2,12,13367,6434,6933
50,6,89,California,Shasta County,2,13,12138,5929,6209
50,6,89,California,Shasta County,2,14,9575,4618,4957
50,6,89,California,Shasta County,2,15,6975,3332,3643
50,6,89,California,Shasta County,2,16,5333,2433,2900
50,6,89,California,Shasta County,2,17,4113,1719,2394
50,6,89,California,Shasta County,2,18,3970,1418,2552
50,6,89,California,Shasta County,3,0,177274,87137,90137
50,6,89,California,Shasta County,3,1,10279,5297,4982
50,6,89,California,Shasta County,3,2,10519,5362,5157
50,6,89,California,Shasta County,3,3,11326,5932,5394
50,6,89,California,Shasta County,3,4,12261,6328,5933
50,6,89,California,Shasta County,3,5,11131,5721,5410
50,6,89,California,Shasta County,3,6,10565,5333,5232
50,6,89,California,Shasta County,3,7,9527,4831,4696
50,6,89,California,Shasta County,3,8,9117,4498,4619
50,6,89,California,Shasta County,3,9,10363,5091,5272
50,6,89,California,Shasta County,3,10,12780,6122,6658
50,6,89,California,Shasta County,3,11,13659,6610,7049
50,6,89,California,Shasta County,3,12,13410,6448,6962
50,6,89,California,Shasta County,3,13,12258,5980,6278
50,6,89,California,Shasta County,3,14,9603,4641,4962
50,6,89,California,Shasta County,3,15,7058,3379,3679
50,6,89,California,Shasta County,3,16,5320,2427,2893
50,6,89,California,Shasta County,3,17,4109,1721,2388
50,6,89,California,Shasta County,3,18,3989,1416,2573
50,6,89,California,Shasta County,4,0,177588,87208,90380
50,6,89,California,Shasta County,4,1,10296,5253,5043
50,6,89,California,Shasta County,4,2,10533,5363,5170
50,6,89,California,Shasta County,4,3,11155,5832,5323
50,6,89,California,Shasta County,4,4,11645,6048,5597
50,6,89,California,Shasta County,4,5,11606,5915,5691
50,6,89,California,Shasta County,4,6,10667,5448,5219
50,6,89,California,Shasta County,4,7,9866,4959,4907
50,6,89,California,Shasta County,4,8,8841,4411,4430
50,6,89,California,Shasta County,4,9,10307,5049,5258
50,6,89,California,Shasta County,4,10,12132,5806,6326
50,6,89,California,Shasta County,4,11,13554,6513,7041
50,6,89,California,Shasta County,4,12,13556,6523,7033
50,6,89,California,Shasta County,4,13,12821,6219,6602
50,6,89,California,Shasta County,4,14,9760,4737,5023
50,6,89,California,Shasta County,4,15,7324,3514,3810
50,6,89,California,Shasta County,4,16,5372,2464,2908
50,6,89,California,Shasta County,4,17,4096,1735,2361
50,6,89,California,Shasta County,4,18,4057,1419,2638
50,6,89,California,Shasta County,5,0,177875,87293,90582
50,6,89,California,Shasta County,5,1,10369,5297,5072
50,6,89,California,Shasta County,5,2,10458,5278,5180
50,6,89,California,Shasta County,5,3,11082,5829,5253
50,6,89,California,Shasta County,5,4,11282,5877,5405
50,6,89,California,Shasta County,5,5,11636,5925,5711
50,6,89,California,Shasta County,5,6,10834,5485,5349
50,6,89,California,Shasta County,5,7,10190,5108,5082
50,6,89,California,Shasta County,5,8,8829,4416,4413
50,6,89,California,Shasta County,5,9,10058,4930,5128
50,6,89,California,Shasta County,5,10,11458,5463,5995
50,6,89,California,Shasta County,5,11,13527,6549,6978
50,6,89,California,Shasta County,5,12,13625,6538,7087
50,6,89,California,Shasta County,5,13,12620,6071,6549
50,6,89,California,Shasta County,5,14,10472,5053,5419
50,6,89,California,Shasta County,5,15,7639,3681,3958
50,6,89,California,Shasta County,5,16,5517,2547,2970
50,6,89,California,Shasta County,5,17,4139,1765,2374
50,6,89,California,Shasta County,5,18,4140,1481,2659
50,6,89,California,Shasta County,6,0,178397,87529,90868
50,6,89,California,Shasta County,6,1,10405,5332,5073
50,6,89,California,Shasta County,6,2,10588,5361,5227
50,6,89,California,Shasta County,6,3,11074,5749,5325
50,6,89,California,Shasta County,6,4,11010,5754,5256
50,6,89,California,Shasta County,6,5,11473,5901,5572
50,6,89,California,Shasta County,6,6,11026,5609,5417
50,6,89,California,Shasta County,6,7,10596,5278,5318
50,6,89,California,Shasta County,6,8,9013,4474,4539
50,6,89,California,Shasta County,6,9,9800,4843,4957
50,6,89,California,Shasta County,6,10,10935,5259,5676
50,6,89,California,Shasta County,6,11,13294,6408,6886
50,6,89,California,Shasta County,6,12,13542,6457,7085
50,6,89,California,Shasta County,6,13,12715,6084,6631
50,6,89,California,Shasta County,6,14,10855,5224,5631
50,6,89,California,Shasta County,6,15,8152,3914,4238
50,6,89,California,Shasta County,6,16,5637,2589,3048
50,6,89,California,Shasta County,6,17,4181,1815,2366
50,6,89,California,Shasta County,6,18,4101,1478,2623
50,6,89,California,Shasta County,7,0,178844,87797,91047
50,6,89,California,Shasta County,7,1,10537,5354,5183
50,6,89,California,Shasta County,7,2,10568,5378,5190
50,6,89,California,Shasta County,7,3,10932,5636,5296
50,6,89,California,Shasta County,7,4,10883,5711,5172
50,6,89,California,Shasta County,7,5,11200,5774,5426
50,6,89,California,Shasta County,7,6,11293,5734,5559
50,6,89,California,Shasta County,7,7,10830,5384,5446
50,6,89,California,Shasta County,7,8,9271,4646,4625
50,6,89,California,Shasta County,7,9,9626,4701,4925
50,6,89,California,Shasta County,7,10,10485,5148,5337
50,6,89,California,Shasta County,7,11,13107,6322,6785
50,6,89,California,Shasta County,7,12,13366,6369,6997
50,6,89,California,Shasta County,7,13,12959,6190,6769
50,6,89,California,Shasta County,7,14,11185,5369,5816
50,6,89,California,Shasta County,7,15,8435,4014,4421
50,6,89,California,Shasta County,7,16,5859,2695,3164
50,6,89,California,Shasta County,7,17,4149,1840,2309
50,6,89,California,Shasta County,7,18,4159,1532,2627
50,6,89,California,Shasta County,8,0,178314,87580,90734
50,6,89,California,Shasta County,8,1,10557,5426,5131
50,6,89,California,Shasta County,8,2,10481,5330,5151
50,6,89,California,Shasta County,8,3,10722,5468,5254
50,6,89,California,Shasta County,8,4,10719,5647,5072
50,6,89,California,Shasta County,8,5,10696,5466,5230
50,6,89,California,Shasta County,8,6,11530,5905,5625
50,6,89,California,Shasta County,8,7,10909,5420,5489
50,6,89,California,Shasta County,8,8,9596,4843,4753
50,6,89,California,Shasta County,8,9,9158,4503,4655
50,6,89,California,Shasta County,8,10,10296,5037,5259
50,6,89,California,Shasta County,8,11,12515,6000,6515
50,6,89,California,Shasta County,8,12,13421,6433,6988
50,6,89,California,Shasta County,8,13,13054,6182,6872
50,6,89,California,Shasta County,8,14,11598,5571,6027
50,6,89,California,Shasta County,8,15,8712,4151,4561
50,6,89,California,Shasta County,8,16,6041,2817,3224
50,6,89,California,Shasta County,8,17,4003,1753,2250
50,6,89,California,Shasta County,8,18,4306,1628,2678
50,6,89,California,Shasta County,9,0,178571,87722,90849
50,6,89,California,Shasta County,9,1,10599,5494,5105
50,6,89,California,Shasta County,9,2,10590,5366,5224
50,6,89,California,Shasta County,9,3,10673,5430,5243
50,6,89,California,Shasta County,9,4,10634,5568,5066
50,6,89,California,Shasta County,9,5,10289,5333,4956
50,6,89,California,Shasta County,9,6,11770,6002,5768
50,6,89,California,Shasta County,9,7,11055,5532,5523
50,6,89,California,Shasta County,9,8,10078,5044,5034
50,6,89,California,Shasta County,9,9,8837,4411,4426
50,6,89,California,Shasta County,9,10,10210,4964,5246
50,6,89,California,Shasta County,9,11,11828,5648,6180
50,6,89,California,Shasta County,9,12,13275,6323,6952
50,6,89,California,Shasta County,9,13,13189,6290,6899
50,6,89,California,Shasta County,9,14,12112,5789,6323
50,6,89,California,Shasta County,9,15,8856,4230,4626
50,6,89,California,Shasta County,9,16,6227,2905,3322
50,6,89,California,Shasta County,9,17,4045,1790,2255
50,6,89,California,Shasta County,9,18,4304,1603,2701
50,6,89,California,Shasta County,10,0,179384,88164,91220
50,6,89,California,Shasta County,10,1,10584,5420,5164
50,6,89,California,Shasta County,10,2,10774,5516,5258
50,6,89,California,Shasta County,10,3,10717,5421,5296
50,6,89,California,Shasta County,10,4,10514,5513,5001
50,6,89,California,Shasta County,10,5,10093,5260,4833
50,6,89,California,Shasta County,10,6,11935,6080,5855
50,6,89,California,Shasta County,10,7,11219,5600,5619
50,6,89,California,Shasta County,10,8,10457,5250,5207
50,6,89,California,Shasta County,10,9,8915,4471,4444
50,6,89,California,Shasta County,10,10,10077,4908,5169
50,6,89,California,Shasta County,10,11,11268,5322,5946
50,6,89,California,Shasta County,10,12,13354,6450,6904
50,6,89,California,Shasta County,10,13,13183,6269,6914
50,6,89,California,Shasta County,10,14,11980,5691,6289
50,6,89,California,Shasta County,10,15,9460,4492,4968
50,6,89,California,Shasta County,10,16,6445,3042,3403
50,6,89,California,Shasta County,10,17,4179,1843,2336
50,6,89,California,Shasta County,10,18,4230,1616,2614
50,6,89,California,Shasta County,11,0,179709,88342,91367
50,6,89,California,Shasta County,11,1,10628,5483,5145
50,6,89,California,Shasta County,11,2,10636,5455,5181
50,6,89,California,Shasta County,11,3,10780,5438,5342
50,6,89,California,Shasta County,11,4,10466,5471,4995
50,6,89,California,Shasta County,11,5,9902,5165,4737
50,6,89,California,Shasta County,11,6,11831,6022,5809
50,6,89,California,Shasta County,11,7,11379,5731,5648
50,6,89,California,Shasta County,11,8,10920,5434,5486
50,6,89,California,Shasta County,11,9,9141,4612,4529
50,6,89,California,Shasta County,11,10,9816,4804,5012
50,6,89,California,Shasta County,11,11,10779,5116,5663
50,6,89,California,Shasta County,11,12,13111,6326,6785
50,6,89,California,Shasta County,11,13,13188,6202,6986
50,6,89,California,Shasta County,11,14,12037,5715,6322
50,6,89,California,Shasta County,11,15,9840,4669,5171
50,6,89,California,Shasta County,11,16,6832,3219,3613
50,6,89,California,Shasta County,11,17,4279,1879,2400
50,6,89,California,Shasta County,11,18,4144,1601,2543
50,6,89,California,Shasta County,12,0,180080,88473,91607
50,6,89,California,Shasta County,12,1,10480,5473,5007
50,6,89,California,Shasta County,12,2,10998,5602,5396
50,6,89,California,Shasta County,12,3,10777,5471,5306
50,6,89,California,Shasta County,12,4,10372,5370,5002
50,6,89,California,Shasta County,12,5,9761,5078,4683
50,6,89,California,Shasta County,12,6,11604,5921,5683
50,6,89,California,Shasta County,12,7,11540,5802,5738
50,6,89,California,Shasta County,12,8,11210,5561,5649
50,6,89,California,Shasta County,12,9,9455,4789,4666
50,6,89,California,Shasta County,12,10,9631,4720,4911
50,6,89,California,Shasta County,12,11,10352,4941,5411
50,6,89,California,Shasta County,12,12,12933,6224,6709
50,6,89,California,Shasta County,12,13,12898,6057,6841
50,6,89,California,Shasta County,12,14,12316,5832,6484
50,6,89,California,Shasta County,12,15,10218,4826,5392
50,6,89,California,Shasta County,12,16,7037,3289,3748
50,6,89,California,Shasta County,12,17,4454,1956,2498
50,6,89,California,Shasta County,12,18,4044,1561,2483
50,6,91,California,Sierra County,1,0,3240,1646,1594
50,6,91,California,Sierra County,1,1,147,69,78
50,6,91,California,Sierra County,1,2,131,69,62
50,6,91,California,Sierra County,1,3,156,92,64
50,6,91,California,Sierra County,1,4,170,91,79
50,6,91,California,Sierra County,1,5,118,64,54
50,6,91,California,Sierra County,1,6,126,66,60
50,6,91,California,Sierra County,1,7,117,58,59
50,6,91,California,Sierra County,1,8,151,75,76
50,6,91,California,Sierra County,1,9,184,91,93
50,6,91,California,Sierra County,1,10,259,128,131
50,6,91,California,Sierra County,1,11,312,155,157
50,6,91,California,Sierra County,1,12,347,171,176
50,6,91,California,Sierra County,1,13,346,177,169
50,6,91,California,Sierra County,1,14,230,126,104
50,6,91,California,Sierra County,1,15,166,76,90
50,6,91,California,Sierra County,1,16,139,70,69
50,6,91,California,Sierra County,1,17,68,33,35
50,6,91,California,Sierra County,1,18,73,35,38
50,6,91,California,Sierra County,2,0,3239,1645,1594
50,6,91,California,Sierra County,2,1,147,69,78
50,6,91,California,Sierra County,2,2,131,69,62
50,6,91,California,Sierra County,2,3,156,92,64
50,6,91,California,Sierra County,2,4,170,91,79
50,6,91,California,Sierra County,2,5,118,64,54
50,6,91,California,Sierra County,2,6,126,66,60
50,6,91,California,Sierra County,2,7,117,58,59
50,6,91,California,Sierra County,2,8,151,75,76
50,6,91,California,Sierra County,2,9,184,91,93
50,6,91,California,Sierra County,2,10,259,128,131
50,6,91,California,Sierra County,2,11,312,155,157
50,6,91,California,Sierra County,2,12,347,171,176
50,6,91,California,Sierra County,2,13,345,176,169
50,6,91,California,Sierra County,2,14,230,126,104
50,6,91,California,Sierra County,2,15,166,76,90
50,6,91,California,Sierra County,2,16,139,70,69
50,6,91,California,Sierra County,2,17,68,33,35
50,6,91,California,Sierra County,2,18,73,35,38
50,6,91,California,Sierra County,3,0,3220,1633,1587
50,6,91,California,Sierra County,3,1,146,69,77
50,6,91,California,Sierra County,3,2,129,67,62
50,6,91,California,Sierra County,3,3,156,92,64
50,6,91,California,Sierra County,3,4,170,91,79
50,6,91,California,Sierra County,3,5,124,67,57
50,6,91,California,Sierra County,3,6,124,64,60
50,6,91,California,Sierra County,3,7,117,58,59
50,6,91,California,Sierra County,3,8,150,74,76
50,6,91,California,Sierra County,3,9,182,90,92
50,6,91,California,Sierra County,3,10,256,126,130
50,6,91,California,Sierra County,3,11,305,153,152
50,6,91,California,Sierra County,3,12,343,166,177
50,6,91,California,Sierra County,3,13,342,177,165
50,6,91,California,Sierra County,3,14,231,124,107
50,6,91,California,Sierra County,3,15,167,78,89
50,6,91,California,Sierra County,3,16,136,71,65
50,6,91,California,Sierra County,3,17,70,33,37
50,6,91,California,Sierra County,3,18,72,33,39
50,6,91,California,Sierra County,4,0,3098,1562,1536
50,6,91,California,Sierra County,4,1,127,59,68
50,6,91,California,Sierra County,4,2,127,65,62
50,6,91,California,Sierra County,4,3,142,75,67
50,6,91,California,Sierra County,4,4,177,97,80
50,6,91,California,Sierra County,4,5,106,63,43
50,6,91,California,Sierra County,4,6,115,59,56
50,6,91,California,Sierra County,4,7,127,59,68
50,6,91,California,Sierra County,4,8,134,63,71
50,6,91,California,Sierra County,4,9,170,87,83
50,6,91,California,Sierra County,4,10,223,106,117
50,6,91,California,Sierra County,4,11,298,151,147
50,6,91,California,Sierra County,4,12,316,148,168
50,6,91,California,Sierra County,4,13,352,187,165
50,6,91,California,Sierra County,4,14,235,121,114
50,6,91,California,Sierra County,4,15,178,91,87
50,6,91,California,Sierra County,4,16,127,63,64
50,6,91,California,Sierra County,4,17,83,39,44
50,6,91,California,Sierra County,4,18,61,29,32
50,6,91,California,Sierra County,5,0,3067,1543,1524
50,6,91,California,Sierra County,5,1,134,57,77
50,6,91,California,Sierra County,5,2,123,60,63
50,6,91,California,Sierra County,5,3,142,77,65
50,6,91,California,Sierra County,5,4,165,92,73
50,6,91,California,Sierra County,5,5,106,65,41
50,6,91,California,Sierra County,5,6,107,53,54
50,6,91,California,Sierra County,5,7,133,60,73
50,6,91,California,Sierra County,5,8,128,55,73
50,6,91,California,Sierra County,5,9,163,85,78
50,6,91,California,Sierra County,5,10,201,98,103
50,6,91,California,Sierra County,5,11,291,147,144
50,6,91,California,Sierra County,5,12,299,141,158
50,6,91,California,Sierra County,5,13,350,184,166
50,6,91,California,Sierra County,5,14,263,139,124
50,6,91,California,Sierra County,5,15,181,95,86
50,6,91,California,Sierra County,5,16,126,60,66
50,6,91,California,Sierra County,5,17,93,47,46
50,6,91,California,Sierra County,5,18,62,28,34
50,6,91,California,Sierra County,6,0,3028,1517,1511
50,6,91,California,Sierra County,6,1,121,59,62
50,6,91,California,Sierra County,6,2,130,57,73
50,6,91,California,Sierra County,6,3,146,76,70
50,6,91,California,Sierra County,6,4,155,88,67
50,6,91,California,Sierra County,6,5,106,68,38
50,6,91,California,Sierra County,6,6,105,49,56
50,6,91,California,Sierra County,6,7,134,67,67
50,6,91,California,Sierra County,6,8,125,56,69
50,6,91,California,Sierra County,6,9,154,73,81
50,6,91,California,Sierra County,6,10,176,87,89
50,6,91,California,Sierra County,6,11,273,142,131
50,6,91,California,Sierra County,6,12,287,127,160
50,6,91,California,Sierra County,6,13,355,181,174
50,6,91,California,Sierra County,6,14,279,148,131
50,6,91,California,Sierra County,6,15,194,99,95
50,6,91,California,Sierra County,6,16,124,58,66
50,6,91,California,Sierra County,6,17,99,51,48
50,6,91,California,Sierra County,6,18,65,31,34
50,6,91,California,Sierra County,7,0,2972,1492,1480
50,6,91,California,Sierra County,7,1,108,51,57
50,6,91,California,Sierra County,7,2,143,70,73
50,6,91,California,Sierra County,7,3,135,72,63
50,6,91,California,Sierra County,7,4,146,83,63
50,6,91,California,Sierra County,7,5,121,73,48
50,6,91,California,Sierra County,7,6,85,46,39
50,6,91,California,Sierra County,7,7,129,60,69
50,6,91,California,Sierra County,7,8,128,66,62
50,6,91,California,Sierra County,7,9,139,61,78
50,6,91,California,Sierra County,7,10,165,78,87
50,6,91,California,Sierra County,7,11,256,127,129
50,6,91,California,Sierra County,7,12,280,128,152
50,6,91,California,Sierra County,7,13,334,171,163
50,6,91,California,Sierra County,7,14,307,164,143
50,6,91,California,Sierra County,7,15,196,98,98
50,6,91,California,Sierra County,7,16,126,63,63
50,6,91,California,Sierra County,7,17,106,49,57
50,6,91,California,Sierra County,7,18,68,32,36
50,6,91,California,Sierra County,8,0,2985,1512,1473
50,6,91,California,Sierra County,8,1,109,51,58
50,6,91,California,Sierra County,8,2,148,71,77
50,6,91,California,Sierra County,8,3,143,80,63
50,6,91,California,Sierra County,8,4,135,77,58
50,6,91,California,Sierra County,8,5,131,76,55
50,6,91,California,Sierra County,8,6,100,62,38
50,6,91,California,Sierra County,8,7,114,51,63
50,6,91,California,Sierra County,8,8,135,71,64
50,6,91,California,Sierra County,8,9,143,66,77
50,6,91,California,Sierra County,8,10,163,76,87
50,6,91,California,Sierra County,8,11,229,110,119
50,6,91,California,Sierra County,8,12,296,146,150
50,6,91,California,Sierra County,8,13,302,159,143
50,6,91,California,Sierra County,8,14,329,173,156
50,6,91,California,Sierra County,8,15,200,99,101
50,6,91,California,Sierra County,8,16,129,61,68
50,6,91,California,Sierra County,8,17,106,51,55
50,6,91,California,Sierra County,8,18,73,32,41
50,6,91,California,Sierra County,9,0,2951,1487,1464
50,6,91,California,Sierra County,9,1,120,60,60
50,6,91,California,Sierra County,9,2,133,64,69
50,6,91,California,Sierra County,9,3,134,72,62
50,6,91,California,Sierra County,9,4,123,70,53
50,6,91,California,Sierra County,9,5,130,75,55
50,6,91,California,Sierra County,9,6,105,62,43
50,6,91,California,Sierra County,9,7,100,47,53
50,6,91,California,Sierra County,9,8,139,72,67
50,6,91,California,Sierra County,9,9,142,66,76
50,6,91,California,Sierra County,9,10,152,75,77
50,6,91,California,Sierra County,9,11,214,98,116
50,6,91,California,Sierra County,9,12,304,155,149
50,6,91,California,Sierra County,9,13,288,145,143
50,6,91,California,Sierra County,9,14,340,180,160
50,6,91,California,Sierra County,9,15,204,96,108
50,6,91,California,Sierra County,9,16,146,77,69
50,6,91,California,Sierra County,9,17,98,41,57
50,6,91,California,Sierra County,9,18,79,32,47
50,6,91,California,Sierra County,10,0,3002,1511,1491
50,6,91,California,Sierra County,10,1,144,71,73
50,6,91,California,Sierra County,10,2,125,64,61
50,6,91,California,Sierra County,10,3,136,67,69
50,6,91,California,Sierra County,10,4,120,68,52
50,6,91,California,Sierra County,10,5,140,77,63
50,6,91,California,Sierra County,10,6,102,63,39
50,6,91,California,Sierra County,10,7,118,57,61
50,6,91,California,Sierra County,10,8,124,64,60
50,6,91,California,Sierra County,10,9,154,71,83
50,6,91,California,Sierra County,10,10,160,79,81
50,6,91,California,Sierra County,10,11,194,93,101
50,6,91,California,Sierra County,10,12,304,156,148
50,6,91,California,Sierra County,10,13,278,143,135
50,6,91,California,Sierra County,10,14,334,173,161
50,6,91,California,Sierra County,10,15,232,112,120
50,6,91,California,Sierra County,10,16,151,82,69
50,6,91,California,Sierra County,10,17,96,35,61
50,6,91,California,Sierra County,10,18,90,36,54
50,6,91,California,Sierra County,11,0,2997,1508,1489
50,6,91,California,Sierra County,11,1,139,64,75
50,6,91,California,Sierra County,11,2,133,73,60
50,6,91,California,Sierra County,11,3,129,60,69
50,6,91,California,Sierra County,11,4,117,69,48
50,6,91,California,Sierra County,11,5,110,67,43
50,6,91,California,Sierra County,11,6,129,79,50
50,6,91,California,Sierra County,11,7,118,52,66
50,6,91,California,Sierra County,11,8,142,75,67
50,6,91,California,Sierra County,11,9,144,70,74
50,6,91,California,Sierra County,11,10,153,70,83
50,6,91,California,Sierra County,11,11,167,82,85
50,6,91,California,Sierra County,11,12,278,148,130
50,6,91,California,Sierra County,11,13,278,131,147
50,6,91,California,Sierra County,11,14,349,180,169
50,6,91,California,Sierra County,11,15,249,120,129
50,6,91,California,Sierra County,11,16,177,95,82
50,6,91,California,Sierra County,11,17,96,37,59
50,6,91,California,Sierra County,11,18,89,36,53
50,6,91,California,Sierra County,12,0,3005,1509,1496
50,6,91,California,Sierra County,12,1,138,66,72
50,6,91,California,Sierra County,12,2,123,67,56
50,6,91,California,Sierra County,12,3,151,73,78
50,6,91,California,Sierra County,12,4,123,76,47
50,6,91,California,Sierra County,12,5,97,55,42
50,6,91,California,Sierra County,12,6,123,75,48
50,6,91,California,Sierra County,12,7,111,53,58
50,6,91,California,Sierra County,12,8,149,68,81
50,6,91,California,Sierra County,12,9,167,85,82
50,6,91,California,Sierra County,12,10,145,67,78
50,6,91,California,Sierra County,12,11,169,82,87
50,6,91,California,Sierra County,12,12,261,139,122
50,6,91,California,Sierra County,12,13,285,138,147
50,6,91,California,Sierra County,12,14,312,157,155
50,6,91,California,Sierra County,12,15,271,133,138
50,6,91,California,Sierra County,12,16,186,93,93
50,6,91,California,Sierra County,12,17,101,44,57
50,6,91,California,Sierra County,12,18,93,38,55
50,6,93,California,Siskiyou County,1,0,44900,22395,22505
50,6,93,California,Siskiyou County,1,1,2473,1291,1182
50,6,93,California,Siskiyou County,1,2,2410,1204,1206
50,6,93,California,Siskiyou County,1,3,2726,1408,1318
50,6,93,California,Siskiyou County,1,4,2757,1496,1261
50,6,93,California,Siskiyou County,1,5,2178,1151,1027
50,6,93,California,Siskiyou County,1,6,2274,1173,1101
50,6,93,California,Siskiyou County,1,7,2003,1028,975
50,6,93,California,Siskiyou County,1,8,2139,1093,1046
50,6,93,California,Siskiyou County,1,9,2397,1192,1205
50,6,93,California,Siskiyou County,1,10,3088,1501,1587
50,6,93,California,Siskiyou County,1,11,3822,1793,2029
50,6,93,California,Siskiyou County,1,12,4029,1948,2081
50,6,93,California,Siskiyou County,1,13,3822,1942,1880
50,6,93,California,Siskiyou County,1,14,2930,1505,1425
50,6,93,California,Siskiyou County,1,15,2011,996,1015
50,6,93,California,Siskiyou County,1,16,1510,719,791
50,6,93,California,Siskiyou County,1,17,1179,515,664
50,6,93,California,Siskiyou County,1,18,1152,440,712
50,6,93,California,Siskiyou County,2,0,44900,22395,22505
50,6,93,California,Siskiyou County,2,1,2473,1291,1182
50,6,93,California,Siskiyou County,2,2,2410,1204,1206
50,6,93,California,Siskiyou County,2,3,2726,1408,1318
50,6,93,California,Siskiyou County,2,4,2757,1496,1261
50,6,93,California,Siskiyou County,2,5,2178,1151,1027
50,6,93,California,Siskiyou County,2,6,2274,1173,1101
50,6,93,California,Siskiyou County,2,7,2003,1028,975
50,6,93,California,Siskiyou County,2,8,2139,1093,1046
50,6,93,California,Siskiyou County,2,9,2397,1192,1205
50,6,93,California,Siskiyou County,2,10,3088,1501,1587
50,6,93,California,Siskiyou County,2,11,3822,1793,2029
50,6,93,California,Siskiyou County,2,12,4029,1948,2081
50,6,93,California,Siskiyou County,2,13,3822,1942,1880
50,6,93,California,Siskiyou County,2,14,2930,1505,1425
50,6,93,California,Siskiyou County,2,15,2011,996,1015
50,6,93,California,Siskiyou County,2,16,1510,719,791
50,6,93,California,Siskiyou County,2,17,1179,515,664
50,6,93,California,Siskiyou County,2,18,1152,440,712
50,6,93,California,Siskiyou County,3,0,44938,22442,22496
50,6,93,California,Siskiyou County,3,1,2460,1284,1176
50,6,93,California,Siskiyou County,3,2,2417,1216,1201
50,6,93,California,Siskiyou County,3,3,2715,1398,1317
50,6,93,California,Siskiyou County,3,4,2749,1505,1244
50,6,93,California,Siskiyou County,3,5,2214,1170,1044
50,6,93,California,Siskiyou County,3,6,2300,1192,1108
50,6,93,California,Siskiyou County,3,7,2025,1042,983
50,6,93,California,Siskiyou County,3,8,2123,1086,1037
50,6,93,California,Siskiyou County,3,9,2398,1193,1205
50,6,93,California,Siskiyou County,3,10,3044,1487,1557
50,6,93,California,Siskiyou County,3,11,3792,1771,2021
50,6,93,California,Siskiyou County,3,12,4031,1947,2084
50,6,93,California,Siskiyou County,3,13,3861,1957,1904
50,6,93,California,Siskiyou County,3,14,2948,1511,1437
50,6,93,California,Siskiyou County,3,15,2018,1007,1011
50,6,93,California,Siskiyou County,3,16,1508,718,790
50,6,93,California,Siskiyou County,3,17,1180,515,665
50,6,93,California,Siskiyou County,3,18,1155,443,712
50,6,93,California,Siskiyou County,4,0,44615,22213,22402
50,6,93,California,Siskiyou County,4,1,2385,1223,1162
50,6,93,California,Siskiyou County,4,2,2426,1217,1209
50,6,93,California,Siskiyou County,4,3,2645,1321,1324
50,6,93,California,Siskiyou County,4,4,2688,1488,1200
50,6,93,California,Siskiyou County,4,5,2266,1185,1081
50,6,93,California,Siskiyou County,4,6,2249,1159,1090
50,6,93,California,Siskiyou County,4,7,2096,1092,1004
50,6,93,California,Siskiyou County,4,8,2032,1051,981
50,6,93,California,Siskiyou County,4,9,2396,1196,1200
50,6,93,California,Siskiyou County,4,10,2794,1380,1414
50,6,93,California,Siskiyou County,4,11,3631,1687,1944
50,6,93,California,Siskiyou County,4,12,4063,1965,2098
50,6,93,California,Siskiyou County,4,13,4038,2002,2036
50,6,93,California,Siskiyou County,4,14,3001,1533,1468
50,6,93,California,Siskiyou County,4,15,2066,1042,1024
50,6,93,California,Siskiyou County,4,16,1529,735,794
50,6,93,California,Siskiyou County,4,17,1167,511,656
50,6,93,California,Siskiyou County,4,18,1143,426,717
50,6,93,California,Siskiyou County,5,0,44079,21901,22178
50,6,93,California,Siskiyou County,5,1,2369,1197,1172
50,6,93,California,Siskiyou County,5,2,2466,1263,1203
50,6,93,California,Siskiyou County,5,3,2552,1235,1317
50,6,93,California,Siskiyou County,5,4,2617,1441,1176
50,6,93,California,Siskiyou County,5,5,2208,1157,1051
50,6,93,California,Siskiyou County,5,6,2192,1130,1062
50,6,93,California,Siskiyou County,5,7,2169,1121,1048
50,6,93,California,Siskiyou County,5,8,1957,1014,943
50,6,93,California,Siskiyou County,5,9,2358,1223,1135
50,6,93,California,Siskiyou County,5,10,2589,1251,1338
50,6,93,California,Siskiyou County,5,11,3371,1579,1792
50,6,93,California,Siskiyou County,5,12,4034,1922,2112
50,6,93,California,Siskiyou County,5,13,3945,1933,2012
50,6,93,California,Siskiyou County,5,14,3246,1656,1590
50,6,93,California,Siskiyou County,5,15,2156,1098,1058
50,6,93,California,Siskiyou County,5,16,1545,749,796
50,6,93,California,Siskiyou County,5,17,1144,518,626
50,6,93,California,Siskiyou County,5,18,1161,414,747
50,6,93,California,Siskiyou County,6,0,43532,21647,21885
50,6,93,California,Siskiyou County,6,1,2353,1163,1190
50,6,93,California,Siskiyou County,6,2,2449,1262,1187
50,6,93,California,Siskiyou County,6,3,2493,1231,1262
50,6,93,California,Siskiyou County,6,4,2546,1371,1175
50,6,93,California,Siskiyou County,6,5,2172,1163,1009
50,6,93,California,Siskiyou County,6,6,2134,1108,1026
50,6,93,California,Siskiyou County,6,7,2177,1126,1051
50,6,93,California,Siskiyou County,6,8,1939,992,947
50,6,93,California,Siskiyou County,6,9,2295,1185,1110
50,6,93,California,Siskiyou County,6,10,2383,1145,1238
50,6,93,California,Siskiyou County,6,11,3196,1512,1684
50,6,93,California,Siskiyou County,6,12,3914,1878,2036
50,6,93,California,Siskiyou County,6,13,3936,1920,2016
50,6,93,California,Siskiyou County,6,14,3381,1691,1690
50,6,93,California,Siskiyou County,6,15,2312,1201,1111
50,6,93,California,Siskiyou County,6,16,1566,765,801
50,6,93,California,Siskiyou County,6,17,1127,506,621
50,6,93,California,Siskiyou County,6,18,1159,428,731
50,6,93,California,Siskiyou County,7,0,43338,21571,21767
50,6,93,California,Siskiyou County,7,1,2333,1150,1183
50,6,93,California,Siskiyou County,7,2,2453,1269,1184
50,6,93,California,Siskiyou County,7,3,2418,1205,1213
50,6,93,California,Siskiyou County,7,4,2488,1311,1177
50,6,93,California,Siskiyou County,7,5,2174,1169,1005
50,6,93,California,Siskiyou County,7,6,2153,1135,1018
50,6,93,California,Siskiyou County,7,7,2262,1150,1112
50,6,93,California,Siskiyou County,7,8,1982,1024,958
50,6,93,California,Siskiyou County,7,9,2183,1123,1060
50,6,93,California,Siskiyou County,7,10,2294,1106,1188
50,6,93,California,Siskiyou County,7,11,3093,1502,1591
50,6,93,California,Siskiyou County,7,12,3769,1788,1981
50,6,93,California,Siskiyou County,7,13,3934,1879,2055
50,6,93,California,Siskiyou County,7,14,3487,1757,1730
50,6,93,California,Siskiyou County,7,15,2483,1284,1199
50,6,93,California,Siskiyou County,7,16,1569,769,800
50,6,93,California,Siskiyou County,7,17,1100,506,594
50,6,93,California,Siskiyou County,7,18,1163,444,719
50,6,93,California,Siskiyou County,8,0,43254,21549,21705
50,6,93,California,Siskiyou County,8,1,2347,1158,1189
50,6,93,California,Siskiyou County,8,2,2490,1297,1193
50,6,93,California,Siskiyou County,8,3,2364,1197,1167
50,6,93,California,Siskiyou County,8,4,2496,1303,1193
50,6,93,California,Siskiyou County,8,5,2092,1106,986
50,6,93,California,Siskiyou County,8,6,2130,1126,1004
50,6,93,California,Siskiyou County,8,7,2302,1169,1133
50,6,93,California,Siskiyou County,8,8,2084,1074,1010
50,6,93,California,Siskiyou County,8,9,2101,1087,1014
50,6,93,California,Siskiyou County,8,10,2335,1127,1208
50,6,93,California,Siskiyou County,8,11,2882,1406,1476
50,6,93,California,Siskiyou County,8,12,3664,1694,1970
50,6,93,California,Siskiyou County,8,13,3897,1864,2033
50,6,93,California,Siskiyou County,8,14,3618,1863,1755
50,6,93,California,Siskiyou County,8,15,2591,1303,1288
50,6,93,California,Siskiyou County,8,16,1613,811,802
50,6,93,California,Siskiyou County,8,17,1086,497,589
50,6,93,California,Siskiyou County,8,18,1162,467,695
50,6,93,California,Siskiyou County,9,0,43376,21600,21776
50,6,93,California,Siskiyou County,9,1,2378,1221,1157
50,6,93,California,Siskiyou County,9,2,2530,1305,1225
50,6,93,California,Siskiyou County,9,3,2395,1223,1172
50,6,93,California,Siskiyou County,9,4,2473,1280,1193
50,6,93,California,Siskiyou County,9,5,2089,1140,949
50,6,93,California,Siskiyou County,9,6,2185,1136,1049
50,6,93,California,Siskiyou County,9,7,2295,1168,1127
50,6,93,California,Siskiyou County,9,8,2168,1110,1058
50,6,93,California,Siskiyou County,9,9,2020,1045,975
50,6,93,California,Siskiyou County,9,10,2376,1161,1215
50,6,93,California,Siskiyou County,9,11,2629,1286,1343
50,6,93,California,Siskiyou County,9,12,3567,1631,1936
50,6,93,California,Siskiyou County,9,13,3900,1852,2048
50,6,93,California,Siskiyou County,9,14,3783,1893,1890
50,6,93,California,Siskiyou County,9,15,2669,1337,1332
50,6,93,California,Siskiyou County,9,16,1670,855,815
50,6,93,California,Siskiyou County,9,17,1108,512,596
50,6,93,California,Siskiyou County,9,18,1141,445,696
50,6,93,California,Siskiyou County,10,0,43622,21700,21922
50,6,93,California,Siskiyou County,10,1,2344,1204,1140
50,6,93,California,Siskiyou County,10,2,2580,1315,1265
50,6,93,California,Siskiyou County,10,3,2498,1293,1205
50,6,93,California,Siskiyou County,10,4,2410,1233,1177
50,6,93,California,Siskiyou County,10,5,2108,1149,959
50,6,93,California,Siskiyou County,10,6,2261,1182,1079
50,6,93,California,Siskiyou County,10,7,2299,1163,1136
50,6,93,California,Siskiyou County,10,8,2277,1153,1124
50,6,93,California,Siskiyou County,10,9,2032,1054,978
50,6,93,California,Siskiyou County,10,10,2367,1193,1174
50,6,93,California,Siskiyou County,10,11,2499,1181,1318
50,6,93,California,Siskiyou County,10,12,3342,1562,1780
50,6,93,California,Siskiyou County,10,13,3930,1827,2103
50,6,93,California,Siskiyou County,10,14,3759,1864,1895
50,6,93,California,Siskiyou County,10,15,2902,1454,1448
50,6,93,California,Siskiyou County,10,16,1777,921,856
50,6,93,California,Siskiyou County,10,17,1134,521,613
50,6,93,California,Siskiyou County,10,18,1103,431,672
50,6,93,California,Siskiyou County,11,0,43550,21656,21894
50,6,93,California,Siskiyou County,11,1,2278,1179,1099
50,6,93,California,Siskiyou County,11,2,2514,1219,1295
50,6,93,California,Siskiyou County,11,3,2602,1375,1227
50,6,93,California,Siskiyou County,11,4,2353,1232,1121
50,6,93,California,Siskiyou County,11,5,2000,1068,932
50,6,93,California,Siskiyou County,11,6,2266,1193,1073
50,6,93,California,Siskiyou County,11,7,2282,1177,1105
50,6,93,California,Siskiyou County,11,8,2387,1188,1199
50,6,93,California,Siskiyou County,11,9,2018,1037,981
50,6,93,California,Siskiyou County,11,10,2326,1185,1141
50,6,93,California,Siskiyou County,11,11,2367,1112,1255
50,6,93,California,Siskiyou County,11,12,3223,1510,1713
50,6,93,California,Siskiyou County,11,13,3892,1833,2059
50,6,93,California,Siskiyou County,11,14,3788,1859,1929
50,6,93,California,Siskiyou County,11,15,3053,1514,1539
50,6,93,California,Siskiyou County,11,16,1946,1023,923
50,6,93,California,Siskiyou County,11,17,1140,528,612
50,6,93,California,Siskiyou County,11,18,1115,424,691
50,6,93,California,Siskiyou County,12,0,43539,21654,21885
50,6,93,California,Siskiyou County,12,1,2178,1125,1053
50,6,93,California,Siskiyou County,12,2,2469,1168,1301
50,6,93,California,Siskiyou County,12,3,2641,1405,1236
50,6,93,California,Siskiyou County,12,4,2359,1253,1106
50,6,93,California,Siskiyou County,12,5,2039,1102,937
50,6,93,California,Siskiyou County,12,6,2206,1172,1034
50,6,93,California,Siskiyou County,12,7,2297,1186,1111
50,6,93,California,Siskiyou County,12,8,2462,1214,1248
50,6,93,California,Siskiyou County,12,9,2032,1038,994
50,6,93,California,Siskiyou County,12,10,2266,1155,1111
50,6,93,California,Siskiyou County,12,11,2283,1070,1213
50,6,93,California,Siskiyou County,12,12,3129,1484,1645
50,6,93,California,Siskiyou County,12,13,3799,1785,2014
50,6,93,California,Siskiyou County,12,14,3829,1834,1995
50,6,93,California,Siskiyou County,12,15,3174,1624,1550
50,6,93,California,Siskiyou County,12,16,2115,1083,1032
50,6,93,California,Siskiyou County,12,17,1140,526,614
50,6,93,California,Siskiyou County,12,18,1121,430,691
50,6,95,California,Solano County,1,0,413344,206195,207149
50,6,95,California,Solano County,1,1,26852,13819,13033
50,6,95,California,Solano County,1,2,27311,13951,13360
50,6,95,California,Solano County,1,3,28575,14652,13923
50,6,95,California,Solano County,1,4,30484,15711,14773
50,6,95,California,Solano County,1,5,28761,15140,13621
50,6,95,California,Solano County,1,6,28596,14825,13771
50,6,95,California,Solano County,1,7,26318,13399,12919
50,6,95,California,Solano County,1,8,26355,13182,13173
50,6,95,California,Solano County,1,9,28068,14220,13848
50,6,95,California,Solano County,1,10,31946,16021,15925
50,6,95,California,Solano County,1,11,32004,15814,16190
50,6,95,California,Solano County,1,12,28009,13630,14379
50,6,95,California,Solano County,1,13,23218,11373,11845
50,6,95,California,Solano County,1,14,15031,7119,7912
50,6,95,California,Solano County,1,15,10966,4989,5977
50,6,95,California,Solano County,1,16,8584,3804,4780
50,6,95,California,Solano County,1,17,6254,2431,3823
50,6,95,California,Solano County,1,18,6012,2115,3897
50,6,95,California,Solano County,2,0,413343,206195,207148
50,6,95,California,Solano County,2,1,26852,13819,13033
50,6,95,California,Solano County,2,2,27311,13951,13360
50,6,95,California,Solano County,2,3,28575,14652,13923
50,6,95,California,Solano County,2,4,30484,15711,14773
50,6,95,California,Solano County,2,5,28761,15140,13621
50,6,95,California,Solano County,2,6,28596,14825,13771
50,6,95,California,Solano County,2,7,26318,13399,12919
50,6,95,California,Solano County,2,8,26355,13182,13173
50,6,95,California,Solano County,2,9,28068,14220,13848
50,6,95,California,Solano County,2,10,31946,16021,15925
50,6,95,California,Solano County,2,11,32004,15814,16190
50,6,95,California,Solano County,2,12,28009,13630,14379
50,6,95,California,Solano County,2,13,23218,11373,11845
50,6,95,California,Solano County,2,14,15031,7119,7912
50,6,95,California,Solano County,2,15,10965,4989,5976
50,6,95,California,Solano County,2,16,8584,3804,4780
50,6,95,California,Solano County,2,17,6254,2431,3823
50,6,95,California,Solano County,2,18,6012,2115,3897
50,6,95,California,Solano County,3,0,413967,206418,207549
50,6,95,California,Solano County,3,1,26751,13770,12981
50,6,95,California,Solano County,3,2,27201,13877,13324
50,6,95,California,Solano County,3,3,28512,14594,13918
50,6,95,California,Solano County,3,4,30263,15630,14633
50,6,95,California,Solano County,3,5,29135,15304,13831
50,6,95,California,Solano County,3,6,28668,14857,13811
50,6,95,California,Solano County,3,7,26473,13486,12987
50,6,95,California,Solano County,3,8,26130,13071,13059
50,6,95,California,Solano County,3,9,28019,14186,13833
50,6,95,California,Solano County,3,10,31812,15948,15864
50,6,95,California,Solano County,3,11,31996,15811,16185
50,6,95,California,Solano County,3,12,28244,13715,14529
50,6,95,California,Solano County,3,13,23488,11494,11994
50,6,95,California,Solano County,3,14,15280,7235,8045
50,6,95,California,Solano County,3,15,11038,5036,6002
50,6,95,California,Solano County,3,16,8603,3813,4790
50,6,95,California,Solano County,3,17,6313,2466,3847
50,6,95,California,Solano County,3,18,6041,2125,3916
50,6,95,California,Solano County,4,0,416342,207649,208693
50,6,95,California,Solano County,4,1,26603,13673,12930
50,6,95,California,Solano County,4,2,27058,13858,13200
50,6,95,California,Solano County,4,3,28241,14391,13850
50,6,95,California,Solano County,4,4,29207,15130,14077
50,6,95,California,Solano County,4,5,30238,16001,14237
50,6,95,California,Solano County,4,6,29062,15020,14042
50,6,95,California,Solano County,4,7,27101,13852,13249
50,6,95,California,Solano County,4,8,25265,12672,12593
50,6,95,California,Solano County,4,9,27824,14074,13750
50,6,95,California,Solano County,4,10,30934,15517,15417
50,6,95,California,Solano County,4,11,31963,15847,16116
50,6,95,California,Solano County,4,12,29020,14039,14981
50,6,95,California,Solano County,4,13,24617,12011,12606
50,6,95,California,Solano County,4,14,16365,7730,8635
50,6,95,California,Solano County,4,15,11395,5247,6148
50,6,95,California,Solano County,4,16,8753,3848,4905
50,6,95,California,Solano County,4,17,6509,2602,3907
50,6,95,California,Solano County,4,18,6187,2137,4050
50,6,95,California,Solano County,5,0,419674,208999,210675
50,6,95,California,Solano County,5,1,26324,13466,12858
50,6,95,California,Solano County,5,2,27035,13944,13091
50,6,95,California,Solano County,5,3,27875,14121,13754
50,6,95,California,Solano County,5,4,28449,14762,13687
50,6,95,California,Solano County,5,5,31172,16411,14761
50,6,95,California,Solano County,5,6,29487,15327,14160
50,6,95,California,Solano County,5,7,27900,14293,13607
50,6,95,California,Solano County,5,8,25185,12700,12485
50,6,95,California,Solano County,5,9,27512,13812,13700
50,6,95,California,Solano County,5,10,30008,15047,14961
50,6,95,California,Solano County,5,11,31915,15787,16128
50,6,95,California,Solano County,5,12,29776,14331,15445
50,6,95,California,Solano County,5,13,24786,12085,12701
50,6,95,California,Solano County,5,14,18387,8652,9735
50,6,95,California,Solano County,5,15,11987,5490,6497
50,6,95,California,Solano County,5,16,8915,3914,5001
50,6,95,California,Solano County,5,17,6560,2661,3899
50,6,95,California,Solano County,5,18,6401,2196,4205
50,6,95,California,Solano County,6,0,423659,210737,212922
50,6,95,California,Solano County,6,1,26234,13365,12869
50,6,95,California,Solano County,6,2,27327,14102,13225
50,6,95,California,Solano County,6,3,27603,13976,13627
50,6,95,California,Solano County,6,4,27932,14522,13410
50,6,95,California,Solano County,6,5,31427,16651,14776
50,6,95,California,Solano County,6,6,30321,15693,14628
50,6,95,California,Solano County,6,7,28601,14674,13927
50,6,95,California,Solano County,6,8,25471,12805,12666
50,6,95,California,Solano County,6,9,26970,13501,13469
50,6,95,California,Solano County,6,10,28956,14522,14434
50,6,95,California,Solano County,6,11,31996,15820,16176
50,6,95,California,Solano County,6,12,30043,14498,15545
50,6,95,California,Solano County,6,13,25539,12332,13207
50,6,95,California,Solano County,6,14,19820,9356,10464
50,6,95,California,Solano County,6,15,12775,5813,6962
50,6,95,California,Solano County,6,16,9191,4040,5151
50,6,95,California,Solano County,6,17,6759,2783,3976
50,6,95,California,Solano County,6,18,6694,2284,4410
50,6,95,California,Solano County,7,0,429006,213206,215800
50,6,95,California,Solano County,7,1,26383,13371,13012
50,6,95,California,Solano County,7,2,27571,14223,13348
50,6,95,California,Solano County,7,3,27509,13997,13512
50,6,95,California,Solano County,7,4,27403,14234,13169
50,6,95,California,Solano County,7,5,31365,16689,14676
50,6,95,California,Solano County,7,6,31212,16141,15071
50,6,95,California,Solano County,7,7,29549,15189,14360
50,6,95,California,Solano County,7,8,25975,13012,12963
50,6,95,California,Solano County,7,9,26714,13389,13325
50,6,95,California,Solano County,7,10,28104,14110,13994
50,6,95,California,Solano County,7,11,31934,15715,16219
50,6,95,California,Solano County,7,12,30684,14850,15834
50,6,95,California,Solano County,7,13,26239,12524,13715
50,6,95,California,Solano County,7,14,21217,10008,11209
50,6,95,California,Solano County,7,15,13627,6235,7392
50,6,95,California,Solano County,7,16,9574,4210,5364
50,6,95,California,Solano County,7,17,6953,2888,4065
50,6,95,California,Solano County,7,18,6993,2421,4572
50,6,95,California,Solano County,8,0,433409,215303,218106
50,6,95,California,Solano County,8,1,26735,13575,13160
50,6,95,California,Solano County,8,2,27526,14184,13342
50,6,95,California,Solano County,8,3,27500,14069,13431
50,6,95,California,Solano County,8,4,27136,14080,13056
50,6,95,California,Solano County,8,5,30477,16230,14247
50,6,95,California,Solano County,8,6,32042,16565,15477
50,6,95,California,Solano County,8,7,30253,15479,14774
50,6,95,California,Solano County,8,8,27112,13626,13486
50,6,95,California,Solano County,8,9,26013,12964,13049
50,6,95,California,Solano County,8,10,27732,13953,13779
50,6,95,California,Solano County,8,11,31224,15412,15812
50,6,95,California,Solano County,8,12,31084,15039,16045
50,6,95,California,Solano County,8,13,27130,12903,14227
50,6,95,California,Solano County,8,14,22595,10699,11896
50,6,95,California,Solano County,8,15,14481,6580,7901
50,6,95,California,Solano County,8,16,9927,4408,5519
50,6,95,California,Solano County,8,17,7089,2967,4122
50,6,95,California,Solano County,8,18,7353,2570,4783
50,6,95,California,Solano County,9,0,438858,218215,220643
50,6,95,California,Solano County,9,1,26967,13850,13117
50,6,95,California,Solano County,9,2,27614,14084,13530
50,6,95,California,Solano County,9,3,27634,14197,13437
50,6,95,California,Solano County,9,4,26935,13883,13052
50,6,95,California,Solano County,9,5,29764,15954,13810
50,6,95,California,Solano County,9,6,33061,17134,15927
50,6,95,California,Solano County,9,7,31311,16013,15298
50,6,95,California,Solano County,9,8,28044,14221,13823
50,6,95,California,Solano County,9,9,25456,12808,12648
50,6,95,California,Solano County,9,10,27896,13993,13903
50,6,95,California,Solano County,9,11,30504,15059,15445
50,6,95,California,Solano County,9,12,31340,15169,16171
50,6,95,California,Solano County,9,13,27959,13229,14730
50,6,95,California,Solano County,9,14,23636,11243,12393
50,6,95,California,Solano County,9,15,15624,7128,8496
50,6,95,California,Solano County,9,16,10306,4541,5765
50,6,95,California,Solano County,9,17,7214,3029,4185
50,6,95,California,Solano County,9,18,7593,2680,4913
50,6,95,California,Solano County,10,0,443511,220820,222691
50,6,95,California,Solano County,10,1,27094,13928,13166
50,6,95,California,Solano County,10,2,27584,14043,13541
50,6,95,California,Solano County,10,3,27667,14266,13401
50,6,95,California,Solano County,10,4,26781,13725,13056
50,6,95,California,Solano County,10,5,29165,15624,13541
50,6,95,California,Solano County,10,6,33744,17638,16106
50,6,95,California,Solano County,10,7,31637,16227,15410
50,6,95,California,Solano County,10,8,29286,14952,14334
50,6,95,California,Solano County,10,9,25648,13018,12630
50,6,95,California,Solano County,10,10,27754,13895,13859
50,6,95,California,Solano County,10,11,29762,14774,14988
50,6,95,California,Solano County,10,12,31275,15177,16098
50,6,95,California,Solano County,10,13,28817,13580,15237
50,6,95,California,Solano County,10,14,23759,11277,12482
50,6,95,California,Solano County,10,15,17499,8054,9445
50,6,95,California,Solano County,10,16,10869,4767,6102
50,6,95,California,Solano County,10,17,7423,3092,4331
50,6,95,California,Solano County,10,18,7747,2783,4964
50,6,95,California,Solano County,11,0,445725,221843,223882
50,6,95,California,Solano County,11,1,26983,13924,13059
50,6,95,California,Solano County,11,2,27433,13982,13451
50,6,95,California,Solano County,11,3,27729,14314,13415
50,6,95,California,Solano County,11,4,26593,13735,12858
50,6,95,California,Solano County,11,5,28663,15286,13377
50,6,95,California,Solano County,11,6,33786,17691,16095
50,6,95,California,Solano County,11,7,31886,16289,15597
50,6,95,California,Solano County,11,8,30082,15421,14661
50,6,95,California,Solano County,11,9,26180,13217,12963
50,6,95,California,Solano County,11,10,27244,13723,13521
50,6,95,California,Solano County,11,11,28767,14261,14506
50,6,95,California,Solano County,11,12,31110,15207,15903
50,6,95,California,Solano County,11,13,28982,13586,15396
50,6,95,California,Solano County,11,14,24373,11486,12887
50,6,95,California,Solano County,11,15,18674,8548,10126
50,6,95,California,Solano County,11,16,11656,5096,6560
50,6,95,California,Solano County,11,17,7605,3155,4450
50,6,95,California,Solano County,11,18,7979,2922,5057
50,6,95,California,Solano County,12,0,447643,222764,224879
50,6,95,California,Solano County,12,1,26792,13774,13018
50,6,95,California,Solano County,12,2,27404,14046,13358
50,6,95,California,Solano County,12,3,27729,14292,13437
50,6,95,California,Solano County,12,4,26423,13623,12800
50,6,95,California,Solano County,12,5,28161,15067,13094
50,6,95,California,Solano County,12,6,33239,17403,15836
50,6,95,California,Solano County,12,7,32496,16610,15886
50,6,95,California,Solano County,12,8,30964,15957,15007
50,6,95,California,Solano County,12,9,26655,13434,13221
50,6,95,California,Solano County,12,10,26940,13642,13298
50,6,95,California,Solano County,12,11,27782,13830,13952
50,6,95,California,Solano County,12,12,30763,14937,15826
50,6,95,California,Solano County,12,13,29139,13787,15352
50,6,95,California,Solano County,12,14,24806,11533,13273
50,6,95,California,Solano County,12,15,19908,9102,10806
50,6,95,California,Solano County,12,16,12420,5445,6975
50,6,95,California,Solano County,12,17,7853,3275,4578
50,6,95,California,Solano County,12,18,8169,3007,5162
50,6,97,California,Sonoma County,1,0,483878,237902,245976
50,6,97,California,Sonoma County,1,1,28199,14419,13780
50,6,97,California,Sonoma County,1,2,29263,14967,14296
50,6,97,California,Sonoma County,1,3,29724,15176,14548
50,6,97,California,Sonoma County,1,4,33298,17210,16088
50,6,97,California,Sonoma County,1,5,32068,16797,15271
50,6,97,California,Sonoma County,1,6,31730,16536,15194
50,6,97,California,Sonoma County,1,7,29567,15252,14315
50,6,97,California,Sonoma County,1,8,28968,14601,14367
50,6,97,California,Sonoma County,1,9,31635,15937,15698
50,6,97,California,Sonoma County,1,10,36096,17391,18705
50,6,97,California,Sonoma County,1,11,37422,18095,19327
50,6,97,California,Sonoma County,1,12,36355,17311,19044
50,6,97,California,Sonoma County,1,13,32189,15323,16866
50,6,97,California,Sonoma County,1,14,21407,10122,11285
50,6,97,California,Sonoma County,1,15,14137,6470,7667
50,6,97,California,Sonoma County,1,16,10975,4780,6195
50,6,97,California,Sonoma County,1,17,9639,3805,5834
50,6,97,California,Sonoma County,1,18,11206,3710,7496
50,6,97,California,Sonoma County,2,0,483861,237892,245969
50,6,97,California,Sonoma County,2,1,28199,14419,13780
50,6,97,California,Sonoma County,2,2,29265,14968,14297
50,6,97,California,Sonoma County,2,3,29725,15176,14549
50,6,97,California,Sonoma County,2,4,33299,17210,16089
50,6,97,California,Sonoma County,2,5,32066,16795,15271
50,6,97,California,Sonoma County,2,6,31729,16536,15193
50,6,97,California,Sonoma County,2,7,29566,15251,14315
50,6,97,California,Sonoma County,2,8,28968,14601,14367
50,6,97,California,Sonoma County,2,9,31635,15937,15698
50,6,97,California,Sonoma County,2,10,36095,17391,18704
50,6,97,California,Sonoma County,2,11,37417,18091,19326
50,6,97,California,Sonoma County,2,12,36355,17311,19044
50,6,97,California,Sonoma County,2,13,32186,15322,16864
50,6,97,California,Sonoma County,2,14,21408,10123,11285
50,6,97,California,Sonoma County,2,15,14135,6470,7665
50,6,97,California,Sonoma County,2,16,10971,4779,6192
50,6,97,California,Sonoma County,2,17,9638,3804,5834
50,6,97,California,Sonoma County,2,18,11204,3708,7496
50,6,97,California,Sonoma County,3,0,484755,238214,246541
50,6,97,California,Sonoma County,3,1,28210,14442,13768
50,6,97,California,Sonoma County,3,2,29207,14928,14279
50,6,97,California,Sonoma County,3,3,29691,15160,14531
50,6,97,California,Sonoma County,3,4,33114,17022,16092
50,6,97,California,Sonoma County,3,5,32269,16856,15413
50,6,97,California,Sonoma County,3,6,31759,16560,15199
50,6,97,California,Sonoma County,3,7,29775,15324,14451
50,6,97,California,Sonoma County,3,8,28831,14557,14274
50,6,97,California,Sonoma County,3,9,31656,15921,15735
50,6,97,California,Sonoma County,3,10,35876,17329,18547
50,6,97,California,Sonoma County,3,11,37449,18082,19367
50,6,97,California,Sonoma County,3,12,36445,17343,19102
50,6,97,California,Sonoma County,3,13,32584,15531,17053
50,6,97,California,Sonoma County,3,14,21748,10274,11474
50,6,97,California,Sonoma County,3,15,14305,6557,7748
50,6,97,California,Sonoma County,3,16,10977,4789,6188
50,6,97,California,Sonoma County,3,17,9627,3817,5810
50,6,97,California,Sonoma County,3,18,11232,3722,7510
50,6,97,California,Sonoma County,4,0,487421,239134,248287
50,6,97,California,Sonoma County,4,1,27847,14196,13651
50,6,97,California,Sonoma County,4,2,29267,14939,14328
50,6,97,California,Sonoma County,4,3,29556,15081,14475
50,6,97,California,Sonoma County,4,4,32120,16336,15784
50,6,97,California,Sonoma County,4,5,32654,16994,15660
50,6,97,California,Sonoma County,4,6,31690,16585,15105
50,6,97,California,Sonoma County,4,7,30528,15546,14982
50,6,97,California,Sonoma County,4,8,28224,14377,13847
50,6,97,California,Sonoma County,4,9,31638,15845,15793
50,6,97,California,Sonoma County,4,10,34812,16928,17884
50,6,97,California,Sonoma County,4,11,37497,18073,19424
50,6,97,California,Sonoma County,4,12,36763,17482,19281
50,6,97,California,Sonoma County,4,13,34558,16449,18109
50,6,97,California,Sonoma County,4,14,23154,10929,12225
50,6,97,California,Sonoma County,4,15,15129,6945,8184
50,6,97,California,Sonoma County,4,16,11035,4830,6205
50,6,97,California,Sonoma County,4,17,9474,3776,5698
50,6,97,California,Sonoma County,4,18,11475,3823,7652
50,6,97,California,Sonoma County,5,0,489993,240184,249809
50,6,97,California,Sonoma County,5,1,27094,13796,13298
50,6,97,California,Sonoma County,5,2,29316,14992,14324
50,6,97,California,Sonoma County,5,3,29280,14956,14324
50,6,97,California,Sonoma County,5,4,31612,15926,15686
50,6,97,California,Sonoma County,5,5,33012,17151,15861
50,6,97,California,Sonoma County,5,6,31494,16422,15072
50,6,97,California,Sonoma County,5,7,31193,15890,15303
50,6,97,California,Sonoma County,5,8,28349,14457,13892
50,6,97,California,Sonoma County,5,9,31476,15673,15803
50,6,97,California,Sonoma County,5,10,33792,16599,17193
50,6,97,California,Sonoma County,5,11,37115,17837,19278
50,6,97,California,Sonoma County,5,12,37013,17682,19331
50,6,97,California,Sonoma County,5,13,34511,16271,18240
50,6,97,California,Sonoma County,5,14,26085,12366,13719
50,6,97,California,Sonoma County,5,15,16282,7467,8815
50,6,97,California,Sonoma County,5,16,11268,4965,6303
50,6,97,California,Sonoma County,5,17,9425,3830,5595
50,6,97,California,Sonoma County,5,18,11676,3904,7772
50,6,97,California,Sonoma County,6,0,494073,242154,251919
50,6,97,California,Sonoma County,6,1,26911,13708,13203
50,6,97,California,Sonoma County,6,2,29209,14964,14245
50,6,97,California,Sonoma County,6,3,29273,14961,14312
50,6,97,California,Sonoma County,6,4,30962,15495,15467
50,6,97,California,Sonoma County,6,5,32831,17085,15746
50,6,97,California,Sonoma County,6,6,31668,16440,15228
50,6,97,California,Sonoma County,6,7,32145,16400,15745
50,6,97,California,Sonoma County,6,8,28914,14693,14221
50,6,97,California,Sonoma County,6,9,31035,15480,15555
50,6,97,California,Sonoma County,6,10,32864,16274,16590
50,6,97,California,Sonoma County,6,11,36964,17735,19229
50,6,97,California,Sonoma County,6,12,37295,17843,19452
50,6,97,California,Sonoma County,6,13,35141,16525,18616
50,6,97,California,Sonoma County,6,14,28138,13356,14782
50,6,97,California,Sonoma County,6,15,17800,8203,9597
50,6,97,California,Sonoma County,6,16,11876,5256,6620
50,6,97,California,Sonoma County,6,17,9205,3750,5455
50,6,97,California,Sonoma County,6,18,11842,3986,7856
50,6,97,California,Sonoma County,7,0,498560,244111,254449
50,6,97,California,Sonoma County,7,1,26640,13558,13082
50,6,97,California,Sonoma County,7,2,28949,14754,14195
50,6,97,California,Sonoma County,7,3,29336,15096,14240
50,6,97,California,Sonoma County,7,4,30606,15245,15361
50,6,97,California,Sonoma County,7,5,32225,16790,15435
50,6,97,California,Sonoma County,7,6,32245,16742,15503
50,6,97,California,Sonoma County,7,7,32874,16618,16256
50,6,97,California,Sonoma County,7,8,29910,15212,14698
50,6,97,California,Sonoma County,7,9,30445,15202,15243
50,6,97,California,Sonoma County,7,10,32281,16083,16198
50,6,97,California,Sonoma County,7,11,36808,17602,19206
50,6,97,California,Sonoma County,7,12,37315,17818,19497
50,6,97,California,Sonoma County,7,13,35862,16842,19020
50,6,97,California,Sonoma County,7,14,30168,14175,15993
50,6,97,California,Sonoma County,7,15,19347,8988,10359
50,6,97,California,Sonoma County,7,16,12533,5584,6949
50,6,97,California,Sonoma County,7,17,9129,3768,5361
50,6,97,California,Sonoma County,7,18,11887,4034,7853
50,6,97,California,Sonoma County,8,0,500863,244927,255936
50,6,97,California,Sonoma County,8,1,26183,13209,12974
50,6,97,California,Sonoma County,8,2,28758,14719,14039
50,6,97,California,Sonoma County,8,3,29370,15047,14323
50,6,97,California,Sonoma County,8,4,30186,15074,15112
50,6,97,California,Sonoma County,8,5,30932,15971,14961
50,6,97,California,Sonoma County,8,6,32872,17099,15773
50,6,97,California,Sonoma County,8,7,32765,16640,16125
50,6,97,California,Sonoma County,8,8,31035,15689,15346
50,6,97,California,Sonoma County,8,9,29674,14895,14779
50,6,97,California,Sonoma County,8,10,32141,16023,16118
50,6,97,California,Sonoma County,8,11,36118,17285,18833
50,6,97,California,Sonoma County,8,12,37199,17738,19461
50,6,97,California,Sonoma County,8,13,36203,17016,19187
50,6,97,California,Sonoma County,8,14,32060,15013,17047
50,6,97,California,Sonoma County,8,15,20944,9701,11243
50,6,97,California,Sonoma County,8,16,13126,5827,7299
50,6,97,California,Sonoma County,8,17,9189,3831,5358
50,6,97,California,Sonoma County,8,18,12108,4150,7958
50,6,97,California,Sonoma County,9,0,502547,245584,256963
50,6,97,California,Sonoma County,9,1,25654,12924,12730
50,6,97,California,Sonoma County,9,2,28447,14599,13848
50,6,97,California,Sonoma County,9,3,29212,14979,14233
50,6,97,California,Sonoma County,9,4,29910,14930,14980
50,6,97,California,Sonoma County,9,5,30035,15261,14774
50,6,97,California,Sonoma County,9,6,33237,17282,15955
50,6,97,California,Sonoma County,9,7,32713,16668,16045
50,6,97,California,Sonoma County,9,8,31989,16129,15860
50,6,97,California,Sonoma County,9,9,29183,14756,14427
50,6,97,California,Sonoma County,9,10,32158,15974,16184
50,6,97,California,Sonoma County,9,11,35004,16871,18133
50,6,97,California,Sonoma County,9,12,37195,17761,19434
50,6,97,California,Sonoma County,9,13,36457,17057,19400
50,6,97,California,Sonoma County,9,14,33757,15822,17935
50,6,97,California,Sonoma County,9,15,22264,10284,11980
50,6,97,California,Sonoma County,9,16,13877,6169,7708
50,6,97,California,Sonoma County,9,17,9323,3907,5416
50,6,97,California,Sonoma County,9,18,12132,4211,7921
50,6,97,California,Sonoma County,10,0,502469,245589,256880
50,6,97,California,Sonoma County,10,1,25344,12902,12442
50,6,97,California,Sonoma County,10,2,27672,14104,13568
50,6,97,California,Sonoma County,10,3,29076,14903,14173
50,6,97,California,Sonoma County,10,4,29704,14902,14802
50,6,97,California,Sonoma County,10,5,29185,14797,14388
50,6,97,California,Sonoma County,10,6,33011,17229,15782
50,6,97,California,Sonoma County,10,7,32536,16648,15888
50,6,97,California,Sonoma County,10,8,32515,16333,16182
50,6,97,California,Sonoma County,10,9,29306,14791,14515
50,6,97,California,Sonoma County,10,10,31887,15823,16064
50,6,97,California,Sonoma County,10,11,33846,16475,17371
50,6,97,California,Sonoma County,10,12,36879,17566,19313
50,6,97,California,Sonoma County,10,13,36540,17094,19446
50,6,97,California,Sonoma County,10,14,33566,15559,18007
50,6,97,California,Sonoma County,10,15,24953,11585,13368
50,6,97,California,Sonoma County,10,16,14760,6596,8164
50,6,97,California,Sonoma County,10,17,9561,4014,5547
50,6,97,California,Sonoma County,10,18,12128,4268,7860
50,6,97,California,Sonoma County,11,0,498643,243377,255266
50,6,97,California,Sonoma County,11,1,24513,12459,12054
50,6,97,California,Sonoma County,11,2,26954,13712,13242
50,6,97,California,Sonoma County,11,3,28724,14683,14041
50,6,97,California,Sonoma County,11,4,29607,14832,14775
50,6,97,California,Sonoma County,11,5,27856,14001,13855
50,6,97,California,Sonoma County,11,6,32494,16901,15593
50,6,97,California,Sonoma County,11,7,31807,16307,15500
50,6,97,California,Sonoma County,11,8,32814,16459,16355
50,6,97,California,Sonoma County,11,9,29399,14851,14548
50,6,97,California,Sonoma County,11,10,31059,15369,15690
50,6,97,California,Sonoma County,11,11,32533,15967,16566
50,6,97,California,Sonoma County,11,12,36127,17210,18917
50,6,97,California,Sonoma County,11,13,36012,16938,19074
50,6,97,California,Sonoma County,11,14,33779,15535,18244
50,6,97,California,Sonoma County,11,15,26724,12423,14301
50,6,97,California,Sonoma County,11,16,16055,7158,8897
50,6,97,California,Sonoma County,11,17,10043,4235,5808
50,6,97,California,Sonoma County,11,18,12143,4337,7806
50,6,97,California,Sonoma County,12,0,494336,241221,253115
50,6,97,California,Sonoma County,12,1,23848,12152,11696
50,6,97,California,Sonoma County,12,2,26280,13312,12968
50,6,97,California,Sonoma County,12,3,28044,14332,13712
50,6,97,California,Sonoma County,12,4,29408,14797,14611
50,6,97,California,Sonoma County,12,5,27200,13650,13550
50,6,97,California,Sonoma County,12,6,31388,16319,15069
50,6,97,California,Sonoma County,12,7,31372,16092,15280
50,6,97,California,Sonoma County,12,8,32714,16397,16317
50,6,97,California,Sonoma County,12,9,29679,14989,14690
50,6,97,California,Sonoma County,12,10,29948,14927,15021
50,6,97,California,Sonoma County,12,11,31427,15551,15876
50,6,97,California,Sonoma County,12,12,35407,16760,18647
50,6,97,California,Sonoma County,12,13,35298,16591,18707
50,6,97,California,Sonoma County,12,14,33950,15610,18340
50,6,97,California,Sonoma County,12,15,28326,13083,15243
50,6,97,California,Sonoma County,12,16,17310,7766,9544
50,6,97,California,Sonoma County,12,17,10540,4464,6076
50,6,97,California,Sonoma County,12,18,12197,4429,7768
50,6,99,California,Stanislaus County,1,0,514453,254489,259964
50,6,99,California,Stanislaus County,1,1,39779,20327,19452
50,6,99,California,Stanislaus County,1,2,40013,20402,19611
50,6,99,California,Stanislaus County,1,3,41276,21399,19877
50,6,99,California,Stanislaus County,1,4,42807,22193,20614
50,6,99,California,Stanislaus County,1,5,37119,18792,18327
50,6,99,California,Stanislaus County,1,6,36474,18326,18148
50,6,99,California,Stanislaus County,1,7,33720,16883,16837
50,6,99,California,Stanislaus County,1,8,33125,16465,16660
50,6,99,California,Stanislaus County,1,9,33601,16678,16923
50,6,99,California,Stanislaus County,1,10,35785,17703,18082
50,6,99,California,Stanislaus County,1,11,33773,16605,17168
50,6,99,California,Stanislaus County,1,12,28545,13854,14691
50,6,99,California,Stanislaus County,1,13,23605,11236,12369
50,6,99,California,Stanislaus County,1,14,16929,7868,9061
50,6,99,California,Stanislaus County,1,15,12708,5756,6952
50,6,99,California,Stanislaus County,1,16,9963,4308,5655
50,6,99,California,Stanislaus County,1,17,7822,3112,4710
50,6,99,California,Stanislaus County,1,18,7409,2582,4827
50,6,99,California,Stanislaus County,2,0,514450,254486,259964
50,6,99,California,Stanislaus County,2,1,39779,20327,19452
50,6,99,California,Stanislaus County,2,2,40013,20402,19611
50,6,99,California,Stanislaus County,2,3,41276,21399,19877
50,6,99,California,Stanislaus County,2,4,42807,22193,20614
50,6,99,California,Stanislaus County,2,5,37119,18792,18327
50,6,99,California,Stanislaus County,2,6,36474,18326,18148
50,6,99,California,Stanislaus County,2,7,33720,16883,16837
50,6,99,California,Stanislaus County,2,8,33125,16465,16660
50,6,99,California,Stanislaus County,2,9,33601,16678,16923
50,6,99,California,Stanislaus County,2,10,35785,17703,18082
50,6,99,California,Stanislaus County,2,11,33772,16604,17168
50,6,99,California,Stanislaus County,2,12,28543,13852,14691
50,6,99,California,Stanislaus County,2,13,23605,11236,12369
50,6,99,California,Stanislaus County,2,14,16929,7868,9061
50,6,99,California,Stanislaus County,2,15,12708,5756,6952
50,6,99,California,Stanislaus County,2,16,9963,4308,5655
50,6,99,California,Stanislaus County,2,17,7822,3112,4710
50,6,99,California,Stanislaus County,2,18,7409,2582,4827
50,6,99,California,Stanislaus County,3,0,515145,254800,260345
50,6,99,California,Stanislaus County,3,1,39726,20305,19421
50,6,99,California,Stanislaus County,3,2,40015,20412,19603
50,6,99,California,Stanislaus County,3,3,41108,21278,19830
50,6,99,California,Stanislaus County,3,4,42469,22058,20411
50,6,99,California,Stanislaus County,3,5,37529,18985,18544
50,6,99,California,Stanislaus County,3,6,36522,18361,18161
50,6,99,California,Stanislaus County,3,7,33864,16939,16925
50,6,99,California,Stanislaus County,3,8,33010,16405,16605
50,6,99,California,Stanislaus County,3,9,33618,16670,16948
50,6,99,California,Stanislaus County,3,10,35563,17573,17990
50,6,99,California,Stanislaus County,3,11,33959,16721,17238
50,6,99,California,Stanislaus County,3,12,28815,13987,14828
50,6,99,California,Stanislaus County,3,13,23851,11370,12481
50,6,99,California,Stanislaus County,3,14,17097,7949,9148
50,6,99,California,Stanislaus County,3,15,12747,5772,6975
50,6,99,California,Stanislaus County,3,16,9989,4315,5674
50,6,99,California,Stanislaus County,3,17,7808,3107,4701
50,6,99,California,Stanislaus County,3,18,7455,2593,4862
50,6,99,California,Stanislaus County,4,0,517560,255913,261647
50,6,99,California,Stanislaus County,4,1,39617,20254,19363
50,6,99,California,Stanislaus County,4,2,40042,20480,19562
50,6,99,California,Stanislaus County,4,3,40526,20813,19713
50,6,99,California,Stanislaus County,4,4,41314,21621,19693
50,6,99,California,Stanislaus County,4,5,38821,19503,19318
50,6,99,California,Stanislaus County,4,6,36452,18319,18133
50,6,99,California,Stanislaus County,4,7,34583,17363,17220
50,6,99,California,Stanislaus County,4,8,32330,16069,16261
50,6,99,California,Stanislaus County,4,9,33767,16722,17045
50,6,99,California,Stanislaus County,4,10,34485,16962,17523
50,6,99,California,Stanislaus County,4,11,34453,17003,17450
50,6,99,California,Stanislaus County,4,12,29764,14450,15314
50,6,99,California,Stanislaus County,4,13,24902,11916,12986
50,6,99,California,Stanislaus County,4,14,17871,8369,9502
50,6,99,California,Stanislaus County,4,15,13000,5871,7129
50,6,99,California,Stanislaus County,4,16,10216,4421,5795
50,6,99,California,Stanislaus County,4,17,7725,3098,4627
50,6,99,California,Stanislaus County,4,18,7692,2679,5013
50,6,99,California,Stanislaus County,5,0,520424,257233,263191
50,6,99,California,Stanislaus County,5,1,39337,20161,19176
50,6,99,California,Stanislaus County,5,2,40375,20582,19793
50,6,99,California,Stanislaus County,5,3,40238,20609,19629
50,6,99,California,Stanislaus County,5,4,40592,21140,19452
50,6,99,California,Stanislaus County,5,5,39282,19731,19551
50,6,99,California,Stanislaus County,5,6,36794,18527,18267
50,6,99,California,Stanislaus County,5,7,34978,17487,17491
50,6,99,California,Stanislaus County,5,8,32365,16131,16234
50,6,99,California,Stanislaus County,5,9,33667,16685,16982
50,6,99,California,Stanislaus County,5,10,33625,16530,17095
50,6,99,California,Stanislaus County,5,11,34551,17074,17477
50,6,99,California,Stanislaus County,5,12,30594,14891,15703
50,6,99,California,Stanislaus County,5,13,25039,12006,13033
50,6,99,California,Stanislaus County,5,14,19416,9140,10276
50,6,99,California,Stanislaus County,5,15,13596,6164,7432
50,6,99,California,Stanislaus County,5,16,10455,4523,5932
50,6,99,California,Stanislaus County,5,17,7673,3094,4579
50,6,99,California,Stanislaus County,5,18,7847,2758,5089
50,6,99,California,Stanislaus County,6,0,523451,258814,264637
50,6,99,California,Stanislaus County,6,1,38789,19822,18967
50,6,99,California,Stanislaus County,6,2,40571,20596,19975
50,6,99,California,Stanislaus County,6,3,40372,20732,19640
50,6,99,California,Stanislaus County,6,4,39994,20707,19287
50,6,99,California,Stanislaus County,6,5,39143,19865,19278
50,6,99,California,Stanislaus County,6,6,37128,18765,18363
50,6,99,California,Stanislaus County,6,7,35691,17928,17763
50,6,99,California,Stanislaus County,6,8,32772,16351,16421
50,6,99,California,Stanislaus County,6,9,33388,16580,16808
50,6,99,California,Stanislaus County,6,10,33037,16263,16774
50,6,99,California,Stanislaus County,6,11,34647,17085,17562
50,6,99,California,Stanislaus County,6,12,31009,15070,15939
50,6,99,California,Stanislaus County,6,13,25679,12335,13344
50,6,99,California,Stanislaus County,6,14,20400,9589,10811
50,6,99,California,Stanislaus County,6,15,14364,6531,7833
50,6,99,California,Stanislaus County,6,16,10707,4608,6099
50,6,99,California,Stanislaus County,6,17,7751,3179,4572
50,6,99,California,Stanislaus County,6,18,8009,2808,5201
50,6,99,California,Stanislaus County,7,0,528015,261122,266893
50,6,99,California,Stanislaus County,7,1,38987,19902,19085
50,6,99,California,Stanislaus County,7,2,40940,20790,20150
50,6,99,California,Stanislaus County,7,3,40391,20715,19676
50,6,99,California,Stanislaus County,7,4,39457,20353,19104
50,6,99,California,Stanislaus County,7,5,39141,20002,19139
50,6,99,California,Stanislaus County,7,6,37834,19074,18760
50,6,99,California,Stanislaus County,7,7,36340,18308,18032
50,6,99,California,Stanislaus County,7,8,33210,16632,16578
50,6,99,California,Stanislaus County,7,9,32894,16342,16552
50,6,99,California,Stanislaus County,7,10,32737,16168,16569
50,6,99,California,Stanislaus County,7,11,34731,17037,17694
50,6,99,California,Stanislaus County,7,12,31522,15311,16211
50,6,99,California,Stanislaus County,7,13,26408,12688,13720
50,6,99,California,Stanislaus County,7,14,21400,10068,11332
50,6,99,California,Stanislaus County,7,15,15021,6834,8187
50,6,99,California,Stanislaus County,7,16,10979,4787,6192
50,6,99,California,Stanislaus County,7,17,7871,3248,4623
50,6,99,California,Stanislaus County,7,18,8152,2863,5289
50,6,99,California,Stanislaus County,8,0,533211,263837,269374
50,6,99,California,Stanislaus County,8,1,39133,19955,19178
50,6,99,California,Stanislaus County,8,2,41309,20995,20314
50,6,99,California,Stanislaus County,8,3,40668,20823,19845
50,6,99,California,Stanislaus County,8,4,39283,20233,19050
50,6,99,California,Stanislaus County,8,5,38423,19661,18762
50,6,99,California,Stanislaus County,8,6,38950,19658,19292
50,6,99,California,Stanislaus County,8,7,36948,18653,18295
50,6,99,California,Stanislaus County,8,8,34080,17109,16971
50,6,99,California,Stanislaus County,8,9,32531,16235,16296
50,6,99,California,Stanislaus County,8,10,32785,16220,16565
50,6,99,California,Stanislaus County,8,11,34206,16738,17468
50,6,99,California,Stanislaus County,8,12,32189,15732,16457
50,6,99,California,Stanislaus County,8,13,27001,13017,13984
50,6,99,California,Stanislaus County,8,14,22346,10387,11959
50,6,99,California,Stanislaus County,8,15,15737,7198,8539
50,6,99,California,Stanislaus County,8,16,11195,4910,6285
50,6,99,California,Stanislaus County,8,17,8048,3323,4725
50,6,99,California,Stanislaus County,8,18,8379,2990,5389
50,6,99,California,Stanislaus County,9,0,539255,266723,272532
50,6,99,California,Stanislaus County,9,1,39449,20062,19387
50,6,99,California,Stanislaus County,9,2,41729,21148,20581
50,6,99,California,Stanislaus County,9,3,41393,21257,20136
50,6,99,California,Stanislaus County,9,4,39182,20160,19022
50,6,99,California,Stanislaus County,9,5,37462,19237,18225
50,6,99,California,Stanislaus County,9,6,40703,20473,20230
50,6,99,California,Stanislaus County,9,7,37566,18994,18572
50,6,99,California,Stanislaus County,9,8,35052,17537,17515
50,6,99,California,Stanislaus County,9,9,32235,16090,16145
50,6,99,California,Stanislaus County,9,10,33103,16378,16725
50,6,99,California,Stanislaus County,9,11,33398,16350,17048
50,6,99,California,Stanislaus County,9,12,32656,15942,16714
50,6,99,California,Stanislaus County,9,13,27823,13378,14445
50,6,99,California,Stanislaus County,9,14,23145,10815,12330
50,6,99,California,Stanislaus County,9,15,16350,7503,8847
50,6,99,California,Stanislaus County,9,16,11365,4999,6366
50,6,99,California,Stanislaus County,9,17,8211,3362,4849
50,6,99,California,Stanislaus County,9,18,8433,3038,5395
50,6,99,California,Stanislaus County,10,0,544717,269618,275099
50,6,99,California,Stanislaus County,10,1,39725,20285,19440
50,6,99,California,Stanislaus County,10,2,41663,21095,20568
50,6,99,California,Stanislaus County,10,3,42217,21478,20739
50,6,99,California,Stanislaus County,10,4,39217,20237,18980
50,6,99,California,Stanislaus County,10,5,37382,19186,18196
50,6,99,California,Stanislaus County,10,6,41221,20715,20506
50,6,99,California,Stanislaus County,10,7,38041,19386,18655
50,6,99,California,Stanislaus County,10,8,35880,17954,17926
50,6,99,California,Stanislaus County,10,9,32471,16281,16190
50,6,99,California,Stanislaus County,10,10,33216,16433,16783
50,6,99,California,Stanislaus County,10,11,32810,16113,16697
50,6,99,California,Stanislaus County,10,12,32888,16088,16800
50,6,99,California,Stanislaus County,10,13,28522,13727,14795
50,6,99,California,Stanislaus County,10,14,23276,10829,12447
50,6,99,California,Stanislaus County,10,15,17673,8136,9537
50,6,99,California,Stanislaus County,10,16,11730,5180,6550
50,6,99,California,Stanislaus County,10,17,8376,3448,4928
50,6,99,California,Stanislaus County,10,18,8409,3047,5362
50,6,99,California,Stanislaus County,11,0,548126,271479,276647
50,6,99,California,Stanislaus County,11,1,39442,20097,19345
50,6,99,California,Stanislaus County,11,2,41583,21093,20490
50,6,99,California,Stanislaus County,11,3,42709,21683,21026
50,6,99,California,Stanislaus County,11,4,39370,20334,19036
50,6,99,California,Stanislaus County,11,5,36964,18885,18079
50,6,99,California,Stanislaus County,11,6,41168,20769,20399
50,6,99,California,Stanislaus County,11,7,38530,19615,18915
50,6,99,California,Stanislaus County,11,8,36632,18496,18136
50,6,99,California,Stanislaus County,11,9,32975,16557,16418
50,6,99,California,Stanislaus County,11,10,32994,16404,16590
50,6,99,California,Stanislaus County,11,11,32209,15848,16361
50,6,99,California,Stanislaus County,11,12,32951,16103,16848
50,6,99,California,Stanislaus County,11,13,29004,13970,15034
50,6,99,California,Stanislaus County,11,14,23722,11033,12689
50,6,99,California,Stanislaus County,11,15,18484,8488,9996
50,6,99,California,Stanislaus County,11,16,12369,5464,6905
50,6,99,California,Stanislaus County,11,17,8467,3489,4978
50,6,99,California,Stanislaus County,11,18,8553,3151,5402
50,6,99,California,Stanislaus County,12,0,550660,272956,277704
50,6,99,California,Stanislaus County,12,1,39137,19920,19217
50,6,99,California,Stanislaus County,12,2,41346,21069,20277
50,6,99,California,Stanislaus County,12,3,42978,21834,21144
50,6,99,California,Stanislaus County,12,4,39537,20365,19172
50,6,99,California,Stanislaus County,12,5,36479,18607,17872
50,6,99,California,Stanislaus County,12,6,41148,20967,20181
50,6,99,California,Stanislaus County,12,7,39033,19767,19266
50,6,99,California,Stanislaus County,12,8,37340,18922,18418
50,6,99,California,Stanislaus County,12,9,33317,16790,16527
50,6,99,California,Stanislaus County,12,10,32451,16194,16257
50,6,99,California,Stanislaus County,12,11,31701,15664,16037
50,6,99,California,Stanislaus County,12,12,32914,16049,16865
50,6,99,California,Stanislaus County,12,13,29358,14095,15263
50,6,99,California,Stanislaus County,12,14,24251,11265,12986
50,6,99,California,Stanislaus County,12,15,19317,8850,10467
50,6,99,California,Stanislaus County,12,16,12985,5710,7275
50,6,99,California,Stanislaus County,12,17,8698,3635,5063
50,6,99,California,Stanislaus County,12,18,8670,3253,5417
50,6,101,California,Sutter County,1,0,94737,47001,47736
50,6,101,California,Sutter County,1,1,7153,3621,3532
50,6,101,California,Sutter County,1,2,7292,3763,3529
50,6,101,California,Sutter County,1,3,7146,3615,3531
50,6,101,California,Sutter County,1,4,7377,3916,3461
50,6,101,California,Sutter County,1,5,6286,3307,2979
50,6,101,California,Sutter County,1,6,6528,3218,3310
50,6,101,California,Sutter County,1,7,6138,3116,3022
50,6,101,California,Sutter County,1,8,5879,2950,2929
50,6,101,California,Sutter County,1,9,6101,3002,3099
50,6,101,California,Sutter County,1,10,6548,3273,3275
50,6,101,California,Sutter County,1,11,6194,3054,3140
50,6,101,California,Sutter County,1,12,5412,2659,2753
50,6,101,California,Sutter County,1,13,4693,2254,2439
50,6,101,California,Sutter County,1,14,3612,1654,1958
50,6,101,California,Sutter County,1,15,2878,1345,1533
50,6,101,California,Sutter County,1,16,2346,1089,1257
50,6,101,California,Sutter County,1,17,1633,660,973
50,6,101,California,Sutter County,1,18,1521,505,1016
50,6,101,California,Sutter County,2,0,94756,47011,47745
50,6,101,California,Sutter County,2,1,7153,3621,3532
50,6,101,California,Sutter County,2,2,7292,3763,3529
50,6,101,California,Sutter County,2,3,7148,3615,3533
50,6,101,California,Sutter County,2,4,7378,3916,3462
50,6,101,California,Sutter County,2,5,6287,3307,2980
50,6,101,California,Sutter County,2,6,6528,3218,3310
50,6,101,California,Sutter County,2,7,6138,3116,3022
50,6,101,California,Sutter County,2,8,5880,2951,2929
50,6,101,California,Sutter County,2,9,6102,3002,3100
50,6,101,California,Sutter County,2,10,6550,3275,3275
50,6,101,California,Sutter County,2,11,6196,3055,3141
50,6,101,California,Sutter County,2,12,5414,2661,2753
50,6,101,California,Sutter County,2,13,4696,2256,2440
50,6,101,California,Sutter County,2,14,3615,1655,1960
50,6,101,California,Sutter County,2,15,2879,1346,1533
50,6,101,California,Sutter County,2,16,2346,1089,1257
50,6,101,California,Sutter County,2,17,1633,660,973
50,6,101,California,Sutter County,2,18,1521,505,1016
50,6,101,California,Sutter County,3,0,94751,47018,47733
50,6,101,California,Sutter County,3,1,7124,3610,3514
50,6,101,California,Sutter County,3,2,7264,3738,3526
50,6,101,California,Sutter County,3,3,7163,3625,3538
50,6,101,California,Sutter County,3,4,7284,3865,3419
50,6,101,California,Sutter County,3,5,6355,3331,3024
50,6,101,California,Sutter County,3,6,6531,3241,3290
50,6,101,California,Sutter County,3,7,6137,3116,3021
50,6,101,California,Sutter County,3,8,5856,2921,2935
50,6,101,California,Sutter County,3,9,6070,2992,3078
50,6,101,California,Sutter County,3,10,6537,3274,3263
50,6,101,California,Sutter County,3,11,6225,3070,3155
50,6,101,California,Sutter County,3,12,5430,2669,2761
50,6,101,California,Sutter County,3,13,4737,2281,2456
50,6,101,California,Sutter County,3,14,3633,1659,1974
50,6,101,California,Sutter County,3,15,2878,1347,1531
50,6,101,California,Sutter County,3,16,2355,1096,1259
50,6,101,California,Sutter County,3,17,1649,678,971
50,6,101,California,Sutter County,3,18,1523,505,1018
50,6,101,California,Sutter County,4,0,94482,46866,47616
50,6,101,California,Sutter County,4,1,6920,3540,3380
50,6,101,California,Sutter County,4,2,7245,3717,3528
50,6,101,California,Sutter County,4,3,7047,3558,3489
50,6,101,California,Sutter County,4,4,6994,3707,3287
50,6,101,California,Sutter County,4,5,6614,3417,3197
50,6,101,California,Sutter County,4,6,6539,3267,3272
50,6,101,California,Sutter County,4,7,6120,3113,3007
50,6,101,California,Sutter County,4,8,5674,2770,2904
50,6,101,California,Sutter County,4,9,5945,2959,2986
50,6,101,California,Sutter County,4,10,6435,3253,3182
50,6,101,California,Sutter County,4,11,6270,3087,3183
50,6,101,California,Sutter County,4,12,5538,2701,2837
50,6,101,California,Sutter County,4,13,4883,2374,2509
50,6,101,California,Sutter County,4,14,3702,1671,2031
50,6,101,California,Sutter County,4,15,2886,1343,1543
50,6,101,California,Sutter County,4,16,2393,1113,1280
50,6,101,California,Sutter County,4,17,1719,756,963
50,6,101,California,Sutter County,4,18,1558,520,1038
50,6,101,California,Sutter County,5,0,94189,46802,47387
50,6,101,California,Sutter County,5,1,6710,3437,3273
50,6,101,California,Sutter County,5,2,7279,3742,3537
50,6,101,California,Sutter County,5,3,7084,3591,3493
50,6,101,California,Sutter County,5,4,6729,3534,3195
50,6,101,California,Sutter County,5,5,6713,3482,3231
50,6,101,California,Sutter County,5,6,6463,3301,3162
50,6,101,California,Sutter County,5,7,6064,3020,3044
50,6,101,California,Sutter County,5,8,5640,2800,2840
50,6,101,California,Sutter County,5,9,5855,2915,2940
50,6,101,California,Sutter County,5,10,6148,3095,3053
50,6,101,California,Sutter County,5,11,6301,3111,3190
50,6,101,California,Sutter County,5,12,5692,2760,2932
50,6,101,California,Sutter County,5,13,4802,2361,2441
50,6,101,California,Sutter County,5,14,3911,1795,2116
50,6,101,California,Sutter County,5,15,2969,1387,1582
50,6,101,California,Sutter County,5,16,2439,1086,1353
50,6,101,California,Sutter County,5,17,1764,807,957
50,6,101,California,Sutter County,5,18,1626,578,1048
50,6,101,California,Sutter County,6,0,94507,46994,47513
50,6,101,California,Sutter County,6,1,6562,3363,3199
50,6,101,California,Sutter County,6,2,7242,3747,3495
50,6,101,California,Sutter County,6,3,7054,3573,3481
50,6,101,California,Sutter County,6,4,6628,3451,3177
50,6,101,California,Sutter County,6,5,6731,3484,3247
50,6,101,California,Sutter County,6,6,6531,3332,3199
50,6,101,California,Sutter County,6,7,6081,3045,3036
50,6,101,California,Sutter County,6,8,5649,2827,2822
50,6,101,California,Sutter County,6,9,5861,2911,2950
50,6,101,California,Sutter County,6,10,5987,2988,2999
50,6,101,California,Sutter County,6,11,6360,3142,3218
50,6,101,California,Sutter County,6,12,5838,2879,2959
50,6,101,California,Sutter County,6,13,4783,2333,2450
50,6,101,California,Sutter County,6,14,4098,1929,2169
50,6,101,California,Sutter County,6,15,3097,1415,1682
50,6,101,California,Sutter County,6,16,2483,1129,1354
50,6,101,California,Sutter County,6,17,1844,839,1005
50,6,101,California,Sutter County,6,18,1678,607,1071
50,6,101,California,Sutter County,7,0,94778,47081,47697
50,6,101,California,Sutter County,7,1,6493,3397,3096
50,6,101,California,Sutter County,7,2,7188,3670,3518
50,6,101,California,Sutter County,7,3,7168,3674,3494
50,6,101,California,Sutter County,7,4,6567,3375,3192
50,6,101,California,Sutter County,7,5,6614,3428,3186
50,6,101,California,Sutter County,7,6,6530,3340,3190
50,6,101,California,Sutter County,7,7,6231,3056,3175
50,6,101,California,Sutter County,7,8,5685,2877,2808
50,6,101,California,Sutter County,7,9,5739,2868,2871
50,6,101,California,Sutter County,7,10,5775,2843,2932
50,6,101,California,Sutter County,7,11,6331,3133,3198
50,6,101,California,Sutter County,7,12,5939,2909,3030
50,6,101,California,Sutter County,7,13,4916,2392,2524
50,6,101,California,Sutter County,7,14,4262,2025,2237
50,6,101,California,Sutter County,7,15,3213,1451,1762
50,6,101,California,Sutter County,7,16,2483,1125,1358
50,6,101,California,Sutter County,7,17,1907,879,1028
50,6,101,California,Sutter County,7,18,1737,639,1098
50,6,101,California,Sutter County,8,0,95282,47307,47975
50,6,101,California,Sutter County,8,1,6557,3388,3169
50,6,101,California,Sutter County,8,2,7062,3624,3438
50,6,101,California,Sutter County,8,3,7191,3728,3463
50,6,101,California,Sutter County,8,4,6520,3341,3179
50,6,101,California,Sutter County,8,5,6531,3400,3131
50,6,101,California,Sutter County,8,6,6634,3355,3279
50,6,101,California,Sutter County,8,7,6245,3069,3176
50,6,101,California,Sutter County,8,8,5841,2957,2884
50,6,101,California,Sutter County,8,9,5607,2772,2835
50,6,101,California,Sutter County,8,10,5755,2830,2925
50,6,101,California,Sutter County,8,11,6235,3099,3136
50,6,101,California,Sutter County,8,12,5996,2947,3049
50,6,101,California,Sutter County,8,13,5139,2502,2637
50,6,101,California,Sutter County,8,14,4390,2126,2264
50,6,101,California,Sutter County,8,15,3320,1473,1847
50,6,101,California,Sutter County,8,16,2479,1117,1362
50,6,101,California,Sutter County,8,17,1968,904,1064
50,6,101,California,Sutter County,8,18,1812,675,1137
50,6,101,California,Sutter County,9,0,95742,47643,48099
50,6,101,California,Sutter County,9,1,6639,3405,3234
50,6,101,California,Sutter County,9,2,7113,3648,3465
50,6,101,California,Sutter County,9,3,7201,3729,3472
50,6,101,California,Sutter County,9,4,6556,3378,3178
50,6,101,California,Sutter County,9,5,6271,3311,2960
50,6,101,California,Sutter County,9,6,6860,3525,3335
50,6,101,California,Sutter County,9,7,6300,3120,3180
50,6,101,California,Sutter County,9,8,5927,2987,2940
50,6,101,California,Sutter County,9,9,5576,2729,2847
50,6,101,California,Sutter County,9,10,5652,2798,2854
50,6,101,California,Sutter County,9,11,6107,3080,3027
50,6,101,California,Sutter County,9,12,6023,2939,3084
50,6,101,California,Sutter County,9,13,5288,2570,2718
50,6,101,California,Sutter County,9,14,4449,2157,2292
50,6,101,California,Sutter County,9,15,3405,1495,1910
50,6,101,California,Sutter County,9,16,2491,1142,1349
50,6,101,California,Sutter County,9,17,1941,873,1068
50,6,101,California,Sutter County,9,18,1943,757,1186
50,6,101,California,Sutter County,10,0,96204,47877,48327
50,6,101,California,Sutter County,10,1,6665,3456,3209
50,6,101,California,Sutter County,10,2,6950,3583,3367
50,6,101,California,Sutter County,10,3,7297,3760,3537
50,6,101,California,Sutter County,10,4,6519,3348,3171
50,6,101,California,Sutter County,10,5,6129,3174,2955
50,6,101,California,Sutter County,10,6,7085,3691,3394
50,6,101,California,Sutter County,10,7,6380,3210,3170
50,6,101,California,Sutter County,10,8,6039,3011,3028
50,6,101,California,Sutter County,10,9,5542,2734,2808
50,6,101,California,Sutter County,10,10,5656,2785,2871
50,6,101,California,Sutter County,10,11,5915,2957,2958
50,6,101,California,Sutter County,10,12,6111,2971,3140
50,6,101,California,Sutter County,10,13,5476,2677,2799
50,6,101,California,Sutter County,10,14,4363,2098,2265
50,6,101,California,Sutter County,10,15,3556,1613,1943
50,6,101,California,Sutter County,10,16,2606,1188,1418
50,6,101,California,Sutter County,10,17,1940,832,1108
50,6,101,California,Sutter County,10,18,1975,789,1186
50,6,101,California,Sutter County,11,0,96348,47997,48351
50,6,101,California,Sutter County,11,1,6641,3444,3197
50,6,101,California,Sutter County,11,2,6739,3479,3260
50,6,101,California,Sutter County,11,3,7279,3738,3541
50,6,101,California,Sutter County,11,4,6552,3379,3173
50,6,101,California,Sutter County,11,5,6049,3133,2916
50,6,101,California,Sutter County,11,6,7071,3666,3405
50,6,101,California,Sutter County,11,7,6546,3333,3213
50,6,101,California,Sutter County,11,8,6084,3014,3070
50,6,101,California,Sutter County,11,9,5585,2792,2793
50,6,101,California,Sutter County,11,10,5599,2741,2858
50,6,101,California,Sutter County,11,11,5799,2884,2915
50,6,101,California,Sutter County,11,12,6071,2975,3096
50,6,101,California,Sutter County,11,13,5595,2740,2855
50,6,101,California,Sutter County,11,14,4378,2092,2286
50,6,101,California,Sutter County,11,15,3709,1740,1969
50,6,101,California,Sutter County,11,16,2721,1191,1530
50,6,101,California,Sutter County,11,17,1917,854,1063
50,6,101,California,Sutter County,11,18,2013,802,1211
50,6,101,California,Sutter County,12,0,96971,48303,48668
50,6,101,California,Sutter County,12,1,6704,3400,3304
50,6,101,California,Sutter County,12,2,6748,3529,3219
50,6,101,California,Sutter County,12,3,7238,3730,3508
50,6,101,California,Sutter County,12,4,6610,3387,3223
50,6,101,California,Sutter County,12,5,5985,3059,2926
50,6,101,California,Sutter County,12,6,7095,3728,3367
50,6,101,California,Sutter County,12,7,6570,3348,3222
50,6,101,California,Sutter County,12,8,6225,3079,3146
50,6,101,California,Sutter County,12,9,5735,2890,2845
50,6,101,California,Sutter County,12,10,5562,2729,2833
50,6,101,California,Sutter County,12,11,5658,2806,2852
50,6,101,California,Sutter County,12,12,6152,3027,3125
50,6,101,California,Sutter County,12,13,5594,2739,2855
50,6,101,California,Sutter County,12,14,4513,2168,2345
50,6,101,California,Sutter County,12,15,3804,1812,1992
50,6,101,California,Sutter County,12,16,2851,1243,1608
50,6,101,California,Sutter County,12,17,1888,812,1076
50,6,101,California,Sutter County,12,18,2039,817,1222
50,6,103,California,Tehama County,1,0,63463,31610,31853
50,6,103,California,Tehama County,1,1,4409,2263,2146
50,6,103,California,Tehama County,1,2,4326,2217,2109
50,6,103,California,Tehama County,1,3,4431,2242,2189
50,6,103,California,Tehama County,1,4,4654,2429,2225
50,6,103,California,Tehama County,1,5,3656,1841,1815
50,6,103,California,Tehama County,1,6,3652,1922,1730
50,6,103,California,Tehama County,1,7,3436,1779,1657
50,6,103,California,Tehama County,1,8,3551,1792,1759
50,6,103,California,Tehama County,1,9,3765,1888,1877
50,6,103,California,Tehama County,1,10,4641,2270,2371
50,6,103,California,Tehama County,1,11,4613,2268,2345
50,6,103,California,Tehama County,1,12,4197,2023,2174
50,6,103,California,Tehama County,1,13,4061,2023,2038
50,6,103,California,Tehama County,1,14,3224,1514,1710
50,6,103,California,Tehama County,1,15,2496,1197,1299
50,6,103,California,Tehama County,1,16,1899,923,976
50,6,103,California,Tehama County,1,17,1273,577,696
50,6,103,California,Tehama County,1,18,1179,442,737
50,6,103,California,Tehama County,2,0,63440,31600,31840
50,6,103,California,Tehama County,2,1,4407,2262,2145
50,6,103,California,Tehama County,2,2,4323,2216,2107
50,6,103,California,Tehama County,2,3,4430,2242,2188
50,6,103,California,Tehama County,2,4,4654,2429,2225
50,6,103,California,Tehama County,2,5,3655,1841,1814
50,6,103,California,Tehama County,2,6,3650,1920,1730
50,6,103,California,Tehama County,2,7,3431,1778,1653
50,6,103,California,Tehama County,2,8,3551,1792,1759
50,6,103,California,Tehama County,2,9,3765,1888,1877
50,6,103,California,Tehama County,2,10,4640,2269,2371
50,6,103,California,Tehama County,2,11,4612,2268,2344
50,6,103,California,Tehama County,2,12,4196,2022,2174
50,6,103,California,Tehama County,2,13,4059,2022,2037
50,6,103,California,Tehama County,2,14,3224,1514,1710
50,6,103,California,Tehama County,2,15,2494,1196,1298
50,6,103,California,Tehama County,2,16,1897,922,975
50,6,103,California,Tehama County,2,17,1273,577,696
50,6,103,California,Tehama County,2,18,1179,442,737
50,6,103,California,Tehama County,3,0,63559,31640,31919
50,6,103,California,Tehama County,3,1,4385,2248,2137
50,6,103,California,Tehama County,3,2,4322,2222,2100
50,6,103,California,Tehama County,3,3,4432,2233,2199
50,6,103,California,Tehama County,3,4,4642,2413,2229
50,6,103,California,Tehama County,3,5,3689,1861,1828
50,6,103,California,Tehama County,3,6,3652,1908,1744
50,6,103,California,Tehama County,3,7,3464,1794,1670
50,6,103,California,Tehama County,3,8,3548,1793,1755
50,6,103,California,Tehama County,3,9,3752,1886,1866
50,6,103,California,Tehama County,3,10,4612,2253,2359
50,6,103,California,Tehama County,3,11,4638,2286,2352
50,6,103,California,Tehama County,3,12,4207,2019,2188
50,6,103,California,Tehama County,3,13,4101,2044,2057
50,6,103,California,Tehama County,3,14,3228,1520,1708
50,6,103,California,Tehama County,3,15,2512,1205,1307
50,6,103,California,Tehama County,3,16,1897,924,973
50,6,103,California,Tehama County,3,17,1293,586,707
50,6,103,California,Tehama County,3,18,1185,445,740
50,6,103,California,Tehama County,4,0,63331,31560,31771
50,6,103,California,Tehama County,4,1,4207,2170,2037
50,6,103,California,Tehama County,4,2,4272,2230,2042
50,6,103,California,Tehama County,4,3,4362,2197,2165
50,6,103,California,Tehama County,4,4,4519,2338,2181
50,6,103,California,Tehama County,4,5,3718,1920,1798
50,6,103,California,Tehama County,4,6,3619,1867,1752
50,6,103,California,Tehama County,4,7,3568,1836,1732
50,6,103,California,Tehama County,4,8,3444,1765,1679
50,6,103,California,Tehama County,4,9,3666,1828,1838
50,6,103,California,Tehama County,4,10,4398,2169,2229
50,6,103,California,Tehama County,4,11,4710,2334,2376
50,6,103,California,Tehama County,4,12,4246,2002,2244
50,6,103,California,Tehama County,4,13,4290,2140,2150
50,6,103,California,Tehama County,4,14,3240,1528,1712
50,6,103,California,Tehama County,4,15,2599,1257,1342
50,6,103,California,Tehama County,4,16,1942,936,1006
50,6,103,California,Tehama County,4,17,1341,600,741
50,6,103,California,Tehama County,4,18,1190,443,747
50,6,103,California,Tehama County,5,0,63212,31509,31703
50,6,103,California,Tehama County,5,1,3990,2086,1904
50,6,103,California,Tehama County,5,2,4363,2264,2099
50,6,103,California,Tehama County,5,3,4294,2189,2105
50,6,103,California,Tehama County,5,4,4301,2197,2104
50,6,103,California,Tehama County,5,5,3735,1934,1801
50,6,103,California,Tehama County,5,6,3686,1904,1782
50,6,103,California,Tehama County,5,7,3522,1806,1716
50,6,103,California,Tehama County,5,8,3441,1792,1649
50,6,103,California,Tehama County,5,9,3640,1806,1834
50,6,103,California,Tehama County,5,10,4176,2066,2110
50,6,103,California,Tehama County,5,11,4735,2323,2412
50,6,103,California,Tehama County,5,12,4332,2069,2263
50,6,103,California,Tehama County,5,13,4204,2068,2136
50,6,103,California,Tehama County,5,14,3537,1704,1833
50,6,103,California,Tehama County,5,15,2687,1294,1393
50,6,103,California,Tehama County,5,16,1961,922,1039
50,6,103,California,Tehama County,5,17,1359,615,744
50,6,103,California,Tehama County,5,18,1249,470,779
50,6,103,California,Tehama County,6,0,62875,31302,31573
50,6,103,California,Tehama County,6,1,3883,2005,1878
50,6,103,California,Tehama County,6,2,4326,2202,2124
50,6,103,California,Tehama County,6,3,4176,2144,2032
50,6,103,California,Tehama County,6,4,4186,2137,2049
50,6,103,California,Tehama County,6,5,3839,1982,1857
50,6,103,California,Tehama County,6,6,3635,1858,1777
50,6,103,California,Tehama County,6,7,3534,1814,1720
50,6,103,California,Tehama County,6,8,3378,1779,1599
50,6,103,California,Tehama County,6,9,3571,1778,1793
50,6,103,California,Tehama County,6,10,3920,1944,1976
50,6,103,California,Tehama County,6,11,4819,2365,2454
50,6,103,California,Tehama County,6,12,4392,2124,2268
50,6,103,California,Tehama County,6,13,4114,1988,2126
50,6,103,California,Tehama County,6,14,3684,1792,1892
50,6,103,California,Tehama County,6,15,2810,1348,1462
50,6,103,California,Tehama County,6,16,2023,933,1090
50,6,103,California,Tehama County,6,17,1335,633,702
50,6,103,California,Tehama County,6,18,1250,476,774
50,6,103,California,Tehama County,7,0,62801,31201,31600
50,6,103,California,Tehama County,7,1,3901,1998,1903
50,6,103,California,Tehama County,7,2,4323,2206,2117
50,6,103,California,Tehama County,7,3,4161,2144,2017
50,6,103,California,Tehama County,7,4,4101,2111,1990
50,6,103,California,Tehama County,7,5,3866,2025,1841
50,6,103,California,Tehama County,7,6,3574,1778,1796
50,6,103,California,Tehama County,7,7,3567,1845,1722
50,6,103,California,Tehama County,7,8,3382,1749,1633
50,6,103,California,Tehama County,7,9,3500,1757,1743
50,6,103,California,Tehama County,7,10,3744,1855,1889
50,6,103,California,Tehama County,7,11,4787,2317,2470
50,6,103,California,Tehama County,7,12,4430,2164,2266
50,6,103,California,Tehama County,7,13,4095,1954,2141
50,6,103,California,Tehama County,7,14,3799,1869,1930
50,6,103,California,Tehama County,7,15,2867,1338,1529
50,6,103,California,Tehama County,7,16,2085,969,1116
50,6,103,California,Tehama County,7,17,1371,651,720
50,6,103,California,Tehama County,7,18,1248,471,777
50,6,103,California,Tehama County,8,0,63158,31402,31756
50,6,103,California,Tehama County,8,1,3929,1987,1942
50,6,103,California,Tehama County,8,2,4373,2266,2107
50,6,103,California,Tehama County,8,3,4239,2211,2028
50,6,103,California,Tehama County,8,4,3975,2017,1958
50,6,103,California,Tehama County,8,5,3814,1973,1841
50,6,103,California,Tehama County,8,6,3701,1846,1855
50,6,103,California,Tehama County,8,7,3590,1853,1737
50,6,103,California,Tehama County,8,8,3469,1790,1679
50,6,103,California,Tehama County,8,9,3453,1756,1697
50,6,103,California,Tehama County,8,10,3630,1809,1821
50,6,103,California,Tehama County,8,11,4546,2185,2361
50,6,103,California,Tehama County,8,12,4623,2261,2362
50,6,103,California,Tehama County,8,13,4137,1974,2163
50,6,103,California,Tehama County,8,14,3901,1938,1963
50,6,103,California,Tehama County,8,15,2874,1323,1551
50,6,103,California,Tehama County,8,16,2143,1032,1111
50,6,103,California,Tehama County,8,17,1437,677,760
50,6,103,California,Tehama County,8,18,1324,504,820
50,6,103,California,Tehama County,9,0,63453,31514,31939
50,6,103,California,Tehama County,9,1,4025,2001,2024
50,6,103,California,Tehama County,9,2,4344,2257,2087
50,6,103,California,Tehama County,9,3,4281,2226,2055
50,6,103,California,Tehama County,9,4,3949,2010,1939
50,6,103,California,Tehama County,9,5,3596,1891,1705
50,6,103,California,Tehama County,9,6,3854,1938,1916
50,6,103,California,Tehama County,9,7,3642,1876,1766
50,6,103,California,Tehama County,9,8,3554,1802,1752
50,6,103,California,Tehama County,9,9,3385,1739,1646
50,6,103,California,Tehama County,9,10,3599,1787,1812
50,6,103,California,Tehama County,9,11,4382,2117,2265
50,6,103,California,Tehama County,9,12,4681,2296,2385
50,6,103,California,Tehama County,9,13,4120,1942,2178
50,6,103,California,Tehama County,9,14,4103,2007,2096
50,6,103,California,Tehama County,9,15,2862,1339,1523
50,6,103,California,Tehama County,9,16,2213,1044,1169
50,6,103,California,Tehama County,9,17,1477,698,779
50,6,103,California,Tehama County,9,18,1386,544,842
50,6,103,California,Tehama County,10,0,63847,31668,32179
50,6,103,California,Tehama County,10,1,4115,2046,2069
50,6,103,California,Tehama County,10,2,4228,2193,2035
50,6,103,California,Tehama County,10,3,4398,2261,2137
50,6,103,California,Tehama County,10,4,3950,2009,1941
50,6,103,California,Tehama County,10,5,3600,1881,1719
50,6,103,California,Tehama County,10,6,3881,1976,1905
50,6,103,California,Tehama County,10,7,3696,1891,1805
50,6,103,California,Tehama County,10,8,3554,1792,1762
50,6,103,California,Tehama County,10,9,3425,1781,1644
50,6,103,California,Tehama County,10,10,3540,1744,1796
50,6,103,California,Tehama County,10,11,4186,2055,2131
50,6,103,California,Tehama County,10,12,4748,2261,2487
50,6,103,California,Tehama County,10,13,4246,2036,2210
50,6,103,California,Tehama County,10,14,3943,1910,2033
50,6,103,California,Tehama County,10,15,3113,1479,1634
50,6,103,California,Tehama County,10,16,2330,1096,1234
50,6,103,California,Tehama County,10,17,1472,682,790
50,6,103,California,Tehama County,10,18,1422,575,847
50,6,103,California,Tehama County,11,0,64018,31806,32212
50,6,103,California,Tehama County,11,1,4075,2054,2021
50,6,103,California,Tehama County,11,2,4204,2169,2035
50,6,103,California,Tehama County,11,3,4491,2298,2193
50,6,103,California,Tehama County,11,4,3913,2001,1912
50,6,103,California,Tehama County,11,5,3505,1835,1670
50,6,103,California,Tehama County,11,6,4027,2070,1957
50,6,103,California,Tehama County,11,7,3690,1880,1810
50,6,103,California,Tehama County,11,8,3651,1880,1771
50,6,103,California,Tehama County,11,9,3414,1737,1677
50,6,103,California,Tehama County,11,10,3539,1793,1746
50,6,103,California,Tehama County,11,11,3928,1929,1999
50,6,103,California,Tehama County,11,12,4796,2255,2541
50,6,103,California,Tehama County,11,13,4259,2062,2197
50,6,103,California,Tehama County,11,14,3871,1834,2037
50,6,103,California,Tehama County,11,15,3250,1563,1687
50,6,103,California,Tehama County,11,16,2429,1146,1283
50,6,103,California,Tehama County,11,17,1535,696,839
50,6,103,California,Tehama County,11,18,1441,604,837
50,6,103,California,Tehama County,12,0,65084,32366,32718
50,6,103,California,Tehama County,12,1,3974,1987,1987
50,6,103,California,Tehama County,12,2,4304,2224,2080
50,6,103,California,Tehama County,12,3,4573,2308,2265
50,6,103,California,Tehama County,12,4,4018,2112,1906
50,6,103,California,Tehama County,12,5,3461,1797,1664
50,6,103,California,Tehama County,12,6,4160,2154,2006
50,6,103,California,Tehama County,12,7,3855,1925,1930
50,6,103,California,Tehama County,12,8,3868,2034,1834
50,6,103,California,Tehama County,12,9,3504,1774,1730
50,6,103,California,Tehama County,12,10,3523,1776,1747
50,6,103,California,Tehama County,12,11,3819,1912,1907
50,6,103,California,Tehama County,12,12,4850,2277,2573
50,6,103,California,Tehama County,12,13,4395,2160,2235
50,6,103,California,Tehama County,12,14,3880,1808,2072
50,6,103,California,Tehama County,12,15,3337,1611,1726
50,6,103,California,Tehama County,12,16,2485,1140,1345
50,6,103,California,Tehama County,12,17,1607,733,874
50,6,103,California,Tehama County,12,18,1471,634,837
50,6,105,California,Trinity County,1,0,13786,7113,6673
50,6,105,California,Trinity County,1,1,618,333,285
50,6,105,California,Trinity County,1,2,640,333,307
50,6,105,California,Trinity County,1,3,744,353,391
50,6,105,California,Trinity County,1,4,789,404,385
50,6,105,California,Trinity County,1,5,544,304,240
50,6,105,California,Trinity County,1,6,641,360,281
50,6,105,California,Trinity County,1,7,630,333,297
50,6,105,California,Trinity County,1,8,664,345,319
50,6,105,California,Trinity County,1,9,724,373,351
50,6,105,California,Trinity County,1,10,1072,527,545
50,6,105,California,Trinity County,1,11,1254,613,641
50,6,105,California,Trinity County,1,12,1401,721,680
50,6,105,California,Trinity County,1,13,1296,687,609
50,6,105,California,Trinity County,1,14,1003,547,456
50,6,105,California,Trinity County,1,15,671,365,306
50,6,105,California,Trinity County,1,16,505,243,262
50,6,105,California,Trinity County,1,17,332,170,162
50,6,105,California,Trinity County,1,18,258,102,156
50,6,105,California,Trinity County,2,0,13784,7112,6672
50,6,105,California,Trinity County,2,1,618,333,285
50,6,105,California,Trinity County,2,2,640,333,307
50,6,105,California,Trinity County,2,3,744,353,391
50,6,105,California,Trinity County,2,4,789,404,385
50,6,105,California,Trinity County,2,5,544,304,240
50,6,105,California,Trinity County,2,6,641,360,281
50,6,105,California,Trinity County,2,7,630,333,297
50,6,105,California,Trinity County,2,8,664,345,319
50,6,105,California,Trinity County,2,9,724,373,351
50,6,105,California,Trinity County,2,10,1072,527,545
50,6,105,California,Trinity County,2,11,1254,613,641
50,6,105,California,Trinity County,2,12,1399,720,679
50,6,105,California,Trinity County,2,13,1296,687,609
50,6,105,California,Trinity County,2,14,1003,547,456
50,6,105,California,Trinity County,2,15,671,365,306
50,6,105,California,Trinity County,2,16,505,243,262
50,6,105,California,Trinity County,2,17,332,170,162
50,6,105,California,Trinity County,2,18,258,102,156
50,6,105,California,Trinity County,3,0,13755,7089,6666
50,6,105,California,Trinity County,3,1,608,322,286
50,6,105,California,Trinity County,3,2,652,342,310
50,6,105,California,Trinity County,3,3,730,346,384
50,6,105,California,Trinity County,3,4,784,401,383
50,6,105,California,Trinity County,3,5,548,308,240
50,6,105,California,Trinity County,3,6,638,357,281
50,6,105,California,Trinity County,3,7,631,334,297
50,6,105,California,Trinity County,3,8,663,340,323
50,6,105,California,Trinity County,3,9,723,374,349
50,6,105,California,Trinity County,3,10,1054,519,535
50,6,105,California,Trinity County,3,11,1251,605,646
50,6,105,California,Trinity County,3,12,1396,717,679
50,6,105,California,Trinity County,3,13,1308,689,619
50,6,105,California,Trinity County,3,14,997,550,447
50,6,105,California,Trinity County,3,15,676,369,307
50,6,105,California,Trinity County,3,16,503,242,261
50,6,105,California,Trinity County,3,17,336,171,165
50,6,105,California,Trinity County,3,18,257,103,154
50,6,105,California,Trinity County,4,0,13685,7052,6633
50,6,105,California,Trinity County,4,1,598,309,289
50,6,105,California,Trinity County,4,2,688,371,317
50,6,105,California,Trinity County,4,3,670,316,354
50,6,105,California,Trinity County,4,4,776,405,371
50,6,105,California,Trinity County,4,5,541,301,240
50,6,105,California,Trinity County,4,6,617,332,285
50,6,105,California,Trinity County,4,7,641,337,304
50,6,105,California,Trinity County,4,8,651,338,313
50,6,105,California,Trinity County,4,9,727,393,334
50,6,105,California,Trinity County,4,10,959,470,489
50,6,105,California,Trinity County,4,11,1245,600,645
50,6,105,California,Trinity County,4,12,1389,710,679
50,6,105,California,Trinity County,4,13,1354,700,654
50,6,105,California,Trinity County,4,14,1001,553,448
50,6,105,California,Trinity County,4,15,718,388,330
50,6,105,California,Trinity County,4,16,506,249,257
50,6,105,California,Trinity County,4,17,331,160,171
50,6,105,California,Trinity County,4,18,273,120,153
50,6,105,California,Trinity County,5,0,13489,6933,6556
50,6,105,California,Trinity County,5,1,579,284,295
50,6,105,California,Trinity County,5,2,653,367,286
50,6,105,California,Trinity County,5,3,621,293,328
50,6,105,California,Trinity County,5,4,739,380,359
50,6,105,California,Trinity County,5,5,550,316,234
50,6,105,California,Trinity County,5,6,566,305,261
50,6,105,California,Trinity County,5,7,663,347,316
50,6,105,California,Trinity County,5,8,643,324,319
50,6,105,California,Trinity County,5,9,704,376,328
50,6,105,California,Trinity County,5,10,882,448,434
50,6,105,California,Trinity County,5,11,1192,575,617
50,6,105,California,Trinity County,5,12,1386,696,690
50,6,105,California,Trinity County,5,13,1344,689,655
50,6,105,California,Trinity County,5,14,1084,592,492
50,6,105,California,Trinity County,5,15,742,392,350
50,6,105,California,Trinity County,5,16,520,268,252
50,6,105,California,Trinity County,5,17,337,160,177
50,6,105,California,Trinity County,5,18,284,121,163
50,6,105,California,Trinity County,6,0,13427,6882,6545
50,6,105,California,Trinity County,6,1,604,303,301
50,6,105,California,Trinity County,6,2,650,351,299
50,6,105,California,Trinity County,6,3,609,299,310
50,6,105,California,Trinity County,6,4,707,354,353
50,6,105,California,Trinity County,6,5,577,324,253
50,6,105,California,Trinity County,6,6,552,288,264
50,6,105,California,Trinity County,6,7,665,350,315
50,6,105,California,Trinity County,6,8,635,317,318
50,6,105,California,Trinity County,6,9,686,373,313
50,6,105,California,Trinity County,6,10,785,406,379
50,6,105,California,Trinity County,6,11,1136,551,585
50,6,105,California,Trinity County,6,12,1366,648,718
50,6,105,California,Trinity County,6,13,1346,701,645
50,6,105,California,Trinity County,6,14,1142,617,525
50,6,105,California,Trinity County,6,15,797,430,367
50,6,105,California,Trinity County,6,16,516,273,243
50,6,105,California,Trinity County,6,17,355,168,187
50,6,105,California,Trinity County,6,18,299,129,170
50,6,105,California,Trinity County,7,0,13128,6703,6425
50,6,105,California,Trinity County,7,1,582,289,293
50,6,105,California,Trinity County,7,2,607,311,296
50,6,105,California,Trinity County,7,3,603,320,283
50,6,105,California,Trinity County,7,4,674,324,350
50,6,105,California,Trinity County,7,5,579,300,279
50,6,105,California,Trinity County,7,6,526,279,247
50,6,105,California,Trinity County,7,7,664,361,303
50,6,105,California,Trinity County,7,8,613,301,312
50,6,105,California,Trinity County,7,9,645,338,307
50,6,105,California,Trinity County,7,10,721,383,338
50,6,105,California,Trinity County,7,11,1074,532,542
50,6,105,California,Trinity County,7,12,1290,606,684
50,6,105,California,Trinity County,7,13,1371,707,664
50,6,105,California,Trinity County,7,14,1162,619,543
50,6,105,California,Trinity County,7,15,828,444,384
50,6,105,California,Trinity County,7,16,519,289,230
50,6,105,California,Trinity County,7,17,374,167,207
50,6,105,California,Trinity County,7,18,296,133,163
50,6,105,California,Trinity County,8,0,13094,6742,6352
50,6,105,California,Trinity County,8,1,590,320,270
50,6,105,California,Trinity County,8,2,605,302,303
50,6,105,California,Trinity County,8,3,629,345,284
50,6,105,California,Trinity County,8,4,633,306,327
50,6,105,California,Trinity County,8,5,572,308,264
50,6,105,California,Trinity County,8,6,499,258,241
50,6,105,California,Trinity County,8,7,696,384,312
50,6,105,California,Trinity County,8,8,654,326,328
50,6,105,California,Trinity County,8,9,648,333,315
50,6,105,California,Trinity County,8,10,687,371,316
50,6,105,California,Trinity County,8,11,1018,498,520
50,6,105,California,Trinity County,8,12,1198,572,626
50,6,105,California,Trinity County,8,13,1406,711,695
50,6,105,California,Trinity County,8,14,1189,627,562
50,6,105,California,Trinity County,8,15,853,476,377
50,6,105,California,Trinity County,8,16,523,288,235
50,6,105,California,Trinity County,8,17,381,176,205
50,6,105,California,Trinity County,8,18,313,141,172
50,6,105,California,Trinity County,9,0,12828,6593,6235
50,6,105,California,Trinity County,9,1,566,311,255
50,6,105,California,Trinity County,9,2,567,286,281
50,6,105,California,Trinity County,9,3,654,365,289
50,6,105,California,Trinity County,9,4,585,290,295
50,6,105,California,Trinity County,9,5,566,296,270
50,6,105,California,Trinity County,9,6,505,255,250
50,6,105,California,Trinity County,9,7,629,329,300
50,6,105,California,Trinity County,9,8,655,333,322
50,6,105,California,Trinity County,9,9,659,342,317
50,6,105,California,Trinity County,9,10,668,356,312
50,6,105,California,Trinity County,9,11,928,455,473
50,6,105,California,Trinity County,9,12,1160,561,599
50,6,105,California,Trinity County,9,13,1374,679,695
50,6,105,California,Trinity County,9,14,1237,641,596
50,6,105,California,Trinity County,9,15,825,465,360
50,6,105,California,Trinity County,9,16,564,297,267
50,6,105,California,Trinity County,9,17,366,178,188
50,6,105,California,Trinity County,9,18,320,154,166
50,6,105,California,Trinity County,10,0,12726,6557,6169
50,6,105,California,Trinity County,10,1,557,311,246
50,6,105,California,Trinity County,10,2,593,301,292
50,6,105,California,Trinity County,10,3,651,359,292
50,6,105,California,Trinity County,10,4,584,299,285
50,6,105,California,Trinity County,10,5,527,271,256
50,6,105,California,Trinity County,10,6,509,274,235
50,6,105,California,Trinity County,10,7,600,313,287
50,6,105,California,Trinity County,10,8,681,344,337
50,6,105,California,Trinity County,10,9,646,329,317
50,6,105,California,Trinity County,10,10,659,347,312
50,6,105,California,Trinity County,10,11,881,443,438
50,6,105,California,Trinity County,10,12,1113,548,565
50,6,105,California,Trinity County,10,13,1365,672,693
50,6,105,California,Trinity County,10,14,1217,630,587
50,6,105,California,Trinity County,10,15,891,496,395
50,6,105,California,Trinity County,10,16,572,291,281
50,6,105,California,Trinity County,10,17,366,187,179
50,6,105,California,Trinity County,10,18,314,142,172
50,6,105,California,Trinity County,11,0,12567,6446,6121
50,6,105,California,Trinity County,11,1,565,307,258
50,6,105,California,Trinity County,11,2,584,301,283
50,6,105,California,Trinity County,11,3,652,361,291
50,6,105,California,Trinity County,11,4,561,289,272
50,6,105,California,Trinity County,11,5,498,259,239
50,6,105,California,Trinity County,11,6,540,271,269
50,6,105,California,Trinity County,11,7,582,301,281
50,6,105,California,Trinity County,11,8,666,339,327
50,6,105,California,Trinity County,11,9,644,315,329
50,6,105,California,Trinity County,11,10,658,357,301
50,6,105,California,Trinity County,11,11,807,415,392
50,6,105,California,Trinity County,11,12,1079,536,543
50,6,105,California,Trinity County,11,13,1292,622,670
50,6,105,California,Trinity County,11,14,1239,638,601
50,6,105,California,Trinity County,11,15,925,507,418
50,6,105,California,Trinity County,11,16,606,306,300
50,6,105,California,Trinity County,11,17,360,185,175
50,6,105,California,Trinity County,11,18,309,137,172
50,6,105,California,Trinity County,12,0,12285,6314,5971
50,6,105,California,Trinity County,12,1,568,308,260
50,6,105,California,Trinity County,12,2,577,294,283
50,6,105,California,Trinity County,12,3,620,334,286
50,6,105,California,Trinity County,12,4,535,299,236
50,6,105,California,Trinity County,12,5,489,253,236
50,6,105,California,Trinity County,12,6,559,286,273
50,6,105,California,Trinity County,12,7,514,263,251
50,6,105,California,Trinity County,12,8,660,353,307
50,6,105,California,Trinity County,12,9,662,326,336
50,6,105,California,Trinity County,12,10,642,336,306
50,6,105,California,Trinity County,12,11,738,388,350
50,6,105,California,Trinity County,12,12,1029,512,517
50,6,105,California,Trinity County,12,13,1217,574,643
50,6,105,California,Trinity County,12,14,1257,651,606
50,6,105,California,Trinity County,12,15,942,512,430
50,6,105,California,Trinity County,12,16,613,308,305
50,6,105,California,Trinity County,12,17,363,190,173
50,6,105,California,Trinity County,12,18,300,127,173
50,6,107,California,Tulare County,1,0,442179,221442,220737
50,6,107,California,Tulare County,1,1,41074,21004,20070
50,6,107,California,Tulare County,1,2,39950,20388,19562
50,6,107,California,Tulare County,1,3,38926,19801,19125
50,6,107,California,Tulare County,1,4,39043,20239,18804
50,6,107,California,Tulare County,1,5,32457,16866,15591
50,6,107,California,Tulare County,1,6,32256,16425,15831
50,6,107,California,Tulare County,1,7,29603,15023,14580
50,6,107,California,Tulare County,1,8,27770,14032,13738
50,6,107,California,Tulare County,1,9,26915,13552,13363
50,6,107,California,Tulare County,1,10,27039,13423,13616
50,6,107,California,Tulare County,1,11,25312,12615,12697
50,6,107,California,Tulare County,1,12,21657,10583,11074
50,6,107,California,Tulare County,1,13,18398,8971,9427
50,6,107,California,Tulare County,1,14,13103,6280,6823
50,6,107,California,Tulare County,1,15,9843,4549,5294
50,6,107,California,Tulare County,1,16,7682,3345,4337
50,6,107,California,Tulare County,1,17,5792,2392,3400
50,6,107,California,Tulare County,1,18,5359,1954,3405
50,6,107,California,Tulare County,2,0,442182,221443,220739
50,6,107,California,Tulare County,2,1,41075,21004,20071
50,6,107,California,Tulare County,2,2,39950,20388,19562
50,6,107,California,Tulare County,2,3,38926,19801,19125
50,6,107,California,Tulare County,2,4,39040,20236,18804
50,6,107,California,Tulare County,2,5,32457,16866,15591
50,6,107,California,Tulare County,2,6,32256,16425,15831
50,6,107,California,Tulare County,2,7,29605,15024,14581
50,6,107,California,Tulare County,2,8,27767,14031,13736
50,6,107,California,Tulare County,2,9,26917,13553,13364
50,6,107,California,Tulare County,2,10,27042,13425,13617
50,6,107,California,Tulare County,2,11,25312,12615,12697
50,6,107,California,Tulare County,2,12,21657,10583,11074
50,6,107,California,Tulare County,2,13,18398,8971,9427
50,6,107,California,Tulare County,2,14,13104,6281,6823
50,6,107,California,Tulare County,2,15,9843,4549,5294
50,6,107,California,Tulare County,2,16,7682,3345,4337
50,6,107,California,Tulare County,2,17,5792,2392,3400
50,6,107,California,Tulare County,2,18,5359,1954,3405
50,6,107,California,Tulare County,3,0,442969,221792,221177
50,6,107,California,Tulare County,3,1,40985,20968,20017
50,6,107,California,Tulare County,3,2,40013,20418,19595
50,6,107,California,Tulare County,3,3,38945,19792,19153
50,6,107,California,Tulare County,3,4,38814,20106,18708
50,6,107,California,Tulare County,3,5,32716,16997,15719
50,6,107,California,Tulare County,3,6,32222,16359,15863
50,6,107,California,Tulare County,3,7,29803,15143,14660
50,6,107,California,Tulare County,3,8,27740,13997,13743
50,6,107,California,Tulare County,3,9,26981,13597,13384
50,6,107,California,Tulare County,3,10,27011,13416,13595
50,6,107,California,Tulare County,3,11,25380,12649,12731
50,6,107,California,Tulare County,3,12,21803,10681,11122
50,6,107,California,Tulare County,3,13,18541,9018,9523
50,6,107,California,Tulare County,3,14,13241,6343,6898
50,6,107,California,Tulare County,3,15,9879,4579,5300
50,6,107,California,Tulare County,3,16,7686,3352,4334
50,6,107,California,Tulare County,3,17,5817,2412,3405
50,6,107,California,Tulare County,3,18,5392,1965,3427
50,6,107,California,Tulare County,4,0,446784,223688,223096
50,6,107,California,Tulare County,4,1,41130,21020,20110
50,6,107,California,Tulare County,4,2,40366,20624,19742
50,6,107,California,Tulare County,4,3,39056,19846,19210
50,6,107,California,Tulare County,4,4,38210,19722,18488
50,6,107,California,Tulare County,4,5,33786,17560,16226
50,6,107,California,Tulare County,4,6,32103,16201,15902
50,6,107,California,Tulare County,4,7,30490,15540,14950
50,6,107,California,Tulare County,4,8,27688,13927,13761
50,6,107,California,Tulare County,4,9,27303,13763,13540
50,6,107,California,Tulare County,4,10,26695,13334,13361
50,6,107,California,Tulare County,4,11,25636,12776,12860
50,6,107,California,Tulare County,4,12,22347,11007,11340
50,6,107,California,Tulare County,4,13,19084,9240,9844
50,6,107,California,Tulare County,4,14,13782,6612,7170
50,6,107,California,Tulare County,4,15,10123,4751,5372
50,6,107,California,Tulare County,4,16,7666,3327,4339
50,6,107,California,Tulare County,4,17,5819,2430,3389
50,6,107,California,Tulare County,4,18,5500,2008,3492
50,6,107,California,Tulare County,5,0,449779,225052,224727
50,6,107,California,Tulare County,5,1,40910,20973,19937
50,6,107,California,Tulare County,5,2,40864,20897,19967
50,6,107,California,Tulare County,5,3,39060,19772,19288
50,6,107,California,Tulare County,5,4,37634,19390,18244
50,6,107,California,Tulare County,5,5,34594,17873,16721
50,6,107,California,Tulare County,5,6,31871,16130,15741
50,6,107,California,Tulare County,5,7,31183,15861,15322
50,6,107,California,Tulare County,5,8,27797,14014,13783
50,6,107,California,Tulare County,5,9,27267,13742,13525
50,6,107,California,Tulare County,5,10,26252,13167,13085
50,6,107,California,Tulare County,5,11,25760,12818,12942
50,6,107,California,Tulare County,5,12,23005,11284,11721
50,6,107,California,Tulare County,5,13,19067,9275,9792
50,6,107,California,Tulare County,5,14,14721,7054,7667
50,6,107,California,Tulare County,5,15,10550,4947,5603
50,6,107,California,Tulare County,5,16,7768,3395,4373
50,6,107,California,Tulare County,5,17,5820,2420,3400
50,6,107,California,Tulare County,5,18,5656,2040,3616
50,6,107,California,Tulare County,6,0,452460,226333,226127
50,6,107,California,Tulare County,6,1,40351,20719,19632
50,6,107,California,Tulare County,6,2,41289,21164,20125
50,6,107,California,Tulare County,6,3,39236,19895,19341
50,6,107,California,Tulare County,6,4,36979,18938,18041
50,6,107,California,Tulare County,6,5,35145,18014,17131
50,6,107,California,Tulare County,6,6,31852,16189,15663
50,6,107,California,Tulare County,6,7,31609,16100,15509
50,6,107,California,Tulare County,6,8,28181,14119,14062
50,6,107,California,Tulare County,6,9,27209,13819,13390
50,6,107,California,Tulare County,6,10,26190,13130,13060
50,6,107,California,Tulare County,6,11,25724,12796,12928
50,6,107,California,Tulare County,6,12,23413,11481,11932
50,6,107,California,Tulare County,6,13,19411,9438,9973
50,6,107,California,Tulare County,6,14,15357,7390,7967
50,6,107,California,Tulare County,6,15,10997,5140,5857
50,6,107,California,Tulare County,6,16,8008,3530,4478
50,6,107,California,Tulare County,6,17,5763,2420,3343
50,6,107,California,Tulare County,6,18,5746,2051,3695
50,6,107,California,Tulare County,7,0,455138,227558,227580
50,6,107,California,Tulare County,7,1,40017,20544,19473
50,6,107,California,Tulare County,7,2,41464,21177,20287
50,6,107,California,Tulare County,7,3,39507,20123,19384
50,6,107,California,Tulare County,7,4,36745,18734,18011
50,6,107,California,Tulare County,7,5,35206,18049,17157
50,6,107,California,Tulare County,7,6,32139,16409,15730
50,6,107,California,Tulare County,7,7,31891,16168,15723
50,6,107,California,Tulare County,7,8,28581,14312,14269
50,6,107,California,Tulare County,7,9,27004,13696,13308
50,6,107,California,Tulare County,7,10,25961,13027,12934
50,6,107,California,Tulare County,7,11,25723,12776,12947
50,6,107,California,Tulare County,7,12,23708,11653,12055
50,6,107,California,Tulare County,7,13,19820,9522,10298
50,6,107,California,Tulare County,7,14,16112,7846,8266
50,6,107,California,Tulare County,7,15,11353,5327,6026
50,6,107,California,Tulare County,7,16,8267,3633,4634
50,6,107,California,Tulare County,7,17,5811,2454,3357
50,6,107,California,Tulare County,7,18,5829,2108,3721
50,6,107,California,Tulare County,8,0,457161,228476,228685
50,6,107,California,Tulare County,8,1,39320,20123,19197
50,6,107,California,Tulare County,8,2,41404,21189,20215
50,6,107,California,Tulare County,8,3,39755,20258,19497
50,6,107,California,Tulare County,8,4,36828,18833,17995
50,6,107,California,Tulare County,8,5,34721,17718,17003
50,6,107,California,Tulare County,8,6,32494,16572,15922
50,6,107,California,Tulare County,8,7,31993,16108,15885
50,6,107,California,Tulare County,8,8,29102,14721,14381
50,6,107,California,Tulare County,8,9,26897,13555,13342
50,6,107,California,Tulare County,8,10,25921,13075,12846
50,6,107,California,Tulare County,8,11,25659,12737,12922
50,6,107,California,Tulare County,8,12,24046,11815,12231
50,6,107,California,Tulare County,8,13,20188,9764,10424
50,6,107,California,Tulare County,8,14,16727,8059,8668
50,6,107,California,Tulare County,8,15,11791,5502,6289
50,6,107,California,Tulare County,8,16,8493,3808,4685
50,6,107,California,Tulare County,8,17,5845,2443,3402
50,6,107,California,Tulare County,8,18,5977,2196,3781
50,6,107,California,Tulare County,9,0,459235,229573,229662
50,6,107,California,Tulare County,9,1,38588,19789,18799
50,6,107,California,Tulare County,9,2,41529,21246,20283
50,6,107,California,Tulare County,9,3,39850,20361,19489
50,6,107,California,Tulare County,9,4,37046,18957,18089
50,6,107,California,Tulare County,9,5,33914,17255,16659
50,6,107,California,Tulare County,9,6,33313,17057,16256
50,6,107,California,Tulare County,9,7,31663,15914,15749
50,6,107,California,Tulare County,9,8,29936,15134,14802
50,6,107,California,Tulare County,9,9,26759,13438,13321
50,6,107,California,Tulare County,9,10,26124,13184,12940
50,6,107,California,Tulare County,9,11,25369,12666,12703
50,6,107,California,Tulare County,9,12,24243,11896,12347
50,6,107,California,Tulare County,9,13,20725,10050,10675
50,6,107,California,Tulare County,9,14,17334,8287,9047
50,6,107,California,Tulare County,9,15,12231,5699,6532
50,6,107,California,Tulare County,9,16,8646,3910,4736
50,6,107,California,Tulare County,9,17,5910,2470,3440
50,6,107,California,Tulare County,9,18,6055,2260,3795
50,6,107,California,Tulare County,10,0,462308,231249,231059
50,6,107,California,Tulare County,10,1,37684,19386,18298
50,6,107,California,Tulare County,10,2,41489,21230,20259
50,6,107,California,Tulare County,10,3,40723,20771,19952
50,6,107,California,Tulare County,10,4,37110,18971,18139
50,6,107,California,Tulare County,10,5,33592,17080,16512
50,6,107,California,Tulare County,10,6,33853,17339,16514
50,6,107,California,Tulare County,10,7,31556,15930,15626
50,6,107,California,Tulare County,10,8,30685,15554,15131
50,6,107,California,Tulare County,10,9,27045,13588,13457
50,6,107,California,Tulare County,10,10,26377,13296,13081
50,6,107,California,Tulare County,10,11,25052,12515,12537
50,6,107,California,Tulare County,10,12,24364,11992,12372
50,6,107,California,Tulare County,10,13,21354,10298,11056
50,6,107,California,Tulare County,10,14,17204,8254,8950
50,6,107,California,Tulare County,10,15,13147,6167,6980
50,6,107,California,Tulare County,10,16,8958,4044,4914
50,6,107,California,Tulare County,10,17,5996,2519,3477
50,6,107,California,Tulare County,10,18,6119,2315,3804
50,6,107,California,Tulare County,11,0,464589,232339,232250
50,6,107,California,Tulare County,11,1,36992,18953,18039
50,6,107,California,Tulare County,11,2,41184,21137,20047
50,6,107,California,Tulare County,11,3,41236,21035,20201
50,6,107,California,Tulare County,11,4,37323,19100,18223
50,6,107,California,Tulare County,11,5,33140,16710,16430
50,6,107,California,Tulare County,11,6,34464,17624,16840
50,6,107,California,Tulare County,11,7,31506,15958,15548
50,6,107,California,Tulare County,11,8,31240,15906,15334
50,6,107,California,Tulare County,11,9,27539,13739,13800
50,6,107,California,Tulare County,11,10,26151,13256,12895
50,6,107,California,Tulare County,11,11,24953,12440,12513
50,6,107,California,Tulare County,11,12,24417,12043,12374
50,6,107,California,Tulare County,11,13,21626,10453,11173
50,6,107,California,Tulare County,11,14,17547,8379,9168
50,6,107,California,Tulare County,11,15,13736,6478,7258
50,6,107,California,Tulare County,11,16,9288,4165,5123
50,6,107,California,Tulare County,11,17,6138,2614,3524
50,6,107,California,Tulare County,11,18,6109,2349,3760
50,6,107,California,Tulare County,12,0,466195,232989,233206
50,6,107,California,Tulare County,12,1,36385,18615,17770
50,6,107,California,Tulare County,12,2,40853,20873,19980
50,6,107,California,Tulare County,12,3,41320,21101,20219
50,6,107,California,Tulare County,12,4,37557,19222,18335
50,6,107,California,Tulare County,12,5,32815,16488,16327
50,6,107,California,Tulare County,12,6,34658,17670,16988
50,6,107,California,Tulare County,12,7,31751,16170,15581
50,6,107,California,Tulare County,12,8,31652,16070,15582
50,6,107,California,Tulare County,12,9,27949,13980,13969
50,6,107,California,Tulare County,12,10,25927,13097,12830
50,6,107,California,Tulare County,12,11,24745,12369,12376
50,6,107,California,Tulare County,12,12,24422,11998,12424
50,6,107,California,Tulare County,12,13,21870,10615,11255
50,6,107,California,Tulare County,12,14,17885,8470,9415
50,6,107,California,Tulare County,12,15,14306,6818,7488
50,6,107,California,Tulare County,12,16,9567,4316,5251
50,6,107,California,Tulare County,12,17,6377,2743,3634
50,6,107,California,Tulare County,12,18,6156,2374,3782
50,6,109,California,Tuolumne County,1,0,55365,29245,26120
50,6,109,California,Tuolumne County,1,1,2328,1195,1133
50,6,109,California,Tuolumne County,1,2,2501,1300,1201
50,6,109,California,Tuolumne County,1,3,2920,1505,1415
50,6,109,California,Tuolumne County,1,4,3210,1724,1486
50,6,109,California,Tuolumne County,1,5,2951,1689,1262
50,6,109,California,Tuolumne County,1,6,3185,1994,1191
50,6,109,California,Tuolumne County,1,7,2892,1758,1134
50,6,109,California,Tuolumne County,1,8,2780,1668,1112
50,6,109,California,Tuolumne County,1,9,3238,1873,1365
50,6,109,California,Tuolumne County,1,10,3912,2096,1816
50,6,109,California,Tuolumne County,1,11,4685,2377,2308
50,6,109,California,Tuolumne County,1,12,4887,2450,2437
50,6,109,California,Tuolumne County,1,13,4582,2322,2260
50,6,109,California,Tuolumne County,1,14,3487,1735,1752
50,6,109,California,Tuolumne County,1,15,2700,1310,1390
50,6,109,California,Tuolumne County,1,16,2055,997,1058
50,6,109,California,Tuolumne County,1,17,1577,687,890
50,6,109,California,Tuolumne County,1,18,1475,565,910
50,6,109,California,Tuolumne County,2,0,55368,29247,26121
50,6,109,California,Tuolumne County,2,1,2328,1195,1133
50,6,109,California,Tuolumne County,2,2,2502,1301,1201
50,6,109,California,Tuolumne County,2,3,2920,1505,1415
50,6,109,California,Tuolumne County,2,4,3210,1724,1486
50,6,109,California,Tuolumne County,2,5,2951,1689,1262
50,6,109,California,Tuolumne County,2,6,3185,1994,1191
50,6,109,California,Tuolumne County,2,7,2893,1759,1134
50,6,109,California,Tuolumne County,2,8,2780,1668,1112
50,6,109,California,Tuolumne County,2,9,3239,1873,1366
50,6,109,California,Tuolumne County,2,10,3912,2096,1816
50,6,109,California,Tuolumne County,2,11,4685,2377,2308
50,6,109,California,Tuolumne County,2,12,4887,2450,2437
50,6,109,California,Tuolumne County,2,13,4582,2322,2260
50,6,109,California,Tuolumne County,2,14,3487,1735,1752
50,6,109,California,Tuolumne County,2,15,2700,1310,1390
50,6,109,California,Tuolumne County,2,16,2055,997,1058
50,6,109,California,Tuolumne County,2,17,1577,687,890
50,6,109,California,Tuolumne County,2,18,1475,565,910
50,6,109,California,Tuolumne County,3,0,55190,29123,26067
50,6,109,California,Tuolumne County,3,1,2326,1185,1141
50,6,109,California,Tuolumne County,3,2,2498,1293,1205
50,6,109,California,Tuolumne County,3,3,2887,1487,1400
50,6,109,California,Tuolumne County,3,4,3163,1692,1471
50,6,109,California,Tuolumne County,3,5,2968,1707,1261
50,6,109,California,Tuolumne County,3,6,3179,1982,1197
50,6,109,California,Tuolumne County,3,7,2897,1752,1145
50,6,109,California,Tuolumne County,3,8,2731,1637,1094
50,6,109,California,Tuolumne County,3,9,3224,1871,1353
50,6,109,California,Tuolumne County,3,10,3847,2067,1780
50,6,109,California,Tuolumne County,3,11,4629,2350,2279
50,6,109,California,Tuolumne County,3,12,4886,2436,2450
50,6,109,California,Tuolumne County,3,13,4596,2331,2265
50,6,109,California,Tuolumne County,3,14,3526,1756,1770
50,6,109,California,Tuolumne County,3,15,2720,1325,1395
50,6,109,California,Tuolumne County,3,16,2058,991,1067
50,6,109,California,Tuolumne County,3,17,1577,689,888
50,6,109,California,Tuolumne County,3,18,1478,572,906
50,6,109,California,Tuolumne County,4,0,54830,28836,25994
50,6,109,California,Tuolumne County,4,1,2279,1157,1122
50,6,109,California,Tuolumne County,4,2,2484,1276,1208
50,6,109,California,Tuolumne County,4,3,2762,1428,1334
50,6,109,California,Tuolumne County,4,4,3015,1595,1420
50,6,109,California,Tuolumne County,4,5,3052,1763,1289
50,6,109,California,Tuolumne County,4,6,3169,1936,1233
50,6,109,California,Tuolumne County,4,7,3022,1816,1206
50,6,109,California,Tuolumne County,4,8,2597,1545,1052
50,6,109,California,Tuolumne County,4,9,3183,1849,1334
50,6,109,California,Tuolumne County,4,10,3595,1961,1634
50,6,109,California,Tuolumne County,4,11,4470,2279,2191
50,6,109,California,Tuolumne County,4,12,4872,2388,2484
50,6,109,California,Tuolumne County,4,13,4749,2403,2346
50,6,109,California,Tuolumne County,4,14,3677,1835,1842
50,6,109,California,Tuolumne County,4,15,2792,1359,1433
50,6,109,California,Tuolumne County,4,16,2042,977,1065
50,6,109,California,Tuolumne County,4,17,1563,683,880
50,6,109,California,Tuolumne County,4,18,1507,586,921
50,6,109,California,Tuolumne County,5,0,54221,28431,25790
50,6,109,California,Tuolumne County,5,1,2276,1144,1132
50,6,109,California,Tuolumne County,5,2,2507,1302,1205
50,6,109,California,Tuolumne County,5,3,2630,1357,1273
50,6,109,California,Tuolumne County,5,4,2921,1540,1381
50,6,109,California,Tuolumne County,5,5,3114,1804,1310
50,6,109,California,Tuolumne County,5,6,3106,1873,1233
50,6,109,California,Tuolumne County,5,7,3018,1805,1213
50,6,109,California,Tuolumne County,5,8,2568,1518,1050
50,6,109,California,Tuolumne County,5,9,3072,1773,1299
50,6,109,California,Tuolumne County,5,10,3359,1845,1514
50,6,109,California,Tuolumne County,5,11,4224,2152,2072
50,6,109,California,Tuolumne County,5,12,4780,2311,2469
50,6,109,California,Tuolumne County,5,13,4640,2357,2283
50,6,109,California,Tuolumne County,5,14,3985,1971,2014
50,6,109,California,Tuolumne County,5,15,2873,1401,1472
50,6,109,California,Tuolumne County,5,16,2070,1000,1070
50,6,109,California,Tuolumne County,5,17,1540,692,848
50,6,109,California,Tuolumne County,5,18,1538,586,952
50,6,109,California,Tuolumne County,6,0,53997,28190,25807
50,6,109,California,Tuolumne County,6,1,2323,1172,1151
50,6,109,California,Tuolumne County,6,2,2487,1275,1212
50,6,109,California,Tuolumne County,6,3,2549,1343,1206
50,6,109,California,Tuolumne County,6,4,2834,1478,1356
50,6,109,California,Tuolumne County,6,5,3125,1780,1345
50,6,109,California,Tuolumne County,6,6,2976,1786,1190
50,6,109,California,Tuolumne County,6,7,3115,1835,1280
50,6,109,California,Tuolumne County,6,8,2591,1503,1088
50,6,109,California,Tuolumne County,6,9,2954,1690,1264
50,6,109,California,Tuolumne County,6,10,3199,1779,1420
50,6,109,California,Tuolumne County,6,11,4042,2022,2020
50,6,109,California,Tuolumne County,6,12,4710,2290,2420
50,6,109,California,Tuolumne County,6,13,4739,2371,2368
50,6,109,California,Tuolumne County,6,14,4132,2052,2080
50,6,109,California,Tuolumne County,6,15,2981,1459,1522
50,6,109,California,Tuolumne County,6,16,2141,1028,1113
50,6,109,California,Tuolumne County,6,17,1562,741,821
50,6,109,California,Tuolumne County,6,18,1537,586,951
50,6,109,California,Tuolumne County,7,0,53851,28113,25738
50,6,109,California,Tuolumne County,7,1,2354,1190,1164
50,6,109,California,Tuolumne County,7,2,2454,1272,1182
50,6,109,California,Tuolumne County,7,3,2526,1335,1191
50,6,109,California,Tuolumne County,7,4,2752,1454,1298
50,6,109,California,Tuolumne County,7,5,3002,1738,1264
50,6,109,California,Tuolumne County,7,6,3067,1813,1254
50,6,109,California,Tuolumne County,7,7,3125,1839,1286
50,6,109,California,Tuolumne County,7,8,2730,1576,1154
50,6,109,California,Tuolumne County,7,9,2848,1655,1193
50,6,109,California,Tuolumne County,7,10,3103,1689,1414
50,6,109,California,Tuolumne County,7,11,3836,1928,1908
50,6,109,California,Tuolumne County,7,12,4613,2271,2342
50,6,109,California,Tuolumne County,7,13,4765,2336,2429
50,6,109,California,Tuolumne County,7,14,4258,2125,2133
50,6,109,California,Tuolumne County,7,15,3104,1497,1607
50,6,109,California,Tuolumne County,7,16,2214,1068,1146
50,6,109,California,Tuolumne County,7,17,1538,714,824
50,6,109,California,Tuolumne County,7,18,1562,613,949
50,6,109,California,Tuolumne County,8,0,53615,27861,25754
50,6,109,California,Tuolumne County,8,1,2409,1231,1178
50,6,109,California,Tuolumne County,8,2,2394,1246,1148
50,6,109,California,Tuolumne County,8,3,2492,1285,1207
50,6,109,California,Tuolumne County,8,4,2650,1406,1244
50,6,109,California,Tuolumne County,8,5,2932,1656,1276
50,6,109,California,Tuolumne County,8,6,3114,1828,1286
50,6,109,California,Tuolumne County,8,7,3109,1828,1281
50,6,109,California,Tuolumne County,8,8,2763,1556,1207
50,6,109,California,Tuolumne County,8,9,2744,1581,1163
50,6,109,California,Tuolumne County,8,10,2993,1642,1351
50,6,109,California,Tuolumne County,8,11,3657,1829,1828
50,6,109,California,Tuolumne County,8,12,4483,2207,2276
50,6,109,California,Tuolumne County,8,13,4850,2373,2477
50,6,109,California,Tuolumne County,8,14,4387,2198,2189
50,6,109,California,Tuolumne County,8,15,3228,1568,1660
50,6,109,California,Tuolumne County,8,16,2331,1119,1212
50,6,109,California,Tuolumne County,8,17,1527,688,839
50,6,109,California,Tuolumne County,8,18,1552,620,932
50,6,109,California,Tuolumne County,9,0,53770,27899,25871
50,6,109,California,Tuolumne County,9,1,2382,1170,1212
50,6,109,California,Tuolumne County,9,2,2434,1269,1165
50,6,109,California,Tuolumne County,9,3,2518,1300,1218
50,6,109,California,Tuolumne County,9,4,2575,1361,1214
50,6,109,California,Tuolumne County,9,5,2859,1613,1246
50,6,109,California,Tuolumne County,9,6,3229,1915,1314
50,6,109,California,Tuolumne County,9,7,3090,1777,1313
50,6,109,California,Tuolumne County,9,8,2901,1653,1248
50,6,109,California,Tuolumne County,9,9,2671,1552,1119
50,6,109,California,Tuolumne County,9,10,3021,1660,1361
50,6,109,California,Tuolumne County,9,11,3501,1768,1733
50,6,109,California,Tuolumne County,9,12,4343,2132,2211
50,6,109,California,Tuolumne County,9,13,4888,2362,2526
50,6,109,California,Tuolumne County,9,14,4538,2272,2266
50,6,109,California,Tuolumne County,9,15,3347,1652,1695
50,6,109,California,Tuolumne County,9,16,2403,1148,1255
50,6,109,California,Tuolumne County,9,17,1538,701,837
50,6,109,California,Tuolumne County,9,18,1532,594,938
50,6,109,California,Tuolumne County,10,0,53976,28002,25974
50,6,109,California,Tuolumne County,10,1,2350,1140,1210
50,6,109,California,Tuolumne County,10,2,2481,1278,1203
50,6,109,California,Tuolumne County,10,3,2584,1365,1219
50,6,109,California,Tuolumne County,10,4,2524,1334,1190
50,6,109,California,Tuolumne County,10,5,2739,1546,1193
50,6,109,California,Tuolumne County,10,6,3351,1974,1377
50,6,109,California,Tuolumne County,10,7,3116,1796,1320
50,6,109,California,Tuolumne County,10,8,3042,1746,1296
50,6,109,California,Tuolumne County,10,9,2715,1571,1144
50,6,109,California,Tuolumne County,10,10,2957,1621,1336
50,6,109,California,Tuolumne County,10,11,3354,1727,1627
50,6,109,California,Tuolumne County,10,12,4178,2038,2140
50,6,109,California,Tuolumne County,10,13,4803,2276,2527
50,6,109,California,Tuolumne County,10,14,4516,2279,2237
50,6,109,California,Tuolumne County,10,15,3695,1788,1907
50,6,109,California,Tuolumne County,10,16,2430,1165,1265
50,6,109,California,Tuolumne County,10,17,1587,745,842
50,6,109,California,Tuolumne County,10,18,1554,613,941
50,6,109,California,Tuolumne County,11,0,54387,28206,26181
50,6,109,California,Tuolumne County,11,1,2403,1184,1219
50,6,109,California,Tuolumne County,11,2,2532,1280,1252
50,6,109,California,Tuolumne County,11,3,2630,1376,1254
50,6,109,California,Tuolumne County,11,4,2500,1312,1188
50,6,109,California,Tuolumne County,11,5,2687,1537,1150
50,6,109,California,Tuolumne County,11,6,3370,1960,1410
50,6,109,California,Tuolumne County,11,7,3119,1807,1312
50,6,109,California,Tuolumne County,11,8,3197,1811,1386
50,6,109,California,Tuolumne County,11,9,2823,1630,1193
50,6,109,California,Tuolumne County,11,10,2900,1598,1302
50,6,109,California,Tuolumne County,11,11,3176,1663,1513
50,6,109,California,Tuolumne County,11,12,4051,1937,2114
50,6,109,California,Tuolumne County,11,13,4771,2310,2461
50,6,109,California,Tuolumne County,11,14,4591,2272,2319
50,6,109,California,Tuolumne County,11,15,3845,1888,1957
50,6,109,California,Tuolumne County,11,16,2528,1209,1319
50,6,109,California,Tuolumne County,11,17,1664,782,882
50,6,109,California,Tuolumne County,11,18,1600,650,950
50,6,109,California,Tuolumne County,12,0,54478,28213,26265
50,6,109,California,Tuolumne County,12,1,2408,1192,1216
50,6,109,California,Tuolumne County,12,2,2550,1270,1280
50,6,109,California,Tuolumne County,12,3,2656,1374,1282
50,6,109,California,Tuolumne County,12,4,2485,1293,1192
50,6,109,California,Tuolumne County,12,5,2606,1508,1098
50,6,109,California,Tuolumne County,12,6,3318,1956,1362
50,6,109,California,Tuolumne County,12,7,3205,1815,1390
50,6,109,California,Tuolumne County,12,8,3194,1814,1380
50,6,109,California,Tuolumne County,12,9,2907,1672,1235
50,6,109,California,Tuolumne County,12,10,2824,1573,1251
50,6,109,California,Tuolumne County,12,11,3049,1584,1465
50,6,109,California,Tuolumne County,12,12,3862,1843,2019
50,6,109,California,Tuolumne County,12,13,4705,2303,2402
50,6,109,California,Tuolumne County,12,14,4705,2289,2416
50,6,109,California,Tuolumne County,12,15,3985,1980,2005
50,6,109,California,Tuolumne County,12,16,2636,1254,1382
50,6,109,California,Tuolumne County,12,17,1744,817,927
50,6,109,California,Tuolumne County,12,18,1639,676,963
50,6,111,California,Ventura County,1,0,823318,408969,414349
50,6,111,California,Ventura County,1,1,55336,28201,27135
50,6,111,California,Ventura County,1,2,56970,28896,28074
50,6,111,California,Ventura County,1,3,60390,31030,29360
50,6,111,California,Ventura County,1,4,64407,33362,31045
50,6,111,California,Ventura County,1,5,56183,29798,26385
50,6,111,California,Ventura County,1,6,54253,28199,26054
50,6,111,California,Ventura County,1,7,51207,25967,25240
50,6,111,California,Ventura County,1,8,53448,26440,27008
50,6,111,California,Ventura County,1,9,57635,28773,28862
50,6,111,California,Ventura County,1,10,62731,30836,31895
50,6,111,California,Ventura County,1,11,60973,29911,31062
50,6,111,California,Ventura County,1,12,51164,24996,26168
50,6,111,California,Ventura County,1,13,42312,20493,21819
50,6,111,California,Ventura County,1,14,29834,14162,15672
50,6,111,California,Ventura County,1,15,21562,9808,11754
50,6,111,California,Ventura County,1,16,17443,7765,9678
50,6,111,California,Ventura County,1,17,13427,5477,7950
50,6,111,California,Ventura County,1,18,14043,4855,9188
50,6,111,California,Ventura County,2,0,823398,409044,414354
50,6,111,California,Ventura County,2,1,55337,28201,27136
50,6,111,California,Ventura County,2,2,56969,28897,28072
50,6,111,California,Ventura County,2,3,60390,31030,29360
50,6,111,California,Ventura County,2,4,64404,33362,31042
50,6,111,California,Ventura County,2,5,56198,29807,26391
50,6,111,California,Ventura County,2,6,54270,28211,26059
50,6,111,California,Ventura County,2,7,51214,25973,25241
50,6,111,California,Ventura County,2,8,53463,26451,27012
50,6,111,California,Ventura County,2,9,57647,28785,28862
50,6,111,California,Ventura County,2,10,62738,30840,31898
50,6,111,California,Ventura County,2,11,60980,29917,31063
50,6,111,California,Ventura County,2,12,51171,25006,26165
50,6,111,California,Ventura County,2,13,42319,20501,21818
50,6,111,California,Ventura County,2,14,29825,14159,15666
50,6,111,California,Ventura County,2,15,21561,9807,11754
50,6,111,California,Ventura County,2,16,17444,7765,9679
50,6,111,California,Ventura County,2,17,13426,5477,7949
50,6,111,California,Ventura County,2,18,14042,4855,9187
50,6,111,California,Ventura County,3,0,825097,409785,415312
50,6,111,California,Ventura County,3,1,55398,28238,27160
50,6,111,California,Ventura County,3,2,56991,28936,28055
50,6,111,California,Ventura County,3,3,60154,30863,29291
50,6,111,California,Ventura County,3,4,64089,33150,30939
50,6,111,California,Ventura County,3,5,56599,29961,26638
50,6,111,California,Ventura County,3,6,54433,28290,26143
50,6,111,California,Ventura County,3,7,51560,26194,25366
50,6,111,California,Ventura County,3,8,53132,26252,26880
50,6,111,California,Ventura County,3,9,57668,28816,28852
50,6,111,California,Ventura County,3,10,62494,30734,31760
50,6,111,California,Ventura County,3,11,61171,29994,31177
50,6,111,California,Ventura County,3,12,51614,25226,26388
50,6,111,California,Ventura County,3,13,42761,20698,22063
50,6,111,California,Ventura County,3,14,30164,14333,15831
50,6,111,California,Ventura County,3,15,21745,9907,11838
50,6,111,California,Ventura County,3,16,17476,7780,9696
50,6,111,California,Ventura County,3,17,13479,5515,7964
50,6,111,California,Ventura County,3,18,14169,4898,9271
50,6,111,California,Ventura County,4,0,830099,411839,418260
50,6,111,California,Ventura County,4,1,55090,28018,27072
50,6,111,California,Ventura County,4,2,57294,29146,28148
50,6,111,California,Ventura County,4,3,59209,30208,29001
50,6,111,California,Ventura County,4,4,62720,32327,30393
50,6,111,California,Ventura County,4,5,58142,30559,27583
50,6,111,California,Ventura County,4,6,54678,28433,26245
50,6,111,California,Ventura County,4,7,52387,26727,25660
50,6,111,California,Ventura County,4,8,51549,25437,26112
50,6,111,California,Ventura County,4,9,57715,28859,28856
50,6,111,California,Ventura County,4,10,60975,30023,30952
50,6,111,California,Ventura County,4,11,62030,30389,31641
50,6,111,California,Ventura County,4,12,53255,25998,27257
50,6,111,California,Ventura County,4,13,44774,21658,23116
50,6,111,California,Ventura County,4,14,31564,15016,16548
50,6,111,California,Ventura County,4,15,22652,10394,12258
50,6,111,California,Ventura County,4,16,17734,7872,9862
50,6,111,California,Ventura County,4,17,13610,5625,7985
50,6,111,California,Ventura County,4,18,14721,5150,9571
50,6,111,California,Ventura County,5,0,833516,413087,420429
50,6,111,California,Ventura County,5,1,54514,27709,26805
50,6,111,California,Ventura County,5,2,57514,29242,28272
50,6,111,California,Ventura County,5,3,58322,29690,28632
50,6,111,California,Ventura County,5,4,61349,31562,29787
50,6,111,California,Ventura County,5,5,59528,30828,28700
50,6,111,California,Ventura County,5,6,54501,28453,26048
50,6,111,California,Ventura County,5,7,52875,27038,25837
50,6,111,California,Ventura County,5,8,51182,25298,25884
50,6,111,California,Ventura County,5,9,56925,28368,28557
50,6,111,California,Ventura County,5,10,59622,29444,30178
50,6,111,California,Ventura County,5,11,62032,30382,31650
50,6,111,California,Ventura County,5,12,55038,26965,28073
50,6,111,California,Ventura County,5,13,44663,21462,23201
50,6,111,California,Ventura County,5,14,34538,16491,18047
50,6,111,California,Ventura County,5,15,23915,11093,12822
50,6,111,California,Ventura County,5,16,17981,7891,10090
50,6,111,California,Ventura County,5,17,13882,5847,8035
50,6,111,California,Ventura County,5,18,15135,5324,9811
50,6,111,California,Ventura County,6,0,838136,414997,423139
50,6,111,California,Ventura County,6,1,53795,27374,26421
50,6,111,California,Ventura County,6,2,57494,29240,28254
50,6,111,California,Ventura County,6,3,57999,29430,28569
50,6,111,California,Ventura County,6,4,60230,30869,29361
50,6,111,California,Ventura County,6,5,60739,31381,29358
50,6,111,California,Ventura County,6,6,54531,28470,26061
50,6,111,California,Ventura County,6,7,53667,27474,26193
50,6,111,California,Ventura County,6,8,50938,25203,25735
50,6,111,California,Ventura County,6,9,56155,27839,28316
50,6,111,California,Ventura County,6,10,58413,28867,29546
50,6,111,California,Ventura County,6,11,61907,30273,31634
50,6,111,California,Ventura County,6,12,56578,27832,28746
50,6,111,California,Ventura County,6,13,45779,21915,23864
50,6,111,California,Ventura County,6,14,36291,17371,18920
50,6,111,California,Ventura County,6,15,25552,11826,13726
50,6,111,California,Ventura County,6,16,18470,8118,10352
50,6,111,California,Ventura County,6,17,14122,6003,8119
50,6,111,California,Ventura County,6,18,15476,5512,9964
50,6,111,California,Ventura County,7,0,842297,416731,425566
50,6,111,California,Ventura County,7,1,53379,27251,26128
50,6,111,California,Ventura County,7,2,56922,28854,28068
50,6,111,California,Ventura County,7,3,57744,29199,28545
50,6,111,California,Ventura County,7,4,59229,30394,28835
50,6,111,California,Ventura County,7,5,61269,31452,29817
50,6,111,California,Ventura County,7,6,55259,28781,26478
50,6,111,California,Ventura County,7,7,54072,27741,26331
50,6,111,California,Ventura County,7,8,51460,25484,25976
50,6,111,California,Ventura County,7,9,54701,27105,27596
50,6,111,California,Ventura County,7,10,57283,28339,28944
50,6,111,California,Ventura County,7,11,61835,30308,31527
50,6,111,California,Ventura County,7,12,57638,28258,29380
50,6,111,California,Ventura County,7,13,47213,22659,24554
50,6,111,California,Ventura County,7,14,38199,18222,19977
50,6,111,California,Ventura County,7,15,26952,12507,14445
50,6,111,California,Ventura County,7,16,19028,8365,10663
50,6,111,California,Ventura County,7,17,14330,6149,8181
50,6,111,California,Ventura County,7,18,15784,5663,10121
50,6,111,California,Ventura County,8,0,845802,418646,427156
50,6,111,California,Ventura County,8,1,52867,27030,25837
50,6,111,California,Ventura County,8,2,56167,28433,27734
50,6,111,California,Ventura County,8,3,57294,28979,28315
50,6,111,California,Ventura County,8,4,58414,29912,28502
50,6,111,California,Ventura County,8,5,60676,31134,29542
50,6,111,California,Ventura County,8,6,56678,29548,27130
50,6,111,California,Ventura County,8,7,54111,27848,26263
50,6,111,California,Ventura County,8,8,52239,26114,26125
50,6,111,California,Ventura County,8,9,53091,26103,26988
50,6,111,California,Ventura County,8,10,57099,28381,28718
50,6,111,California,Ventura County,8,11,60865,29879,30986
50,6,111,California,Ventura County,8,12,58539,28635,29904
50,6,111,California,Ventura County,8,13,48850,23528,25322
50,6,111,California,Ventura County,8,14,40177,19177,21000
50,6,111,California,Ventura County,8,15,28305,13114,15191
50,6,111,California,Ventura County,8,16,19682,8675,11007
50,6,111,California,Ventura County,8,17,14582,6264,8318
50,6,111,California,Ventura County,8,18,16166,5892,10274
50,6,111,California,Ventura County,9,0,847323,419522,427801
50,6,111,California,Ventura County,9,1,51704,26476,25228
50,6,111,California,Ventura County,9,2,55398,28142,27256
50,6,111,California,Ventura County,9,3,57284,29062,28222
50,6,111,California,Ventura County,9,4,57564,29391,28173
50,6,111,California,Ventura County,9,5,59241,30323,28918
50,6,111,California,Ventura County,9,6,58068,30296,27772
50,6,111,California,Ventura County,9,7,54267,27984,26283
50,6,111,California,Ventura County,9,8,52870,26605,26265
50,6,111,California,Ventura County,9,9,51682,25378,26304
50,6,111,California,Ventura County,9,10,57062,28242,28820
50,6,111,California,Ventura County,9,11,59286,29240,30046
50,6,111,California,Ventura County,9,12,59369,28975,30394
50,6,111,California,Ventura County,9,13,50239,24237,26002
50,6,111,California,Ventura County,9,14,41953,19952,22001
50,6,111,California,Ventura County,9,15,29428,13683,15745
50,6,111,California,Ventura County,9,16,20522,9092,11430
50,6,111,California,Ventura County,9,17,14885,6365,8520
50,6,111,California,Ventura County,9,18,16501,6079,10422
50,6,111,California,Ventura County,10,0,849044,420263,428781
50,6,111,California,Ventura County,10,1,50855,26003,24852
50,6,111,California,Ventura County,10,2,54452,27585,26867
50,6,111,California,Ventura County,10,3,57078,29005,28073
50,6,111,California,Ventura County,10,4,56995,28986,28009
50,6,111,California,Ventura County,10,5,57980,29585,28395
50,6,111,California,Ventura County,10,6,59139,30697,28442
50,6,111,California,Ventura County,10,7,54510,28196,26314
50,6,111,California,Ventura County,10,8,53522,27128,26394
50,6,111,California,Ventura County,10,9,51356,25280,26076
50,6,111,California,Ventura County,10,10,56402,27866,28536
50,6,111,California,Ventura County,10,11,57955,28629,29326
50,6,111,California,Ventura County,10,12,59471,29038,30433
50,6,111,California,Ventura County,10,13,51829,25170,26659
50,6,111,California,Ventura County,10,14,41824,19759,22065
50,6,111,California,Ventura County,10,15,32024,14960,17064
50,6,111,California,Ventura County,10,16,21621,9675,11946
50,6,111,California,Ventura County,10,17,15127,6352,8775
50,6,111,California,Ventura County,10,18,16904,6349,10555
50,6,111,California,Ventura County,11,0,848142,419784,428358
50,6,111,California,Ventura County,11,1,49539,25378,24161
50,6,111,California,Ventura County,11,2,53717,27146,26571
50,6,111,California,Ventura County,11,3,56696,28874,27822
50,6,111,California,Ventura County,11,4,56246,28602,27644
50,6,111,California,Ventura County,11,5,56769,28923,27846
50,6,111,California,Ventura County,11,6,59544,30800,28744
50,6,111,California,Ventura County,11,7,54528,28283,26245
50,6,111,California,Ventura County,11,8,54183,27487,26696
50,6,111,California,Ventura County,11,9,51052,25105,25947
50,6,111,California,Ventura County,11,10,55370,27320,28050
50,6,111,California,Ventura County,11,11,56644,28048,28596
50,6,111,California,Ventura County,11,12,58959,28797,30162
50,6,111,California,Ventura County,11,13,52978,25882,27096
50,6,111,California,Ventura County,11,14,42475,20009,22466
50,6,111,California,Ventura County,11,15,33576,15782,17794
50,6,111,California,Ventura County,11,16,23062,10303,12759
50,6,111,California,Ventura County,11,17,15489,6532,8957
50,6,111,California,Ventura County,11,18,17315,6513,10802
50,6,111,California,Ventura County,12,0,846006,418712,427294
50,6,111,California,Ventura County,12,1,48393,24757,23636
50,6,111,California,Ventura County,12,2,52940,26917,26023
50,6,111,California,Ventura County,12,3,55645,28280,27365
50,6,111,California,Ventura County,12,4,55653,28228,27425
50,6,111,California,Ventura County,12,5,55691,28333,27358
50,6,111,California,Ventura County,12,6,59565,30732,28833
50,6,111,California,Ventura County,12,7,54705,28422,26283
50,6,111,California,Ventura County,12,8,54091,27495,26596
50,6,111,California,Ventura County,12,9,51125,25295,25830
50,6,111,California,Ventura County,12,10,53784,26475,27309
50,6,111,California,Ventura County,12,11,55519,27488,28031
50,6,111,California,Ventura County,12,12,58538,28660,29878
50,6,111,California,Ventura County,12,13,53652,26170,27482
50,6,111,California,Ventura County,12,14,43558,20597,22961
50,6,111,California,Ventura County,12,15,35212,16524,18688
50,6,111,California,Ventura County,12,16,24223,10885,13338
50,6,111,California,Ventura County,12,17,15969,6778,9191
50,6,111,California,Ventura County,12,18,17743,6676,11067
50,6,113,California,Yolo County,1,0,200849,97935,102914
50,6,113,California,Yolo County,1,1,12577,6429,6148
50,6,113,California,Yolo County,1,2,12235,6195,6040
50,6,113,California,Yolo County,1,3,12693,6545,6148
50,6,113,California,Yolo County,1,4,19318,9330,9988
50,6,113,California,Yolo County,1,5,27185,13212,13973
50,6,113,California,Yolo County,1,6,15141,7577,7564
50,6,113,California,Yolo County,1,7,13027,6523,6504
50,6,113,California,Yolo County,1,8,11827,5918,5909
50,6,113,California,Yolo County,1,9,12086,5936,6150
50,6,113,California,Yolo County,1,10,12524,6056,6468
50,6,113,California,Yolo County,1,11,12306,5897,6409
50,6,113,California,Yolo County,1,12,11193,5408,5785
50,6,113,California,Yolo County,1,13,8966,4310,4656
50,6,113,California,Yolo County,1,14,6163,2892,3271
50,6,113,California,Yolo County,1,15,4407,1988,2419
50,6,113,California,Yolo County,1,16,3485,1559,1926
50,6,113,California,Yolo County,1,17,2742,1127,1615
50,6,113,California,Yolo County,1,18,2974,1033,1941
50,6,113,California,Yolo County,2,0,200855,97939,102916
50,6,113,California,Yolo County,2,1,12578,6430,6148
50,6,113,California,Yolo County,2,2,12235,6195,6040
50,6,113,California,Yolo County,2,3,12695,6547,6148
50,6,113,California,Yolo County,2,4,19318,9330,9988
50,6,113,California,Yolo County,2,5,27185,13212,13973
50,6,113,California,Yolo County,2,6,15141,7577,7564
50,6,113,California,Yolo County,2,7,13029,6524,6505
50,6,113,California,Yolo County,2,8,11827,5918,5909
50,6,113,California,Yolo County,2,9,12086,5936,6150
50,6,113,California,Yolo County,2,10,12525,6056,6469
50,6,113,California,Yolo County,2,11,12306,5897,6409
50,6,113,California,Yolo County,2,12,11193,5408,5785
50,6,113,California,Yolo County,2,13,8966,4310,4656
50,6,113,California,Yolo County,2,14,6163,2892,3271
50,6,113,California,Yolo County,2,15,4407,1988,2419
50,6,113,California,Yolo County,2,16,3485,1559,1926
50,6,113,California,Yolo County,2,17,2742,1127,1615
50,6,113,California,Yolo County,2,18,2974,1033,1941
50,6,113,California,Yolo County,3,0,201073,97996,103077
50,6,113,California,Yolo County,3,1,12512,6398,6114
50,6,113,California,Yolo County,3,2,12256,6195,6061
50,6,113,California,Yolo County,3,3,12644,6523,6121
50,6,113,California,Yolo County,3,4,19150,9239,9911
50,6,113,California,Yolo County,3,5,27682,13412,14270
50,6,113,California,Yolo County,3,6,14973,7509,7464
50,6,113,California,Yolo County,3,7,13047,6535,6512
50,6,113,California,Yolo County,3,8,11797,5892,5905
50,6,113,California,Yolo County,3,9,12017,5907,6110
50,6,113,California,Yolo County,3,10,12456,6031,6425
50,6,113,California,Yolo County,3,11,12326,5911,6415
50,6,113,California,Yolo County,3,12,11214,5402,5812
50,6,113,California,Yolo County,3,13,9065,4359,4706
50,6,113,California,Yolo County,3,14,6208,2910,3298
50,6,113,California,Yolo County,3,15,4488,2040,2448
50,6,113,California,Yolo County,3,16,3487,1545,1942
50,6,113,California,Yolo County,3,17,2755,1136,1619
50,6,113,California,Yolo County,3,18,2996,1052,1944
50,6,113,California,Yolo County,4,0,201954,98347,103607
50,6,113,California,Yolo County,4,1,12361,6317,6044
50,6,113,California,Yolo County,4,2,12392,6255,6137
50,6,113,California,Yolo County,4,3,12481,6428,6053
50,6,113,California,Yolo County,4,4,18705,8989,9716
50,6,113,California,Yolo County,4,5,29108,13949,15159
50,6,113,California,Yolo County,4,6,14273,7299,6974
50,6,113,California,Yolo County,4,7,13255,6621,6634
50,6,113,California,Yolo County,4,8,11687,5834,5853
50,6,113,California,Yolo County,4,9,11901,5851,6050
50,6,113,California,Yolo County,4,10,12245,5953,6292
50,6,113,California,Yolo County,4,11,12366,5975,6391
50,6,113,California,Yolo County,4,12,11257,5397,5860
50,6,113,California,Yolo County,4,13,9463,4525,4938
50,6,113,California,Yolo County,4,14,6426,3001,3425
50,6,113,California,Yolo County,4,15,4673,2168,2505
50,6,113,California,Yolo County,4,16,3512,1520,1992
50,6,113,California,Yolo County,4,17,2789,1184,1605
50,6,113,California,Yolo County,4,18,3060,1081,1979
50,6,113,California,Yolo County,5,0,204576,99604,104972
50,6,113,California,Yolo County,5,1,12145,6210,5935
50,6,113,California,Yolo County,5,2,12761,6483,6278
50,6,113,California,Yolo County,5,3,12375,6323,6052
50,6,113,California,Yolo County,5,4,19398,9253,10145
50,6,113,California,Yolo County,5,5,30077,14361,15716
50,6,113,California,Yolo County,5,6,13774,7102,6672
50,6,113,California,Yolo County,5,7,13649,6821,6828
50,6,113,California,Yolo County,5,8,11732,5888,5844
50,6,113,California,Yolo County,5,9,11938,5861,6077
50,6,113,California,Yolo County,5,10,11956,5849,6107
50,6,113,California,Yolo County,5,11,12314,5974,6340
50,6,113,California,Yolo County,5,12,11493,5519,5974
50,6,113,California,Yolo County,5,13,9438,4496,4942
50,6,113,California,Yolo County,5,14,7031,3279,3752
50,6,113,California,Yolo County,5,15,4897,2298,2599
50,6,113,California,Yolo County,5,16,3591,1551,2040
50,6,113,California,Yolo County,5,17,2852,1217,1635
50,6,113,California,Yolo County,5,18,3155,1119,2036
50,6,113,California,Yolo County,6,0,206292,100597,105695
50,6,113,California,Yolo County,6,1,12254,6278,5976
50,6,113,California,Yolo County,6,2,12700,6446,6254
50,6,113,California,Yolo County,6,3,12327,6288,6039
50,6,113,California,Yolo County,6,4,19450,9255,10195
50,6,113,California,Yolo County,6,5,30279,14562,15717
50,6,113,California,Yolo County,6,6,13958,7223,6735
50,6,113,California,Yolo County,6,7,13848,6968,6880
50,6,113,California,Yolo County,6,8,11916,5961,5955
50,6,113,California,Yolo County,6,9,11812,5848,5964
50,6,113,California,Yolo County,6,10,11826,5810,6016
50,6,113,California,Yolo County,6,11,12156,5875,6281
50,6,113,California,Yolo County,6,12,11608,5546,6062
50,6,113,California,Yolo County,6,13,9649,4594,5055
50,6,113,California,Yolo County,6,14,7466,3483,3983
50,6,113,California,Yolo County,6,15,5246,2477,2769
50,6,113,California,Yolo County,6,16,3694,1598,2096
50,6,113,California,Yolo County,6,17,2878,1235,1643
50,6,113,California,Yolo County,6,18,3225,1150,2075
50,6,113,California,Yolo County,7,0,208398,101628,106770
50,6,113,California,Yolo County,7,1,12359,6359,6000
50,6,113,California,Yolo County,7,2,12799,6519,6280
50,6,113,California,Yolo County,7,3,12524,6320,6204
50,6,113,California,Yolo County,7,4,18818,9007,9811
50,6,113,California,Yolo County,7,5,30207,14484,15723
50,6,113,California,Yolo County,7,6,14525,7514,7011
50,6,113,California,Yolo County,7,7,13939,6980,6959
50,6,113,California,Yolo County,7,8,12331,6158,6173
50,6,113,California,Yolo County,7,9,11723,5806,5917
50,6,113,California,Yolo County,7,10,11822,5830,5992
50,6,113,California,Yolo County,7,11,12168,5883,6285
50,6,113,California,Yolo County,7,12,11644,5557,6087
50,6,113,California,Yolo County,7,13,10059,4799,5260
50,6,113,California,Yolo County,7,14,7885,3688,4197
50,6,113,California,Yolo County,7,15,5511,2592,2919
50,6,113,California,Yolo County,7,16,3884,1689,2195
50,6,113,California,Yolo County,7,17,2870,1238,1632
50,6,113,California,Yolo County,7,18,3330,1205,2125
50,6,113,California,Yolo County,8,0,212037,103313,108724
50,6,113,California,Yolo County,8,1,12419,6355,6064
50,6,113,California,Yolo County,8,2,12936,6577,6359
50,6,113,California,Yolo County,8,3,12555,6366,6189
50,6,113,California,Yolo County,8,4,19512,9347,10165
50,6,113,California,Yolo County,8,5,30447,14571,15876
50,6,113,California,Yolo County,8,6,15312,7900,7412
50,6,113,California,Yolo County,8,7,13777,6863,6914
50,6,113,California,Yolo County,8,8,12837,6388,6449
50,6,113,California,Yolo County,8,9,11617,5830,5787
50,6,113,California,Yolo County,8,10,11912,5825,6087
50,6,113,California,Yolo County,8,11,12112,5886,6226
50,6,113,California,Yolo County,8,12,11797,5639,6158
50,6,113,California,Yolo County,8,13,10305,4872,5433
50,6,113,California,Yolo County,8,14,8347,3940,4407
50,6,113,California,Yolo County,8,15,5796,2656,3140
50,6,113,California,Yolo County,8,16,4021,1796,2225
50,6,113,California,Yolo County,8,17,2899,1246,1653
50,6,113,California,Yolo County,8,18,3436,1256,2180
50,6,113,California,Yolo County,9,0,215627,104850,110777
50,6,113,California,Yolo County,9,1,12415,6303,6112
50,6,113,California,Yolo County,9,2,12917,6580,6337
50,6,113,California,Yolo County,9,3,12915,6510,6405
50,6,113,California,Yolo County,9,4,20643,9832,10811
50,6,113,California,Yolo County,9,5,30532,14549,15983
50,6,113,California,Yolo County,9,6,16045,8217,7828
50,6,113,California,Yolo County,9,7,13627,6893,6734
50,6,113,California,Yolo County,9,8,13400,6616,6784
50,6,113,California,Yolo County,9,9,11646,5800,5846
50,6,113,California,Yolo County,9,10,11844,5807,6037
50,6,113,California,Yolo County,9,11,11871,5782,6089
50,6,113,California,Yolo County,9,12,11841,5691,6150
50,6,113,California,Yolo County,9,13,10505,4940,5565
50,6,113,California,Yolo County,9,14,8796,4121,4675
50,6,113,California,Yolo County,9,15,6002,2737,3265
50,6,113,California,Yolo County,9,16,4139,1907,2232
50,6,113,California,Yolo County,9,17,2976,1249,1727
50,6,113,California,Yolo County,9,18,3513,1316,2197
50,6,113,California,Yolo County,10,0,218477,105980,112497
50,6,113,California,Yolo County,10,1,12350,6259,6091
50,6,113,California,Yolo County,10,2,12774,6446,6328
50,6,113,California,Yolo County,10,3,13183,6684,6499
50,6,113,California,Yolo County,10,4,21263,10088,11175
50,6,113,California,Yolo County,10,5,30852,14550,16302
50,6,113,California,Yolo County,10,6,16411,8396,8015
50,6,113,California,Yolo County,10,7,13595,6928,6667
50,6,113,California,Yolo County,10,8,13621,6674,6947
50,6,113,California,Yolo County,10,9,11875,5955,5920
50,6,113,California,Yolo County,10,10,11804,5737,6067
50,6,113,California,Yolo County,10,11,11733,5744,5989
50,6,113,California,Yolo County,10,12,11893,5753,6140
50,6,113,California,Yolo County,10,13,10701,5039,5662
50,6,113,California,Yolo County,10,14,8876,4124,4752
50,6,113,California,Yolo County,10,15,6556,2999,3557
50,6,113,California,Yolo County,10,16,4370,2011,2359
50,6,113,California,Yolo County,10,17,3048,1282,1766
50,6,113,California,Yolo County,10,18,3572,1311,2261
50,6,113,California,Yolo County,11,0,220118,106696,113422
50,6,113,California,Yolo County,11,1,12166,6185,5981
50,6,113,California,Yolo County,11,2,12829,6461,6368
50,6,113,California,Yolo County,11,3,13231,6714,6517
50,6,113,California,Yolo County,11,4,21497,10152,11345
50,6,113,California,Yolo County,11,5,30772,14525,16247
50,6,113,California,Yolo County,11,6,16464,8315,8149
50,6,113,California,Yolo County,11,7,13616,6966,6650
50,6,113,California,Yolo County,11,8,13972,6860,7112
50,6,113,California,Yolo County,11,9,12065,6076,5989
50,6,113,California,Yolo County,11,10,11729,5754,5975
50,6,113,California,Yolo County,11,11,11637,5705,5932
50,6,113,California,Yolo County,11,12,11787,5695,6092
50,6,113,California,Yolo County,11,13,10918,5129,5789
50,6,113,California,Yolo County,11,14,9025,4172,4853
50,6,113,California,Yolo County,11,15,6954,3185,3769
50,6,113,California,Yolo County,11,16,4716,2167,2549
50,6,113,California,Yolo County,11,17,3149,1314,1835
50,6,113,California,Yolo County,11,18,3591,1321,2270
50,6,113,California,Yolo County,12,0,220500,106876,113624
50,6,113,California,Yolo County,12,1,11775,5934,5841
50,6,113,California,Yolo County,12,2,12840,6513,6327
50,6,113,California,Yolo County,12,3,13199,6672,6527
50,6,113,California,Yolo County,12,4,21920,10356,11564
50,6,113,California,Yolo County,12,5,30537,14370,16167
50,6,113,California,Yolo County,12,6,16201,8244,7957
50,6,113,California,Yolo County,12,7,13567,6989,6578
50,6,113,California,Yolo County,12,8,14082,6890,7192
50,6,113,California,Yolo County,12,9,12276,6151,6125
50,6,113,California,Yolo County,12,10,11592,5732,5860
50,6,113,California,Yolo County,12,11,11489,5670,5819
50,6,113,California,Yolo County,12,12,11572,5581,5991
50,6,113,California,Yolo County,12,13,10942,5163,5779
50,6,113,California,Yolo County,12,14,9294,4286,5008
50,6,113,California,Yolo County,12,15,7265,3303,3962
50,6,113,California,Yolo County,12,16,4974,2295,2679
50,6,113,California,Yolo County,12,17,3297,1374,1923
50,6,113,California,Yolo County,12,18,3678,1353,2325
50,6,115,California,Yuba County,1,0,72155,36352,35803
50,6,115,California,Yuba County,1,1,6217,3216,3001
50,6,115,California,Yuba County,1,2,5872,3086,2786
50,6,115,California,Yuba County,1,3,5547,2823,2724
50,6,115,California,Yuba County,1,4,5466,2820,2646
50,6,115,California,Yuba County,1,5,5395,2780,2615
50,6,115,California,Yuba County,1,6,5380,2704,2676
50,6,115,California,Yuba County,1,7,5033,2543,2490
50,6,115,California,Yuba County,1,8,4389,2202,2187
50,6,115,California,Yuba County,1,9,4486,2303,2183
50,6,115,California,Yuba County,1,10,4770,2432,2338
50,6,115,California,Yuba County,1,11,4778,2350,2428
50,6,115,California,Yuba County,1,12,4120,2069,2051
50,6,115,California,Yuba County,1,13,3447,1695,1752
50,6,115,California,Yuba County,1,14,2349,1118,1231
50,6,115,California,Yuba County,1,15,1832,848,984
50,6,115,California,Yuba County,1,16,1366,695,671
50,6,115,California,Yuba County,1,17,945,364,581
50,6,115,California,Yuba County,1,18,763,304,459
50,6,115,California,Yuba County,2,0,72142,36347,35795
50,6,115,California,Yuba County,2,1,6216,3216,3000
50,6,115,California,Yuba County,2,2,5872,3086,2786
50,6,115,California,Yuba County,2,3,5545,2823,2722
50,6,115,California,Yuba County,2,4,5465,2820,2645
50,6,115,California,Yuba County,2,5,5393,2780,2613
50,6,115,California,Yuba County,2,6,5380,2704,2676
50,6,115,California,Yuba County,2,7,5033,2543,2490
50,6,115,California,Yuba County,2,8,4389,2202,2187
50,6,115,California,Yuba County,2,9,4486,2303,2183
50,6,115,California,Yuba County,2,10,4768,2430,2338
50,6,115,California,Yuba County,2,11,4774,2348,2426
50,6,115,California,Yuba County,2,12,4120,2069,2051
50,6,115,California,Yuba County,2,13,3446,1694,1752
50,6,115,California,Yuba County,2,14,2349,1118,1231
50,6,115,California,Yuba County,2,15,1832,848,984
50,6,115,California,Yuba County,2,16,1366,695,671
50,6,115,California,Yuba County,2,17,945,364,581
50,6,115,California,Yuba County,2,18,763,304,459
50,6,115,California,Yuba County,3,0,72348,36454,35894
50,6,115,California,Yuba County,3,1,6192,3202,2990
50,6,115,California,Yuba County,3,2,5883,3079,2804
50,6,115,California,Yuba County,3,3,5538,2833,2705
50,6,115,California,Yuba County,3,4,5428,2807,2621
50,6,115,California,Yuba County,3,5,5434,2806,2628
50,6,115,California,Yuba County,3,6,5424,2726,2698
50,6,115,California,Yuba County,3,7,5055,2560,2495
50,6,115,California,Yuba County,3,8,4398,2207,2191
50,6,115,California,Yuba County,3,9,4470,2294,2176
50,6,115,California,Yuba County,3,10,4755,2427,2328
50,6,115,California,Yuba County,3,11,4791,2354,2437
50,6,115,California,Yuba County,3,12,4164,2085,2079
50,6,115,California,Yuba County,3,13,3510,1730,1780
50,6,115,California,Yuba County,3,14,2361,1117,1244
50,6,115,California,Yuba County,3,15,1848,857,991
50,6,115,California,Yuba County,3,16,1364,689,675
50,6,115,California,Yuba County,3,17,959,378,581
50,6,115,California,Yuba County,3,18,774,303,471
50,6,115,California,Yuba County,4,0,72489,36529,35960
50,6,115,California,Yuba County,4,1,6127,3194,2933
50,6,115,California,Yuba County,4,2,5917,3050,2867
50,6,115,California,Yuba County,4,3,5524,2894,2630
50,6,115,California,Yuba County,4,4,5265,2698,2567
50,6,115,California,Yuba County,4,5,5514,2843,2671
50,6,115,California,Yuba County,4,6,5523,2801,2722
50,6,115,California,Yuba County,4,7,5151,2570,2581
50,6,115,California,Yuba County,4,8,4317,2179,2138
50,6,115,California,Yuba County,4,9,4329,2221,2108
50,6,115,California,Yuba County,4,10,4580,2339,2241
50,6,115,California,Yuba County,4,11,4786,2334,2452
50,6,115,California,Yuba County,4,12,4311,2138,2173
50,6,115,California,Yuba County,4,13,3713,1846,1867
50,6,115,California,Yuba County,4,14,2401,1133,1268
50,6,115,California,Yuba County,4,15,1896,900,996
50,6,115,California,Yuba County,4,16,1372,668,704
50,6,115,California,Yuba County,4,17,961,408,553
50,6,115,California,Yuba County,4,18,802,313,489
50,6,115,California,Yuba County,5,0,72774,36737,36037
50,6,115,California,Yuba County,5,1,6163,3182,2981
50,6,115,California,Yuba County,5,2,5903,3048,2855
50,6,115,California,Yuba County,5,3,5466,2830,2636
50,6,115,California,Yuba County,5,4,5133,2661,2472
50,6,115,California,Yuba County,5,5,5689,2996,2693
50,6,115,California,Yuba County,5,6,5720,2932,2788
50,6,115,California,Yuba County,5,7,5163,2559,2604
50,6,115,California,Yuba County,5,8,4348,2196,2152
50,6,115,California,Yuba County,5,9,4246,2185,2061
50,6,115,California,Yuba County,5,10,4372,2211,2161
50,6,115,California,Yuba County,5,11,4714,2299,2415
50,6,115,California,Yuba County,5,12,4432,2197,2235
50,6,115,California,Yuba County,5,13,3672,1833,1839
50,6,115,California,Yuba County,5,14,2659,1265,1394
50,6,115,California,Yuba County,5,15,1931,944,987
50,6,115,California,Yuba County,5,16,1381,656,725
50,6,115,California,Yuba County,5,17,929,411,518
50,6,115,California,Yuba County,5,18,853,332,521
50,6,115,California,Yuba County,6,0,73090,36912,36178
50,6,115,California,Yuba County,6,1,6135,3154,2981
50,6,115,California,Yuba County,6,2,5899,3021,2878
50,6,115,California,Yuba County,6,3,5410,2833,2577
50,6,115,California,Yuba County,6,4,5063,2596,2467
50,6,115,California,Yuba County,6,5,5734,3084,2650
50,6,115,California,Yuba County,6,6,5823,2967,2856
50,6,115,California,Yuba County,6,7,5313,2646,2667
50,6,115,California,Yuba County,6,8,4452,2237,2215
50,6,115,California,Yuba County,6,9,4222,2127,2095
50,6,115,California,Yuba County,6,10,4213,2172,2041
50,6,115,California,Yuba County,6,11,4628,2265,2363
50,6,115,California,Yuba County,6,12,4460,2178,2282
50,6,115,California,Yuba County,6,13,3704,1877,1827
50,6,115,California,Yuba County,6,14,2845,1363,1482
50,6,115,California,Yuba County,6,15,2016,991,1025
50,6,115,California,Yuba County,6,16,1408,639,769
50,6,115,California,Yuba County,6,17,928,429,499
50,6,115,California,Yuba County,6,18,837,333,504
50,6,115,California,Yuba County,7,0,73533,37243,36290
50,6,115,California,Yuba County,7,1,6105,3093,3012
50,6,115,California,Yuba County,7,2,5927,3047,2880
50,6,115,California,Yuba County,7,3,5369,2824,2545
50,6,115,California,Yuba County,7,4,4964,2549,2415
50,6,115,California,Yuba County,7,5,5807,3200,2607
50,6,115,California,Yuba County,7,6,6007,3047,2960
50,6,115,California,Yuba County,7,7,5373,2710,2663
50,6,115,California,Yuba County,7,8,4578,2334,2244
50,6,115,California,Yuba County,7,9,4082,2060,2022
50,6,115,California,Yuba County,7,10,4120,2086,2034
50,6,115,California,Yuba County,7,11,4551,2265,2286
50,6,115,California,Yuba County,7,12,4452,2197,2255
50,6,115,California,Yuba County,7,13,3857,1942,1915
50,6,115,California,Yuba County,7,14,3032,1458,1574
50,6,115,California,Yuba County,7,15,2088,1005,1083
50,6,115,California,Yuba County,7,16,1437,661,776
50,6,115,California,Yuba County,7,17,941,443,498
50,6,115,California,Yuba County,7,18,843,322,521
50,6,115,California,Yuba County,8,0,74045,37503,36542
50,6,115,California,Yuba County,8,1,6117,3104,3013
50,6,115,California,Yuba County,8,2,5914,3018,2896
50,6,115,California,Yuba County,8,3,5451,2825,2626
50,6,115,California,Yuba County,8,4,4895,2566,2329
50,6,115,California,Yuba County,8,5,5708,3152,2556
50,6,115,California,Yuba County,8,6,6024,3091,2933
50,6,115,California,Yuba County,8,7,5447,2767,2680
50,6,115,California,Yuba County,8,8,4769,2424,2345
50,6,115,California,Yuba County,8,9,4085,2037,2048
50,6,115,California,Yuba County,8,10,4033,2027,2006
50,6,115,California,Yuba County,8,11,4421,2243,2178
50,6,115,California,Yuba County,8,12,4458,2169,2289
50,6,115,California,Yuba County,8,13,4012,1999,2013
50,6,115,California,Yuba County,8,14,3259,1604,1655
50,6,115,California,Yuba County,8,15,2138,997,1141
50,6,115,California,Yuba County,8,16,1500,704,796
50,6,115,California,Yuba County,8,17,956,454,502
50,6,115,California,Yuba County,8,18,858,322,536
50,6,115,California,Yuba County,9,0,74952,37971,36981
50,6,115,California,Yuba County,9,1,6028,3069,2959
50,6,115,California,Yuba County,9,2,5885,2991,2894
50,6,115,California,Yuba County,9,3,5555,2864,2691
50,6,115,California,Yuba County,9,4,4968,2662,2306
50,6,115,California,Yuba County,9,5,5721,3172,2549
50,6,115,California,Yuba County,9,6,6053,3102,2951
50,6,115,California,Yuba County,9,7,5619,2858,2761
50,6,115,California,Yuba County,9,8,4916,2499,2417
50,6,115,California,Yuba County,9,9,4107,2047,2060
50,6,115,California,Yuba County,9,10,4099,2021,2078
50,6,115,California,Yuba County,9,11,4308,2201,2107
50,6,115,California,Yuba County,9,12,4459,2193,2266
50,6,115,California,Yuba County,9,13,4131,2028,2103
50,6,115,California,Yuba County,9,14,3508,1731,1777
50,6,115,California,Yuba County,9,15,2156,1002,1154
50,6,115,California,Yuba County,9,16,1550,727,823
50,6,115,California,Yuba County,9,17,1014,474,540
50,6,115,California,Yuba County,9,18,875,330,545
50,6,115,California,Yuba County,10,0,76578,38775,37803
50,6,115,California,Yuba County,10,1,6121,3143,2978
50,6,115,California,Yuba County,10,2,6100,3067,3033
50,6,115,California,Yuba County,10,3,5740,2989,2751
50,6,115,California,Yuba County,10,4,5058,2686,2372
50,6,115,California,Yuba County,10,5,5598,3134,2464
50,6,115,California,Yuba County,10,6,6200,3144,3056
50,6,115,California,Yuba County,10,7,5842,2977,2865
50,6,115,California,Yuba County,10,8,5200,2599,2601
50,6,115,California,Yuba County,10,9,4182,2131,2051
50,6,115,California,Yuba County,10,10,4104,2029,2075
50,6,115,California,Yuba County,10,11,4249,2163,2086
50,6,115,California,Yuba County,10,12,4520,2202,2318
50,6,115,California,Yuba County,10,13,4194,2076,2118
50,6,115,California,Yuba County,10,14,3510,1723,1787
50,6,115,California,Yuba County,10,15,2409,1102,1307
50,6,115,California,Yuba County,10,16,1626,788,838
50,6,115,California,Yuba County,10,17,1019,459,560
50,6,115,California,Yuba County,10,18,906,363,543
50,6,115,California,Yuba County,11,0,77557,39249,38308
50,6,115,California,Yuba County,11,1,6090,3175,2915
50,6,115,California,Yuba County,11,2,6243,3142,3101
50,6,115,California,Yuba County,11,3,5900,3034,2866
50,6,115,California,Yuba County,11,4,5104,2710,2394
50,6,115,California,Yuba County,11,5,5464,3034,2430
50,6,115,California,Yuba County,11,6,6219,3185,3034
50,6,115,California,Yuba County,11,7,5964,3012,2952
50,6,115,California,Yuba County,11,8,5388,2694,2694
50,6,115,California,Yuba County,11,9,4356,2211,2145
50,6,115,California,Yuba County,11,10,4058,1963,2095
50,6,115,California,Yuba County,11,11,4172,2173,1999
50,6,115,California,Yuba County,11,12,4543,2230,2313
50,6,115,California,Yuba County,11,13,4232,2065,2167
50,6,115,California,Yuba County,11,14,3557,1748,1809
50,6,115,California,Yuba County,11,15,2611,1211,1400
50,6,115,California,Yuba County,11,16,1678,821,857
50,6,115,California,Yuba County,11,17,1054,451,603
50,6,115,California,Yuba County,11,18,924,390,534
50,6,115,California,Yuba County,12,0,78668,39819,38849
50,6,115,California,Yuba County,12,1,6115,3162,2953
50,6,115,California,Yuba County,12,2,6231,3123,3108
50,6,115,California,Yuba County,12,3,5969,3052,2917
50,6,115,California,Yuba County,12,4,5186,2758,2428
50,6,115,California,Yuba County,12,5,5436,3002,2434
50,6,115,California,Yuba County,12,6,6252,3254,2998
50,6,115,California,Yuba County,12,7,6050,3043,3007
50,6,115,California,Yuba County,12,8,5573,2835,2738
50,6,115,California,Yuba County,12,9,4534,2310,2224
50,6,115,California,Yuba County,12,10,4007,1960,2047
50,6,115,California,Yuba County,12,11,4161,2122,2039
50,6,115,California,Yuba County,12,12,4540,2253,2287
50,6,115,California,Yuba County,12,13,4344,2097,2247
50,6,115,California,Yuba County,12,14,3669,1816,1853
50,6,115,California,Yuba County,12,15,2791,1296,1495
50,6,115,California,Yuba County,12,16,1778,858,920
50,6,115,California,Yuba County,12,17,1066,458,608
50,6,115,California,Yuba County,12,18,966,420,546
