SUMLEV,STATE,COUNTY,STNAME,CTYNAME,YEAR,AGEGRP,TOT_POP,TOT_MALE,TOT_FEMALE
50,12,1,Florida,Alachua County,1,0,2286,1140,1146
50,12,1,Florida,Alachua County,1,1,8874,4545,4329
50,12,1,Florida,Alachua County,1,2,12092,6282,5810
50,12,1,Florida,Alachua County,1,3,12937,6533,6404
50,12,1,Florida,Alachua County,1,4,22352,10634,11718
50,12,1,Florida,Alachua County,1,5,36011,18014,17997
50,12,1,Florida,Alachua County,1,6,17646,9488,8158
50,12,1,Florida,Alachua County,1,7,13759,7031,6728
50,12,1,Florida,Alachua County,1,8,14296,6981,7315
50,12,1,Florida,Alachua County,1,9,14707,6967,7740
50,12,1,Florida,Alachua County,1,10,14295,6812,7483
50,12,1,Florida,Alachua County,1,11,12387,6113,6274
50,12,1,Florida,Alachua County,1,12,8752,4228,4524
50,12,1,Florida,Alachua County,1,13,6648,3041,3607
50,12,1,Florida,Alachua County,1,14,5646,2641,3005
50,12,1,Florida,Alachua County,1,15,5226,2244,2982
50,12,1,Florida,Alachua County,1,16,4490,1800,2690
50,12,1,Florida,Alachua County,1,17,3059,1200,1859
50,12,1,Florida,Alachua County,1,18,2501,712,1789
50,12,1,Florida,Alachua County,1,99,217964,106406,111558
50,12,1,Florida,Alachua County,2,0,2303,1148,1155
50,12,1,Florida,Alachua County,2,1,8803,4504,4299
50,12,1,Florida,Alachua County,2,2,12009,6237,5772
50,12,1,Florida,Alachua County,2,3,12969,6548,6421
50,12,1,Florida,Alachua County,2,4,22512,10692,11820
50,12,1,Florida,Alachua County,2,5,36401,18192,18209
50,12,1,Florida,Alachua County,2,6,17552,9439,8113
50,12,1,Florida,Alachua County,2,7,13754,7030,6724
50,12,1,Florida,Alachua County,2,8,14224,6945,7279
50,12,1,Florida,Alachua County,2,9,14724,6975,7749
50,12,1,Florida,Alachua County,2,10,14357,6846,7511
50,12,1,Florida,Alachua County,2,11,12510,6181,6329
50,12,1,Florida,Alachua County,2,12,8804,4252,4552
50,12,1,Florida,Alachua County,2,13,6675,3056,3619
50,12,1,Florida,Alachua County,2,14,5660,2650,3010
50,12,1,Florida,Alachua County,2,15,5236,2250,2986
50,12,1,Florida,Alachua County,2,16,4516,1814,2702
50,12,1,Florida,Alachua County,2,17,3087,1214,1873
50,12,1,Florida,Alachua County,2,18,2515,717,1798
50,12,1,Florida,Alachua County,2,99,218611,106690,111921
50,12,1,Florida,Alachua County,3,0,2443,1292,1151
50,12,1,Florida,Alachua County,3,1,8764,4417,4347
50,12,1,Florida,Alachua County,3,2,11506,5989,5517
50,12,1,Florida,Alachua County,3,3,13010,6549,6461
50,12,1,Florida,Alachua County,3,4,23665,11138,12527
50,12,1,Florida,Alachua County,3,5,39133,19370,19763
50,12,1,Florida,Alachua County,3,6,16223,8749,7474
50,12,1,Florida,Alachua County,3,7,14038,7281,6757
50,12,1,Florida,Alachua County,3,8,13555,6615,6940
50,12,1,Florida,Alachua County,3,9,14633,6984,7649
50,12,1,Florida,Alachua County,3,10,14265,6730,7535
50,12,1,Florida,Alachua County,3,11,13176,6452,6724
50,12,1,Florida,Alachua County,3,12,9258,4522,4736
50,12,1,Florida,Alachua County,3,13,6929,3191,3738
50,12,1,Florida,Alachua County,3,14,5747,2667,3080
50,12,1,Florida,Alachua County,3,15,5208,2272,2936
50,12,1,Florida,Alachua County,3,16,4441,1786,2655
50,12,1,Florida,Alachua County,3,17,3204,1216,1988
50,12,1,Florida,Alachua County,3,18,2520,743,1777
50,12,1,Florida,Alachua County,3,99,221718,107963,113755
50,12,1,Florida,Alachua County,4,0,2422,1226,1196
50,12,1,Florida,Alachua County,4,1,8925,4558,4367
50,12,1,Florida,Alachua County,4,2,11156,5781,5375
50,12,1,Florida,Alachua County,4,3,12861,6541,6320
50,12,1,Florida,Alachua County,4,4,24050,11332,12718
50,12,1,Florida,Alachua County,4,5,41293,20313,20980
50,12,1,Florida,Alachua County,4,6,15715,8494,7221
50,12,1,Florida,Alachua County,4,7,14273,7462,6811
50,12,1,Florida,Alachua County,4,8,12984,6305,6679
50,12,1,Florida,Alachua County,4,9,14423,6976,7447
50,12,1,Florida,Alachua County,4,10,14380,6766,7614
50,12,1,Florida,Alachua County,4,11,13415,6470,6945
50,12,1,Florida,Alachua County,4,12,10116,5006,5110
50,12,1,Florida,Alachua County,4,13,7256,3347,3909
50,12,1,Florida,Alachua County,4,14,5829,2721,3108
50,12,1,Florida,Alachua County,4,15,5118,2227,2891
50,12,1,Florida,Alachua County,4,16,4483,1785,2698
50,12,1,Florida,Alachua County,4,17,3293,1264,2029
50,12,1,Florida,Alachua County,4,18,2622,812,1810
50,12,1,Florida,Alachua County,4,99,224614,109386,115228
50,12,1,Florida,Alachua County,5,0,2378,1262,1116
50,12,1,Florida,Alachua County,5,1,8998,4583,4415
50,12,1,Florida,Alachua County,5,2,10906,5587,5319
50,12,1,Florida,Alachua County,5,3,12715,6541,6174
50,12,1,Florida,Alachua County,5,4,23927,11150,12777
50,12,1,Florida,Alachua County,5,5,42782,21100,21682
50,12,1,Florida,Alachua County,5,6,15732,8444,7288
50,12,1,Florida,Alachua County,5,7,14276,7444,6832
50,12,1,Florida,Alachua County,5,8,12689,6220,6469
50,12,1,Florida,Alachua County,5,9,14044,6804,7240
50,12,1,Florida,Alachua County,5,10,14519,6838,7681
50,12,1,Florida,Alachua County,5,11,13798,6556,7242
50,12,1,Florida,Alachua County,5,12,10742,5300,5442
50,12,1,Florida,Alachua County,5,13,7839,3681,4158
50,12,1,Florida,Alachua County,5,14,5934,2775,3159
50,12,1,Florida,Alachua County,5,15,5161,2280,2881
50,12,1,Florida,Alachua County,5,16,4515,1792,2723
50,12,1,Florida,Alachua County,5,17,3340,1263,2077
50,12,1,Florida,Alachua County,5,18,2727,850,1877
50,12,1,Florida,Alachua County,5,99,227022,110470,116552
50,12,1,Florida,Alachua County,6,0,2487,1316,1171
50,12,1,Florida,Alachua County,6,1,9208,4703,4505
50,12,1,Florida,Alachua County,6,2,10724,5505,5219
50,12,1,Florida,Alachua County,6,3,12401,6380,6021
50,12,1,Florida,Alachua County,6,4,24122,11202,12920
50,12,1,Florida,Alachua County,6,5,43723,21528,22195
50,12,1,Florida,Alachua County,6,6,15826,8444,7382
50,12,1,Florida,Alachua County,6,7,14550,7628,6922
50,12,1,Florida,Alachua County,6,8,12423,6127,6296
50,12,1,Florida,Alachua County,6,9,14020,6781,7239
50,12,1,Florida,Alachua County,6,10,14519,6834,7685
50,12,1,Florida,Alachua County,6,11,14039,6550,7489
50,12,1,Florida,Alachua County,6,12,11506,5726,5780
50,12,1,Florida,Alachua County,6,13,8248,3849,4399
50,12,1,Florida,Alachua County,6,14,6268,2902,3366
50,12,1,Florida,Alachua County,6,15,5063,2263,2800
50,12,1,Florida,Alachua County,6,16,4527,1834,2693
50,12,1,Florida,Alachua County,6,17,3406,1233,2173
50,12,1,Florida,Alachua County,6,18,2807,898,1909
50,12,1,Florida,Alachua County,6,99,229867,111703,118164
50,12,1,Florida,Alachua County,7,0,2660,1344,1316
50,12,1,Florida,Alachua County,7,1,9445,4890,4555
50,12,1,Florida,Alachua County,7,2,10850,5567,5283
50,12,1,Florida,Alachua County,7,3,12151,6303,5848
50,12,1,Florida,Alachua County,7,4,24302,11259,13043
50,12,1,Florida,Alachua County,7,5,43970,21509,22461
50,12,1,Florida,Alachua County,7,6,16478,8702,7776
50,12,1,Florida,Alachua County,7,7,14806,7792,7014
50,12,1,Florida,Alachua County,7,8,12431,6086,6345
50,12,1,Florida,Alachua County,7,9,13825,6652,7173
50,12,1,Florida,Alachua County,7,10,14592,6855,7737
50,12,1,Florida,Alachua County,7,11,14384,6745,7639
50,12,1,Florida,Alachua County,7,12,12452,6158,6294
50,12,1,Florida,Alachua County,7,13,8690,4102,4588
50,12,1,Florida,Alachua County,7,14,6549,3057,3492
50,12,1,Florida,Alachua County,7,15,5119,2276,2843
50,12,1,Florida,Alachua County,7,16,4555,1877,2678
50,12,1,Florida,Alachua County,7,17,3529,1297,2232
50,12,1,Florida,Alachua County,7,18,2968,996,1972
50,12,1,Florida,Alachua County,7,99,233756,113467,120289
50,12,1,Florida,Alachua County,8,0,2636,1363,1273
50,12,1,Florida,Alachua County,8,1,9771,4991,4780
50,12,1,Florida,Alachua County,8,2,11271,5737,5534
50,12,1,Florida,Alachua County,8,3,12038,6330,5708
50,12,1,Florida,Alachua County,8,4,24490,11331,13159
50,12,1,Florida,Alachua County,8,5,44132,21507,22625
50,12,1,Florida,Alachua County,8,6,18060,9422,8638
50,12,1,Florida,Alachua County,8,7,14669,7780,6889
50,12,1,Florida,Alachua County,8,8,12928,6442,6486
50,12,1,Florida,Alachua County,8,9,13557,6493,7064
50,12,1,Florida,Alachua County,8,10,14932,7091,7841
50,12,1,Florida,Alachua County,8,11,14688,6826,7862
50,12,1,Florida,Alachua County,8,12,13379,6563,6816
50,12,1,Florida,Alachua County,8,13,9290,4430,4860
50,12,1,Florida,Alachua County,8,14,6949,3235,3714
50,12,1,Florida,Alachua County,8,15,5331,2371,2960
50,12,1,Florida,Alachua County,8,16,4620,1939,2681
50,12,1,Florida,Alachua County,8,17,3571,1338,2233
50,12,1,Florida,Alachua County,8,18,3194,1077,2117
50,12,1,Florida,Alachua County,8,99,239506,116266,123240
50,12,1,Florida,Alachua County,9,0,2786,1423,1363
50,12,1,Florida,Alachua County,9,1,9853,5036,4817
50,12,1,Florida,Alachua County,9,2,11430,5801,5629
50,12,1,Florida,Alachua County,9,3,11925,6180,5745
50,12,1,Florida,Alachua County,9,4,24398,11363,13035
50,12,1,Florida,Alachua County,9,5,43610,21272,22338
50,12,1,Florida,Alachua County,9,6,19640,10227,9413
50,12,1,Florida,Alachua County,9,7,14616,7677,6939
50,12,1,Florida,Alachua County,9,8,13149,6621,6528
50,12,1,Florida,Alachua County,9,9,13194,6310,6884
50,12,1,Florida,Alachua County,9,10,14857,7099,7758
50,12,1,Florida,Alachua County,9,11,14953,6908,8045
50,12,1,Florida,Alachua County,9,12,13822,6704,7118
50,12,1,Florida,Alachua County,9,13,10229,4921,5308
50,12,1,Florida,Alachua County,9,14,7195,3360,3835
50,12,1,Florida,Alachua County,9,15,5432,2411,3021
50,12,1,Florida,Alachua County,9,16,4566,1948,2618
50,12,1,Florida,Alachua County,9,17,3730,1416,2314
50,12,1,Florida,Alachua County,9,18,3300,1128,2172
50,12,1,Florida,Alachua County,9,99,242685,117805,124880
50,12,1,Florida,Alachua County,10,0,2843,1465,1378
50,12,1,Florida,Alachua County,10,1,10034,5133,4901
50,12,1,Florida,Alachua County,10,2,11528,5844,5684
50,12,1,Florida,Alachua County,10,3,11783,6083,5700
50,12,1,Florida,Alachua County,10,4,24357,11318,13039
50,12,1,Florida,Alachua County,10,5,42725,20661,22064
50,12,1,Florida,Alachua County,10,6,20622,10900,9722
50,12,1,Florida,Alachua County,10,7,14852,7721,7131
50,12,1,Florida,Alachua County,10,8,13095,6542,6553
50,12,1,Florida,Alachua County,10,9,12963,6286,6677
50,12,1,Florida,Alachua County,10,10,14707,7064,7643
50,12,1,Florida,Alachua County,10,11,15127,7013,8114
50,12,1,Florida,Alachua County,10,12,14201,6827,7374
50,12,1,Florida,Alachua County,10,13,10944,5217,5727
50,12,1,Florida,Alachua County,10,14,7757,3685,4072
50,12,1,Florida,Alachua County,10,15,5526,2435,3091
50,12,1,Florida,Alachua County,10,16,4616,1990,2626
50,12,1,Florida,Alachua County,10,17,3810,1465,2345
50,12,1,Florida,Alachua County,10,18,3398,1127,2271
50,12,1,Florida,Alachua County,10,99,244888,118776,126112
50,12,1,Florida,Alachua County,11,0,2846,1522,1324
50,12,1,Florida,Alachua County,11,1,10331,5222,5109
50,12,1,Florida,Alachua County,11,2,11574,5809,5765
50,12,1,Florida,Alachua County,11,3,11621,5991,5630
50,12,1,Florida,Alachua County,11,4,24186,11254,12932
50,12,1,Florida,Alachua County,11,5,42244,20383,21861
50,12,1,Florida,Alachua County,11,6,21370,11235,10135
50,12,1,Florida,Alachua County,11,7,15012,7760,7252
50,12,1,Florida,Alachua County,11,8,13000,6555,6445
50,12,1,Florida,Alachua County,11,9,12548,6140,6408
50,12,1,Florida,Alachua County,11,10,14597,6990,7607
50,12,1,Florida,Alachua County,11,11,15203,7073,8130
50,12,1,Florida,Alachua County,11,12,14471,6867,7604
50,12,1,Florida,Alachua County,11,13,11658,5596,6062
50,12,1,Florida,Alachua County,11,14,8263,3948,4315
50,12,1,Florida,Alachua County,11,15,5796,2525,3271
50,12,1,Florida,Alachua County,11,16,4575,1995,2580
50,12,1,Florida,Alachua County,11,17,3819,1503,2316
50,12,1,Florida,Alachua County,11,18,3543,1180,2363
50,12,1,Florida,Alachua County,11,99,246657,119548,127109
50,12,1,Florida,Alachua County,12,0,2747,1443,1304
50,12,1,Florida,Alachua County,12,1,10321,5260,5061
50,12,1,Florida,Alachua County,12,2,11739,5913,5826
50,12,1,Florida,Alachua County,12,3,11669,5992,5677
50,12,1,Florida,Alachua County,12,4,23589,10942,12647
50,12,1,Florida,Alachua County,12,5,41515,19979,21536
50,12,1,Florida,Alachua County,12,6,21724,11365,10359
50,12,1,Florida,Alachua County,12,7,15256,7917,7339
50,12,1,Florida,Alachua County,12,8,13043,6566,6477
50,12,1,Florida,Alachua County,12,9,12465,6091,6374
50,12,1,Florida,Alachua County,12,10,14262,6829,7433
50,12,1,Florida,Alachua County,12,11,15208,7034,8174
50,12,1,Florida,Alachua County,12,12,14800,7036,7764
50,12,1,Florida,Alachua County,12,13,12371,5903,6468
50,12,1,Florida,Alachua County,12,14,8593,4156,4437
50,12,1,Florida,Alachua County,12,15,5987,2623,3364
50,12,1,Florida,Alachua County,12,16,4589,2016,2573
50,12,1,Florida,Alachua County,12,17,3786,1476,2310
50,12,1,Florida,Alachua County,12,18,3672,1245,2427
50,12,1,Florida,Alachua County,12,99,247336,119786,127550
50,12,1,Florida,Alachua County,13,0,2750,1447,1303
50,12,1,Florida,Alachua County,13,1,10309,5262,5047
50,12,1,Florida,Alachua County,13,2,11736,5915,5821
50,12,1,Florida,Alachua County,13,3,11668,5989,5679
50,12,1,Florida,Alachua County,13,4,23443,10880,12563
50,12,1,Florida,Alachua County,13,5,41574,20008,21566
50,12,1,Florida,Alachua County,13,6,21735,11392,10343
50,12,1,Florida,Alachua County,13,7,15343,7960,7383
50,12,1,Florida,Alachua County,13,8,12941,6513,6428
50,12,1,Florida,Alachua County,13,9,12457,6091,6366
50,12,1,Florida,Alachua County,13,10,14211,6803,7408
50,12,1,Florida,Alachua County,13,11,15230,7043,8187
50,12,1,Florida,Alachua County,13,12,14862,7065,7797
50,12,1,Florida,Alachua County,13,13,12488,5959,6529
50,12,1,Florida,Alachua County,13,14,8629,4179,4450
50,12,1,Florida,Alachua County,13,15,6022,2644,3378
50,12,1,Florida,Alachua County,13,16,4597,2022,2575
50,12,1,Florida,Alachua County,13,17,3803,1487,2316
50,12,1,Florida,Alachua County,13,18,3699,1258,2441
50,12,1,Florida,Alachua County,13,99,247497,119917,127580
50,12,3,Florida,Baker County,1,0,365,185,180
50,12,3,Florida,Baker County,1,1,1196,583,613
50,12,3,Florida,Baker County,1,2,1615,858,757
50,12,3,Florida,Baker County,1,3,1834,929,905
50,12,3,Florida,Baker County,1,4,1824,951,873
50,12,3,Florida,Baker County,1,5,1490,874,616
50,12,3,Florida,Baker County,1,6,1511,833,678
50,12,3,Florida,Baker County,1,7,1635,930,705
50,12,3,Florida,Baker County,1,8,1885,1028,857
50,12,3,Florida,Baker County,1,9,1805,973,832
50,12,3,Florida,Baker County,1,10,1640,893,747
50,12,3,Florida,Baker County,1,11,1428,755,673
50,12,3,Florida,Baker County,1,12,1079,551,528
50,12,3,Florida,Baker County,1,13,899,462,437
50,12,3,Florida,Baker County,1,14,721,355,366
50,12,3,Florida,Baker County,1,15,567,267,300
50,12,3,Florida,Baker County,1,16,342,142,200
50,12,3,Florida,Baker County,1,17,236,64,172
50,12,3,Florida,Baker County,1,18,183,53,130
50,12,3,Florida,Baker County,1,99,22255,11686,10569
50,12,3,Florida,Baker County,2,0,370,187,183
50,12,3,Florida,Baker County,2,1,1200,585,615
50,12,3,Florida,Baker County,2,2,1617,860,757
50,12,3,Florida,Baker County,2,3,1850,940,910
50,12,3,Florida,Baker County,2,4,1839,959,880
50,12,3,Florida,Baker County,2,5,1508,883,625
50,12,3,Florida,Baker County,2,6,1504,829,675
50,12,3,Florida,Baker County,2,7,1638,931,707
50,12,3,Florida,Baker County,2,8,1884,1026,858
50,12,3,Florida,Baker County,2,9,1817,977,840
50,12,3,Florida,Baker County,2,10,1654,899,755
50,12,3,Florida,Baker County,2,11,1447,763,684
50,12,3,Florida,Baker County,2,12,1086,554,532
50,12,3,Florida,Baker County,2,13,905,465,440
50,12,3,Florida,Baker County,2,14,722,356,366
50,12,3,Florida,Baker County,2,15,568,268,300
50,12,3,Florida,Baker County,2,16,343,142,201
50,12,3,Florida,Baker County,2,17,238,64,174
50,12,3,Florida,Baker County,2,18,184,54,130
50,12,3,Florida,Baker County,2,99,22374,11742,10632
50,12,3,Florida,Baker County,3,0,339,154,185
50,12,3,Florida,Baker County,3,1,1266,638,628
50,12,3,Florida,Baker County,3,2,1583,832,751
50,12,3,Florida,Baker County,3,3,1794,919,875
50,12,3,Florida,Baker County,3,4,1818,965,853
50,12,3,Florida,Baker County,3,5,1609,892,717
50,12,3,Florida,Baker County,3,6,1466,827,639
50,12,3,Florida,Baker County,3,7,1630,932,698
50,12,3,Florida,Baker County,3,8,1827,1007,820
50,12,3,Florida,Baker County,3,9,1886,1018,868
50,12,3,Florida,Baker County,3,10,1720,927,793
50,12,3,Florida,Baker County,3,11,1502,805,697
50,12,3,Florida,Baker County,3,12,1145,570,575
50,12,3,Florida,Baker County,3,13,931,474,457
50,12,3,Florida,Baker County,3,14,756,384,372
50,12,3,Florida,Baker County,3,15,548,258,290
50,12,3,Florida,Baker County,3,16,376,165,211
50,12,3,Florida,Baker County,3,17,242,61,181
50,12,3,Florida,Baker County,3,18,182,58,124
50,12,3,Florida,Baker County,3,99,22620,11886,10734
50,12,3,Florida,Baker County,4,0,346,182,164
50,12,3,Florida,Baker County,4,1,1371,688,683
50,12,3,Florida,Baker County,4,2,1610,834,776
50,12,3,Florida,Baker County,4,3,1787,945,842
50,12,3,Florida,Baker County,4,4,1848,966,882
50,12,3,Florida,Baker County,4,5,1726,932,794
50,12,3,Florida,Baker County,4,6,1491,847,644
50,12,3,Florida,Baker County,4,7,1709,946,763
50,12,3,Florida,Baker County,4,8,1762,979,783
50,12,3,Florida,Baker County,4,9,1943,1051,892
50,12,3,Florida,Baker County,4,10,1750,947,803
50,12,3,Florida,Baker County,4,11,1569,818,751
50,12,3,Florida,Baker County,4,12,1238,635,603
50,12,3,Florida,Baker County,4,13,978,482,496
50,12,3,Florida,Baker County,4,14,793,392,401
50,12,3,Florida,Baker County,4,15,545,278,267
50,12,3,Florida,Baker County,4,16,421,174,247
50,12,3,Florida,Baker County,4,17,221,65,156
50,12,3,Florida,Baker County,4,18,190,59,131
50,12,3,Florida,Baker County,4,99,23298,12220,11078
50,12,3,Florida,Baker County,5,0,338,182,156
50,12,3,Florida,Baker County,5,1,1403,719,684
50,12,3,Florida,Baker County,5,2,1562,790,772
50,12,3,Florida,Baker County,5,3,1823,974,849
50,12,3,Florida,Baker County,5,4,1797,923,874
50,12,3,Florida,Baker County,5,5,1689,940,749
50,12,3,Florida,Baker County,5,6,1530,863,667
50,12,3,Florida,Baker County,5,7,1712,925,787
50,12,3,Florida,Baker County,5,8,1764,1015,749
50,12,3,Florida,Baker County,5,9,1946,1051,895
50,12,3,Florida,Baker County,5,10,1804,982,822
50,12,3,Florida,Baker County,5,11,1612,846,766
50,12,3,Florida,Baker County,5,12,1322,683,639
50,12,3,Florida,Baker County,5,13,1018,493,525
50,12,3,Florida,Baker County,5,14,843,427,416
50,12,3,Florida,Baker County,5,15,534,277,257
50,12,3,Florida,Baker County,5,16,423,171,252
50,12,3,Florida,Baker County,5,17,244,74,170
50,12,3,Florida,Baker County,5,18,191,55,136
50,12,3,Florida,Baker County,5,99,23555,12390,11165
50,12,3,Florida,Baker County,6,0,366,174,192
50,12,3,Florida,Baker County,6,1,1442,752,690
50,12,3,Florida,Baker County,6,2,1613,801,812
50,12,3,Florida,Baker County,6,3,1825,982,843
50,12,3,Florida,Baker County,6,4,1845,967,878
50,12,3,Florida,Baker County,6,5,1775,987,788
50,12,3,Florida,Baker County,6,6,1531,874,657
50,12,3,Florida,Baker County,6,7,1727,966,761
50,12,3,Florida,Baker County,6,8,1771,1018,753
50,12,3,Florida,Baker County,6,9,1996,1069,927
50,12,3,Florida,Baker County,6,10,1804,1012,792
50,12,3,Florida,Baker County,6,11,1685,863,822
50,12,3,Florida,Baker County,6,12,1366,699,667
50,12,3,Florida,Baker County,6,13,1066,524,542
50,12,3,Florida,Baker County,6,14,862,442,420
50,12,3,Florida,Baker County,6,15,594,289,305
50,12,3,Florida,Baker County,6,16,425,182,243
50,12,3,Florida,Baker County,6,17,265,83,182
50,12,3,Florida,Baker County,6,18,184,45,139
50,12,3,Florida,Baker County,6,99,24142,12729,11413
50,12,3,Florida,Baker County,7,0,375,190,185
50,12,3,Florida,Baker County,7,1,1491,762,729
50,12,3,Florida,Baker County,7,2,1727,860,867
50,12,3,Florida,Baker County,7,3,1795,973,822
50,12,3,Florida,Baker County,7,4,1878,988,890
50,12,3,Florida,Baker County,7,5,1786,958,828
50,12,3,Florida,Baker County,7,6,1653,949,704
50,12,3,Florida,Baker County,7,7,1703,938,765
50,12,3,Florida,Baker County,7,8,1781,1019,762
50,12,3,Florida,Baker County,7,9,1978,1059,919
50,12,3,Florida,Baker County,7,10,1956,1071,885
50,12,3,Florida,Baker County,7,11,1680,883,797
50,12,3,Florida,Baker County,7,12,1502,756,746
50,12,3,Florida,Baker County,7,13,1086,545,541
50,12,3,Florida,Baker County,7,14,908,475,433
50,12,3,Florida,Baker County,7,15,612,301,311
50,12,3,Florida,Baker County,7,16,441,187,254
50,12,3,Florida,Baker County,7,17,273,93,180
50,12,3,Florida,Baker County,7,18,207,50,157
50,12,3,Florida,Baker County,7,99,24832,13057,11775
50,12,3,Florida,Baker County,8,0,359,177,182
50,12,3,Florida,Baker County,8,1,1479,757,722
50,12,3,Florida,Baker County,8,2,1847,917,930
50,12,3,Florida,Baker County,8,3,1883,1013,870
50,12,3,Florida,Baker County,8,4,1917,1007,910
50,12,3,Florida,Baker County,8,5,1811,978,833
50,12,3,Florida,Baker County,8,6,1732,955,777
50,12,3,Florida,Baker County,8,7,1705,937,768
50,12,3,Florida,Baker County,8,8,1856,1046,810
50,12,3,Florida,Baker County,8,9,1920,1035,885
50,12,3,Florida,Baker County,8,10,2043,1127,916
50,12,3,Florida,Baker County,8,11,1744,893,851
50,12,3,Florida,Baker County,8,12,1558,798,760
50,12,3,Florida,Baker County,8,13,1141,554,587
50,12,3,Florida,Baker County,8,14,942,479,463
50,12,3,Florida,Baker County,8,15,664,336,328
50,12,3,Florida,Baker County,8,16,431,186,245
50,12,3,Florida,Baker County,8,17,305,106,199
50,12,3,Florida,Baker County,8,18,234,58,176
50,12,3,Florida,Baker County,8,99,25571,13359,12212
50,12,3,Florida,Baker County,9,0,391,195,196
50,12,3,Florida,Baker County,9,1,1531,786,745
50,12,3,Florida,Baker County,9,2,1935,953,982
50,12,3,Florida,Baker County,9,3,1851,961,890
50,12,3,Florida,Baker County,9,4,1895,1025,870
50,12,3,Florida,Baker County,9,5,1829,999,830
50,12,3,Florida,Baker County,9,6,1858,1016,842
50,12,3,Florida,Baker County,9,7,1709,971,738
50,12,3,Florida,Baker County,9,8,1916,1052,864
50,12,3,Florida,Baker County,9,9,1879,1029,850
50,12,3,Florida,Baker County,9,10,2093,1153,940
50,12,3,Florida,Baker County,9,11,1816,927,889
50,12,3,Florida,Baker County,9,12,1620,824,796
50,12,3,Florida,Baker County,9,13,1265,640,625
50,12,3,Florida,Baker County,9,14,953,471,482
50,12,3,Florida,Baker County,9,15,696,334,362
50,12,3,Florida,Baker County,9,16,413,194,219
50,12,3,Florida,Baker County,9,17,344,106,238
50,12,3,Florida,Baker County,9,18,218,62,156
50,12,3,Florida,Baker County,9,99,26212,13698,12514
50,12,3,Florida,Baker County,10,0,380,186,194
50,12,3,Florida,Baker County,10,1,1597,826,771
50,12,3,Florida,Baker County,10,2,1970,977,993
50,12,3,Florida,Baker County,10,3,1873,983,890
50,12,3,Florida,Baker County,10,4,1934,1022,912
50,12,3,Florida,Baker County,10,5,1834,981,853
50,12,3,Florida,Baker County,10,6,1879,1053,826
50,12,3,Florida,Baker County,10,7,1747,968,779
50,12,3,Florida,Baker County,10,8,1897,1046,851
50,12,3,Florida,Baker County,10,9,1944,1083,861
50,12,3,Florida,Baker County,10,10,2066,1134,932
50,12,3,Florida,Baker County,10,11,1861,933,928
50,12,3,Florida,Baker County,10,12,1649,836,813
50,12,3,Florida,Baker County,10,13,1339,664,675
50,12,3,Florida,Baker County,10,14,1004,501,503
50,12,3,Florida,Baker County,10,15,729,352,377
50,12,3,Florida,Baker County,10,16,446,215,231
50,12,3,Florida,Baker County,10,17,361,117,244
50,12,3,Florida,Baker County,10,18,215,60,155
50,12,3,Florida,Baker County,10,99,26725,13937,12788
50,12,3,Florida,Baker County,11,0,376,180,196
50,12,3,Florida,Baker County,11,1,1611,863,748
50,12,3,Florida,Baker County,11,2,2009,999,1010
50,12,3,Florida,Baker County,11,3,1926,971,955
50,12,3,Florida,Baker County,11,4,1922,1033,889
50,12,3,Florida,Baker County,11,5,1793,980,813
50,12,3,Florida,Baker County,11,6,1928,1046,882
50,12,3,Florida,Baker County,11,7,1759,978,781
50,12,3,Florida,Baker County,11,8,1901,1066,835
50,12,3,Florida,Baker County,11,9,1924,1063,861
50,12,3,Florida,Baker County,11,10,2128,1163,965
50,12,3,Florida,Baker County,11,11,1876,974,902
50,12,3,Florida,Baker County,11,12,1706,835,871
50,12,3,Florida,Baker County,11,13,1390,685,705
50,12,3,Florida,Baker County,11,14,1049,529,520
50,12,3,Florida,Baker County,11,15,750,376,374
50,12,3,Florida,Baker County,11,16,494,219,275
50,12,3,Florida,Baker County,11,17,356,133,223
50,12,3,Florida,Baker County,11,18,226,63,163
50,12,3,Florida,Baker County,11,99,27124,14156,12968
50,12,3,Florida,Baker County,12,0,351,167,184
50,12,3,Florida,Baker County,12,1,1582,837,745
50,12,3,Florida,Baker County,12,2,1991,998,993
50,12,3,Florida,Baker County,12,3,1962,1006,956
50,12,3,Florida,Baker County,12,4,1877,1006,871
50,12,3,Florida,Baker County,12,5,1766,966,800
50,12,3,Florida,Baker County,12,6,1893,1037,856
50,12,3,Florida,Baker County,12,7,1782,998,784
50,12,3,Florida,Baker County,12,8,1853,1031,822
50,12,3,Florida,Baker County,12,9,1931,1062,869
50,12,3,Florida,Baker County,12,10,2088,1150,938
50,12,3,Florida,Baker County,12,11,1930,975,955
50,12,3,Florida,Baker County,12,12,1692,853,839
50,12,3,Florida,Baker County,12,13,1461,713,748
50,12,3,Florida,Baker County,12,14,1063,538,525
50,12,3,Florida,Baker County,12,15,766,384,382
50,12,3,Florida,Baker County,12,16,520,225,295
50,12,3,Florida,Baker County,12,17,368,145,223
50,12,3,Florida,Baker County,12,18,239,69,170
50,12,3,Florida,Baker County,12,99,27115,14160,12955
50,12,3,Florida,Baker County,13,0,352,168,184
50,12,3,Florida,Baker County,13,1,1577,834,743
50,12,3,Florida,Baker County,13,2,1987,997,990
50,12,3,Florida,Baker County,13,3,1960,1006,954
50,12,3,Florida,Baker County,13,4,1862,1002,860
50,12,3,Florida,Baker County,13,5,1770,967,803
50,12,3,Florida,Baker County,13,6,1904,1045,859
50,12,3,Florida,Baker County,13,7,1792,1005,787
50,12,3,Florida,Baker County,13,8,1835,1023,812
50,12,3,Florida,Baker County,13,9,1934,1064,870
50,12,3,Florida,Baker County,13,10,2077,1144,933
50,12,3,Florida,Baker County,13,11,1932,978,954
50,12,3,Florida,Baker County,13,12,1697,853,844
50,12,3,Florida,Baker County,13,13,1471,715,756
50,12,3,Florida,Baker County,13,14,1061,538,523
50,12,3,Florida,Baker County,13,15,767,385,382
50,12,3,Florida,Baker County,13,16,521,227,294
50,12,3,Florida,Baker County,13,17,367,145,222
50,12,3,Florida,Baker County,13,18,240,69,171
50,12,3,Florida,Baker County,13,99,27106,14165,12941
50,12,5,Florida,Bay County,1,0,1786,954,832
50,12,5,Florida,Bay County,1,1,7193,3683,3510
50,12,5,Florida,Bay County,1,2,10102,5210,4892
50,12,5,Florida,Bay County,1,3,10327,5274,5053
50,12,5,Florida,Bay County,1,4,10114,5200,4914
50,12,5,Florida,Bay County,1,5,8959,4658,4301
50,12,5,Florida,Bay County,1,6,9666,4912,4754
50,12,5,Florida,Bay County,1,7,10083,5130,4953
50,12,5,Florida,Bay County,1,8,12608,6390,6218
50,12,5,Florida,Bay County,1,9,12399,6162,6237
50,12,5,Florida,Bay County,1,10,10636,5209,5427
50,12,5,Florida,Bay County,1,11,9748,4835,4913
50,12,5,Florida,Bay County,1,12,7903,3867,4036
50,12,5,Florida,Bay County,1,13,6926,3273,3653
50,12,5,Florida,Bay County,1,14,6191,2980,3211
50,12,5,Florida,Bay County,1,15,5554,2561,2993
50,12,5,Florida,Bay County,1,16,4044,1661,2383
50,12,5,Florida,Bay County,1,17,2280,924,1356
50,12,5,Florida,Bay County,1,18,1751,550,1201
50,12,5,Florida,Bay County,1,99,148270,73433,74837
50,12,5,Florida,Bay County,2,0,1803,964,839
50,12,5,Florida,Bay County,2,1,7161,3667,3494
50,12,5,Florida,Bay County,2,2,10032,5172,4860
50,12,5,Florida,Bay County,2,3,10348,5288,5060
50,12,5,Florida,Bay County,2,4,10121,5207,4914
50,12,5,Florida,Bay County,2,5,9030,4695,4335
50,12,5,Florida,Bay County,2,6,9578,4867,4711
50,12,5,Florida,Bay County,2,7,10059,5118,4941
50,12,5,Florida,Bay County,2,8,12539,6356,6183
50,12,5,Florida,Bay County,2,9,12412,6167,6245
50,12,5,Florida,Bay County,2,10,10684,5236,5448
50,12,5,Florida,Bay County,2,11,9837,4879,4958
50,12,5,Florida,Bay County,2,12,7937,3883,4054
50,12,5,Florida,Bay County,2,13,6947,3284,3663
50,12,5,Florida,Bay County,2,14,6201,2985,3216
50,12,5,Florida,Bay County,2,15,5561,2566,2995
50,12,5,Florida,Bay County,2,16,4066,1671,2395
50,12,5,Florida,Bay County,2,17,2308,936,1372
50,12,5,Florida,Bay County,2,18,1769,559,1210
50,12,5,Florida,Bay County,2,99,148393,73500,74893
50,12,5,Florida,Bay County,3,0,2017,1012,1005
50,12,5,Florida,Bay County,3,1,7158,3669,3489
50,12,5,Florida,Bay County,3,2,9802,5029,4773
50,12,5,Florida,Bay County,3,3,10514,5366,5148
50,12,5,Florida,Bay County,3,4,9969,5125,4844
50,12,5,Florida,Bay County,3,5,9519,4904,4615
50,12,5,Florida,Bay County,3,6,9318,4705,4613
50,12,5,Florida,Bay County,3,7,10126,5130,4996
50,12,5,Florida,Bay County,3,8,12015,6074,5941
50,12,5,Florida,Bay County,3,9,12705,6320,6385
50,12,5,Florida,Bay County,3,10,11184,5519,5665
50,12,5,Florida,Bay County,3,11,10246,5049,5197
50,12,5,Florida,Bay County,3,12,8136,4026,4110
50,12,5,Florida,Bay County,3,13,7106,3370,3736
50,12,5,Florida,Bay County,3,14,6260,2991,3269
50,12,5,Florida,Bay County,3,15,5604,2594,3010
50,12,5,Florida,Bay County,3,16,4203,1758,2445
50,12,5,Florida,Bay County,3,17,2511,1020,1491
50,12,5,Florida,Bay County,3,18,1814,579,1235
50,12,5,Florida,Bay County,3,99,150207,74240,75967
50,12,5,Florida,Bay County,4,0,1866,947,919
50,12,5,Florida,Bay County,4,1,7428,3816,3612
50,12,5,Florida,Bay County,4,2,9686,4969,4717
50,12,5,Florida,Bay County,4,3,10724,5500,5224
50,12,5,Florida,Bay County,4,4,10000,5135,4865
50,12,5,Florida,Bay County,4,5,9965,5077,4888
50,12,5,Florida,Bay County,4,6,9247,4688,4559
50,12,5,Florida,Bay County,4,7,10229,5147,5082
50,12,5,Florida,Bay County,4,8,11760,5973,5787
50,12,5,Florida,Bay County,4,9,12741,6369,6372
50,12,5,Florida,Bay County,4,10,11610,5683,5927
50,12,5,Florida,Bay County,4,11,10251,5021,5230
50,12,5,Florida,Bay County,4,12,8860,4388,4472
50,12,5,Florida,Bay County,4,13,7352,3554,3798
50,12,5,Florida,Bay County,4,14,6416,3008,3408
50,12,5,Florida,Bay County,4,15,5662,2657,3005
50,12,5,Florida,Bay County,4,16,4343,1849,2494
50,12,5,Florida,Bay County,4,17,2732,1086,1646
50,12,5,Florida,Bay County,4,18,1869,625,1244
50,12,5,Florida,Bay County,4,99,152741,75492,77249
50,12,5,Florida,Bay County,5,0,2014,1016,998
50,12,5,Florida,Bay County,5,1,7618,3939,3679
50,12,5,Florida,Bay County,5,2,9500,4863,4637
50,12,5,Florida,Bay County,5,3,10847,5613,5234
50,12,5,Florida,Bay County,5,4,10158,5267,4891
50,12,5,Florida,Bay County,5,5,10228,5136,5092
50,12,5,Florida,Bay County,5,6,9501,4796,4705
50,12,5,Florida,Bay County,5,7,10173,5048,5125
50,12,5,Florida,Bay County,5,8,11105,5591,5514
50,12,5,Florida,Bay County,5,9,12862,6419,6443
50,12,5,Florida,Bay County,5,10,12076,5922,6154
50,12,5,Florida,Bay County,5,11,10446,5099,5347
50,12,5,Florida,Bay County,5,12,9339,4647,4692
50,12,5,Florida,Bay County,5,13,7718,3773,3945
50,12,5,Florida,Bay County,5,14,6600,3117,3483
50,12,5,Florida,Bay County,5,15,5586,2589,2997
50,12,5,Florida,Bay County,5,16,4458,1907,2551
50,12,5,Florida,Bay County,5,17,2884,1134,1750
50,12,5,Florida,Bay County,5,18,1931,675,1256
50,12,5,Florida,Bay County,5,99,155044,76551,78493
50,12,5,Florida,Bay County,6,0,2054,1059,995
50,12,5,Florida,Bay County,6,1,7906,4060,3846
50,12,5,Florida,Bay County,6,2,9384,4817,4567
50,12,5,Florida,Bay County,6,3,10831,5569,5262
50,12,5,Florida,Bay County,6,4,10536,5428,5108
50,12,5,Florida,Bay County,6,5,10993,5653,5340
50,12,5,Florida,Bay County,6,6,9899,5057,4842
50,12,5,Florida,Bay County,6,7,10149,5052,5097
50,12,5,Florida,Bay County,6,8,10822,5459,5363
50,12,5,Florida,Bay County,6,9,13067,6564,6503
50,12,5,Florida,Bay County,6,10,12632,6155,6477
50,12,5,Florida,Bay County,6,11,10794,5273,5521
50,12,5,Florida,Bay County,6,12,9853,4882,4971
50,12,5,Florida,Bay County,6,13,7963,3895,4068
50,12,5,Florida,Bay County,6,14,6807,3190,3617
50,12,5,Florida,Bay County,6,15,5653,2635,3018
50,12,5,Florida,Bay County,6,16,4434,1964,2470
50,12,5,Florida,Bay County,6,17,2974,1158,1816
50,12,5,Florida,Bay County,6,18,2053,736,1317
50,12,5,Florida,Bay County,6,99,158804,78606,80198
50,12,5,Florida,Bay County,7,0,2311,1164,1147
50,12,5,Florida,Bay County,7,1,8106,4152,3954
50,12,5,Florida,Bay County,7,2,9644,4941,4703
50,12,5,Florida,Bay County,7,3,10727,5574,5153
50,12,5,Florida,Bay County,7,4,10872,5587,5285
50,12,5,Florida,Bay County,7,5,11402,5891,5511
50,12,5,Florida,Bay County,7,6,10544,5352,5192
50,12,5,Florida,Bay County,7,7,10281,5166,5115
50,12,5,Florida,Bay County,7,8,10691,5350,5341
50,12,5,Florida,Bay County,7,9,13216,6667,6549
50,12,5,Florida,Bay County,7,10,13036,6360,6676
50,12,5,Florida,Bay County,7,11,11183,5462,5721
50,12,5,Florida,Bay County,7,12,10387,5137,5250
50,12,5,Florida,Bay County,7,13,8220,4012,4208
50,12,5,Florida,Bay County,7,14,6855,3204,3651
50,12,5,Florida,Bay County,7,15,5623,2638,2985
50,12,5,Florida,Bay County,7,16,4588,2018,2570
50,12,5,Florida,Bay County,7,17,3075,1197,1878
50,12,5,Florida,Bay County,7,18,2156,805,1351
50,12,5,Florida,Bay County,7,99,162917,80677,82240
50,12,5,Florida,Bay County,8,0,2213,1122,1091
50,12,5,Florida,Bay County,8,1,8405,4310,4095
50,12,5,Florida,Bay County,8,2,9859,4966,4893
50,12,5,Florida,Bay County,8,3,10680,5563,5117
50,12,5,Florida,Bay County,8,4,11173,5738,5435
50,12,5,Florida,Bay County,8,5,11554,5942,5612
50,12,5,Florida,Bay County,8,6,11168,5685,5483
50,12,5,Florida,Bay County,8,7,10083,5089,4994
50,12,5,Florida,Bay County,8,8,10984,5508,5476
50,12,5,Florida,Bay County,8,9,12935,6514,6421
50,12,5,Florida,Bay County,8,10,13366,6614,6752
50,12,5,Florida,Bay County,8,11,11652,5650,6002
50,12,5,Florida,Bay County,8,12,10802,5294,5508
50,12,5,Florida,Bay County,8,13,8244,4037,4207
50,12,5,Florida,Bay County,8,14,6900,3262,3638
50,12,5,Florida,Bay County,8,15,5592,2593,2999
50,12,5,Florida,Bay County,8,16,4572,2035,2537
50,12,5,Florida,Bay County,8,17,3163,1244,1919
50,12,5,Florida,Bay County,8,18,2299,877,1422
50,12,5,Florida,Bay County,8,99,165644,82043,83601
50,12,5,Florida,Bay County,9,0,2217,1102,1115
50,12,5,Florida,Bay County,9,1,8442,4336,4106
50,12,5,Florida,Bay County,9,2,9792,4925,4867
50,12,5,Florida,Bay County,9,3,10373,5348,5025
50,12,5,Florida,Bay County,9,4,11221,5748,5473
50,12,5,Florida,Bay County,9,5,11256,5852,5404
50,12,5,Florida,Bay County,9,6,11323,5772,5551
50,12,5,Florida,Bay County,9,7,9755,4979,4776
50,12,5,Florida,Bay County,9,8,10919,5502,5417
50,12,5,Florida,Bay County,9,9,12456,6283,6173
50,12,5,Florida,Bay County,9,10,13438,6701,6737
50,12,5,Florida,Bay County,9,11,11929,5753,6176
50,12,5,Florida,Bay County,9,12,10588,5141,5447
50,12,5,Florida,Bay County,9,13,8776,4327,4449
50,12,5,Florida,Bay County,9,14,7028,3326,3702
50,12,5,Florida,Bay County,9,15,5634,2578,3056
50,12,5,Florida,Bay County,9,16,4601,2080,2521
50,12,5,Florida,Bay County,9,17,3174,1272,1902
50,12,5,Florida,Bay County,9,18,2423,896,1527
50,12,5,Florida,Bay County,9,99,165345,81921,83424
50,12,5,Florida,Bay County,10,0,2253,1114,1139
50,12,5,Florida,Bay County,10,1,8441,4351,4090
50,12,5,Florida,Bay County,10,2,9886,4912,4974
50,12,5,Florida,Bay County,10,3,10051,5186,4865
50,12,5,Florida,Bay County,10,4,11248,5760,5488
50,12,5,Florida,Bay County,10,5,11264,5835,5429
50,12,5,Florida,Bay County,10,6,11531,5872,5659
50,12,5,Florida,Bay County,10,7,9862,5033,4829
50,12,5,Florida,Bay County,10,8,10735,5372,5363
50,12,5,Florida,Bay County,10,9,11834,5962,5872
50,12,5,Florida,Bay County,10,10,13416,6685,6731
50,12,5,Florida,Bay County,10,11,12353,5968,6385
50,12,5,Florida,Bay County,10,12,10530,5084,5446
50,12,5,Florida,Bay County,10,13,9210,4584,4626
50,12,5,Florida,Bay County,10,14,7357,3530,3827
50,12,5,Florida,Bay County,10,15,5832,2684,3148
50,12,5,Florida,Bay County,10,16,4538,2010,2528
50,12,5,Florida,Bay County,10,17,3317,1330,1987
50,12,5,Florida,Bay County,10,18,2609,965,1644
50,12,5,Florida,Bay County,10,99,166267,82237,84030
50,12,5,Florida,Bay County,11,0,2176,1127,1049
50,12,5,Florida,Bay County,11,1,8496,4348,4148
50,12,5,Florida,Bay County,11,2,9827,4888,4939
50,12,5,Florida,Bay County,11,3,9984,5089,4895
50,12,5,Florida,Bay County,11,4,11092,5687,5405
50,12,5,Florida,Bay County,11,5,11516,5957,5559
50,12,5,Florida,Bay County,11,6,11645,5938,5707
50,12,5,Florida,Bay County,11,7,10122,5222,4900
50,12,5,Florida,Bay County,11,8,10495,5230,5265
50,12,5,Florida,Bay County,11,9,11412,5819,5593
50,12,5,Florida,Bay County,11,10,13512,6710,6802
50,12,5,Florida,Bay County,11,11,12727,6142,6585
50,12,5,Florida,Bay County,11,12,10700,5134,5566
50,12,5,Florida,Bay County,11,13,9561,4729,4832
50,12,5,Florida,Bay County,11,14,7599,3649,3950
50,12,5,Florida,Bay County,11,15,5902,2687,3215
50,12,5,Florida,Bay County,11,16,4599,2036,2563
50,12,5,Florida,Bay County,11,17,3309,1362,1947
50,12,5,Florida,Bay County,11,18,2790,1039,1751
50,12,5,Florida,Bay County,11,99,167464,82793,84671
50,12,5,Florida,Bay County,12,0,2157,1087,1070
50,12,5,Florida,Bay County,12,1,8476,4364,4112
50,12,5,Florida,Bay County,12,2,10014,4971,5043
50,12,5,Florida,Bay County,12,3,9993,5121,4872
50,12,5,Florida,Bay County,12,4,10889,5604,5285
50,12,5,Florida,Bay County,12,5,11624,5957,5667
50,12,5,Florida,Bay County,12,6,11754,6093,5661
50,12,5,Florida,Bay County,12,7,10396,5371,5025
50,12,5,Florida,Bay County,12,8,10322,5158,5164
50,12,5,Florida,Bay County,12,9,11259,5760,5499
50,12,5,Florida,Bay County,12,10,13579,6809,6770
50,12,5,Florida,Bay County,12,11,12929,6227,6702
50,12,5,Florida,Bay County,12,12,10925,5265,5660
50,12,5,Florida,Bay County,12,13,9976,4919,5057
50,12,5,Florida,Bay County,12,14,7731,3694,4037
50,12,5,Florida,Bay County,12,15,5947,2715,3232
50,12,5,Florida,Bay County,12,16,4617,2067,2550
50,12,5,Florida,Bay County,12,17,3430,1403,2027
50,12,5,Florida,Bay County,12,18,2834,1071,1763
50,12,5,Florida,Bay County,12,99,168852,83656,85196
50,12,5,Florida,Bay County,13,0,2164,1089,1075
50,12,5,Florida,Bay County,13,1,8467,4356,4111
50,12,5,Florida,Bay County,13,2,10033,4981,5052
50,12,5,Florida,Bay County,13,3,10001,5127,4874
50,12,5,Florida,Bay County,13,4,10836,5580,5256
50,12,5,Florida,Bay County,13,5,11675,5982,5693
50,12,5,Florida,Bay County,13,6,11799,6122,5677
50,12,5,Florida,Bay County,13,7,10490,5423,5067
50,12,5,Florida,Bay County,13,8,10265,5126,5139
50,12,5,Florida,Bay County,13,9,11258,5763,5495
50,12,5,Florida,Bay County,13,10,13544,6789,6755
50,12,5,Florida,Bay County,13,11,12974,6248,6726
50,12,5,Florida,Bay County,13,12,11001,5303,5698
50,12,5,Florida,Bay County,13,13,10086,4973,5113
50,12,5,Florida,Bay County,13,14,7782,3720,4062
50,12,5,Florida,Bay County,13,15,5989,2735,3254
50,12,5,Florida,Bay County,13,16,4619,2069,2550
50,12,5,Florida,Bay County,13,17,3436,1409,2027
50,12,5,Florida,Bay County,13,18,2853,1079,1774
50,12,5,Florida,Bay County,13,99,169272,83874,85398
50,12,7,Florida,Bradford County,1,0,267,135,132
50,12,7,Florida,Bradford County,1,1,1178,630,548
50,12,7,Florida,Bradford County,1,2,1540,798,742
50,12,7,Florida,Bradford County,1,3,1666,864,802
50,12,7,Florida,Bradford County,1,4,1769,930,839
50,12,7,Florida,Bradford County,1,5,1788,1132,656
50,12,7,Florida,Bradford County,1,6,1888,1239,649
50,12,7,Florida,Bradford County,1,7,1982,1315,667
50,12,7,Florida,Bradford County,1,8,2244,1465,779
50,12,7,Florida,Bradford County,1,9,2266,1341,925
50,12,7,Florida,Bradford County,1,10,1932,1117,815
50,12,7,Florida,Bradford County,1,11,1677,897,780
50,12,7,Florida,Bradford County,1,12,1372,708,664
50,12,7,Florida,Bradford County,1,13,1152,598,554
50,12,7,Florida,Bradford County,1,14,984,473,511
50,12,7,Florida,Bradford County,1,15,845,391,454
50,12,7,Florida,Bradford County,1,16,727,293,434
50,12,7,Florida,Bradford County,1,17,438,164,274
50,12,7,Florida,Bradford County,1,18,381,107,274
50,12,7,Florida,Bradford County,1,99,26096,14597,11499
50,12,7,Florida,Bradford County,2,0,266,135,131
50,12,7,Florida,Bradford County,2,1,1171,626,545
50,12,7,Florida,Bradford County,2,2,1537,796,741
50,12,7,Florida,Bradford County,2,3,1664,863,801
50,12,7,Florida,Bradford County,2,4,1771,932,839
50,12,7,Florida,Bradford County,2,5,1795,1136,659
50,12,7,Florida,Bradford County,2,6,1872,1230,642
50,12,7,Florida,Bradford County,2,7,1971,1306,665
50,12,7,Florida,Bradford County,2,8,2226,1452,774
50,12,7,Florida,Bradford County,2,9,2258,1336,922
50,12,7,Florida,Bradford County,2,10,1939,1121,818
50,12,7,Florida,Bradford County,2,11,1691,906,785
50,12,7,Florida,Bradford County,2,12,1376,711,665
50,12,7,Florida,Bradford County,2,13,1153,599,554
50,12,7,Florida,Bradford County,2,14,980,472,508
50,12,7,Florida,Bradford County,2,15,842,390,452
50,12,7,Florida,Bradford County,2,16,728,294,434
50,12,7,Florida,Bradford County,2,17,442,166,276
50,12,7,Florida,Bradford County,2,18,382,108,274
50,12,7,Florida,Bradford County,2,99,26064,14579,11485
50,12,7,Florida,Bradford County,3,0,319,163,156
50,12,7,Florida,Bradford County,3,1,1206,658,548
50,12,7,Florida,Bradford County,3,2,1518,756,762
50,12,7,Florida,Bradford County,3,3,1619,827,792
50,12,7,Florida,Bradford County,3,4,1676,914,762
50,12,7,Florida,Bradford County,3,5,1933,1173,760
50,12,7,Florida,Bradford County,3,6,1836,1187,649
50,12,7,Florida,Bradford County,3,7,1944,1276,668
50,12,7,Florida,Bradford County,3,8,2114,1366,748
50,12,7,Florida,Bradford County,3,9,2197,1321,876
50,12,7,Florida,Bradford County,3,10,1998,1136,862
50,12,7,Florida,Bradford County,3,11,1763,949,814
50,12,7,Florida,Bradford County,3,12,1400,733,667
50,12,7,Florida,Bradford County,3,13,1196,611,585
50,12,7,Florida,Bradford County,3,14,992,487,505
50,12,7,Florida,Bradford County,3,15,830,390,440
50,12,7,Florida,Bradford County,3,16,719,288,431
50,12,7,Florida,Bradford County,3,17,459,184,275
50,12,7,Florida,Bradford County,3,18,364,98,266
50,12,7,Florida,Bradford County,3,99,26083,14517,11566
50,12,7,Florida,Bradford County,4,0,305,169,136
50,12,7,Florida,Bradford County,4,1,1178,616,562
50,12,7,Florida,Bradford County,4,2,1512,765,747
50,12,7,Florida,Bradford County,4,3,1630,819,811
50,12,7,Florida,Bradford County,4,4,1626,888,738
50,12,7,Florida,Bradford County,4,5,1979,1211,768
50,12,7,Florida,Bradford County,4,6,1853,1228,625
50,12,7,Florida,Bradford County,4,7,1950,1284,666
50,12,7,Florida,Bradford County,4,8,2088,1363,725
50,12,7,Florida,Bradford County,4,9,2177,1324,853
50,12,7,Florida,Bradford County,4,10,2073,1160,913
50,12,7,Florida,Bradford County,4,11,1777,975,802
50,12,7,Florida,Bradford County,4,12,1504,801,703
50,12,7,Florida,Bradford County,4,13,1219,627,592
50,12,7,Florida,Bradford County,4,14,989,494,495
50,12,7,Florida,Bradford County,4,15,850,410,440
50,12,7,Florida,Bradford County,4,16,740,284,456
50,12,7,Florida,Bradford County,4,17,488,195,293
50,12,7,Florida,Bradford County,4,18,368,108,260
50,12,7,Florida,Bradford County,4,99,26306,14721,11585
50,12,7,Florida,Bradford County,5,0,306,173,133
50,12,7,Florida,Bradford County,5,1,1237,662,575
50,12,7,Florida,Bradford County,5,2,1515,802,713
50,12,7,Florida,Bradford County,5,3,1628,810,818
50,12,7,Florida,Bradford County,5,4,1612,862,750
50,12,7,Florida,Bradford County,5,5,2061,1297,764
50,12,7,Florida,Bradford County,5,6,1984,1351,633
50,12,7,Florida,Bradford County,5,7,2011,1354,657
50,12,7,Florida,Bradford County,5,8,2082,1377,705
50,12,7,Florida,Bradford County,5,9,2228,1359,869
50,12,7,Florida,Bradford County,5,10,2201,1256,945
50,12,7,Florida,Bradford County,5,11,1821,1017,804
50,12,7,Florida,Bradford County,5,12,1587,853,734
50,12,7,Florida,Bradford County,5,13,1269,625,644
50,12,7,Florida,Bradford County,5,14,1035,529,506
50,12,7,Florida,Bradford County,5,15,806,387,419
50,12,7,Florida,Bradford County,5,16,782,308,474
50,12,7,Florida,Bradford County,5,17,488,190,298
50,12,7,Florida,Bradford County,5,18,382,113,269
50,12,7,Florida,Bradford County,5,99,27035,15325,11710
50,12,7,Florida,Bradford County,6,0,333,175,158
50,12,7,Florida,Bradford County,6,1,1234,657,577
50,12,7,Florida,Bradford County,6,2,1509,787,722
50,12,7,Florida,Bradford County,6,3,1629,819,810
50,12,7,Florida,Bradford County,6,4,1633,859,774
50,12,7,Florida,Bradford County,6,5,2095,1347,748
50,12,7,Florida,Bradford County,6,6,2127,1452,675
50,12,7,Florida,Bradford County,6,7,2028,1398,630
50,12,7,Florida,Bradford County,6,8,2112,1404,708
50,12,7,Florida,Bradford County,6,9,2237,1403,834
50,12,7,Florida,Bradford County,6,10,2292,1349,943
50,12,7,Florida,Bradford County,6,11,1866,1046,820
50,12,7,Florida,Bradford County,6,12,1677,888,789
50,12,7,Florida,Bradford County,6,13,1331,668,663
50,12,7,Florida,Bradford County,6,14,1116,568,548
50,12,7,Florida,Bradford County,6,15,816,386,430
50,12,7,Florida,Bradford County,6,16,758,323,435
50,12,7,Florida,Bradford County,6,17,515,186,329
50,12,7,Florida,Bradford County,6,18,395,120,275
50,12,7,Florida,Bradford County,6,99,27703,15835,11868
50,12,7,Florida,Bradford County,7,0,346,179,167
50,12,7,Florida,Bradford County,7,1,1266,668,598
50,12,7,Florida,Bradford County,7,2,1560,810,750
50,12,7,Florida,Bradford County,7,3,1544,794,750
50,12,7,Florida,Bradford County,7,4,1650,875,775
50,12,7,Florida,Bradford County,7,5,2122,1328,794
50,12,7,Florida,Bradford County,7,6,2254,1522,732
50,12,7,Florida,Bradford County,7,7,1972,1356,616
50,12,7,Florida,Bradford County,7,8,2056,1359,697
50,12,7,Florida,Bradford County,7,9,2220,1409,811
50,12,7,Florida,Bradford County,7,10,2352,1391,961
50,12,7,Florida,Bradford County,7,11,1953,1074,879
50,12,7,Florida,Bradford County,7,12,1757,925,832
50,12,7,Florida,Bradford County,7,13,1340,693,647
50,12,7,Florida,Bradford County,7,14,1155,573,582
50,12,7,Florida,Bradford County,7,15,868,414,454
50,12,7,Florida,Bradford County,7,16,714,338,376
50,12,7,Florida,Bradford County,7,17,542,173,369
50,12,7,Florida,Bradford County,7,18,427,144,283
50,12,7,Florida,Bradford County,7,99,28098,16025,12073
50,12,7,Florida,Bradford County,8,0,359,196,163
50,12,7,Florida,Bradford County,8,1,1296,698,598
50,12,7,Florida,Bradford County,8,2,1647,821,826
50,12,7,Florida,Bradford County,8,3,1514,754,760
50,12,7,Florida,Bradford County,8,4,1631,867,764
50,12,7,Florida,Bradford County,8,5,2031,1306,725
50,12,7,Florida,Bradford County,8,6,2361,1587,774
50,12,7,Florida,Bradford County,8,7,1966,1346,620
50,12,7,Florida,Bradford County,8,8,2027,1349,678
50,12,7,Florida,Bradford County,8,9,2194,1383,811
50,12,7,Florida,Bradford County,8,10,2359,1421,938
50,12,7,Florida,Bradford County,8,11,2060,1131,929
50,12,7,Florida,Bradford County,8,12,1832,971,861
50,12,7,Florida,Bradford County,8,13,1403,737,666
50,12,7,Florida,Bradford County,8,14,1206,590,616
50,12,7,Florida,Bradford County,8,15,898,418,480
50,12,7,Florida,Bradford County,8,16,714,335,379
50,12,7,Florida,Bradford County,8,17,558,178,380
50,12,7,Florida,Bradford County,8,18,450,158,292
50,12,7,Florida,Bradford County,8,99,28506,16246,12260
50,12,7,Florida,Bradford County,9,0,391,219,172
50,12,7,Florida,Bradford County,9,1,1290,690,600
50,12,7,Florida,Bradford County,9,2,1641,830,811
50,12,7,Florida,Bradford County,9,3,1510,752,758
50,12,7,Florida,Bradford County,9,4,1674,885,789
50,12,7,Florida,Bradford County,9,5,1980,1278,702
50,12,7,Florida,Bradford County,9,6,2407,1615,792
50,12,7,Florida,Bradford County,9,7,2015,1374,641
50,12,7,Florida,Bradford County,9,8,2036,1343,693
50,12,7,Florida,Bradford County,9,9,2137,1355,782
50,12,7,Florida,Bradford County,9,10,2318,1413,905
50,12,7,Florida,Bradford County,9,11,2191,1186,1005
50,12,7,Florida,Bradford County,9,12,1837,985,852
50,12,7,Florida,Bradford County,9,13,1489,770,719
50,12,7,Florida,Bradford County,9,14,1234,611,623
50,12,7,Florida,Bradford County,9,15,891,419,472
50,12,7,Florida,Bradford County,9,16,761,341,420
50,12,7,Florida,Bradford County,9,17,571,192,379
50,12,7,Florida,Bradford County,9,18,452,152,300
50,12,7,Florida,Bradford County,9,99,28825,16410,12415
50,12,7,Florida,Bradford County,10,0,392,221,171
50,12,7,Florida,Bradford County,10,1,1320,702,618
50,12,7,Florida,Bradford County,10,2,1648,823,825
50,12,7,Florida,Bradford County,10,3,1481,757,724
50,12,7,Florida,Bradford County,10,4,1687,892,795
50,12,7,Florida,Bradford County,10,5,1986,1250,736
50,12,7,Florida,Bradford County,10,6,2403,1609,794
50,12,7,Florida,Bradford County,10,7,1983,1347,636
50,12,7,Florida,Bradford County,10,8,2020,1300,720
50,12,7,Florida,Bradford County,10,9,2075,1314,761
50,12,7,Florida,Bradford County,10,10,2362,1423,939
50,12,7,Florida,Bradford County,10,11,2233,1230,1003
50,12,7,Florida,Bradford County,10,12,1854,982,872
50,12,7,Florida,Bradford County,10,13,1540,789,751
50,12,7,Florida,Bradford County,10,14,1261,608,653
50,12,7,Florida,Bradford County,10,15,928,455,473
50,12,7,Florida,Bradford County,10,16,741,322,419
50,12,7,Florida,Bradford County,10,17,588,214,374
50,12,7,Florida,Bradford County,10,18,459,150,309
50,12,7,Florida,Bradford County,10,99,28961,16388,12573
50,12,7,Florida,Bradford County,11,0,380,200,180
50,12,7,Florida,Bradford County,11,1,1341,676,665
50,12,7,Florida,Bradford County,11,2,1580,818,762
50,12,7,Florida,Bradford County,11,3,1495,767,728
50,12,7,Florida,Bradford County,11,4,1638,871,767
50,12,7,Florida,Bradford County,11,5,1932,1226,706
50,12,7,Florida,Bradford County,11,6,2432,1628,804
50,12,7,Florida,Bradford County,11,7,2021,1378,643
50,12,7,Florida,Bradford County,11,8,1997,1305,692
50,12,7,Florida,Bradford County,11,9,2011,1288,723
50,12,7,Florida,Bradford County,11,10,2368,1438,930
50,12,7,Florida,Bradford County,11,11,2263,1252,1011
50,12,7,Florida,Bradford County,11,12,1849,1004,845
50,12,7,Florida,Bradford County,11,13,1605,791,814
50,12,7,Florida,Bradford County,11,14,1335,663,672
50,12,7,Florida,Bradford County,11,15,952,462,490
50,12,7,Florida,Bradford County,11,16,742,313,429
50,12,7,Florida,Bradford County,11,17,578,231,347
50,12,7,Florida,Bradford County,11,18,460,143,317
50,12,7,Florida,Bradford County,11,99,28979,16454,12525
50,12,7,Florida,Bradford County,12,0,350,191,159
50,12,7,Florida,Bradford County,12,1,1320,685,635
50,12,7,Florida,Bradford County,12,2,1571,786,785
50,12,7,Florida,Bradford County,12,3,1497,758,739
50,12,7,Florida,Bradford County,12,4,1571,845,726
50,12,7,Florida,Bradford County,12,5,1877,1171,706
50,12,7,Florida,Bradford County,12,6,2334,1548,786
50,12,7,Florida,Bradford County,12,7,2015,1347,668
50,12,7,Florida,Bradford County,12,8,1917,1225,692
50,12,7,Florida,Bradford County,12,9,1904,1205,699
50,12,7,Florida,Bradford County,12,10,2300,1390,910
50,12,7,Florida,Bradford County,12,11,2239,1240,999
50,12,7,Florida,Bradford County,12,12,1874,1011,863
50,12,7,Florida,Bradford County,12,13,1638,799,839
50,12,7,Florida,Bradford County,12,14,1362,665,697
50,12,7,Florida,Bradford County,12,15,961,467,494
50,12,7,Florida,Bradford County,12,16,780,315,465
50,12,7,Florida,Bradford County,12,17,523,216,307
50,12,7,Florida,Bradford County,12,18,487,146,341
50,12,7,Florida,Bradford County,12,99,28520,16010,12510
50,12,7,Florida,Bradford County,13,0,345,187,158
50,12,7,Florida,Bradford County,13,1,1317,680,637
50,12,7,Florida,Bradford County,13,2,1571,789,782
50,12,7,Florida,Bradford County,13,3,1489,757,732
50,12,7,Florida,Bradford County,13,4,1557,840,717
50,12,7,Florida,Bradford County,13,5,1876,1171,705
50,12,7,Florida,Bradford County,13,6,2341,1552,789
50,12,7,Florida,Bradford County,13,7,2017,1349,668
50,12,7,Florida,Bradford County,13,8,1905,1220,685
50,12,7,Florida,Bradford County,13,9,1913,1211,702
50,12,7,Florida,Bradford County,13,10,2291,1386,905
50,12,7,Florida,Bradford County,13,11,2236,1241,995
50,12,7,Florida,Bradford County,13,12,1876,1014,862
50,12,7,Florida,Bradford County,13,13,1644,803,841
50,12,7,Florida,Bradford County,13,14,1358,664,694
50,12,7,Florida,Bradford County,13,15,959,467,492
50,12,7,Florida,Bradford County,13,16,777,314,463
50,12,7,Florida,Bradford County,13,17,519,214,305
50,12,7,Florida,Bradford County,13,18,489,146,343
50,12,7,Florida,Bradford County,13,99,28480,16005,12475
50,12,9,Florida,Brevard County,1,0,4854,2497,2357
50,12,9,Florida,Brevard County,1,1,19856,10153,9703
50,12,9,Florida,Brevard County,1,2,29553,15050,14503
50,12,9,Florida,Brevard County,1,3,31999,16452,15547
50,12,9,Florida,Brevard County,1,4,29175,15346,13829
50,12,9,Florida,Brevard County,1,5,21500,11473,10027
50,12,9,Florida,Brevard County,1,6,22727,11333,11394
50,12,9,Florida,Brevard County,1,7,27925,13706,14219
50,12,9,Florida,Brevard County,1,8,38680,19145,19535
50,12,9,Florida,Brevard County,1,9,39751,19999,19752
50,12,9,Florida,Brevard County,1,10,33331,16681,16650
50,12,9,Florida,Brevard County,1,11,29923,14316,15607
50,12,9,Florida,Brevard County,1,12,26846,12646,14200
50,12,9,Florida,Brevard County,1,13,25476,11928,13548
50,12,9,Florida,Brevard County,1,14,26893,12949,13944
50,12,9,Florida,Brevard County,1,15,25067,11612,13455
50,12,9,Florida,Brevard County,1,16,21006,9299,11707
50,12,9,Florida,Brevard County,1,17,12776,5625,7151
50,12,9,Florida,Brevard County,1,18,8961,3017,5944
50,12,9,Florida,Brevard County,1,99,476299,233227,243072
50,12,9,Florida,Brevard County,2,0,4904,2522,2382
50,12,9,Florida,Brevard County,2,1,19801,10128,9673
50,12,9,Florida,Brevard County,2,2,29442,15003,14439
50,12,9,Florida,Brevard County,2,3,32150,16522,15628
50,12,9,Florida,Brevard County,2,4,29282,15419,13863
50,12,9,Florida,Brevard County,2,5,21674,11578,10096
50,12,9,Florida,Brevard County,2,6,22553,11243,11310
50,12,9,Florida,Brevard County,2,7,27923,13703,14220
50,12,9,Florida,Brevard County,2,8,38599,19106,19493
50,12,9,Florida,Brevard County,2,9,39871,20061,19810
50,12,9,Florida,Brevard County,2,10,33573,16800,16773
50,12,9,Florida,Brevard County,2,11,30283,14490,15793
50,12,9,Florida,Brevard County,2,12,27063,12752,14311
50,12,9,Florida,Brevard County,2,13,25610,11990,13620
50,12,9,Florida,Brevard County,2,14,26924,12967,13957
50,12,9,Florida,Brevard County,2,15,25135,11660,13475
50,12,9,Florida,Brevard County,2,16,21108,9355,11753
50,12,9,Florida,Brevard County,2,17,12908,5687,7221
50,12,9,Florida,Brevard County,2,18,9016,3041,5975
50,12,9,Florida,Brevard County,2,99,477819,234027,243792
50,12,9,Florida,Brevard County,3,0,4954,2566,2388
50,12,9,Florida,Brevard County,3,1,20055,10234,9821
50,12,9,Florida,Brevard County,3,2,28955,14715,14240
50,12,9,Florida,Brevard County,3,3,32985,16915,16070
50,12,9,Florida,Brevard County,3,4,29968,15929,14039
50,12,9,Florida,Brevard County,3,5,23312,12328,10984
50,12,9,Florida,Brevard County,3,6,21662,10833,10829
50,12,9,Florida,Brevard County,3,7,27496,13471,14025
50,12,9,Florida,Brevard County,3,8,37290,18376,18914
50,12,9,Florida,Brevard County,3,9,41470,20793,20677
50,12,9,Florida,Brevard County,3,10,35531,17712,17819
50,12,9,Florida,Brevard County,3,11,32023,15459,16564
50,12,9,Florida,Brevard County,3,12,27713,13148,14565
50,12,9,Florida,Brevard County,3,13,26158,12240,13918
50,12,9,Florida,Brevard County,3,14,27120,12933,14187
50,12,9,Florida,Brevard County,3,15,25560,12014,13546
50,12,9,Florida,Brevard County,3,16,21236,9383,11853
50,12,9,Florida,Brevard County,3,17,13739,6052,7687
50,12,9,Florida,Brevard County,3,18,9202,3187,6015
50,12,9,Florida,Brevard County,3,99,486429,238288,248141
50,12,9,Florida,Brevard County,4,0,4874,2551,2323
50,12,9,Florida,Brevard County,4,1,20174,10283,9891
50,12,9,Florida,Brevard County,4,2,28533,14542,13991
50,12,9,Florida,Brevard County,4,3,33709,17262,16447
50,12,9,Florida,Brevard County,4,4,30815,16458,14357
50,12,9,Florida,Brevard County,4,5,24847,13034,11813
50,12,9,Florida,Brevard County,4,6,21586,10813,10773
50,12,9,Florida,Brevard County,4,7,27173,13321,13852
50,12,9,Florida,Brevard County,4,8,35582,17471,18111
50,12,9,Florida,Brevard County,4,9,42299,21153,21146
50,12,9,Florida,Brevard County,4,10,38027,18888,19139
50,12,9,Florida,Brevard County,4,11,32278,15729,16549
50,12,9,Florida,Brevard County,4,12,30132,14321,15811
50,12,9,Florida,Brevard County,4,13,27050,12642,14408
50,12,9,Florida,Brevard County,4,14,27266,12923,14343
50,12,9,Florida,Brevard County,4,15,25850,12212,13638
50,12,9,Florida,Brevard County,4,16,21255,9381,11874
50,12,9,Florida,Brevard County,4,17,14449,6384,8065
50,12,9,Florida,Brevard County,4,18,9526,3332,6194
50,12,9,Florida,Brevard County,4,99,495425,242700,252725
50,12,9,Florida,Brevard County,5,0,4890,2505,2385
50,12,9,Florida,Brevard County,5,1,20492,10465,10027
50,12,9,Florida,Brevard County,5,2,28066,14369,13697
50,12,9,Florida,Brevard County,5,3,34019,17398,16621
50,12,9,Florida,Brevard County,5,4,31865,16965,14900
50,12,9,Florida,Brevard County,5,5,25889,13612,12277
50,12,9,Florida,Brevard County,5,6,22112,11138,10974
50,12,9,Florida,Brevard County,5,7,26901,13229,13672
50,12,9,Florida,Brevard County,5,8,34051,16668,17383
50,12,9,Florida,Brevard County,5,9,42632,21264,21368
50,12,9,Florida,Brevard County,5,10,40089,19820,20269
50,12,9,Florida,Brevard County,5,11,33471,16349,17122
50,12,9,Florida,Brevard County,5,12,31105,14850,16255
50,12,9,Florida,Brevard County,5,13,28692,13410,15282
50,12,9,Florida,Brevard County,5,14,27657,13007,14650
50,12,9,Florida,Brevard County,5,15,26358,12634,13724
50,12,9,Florida,Brevard County,5,16,21526,9518,12008
50,12,9,Florida,Brevard County,5,17,14963,6510,8453
50,12,9,Florida,Brevard County,5,18,10069,3580,6489
50,12,9,Florida,Brevard County,5,99,504847,247291,257556
50,12,9,Florida,Brevard County,6,0,5096,2616,2480
50,12,9,Florida,Brevard County,6,1,20900,10619,10281
50,12,9,Florida,Brevard County,6,2,28111,14409,13702
50,12,9,Florida,Brevard County,6,3,34223,17435,16788
50,12,9,Florida,Brevard County,6,4,33324,17674,15650
50,12,9,Florida,Brevard County,6,5,27253,14463,12790
50,12,9,Florida,Brevard County,6,6,23527,11925,11602
50,12,9,Florida,Brevard County,6,7,26805,13186,13619
50,12,9,Florida,Brevard County,6,8,32811,16021,16790
50,12,9,Florida,Brevard County,6,9,43339,21491,21848
50,12,9,Florida,Brevard County,6,10,42092,20740,21352
50,12,9,Florida,Brevard County,6,11,35543,17459,18084
50,12,9,Florida,Brevard County,6,12,32767,15567,17200
50,12,9,Florida,Brevard County,6,13,30160,14169,15991
50,12,9,Florida,Brevard County,6,14,28283,13382,14901
50,12,9,Florida,Brevard County,6,15,26379,12559,13820
50,12,9,Florida,Brevard County,6,16,21934,9844,12090
50,12,9,Florida,Brevard County,6,17,15595,6699,8896
50,12,9,Florida,Brevard County,6,18,10580,3839,6741
50,12,9,Florida,Brevard County,6,99,518722,254097,264625
50,12,9,Florida,Brevard County,7,0,5360,2707,2653
50,12,9,Florida,Brevard County,7,1,21248,10791,10457
50,12,9,Florida,Brevard County,7,2,28485,14615,13870
50,12,9,Florida,Brevard County,7,3,34053,17362,16691
50,12,9,Florida,Brevard County,7,4,34562,18323,16239
50,12,9,Florida,Brevard County,7,5,28231,14965,13266
50,12,9,Florida,Brevard County,7,6,25079,12686,12393
50,12,9,Florida,Brevard County,7,7,26579,13151,13428
50,12,9,Florida,Brevard County,7,8,32214,15803,16411
50,12,9,Florida,Brevard County,7,9,43041,21171,21870
50,12,9,Florida,Brevard County,7,10,44031,21782,22249
50,12,9,Florida,Brevard County,7,11,37820,18589,19231
50,12,9,Florida,Brevard County,7,12,34610,16471,18139
50,12,9,Florida,Brevard County,7,13,31039,14525,16514
50,12,9,Florida,Brevard County,7,14,28334,13379,14955
50,12,9,Florida,Brevard County,7,15,26412,12554,13858
50,12,9,Florida,Brevard County,7,16,22013,10059,11954
50,12,9,Florida,Brevard County,7,17,15767,6710,9057
50,12,9,Florida,Brevard County,7,18,11029,4065,6964
50,12,9,Florida,Brevard County,7,99,529907,259708,270199
50,12,9,Florida,Brevard County,8,0,5421,2814,2607
50,12,9,Florida,Brevard County,8,1,21311,10721,10590
50,12,9,Florida,Brevard County,8,2,28800,14775,14025
50,12,9,Florida,Brevard County,8,3,33546,17145,16401
50,12,9,Florida,Brevard County,8,4,35325,18703,16622
50,12,9,Florida,Brevard County,8,5,28523,15281,13242
50,12,9,Florida,Brevard County,8,6,26744,13390,13354
50,12,9,Florida,Brevard County,8,7,25675,12736,12939
50,12,9,Florida,Brevard County,8,8,31939,15559,16380
50,12,9,Florida,Brevard County,8,9,41495,20365,21130
50,12,9,Florida,Brevard County,8,10,45508,22433,23075
50,12,9,Florida,Brevard County,8,11,39636,19457,20179
50,12,9,Florida,Brevard County,8,12,36123,17385,18738
50,12,9,Florida,Brevard County,8,13,31181,14694,16487
50,12,9,Florida,Brevard County,8,14,28377,13361,15016
50,12,9,Florida,Brevard County,8,15,26134,12279,13855
50,12,9,Florida,Brevard County,8,16,22057,10226,11831
50,12,9,Florida,Brevard County,8,17,15728,6576,9152
50,12,9,Florida,Brevard County,8,18,11615,4428,7187
50,12,9,Florida,Brevard County,8,99,535138,262328,272810
50,12,9,Florida,Brevard County,9,0,5577,2954,2623
50,12,9,Florida,Brevard County,9,1,21390,10788,10602
50,12,9,Florida,Brevard County,9,2,28801,14711,14090
50,12,9,Florida,Brevard County,9,3,32987,16931,16056
50,12,9,Florida,Brevard County,9,4,35722,18846,16876
50,12,9,Florida,Brevard County,9,5,29005,15637,13368
50,12,9,Florida,Brevard County,9,6,27744,13745,13999
50,12,9,Florida,Brevard County,9,7,25251,12561,12690
50,12,9,Florida,Brevard County,9,8,31504,15345,16159
50,12,9,Florida,Brevard County,9,9,39515,19440,20075
50,12,9,Florida,Brevard County,9,10,46122,22707,23415
50,12,9,Florida,Brevard County,9,11,41721,20429,21292
50,12,9,Florida,Brevard County,9,12,35957,17416,18541
50,12,9,Florida,Brevard County,9,13,33156,15718,17438
50,12,9,Florida,Brevard County,9,14,28680,13402,15278
50,12,9,Florida,Brevard County,9,15,26204,12258,13946
50,12,9,Florida,Brevard County,9,16,22106,10275,11831
50,12,9,Florida,Brevard County,9,17,16069,6716,9353
50,12,9,Florida,Brevard County,9,18,12208,4675,7533
50,12,9,Florida,Brevard County,9,99,539719,264554,275165
50,12,9,Florida,Brevard County,10,0,5608,2954,2654
50,12,9,Florida,Brevard County,10,1,21614,11045,10569
50,12,9,Florida,Brevard County,10,2,28684,14581,14103
50,12,9,Florida,Brevard County,10,3,32250,16573,15677
50,12,9,Florida,Brevard County,10,4,35624,18808,16816
50,12,9,Florida,Brevard County,10,5,29301,15704,13597
50,12,9,Florida,Brevard County,10,6,28204,14098,14106
50,12,9,Florida,Brevard County,10,7,25306,12645,12661
50,12,9,Florida,Brevard County,10,8,30936,14962,15974
50,12,9,Florida,Brevard County,10,9,37184,18272,18912
50,12,9,Florida,Brevard County,10,10,46115,22668,23447
50,12,9,Florida,Brevard County,10,11,43405,21149,22256
50,12,9,Florida,Brevard County,10,12,36456,17728,18728
50,12,9,Florida,Brevard County,10,13,33774,16123,17651
50,12,9,Florida,Brevard County,10,14,29996,13986,16010
50,12,9,Florida,Brevard County,10,15,26359,12227,14132
50,12,9,Florida,Brevard County,10,16,22454,10488,11966
50,12,9,Florida,Brevard County,10,17,16290,6882,9408
50,12,9,Florida,Brevard County,10,18,12818,4865,7953
50,12,9,Florida,Brevard County,10,99,542378,265758,276620
50,12,9,Florida,Brevard County,11,0,5244,2713,2531
50,12,9,Florida,Brevard County,11,1,21883,11285,10598
50,12,9,Florida,Brevard County,11,2,28427,14538,13889
50,12,9,Florida,Brevard County,11,3,31528,16202,15326
50,12,9,Florida,Brevard County,11,4,35187,18553,16634
50,12,9,Florida,Brevard County,11,5,29193,15597,13596
50,12,9,Florida,Brevard County,11,6,28546,14365,14181
50,12,9,Florida,Brevard County,11,7,25561,12701,12860
50,12,9,Florida,Brevard County,11,8,29608,14361,15247
50,12,9,Florida,Brevard County,11,9,34879,17076,17803
50,12,9,Florida,Brevard County,11,10,45811,22387,23424
50,12,9,Florida,Brevard County,11,11,44520,21722,22798
50,12,9,Florida,Brevard County,11,12,37517,18298,19219
50,12,9,Florida,Brevard County,11,13,34714,16526,18188
50,12,9,Florida,Brevard County,11,14,30772,14394,16378
50,12,9,Florida,Brevard County,11,15,26471,12336,14135
50,12,9,Florida,Brevard County,11,16,22117,10352,11765
50,12,9,Florida,Brevard County,11,17,16533,7109,9424
50,12,9,Florida,Brevard County,11,18,13598,5138,8460
50,12,9,Florida,Brevard County,11,99,542109,265653,276456
50,12,9,Florida,Brevard County,12,0,5096,2653,2443
50,12,9,Florida,Brevard County,12,1,21713,11261,10452
50,12,9,Florida,Brevard County,12,2,28563,14611,13952
50,12,9,Florida,Brevard County,12,3,31269,15986,15283
50,12,9,Florida,Brevard County,12,4,34491,18192,16299
50,12,9,Florida,Brevard County,12,5,29335,15685,13650
50,12,9,Florida,Brevard County,12,6,28624,14418,14206
50,12,9,Florida,Brevard County,12,7,26171,13057,13114
50,12,9,Florida,Brevard County,12,8,28521,13864,14657
50,12,9,Florida,Brevard County,12,9,33627,16372,17255
50,12,9,Florida,Brevard County,12,10,44882,21809,23073
50,12,9,Florida,Brevard County,12,11,45720,22411,23309
50,12,9,Florida,Brevard County,12,12,38668,18878,19790
50,12,9,Florida,Brevard County,12,13,35984,17137,18847
50,12,9,Florida,Brevard County,12,14,31238,14634,16604
50,12,9,Florida,Brevard County,12,15,26448,12328,14120
50,12,9,Florida,Brevard County,12,16,22238,10365,11873
50,12,9,Florida,Brevard County,12,17,16687,7273,9414
50,12,9,Florida,Brevard County,12,18,14101,5308,8793
50,12,9,Florida,Brevard County,12,99,543376,266242,277134
50,12,9,Florida,Brevard County,13,0,5081,2648,2433
50,12,9,Florida,Brevard County,13,1,21594,11197,10397
50,12,9,Florida,Brevard County,13,2,28493,14581,13912
50,12,9,Florida,Brevard County,13,3,31170,15937,15233
50,12,9,Florida,Brevard County,13,4,34229,18060,16169
50,12,9,Florida,Brevard County,13,5,29374,15710,13664
50,12,9,Florida,Brevard County,13,6,28653,14459,14194
50,12,9,Florida,Brevard County,13,7,26297,13123,13174
50,12,9,Florida,Brevard County,13,8,28254,13737,14517
50,12,9,Florida,Brevard County,13,9,33531,16323,17208
50,12,9,Florida,Brevard County,13,10,44621,21686,22935
50,12,9,Florida,Brevard County,13,11,45724,22417,23307
50,12,9,Florida,Brevard County,13,12,38821,18947,19874
50,12,9,Florida,Brevard County,13,13,36336,17307,19029
50,12,9,Florida,Brevard County,13,14,31540,14796,16744
50,12,9,Florida,Brevard County,13,15,26697,12458,14239
50,12,9,Florida,Brevard County,13,16,22291,10396,11895
50,12,9,Florida,Brevard County,13,17,16690,7288,9402
50,12,9,Florida,Brevard County,13,18,14177,5347,8830
50,12,9,Florida,Brevard County,13,99,543573,266417,277156
50,12,11,Florida,Broward County,1,0,20198,10227,9971
50,12,11,Florida,Broward County,1,1,82844,42710,40134
50,12,11,Florida,Broward County,1,2,110139,56642,53497
50,12,11,Florida,Broward County,1,3,109133,55946,53187
50,12,11,Florida,Broward County,1,4,95159,48585,46574
50,12,11,Florida,Broward County,1,5,82830,40710,42120
50,12,11,Florida,Broward County,1,6,105810,51479,54331
50,12,11,Florida,Broward County,1,7,125050,61366,63684
50,12,11,Florida,Broward County,1,8,143480,71280,72200
50,12,11,Florida,Broward County,1,9,135066,67330,67736
50,12,11,Florida,Broward County,1,10,115578,56886,58692
50,12,11,Florida,Broward County,1,11,99494,48706,50788
50,12,11,Florida,Broward County,1,12,76544,36959,39585
50,12,11,Florida,Broward County,1,13,60553,28600,31953
50,12,11,Florida,Broward County,1,14,57028,25509,31519
50,12,11,Florida,Broward County,1,15,59611,25432,34179
50,12,11,Florida,Broward County,1,16,56742,22683,34059
50,12,11,Florida,Broward County,1,17,44665,16977,27688
50,12,11,Florida,Broward County,1,18,43050,15176,27874
50,12,11,Florida,Broward County,1,99,1622974,783203,839771
50,12,11,Florida,Broward County,2,0,20515,10394,10121
50,12,11,Florida,Broward County,2,1,82711,42639,40072
50,12,11,Florida,Broward County,2,2,109812,56472,53340
50,12,11,Florida,Broward County,2,3,110201,56489,53712
50,12,11,Florida,Broward County,2,4,95791,48937,46854
50,12,11,Florida,Broward County,2,5,83785,41203,42582
50,12,11,Florida,Broward County,2,6,105599,51323,54276
50,12,11,Florida,Broward County,2,7,125446,61514,63932
50,12,11,Florida,Broward County,2,8,143753,71399,72354
50,12,11,Florida,Broward County,2,9,136164,67840,68324
50,12,11,Florida,Broward County,2,10,116783,57484,59299
50,12,11,Florida,Broward County,2,11,101038,49463,51575
50,12,11,Florida,Broward County,2,12,77429,37403,40026
50,12,11,Florida,Broward County,2,13,61172,28905,32267
50,12,11,Florida,Broward County,2,14,56701,25391,31310
50,12,11,Florida,Broward County,2,15,59344,25357,33987
50,12,11,Florida,Broward County,2,16,56589,22647,33942
50,12,11,Florida,Broward County,2,17,44726,17021,27705
50,12,11,Florida,Broward County,2,18,43041,15171,27870
50,12,11,Florida,Broward County,2,99,1630600,787052,843548
50,12,11,Florida,Broward County,3,0,22515,11509,11006
50,12,11,Florida,Broward County,3,1,83257,42668,40589
50,12,11,Florida,Broward County,3,2,110009,56845,53164
50,12,11,Florida,Broward County,3,3,114117,58335,55782
50,12,11,Florida,Broward County,3,4,99195,51228,47967
50,12,11,Florida,Broward County,3,5,87726,43416,44310
50,12,11,Florida,Broward County,3,6,103587,50298,53289
50,12,11,Florida,Broward County,3,7,126573,61980,64593
50,12,11,Florida,Broward County,3,8,144461,71523,72938
50,12,11,Florida,Broward County,3,9,141138,70243,70895
50,12,11,Florida,Broward County,3,10,121382,59787,61595
50,12,11,Florida,Broward County,3,11,106809,52201,54608
50,12,11,Florida,Broward County,3,12,81125,39162,41963
50,12,11,Florida,Broward County,3,13,63463,30074,33389
50,12,11,Florida,Broward County,3,14,56743,25490,31253
50,12,11,Florida,Broward County,3,15,58348,25277,33071
50,12,11,Florida,Broward County,3,16,55441,22125,33316
50,12,11,Florida,Broward County,3,17,44490,16935,27555
50,12,11,Florida,Broward County,3,18,42469,14907,27562
50,12,11,Florida,Broward County,3,99,1662848,804003,858845
50,12,11,Florida,Broward County,4,0,22042,11360,10682
50,12,11,Florida,Broward County,4,1,85426,43734,41692
50,12,11,Florida,Broward County,4,2,109779,56705,53074
50,12,11,Florida,Broward County,4,3,117233,60216,57017
50,12,11,Florida,Broward County,4,4,102310,52831,49479
50,12,11,Florida,Broward County,4,5,91253,45088,46165
50,12,11,Florida,Broward County,4,6,103480,50448,53032
50,12,11,Florida,Broward County,4,7,126510,61810,64700
50,12,11,Florida,Broward County,4,8,142999,70369,72630
50,12,11,Florida,Broward County,4,9,145062,72234,72828
50,12,11,Florida,Broward County,4,10,126752,62519,64233
50,12,11,Florida,Broward County,4,11,108693,52994,55699
50,12,11,Florida,Broward County,4,12,88083,42565,45518
50,12,11,Florida,Broward County,4,13,66040,31370,34670
50,12,11,Florida,Broward County,4,14,56588,25690,30898
50,12,11,Florida,Broward County,4,15,57265,24775,32490
50,12,11,Florida,Broward County,4,16,54384,21721,32663
50,12,11,Florida,Broward County,4,17,44147,16801,27346
50,12,11,Florida,Broward County,4,18,42072,14747,27325
50,12,11,Florida,Broward County,4,99,1690118,817977,872141
50,12,11,Florida,Broward County,5,0,21844,11269,10575
50,12,11,Florida,Broward County,5,1,86365,44201,42164
50,12,11,Florida,Broward County,5,2,108902,56103,52799
50,12,11,Florida,Broward County,5,3,119287,61474,57813
50,12,11,Florida,Broward County,5,4,105558,54509,51049
50,12,11,Florida,Broward County,5,5,94184,46858,47326
50,12,11,Florida,Broward County,5,6,103726,50681,53045
50,12,11,Florida,Broward County,5,7,124767,60957,63810
50,12,11,Florida,Broward County,5,8,140225,68637,71588
50,12,11,Florida,Broward County,5,9,147424,73395,74029
50,12,11,Florida,Broward County,5,10,131195,64777,66418
50,12,11,Florida,Broward County,5,11,111154,54099,57055
50,12,11,Florida,Broward County,5,12,91761,44519,47242
50,12,11,Florida,Broward County,5,13,70096,33155,36941
50,12,11,Florida,Broward County,5,14,57235,26027,31208
50,12,11,Florida,Broward County,5,15,55911,24193,31718
50,12,11,Florida,Broward County,5,16,53090,21506,31584
50,12,11,Florida,Broward County,5,17,43457,16516,26941
50,12,11,Florida,Broward County,5,18,41362,14374,26988
50,12,11,Florida,Broward County,5,99,1707543,827250,880293
50,12,11,Florida,Broward County,6,0,21806,11072,10734
50,12,11,Florida,Broward County,6,1,87864,44827,43037
50,12,11,Florida,Broward County,6,2,107082,55137,51945
50,12,11,Florida,Broward County,6,3,120062,61782,58280
50,12,11,Florida,Broward County,6,4,109228,56571,52657
50,12,11,Florida,Broward County,6,5,97782,48617,49165
50,12,11,Florida,Broward County,6,6,106065,52046,54019
50,12,11,Florida,Broward County,6,7,122316,59416,62900
50,12,11,Florida,Broward County,6,8,136416,66646,69770
50,12,11,Florida,Broward County,6,9,149045,73876,75169
50,12,11,Florida,Broward County,6,10,135349,67012,68337
50,12,11,Florida,Broward County,6,11,114382,55642,58740
50,12,11,Florida,Broward County,6,12,96009,46538,49471
50,12,11,Florida,Broward County,6,13,73569,34820,38749
50,12,11,Florida,Broward County,6,14,58212,26662,31550
50,12,11,Florida,Broward County,6,15,54346,23581,30765
50,12,11,Florida,Broward County,6,16,51923,21342,30581
50,12,11,Florida,Broward County,6,17,43195,16377,26818
50,12,11,Florida,Broward County,6,18,40810,14042,26768
50,12,11,Florida,Broward County,6,99,1725461,836006,889455
50,12,11,Florida,Broward County,7,0,22432,11439,10993
50,12,11,Florida,Broward County,7,1,88589,45372,43217
50,12,11,Florida,Broward County,7,2,106541,54581,51960
50,12,11,Florida,Broward County,7,3,119399,61393,58006
50,12,11,Florida,Broward County,7,4,113356,58610,54746
50,12,11,Florida,Broward County,7,5,100759,50271,50488
50,12,11,Florida,Broward County,7,6,109120,53520,55600
50,12,11,Florida,Broward County,7,7,119758,58010,61748
50,12,11,Florida,Broward County,7,8,134510,65530,68980
50,12,11,Florida,Broward County,7,9,149194,73530,75664
50,12,11,Florida,Broward County,7,10,139283,69095,70188
50,12,11,Florida,Broward County,7,11,118660,57691,60969
50,12,11,Florida,Broward County,7,12,100728,48945,51783
50,12,11,Florida,Broward County,7,13,76693,36359,40334
50,12,11,Florida,Broward County,7,14,59560,27449,32111
50,12,11,Florida,Broward County,7,15,53435,23261,30174
50,12,11,Florida,Broward County,7,16,51363,21394,29969
50,12,11,Florida,Broward County,7,17,42652,16087,26565
50,12,11,Florida,Broward County,7,18,40864,14054,26810
50,12,11,Florida,Broward County,7,99,1746896,846591,900305
50,12,11,Florida,Broward County,8,0,21867,11091,10776
50,12,11,Florida,Broward County,8,1,86962,44454,42508
50,12,11,Florida,Broward County,8,2,105384,53821,51563
50,12,11,Florida,Broward County,8,3,117634,60622,57012
50,12,11,Florida,Broward County,8,4,115185,59380,55805
50,12,11,Florida,Broward County,8,5,100611,50587,50024
50,12,11,Florida,Broward County,8,6,110719,54162,56557
50,12,11,Florida,Broward County,8,7,114502,55417,59085
50,12,11,Florida,Broward County,8,8,132480,64450,68030
50,12,11,Florida,Broward County,8,9,146499,71963,74536
50,12,11,Florida,Broward County,8,10,141736,70112,71624
50,12,11,Florida,Broward County,8,11,121050,58998,62052
50,12,11,Florida,Broward County,8,12,104652,50819,53833
50,12,11,Florida,Broward County,8,13,78803,37267,41536
50,12,11,Florida,Broward County,8,14,59783,27695,32088
50,12,11,Florida,Broward County,8,15,51521,22612,28909
50,12,11,Florida,Broward County,8,16,48817,20512,28305
50,12,11,Florida,Broward County,8,17,40855,15379,25476
50,12,11,Florida,Broward County,8,18,40288,13850,26438
50,12,11,Florida,Broward County,8,99,1739348,843191,896157
50,12,11,Florida,Broward County,9,0,21405,10883,10522
50,12,11,Florida,Broward County,9,1,83895,42664,41231
50,12,11,Florida,Broward County,9,2,102542,52353,50189
50,12,11,Florida,Broward County,9,3,114588,59077,55511
50,12,11,Florida,Broward County,9,4,115062,59469,55593
50,12,11,Florida,Broward County,9,5,100888,50913,49975
50,12,11,Florida,Broward County,9,6,110979,54334,56645
50,12,11,Florida,Broward County,9,7,109771,53226,56545
50,12,11,Florida,Broward County,9,8,127798,62099,65699
50,12,11,Florida,Broward County,9,9,140709,68649,72060
50,12,11,Florida,Broward County,9,10,141365,70121,71244
50,12,11,Florida,Broward County,9,11,123447,60339,63108
50,12,11,Florida,Broward County,9,12,104800,50718,54082
50,12,11,Florida,Broward County,9,13,83092,39434,43658
50,12,11,Florida,Broward County,9,14,61715,28655,33060
50,12,11,Florida,Broward County,9,15,51049,22512,28537
50,12,11,Florida,Broward County,9,16,47593,20027,27566
50,12,11,Florida,Broward County,9,17,39781,14995,24786
50,12,11,Florida,Broward County,9,18,40346,14001,26345
50,12,11,Florida,Broward County,9,99,1720825,834469,886356
50,12,11,Florida,Broward County,10,0,21076,10796,10280
50,12,11,Florida,Broward County,10,1,83332,42404,40928
50,12,11,Florida,Broward County,10,2,102468,52375,50093
50,12,11,Florida,Broward County,10,3,113040,58185,54855
50,12,11,Florida,Broward County,10,4,115311,59802,55509
50,12,11,Florida,Broward County,10,5,101954,51387,50567
50,12,11,Florida,Broward County,10,6,111663,54382,57281
50,12,11,Florida,Broward County,10,7,108068,52183,55885
50,12,11,Florida,Broward County,10,8,124616,60514,64102
50,12,11,Florida,Broward County,10,9,136474,66264,70210
50,12,11,Florida,Broward County,10,10,141960,70355,71605
50,12,11,Florida,Broward County,10,11,126583,62039,64544
50,12,11,Florida,Broward County,10,12,106427,51310,55117
50,12,11,Florida,Broward County,10,13,86785,41499,45286
50,12,11,Florida,Broward County,10,14,65737,30726,35011
50,12,11,Florida,Broward County,10,15,51823,22995,28828
50,12,11,Florida,Broward County,10,16,46438,19579,26859
50,12,11,Florida,Broward County,10,17,39012,14999,24013
50,12,11,Florida,Broward County,10,18,40866,14079,26787
50,12,11,Florida,Broward County,10,99,1723633,835873,887760
50,12,11,Florida,Broward County,11,0,20035,10196,9839
50,12,11,Florida,Broward County,11,1,83363,42517,40846
50,12,11,Florida,Broward County,11,2,102972,52326,50646
50,12,11,Florida,Broward County,11,3,111934,57769,54165
50,12,11,Florida,Broward County,11,4,114941,59353,55588
50,12,11,Florida,Broward County,11,5,102760,51609,51151
50,12,11,Florida,Broward County,11,6,113077,54843,58234
50,12,11,Florida,Broward County,11,7,109139,52811,56328
50,12,11,Florida,Broward County,11,8,121691,58865,62826
50,12,11,Florida,Broward County,11,9,132611,64312,68299
50,12,11,Florida,Broward County,11,10,143592,70902,72690
50,12,11,Florida,Broward County,11,11,130351,63918,66433
50,12,11,Florida,Broward County,11,12,109299,52576,56723
50,12,11,Florida,Broward County,11,13,90547,43425,47122
50,12,11,Florida,Broward County,11,14,69351,32382,36969
50,12,11,Florida,Broward County,11,15,52780,23665,29115
50,12,11,Florida,Broward County,11,16,45110,19024,26086
50,12,11,Florida,Broward County,11,17,38386,14955,23431
50,12,11,Florida,Broward County,11,18,41371,14131,27240
50,12,11,Florida,Broward County,11,99,1733310,839579,893731
50,12,11,Florida,Broward County,12,0,20074,10217,9857
50,12,11,Florida,Broward County,12,1,83182,42438,40744
50,12,11,Florida,Broward County,12,2,104071,52938,51133
50,12,11,Florida,Broward County,12,3,112207,57800,54407
50,12,11,Florida,Broward County,12,4,114200,58922,55278
50,12,11,Florida,Broward County,12,5,104783,52502,52281
50,12,11,Florida,Broward County,12,6,113599,55272,58327
50,12,11,Florida,Broward County,12,7,110880,53431,57449
50,12,11,Florida,Broward County,12,8,120146,58036,62110
50,12,11,Florida,Broward County,12,9,131279,63594,67685
50,12,11,Florida,Broward County,12,10,143737,70701,73036
50,12,11,Florida,Broward County,12,11,133303,65509,67794
50,12,11,Florida,Broward County,12,12,112695,54163,58532
50,12,11,Florida,Broward County,12,13,94486,45296,49190
50,12,11,Florida,Broward County,12,14,71669,33709,37960
50,12,11,Florida,Broward County,12,15,53684,24202,29482
50,12,11,Florida,Broward County,12,16,44374,18829,25545
50,12,11,Florida,Broward County,12,17,38171,14947,23224
50,12,11,Florida,Broward County,12,18,41526,14065,27461
50,12,11,Florida,Broward County,12,99,1748066,846571,901495
50,12,11,Florida,Broward County,13,0,20130,10250,9880
50,12,11,Florida,Broward County,13,1,83277,42477,40800
50,12,11,Florida,Broward County,13,2,104310,53057,51253
50,12,11,Florida,Broward County,13,3,112326,57854,54472
50,12,11,Florida,Broward County,13,4,113875,58763,55112
50,12,11,Florida,Broward County,13,5,105387,52819,52568
50,12,11,Florida,Broward County,13,6,113878,55497,58381
50,12,11,Florida,Broward County,13,7,111647,53840,57807
50,12,11,Florida,Broward County,13,8,119820,57885,61935
50,12,11,Florida,Broward County,13,9,131442,63679,67763
50,12,11,Florida,Broward County,13,10,143633,70651,72982
50,12,11,Florida,Broward County,13,11,133942,65826,68116
50,12,11,Florida,Broward County,13,12,113434,54521,58913
50,12,11,Florida,Broward County,13,13,95549,45800,49749
50,12,11,Florida,Broward County,13,14,72172,33960,38212
50,12,11,Florida,Broward County,13,15,53998,24356,29642
50,12,11,Florida,Broward County,13,16,44474,18889,25585
50,12,11,Florida,Broward County,13,17,38386,15076,23310
50,12,11,Florida,Broward County,13,18,41898,14225,27673
50,12,11,Florida,Broward County,13,99,1753578,849425,904153
50,12,13,Florida,Calhoun County,1,0,143,78,65
50,12,13,Florida,Calhoun County,1,1,623,303,320
50,12,13,Florida,Calhoun County,1,2,769,385,384
50,12,13,Florida,Calhoun County,1,3,912,500,412
50,12,13,Florida,Calhoun County,1,4,878,458,420
50,12,13,Florida,Calhoun County,1,5,863,535,328
50,12,13,Florida,Calhoun County,1,6,1027,659,368
50,12,13,Florida,Calhoun County,1,7,1056,681,375
50,12,13,Florida,Calhoun County,1,8,999,617,382
50,12,13,Florida,Calhoun County,1,9,1014,579,435
50,12,13,Florida,Calhoun County,1,10,876,490,386
50,12,13,Florida,Calhoun County,1,11,748,393,355
50,12,13,Florida,Calhoun County,1,12,681,318,363
50,12,13,Florida,Calhoun County,1,13,600,300,300
50,12,13,Florida,Calhoun County,1,14,481,221,260
50,12,13,Florida,Calhoun County,1,15,468,223,245
50,12,13,Florida,Calhoun County,1,16,353,124,229
50,12,13,Florida,Calhoun County,1,17,250,84,166
50,12,13,Florida,Calhoun County,1,18,261,67,194
50,12,13,Florida,Calhoun County,1,99,13002,7015,5987
50,12,13,Florida,Calhoun County,2,0,145,78,67
50,12,13,Florida,Calhoun County,2,1,617,300,317
50,12,13,Florida,Calhoun County,2,2,763,382,381
50,12,13,Florida,Calhoun County,2,3,913,501,412
50,12,13,Florida,Calhoun County,2,4,882,460,422
50,12,13,Florida,Calhoun County,2,5,865,535,330
50,12,13,Florida,Calhoun County,2,6,1018,654,364
50,12,13,Florida,Calhoun County,2,7,1056,681,375
50,12,13,Florida,Calhoun County,2,8,998,617,381
50,12,13,Florida,Calhoun County,2,9,1017,580,437
50,12,13,Florida,Calhoun County,2,10,892,498,394
50,12,13,Florida,Calhoun County,2,11,753,395,358
50,12,13,Florida,Calhoun County,2,12,691,320,371
50,12,13,Florida,Calhoun County,2,13,603,300,303
50,12,13,Florida,Calhoun County,2,14,485,223,262
50,12,13,Florida,Calhoun County,2,15,474,224,250
50,12,13,Florida,Calhoun County,2,16,356,125,231
50,12,13,Florida,Calhoun County,2,17,253,87,166
50,12,13,Florida,Calhoun County,2,18,259,68,191
50,12,13,Florida,Calhoun County,2,99,13040,7028,6012
50,12,13,Florida,Calhoun County,3,0,140,63,77
50,12,13,Florida,Calhoun County,3,1,633,312,321
50,12,13,Florida,Calhoun County,3,2,705,358,347
50,12,13,Florida,Calhoun County,3,3,899,474,425
50,12,13,Florida,Calhoun County,3,4,870,468,402
50,12,13,Florida,Calhoun County,3,5,822,499,323
50,12,13,Florida,Calhoun County,3,6,966,612,354
50,12,13,Florida,Calhoun County,3,7,1007,637,370
50,12,13,Florida,Calhoun County,3,8,981,591,390
50,12,13,Florida,Calhoun County,3,9,976,576,400
50,12,13,Florida,Calhoun County,3,10,932,507,425
50,12,13,Florida,Calhoun County,3,11,778,416,362
50,12,13,Florida,Calhoun County,3,12,706,343,363
50,12,13,Florida,Calhoun County,3,13,587,284,303
50,12,13,Florida,Calhoun County,3,14,522,237,285
50,12,13,Florida,Calhoun County,3,15,475,232,243
50,12,13,Florida,Calhoun County,3,16,348,128,220
50,12,13,Florida,Calhoun County,3,17,261,92,169
50,12,13,Florida,Calhoun County,3,18,239,61,178
50,12,13,Florida,Calhoun County,3,99,12847,6890,5957
50,12,13,Florida,Calhoun County,4,0,157,81,76
50,12,13,Florida,Calhoun County,4,1,601,288,313
50,12,13,Florida,Calhoun County,4,2,711,358,353
50,12,13,Florida,Calhoun County,4,3,899,466,433
50,12,13,Florida,Calhoun County,4,4,857,459,398
50,12,13,Florida,Calhoun County,4,5,812,498,314
50,12,13,Florida,Calhoun County,4,6,937,602,335
50,12,13,Florida,Calhoun County,4,7,1023,655,368
50,12,13,Florida,Calhoun County,4,8,982,592,390
50,12,13,Florida,Calhoun County,4,9,961,557,404
50,12,13,Florida,Calhoun County,4,10,971,531,440
50,12,13,Florida,Calhoun County,4,11,815,457,358
50,12,13,Florida,Calhoun County,4,12,701,331,370
50,12,13,Florida,Calhoun County,4,13,633,310,323
50,12,13,Florida,Calhoun County,4,14,538,243,295
50,12,13,Florida,Calhoun County,4,15,501,243,258
50,12,13,Florida,Calhoun County,4,16,361,139,222
50,12,13,Florida,Calhoun County,4,17,266,93,173
50,12,13,Florida,Calhoun County,4,18,221,56,165
50,12,13,Florida,Calhoun County,4,99,12947,6959,5988
50,12,13,Florida,Calhoun County,5,0,167,88,79
50,12,13,Florida,Calhoun County,5,1,633,321,312
50,12,13,Florida,Calhoun County,5,2,758,365,393
50,12,13,Florida,Calhoun County,5,3,869,451,418
50,12,13,Florida,Calhoun County,5,4,891,472,419
50,12,13,Florida,Calhoun County,5,5,856,514,342
50,12,13,Florida,Calhoun County,5,6,948,610,338
50,12,13,Florida,Calhoun County,5,7,1004,634,370
50,12,13,Florida,Calhoun County,5,8,1011,623,388
50,12,13,Florida,Calhoun County,5,9,970,568,402
50,12,13,Florida,Calhoun County,5,10,1005,553,452
50,12,13,Florida,Calhoun County,5,11,822,449,373
50,12,13,Florida,Calhoun County,5,12,766,381,385
50,12,13,Florida,Calhoun County,5,13,637,313,324
50,12,13,Florida,Calhoun County,5,14,590,289,301
50,12,13,Florida,Calhoun County,5,15,488,229,259
50,12,13,Florida,Calhoun County,5,16,374,164,210
50,12,13,Florida,Calhoun County,5,17,273,82,191
50,12,13,Florida,Calhoun County,5,18,231,66,165
50,12,13,Florida,Calhoun County,5,99,13293,7172,6121
50,12,13,Florida,Calhoun County,6,0,163,83,80
50,12,13,Florida,Calhoun County,6,1,629,311,318
50,12,13,Florida,Calhoun County,6,2,779,391,388
50,12,13,Florida,Calhoun County,6,3,873,442,431
50,12,13,Florida,Calhoun County,6,4,896,486,410
50,12,13,Florida,Calhoun County,6,5,849,509,340
50,12,13,Florida,Calhoun County,6,6,996,631,365
50,12,13,Florida,Calhoun County,6,7,998,633,365
50,12,13,Florida,Calhoun County,6,8,988,632,356
50,12,13,Florida,Calhoun County,6,9,973,551,422
50,12,13,Florida,Calhoun County,6,10,1029,576,453
50,12,13,Florida,Calhoun County,6,11,825,443,382
50,12,13,Florida,Calhoun County,6,12,812,421,391
50,12,13,Florida,Calhoun County,6,13,669,316,353
50,12,13,Florida,Calhoun County,6,14,581,304,277
50,12,13,Florida,Calhoun County,6,15,499,217,282
50,12,13,Florida,Calhoun County,6,16,366,173,193
50,12,13,Florida,Calhoun County,6,17,290,84,206
50,12,13,Florida,Calhoun County,6,18,230,64,166
50,12,13,Florida,Calhoun County,6,99,13445,7267,6178
50,12,13,Florida,Calhoun County,7,0,174,89,85
50,12,13,Florida,Calhoun County,7,1,624,311,313
50,12,13,Florida,Calhoun County,7,2,855,425,430
50,12,13,Florida,Calhoun County,7,3,855,436,419
50,12,13,Florida,Calhoun County,7,4,945,497,448
50,12,13,Florida,Calhoun County,7,5,891,529,362
50,12,13,Florida,Calhoun County,7,6,964,616,348
50,12,13,Florida,Calhoun County,7,7,1008,600,408
50,12,13,Florida,Calhoun County,7,8,1039,666,373
50,12,13,Florida,Calhoun County,7,9,960,558,402
50,12,13,Florida,Calhoun County,7,10,1093,611,482
50,12,13,Florida,Calhoun County,7,11,864,455,409
50,12,13,Florida,Calhoun County,7,12,807,420,387
50,12,13,Florida,Calhoun County,7,13,722,331,391
50,12,13,Florida,Calhoun County,7,14,617,320,297
50,12,13,Florida,Calhoun County,7,15,502,223,279
50,12,13,Florida,Calhoun County,7,16,410,206,204
50,12,13,Florida,Calhoun County,7,17,270,80,190
50,12,13,Florida,Calhoun County,7,18,250,72,178
50,12,13,Florida,Calhoun County,7,99,13850,7445,6405
50,12,13,Florida,Calhoun County,8,0,198,97,101
50,12,13,Florida,Calhoun County,8,1,620,331,289
50,12,13,Florida,Calhoun County,8,2,844,406,438
50,12,13,Florida,Calhoun County,8,3,819,416,403
50,12,13,Florida,Calhoun County,8,4,920,469,451
50,12,13,Florida,Calhoun County,8,5,906,535,371
50,12,13,Florida,Calhoun County,8,6,987,600,387
50,12,13,Florida,Calhoun County,8,7,982,598,384
50,12,13,Florida,Calhoun County,8,8,1041,656,385
50,12,13,Florida,Calhoun County,8,9,976,566,410
50,12,13,Florida,Calhoun County,8,10,1085,619,466
50,12,13,Florida,Calhoun County,8,11,932,491,441
50,12,13,Florida,Calhoun County,8,12,844,440,404
50,12,13,Florida,Calhoun County,8,13,741,345,396
50,12,13,Florida,Calhoun County,8,14,613,306,307
50,12,13,Florida,Calhoun County,8,15,536,252,284
50,12,13,Florida,Calhoun County,8,16,405,202,203
50,12,13,Florida,Calhoun County,8,17,288,97,191
50,12,13,Florida,Calhoun County,8,18,260,79,181
50,12,13,Florida,Calhoun County,8,99,13997,7505,6492
50,12,13,Florida,Calhoun County,9,0,202,101,101
50,12,13,Florida,Calhoun County,9,1,626,322,304
50,12,13,Florida,Calhoun County,9,2,818,402,416
50,12,13,Florida,Calhoun County,9,3,841,413,428
50,12,13,Florida,Calhoun County,9,4,948,485,463
50,12,13,Florida,Calhoun County,9,5,892,520,372
50,12,13,Florida,Calhoun County,9,6,966,615,351
50,12,13,Florida,Calhoun County,9,7,998,603,395
50,12,13,Florida,Calhoun County,9,8,1074,688,386
50,12,13,Florida,Calhoun County,9,9,1004,575,429
50,12,13,Florida,Calhoun County,9,10,1078,626,452
50,12,13,Florida,Calhoun County,9,11,973,518,455
50,12,13,Florida,Calhoun County,9,12,919,495,424
50,12,13,Florida,Calhoun County,9,13,749,340,409
50,12,13,Florida,Calhoun County,9,14,658,332,326
50,12,13,Florida,Calhoun County,9,15,544,258,286
50,12,13,Florida,Calhoun County,9,16,396,203,193
50,12,13,Florida,Calhoun County,9,17,288,108,180
50,12,13,Florida,Calhoun County,9,18,248,73,175
50,12,13,Florida,Calhoun County,9,99,14222,7677,6545
50,12,13,Florida,Calhoun County,10,0,226,106,120
50,12,13,Florida,Calhoun County,10,1,672,352,320
50,12,13,Florida,Calhoun County,10,2,794,414,380
50,12,13,Florida,Calhoun County,10,3,848,407,441
50,12,13,Florida,Calhoun County,10,4,923,464,459
50,12,13,Florida,Calhoun County,10,5,888,530,358
50,12,13,Florida,Calhoun County,10,6,1007,603,404
50,12,13,Florida,Calhoun County,10,7,960,601,359
50,12,13,Florida,Calhoun County,10,8,1007,644,363
50,12,13,Florida,Calhoun County,10,9,1040,598,442
50,12,13,Florida,Calhoun County,10,10,1085,626,459
50,12,13,Florida,Calhoun County,10,11,1017,545,472
50,12,13,Florida,Calhoun County,10,12,926,500,426
50,12,13,Florida,Calhoun County,10,13,788,377,411
50,12,13,Florida,Calhoun County,10,14,658,316,342
50,12,13,Florida,Calhoun County,10,15,572,288,284
50,12,13,Florida,Calhoun County,10,16,401,184,217
50,12,13,Florida,Calhoun County,10,17,286,117,169
50,12,13,Florida,Calhoun County,10,18,253,71,182
50,12,13,Florida,Calhoun County,10,99,14351,7743,6608
50,12,13,Florida,Calhoun County,11,0,183,95,88
50,12,13,Florida,Calhoun County,11,1,718,358,360
50,12,13,Florida,Calhoun County,11,2,808,409,399
50,12,13,Florida,Calhoun County,11,3,855,425,430
50,12,13,Florida,Calhoun County,11,4,906,467,439
50,12,13,Florida,Calhoun County,11,5,919,540,379
50,12,13,Florida,Calhoun County,11,6,1030,648,382
50,12,13,Florida,Calhoun County,11,7,1034,638,396
50,12,13,Florida,Calhoun County,11,8,1020,659,361
50,12,13,Florida,Calhoun County,11,9,1032,640,392
50,12,13,Florida,Calhoun County,11,10,1113,632,481
50,12,13,Florida,Calhoun County,11,11,1081,597,484
50,12,13,Florida,Calhoun County,11,12,924,480,444
50,12,13,Florida,Calhoun County,11,13,830,410,420
50,12,13,Florida,Calhoun County,11,14,714,340,374
50,12,13,Florida,Calhoun County,11,15,570,302,268
50,12,13,Florida,Calhoun County,11,16,413,185,228
50,12,13,Florida,Calhoun County,11,17,285,125,160
50,12,13,Florida,Calhoun County,11,18,257,71,186
50,12,13,Florida,Calhoun County,11,99,14692,8021,6671
50,12,13,Florida,Calhoun County,12,0,183,91,92
50,12,13,Florida,Calhoun County,12,1,726,359,367
50,12,13,Florida,Calhoun County,12,2,814,415,399
50,12,13,Florida,Calhoun County,12,3,886,452,434
50,12,13,Florida,Calhoun County,12,4,869,442,427
50,12,13,Florida,Calhoun County,12,5,895,511,384
50,12,13,Florida,Calhoun County,12,6,1000,630,370
50,12,13,Florida,Calhoun County,12,7,992,615,377
50,12,13,Florida,Calhoun County,12,8,1004,636,368
50,12,13,Florida,Calhoun County,12,9,1025,618,407
50,12,13,Florida,Calhoun County,12,10,1089,629,460
50,12,13,Florida,Calhoun County,12,11,1107,609,498
50,12,13,Florida,Calhoun County,12,12,953,500,453
50,12,13,Florida,Calhoun County,12,13,824,405,419
50,12,13,Florida,Calhoun County,12,14,732,348,384
50,12,13,Florida,Calhoun County,12,15,588,313,275
50,12,13,Florida,Calhoun County,12,16,413,181,232
50,12,13,Florida,Calhoun County,12,17,280,131,149
50,12,13,Florida,Calhoun County,12,18,245,70,175
50,12,13,Florida,Calhoun County,12,99,14625,7955,6670
50,12,13,Florida,Calhoun County,13,0,179,87,92
50,12,13,Florida,Calhoun County,13,1,719,357,362
50,12,13,Florida,Calhoun County,13,2,812,416,396
50,12,13,Florida,Calhoun County,13,3,879,453,426
50,12,13,Florida,Calhoun County,13,4,870,444,426
50,12,13,Florida,Calhoun County,13,5,901,513,388
50,12,13,Florida,Calhoun County,13,6,1002,631,371
50,12,13,Florida,Calhoun County,13,7,996,617,379
50,12,13,Florida,Calhoun County,13,8,998,636,362
50,12,13,Florida,Calhoun County,13,9,1026,617,409
50,12,13,Florida,Calhoun County,13,10,1083,626,457
50,12,13,Florida,Calhoun County,13,11,1105,614,491
50,12,13,Florida,Calhoun County,13,12,956,498,458
50,12,13,Florida,Calhoun County,13,13,822,403,419
50,12,13,Florida,Calhoun County,13,14,728,348,380
50,12,13,Florida,Calhoun County,13,15,586,313,273
50,12,13,Florida,Calhoun County,13,16,414,181,233
50,12,13,Florida,Calhoun County,13,17,277,129,148
50,12,13,Florida,Calhoun County,13,18,246,70,176
50,12,13,Florida,Calhoun County,13,99,14599,7953,6646
50,12,15,Florida,Charlotte County,1,0,964,465,499
50,12,15,Florida,Charlotte County,1,1,4290,2168,2122
50,12,15,Florida,Charlotte County,1,2,6117,3111,3006
50,12,15,Florida,Charlotte County,1,3,6756,3408,3348
50,12,15,Florida,Charlotte County,1,4,6181,3169,3012
50,12,15,Florida,Charlotte County,1,5,4215,2220,1995
50,12,15,Florida,Charlotte County,1,6,4834,2428,2406
50,12,15,Florida,Charlotte County,1,7,5944,3020,2924
50,12,15,Florida,Charlotte County,1,8,7588,3726,3862
50,12,15,Florida,Charlotte County,1,9,8234,4010,4224
50,12,15,Florida,Charlotte County,1,10,8145,3763,4382
50,12,15,Florida,Charlotte County,1,11,8621,3864,4757
50,12,15,Florida,Charlotte County,1,12,9577,4235,5342
50,12,15,Florida,Charlotte County,1,13,10994,5017,5977
50,12,15,Florida,Charlotte County,1,14,12868,6368,6500
50,12,15,Florida,Charlotte County,1,15,13218,6324,6894
50,12,15,Florida,Charlotte County,1,16,11096,5294,5802
50,12,15,Florida,Charlotte County,1,17,6910,3130,3780
50,12,15,Florida,Charlotte County,1,18,5068,1933,3135
50,12,15,Florida,Charlotte County,1,99,141620,67653,73967
50,12,15,Florida,Charlotte County,2,0,975,468,507
50,12,15,Florida,Charlotte County,2,1,4286,2164,2122
50,12,15,Florida,Charlotte County,2,2,6119,3115,3004
50,12,15,Florida,Charlotte County,2,3,6797,3434,3363
50,12,15,Florida,Charlotte County,2,4,6218,3192,3026
50,12,15,Florida,Charlotte County,2,5,4265,2250,2015
50,12,15,Florida,Charlotte County,2,6,4803,2415,2388
50,12,15,Florida,Charlotte County,2,7,5955,3027,2928
50,12,15,Florida,Charlotte County,2,8,7575,3721,3854
50,12,15,Florida,Charlotte County,2,9,8285,4036,4249
50,12,15,Florida,Charlotte County,2,10,8221,3800,4421
50,12,15,Florida,Charlotte County,2,11,8739,3915,4824
50,12,15,Florida,Charlotte County,2,12,9683,4282,5401
50,12,15,Florida,Charlotte County,2,13,11081,5059,6022
50,12,15,Florida,Charlotte County,2,14,12851,6362,6489
50,12,15,Florida,Charlotte County,2,15,13224,6334,6890
50,12,15,Florida,Charlotte County,2,16,11129,5315,5814
50,12,15,Florida,Charlotte County,2,17,6965,3156,3809
50,12,15,Florida,Charlotte County,2,18,5095,1946,3149
50,12,15,Florida,Charlotte County,2,99,142266,67991,74275
50,12,15,Florida,Charlotte County,3,0,1044,528,516
50,12,15,Florida,Charlotte County,3,1,4278,2119,2159
50,12,15,Florida,Charlotte County,3,2,6042,3028,3014
50,12,15,Florida,Charlotte County,3,3,7012,3665,3347
50,12,15,Florida,Charlotte County,3,4,6446,3295,3151
50,12,15,Florida,Charlotte County,3,5,4533,2389,2144
50,12,15,Florida,Charlotte County,3,6,4582,2362,2220
50,12,15,Florida,Charlotte County,3,7,6033,3073,2960
50,12,15,Florida,Charlotte County,3,8,7467,3632,3835
50,12,15,Florida,Charlotte County,3,9,8650,4217,4433
50,12,15,Florida,Charlotte County,3,10,8528,3943,4585
50,12,15,Florida,Charlotte County,3,11,9483,4306,5177
50,12,15,Florida,Charlotte County,3,12,10126,4542,5584
50,12,15,Florida,Charlotte County,3,13,11568,5341,6227
50,12,15,Florida,Charlotte County,3,14,12909,6298,6611
50,12,15,Florida,Charlotte County,3,15,13576,6573,7003
50,12,15,Florida,Charlotte County,3,16,11432,5415,6017
50,12,15,Florida,Charlotte County,3,17,7188,3267,3921
50,12,15,Florida,Charlotte County,3,18,5414,2116,3298
50,12,15,Florida,Charlotte County,3,99,146311,70109,76202
50,12,15,Florida,Charlotte County,4,0,1022,498,524
50,12,15,Florida,Charlotte County,4,1,4264,2121,2143
50,12,15,Florida,Charlotte County,4,2,6114,3123,2991
50,12,15,Florida,Charlotte County,4,3,7214,3708,3506
50,12,15,Florida,Charlotte County,4,4,6743,3534,3209
50,12,15,Florida,Charlotte County,4,5,4878,2570,2308
50,12,15,Florida,Charlotte County,4,6,4549,2341,2208
50,12,15,Florida,Charlotte County,4,7,6071,3054,3017
50,12,15,Florida,Charlotte County,4,8,7343,3570,3773
50,12,15,Florida,Charlotte County,4,9,8952,4349,4603
50,12,15,Florida,Charlotte County,4,10,8953,4155,4798
50,12,15,Florida,Charlotte County,4,11,9650,4418,5232
50,12,15,Florida,Charlotte County,4,12,11036,4965,6071
50,12,15,Florida,Charlotte County,4,13,12017,5576,6441
50,12,15,Florida,Charlotte County,4,14,12988,6305,6683
50,12,15,Florida,Charlotte County,4,15,13623,6646,6977
50,12,15,Florida,Charlotte County,4,16,11670,5513,6157
50,12,15,Florida,Charlotte County,4,17,7525,3418,4107
50,12,15,Florida,Charlotte County,4,18,5511,2109,3402
50,12,15,Florida,Charlotte County,4,99,150123,71973,78150
50,12,15,Florida,Charlotte County,5,0,1070,532,538
50,12,15,Florida,Charlotte County,5,1,4417,2191,2226
50,12,15,Florida,Charlotte County,5,2,6193,3196,2997
50,12,15,Florida,Charlotte County,5,3,7330,3794,3536
50,12,15,Florida,Charlotte County,5,4,7038,3649,3389
50,12,15,Florida,Charlotte County,5,5,5118,2686,2432
50,12,15,Florida,Charlotte County,5,6,4679,2442,2237
50,12,15,Florida,Charlotte County,5,7,6072,3029,3043
50,12,15,Florida,Charlotte County,5,8,7218,3536,3682
50,12,15,Florida,Charlotte County,5,9,9079,4416,4663
50,12,15,Florida,Charlotte County,5,10,9323,4360,4963
50,12,15,Florida,Charlotte County,5,11,9926,4489,5437
50,12,15,Florida,Charlotte County,5,12,11539,5275,6264
50,12,15,Florida,Charlotte County,5,13,12748,5924,6824
50,12,15,Florida,Charlotte County,5,14,13237,6436,6801
50,12,15,Florida,Charlotte County,5,15,13340,6515,6825
50,12,15,Florida,Charlotte County,5,16,11685,5566,6119
50,12,15,Florida,Charlotte County,5,17,7714,3535,4179
50,12,15,Florida,Charlotte County,5,18,5509,2127,3382
50,12,15,Florida,Charlotte County,5,99,153235,73698,79537
50,12,15,Florida,Charlotte County,6,0,1051,544,507
50,12,15,Florida,Charlotte County,6,1,4515,2234,2281
50,12,15,Florida,Charlotte County,6,2,6361,3251,3110
50,12,15,Florida,Charlotte County,6,3,7497,3860,3637
50,12,15,Florida,Charlotte County,6,4,7252,3798,3454
50,12,15,Florida,Charlotte County,6,5,5539,2894,2645
50,12,15,Florida,Charlotte County,6,6,4922,2614,2308
50,12,15,Florida,Charlotte County,6,7,6066,3060,3006
50,12,15,Florida,Charlotte County,6,8,7263,3603,3660
50,12,15,Florida,Charlotte County,6,9,9169,4429,4740
50,12,15,Florida,Charlotte County,6,10,9938,4708,5230
50,12,15,Florida,Charlotte County,6,11,10213,4585,5628
50,12,15,Florida,Charlotte County,6,12,12264,5632,6632
50,12,15,Florida,Charlotte County,6,13,13522,6208,7314
50,12,15,Florida,Charlotte County,6,14,13661,6735,6926
50,12,15,Florida,Charlotte County,6,15,13179,6541,6638
50,12,15,Florida,Charlotte County,6,16,11623,5534,6089
50,12,15,Florida,Charlotte County,6,17,7996,3645,4351
50,12,15,Florida,Charlotte County,6,18,5724,2239,3485
50,12,15,Florida,Charlotte County,6,99,157755,76114,81641
50,12,15,Florida,Charlotte County,7,0,1161,592,569
50,12,15,Florida,Charlotte County,7,1,4342,2233,2109
50,12,15,Florida,Charlotte County,7,2,6053,3086,2967
50,12,15,Florida,Charlotte County,7,3,7242,3784,3458
50,12,15,Florida,Charlotte County,7,4,7418,3887,3531
50,12,15,Florida,Charlotte County,7,5,5480,2848,2632
50,12,15,Florida,Charlotte County,7,6,4994,2683,2311
50,12,15,Florida,Charlotte County,7,7,5669,2841,2828
50,12,15,Florida,Charlotte County,7,8,7054,3501,3553
50,12,15,Florida,Charlotte County,7,9,9014,4391,4623
50,12,15,Florida,Charlotte County,7,10,10048,4801,5247
50,12,15,Florida,Charlotte County,7,11,10298,4626,5672
50,12,15,Florida,Charlotte County,7,12,12659,5841,6818
50,12,15,Florida,Charlotte County,7,13,13754,6392,7362
50,12,15,Florida,Charlotte County,7,14,13457,6591,6866
50,12,15,Florida,Charlotte County,7,15,12583,6308,6275
50,12,15,Florida,Charlotte County,7,16,10865,5252,5613
50,12,15,Florida,Charlotte County,7,17,7716,3480,4236
50,12,15,Florida,Charlotte County,7,18,5455,2095,3360
50,12,15,Florida,Charlotte County,7,99,155262,75232,80030
50,12,15,Florida,Charlotte County,8,0,1178,609,569
50,12,15,Florida,Charlotte County,8,1,4442,2314,2128
50,12,15,Florida,Charlotte County,8,2,6215,3154,3061
50,12,15,Florida,Charlotte County,8,3,7221,3684,3537
50,12,15,Florida,Charlotte County,8,4,7621,4035,3586
50,12,15,Florida,Charlotte County,8,5,5766,2989,2777
50,12,15,Florida,Charlotte County,8,6,5405,2844,2561
50,12,15,Florida,Charlotte County,8,7,5527,2809,2718
50,12,15,Florida,Charlotte County,8,8,7284,3666,3618
50,12,15,Florida,Charlotte County,8,9,8886,4396,4490
50,12,15,Florida,Charlotte County,8,10,10340,4986,5354
50,12,15,Florida,Charlotte County,8,11,10565,4745,5820
50,12,15,Florida,Charlotte County,8,12,12977,5950,7027
50,12,15,Florida,Charlotte County,8,13,13853,6520,7333
50,12,15,Florida,Charlotte County,8,14,13391,6502,6889
50,12,15,Florida,Charlotte County,8,15,12284,6088,6196
50,12,15,Florida,Charlotte County,8,16,10834,5365,5469
50,12,15,Florida,Charlotte County,8,17,7641,3401,4240
50,12,15,Florida,Charlotte County,8,18,5669,2203,3466
50,12,15,Florida,Charlotte County,8,99,157099,76260,80839
50,12,15,Florida,Charlotte County,9,0,1241,621,620
50,12,15,Florida,Charlotte County,9,1,4536,2348,2188
50,12,15,Florida,Charlotte County,9,2,6375,3200,3175
50,12,15,Florida,Charlotte County,9,3,7226,3740,3486
50,12,15,Florida,Charlotte County,9,4,7764,4040,3724
50,12,15,Florida,Charlotte County,9,5,5970,3184,2786
50,12,15,Florida,Charlotte County,9,6,5709,2980,2729
50,12,15,Florida,Charlotte County,9,7,5654,2927,2727
50,12,15,Florida,Charlotte County,9,8,7247,3627,3620
50,12,15,Florida,Charlotte County,9,9,8692,4322,4370
50,12,15,Florida,Charlotte County,9,10,10521,5082,5439
50,12,15,Florida,Charlotte County,9,11,10771,4872,5899
50,12,15,Florida,Charlotte County,9,12,12670,5798,6872
50,12,15,Florida,Charlotte County,9,13,14614,6856,7758
50,12,15,Florida,Charlotte County,9,14,13818,6737,7081
50,12,15,Florida,Charlotte County,9,15,12406,6085,6321
50,12,15,Florida,Charlotte County,9,16,10878,5398,5480
50,12,15,Florida,Charlotte County,9,17,7762,3495,4267
50,12,15,Florida,Charlotte County,9,18,5888,2306,3582
50,12,15,Florida,Charlotte County,9,99,159742,77618,82124
50,12,15,Florida,Charlotte County,10,0,1240,619,621
50,12,15,Florida,Charlotte County,10,1,4565,2366,2199
50,12,15,Florida,Charlotte County,10,2,6295,3192,3103
50,12,15,Florida,Charlotte County,10,3,7042,3678,3364
50,12,15,Florida,Charlotte County,10,4,7699,4025,3674
50,12,15,Florida,Charlotte County,10,5,5992,3127,2865
50,12,15,Florida,Charlotte County,10,6,5819,2995,2824
50,12,15,Florida,Charlotte County,10,7,5548,2910,2638
50,12,15,Florida,Charlotte County,10,8,7056,3517,3539
50,12,15,Florida,Charlotte County,10,9,8330,4162,4168
50,12,15,Florida,Charlotte County,10,10,10534,5169,5365
50,12,15,Florida,Charlotte County,10,11,10866,4932,5934
50,12,15,Florida,Charlotte County,10,12,12401,5618,6783
50,12,15,Florida,Charlotte County,10,13,14712,6880,7832
50,12,15,Florida,Charlotte County,10,14,14663,7123,7540
50,12,15,Florida,Charlotte County,10,15,12778,6212,6566
50,12,15,Florida,Charlotte County,10,16,10803,5328,5475
50,12,15,Florida,Charlotte County,10,17,7897,3629,4268
50,12,15,Florida,Charlotte County,10,18,6227,2457,3770
50,12,15,Florida,Charlotte County,10,99,160467,77939,82528
50,12,15,Florida,Charlotte County,11,0,1138,542,596
50,12,15,Florida,Charlotte County,11,1,4628,2433,2195
50,12,15,Florida,Charlotte County,11,2,5979,3028,2951
50,12,15,Florida,Charlotte County,11,3,6890,3607,3283
50,12,15,Florida,Charlotte County,11,4,7569,3928,3641
50,12,15,Florida,Charlotte County,11,5,5747,3084,2663
50,12,15,Florida,Charlotte County,11,6,5772,3009,2763
50,12,15,Florida,Charlotte County,11,7,5385,2818,2567
50,12,15,Florida,Charlotte County,11,8,6663,3358,3305
50,12,15,Florida,Charlotte County,11,9,7917,3954,3963
50,12,15,Florida,Charlotte County,11,10,10278,4979,5299
50,12,15,Florida,Charlotte County,11,11,11129,5140,5989
50,12,15,Florida,Charlotte County,11,12,12099,5420,6679
50,12,15,Florida,Charlotte County,11,13,14814,6893,7921
50,12,15,Florida,Charlotte County,11,14,15243,7291,7952
50,12,15,Florida,Charlotte County,11,15,13149,6478,6671
50,12,15,Florida,Charlotte County,11,16,10678,5385,5293
50,12,15,Florida,Charlotte County,11,17,7961,3631,4330
50,12,15,Florida,Charlotte County,11,18,6590,2659,3931
50,12,15,Florida,Charlotte County,11,99,159629,77637,81992
50,12,15,Florida,Charlotte County,12,0,1010,490,520
50,12,15,Florida,Charlotte County,12,1,4535,2363,2172
50,12,15,Florida,Charlotte County,12,2,6031,3061,2970
50,12,15,Florida,Charlotte County,12,3,6773,3529,3244
50,12,15,Florida,Charlotte County,12,4,7336,3807,3529
50,12,15,Florida,Charlotte County,12,5,5805,3106,2699
50,12,15,Florida,Charlotte County,12,6,5704,2952,2752
50,12,15,Florida,Charlotte County,12,7,5482,2900,2582
50,12,15,Florida,Charlotte County,12,8,6318,3162,3156
50,12,15,Florida,Charlotte County,12,9,7777,3898,3879
50,12,15,Florida,Charlotte County,12,10,10052,4881,5171
50,12,15,Florida,Charlotte County,12,11,11180,5180,6000
50,12,15,Florida,Charlotte County,12,12,12192,5441,6751
50,12,15,Florida,Charlotte County,12,13,15184,7019,8165
50,12,15,Florida,Charlotte County,12,14,15550,7487,8063
50,12,15,Florida,Charlotte County,12,15,13395,6551,6844
50,12,15,Florida,Charlotte County,12,16,10823,5471,5352
50,12,15,Florida,Charlotte County,12,17,8061,3724,4337
50,12,15,Florida,Charlotte County,12,18,6770,2740,4030
50,12,15,Florida,Charlotte County,12,99,159978,77762,82216
50,12,15,Florida,Charlotte County,13,0,1012,488,524
50,12,15,Florida,Charlotte County,13,1,4510,2351,2159
50,12,15,Florida,Charlotte County,13,2,6036,3069,2967
50,12,15,Florida,Charlotte County,13,3,6753,3526,3227
50,12,15,Florida,Charlotte County,13,4,7269,3767,3502
50,12,15,Florida,Charlotte County,13,5,5833,3121,2712
50,12,15,Florida,Charlotte County,13,6,5706,2956,2750
50,12,15,Florida,Charlotte County,13,7,5506,2913,2593
50,12,15,Florida,Charlotte County,13,8,6259,3133,3126
50,12,15,Florida,Charlotte County,13,9,7756,3886,3870
50,12,15,Florida,Charlotte County,13,10,9980,4851,5129
50,12,15,Florida,Charlotte County,13,11,11178,5180,5998
50,12,15,Florida,Charlotte County,13,12,12223,5457,6766
50,12,15,Florida,Charlotte County,13,13,15314,7080,8234
50,12,15,Florida,Charlotte County,13,14,15602,7518,8084
50,12,15,Florida,Charlotte County,13,15,13433,6573,6860
50,12,15,Florida,Charlotte County,13,16,10773,5448,5325
50,12,15,Florida,Charlotte County,13,17,8049,3728,4321
50,12,15,Florida,Charlotte County,13,18,6798,2758,4040
50,12,15,Florida,Charlotte County,13,99,159990,77803,82187
50,12,17,Florida,Citrus County,1,0,808,406,402
50,12,17,Florida,Citrus County,1,1,3659,1864,1795
50,12,17,Florida,Citrus County,1,2,5540,2875,2665
50,12,17,Florida,Citrus County,1,3,6478,3374,3104
50,12,17,Florida,Citrus County,1,4,5690,2922,2768
50,12,17,Florida,Citrus County,1,5,3529,1784,1745
50,12,17,Florida,Citrus County,1,6,4098,1980,2118
50,12,17,Florida,Citrus County,1,7,5011,2388,2623
50,12,17,Florida,Citrus County,1,8,6408,3101,3307
50,12,17,Florida,Citrus County,1,9,7102,3429,3673
50,12,17,Florida,Citrus County,1,10,6938,3293,3645
50,12,17,Florida,Citrus County,1,11,7391,3358,4033
50,12,17,Florida,Citrus County,1,12,8188,3697,4491
50,12,17,Florida,Citrus County,1,13,9251,4388,4863
50,12,17,Florida,Citrus County,1,14,10198,5009,5189
50,12,17,Florida,Citrus County,1,15,10372,5093,5279
50,12,17,Florida,Citrus County,1,16,8502,3964,4538
50,12,17,Florida,Citrus County,1,17,5205,2387,2818
50,12,17,Florida,Citrus County,1,18,3738,1391,2347
50,12,17,Florida,Citrus County,1,99,118106,56703,61403
50,12,17,Florida,Citrus County,2,0,819,413,406
50,12,17,Florida,Citrus County,2,1,3651,1862,1789
50,12,17,Florida,Citrus County,2,2,5533,2871,2662
50,12,17,Florida,Citrus County,2,3,6528,3399,3129
50,12,17,Florida,Citrus County,2,4,5727,2942,2785
50,12,17,Florida,Citrus County,2,5,3576,1809,1767
50,12,17,Florida,Citrus County,2,6,4065,1965,2100
50,12,17,Florida,Citrus County,2,7,5015,2392,2623
50,12,17,Florida,Citrus County,2,8,6399,3097,3302
50,12,17,Florida,Citrus County,2,9,7141,3446,3695
50,12,17,Florida,Citrus County,2,10,7004,3329,3675
50,12,17,Florida,Citrus County,2,11,7494,3406,4088
50,12,17,Florida,Citrus County,2,12,8267,3735,4532
50,12,17,Florida,Citrus County,2,13,9316,4420,4896
50,12,17,Florida,Citrus County,2,14,10178,4998,5180
50,12,17,Florida,Citrus County,2,15,10376,5102,5274
50,12,17,Florida,Citrus County,2,16,8536,3983,4553
50,12,17,Florida,Citrus County,2,17,5258,2416,2842
50,12,17,Florida,Citrus County,2,18,3766,1405,2361
50,12,17,Florida,Citrus County,2,99,118649,56990,61659
50,12,17,Florida,Citrus County,3,0,866,428,438
50,12,17,Florida,Citrus County,3,1,3631,1813,1818
50,12,17,Florida,Citrus County,3,2,5547,2859,2688
50,12,17,Florida,Citrus County,3,3,6614,3426,3188
50,12,17,Florida,Citrus County,3,4,6119,3215,2904
50,12,17,Florida,Citrus County,3,5,3868,1931,1937
50,12,17,Florida,Citrus County,3,6,3859,1906,1953
50,12,17,Florida,Citrus County,3,7,4989,2394,2595
50,12,17,Florida,Citrus County,3,8,6383,3071,3312
50,12,17,Florida,Citrus County,3,9,7301,3535,3766
50,12,17,Florida,Citrus County,3,10,7296,3461,3835
50,12,17,Florida,Citrus County,3,11,7938,3583,4355
50,12,17,Florida,Citrus County,3,12,8567,3874,4693
50,12,17,Florida,Citrus County,3,13,9614,4550,5064
50,12,17,Florida,Citrus County,3,14,10199,4988,5211
50,12,17,Florida,Citrus County,3,15,10372,5205,5167
50,12,17,Florida,Citrus County,3,16,8646,4031,4615
50,12,17,Florida,Citrus County,3,17,5487,2531,2956
50,12,17,Florida,Citrus County,3,18,3901,1470,2431
50,12,17,Florida,Citrus County,3,99,121197,58271,62926
50,12,17,Florida,Citrus County,4,0,886,469,417
50,12,17,Florida,Citrus County,4,1,3623,1777,1846
50,12,17,Florida,Citrus County,4,2,5481,2803,2678
50,12,17,Florida,Citrus County,4,3,6741,3472,3269
50,12,17,Florida,Citrus County,4,4,6359,3346,3013
50,12,17,Florida,Citrus County,4,5,4126,2016,2110
50,12,17,Florida,Citrus County,4,6,3692,1862,1830
50,12,17,Florida,Citrus County,4,7,5041,2442,2599
50,12,17,Florida,Citrus County,4,8,6297,3059,3238
50,12,17,Florida,Citrus County,4,9,7367,3519,3848
50,12,17,Florida,Citrus County,4,10,7566,3647,3919
50,12,17,Florida,Citrus County,4,11,7903,3531,4372
50,12,17,Florida,Citrus County,4,12,9169,4119,5050
50,12,17,Florida,Citrus County,4,13,10107,4813,5294
50,12,17,Florida,Citrus County,4,14,10400,5128,5272
50,12,17,Florida,Citrus County,4,15,10244,5128,5116
50,12,17,Florida,Citrus County,4,16,8788,4181,4607
50,12,17,Florida,Citrus County,4,17,5687,2626,3061
50,12,17,Florida,Citrus County,4,18,4014,1521,2493
50,12,17,Florida,Citrus County,4,99,123491,59459,64032
50,12,17,Florida,Citrus County,5,0,937,490,447
50,12,17,Florida,Citrus County,5,1,3693,1829,1864
50,12,17,Florida,Citrus County,5,2,5495,2861,2634
50,12,17,Florida,Citrus County,5,3,6772,3475,3297
50,12,17,Florida,Citrus County,5,4,6485,3433,3052
50,12,17,Florida,Citrus County,5,5,4367,2170,2197
50,12,17,Florida,Citrus County,5,6,3725,1881,1844
50,12,17,Florida,Citrus County,5,7,4968,2389,2579
50,12,17,Florida,Citrus County,5,8,6254,3055,3199
50,12,17,Florida,Citrus County,5,9,7445,3551,3894
50,12,17,Florida,Citrus County,5,10,7932,3807,4125
50,12,17,Florida,Citrus County,5,11,7986,3567,4419
50,12,17,Florida,Citrus County,5,12,9612,4319,5293
50,12,17,Florida,Citrus County,5,13,10604,5044,5560
50,12,17,Florida,Citrus County,5,14,10888,5398,5490
50,12,17,Florida,Citrus County,5,15,10293,5164,5129
50,12,17,Florida,Citrus County,5,16,8818,4250,4568
50,12,17,Florida,Citrus County,5,17,5812,2675,3137
50,12,17,Florida,Citrus County,5,18,4129,1584,2545
50,12,17,Florida,Citrus County,5,99,126215,60942,65273
50,12,17,Florida,Citrus County,6,0,987,518,469
50,12,17,Florida,Citrus County,6,1,3815,1911,1904
50,12,17,Florida,Citrus County,6,2,5554,2842,2712
50,12,17,Florida,Citrus County,6,3,6879,3567,3312
50,12,17,Florida,Citrus County,6,4,6737,3531,3206
50,12,17,Florida,Citrus County,6,5,4637,2374,2263
50,12,17,Florida,Citrus County,6,6,3890,1930,1960
50,12,17,Florida,Citrus County,6,7,4902,2340,2562
50,12,17,Florida,Citrus County,6,8,6250,3003,3247
50,12,17,Florida,Citrus County,6,9,7635,3645,3990
50,12,17,Florida,Citrus County,6,10,8287,4018,4269
50,12,17,Florida,Citrus County,6,11,8349,3787,4562
50,12,17,Florida,Citrus County,6,12,10067,4504,5563
50,12,17,Florida,Citrus County,6,13,11142,5230,5912
50,12,17,Florida,Citrus County,6,14,11266,5654,5612
50,12,17,Florida,Citrus County,6,15,10332,5175,5157
50,12,17,Florida,Citrus County,6,16,8834,4332,4502
50,12,17,Florida,Citrus County,6,17,6099,2790,3309
50,12,17,Florida,Citrus County,6,18,4178,1628,2550
50,12,17,Florida,Citrus County,6,99,129840,62779,67061
50,12,17,Florida,Citrus County,7,0,1017,544,473
50,12,17,Florida,Citrus County,7,1,3947,1976,1971
50,12,17,Florida,Citrus County,7,2,5631,2842,2789
50,12,17,Florida,Citrus County,7,3,6875,3530,3345
50,12,17,Florida,Citrus County,7,4,7038,3706,3332
50,12,17,Florida,Citrus County,7,5,4803,2425,2378
50,12,17,Florida,Citrus County,7,6,4254,2089,2165
50,12,17,Florida,Citrus County,7,7,4783,2323,2460
50,12,17,Florida,Citrus County,7,8,6219,2993,3226
50,12,17,Florida,Citrus County,7,9,7818,3774,4044
50,12,17,Florida,Citrus County,7,10,8622,4130,4492
50,12,17,Florida,Citrus County,7,11,8943,4077,4866
50,12,17,Florida,Citrus County,7,12,10571,4722,5849
50,12,17,Florida,Citrus County,7,13,11829,5497,6332
50,12,17,Florida,Citrus County,7,14,11642,5847,5795
50,12,17,Florida,Citrus County,7,15,10390,5266,5124
50,12,17,Florida,Citrus County,7,16,8898,4378,4520
50,12,17,Florida,Citrus County,7,17,6100,2769,3331
50,12,17,Florida,Citrus County,7,18,4411,1722,2689
50,12,17,Florida,Citrus County,7,99,133791,64610,69181
50,12,17,Florida,Citrus County,8,0,1218,615,603
50,12,17,Florida,Citrus County,8,1,4024,2032,1992
50,12,17,Florida,Citrus County,8,2,5797,2936,2861
50,12,17,Florida,Citrus County,8,3,6996,3568,3428
50,12,17,Florida,Citrus County,8,4,7190,3789,3401
50,12,17,Florida,Citrus County,8,5,5066,2619,2447
50,12,17,Florida,Citrus County,8,6,4591,2225,2366
50,12,17,Florida,Citrus County,8,7,4716,2317,2399
50,12,17,Florida,Citrus County,8,8,6339,3054,3285
50,12,17,Florida,Citrus County,8,9,7894,3791,4103
50,12,17,Florida,Citrus County,8,10,8978,4324,4654
50,12,17,Florida,Citrus County,8,11,9460,4324,5136
50,12,17,Florida,Citrus County,8,12,11127,5027,6100
50,12,17,Florida,Citrus County,8,13,12276,5735,6541
50,12,17,Florida,Citrus County,8,14,11965,5948,6017
50,12,17,Florida,Citrus County,8,15,10502,5359,5143
50,12,17,Florida,Citrus County,8,16,8927,4410,4517
50,12,17,Florida,Citrus County,8,17,6113,2819,3294
50,12,17,Florida,Citrus County,8,18,4647,1810,2837
50,12,17,Florida,Citrus County,8,99,137826,66702,71124
50,12,17,Florida,Citrus County,9,0,1271,670,601
50,12,17,Florida,Citrus County,9,1,4272,2120,2152
50,12,17,Florida,Citrus County,9,2,5907,3006,2901
50,12,17,Florida,Citrus County,9,3,6898,3513,3385
50,12,17,Florida,Citrus County,9,4,7388,3882,3506
50,12,17,Florida,Citrus County,9,5,5360,2803,2557
50,12,17,Florida,Citrus County,9,6,4842,2358,2484
50,12,17,Florida,Citrus County,9,7,4738,2392,2346
50,12,17,Florida,Citrus County,9,8,6514,3139,3375
50,12,17,Florida,Citrus County,9,9,7827,3777,4050
50,12,17,Florida,Citrus County,9,10,9244,4412,4832
50,12,17,Florida,Citrus County,9,11,9796,4545,5251
50,12,17,Florida,Citrus County,9,12,10967,4958,6009
50,12,17,Florida,Citrus County,9,13,12900,5954,6946
50,12,17,Florida,Citrus County,9,14,12456,6155,6301
50,12,17,Florida,Citrus County,9,15,10619,5411,5208
50,12,17,Florida,Citrus County,9,16,8958,4427,4531
50,12,17,Florida,Citrus County,9,17,6176,2849,3327
50,12,17,Florida,Citrus County,9,18,4841,1888,2953
50,12,17,Florida,Citrus County,9,99,140974,68259,72715
50,12,17,Florida,Citrus County,10,0,1305,703,602
50,12,17,Florida,Citrus County,10,1,4366,2188,2178
50,12,17,Florida,Citrus County,10,2,5938,2997,2941
50,12,17,Florida,Citrus County,10,3,6932,3574,3358
50,12,17,Florida,Citrus County,10,4,7349,3823,3526
50,12,17,Florida,Citrus County,10,5,5392,2820,2572
50,12,17,Florida,Citrus County,10,6,4972,2434,2538
50,12,17,Florida,Citrus County,10,7,4741,2417,2324
50,12,17,Florida,Citrus County,10,8,6446,3113,3333
50,12,17,Florida,Citrus County,10,9,7628,3639,3989
50,12,17,Florida,Citrus County,10,10,9290,4464,4826
50,12,17,Florida,Citrus County,10,11,10070,4642,5428
50,12,17,Florida,Citrus County,10,12,10794,4892,5902
50,12,17,Florida,Citrus County,10,13,12999,6012,6987
50,12,17,Florida,Citrus County,10,14,12922,6335,6587
50,12,17,Florida,Citrus County,10,15,10921,5534,5387
50,12,17,Florida,Citrus County,10,16,8926,4418,4508
50,12,17,Florida,Citrus County,10,17,6156,2847,3309
50,12,17,Florida,Citrus County,10,18,4975,1942,3033
50,12,17,Florida,Citrus County,10,99,142122,68794,73328
50,12,17,Florida,Citrus County,11,0,1124,565,559
50,12,17,Florida,Citrus County,11,1,4523,2299,2224
50,12,17,Florida,Citrus County,11,2,5784,2962,2822
50,12,17,Florida,Citrus County,11,3,6686,3374,3312
50,12,17,Florida,Citrus County,11,4,7307,3813,3494
50,12,17,Florida,Citrus County,11,5,5393,2797,2596
50,12,17,Florida,Citrus County,11,6,4963,2504,2459
50,12,17,Florida,Citrus County,11,7,4712,2353,2359
50,12,17,Florida,Citrus County,11,8,6115,2974,3141
50,12,17,Florida,Citrus County,11,9,7293,3461,3832
50,12,17,Florida,Citrus County,11,10,9244,4492,4752
50,12,17,Florida,Citrus County,11,11,10163,4755,5408
50,12,17,Florida,Citrus County,11,12,10640,4760,5880
50,12,17,Florida,Citrus County,11,13,12885,5943,6942
50,12,17,Florida,Citrus County,11,14,13205,6383,6822
50,12,17,Florida,Citrus County,11,15,11166,5687,5479
50,12,17,Florida,Citrus County,11,16,8785,4343,4442
50,12,17,Florida,Citrus County,11,17,6255,2965,3290
50,12,17,Florida,Citrus County,11,18,5138,2005,3133
50,12,17,Florida,Citrus County,11,99,141381,68435,72946
50,12,17,Florida,Citrus County,12,0,1025,538,487
50,12,17,Florida,Citrus County,12,1,4512,2245,2267
50,12,17,Florida,Citrus County,12,2,5724,2926,2798
50,12,17,Florida,Citrus County,12,3,6602,3361,3241
50,12,17,Florida,Citrus County,12,4,7195,3767,3428
50,12,17,Florida,Citrus County,12,5,5357,2801,2556
50,12,17,Florida,Citrus County,12,6,5007,2532,2475
50,12,17,Florida,Citrus County,12,7,4858,2407,2451
50,12,17,Florida,Citrus County,12,8,5945,2909,3036
50,12,17,Florida,Citrus County,12,9,7134,3388,3746
50,12,17,Florida,Citrus County,12,10,9188,4470,4718
50,12,17,Florida,Citrus County,12,11,10147,4718,5429
50,12,17,Florida,Citrus County,12,12,10666,4854,5812
50,12,17,Florida,Citrus County,12,13,12835,5841,6994
50,12,17,Florida,Citrus County,12,14,13265,6375,6890
50,12,17,Florida,Citrus County,12,15,11332,5720,5612
50,12,17,Florida,Citrus County,12,16,8866,4446,4420
50,12,17,Florida,Citrus County,12,17,6300,2991,3309
50,12,17,Florida,Citrus County,12,18,5278,2070,3208
50,12,17,Florida,Citrus County,12,99,141236,68359,72877
50,12,17,Florida,Citrus County,13,0,1023,536,487
50,12,17,Florida,Citrus County,13,1,4485,2234,2251
50,12,17,Florida,Citrus County,13,2,5711,2925,2786
50,12,17,Florida,Citrus County,13,3,6573,3349,3224
50,12,17,Florida,Citrus County,13,4,7130,3734,3396
50,12,17,Florida,Citrus County,13,5,5378,2814,2564
50,12,17,Florida,Citrus County,13,6,5018,2541,2477
50,12,17,Florida,Citrus County,13,7,4888,2419,2469
50,12,17,Florida,Citrus County,13,8,5888,2879,3009
50,12,17,Florida,Citrus County,13,9,7112,3377,3735
50,12,17,Florida,Citrus County,13,10,9117,4434,4683
50,12,17,Florida,Citrus County,13,11,10138,4713,5425
50,12,17,Florida,Citrus County,13,12,10683,4863,5820
50,12,17,Florida,Citrus County,13,13,12927,5888,7039
50,12,17,Florida,Citrus County,13,14,13303,6396,6907
50,12,17,Florida,Citrus County,13,15,11349,5731,5618
50,12,17,Florida,Citrus County,13,16,8818,4424,4394
50,12,17,Florida,Citrus County,13,17,6291,2991,3300
50,12,17,Florida,Citrus County,13,18,5297,2082,3215
50,12,17,Florida,Citrus County,13,99,141129,68330,72799
50,12,19,Florida,Clay County,1,0,1775,860,915
50,12,19,Florida,Clay County,1,1,7451,3819,3632
50,12,19,Florida,Clay County,1,2,10991,5633,5358
50,12,19,Florida,Clay County,1,3,12077,6244,5833
50,12,19,Florida,Clay County,1,4,10874,5549,5325
50,12,19,Florida,Clay County,1,5,7338,3718,3620
50,12,19,Florida,Clay County,1,6,8164,4006,4158
50,12,19,Florida,Clay County,1,7,9733,4746,4987
50,12,19,Florida,Clay County,1,8,12640,6158,6482
50,12,19,Florida,Clay County,1,9,12183,5945,6238
50,12,19,Florida,Clay County,1,10,10807,5257,5550
50,12,19,Florida,Clay County,1,11,9840,4854,4986
50,12,19,Florida,Clay County,1,12,7445,3694,3751
50,12,19,Florida,Clay County,1,13,5696,2824,2872
50,12,19,Florida,Clay County,1,14,4327,2106,2221
50,12,19,Florida,Clay County,1,15,3555,1628,1927
50,12,19,Florida,Clay County,1,16,2775,1187,1588
50,12,19,Florida,Clay County,1,17,1736,695,1041
50,12,19,Florida,Clay County,1,18,1381,399,982
50,12,19,Florida,Clay County,1,99,140788,69322,71466
50,12,19,Florida,Clay County,2,0,1805,874,931
50,12,19,Florida,Clay County,2,1,7450,3817,3633
50,12,19,Florida,Clay County,2,2,10990,5632,5358
50,12,19,Florida,Clay County,2,3,12162,6289,5873
50,12,19,Florida,Clay County,2,4,10962,5604,5358
50,12,19,Florida,Clay County,2,5,7413,3757,3656
50,12,19,Florida,Clay County,2,6,8118,3985,4133
50,12,19,Florida,Clay County,2,7,9766,4762,5004
50,12,19,Florida,Clay County,2,8,12637,6152,6485
50,12,19,Florida,Clay County,2,9,12258,5978,6280
50,12,19,Florida,Clay County,2,10,10912,5307,5605
50,12,19,Florida,Clay County,2,11,9982,4923,5059
50,12,19,Florida,Clay County,2,12,7515,3729,3786
50,12,19,Florida,Clay County,2,13,5736,2843,2893
50,12,19,Florida,Clay County,2,14,4364,2124,2240
50,12,19,Florida,Clay County,2,15,3596,1646,1950
50,12,19,Florida,Clay County,2,16,2810,1204,1606
50,12,19,Florida,Clay County,2,17,1760,705,1055
50,12,19,Florida,Clay County,2,18,1393,404,989
50,12,19,Florida,Clay County,2,99,141629,69735,71894
50,12,19,Florida,Clay County,3,0,1821,907,914
50,12,19,Florida,Clay County,3,1,7693,3909,3784
50,12,19,Florida,Clay County,3,2,11030,5622,5408
50,12,19,Florida,Clay County,3,3,12492,6513,5979
50,12,19,Florida,Clay County,3,4,11211,5704,5507
50,12,19,Florida,Clay County,3,5,7868,3967,3901
50,12,19,Florida,Clay County,3,6,8066,3982,4084
50,12,19,Florida,Clay County,3,7,9943,4866,5077
50,12,19,Florida,Clay County,3,8,12430,6006,6424
50,12,19,Florida,Clay County,3,9,12877,6301,6576
50,12,19,Florida,Clay County,3,10,11226,5468,5758
50,12,19,Florida,Clay County,3,11,10566,5163,5403
50,12,19,Florida,Clay County,3,12,7904,3932,3972
50,12,19,Florida,Clay County,3,13,6019,2967,3052
50,12,19,Florida,Clay County,3,14,4552,2199,2353
50,12,19,Florida,Clay County,3,15,3766,1753,2013
50,12,19,Florida,Clay County,3,16,2929,1244,1685
50,12,19,Florida,Clay County,3,17,1818,720,1098
50,12,19,Florida,Clay County,3,18,1474,431,1043
50,12,19,Florida,Clay County,3,99,145685,71654,74031
50,12,19,Florida,Clay County,4,0,1882,950,932
50,12,19,Florida,Clay County,4,1,8072,4051,4021
50,12,19,Florida,Clay County,4,2,11155,5675,5480
50,12,19,Florida,Clay County,4,3,12836,6683,6153
50,12,19,Florida,Clay County,4,4,11731,5994,5737
50,12,19,Florida,Clay County,4,5,8401,4224,4177
50,12,19,Florida,Clay County,4,6,8273,4104,4169
50,12,19,Florida,Clay County,4,7,10222,4929,5293
50,12,19,Florida,Clay County,4,8,12276,5945,6331
50,12,19,Florida,Clay County,4,9,13312,6532,6780
50,12,19,Florida,Clay County,4,10,11800,5710,6090
50,12,19,Florida,Clay County,4,11,10547,5202,5345
50,12,19,Florida,Clay County,4,12,8807,4370,4437
50,12,19,Florida,Clay County,4,13,6445,3149,3296
50,12,19,Florida,Clay County,4,14,4733,2284,2449
50,12,19,Florida,Clay County,4,15,3930,1847,2083
50,12,19,Florida,Clay County,4,16,3037,1308,1729
50,12,19,Florida,Clay County,4,17,1974,779,1195
50,12,19,Florida,Clay County,4,18,1514,457,1057
50,12,19,Florida,Clay County,4,99,150947,74193,76754
50,12,19,Florida,Clay County,5,0,1964,1025,939
50,12,19,Florida,Clay County,5,1,8293,4250,4043
50,12,19,Florida,Clay County,5,2,11356,5759,5597
50,12,19,Florida,Clay County,5,3,13201,6748,6453
50,12,19,Florida,Clay County,5,4,12023,6186,5837
50,12,19,Florida,Clay County,5,5,8752,4390,4362
50,12,19,Florida,Clay County,5,6,8324,4115,4209
50,12,19,Florida,Clay County,5,7,10485,5003,5482
50,12,19,Florida,Clay County,5,8,12130,5795,6335
50,12,19,Florida,Clay County,5,9,13746,6826,6920
50,12,19,Florida,Clay County,5,10,12209,5913,6296
50,12,19,Florida,Clay County,5,11,10717,5197,5520
50,12,19,Florida,Clay County,5,12,9451,4695,4756
50,12,19,Florida,Clay County,5,13,6954,3406,3548
50,12,19,Florida,Clay County,5,14,5115,2483,2632
50,12,19,Florida,Clay County,5,15,4025,1894,2131
50,12,19,Florida,Clay County,5,16,3198,1366,1832
50,12,19,Florida,Clay County,5,17,2083,856,1227
50,12,19,Florida,Clay County,5,18,1594,482,1112
50,12,19,Florida,Clay County,5,99,155620,76389,79231
50,12,19,Florida,Clay County,6,0,2073,1055,1018
50,12,19,Florida,Clay County,6,1,8622,4380,4242
50,12,19,Florida,Clay County,6,2,12015,6119,5896
50,12,19,Florida,Clay County,6,3,13663,6955,6708
50,12,19,Florida,Clay County,6,4,12624,6580,6044
50,12,19,Florida,Clay County,6,5,9458,4754,4704
50,12,19,Florida,Clay County,6,6,8995,4407,4588
50,12,19,Florida,Clay County,6,7,10888,5096,5792
50,12,19,Florida,Clay County,6,8,12177,5899,6278
50,12,19,Florida,Clay County,6,9,14463,7187,7276
50,12,19,Florida,Clay County,6,10,12749,6218,6531
50,12,19,Florida,Clay County,6,11,11138,5414,5724
50,12,19,Florida,Clay County,6,12,9981,4874,5107
50,12,19,Florida,Clay County,6,13,7539,3658,3881
50,12,19,Florida,Clay County,6,14,5444,2651,2793
50,12,19,Florida,Clay County,6,15,4179,1994,2185
50,12,19,Florida,Clay County,6,16,3330,1453,1877
50,12,19,Florida,Clay County,6,17,2294,928,1366
50,12,19,Florida,Clay County,6,18,1606,484,1122
50,12,19,Florida,Clay County,6,99,163238,80106,83132
50,12,19,Florida,Clay County,7,0,2107,1067,1040
50,12,19,Florida,Clay County,7,1,8792,4470,4322
50,12,19,Florida,Clay County,7,2,12572,6402,6170
50,12,19,Florida,Clay County,7,3,13892,7055,6837
50,12,19,Florida,Clay County,7,4,13219,6917,6302
50,12,19,Florida,Clay County,7,5,9810,4975,4835
50,12,19,Florida,Clay County,7,6,9269,4571,4698
50,12,19,Florida,Clay County,7,7,10917,5182,5735
50,12,19,Florida,Clay County,7,8,12676,6167,6509
50,12,19,Florida,Clay County,7,9,14859,7336,7523
50,12,19,Florida,Clay County,7,10,13363,6511,6852
50,12,19,Florida,Clay County,7,11,11666,5680,5986
50,12,19,Florida,Clay County,7,12,10684,5190,5494
50,12,19,Florida,Clay County,7,13,8054,3961,4093
50,12,19,Florida,Clay County,7,14,5763,2782,2981
50,12,19,Florida,Clay County,7,15,4358,2035,2323
50,12,19,Florida,Clay County,7,16,3353,1466,1887
50,12,19,Florida,Clay County,7,17,2371,992,1379
50,12,19,Florida,Clay County,7,18,1693,520,1173
50,12,19,Florida,Clay County,7,99,169418,83279,86139
50,12,19,Florida,Clay County,8,0,2257,1171,1086
50,12,19,Florida,Clay County,8,1,9162,4730,4432
50,12,19,Florida,Clay County,8,2,13300,6806,6494
50,12,19,Florida,Clay County,8,3,14388,7236,7152
50,12,19,Florida,Clay County,8,4,13932,7285,6647
50,12,19,Florida,Clay County,8,5,10145,5145,5000
50,12,19,Florida,Clay County,8,6,10087,5021,5066
50,12,19,Florida,Clay County,8,7,11008,5219,5789
50,12,19,Florida,Clay County,8,8,13329,6434,6895
50,12,19,Florida,Clay County,8,9,15099,7449,7650
50,12,19,Florida,Clay County,8,10,14452,7031,7421
50,12,19,Florida,Clay County,8,11,12249,5922,6327
50,12,19,Florida,Clay County,8,12,11570,5614,5956
50,12,19,Florida,Clay County,8,13,8581,4233,4348
50,12,19,Florida,Clay County,8,14,6239,2974,3265
50,12,19,Florida,Clay County,8,15,4713,2220,2493
50,12,19,Florida,Clay County,8,16,3573,1605,1968
50,12,19,Florida,Clay County,8,17,2477,1011,1466
50,12,19,Florida,Clay County,8,18,1778,552,1226
50,12,19,Florida,Clay County,8,99,178339,87658,90681
50,12,19,Florida,Clay County,9,0,2294,1146,1148
50,12,19,Florida,Clay County,9,1,9428,4858,4570
50,12,19,Florida,Clay County,9,2,13774,7033,6741
50,12,19,Florida,Clay County,9,3,14776,7455,7321
50,12,19,Florida,Clay County,9,4,14614,7647,6967
50,12,19,Florida,Clay County,9,5,10364,5250,5114
50,12,19,Florida,Clay County,9,6,10331,5071,5260
50,12,19,Florida,Clay County,9,7,11159,5321,5838
50,12,19,Florida,Clay County,9,8,13797,6631,7166
50,12,19,Florida,Clay County,9,9,14969,7362,7607
50,12,19,Florida,Clay County,9,10,15094,7422,7672
50,12,19,Florida,Clay County,9,11,12893,6159,6734
50,12,19,Florida,Clay County,9,12,11685,5650,6035
50,12,19,Florida,Clay County,9,13,9340,4614,4726
50,12,19,Florida,Clay County,9,14,6699,3181,3518
50,12,19,Florida,Clay County,9,15,4869,2283,2586
50,12,19,Florida,Clay County,9,16,3704,1680,2024
50,12,19,Florida,Clay County,9,17,2515,1032,1483
50,12,19,Florida,Clay County,9,18,1951,610,1341
50,12,19,Florida,Clay County,9,99,184256,90405,93851
50,12,19,Florida,Clay County,10,0,2221,1143,1078
50,12,19,Florida,Clay County,10,1,9598,4976,4622
50,12,19,Florida,Clay County,10,2,13693,7026,6667
50,12,19,Florida,Clay County,10,3,14933,7552,7381
50,12,19,Florida,Clay County,10,4,15049,7797,7252
50,12,19,Florida,Clay County,10,5,10477,5322,5155
50,12,19,Florida,Clay County,10,6,10524,5205,5319
50,12,19,Florida,Clay County,10,7,10941,5259,5682
50,12,19,Florida,Clay County,10,8,13816,6596,7220
50,12,19,Florida,Clay County,10,9,14834,7178,7656
50,12,19,Florida,Clay County,10,10,15458,7641,7817
50,12,19,Florida,Clay County,10,11,13337,6415,6922
50,12,19,Florida,Clay County,10,12,11633,5584,6049
50,12,19,Florida,Clay County,10,13,10058,4973,5085
50,12,19,Florida,Clay County,10,14,7200,3431,3769
50,12,19,Florida,Clay County,10,15,5097,2402,2695
50,12,19,Florida,Clay County,10,16,3783,1728,2055
50,12,19,Florida,Clay County,10,17,2538,1016,1522
50,12,19,Florida,Clay County,10,18,2099,680,1419
50,12,19,Florida,Clay County,10,99,187289,91924,95365
50,12,19,Florida,Clay County,11,0,2166,1093,1073
50,12,19,Florida,Clay County,11,1,9653,4992,4661
50,12,19,Florida,Clay County,11,2,13496,6949,6547
50,12,19,Florida,Clay County,11,3,14875,7582,7293
50,12,19,Florida,Clay County,11,4,15275,7940,7335
50,12,19,Florida,Clay County,11,5,10606,5422,5184
50,12,19,Florida,Clay County,11,6,10729,5271,5458
50,12,19,Florida,Clay County,11,7,10889,5197,5692
50,12,19,Florida,Clay County,11,8,13566,6416,7150
50,12,19,Florida,Clay County,11,9,14275,6887,7388
50,12,19,Florida,Clay County,11,10,15856,7800,8056
50,12,19,Florida,Clay County,11,11,13762,6687,7075
50,12,19,Florida,Clay County,11,12,11877,5684,6193
50,12,19,Florida,Clay County,11,13,10446,5071,5375
50,12,19,Florida,Clay County,11,14,7686,3615,4071
50,12,19,Florida,Clay County,11,15,5309,2535,2774
50,12,19,Florida,Clay County,11,16,3806,1754,2052
50,12,19,Florida,Clay County,11,17,2646,1100,1546
50,12,19,Florida,Clay County,11,18,2183,727,1456
50,12,19,Florida,Clay County,11,99,189101,92722,96379
50,12,19,Florida,Clay County,12,0,2175,1106,1069
50,12,19,Florida,Clay County,12,1,9694,4973,4721
50,12,19,Florida,Clay County,12,2,13625,7025,6600
50,12,19,Florida,Clay County,12,3,15002,7643,7359
50,12,19,Florida,Clay County,12,4,15061,7809,7252
50,12,19,Florida,Clay County,12,5,10835,5518,5317
50,12,19,Florida,Clay County,12,6,10732,5283,5449
50,12,19,Florida,Clay County,12,7,10961,5197,5764
50,12,19,Florida,Clay County,12,8,13122,6210,6912
50,12,19,Florida,Clay County,12,9,14253,6894,7359
50,12,19,Florida,Clay County,12,10,15954,7840,8114
50,12,19,Florida,Clay County,12,11,14135,6861,7274
50,12,19,Florida,Clay County,12,12,12118,5809,6309
50,12,19,Florida,Clay County,12,13,10906,5249,5657
50,12,19,Florida,Clay County,12,14,7941,3775,4166
50,12,19,Florida,Clay County,12,15,5563,2642,2921
50,12,19,Florida,Clay County,12,16,3873,1774,2099
50,12,19,Florida,Clay County,12,17,2672,1128,1544
50,12,19,Florida,Clay County,12,18,2243,755,1488
50,12,19,Florida,Clay County,12,99,190865,93491,97374
50,12,19,Florida,Clay County,13,0,2185,1110,1075
50,12,19,Florida,Clay County,13,1,9696,4972,4724
50,12,19,Florida,Clay County,13,2,13655,7041,6614
50,12,19,Florida,Clay County,13,3,15020,7653,7367
50,12,19,Florida,Clay County,13,4,15013,7786,7227
50,12,19,Florida,Clay County,13,5,10901,5552,5349
50,12,19,Florida,Clay County,13,6,10774,5310,5464
50,12,19,Florida,Clay County,13,7,11060,5243,5817
50,12,19,Florida,Clay County,13,8,13060,6182,6878
50,12,19,Florida,Clay County,13,9,14260,6895,7365
50,12,19,Florida,Clay County,13,10,15916,7823,8093
50,12,19,Florida,Clay County,13,11,14194,6890,7304
50,12,19,Florida,Clay County,13,12,12210,5853,6357
50,12,19,Florida,Clay County,13,13,11027,5310,5717
50,12,19,Florida,Clay County,13,14,7999,3804,4195
50,12,19,Florida,Clay County,13,15,5606,2661,2945
50,12,19,Florida,Clay County,13,16,3876,1775,2101
50,12,19,Florida,Clay County,13,17,2681,1135,1546
50,12,19,Florida,Clay County,13,18,2262,763,1499
50,12,19,Florida,Clay County,13,99,191395,93758,97637
50,12,21,Florida,Collier County,1,0,2728,1420,1308
50,12,21,Florida,Collier County,1,1,10714,5539,5175
50,12,21,Florida,Collier County,1,2,14450,7294,7156
50,12,21,Florida,Collier County,1,3,13682,6911,6771
50,12,21,Florida,Collier County,1,4,13387,7272,6115
50,12,21,Florida,Collier County,1,5,11707,6777,4930
50,12,21,Florida,Collier County,1,6,13360,7290,6070
50,12,21,Florida,Collier County,1,7,14904,7953,6951
50,12,21,Florida,Collier County,1,8,17184,8880,8304
50,12,21,Florida,Collier County,1,9,16280,8231,8049
50,12,21,Florida,Collier County,1,10,14755,7297,7458
50,12,21,Florida,Collier County,1,11,14761,6775,7986
50,12,21,Florida,Collier County,1,12,15514,6995,8519
50,12,21,Florida,Collier County,1,13,16466,7703,8763
50,12,21,Florida,Collier County,1,14,17757,8766,8991
50,12,21,Florida,Collier County,1,15,17336,8571,8765
50,12,21,Florida,Collier County,1,16,13299,6463,6836
50,12,21,Florida,Collier County,1,17,7763,3639,4124
50,12,21,Florida,Collier County,1,18,5365,2095,3270
50,12,21,Florida,Collier County,1,99,251412,125871,125541
50,12,21,Florida,Collier County,2,0,2791,1450,1341
50,12,21,Florida,Collier County,2,1,10758,5565,5193
50,12,21,Florida,Collier County,2,2,14505,7325,7180
50,12,21,Florida,Collier County,2,3,13880,7015,6865
50,12,21,Florida,Collier County,2,4,13536,7353,6183
50,12,21,Florida,Collier County,2,5,11889,6878,5011
50,12,21,Florida,Collier County,2,6,13436,7329,6107
50,12,21,Florida,Collier County,2,7,15062,8038,7024
50,12,21,Florida,Collier County,2,8,17292,8939,8353
50,12,21,Florida,Collier County,2,9,16464,8322,8142
50,12,21,Florida,Collier County,2,10,14974,7408,7566
50,12,21,Florida,Collier County,2,11,15042,6906,8136
50,12,21,Florida,Collier County,2,12,15740,7101,8639
50,12,21,Florida,Collier County,2,13,16679,7806,8873
50,12,21,Florida,Collier County,2,14,17849,8815,9034
50,12,21,Florida,Collier County,2,15,17446,8639,8807
50,12,21,Florida,Collier County,2,16,13407,6524,6883
50,12,21,Florida,Collier County,2,17,7862,3692,4170
50,12,21,Florida,Collier County,2,18,5403,2113,3290
50,12,21,Florida,Collier County,2,99,254015,127218,126797
50,12,21,Florida,Collier County,3,0,3363,1697,1666
50,12,21,Florida,Collier County,3,1,11080,5708,5372
50,12,21,Florida,Collier County,3,2,14646,7433,7213
50,12,21,Florida,Collier County,3,3,14777,7432,7345
50,12,21,Florida,Collier County,3,4,14060,7607,6453
50,12,21,Florida,Collier County,3,5,12492,7204,5288
50,12,21,Florida,Collier County,3,6,13423,7264,6159
50,12,21,Florida,Collier County,3,7,15599,8190,7409
50,12,21,Florida,Collier County,3,8,17492,9058,8434
50,12,21,Florida,Collier County,3,9,17546,8875,8671
50,12,21,Florida,Collier County,3,10,15748,7832,7916
50,12,21,Florida,Collier County,3,11,16127,7450,8677
50,12,21,Florida,Collier County,3,12,16459,7360,9099
50,12,21,Florida,Collier County,3,13,17582,8228,9354
50,12,21,Florida,Collier County,3,14,17954,8814,9140
50,12,21,Florida,Collier County,3,15,17918,8895,9023
50,12,21,Florida,Collier County,3,16,13619,6645,6974
50,12,21,Florida,Collier County,3,17,8556,3986,4570
50,12,21,Florida,Collier County,3,18,5799,2271,3528
50,12,21,Florida,Collier County,3,99,264240,131949,132291
50,12,21,Florida,Collier County,4,0,3635,1833,1802
50,12,21,Florida,Collier County,4,1,11854,6085,5769
50,12,21,Florida,Collier County,4,2,14685,7481,7204
50,12,21,Florida,Collier County,4,3,15792,7945,7847
50,12,21,Florida,Collier County,4,4,14720,7920,6800
50,12,21,Florida,Collier County,4,5,13237,7548,5689
50,12,21,Florida,Collier County,4,6,13805,7507,6298
50,12,21,Florida,Collier County,4,7,16111,8486,7625
50,12,21,Florida,Collier County,4,8,17987,9299,8688
50,12,21,Florida,Collier County,4,9,18388,9284,9104
50,12,21,Florida,Collier County,4,10,16802,8263,8539
50,12,21,Florida,Collier County,4,11,16372,7644,8728
50,12,21,Florida,Collier County,4,12,17847,7949,9898
50,12,21,Florida,Collier County,4,13,18579,8690,9889
50,12,21,Florida,Collier County,4,14,18263,8918,9345
50,12,21,Florida,Collier County,4,15,18290,9152,9138
50,12,21,Florida,Collier County,4,16,14029,6862,7167
50,12,21,Florida,Collier County,4,17,9042,4229,4813
50,12,21,Florida,Collier County,4,18,6052,2405,3647
50,12,21,Florida,Collier County,4,99,275490,137500,137990
50,12,21,Florida,Collier County,5,0,3653,1909,1744
50,12,21,Florida,Collier County,5,1,12804,6586,6218
50,12,21,Florida,Collier County,5,2,15084,7714,7370
50,12,21,Florida,Collier County,5,3,16410,8323,8087
50,12,21,Florida,Collier County,5,4,15209,8069,7140
50,12,21,Florida,Collier County,5,5,14089,7982,6107
50,12,21,Florida,Collier County,5,6,14310,7739,6571
50,12,21,Florida,Collier County,5,7,16431,8684,7747
50,12,21,Florida,Collier County,5,8,18032,9309,8723
50,12,21,Florida,Collier County,5,9,19205,9665,9540
50,12,21,Florida,Collier County,5,10,17605,8659,8946
50,12,21,Florida,Collier County,5,11,16887,7932,8955
50,12,21,Florida,Collier County,5,12,18429,8249,10180
50,12,21,Florida,Collier County,5,13,19812,9064,10748
50,12,21,Florida,Collier County,5,14,18821,9191,9630
50,12,21,Florida,Collier County,5,15,18237,9127,9110
50,12,21,Florida,Collier County,5,16,14567,7186,7381
50,12,21,Florida,Collier County,5,17,9355,4392,4963
50,12,21,Florida,Collier County,5,18,6381,2579,3802
50,12,21,Florida,Collier County,5,99,285321,142359,142962
50,12,21,Florida,Collier County,6,0,3736,1907,1829
50,12,21,Florida,Collier County,6,1,13788,7059,6729
50,12,21,Florida,Collier County,6,2,15307,7859,7448
50,12,21,Florida,Collier County,6,3,17239,8744,8495
50,12,21,Florida,Collier County,6,4,15872,8450,7422
50,12,21,Florida,Collier County,6,5,14698,8163,6535
50,12,21,Florida,Collier County,6,6,14951,8086,6865
50,12,21,Florida,Collier County,6,7,16818,8792,8026
50,12,21,Florida,Collier County,6,8,18221,9362,8859
50,12,21,Florida,Collier County,6,9,20099,10092,10007
50,12,21,Florida,Collier County,6,10,18494,9114,9380
50,12,21,Florida,Collier County,6,11,17526,8334,9192
50,12,21,Florida,Collier County,6,12,18872,8415,10457
50,12,21,Florida,Collier County,6,13,20991,9579,11412
50,12,21,Florida,Collier County,6,14,19574,9435,10139
50,12,21,Florida,Collier County,6,15,18038,9045,8993
50,12,21,Florida,Collier County,6,16,15194,7540,7654
50,12,21,Florida,Collier County,6,17,9867,4632,5235
50,12,21,Florida,Collier County,6,18,6736,2748,3988
50,12,21,Florida,Collier County,6,99,296021,147356,148665
50,12,21,Florida,Collier County,7,0,3929,2012,1917
50,12,21,Florida,Collier County,7,1,14537,7529,7008
50,12,21,Florida,Collier County,7,2,15610,8032,7578
50,12,21,Florida,Collier County,7,3,17747,9042,8705
50,12,21,Florida,Collier County,7,4,16678,8864,7814
50,12,21,Florida,Collier County,7,5,15261,8386,6875
50,12,21,Florida,Collier County,7,6,16013,8728,7285
50,12,21,Florida,Collier County,7,7,16967,8832,8135
50,12,21,Florida,Collier County,7,8,18565,9569,8996
50,12,21,Florida,Collier County,7,9,20627,10322,10305
50,12,21,Florida,Collier County,7,10,19601,9666,9935
50,12,21,Florida,Collier County,7,11,18222,8695,9527
50,12,21,Florida,Collier County,7,12,19836,8739,11097
50,12,21,Florida,Collier County,7,13,21705,9947,11758
50,12,21,Florida,Collier County,7,14,20468,9778,10690
50,12,21,Florida,Collier County,7,15,18443,9251,9192
50,12,21,Florida,Collier County,7,16,15722,7848,7874
50,12,21,Florida,Collier County,7,17,10332,4874,5458
50,12,21,Florida,Collier County,7,18,7189,2963,4226
50,12,21,Florida,Collier County,7,99,307452,153077,154375
50,12,21,Florida,Collier County,8,0,4039,2028,2011
50,12,21,Florida,Collier County,8,1,14559,7636,6923
50,12,21,Florida,Collier County,8,2,16034,8165,7869
50,12,21,Florida,Collier County,8,3,17893,9191,8702
50,12,21,Florida,Collier County,8,4,17323,9182,8141
50,12,21,Florida,Collier County,8,5,15587,8582,7005
50,12,21,Florida,Collier County,8,6,16267,8774,7493
50,12,21,Florida,Collier County,8,7,16374,8520,7854
50,12,21,Florida,Collier County,8,8,18918,9645,9273
50,12,21,Florida,Collier County,8,9,20601,10338,10263
50,12,21,Florida,Collier County,8,10,20333,10102,10231
50,12,21,Florida,Collier County,8,11,18536,8861,9675
50,12,21,Florida,Collier County,8,12,20595,9096,11499
50,12,21,Florida,Collier County,8,13,21995,9995,12000
50,12,21,Florida,Collier County,8,14,21002,10043,10959
50,12,21,Florida,Collier County,8,15,18549,9280,9269
50,12,21,Florida,Collier County,8,16,15885,7878,8007
50,12,21,Florida,Collier County,8,17,10468,4975,5493
50,12,21,Florida,Collier County,8,18,7663,3152,4511
50,12,21,Florida,Collier County,8,99,312621,155443,157178
50,12,21,Florida,Collier County,9,0,3981,1994,1987
50,12,21,Florida,Collier County,9,1,14353,7435,6918
50,12,21,Florida,Collier County,9,2,16392,8354,8038
50,12,21,Florida,Collier County,9,3,17621,9082,8539
50,12,21,Florida,Collier County,9,4,17595,9284,8311
50,12,21,Florida,Collier County,9,5,15553,8539,7014
50,12,21,Florida,Collier County,9,6,16398,8847,7551
50,12,21,Florida,Collier County,9,7,15766,8280,7486
50,12,21,Florida,Collier County,9,8,18473,9377,9096
50,12,21,Florida,Collier County,9,9,20228,10159,10069
50,12,21,Florida,Collier County,9,10,20391,10118,10273
50,12,21,Florida,Collier County,9,11,18917,8996,9921
50,12,21,Florida,Collier County,9,12,20009,8917,11092
50,12,21,Florida,Collier County,9,13,22830,10313,12517
50,12,21,Florida,Collier County,9,14,21862,10396,11466
50,12,21,Florida,Collier County,9,15,18980,9378,9602
50,12,21,Florida,Collier County,9,16,16161,8118,8043
50,12,21,Florida,Collier County,9,17,10845,5148,5697
50,12,21,Florida,Collier County,9,18,8082,3401,4681
50,12,21,Florida,Collier County,9,99,314437,156136,158301
50,12,21,Florida,Collier County,10,0,3685,1832,1853
50,12,21,Florida,Collier County,10,1,13886,7115,6771
50,12,21,Florida,Collier County,10,2,16652,8494,8158
50,12,21,Florida,Collier County,10,3,17603,9007,8596
50,12,21,Florida,Collier County,10,4,17660,9323,8337
50,12,21,Florida,Collier County,10,5,15552,8396,7156
50,12,21,Florida,Collier County,10,6,16425,8832,7593
50,12,21,Florida,Collier County,10,7,15662,8153,7509
50,12,21,Florida,Collier County,10,8,17788,8952,8836
50,12,21,Florida,Collier County,10,9,19399,9726,9673
50,12,21,Florida,Collier County,10,10,20548,10183,10365
50,12,21,Florida,Collier County,10,11,19328,9184,10144
50,12,21,Florida,Collier County,10,12,19657,8857,10800
50,12,21,Florida,Collier County,10,13,22837,10370,12467
50,12,21,Florida,Collier County,10,14,23416,10943,12473
50,12,21,Florida,Collier County,10,15,20080,9930,10150
50,12,21,Florida,Collier County,10,16,16342,8209,8133
50,12,21,Florida,Collier County,10,17,11498,5489,6009
50,12,21,Florida,Collier County,10,18,8623,3677,4946
50,12,21,Florida,Collier County,10,99,316641,156672,159969
50,12,21,Florida,Collier County,11,0,3325,1678,1647
50,12,21,Florida,Collier County,11,1,13759,6956,6803
50,12,21,Florida,Collier County,11,2,16911,8657,8254
50,12,21,Florida,Collier County,11,3,17354,8944,8410
50,12,21,Florida,Collier County,11,4,17644,9257,8387
50,12,21,Florida,Collier County,11,5,15455,8394,7061
50,12,21,Florida,Collier County,11,6,16501,8681,7820
50,12,21,Florida,Collier County,11,7,15825,8216,7609
50,12,21,Florida,Collier County,11,8,17283,8654,8629
50,12,21,Florida,Collier County,11,9,18854,9467,9387
50,12,21,Florida,Collier County,11,10,20670,10199,10471
50,12,21,Florida,Collier County,11,11,19760,9411,10349
50,12,21,Florida,Collier County,11,12,19670,8947,10723
50,12,21,Florida,Collier County,11,13,22706,10193,12513
50,12,21,Florida,Collier County,11,14,24133,11231,12902
50,12,21,Florida,Collier County,11,15,20889,10293,10596
50,12,21,Florida,Collier County,11,16,16541,8229,8312
50,12,21,Florida,Collier County,11,17,12055,5856,6199
50,12,21,Florida,Collier County,11,18,9150,3905,5245
50,12,21,Florida,Collier County,11,99,318485,157168,161317
50,12,21,Florida,Collier County,12,0,3273,1642,1631
50,12,21,Florida,Collier County,12,1,13563,6849,6714
50,12,21,Florida,Collier County,12,2,17277,8871,8406
50,12,21,Florida,Collier County,12,3,17451,9003,8448
50,12,21,Florida,Collier County,12,4,17613,9218,8395
50,12,21,Florida,Collier County,12,5,15516,8380,7136
50,12,21,Florida,Collier County,12,6,16504,8626,7878
50,12,21,Florida,Collier County,12,7,16046,8308,7738
50,12,21,Florida,Collier County,12,8,16892,8440,8452
50,12,21,Florida,Collier County,12,9,18665,9345,9320
50,12,21,Florida,Collier County,12,10,20763,10249,10514
50,12,21,Florida,Collier County,12,11,20066,9564,10502
50,12,21,Florida,Collier County,12,12,19857,9042,10815
50,12,21,Florida,Collier County,12,13,23083,10369,12714
50,12,21,Florida,Collier County,12,14,24701,11495,13206
50,12,21,Florida,Collier County,12,15,21453,10500,10953
50,12,21,Florida,Collier County,12,16,16857,8405,8452
50,12,21,Florida,Collier County,12,17,12433,6085,6348
50,12,21,Florida,Collier County,12,18,9507,4103,5404
50,12,21,Florida,Collier County,12,99,321520,158494,163026
50,12,21,Florida,Collier County,13,0,3281,1647,1634
50,12,21,Florida,Collier County,13,1,13561,6847,6714
50,12,21,Florida,Collier County,13,2,17341,8906,8435
50,12,21,Florida,Collier County,13,3,17478,9024,8454
50,12,21,Florida,Collier County,13,4,17571,9196,8375
50,12,21,Florida,Collier County,13,5,15607,8431,7176
50,12,21,Florida,Collier County,13,6,16542,8652,7890
50,12,21,Florida,Collier County,13,7,16157,8370,7787
50,12,21,Florida,Collier County,13,8,16843,8420,8423
50,12,21,Florida,Collier County,13,9,18685,9356,9329
50,12,21,Florida,Collier County,13,10,20727,10233,10494
50,12,21,Florida,Collier County,13,11,20136,9605,10531
50,12,21,Florida,Collier County,13,12,19965,9094,10871
50,12,21,Florida,Collier County,13,13,23329,10480,12849
50,12,21,Florida,Collier County,13,14,24854,11572,13282
50,12,21,Florida,Collier County,13,15,21557,10554,11003
50,12,21,Florida,Collier County,13,16,16825,8394,8431
50,12,21,Florida,Collier County,13,17,12441,6102,6339
50,12,21,Florida,Collier County,13,18,9572,4140,5432
50,12,21,Florida,Collier County,13,99,322472,159023,163449
50,12,23,Florida,Columbia County,1,0,709,382,327
50,12,23,Florida,Columbia County,1,1,2916,1474,1442
50,12,23,Florida,Columbia County,1,2,3922,2058,1864
50,12,23,Florida,Columbia County,1,3,4143,2154,1989
50,12,23,Florida,Columbia County,1,4,4225,2161,2064
50,12,23,Florida,Columbia County,1,5,3489,1949,1540
50,12,23,Florida,Columbia County,1,6,3349,1766,1583
50,12,23,Florida,Columbia County,1,7,3579,1908,1671
50,12,23,Florida,Columbia County,1,8,4178,2140,2038
50,12,23,Florida,Columbia County,1,9,4505,2252,2253
50,12,23,Florida,Columbia County,1,10,3985,2033,1952
50,12,23,Florida,Columbia County,1,11,3719,1813,1906
50,12,23,Florida,Columbia County,1,12,3117,1568,1549
50,12,23,Florida,Columbia County,1,13,2694,1333,1361
50,12,23,Florida,Columbia County,1,14,2427,1204,1223
50,12,23,Florida,Columbia County,1,15,2104,1003,1101
50,12,23,Florida,Columbia County,1,16,1652,780,872
50,12,23,Florida,Columbia County,1,17,983,401,582
50,12,23,Florida,Columbia County,1,18,717,232,485
50,12,23,Florida,Columbia County,1,99,56413,28611,27802
50,12,23,Florida,Columbia County,2,0,714,387,327
50,12,23,Florida,Columbia County,2,1,2908,1470,1438
50,12,23,Florida,Columbia County,2,2,3910,2052,1858
50,12,23,Florida,Columbia County,2,3,4163,2163,2000
50,12,23,Florida,Columbia County,2,4,4245,2172,2073
50,12,23,Florida,Columbia County,2,5,3527,1969,1558
50,12,23,Florida,Columbia County,2,6,3321,1753,1568
50,12,23,Florida,Columbia County,2,7,3578,1909,1669
50,12,23,Florida,Columbia County,2,8,4168,2134,2034
50,12,23,Florida,Columbia County,2,9,4515,2257,2258
50,12,23,Florida,Columbia County,2,10,4007,2043,1964
50,12,23,Florida,Columbia County,2,11,3764,1835,1929
50,12,23,Florida,Columbia County,2,12,3135,1576,1559
50,12,23,Florida,Columbia County,2,13,2707,1340,1367
50,12,23,Florida,Columbia County,2,14,2429,1204,1225
50,12,23,Florida,Columbia County,2,15,2106,1002,1104
50,12,23,Florida,Columbia County,2,16,1655,779,876
50,12,23,Florida,Columbia County,2,17,995,406,589
50,12,23,Florida,Columbia County,2,18,724,234,490
50,12,23,Florida,Columbia County,2,99,56571,28685,27886
50,12,23,Florida,Columbia County,3,0,738,351,387
50,12,23,Florida,Columbia County,3,1,2880,1475,1405
50,12,23,Florida,Columbia County,3,2,3791,1988,1803
50,12,23,Florida,Columbia County,3,3,4157,2175,1982
50,12,23,Florida,Columbia County,3,4,4215,2195,2020
50,12,23,Florida,Columbia County,3,5,3732,2112,1620
50,12,23,Florida,Columbia County,3,6,3251,1699,1552
50,12,23,Florida,Columbia County,3,7,3548,1896,1652
50,12,23,Florida,Columbia County,3,8,4048,2083,1965
50,12,23,Florida,Columbia County,3,9,4521,2288,2233
50,12,23,Florida,Columbia County,3,10,4105,2119,1986
50,12,23,Florida,Columbia County,3,11,3998,1944,2054
50,12,23,Florida,Columbia County,3,12,3202,1598,1604
50,12,23,Florida,Columbia County,3,13,2803,1389,1414
50,12,23,Florida,Columbia County,3,14,2445,1194,1251
50,12,23,Florida,Columbia County,3,15,2121,1020,1101
50,12,23,Florida,Columbia County,3,16,1703,796,907
50,12,23,Florida,Columbia County,3,17,1037,431,606
50,12,23,Florida,Columbia County,3,18,745,245,500
50,12,23,Florida,Columbia County,3,99,57040,28998,28042
50,12,23,Florida,Columbia County,4,0,800,443,357
50,12,23,Florida,Columbia County,4,1,3020,1543,1477
50,12,23,Florida,Columbia County,4,2,3683,1893,1790
50,12,23,Florida,Columbia County,4,3,4194,2225,1969
50,12,23,Florida,Columbia County,4,4,4203,2207,1996
50,12,23,Florida,Columbia County,4,5,3918,2236,1682
50,12,23,Florida,Columbia County,4,6,3192,1666,1526
50,12,23,Florida,Columbia County,4,7,3608,1883,1725
50,12,23,Florida,Columbia County,4,8,3929,2048,1881
50,12,23,Florida,Columbia County,4,9,4459,2271,2188
50,12,23,Florida,Columbia County,4,10,4355,2220,2135
50,12,23,Florida,Columbia County,4,11,3974,1977,1997
50,12,23,Florida,Columbia County,4,12,3506,1715,1791
50,12,23,Florida,Columbia County,4,13,2862,1442,1420
50,12,23,Florida,Columbia County,4,14,2492,1222,1270
50,12,23,Florida,Columbia County,4,15,2161,1080,1081
50,12,23,Florida,Columbia County,4,16,1730,789,941
50,12,23,Florida,Columbia County,4,17,1069,454,615
50,12,23,Florida,Columbia County,4,18,775,258,517
50,12,23,Florida,Columbia County,4,99,57930,29572,28358
50,12,23,Florida,Columbia County,5,0,810,444,366
50,12,23,Florida,Columbia County,5,1,3182,1690,1492
50,12,23,Florida,Columbia County,5,2,3693,1905,1788
50,12,23,Florida,Columbia County,5,3,4285,2235,2050
50,12,23,Florida,Columbia County,5,4,4239,2257,1982
50,12,23,Florida,Columbia County,5,5,4158,2367,1791
50,12,23,Florida,Columbia County,5,6,3368,1790,1578
50,12,23,Florida,Columbia County,5,7,3584,1896,1688
50,12,23,Florida,Columbia County,5,8,3903,2035,1868
50,12,23,Florida,Columbia County,5,9,4416,2248,2168
50,12,23,Florida,Columbia County,5,10,4491,2268,2223
50,12,23,Florida,Columbia County,5,11,4112,2040,2072
50,12,23,Florida,Columbia County,5,12,3766,1868,1898
50,12,23,Florida,Columbia County,5,13,3015,1500,1515
50,12,23,Florida,Columbia County,5,14,2562,1259,1303
50,12,23,Florida,Columbia County,5,15,2141,1076,1065
50,12,23,Florida,Columbia County,5,16,1767,788,979
50,12,23,Florida,Columbia County,5,17,1105,484,621
50,12,23,Florida,Columbia County,5,18,798,273,525
50,12,23,Florida,Columbia County,5,99,59395,30423,28972
50,12,23,Florida,Columbia County,6,0,773,376,397
50,12,23,Florida,Columbia County,6,1,3254,1743,1511
50,12,23,Florida,Columbia County,6,2,3786,1940,1846
50,12,23,Florida,Columbia County,6,3,4423,2302,2121
50,12,23,Florida,Columbia County,6,4,4193,2227,1966
50,12,23,Florida,Columbia County,6,5,4289,2478,1811
50,12,23,Florida,Columbia County,6,6,3618,1905,1713
50,12,23,Florida,Columbia County,6,7,3593,1910,1683
50,12,23,Florida,Columbia County,6,8,3868,2041,1827
50,12,23,Florida,Columbia County,6,9,4467,2258,2209
50,12,23,Florida,Columbia County,6,10,4624,2314,2310
50,12,23,Florida,Columbia County,6,11,4222,2128,2094
50,12,23,Florida,Columbia County,6,12,3919,1943,1976
50,12,23,Florida,Columbia County,6,13,3234,1599,1635
50,12,23,Florida,Columbia County,6,14,2650,1298,1352
50,12,23,Florida,Columbia County,6,15,2189,1113,1076
50,12,23,Florida,Columbia County,6,16,1732,783,949
50,12,23,Florida,Columbia County,6,17,1150,504,646
50,12,23,Florida,Columbia County,6,18,820,291,529
50,12,23,Florida,Columbia County,6,99,60804,31153,29651
50,12,23,Florida,Columbia County,7,0,872,461,411
50,12,23,Florida,Columbia County,7,1,3414,1811,1603
50,12,23,Florida,Columbia County,7,2,3930,2003,1927
50,12,23,Florida,Columbia County,7,3,4374,2288,2086
50,12,23,Florida,Columbia County,7,4,4337,2331,2006
50,12,23,Florida,Columbia County,7,5,4488,2605,1883
50,12,23,Florida,Columbia County,7,6,3791,1983,1808
50,12,23,Florida,Columbia County,7,7,3636,1961,1675
50,12,23,Florida,Columbia County,7,8,3912,2124,1788
50,12,23,Florida,Columbia County,7,9,4527,2314,2213
50,12,23,Florida,Columbia County,7,10,4868,2435,2433
50,12,23,Florida,Columbia County,7,11,4429,2244,2185
50,12,23,Florida,Columbia County,7,12,4165,2039,2126
50,12,23,Florida,Columbia County,7,13,3442,1709,1733
50,12,23,Florida,Columbia County,7,14,2746,1381,1365
50,12,23,Florida,Columbia County,7,15,2313,1143,1170
50,12,23,Florida,Columbia County,7,16,1790,816,974
50,12,23,Florida,Columbia County,7,17,1196,521,675
50,12,23,Florida,Columbia County,7,18,879,302,577
50,12,23,Florida,Columbia County,7,99,63109,32471,30638
50,12,23,Florida,Columbia County,8,0,867,428,439
50,12,23,Florida,Columbia County,8,1,3418,1819,1599
50,12,23,Florida,Columbia County,8,2,4047,2076,1971
50,12,23,Florida,Columbia County,8,3,4334,2289,2045
50,12,23,Florida,Columbia County,8,4,4562,2478,2084
50,12,23,Florida,Columbia County,8,5,4713,2769,1944
50,12,23,Florida,Columbia County,8,6,4047,2164,1883
50,12,23,Florida,Columbia County,8,7,3738,2033,1705
50,12,23,Florida,Columbia County,8,8,4080,2206,1874
50,12,23,Florida,Columbia County,8,9,4590,2381,2209
50,12,23,Florida,Columbia County,8,10,5014,2563,2451
50,12,23,Florida,Columbia County,8,11,4713,2413,2300
50,12,23,Florida,Columbia County,8,12,4524,2216,2308
50,12,23,Florida,Columbia County,8,13,3662,1826,1836
50,12,23,Florida,Columbia County,8,14,3018,1527,1491
50,12,23,Florida,Columbia County,8,15,2408,1174,1234
50,12,23,Florida,Columbia County,8,16,1945,915,1030
50,12,23,Florida,Columbia County,8,17,1237,536,701
50,12,23,Florida,Columbia County,8,18,973,343,630
50,12,23,Florida,Columbia County,8,99,65890,34156,31734
50,12,23,Florida,Columbia County,9,0,868,437,431
50,12,23,Florida,Columbia County,9,1,3399,1774,1625
50,12,23,Florida,Columbia County,9,2,4154,2157,1997
50,12,23,Florida,Columbia County,9,3,4210,2195,2015
50,12,23,Florida,Columbia County,9,4,4688,2553,2135
50,12,23,Florida,Columbia County,9,5,4744,2777,1967
50,12,23,Florida,Columbia County,9,6,4159,2218,1941
50,12,23,Florida,Columbia County,9,7,3652,2003,1649
50,12,23,Florida,Columbia County,9,8,4119,2196,1923
50,12,23,Florida,Columbia County,9,9,4586,2410,2176
50,12,23,Florida,Columbia County,9,10,4901,2516,2385
50,12,23,Florida,Columbia County,9,11,4992,2538,2454
50,12,23,Florida,Columbia County,9,12,4458,2207,2251
50,12,23,Florida,Columbia County,9,13,3900,1909,1991
50,12,23,Florida,Columbia County,9,14,3080,1525,1555
50,12,23,Florida,Columbia County,9,15,2473,1195,1278
50,12,23,Florida,Columbia County,9,16,1932,951,981
50,12,23,Florida,Columbia County,9,17,1267,519,748
50,12,23,Florida,Columbia County,9,18,1022,341,681
50,12,23,Florida,Columbia County,9,99,66604,34421,32183
50,12,23,Florida,Columbia County,10,0,881,429,452
50,12,23,Florida,Columbia County,10,1,3397,1754,1643
50,12,23,Florida,Columbia County,10,2,4206,2205,2001
50,12,23,Florida,Columbia County,10,3,4168,2171,1997
50,12,23,Florida,Columbia County,10,4,4728,2593,2135
50,12,23,Florida,Columbia County,10,5,4717,2793,1924
50,12,23,Florida,Columbia County,10,6,4300,2289,2011
50,12,23,Florida,Columbia County,10,7,3696,2065,1631
50,12,23,Florida,Columbia County,10,8,4026,2154,1872
50,12,23,Florida,Columbia County,10,9,4499,2387,2112
50,12,23,Florida,Columbia County,10,10,4964,2549,2415
50,12,23,Florida,Columbia County,10,11,5127,2580,2547
50,12,23,Florida,Columbia County,10,12,4476,2255,2221
50,12,23,Florida,Columbia County,10,13,4074,2010,2064
50,12,23,Florida,Columbia County,10,14,3259,1597,1662
50,12,23,Florida,Columbia County,10,15,2538,1219,1319
50,12,23,Florida,Columbia County,10,16,1909,922,987
50,12,23,Florida,Columbia County,10,17,1338,572,766
50,12,23,Florida,Columbia County,10,18,1015,357,658
50,12,23,Florida,Columbia County,10,99,67318,34901,32417
50,12,23,Florida,Columbia County,11,0,829,405,424
50,12,23,Florida,Columbia County,11,1,3397,1744,1653
50,12,23,Florida,Columbia County,11,2,4117,2130,1987
50,12,23,Florida,Columbia County,11,3,4213,2181,2032
50,12,23,Florida,Columbia County,11,4,4668,2546,2122
50,12,23,Florida,Columbia County,11,5,4741,2796,1945
50,12,23,Florida,Columbia County,11,6,4243,2315,1928
50,12,23,Florida,Columbia County,11,7,3832,2126,1706
50,12,23,Florida,Columbia County,11,8,3963,2154,1809
50,12,23,Florida,Columbia County,11,9,4318,2298,2020
50,12,23,Florida,Columbia County,11,10,4990,2597,2393
50,12,23,Florida,Columbia County,11,11,5188,2585,2603
50,12,23,Florida,Columbia County,11,12,4507,2271,2236
50,12,23,Florida,Columbia County,11,13,4187,2039,2148
50,12,23,Florida,Columbia County,11,14,3396,1655,1741
50,12,23,Florida,Columbia County,11,15,2550,1217,1333
50,12,23,Florida,Columbia County,11,16,1900,922,978
50,12,23,Florida,Columbia County,11,17,1315,546,769
50,12,23,Florida,Columbia County,11,18,1058,377,681
50,12,23,Florida,Columbia County,11,99,67412,34904,32508
50,12,23,Florida,Columbia County,12,0,820,410,410
50,12,23,Florida,Columbia County,12,1,3412,1747,1665
50,12,23,Florida,Columbia County,12,2,4156,2149,2007
50,12,23,Florida,Columbia County,12,3,4205,2190,2015
50,12,23,Florida,Columbia County,12,4,4514,2469,2045
50,12,23,Florida,Columbia County,12,5,4725,2792,1933
50,12,23,Florida,Columbia County,12,6,4271,2310,1961
50,12,23,Florida,Columbia County,12,7,3929,2173,1756
50,12,23,Florida,Columbia County,12,8,3833,2088,1745
50,12,23,Florida,Columbia County,12,9,4242,2271,1971
50,12,23,Florida,Columbia County,12,10,4935,2557,2378
50,12,23,Florida,Columbia County,12,11,5275,2621,2654
50,12,23,Florida,Columbia County,12,12,4547,2301,2246
50,12,23,Florida,Columbia County,12,13,4277,2061,2216
50,12,23,Florida,Columbia County,12,14,3480,1700,1780
50,12,23,Florida,Columbia County,12,15,2563,1232,1331
50,12,23,Florida,Columbia County,12,16,1937,914,1023
50,12,23,Florida,Columbia County,12,17,1316,571,745
50,12,23,Florida,Columbia County,12,18,1094,395,699
50,12,23,Florida,Columbia County,12,99,67531,34951,32580
50,12,23,Florida,Columbia County,13,0,820,408,412
50,12,23,Florida,Columbia County,13,1,3397,1737,1660
50,12,23,Florida,Columbia County,13,2,4159,2151,2008
50,12,23,Florida,Columbia County,13,3,4202,2192,2010
50,12,23,Florida,Columbia County,13,4,4493,2459,2034
50,12,23,Florida,Columbia County,13,5,4736,2794,1942
50,12,23,Florida,Columbia County,13,6,4278,2319,1959
50,12,23,Florida,Columbia County,13,7,3956,2190,1766
50,12,23,Florida,Columbia County,13,8,3806,2075,1731
50,12,23,Florida,Columbia County,13,9,4241,2269,1972
50,12,23,Florida,Columbia County,13,10,4919,2549,2370
50,12,23,Florida,Columbia County,13,11,5285,2627,2658
50,12,23,Florida,Columbia County,13,12,4567,2310,2257
50,12,23,Florida,Columbia County,13,13,4314,2078,2236
50,12,23,Florida,Columbia County,13,14,3503,1711,1792
50,12,23,Florida,Columbia County,13,15,2576,1237,1339
50,12,23,Florida,Columbia County,13,16,1932,912,1020
50,12,23,Florida,Columbia County,13,17,1313,571,742
50,12,23,Florida,Columbia County,13,18,1100,398,702
50,12,23,Florida,Columbia County,13,99,67597,34987,32610
50,12,27,Florida,DeSoto County,1,0,431,224,207
50,12,27,Florida,DeSoto County,1,1,1442,716,726
50,12,27,Florida,DeSoto County,1,2,1944,1028,916
50,12,27,Florida,DeSoto County,1,3,2114,1105,1009
50,12,27,Florida,DeSoto County,1,4,2432,1427,1005
50,12,27,Florida,DeSoto County,1,5,2542,1845,697
50,12,27,Florida,DeSoto County,1,6,2486,1722,764
50,12,27,Florida,DeSoto County,1,7,2062,1305,757
50,12,27,Florida,DeSoto County,1,8,2095,1288,807
50,12,27,Florida,DeSoto County,1,9,1956,1148,808
50,12,27,Florida,DeSoto County,1,10,1736,977,759
50,12,27,Florida,DeSoto County,1,11,1605,797,808
50,12,27,Florida,DeSoto County,1,12,1617,807,810
50,12,27,Florida,DeSoto County,1,13,1632,765,867
50,12,27,Florida,DeSoto County,1,14,1763,872,891
50,12,27,Florida,DeSoto County,1,15,1655,821,834
50,12,27,Florida,DeSoto County,1,16,1353,640,713
50,12,27,Florida,DeSoto County,1,17,806,390,416
50,12,27,Florida,DeSoto County,1,18,533,223,310
50,12,27,Florida,DeSoto County,1,99,32204,18100,14104
50,12,27,Florida,DeSoto County,2,0,437,227,210
50,12,27,Florida,DeSoto County,2,1,1432,711,721
50,12,27,Florida,DeSoto County,2,2,1935,1022,913
50,12,27,Florida,DeSoto County,2,3,2121,1107,1014
50,12,27,Florida,DeSoto County,2,4,2430,1427,1003
50,12,27,Florida,DeSoto County,2,5,2543,1841,702
50,12,27,Florida,DeSoto County,2,6,2471,1711,760
50,12,27,Florida,DeSoto County,2,7,2060,1304,756
50,12,27,Florida,DeSoto County,2,8,2088,1283,805
50,12,27,Florida,DeSoto County,2,9,1961,1151,810
50,12,27,Florida,DeSoto County,2,10,1746,984,762
50,12,27,Florida,DeSoto County,2,11,1621,807,814
50,12,27,Florida,DeSoto County,2,12,1622,810,812
50,12,27,Florida,DeSoto County,2,13,1637,768,869
50,12,27,Florida,DeSoto County,2,14,1757,868,889
50,12,27,Florida,DeSoto County,2,15,1650,821,829
50,12,27,Florida,DeSoto County,2,16,1351,640,711
50,12,27,Florida,DeSoto County,2,17,804,387,417
50,12,27,Florida,DeSoto County,2,18,530,220,310
50,12,27,Florida,DeSoto County,2,99,32196,18089,14107
50,12,27,Florida,DeSoto County,3,0,458,241,217
50,12,27,Florida,DeSoto County,3,1,1495,777,718
50,12,27,Florida,DeSoto County,3,2,1896,981,915
50,12,27,Florida,DeSoto County,3,3,2202,1147,1055
50,12,27,Florida,DeSoto County,3,4,2417,1416,1001
50,12,27,Florida,DeSoto County,3,5,2546,1803,743
50,12,27,Florida,DeSoto County,3,6,2368,1640,728
50,12,27,Florida,DeSoto County,3,7,2049,1312,737
50,12,27,Florida,DeSoto County,3,8,2144,1269,875
50,12,27,Florida,DeSoto County,3,9,2058,1231,827
50,12,27,Florida,DeSoto County,3,10,1811,996,815
50,12,27,Florida,DeSoto County,3,11,1672,855,817
50,12,27,Florida,DeSoto County,3,12,1643,804,839
50,12,27,Florida,DeSoto County,3,13,1646,806,840
50,12,27,Florida,DeSoto County,3,14,1728,848,880
50,12,27,Florida,DeSoto County,3,15,1659,820,839
50,12,27,Florida,DeSoto County,3,16,1280,612,668
50,12,27,Florida,DeSoto County,3,17,841,419,422
50,12,27,Florida,DeSoto County,3,18,489,193,296
50,12,27,Florida,DeSoto County,3,99,32402,18170,14232
50,12,27,Florida,DeSoto County,4,0,478,263,215
50,12,27,Florida,DeSoto County,4,1,1618,841,777
50,12,27,Florida,DeSoto County,4,2,1850,955,895
50,12,27,Florida,DeSoto County,4,3,2193,1166,1027
50,12,27,Florida,DeSoto County,4,4,2428,1389,1039
50,12,27,Florida,DeSoto County,4,5,2596,1811,785
50,12,27,Florida,DeSoto County,4,6,2221,1546,675
50,12,27,Florida,DeSoto County,4,7,2120,1346,774
50,12,27,Florida,DeSoto County,4,8,2015,1198,817
50,12,27,Florida,DeSoto County,4,9,2099,1262,837
50,12,27,Florida,DeSoto County,4,10,1911,1037,874
50,12,27,Florida,DeSoto County,4,11,1669,889,780
50,12,27,Florida,DeSoto County,4,12,1675,828,847
50,12,27,Florida,DeSoto County,4,13,1683,816,867
50,12,27,Florida,DeSoto County,4,14,1681,792,889
50,12,27,Florida,DeSoto County,4,15,1630,809,821
50,12,27,Florida,DeSoto County,4,16,1217,604,613
50,12,27,Florida,DeSoto County,4,17,872,420,452
50,12,27,Florida,DeSoto County,4,18,490,183,307
50,12,27,Florida,DeSoto County,4,99,32446,18155,14291
50,12,27,Florida,DeSoto County,5,0,459,230,229
50,12,27,Florida,DeSoto County,5,1,1821,955,866
50,12,27,Florida,DeSoto County,5,2,1770,910,860
50,12,27,Florida,DeSoto County,5,3,2260,1199,1061
50,12,27,Florida,DeSoto County,5,4,2474,1427,1047
50,12,27,Florida,DeSoto County,5,5,2709,1898,811
50,12,27,Florida,DeSoto County,5,6,2258,1545,713
50,12,27,Florida,DeSoto County,5,7,2197,1395,802
50,12,27,Florida,DeSoto County,5,8,2070,1224,846
50,12,27,Florida,DeSoto County,5,9,2123,1280,843
50,12,27,Florida,DeSoto County,5,10,1982,1123,859
50,12,27,Florida,DeSoto County,5,11,1730,915,815
50,12,27,Florida,DeSoto County,5,12,1748,882,866
50,12,27,Florida,DeSoto County,5,13,1726,838,888
50,12,27,Florida,DeSoto County,5,14,1713,807,906
50,12,27,Florida,DeSoto County,5,15,1613,816,797
50,12,27,Florida,DeSoto County,5,16,1219,615,604
50,12,27,Florida,DeSoto County,5,17,905,427,478
50,12,27,Florida,DeSoto County,5,18,494,176,318
50,12,27,Florida,DeSoto County,5,99,33271,18662,14609
50,12,27,Florida,DeSoto County,6,0,482,225,257
50,12,27,Florida,DeSoto County,6,1,1845,980,865
50,12,27,Florida,DeSoto County,6,2,1850,946,904
50,12,27,Florida,DeSoto County,6,3,2254,1201,1053
50,12,27,Florida,DeSoto County,6,4,2490,1425,1065
50,12,27,Florida,DeSoto County,6,5,2693,1857,836
50,12,27,Florida,DeSoto County,6,6,2319,1585,734
50,12,27,Florida,DeSoto County,6,7,2298,1457,841
50,12,27,Florida,DeSoto County,6,8,2017,1209,808
50,12,27,Florida,DeSoto County,6,9,2159,1297,862
50,12,27,Florida,DeSoto County,6,10,2064,1146,918
50,12,27,Florida,DeSoto County,6,11,1796,965,831
50,12,27,Florida,DeSoto County,6,12,1828,904,924
50,12,27,Florida,DeSoto County,6,13,1794,892,902
50,12,27,Florida,DeSoto County,6,14,1743,816,927
50,12,27,Florida,DeSoto County,6,15,1616,824,792
50,12,27,Florida,DeSoto County,6,16,1223,619,604
50,12,27,Florida,DeSoto County,6,17,903,430,473
50,12,27,Florida,DeSoto County,6,18,521,194,327
50,12,27,Florida,DeSoto County,6,99,33895,18972,14923
50,12,27,Florida,DeSoto County,7,0,506,260,246
50,12,27,Florida,DeSoto County,7,1,1775,913,862
50,12,27,Florida,DeSoto County,7,2,1837,970,867
50,12,27,Florida,DeSoto County,7,3,2191,1163,1028
50,12,27,Florida,DeSoto County,7,4,2553,1458,1095
50,12,27,Florida,DeSoto County,7,5,2698,1906,792
50,12,27,Florida,DeSoto County,7,6,2402,1617,785
50,12,27,Florida,DeSoto County,7,7,2214,1431,783
50,12,27,Florida,DeSoto County,7,8,2073,1258,815
50,12,27,Florida,DeSoto County,7,9,2168,1293,875
50,12,27,Florida,DeSoto County,7,10,2065,1179,886
50,12,27,Florida,DeSoto County,7,11,1917,1037,880
50,12,27,Florida,DeSoto County,7,12,1849,930,919
50,12,27,Florida,DeSoto County,7,13,1806,930,876
50,12,27,Florida,DeSoto County,7,14,1668,772,896
50,12,27,Florida,DeSoto County,7,15,1589,830,759
50,12,27,Florida,DeSoto County,7,16,1197,616,581
50,12,27,Florida,DeSoto County,7,17,827,392,435
50,12,27,Florida,DeSoto County,7,18,529,195,334
50,12,27,Florida,DeSoto County,7,99,33864,19150,14714
50,12,27,Florida,DeSoto County,8,0,497,246,251
50,12,27,Florida,DeSoto County,8,1,1758,916,842
50,12,27,Florida,DeSoto County,8,2,1926,1024,902
50,12,27,Florida,DeSoto County,8,3,2167,1144,1023
50,12,27,Florida,DeSoto County,8,4,2587,1475,1112
50,12,27,Florida,DeSoto County,8,5,2673,1918,755
50,12,27,Florida,DeSoto County,8,6,2504,1627,877
50,12,27,Florida,DeSoto County,8,7,2221,1447,774
50,12,27,Florida,DeSoto County,8,8,2102,1298,804
50,12,27,Florida,DeSoto County,8,9,2165,1261,904
50,12,27,Florida,DeSoto County,8,10,2116,1224,892
50,12,27,Florida,DeSoto County,8,11,1982,1055,927
50,12,27,Florida,DeSoto County,8,12,1894,1003,891
50,12,27,Florida,DeSoto County,8,13,1824,904,920
50,12,27,Florida,DeSoto County,8,14,1728,839,889
50,12,27,Florida,DeSoto County,8,15,1588,833,755
50,12,27,Florida,DeSoto County,8,16,1253,616,637
50,12,27,Florida,DeSoto County,8,17,768,370,398
50,12,27,Florida,DeSoto County,8,18,547,210,337
50,12,27,Florida,DeSoto County,8,99,34300,19410,14890
50,12,27,Florida,DeSoto County,9,0,510,267,243
50,12,27,Florida,DeSoto County,9,1,1751,888,863
50,12,27,Florida,DeSoto County,9,2,2043,1111,932
50,12,27,Florida,DeSoto County,9,3,2116,1106,1010
50,12,27,Florida,DeSoto County,9,4,2546,1468,1078
50,12,27,Florida,DeSoto County,9,5,2659,1825,834
50,12,27,Florida,DeSoto County,9,6,2588,1732,856
50,12,27,Florida,DeSoto County,9,7,2149,1412,737
50,12,27,Florida,DeSoto County,9,8,2170,1332,838
50,12,27,Florida,DeSoto County,9,9,2046,1214,832
50,12,27,Florida,DeSoto County,9,10,2177,1260,917
50,12,27,Florida,DeSoto County,9,11,2073,1098,975
50,12,27,Florida,DeSoto County,9,12,1886,1027,859
50,12,27,Florida,DeSoto County,9,13,1884,953,931
50,12,27,Florida,DeSoto County,9,14,1789,848,941
50,12,27,Florida,DeSoto County,9,15,1531,773,758
50,12,27,Florida,DeSoto County,9,16,1261,647,614
50,12,27,Florida,DeSoto County,9,17,766,386,380
50,12,27,Florida,DeSoto County,9,18,592,222,370
50,12,27,Florida,DeSoto County,9,99,34537,19569,14968
50,12,27,Florida,DeSoto County,10,0,487,221,266
50,12,27,Florida,DeSoto County,10,1,1762,929,833
50,12,27,Florida,DeSoto County,10,2,2094,1112,982
50,12,27,Florida,DeSoto County,10,3,1992,1038,954
50,12,27,Florida,DeSoto County,10,4,2504,1459,1045
50,12,27,Florida,DeSoto County,10,5,2636,1802,834
50,12,27,Florida,DeSoto County,10,6,2418,1618,800
50,12,27,Florida,DeSoto County,10,7,2149,1364,785
50,12,27,Florida,DeSoto County,10,8,2226,1386,840
50,12,27,Florida,DeSoto County,10,9,2028,1215,813
50,12,27,Florida,DeSoto County,10,10,2117,1226,891
50,12,27,Florida,DeSoto County,10,11,2109,1171,938
50,12,27,Florida,DeSoto County,10,12,1908,1025,883
50,12,27,Florida,DeSoto County,10,13,1880,976,904
50,12,27,Florida,DeSoto County,10,14,1897,885,1012
50,12,27,Florida,DeSoto County,10,15,1527,778,749
50,12,27,Florida,DeSoto County,10,16,1256,637,619
50,12,27,Florida,DeSoto County,10,17,826,409,417
50,12,27,Florida,DeSoto County,10,18,558,213,345
50,12,27,Florida,DeSoto County,10,99,34374,19464,14910
50,12,27,Florida,DeSoto County,11,0,459,220,239
50,12,27,Florida,DeSoto County,11,1,1804,926,878
50,12,27,Florida,DeSoto County,11,2,2071,1092,979
50,12,27,Florida,DeSoto County,11,3,2014,1056,958
50,12,27,Florida,DeSoto County,11,4,2469,1494,975
50,12,27,Florida,DeSoto County,11,5,2667,1816,851
50,12,27,Florida,DeSoto County,11,6,2450,1600,850
50,12,27,Florida,DeSoto County,11,7,2122,1352,770
50,12,27,Florida,DeSoto County,11,8,2231,1375,856
50,12,27,Florida,DeSoto County,11,9,2018,1252,766
50,12,27,Florida,DeSoto County,11,10,2137,1233,904
50,12,27,Florida,DeSoto County,11,11,2160,1200,960
50,12,27,Florida,DeSoto County,11,12,1930,1069,861
50,12,27,Florida,DeSoto County,11,13,1917,977,940
50,12,27,Florida,DeSoto County,11,14,1880,892,988
50,12,27,Florida,DeSoto County,11,15,1619,838,781
50,12,27,Florida,DeSoto County,11,16,1219,602,617
50,12,27,Florida,DeSoto County,11,17,832,413,419
50,12,27,Florida,DeSoto County,11,18,593,239,354
50,12,27,Florida,DeSoto County,11,99,34592,19646,14946
50,12,27,Florida,DeSoto County,12,0,454,223,231
50,12,27,Florida,DeSoto County,12,1,1824,942,882
50,12,27,Florida,DeSoto County,12,2,2103,1119,984
50,12,27,Florida,DeSoto County,12,3,2027,1052,975
50,12,27,Florida,DeSoto County,12,4,2456,1475,981
50,12,27,Florida,DeSoto County,12,5,2678,1813,865
50,12,27,Florida,DeSoto County,12,6,2407,1577,830
50,12,27,Florida,DeSoto County,12,7,2200,1376,824
50,12,27,Florida,DeSoto County,12,8,2120,1300,820
50,12,27,Florida,DeSoto County,12,9,2053,1265,788
50,12,27,Florida,DeSoto County,12,10,2175,1251,924
50,12,27,Florida,DeSoto County,12,11,2173,1220,953
50,12,27,Florida,DeSoto County,12,12,2002,1099,903
50,12,27,Florida,DeSoto County,12,13,1962,1002,960
50,12,27,Florida,DeSoto County,12,14,1934,926,1008
50,12,27,Florida,DeSoto County,12,15,1633,824,809
50,12,27,Florida,DeSoto County,12,16,1224,611,613
50,12,27,Florida,DeSoto County,12,17,831,402,429
50,12,27,Florida,DeSoto County,12,18,606,241,365
50,12,27,Florida,DeSoto County,12,99,34862,19718,15144
50,12,27,Florida,DeSoto County,13,0,456,223,233
50,12,27,Florida,DeSoto County,13,1,1835,946,889
50,12,27,Florida,DeSoto County,13,2,2099,1119,980
50,12,27,Florida,DeSoto County,13,3,2043,1061,982
50,12,27,Florida,DeSoto County,13,4,2463,1479,984
50,12,27,Florida,DeSoto County,13,5,2691,1822,869
50,12,27,Florida,DeSoto County,13,6,2413,1583,830
50,12,27,Florida,DeSoto County,13,7,2208,1380,828
50,12,27,Florida,DeSoto County,13,8,2119,1301,818
50,12,27,Florida,DeSoto County,13,9,2057,1263,794
50,12,27,Florida,DeSoto County,13,10,2175,1251,924
50,12,27,Florida,DeSoto County,13,11,2181,1226,955
50,12,27,Florida,DeSoto County,13,12,2017,1104,913
50,12,27,Florida,DeSoto County,13,13,1980,1012,968
50,12,27,Florida,DeSoto County,13,14,1946,931,1015
50,12,27,Florida,DeSoto County,13,15,1640,827,813
50,12,27,Florida,DeSoto County,13,16,1220,609,611
50,12,27,Florida,DeSoto County,13,17,831,403,428
50,12,27,Florida,DeSoto County,13,18,610,244,366
50,12,27,Florida,DeSoto County,13,99,34984,19784,15200
50,12,29,Florida,Dixie County,1,0,161,84,77
50,12,29,Florida,Dixie County,1,1,607,311,296
50,12,29,Florida,Dixie County,1,2,813,412,401
50,12,29,Florida,Dixie County,1,3,868,438,430
50,12,29,Florida,Dixie County,1,4,911,479,432
50,12,29,Florida,Dixie County,1,5,772,438,334
50,12,29,Florida,Dixie County,1,6,804,468,336
50,12,29,Florida,Dixie County,1,7,822,495,327
50,12,29,Florida,Dixie County,1,8,1004,606,398
50,12,29,Florida,Dixie County,1,9,1039,585,454
50,12,29,Florida,Dixie County,1,10,913,499,414
50,12,29,Florida,Dixie County,1,11,948,471,477
50,12,29,Florida,Dixie County,1,12,865,437,428
50,12,29,Florida,Dixie County,1,13,878,441,437
50,12,29,Florida,Dixie County,1,14,800,431,369
50,12,29,Florida,Dixie County,1,15,665,313,352
50,12,29,Florida,Dixie County,1,16,473,255,218
50,12,29,Florida,Dixie County,1,17,250,115,135
50,12,29,Florida,Dixie County,1,18,165,53,112
50,12,29,Florida,Dixie County,1,99,13758,7331,6427
50,12,29,Florida,Dixie County,2,0,162,84,78
50,12,29,Florida,Dixie County,2,1,603,308,295
50,12,29,Florida,Dixie County,2,2,808,411,397
50,12,29,Florida,Dixie County,2,3,870,439,431
50,12,29,Florida,Dixie County,2,4,913,480,433
50,12,29,Florida,Dixie County,2,5,779,440,339
50,12,29,Florida,Dixie County,2,6,792,461,331
50,12,29,Florida,Dixie County,2,7,813,488,325
50,12,29,Florida,Dixie County,2,8,992,597,395
50,12,29,Florida,Dixie County,2,9,1034,579,455
50,12,29,Florida,Dixie County,2,10,920,502,418
50,12,29,Florida,Dixie County,2,11,960,478,482
50,12,29,Florida,Dixie County,2,12,870,440,430
50,12,29,Florida,Dixie County,2,13,885,446,439
50,12,29,Florida,Dixie County,2,14,797,429,368
50,12,29,Florida,Dixie County,2,15,667,314,353
50,12,29,Florida,Dixie County,2,16,475,256,219
50,12,29,Florida,Dixie County,2,17,255,117,138
50,12,29,Florida,Dixie County,2,18,163,52,111
50,12,29,Florida,Dixie County,2,99,13758,7321,6437
50,12,29,Florida,Dixie County,3,0,164,83,81
50,12,29,Florida,Dixie County,3,1,621,321,300
50,12,29,Florida,Dixie County,3,2,827,400,427
50,12,29,Florida,Dixie County,3,3,857,420,437
50,12,29,Florida,Dixie County,3,4,873,462,411
50,12,29,Florida,Dixie County,3,5,838,479,359
50,12,29,Florida,Dixie County,3,6,757,446,311
50,12,29,Florida,Dixie County,3,7,806,461,345
50,12,29,Florida,Dixie County,3,8,966,597,369
50,12,29,Florida,Dixie County,3,9,1065,582,483
50,12,29,Florida,Dixie County,3,10,968,525,443
50,12,29,Florida,Dixie County,3,11,1001,512,489
50,12,29,Florida,Dixie County,3,12,909,451,458
50,12,29,Florida,Dixie County,3,13,894,438,456
50,12,29,Florida,Dixie County,3,14,849,466,383
50,12,29,Florida,Dixie County,3,15,686,327,359
50,12,29,Florida,Dixie County,3,16,538,289,249
50,12,29,Florida,Dixie County,3,17,246,125,121
50,12,29,Florida,Dixie County,3,18,168,54,114
50,12,29,Florida,Dixie County,3,99,14033,7438,6595
50,12,29,Florida,Dixie County,4,0,171,80,91
50,12,29,Florida,Dixie County,4,1,669,342,327
50,12,29,Florida,Dixie County,4,2,816,400,416
50,12,29,Florida,Dixie County,4,3,867,419,448
50,12,29,Florida,Dixie County,4,4,893,471,422
50,12,29,Florida,Dixie County,4,5,863,486,377
50,12,29,Florida,Dixie County,4,6,756,445,311
50,12,29,Florida,Dixie County,4,7,792,449,343
50,12,29,Florida,Dixie County,4,8,923,558,365
50,12,29,Florida,Dixie County,4,9,1082,578,504
50,12,29,Florida,Dixie County,4,10,1012,545,467
50,12,29,Florida,Dixie County,4,11,977,501,476
50,12,29,Florida,Dixie County,4,12,1004,504,500
50,12,29,Florida,Dixie County,4,13,896,431,465
50,12,29,Florida,Dixie County,4,14,879,476,403
50,12,29,Florida,Dixie County,4,15,689,333,356
50,12,29,Florida,Dixie County,4,16,532,301,231
50,12,29,Florida,Dixie County,4,17,250,126,124
50,12,29,Florida,Dixie County,4,18,163,55,108
50,12,29,Florida,Dixie County,4,99,14234,7500,6734
50,12,29,Florida,Dixie County,5,0,156,78,78
50,12,29,Florida,Dixie County,5,1,635,332,303
50,12,29,Florida,Dixie County,5,2,810,418,392
50,12,29,Florida,Dixie County,5,3,925,433,492
50,12,29,Florida,Dixie County,5,4,858,461,397
50,12,29,Florida,Dixie County,5,5,858,479,379
50,12,29,Florida,Dixie County,5,6,755,452,303
50,12,29,Florida,Dixie County,5,7,790,436,354
50,12,29,Florida,Dixie County,5,8,905,544,361
50,12,29,Florida,Dixie County,5,9,1081,596,485
50,12,29,Florida,Dixie County,5,10,1053,539,514
50,12,29,Florida,Dixie County,5,11,974,532,442
50,12,29,Florida,Dixie County,5,12,1049,520,529
50,12,29,Florida,Dixie County,5,13,953,469,484
50,12,29,Florida,Dixie County,5,14,870,457,413
50,12,29,Florida,Dixie County,5,15,692,349,343
50,12,29,Florida,Dixie County,5,16,538,283,255
50,12,29,Florida,Dixie County,5,17,282,147,135
50,12,29,Florida,Dixie County,5,18,180,68,112
50,12,29,Florida,Dixie County,5,99,14364,7593,6771
50,12,29,Florida,Dixie County,6,0,169,83,86
50,12,29,Florida,Dixie County,6,1,652,333,319
50,12,29,Florida,Dixie County,6,2,805,415,390
50,12,29,Florida,Dixie County,6,3,920,456,464
50,12,29,Florida,Dixie County,6,4,860,462,398
50,12,29,Florida,Dixie County,6,5,889,490,399
50,12,29,Florida,Dixie County,6,6,813,488,325
50,12,29,Florida,Dixie County,6,7,826,474,352
50,12,29,Florida,Dixie County,6,8,935,560,375
50,12,29,Florida,Dixie County,6,9,1111,634,477
50,12,29,Florida,Dixie County,6,10,1136,590,546
50,12,29,Florida,Dixie County,6,11,1004,545,459
50,12,29,Florida,Dixie County,6,12,1075,545,530
50,12,29,Florida,Dixie County,6,13,1000,497,503
50,12,29,Florida,Dixie County,6,14,898,457,441
50,12,29,Florida,Dixie County,6,15,713,370,343
50,12,29,Florida,Dixie County,6,16,515,242,273
50,12,29,Florida,Dixie County,6,17,321,172,149
50,12,29,Florida,Dixie County,6,18,183,71,112
50,12,29,Florida,Dixie County,6,99,14825,7884,6941
50,12,29,Florida,Dixie County,7,0,203,99,104
50,12,29,Florida,Dixie County,7,1,652,328,324
50,12,29,Florida,Dixie County,7,2,801,412,389
50,12,29,Florida,Dixie County,7,3,880,432,448
50,12,29,Florida,Dixie County,7,4,926,487,439
50,12,29,Florida,Dixie County,7,5,911,541,370
50,12,29,Florida,Dixie County,7,6,886,535,351
50,12,29,Florida,Dixie County,7,7,822,489,333
50,12,29,Florida,Dixie County,7,8,951,577,374
50,12,29,Florida,Dixie County,7,9,1156,677,479
50,12,29,Florida,Dixie County,7,10,1220,645,575
50,12,29,Florida,Dixie County,7,11,1086,605,481
50,12,29,Florida,Dixie County,7,12,1145,555,590
50,12,29,Florida,Dixie County,7,13,1050,546,504
50,12,29,Florida,Dixie County,7,14,958,500,458
50,12,29,Florida,Dixie County,7,15,735,398,337
50,12,29,Florida,Dixie County,7,16,480,214,266
50,12,29,Florida,Dixie County,7,17,367,199,168
50,12,29,Florida,Dixie County,7,18,198,70,128
50,12,29,Florida,Dixie County,7,99,15427,8309,7118
50,12,29,Florida,Dixie County,8,0,203,103,100
50,12,29,Florida,Dixie County,8,1,648,328,320
50,12,29,Florida,Dixie County,8,2,862,444,418
50,12,29,Florida,Dixie County,8,3,890,430,460
50,12,29,Florida,Dixie County,8,4,931,498,433
50,12,29,Florida,Dixie County,8,5,904,533,371
50,12,29,Florida,Dixie County,8,6,980,569,411
50,12,29,Florida,Dixie County,8,7,808,497,311
50,12,29,Florida,Dixie County,8,8,959,566,393
50,12,29,Florida,Dixie County,8,9,1105,664,441
50,12,29,Florida,Dixie County,8,10,1275,664,611
50,12,29,Florida,Dixie County,8,11,1150,639,511
50,12,29,Florida,Dixie County,8,12,1185,594,591
50,12,29,Florida,Dixie County,8,13,1169,616,553
50,12,29,Florida,Dixie County,8,14,972,480,492
50,12,29,Florida,Dixie County,8,15,771,422,349
50,12,29,Florida,Dixie County,8,16,483,233,250
50,12,29,Florida,Dixie County,8,17,411,216,195
50,12,29,Florida,Dixie County,8,18,186,70,116
50,12,29,Florida,Dixie County,8,99,15892,8566,7326
50,12,29,Florida,Dixie County,9,0,215,106,109
50,12,29,Florida,Dixie County,9,1,682,352,330
50,12,29,Florida,Dixie County,9,2,888,457,431
50,12,29,Florida,Dixie County,9,3,877,437,440
50,12,29,Florida,Dixie County,9,4,936,476,460
50,12,29,Florida,Dixie County,9,5,904,530,374
50,12,29,Florida,Dixie County,9,6,962,562,400
50,12,29,Florida,Dixie County,9,7,795,500,295
50,12,29,Florida,Dixie County,9,8,925,561,364
50,12,29,Florida,Dixie County,9,9,1109,644,465
50,12,29,Florida,Dixie County,9,10,1267,661,606
50,12,29,Florida,Dixie County,9,11,1233,691,542
50,12,29,Florida,Dixie County,9,12,1143,569,574
50,12,29,Florida,Dixie County,9,13,1256,662,594
50,12,29,Florida,Dixie County,9,14,969,479,490
50,12,29,Florida,Dixie County,9,15,833,438,395
50,12,29,Florida,Dixie County,9,16,495,244,251
50,12,29,Florida,Dixie County,9,17,380,190,190
50,12,29,Florida,Dixie County,9,18,214,78,136
50,12,29,Florida,Dixie County,9,99,16083,8637,7446
50,12,29,Florida,Dixie County,10,0,207,101,106
50,12,29,Florida,Dixie County,10,1,724,370,354
50,12,29,Florida,Dixie County,10,2,851,440,411
50,12,29,Florida,Dixie County,10,3,843,422,421
50,12,29,Florida,Dixie County,10,4,954,497,457
50,12,29,Florida,Dixie County,10,5,889,537,352
50,12,29,Florida,Dixie County,10,6,991,548,443
50,12,29,Florida,Dixie County,10,7,792,514,278
50,12,29,Florida,Dixie County,10,8,904,535,369
50,12,29,Florida,Dixie County,10,9,1065,610,455
50,12,29,Florida,Dixie County,10,10,1308,721,587
50,12,29,Florida,Dixie County,10,11,1301,697,604
50,12,29,Florida,Dixie County,10,12,1129,587,542
50,12,29,Florida,Dixie County,10,13,1291,655,636
50,12,29,Florida,Dixie County,10,14,1026,522,504
50,12,29,Florida,Dixie County,10,15,823,430,393
50,12,29,Florida,Dixie County,10,16,513,262,251
50,12,29,Florida,Dixie County,10,17,374,175,199
50,12,29,Florida,Dixie County,10,18,229,93,136
50,12,29,Florida,Dixie County,10,99,16214,8716,7498
50,12,29,Florida,Dixie County,11,0,191,85,106
50,12,29,Florida,Dixie County,11,1,702,372,330
50,12,29,Florida,Dixie County,11,2,903,461,442
50,12,29,Florida,Dixie County,11,3,851,403,448
50,12,29,Florida,Dixie County,11,4,928,502,426
50,12,29,Florida,Dixie County,11,5,889,511,378
50,12,29,Florida,Dixie County,11,6,1001,569,432
50,12,29,Florida,Dixie County,11,7,859,555,304
50,12,29,Florida,Dixie County,11,8,855,517,338
50,12,29,Florida,Dixie County,11,9,1075,620,455
50,12,29,Florida,Dixie County,11,10,1245,697,548
50,12,29,Florida,Dixie County,11,11,1345,729,616
50,12,29,Florida,Dixie County,11,12,1200,604,596
50,12,29,Florida,Dixie County,11,13,1287,658,629
50,12,29,Florida,Dixie County,11,14,1119,579,540
50,12,29,Florida,Dixie County,11,15,816,429,387
50,12,29,Florida,Dixie County,11,16,555,292,263
50,12,29,Florida,Dixie County,11,17,352,157,195
50,12,29,Florida,Dixie County,11,18,230,95,135
50,12,29,Florida,Dixie County,11,99,16403,8835,7568
50,12,29,Florida,Dixie County,12,0,173,80,93
50,12,29,Florida,Dixie County,12,1,692,359,333
50,12,29,Florida,Dixie County,12,2,885,459,426
50,12,29,Florida,Dixie County,12,3,859,430,429
50,12,29,Florida,Dixie County,12,4,880,469,411
50,12,29,Florida,Dixie County,12,5,872,490,382
50,12,29,Florida,Dixie County,12,6,929,544,385
50,12,29,Florida,Dixie County,12,7,923,565,358
50,12,29,Florida,Dixie County,12,8,856,520,336
50,12,29,Florida,Dixie County,12,9,1058,604,454
50,12,29,Florida,Dixie County,12,10,1253,706,547
50,12,29,Florida,Dixie County,12,11,1321,723,598
50,12,29,Florida,Dixie County,12,12,1243,638,605
50,12,29,Florida,Dixie County,12,13,1308,649,659
50,12,29,Florida,Dixie County,12,14,1132,579,553
50,12,29,Florida,Dixie County,12,15,865,463,402
50,12,29,Florida,Dixie County,12,16,576,312,264
50,12,29,Florida,Dixie County,12,17,347,148,199
50,12,29,Florida,Dixie County,12,18,250,104,146
50,12,29,Florida,Dixie County,12,99,16422,8842,7580
50,12,29,Florida,Dixie County,13,0,173,80,93
50,12,29,Florida,Dixie County,13,1,698,362,336
50,12,29,Florida,Dixie County,13,2,873,454,419
50,12,29,Florida,Dixie County,13,3,853,429,424
50,12,29,Florida,Dixie County,13,4,880,469,411
50,12,29,Florida,Dixie County,13,5,872,491,381
50,12,29,Florida,Dixie County,13,6,928,546,382
50,12,29,Florida,Dixie County,13,7,923,566,357
50,12,29,Florida,Dixie County,13,8,853,523,330
50,12,29,Florida,Dixie County,13,9,1061,601,460
50,12,29,Florida,Dixie County,13,10,1244,703,541
50,12,29,Florida,Dixie County,13,11,1309,719,590
50,12,29,Florida,Dixie County,13,12,1244,637,607
50,12,29,Florida,Dixie County,13,13,1307,649,658
50,12,29,Florida,Dixie County,13,14,1133,580,553
50,12,29,Florida,Dixie County,13,15,864,463,401
50,12,29,Florida,Dixie County,13,16,579,312,267
50,12,29,Florida,Dixie County,13,17,345,147,198
50,12,29,Florida,Dixie County,13,18,251,105,146
50,12,29,Florida,Dixie County,13,99,16390,8836,7554
50,12,31,Florida,Duval County,1,0,11516,5764,5752
50,12,31,Florida,Duval County,1,1,44729,22858,21871
50,12,31,Florida,Duval County,1,2,57961,29584,28377
50,12,31,Florida,Duval County,1,3,57825,29599,28226
50,12,31,Florida,Duval County,1,4,54382,27432,26950
50,12,31,Florida,Duval County,1,5,53360,26492,26868
50,12,31,Florida,Duval County,1,6,59652,29523,30129
50,12,31,Florida,Duval County,1,7,61318,30567,30751
50,12,31,Florida,Duval County,1,8,67210,33258,33952
50,12,31,Florida,Duval County,1,9,64189,31472,32717
50,12,31,Florida,Duval County,1,10,55501,26674,28827
50,12,31,Florida,Duval County,1,11,48041,23155,24886
50,12,31,Florida,Duval County,1,12,34768,16437,18331
50,12,31,Florida,Duval County,1,13,26672,12504,14168
50,12,31,Florida,Duval County,1,14,22679,10256,12423
50,12,31,Florida,Duval County,1,15,20917,8753,12164
50,12,31,Florida,Duval County,1,16,17758,6929,10829
50,12,31,Florida,Duval County,1,17,11254,4013,7241
50,12,31,Florida,Duval County,1,18,9164,2509,6655
50,12,31,Florida,Duval County,1,99,778896,377779,401117
50,12,31,Florida,Duval County,2,0,11594,5797,5797
50,12,31,Florida,Duval County,2,1,44451,22716,21735
50,12,31,Florida,Duval County,2,2,57526,29356,28170
50,12,31,Florida,Duval County,2,3,58059,29696,28363
50,12,31,Florida,Duval County,2,4,54473,27487,26986
50,12,31,Florida,Duval County,2,5,53869,26741,27128
50,12,31,Florida,Duval County,2,6,59192,29293,29899
50,12,31,Florida,Duval County,2,7,61213,30531,30682
50,12,31,Florida,Duval County,2,8,66954,33124,33830
50,12,31,Florida,Duval County,2,9,64336,31530,32806
50,12,31,Florida,Duval County,2,10,55822,26839,28983
50,12,31,Florida,Duval County,2,11,48563,23415,25148
50,12,31,Florida,Duval County,2,12,34979,16546,18433
50,12,31,Florida,Duval County,2,13,26783,12564,14219
50,12,31,Florida,Duval County,2,14,22701,10276,12425
50,12,31,Florida,Duval County,2,15,20905,8762,12143
50,12,31,Florida,Duval County,2,16,17822,6960,10862
50,12,31,Florida,Duval County,2,17,11339,4051,7288
50,12,31,Florida,Duval County,2,18,9219,2526,6693
50,12,31,Florida,Duval County,2,99,779800,378210,401590
50,12,31,Florida,Duval County,3,0,11990,6019,5971
50,12,31,Florida,Duval County,3,1,45068,22925,22143
50,12,31,Florida,Duval County,3,2,56416,28824,27592
50,12,31,Florida,Duval County,3,3,59064,30243,28821
50,12,31,Florida,Duval County,3,4,54537,27707,26830
50,12,31,Florida,Duval County,3,5,57382,28313,29069
50,12,31,Florida,Duval County,3,6,57627,28570,29057
50,12,31,Florida,Duval County,3,7,61955,30704,31251
50,12,31,Florida,Duval County,3,8,65382,32335,33047
50,12,31,Florida,Duval County,3,9,65685,32287,33398
50,12,31,Florida,Duval County,3,10,57520,27669,29851
50,12,31,Florida,Duval County,3,11,51529,24787,26742
50,12,31,Florida,Duval County,3,12,36460,17300,19160
50,12,31,Florida,Duval County,3,13,27661,12964,14697
50,12,31,Florida,Duval County,3,14,22589,10224,12365
50,12,31,Florida,Duval County,3,15,20322,8564,11758
50,12,31,Florida,Duval County,3,16,17729,6908,10821
50,12,31,Florida,Duval County,3,17,11852,4254,7598
50,12,31,Florida,Duval County,3,18,9913,2665,7248
50,12,31,Florida,Duval County,3,99,790681,383262,407419
50,12,31,Florida,Duval County,4,0,11679,5936,5743
50,12,31,Florida,Duval County,4,1,45935,23189,22746
50,12,31,Florida,Duval County,4,2,55744,28355,27389
50,12,31,Florida,Duval County,4,3,59622,30404,29218
50,12,31,Florida,Duval County,4,4,55263,28236,27027
50,12,31,Florida,Duval County,4,5,59548,29159,30389
50,12,31,Florida,Duval County,4,6,57293,28335,28958
50,12,31,Florida,Duval County,4,7,62538,31044,31494
50,12,31,Florida,Duval County,4,8,63692,31296,32396
50,12,31,Florida,Duval County,4,9,65986,32408,33578
50,12,31,Florida,Duval County,4,10,59808,28910,30898
50,12,31,Florida,Duval County,4,11,51876,24709,27167
50,12,31,Florida,Duval County,4,12,40033,19191,20842
50,12,31,Florida,Duval County,4,13,28716,13418,15298
50,12,31,Florida,Duval County,4,14,22837,10257,12580
50,12,31,Florida,Duval County,4,15,20068,8624,11444
50,12,31,Florida,Duval County,4,16,17659,6888,10771
50,12,31,Florida,Duval County,4,17,12272,4450,7822
50,12,31,Florida,Duval County,4,18,9963,2720,7243
50,12,31,Florida,Duval County,4,99,800532,387529,413003
50,12,31,Florida,Duval County,5,0,11662,5986,5676
50,12,31,Florida,Duval County,5,1,46922,23670,23252
50,12,31,Florida,Duval County,5,2,54977,28035,26942
50,12,31,Florida,Duval County,5,3,59922,30572,29350
50,12,31,Florida,Duval County,5,4,56073,28618,27455
50,12,31,Florida,Duval County,5,5,61558,30207,31351
50,12,31,Florida,Duval County,5,6,58027,28388,29639
50,12,31,Florida,Duval County,5,7,62114,30702,31412
50,12,31,Florida,Duval County,5,8,61990,30416,31574
50,12,31,Florida,Duval County,5,9,65802,32360,33442
50,12,31,Florida,Duval County,5,10,61573,29715,31858
50,12,31,Florida,Duval County,5,11,52612,24945,27667
50,12,31,Florida,Duval County,5,12,42644,20417,22227
50,12,31,Florida,Duval County,5,13,30338,14093,16245
50,12,31,Florida,Duval County,5,14,23265,10579,12686
50,12,31,Florida,Duval County,5,15,19827,8540,11287
50,12,31,Florida,Duval County,5,16,17462,6809,10653
50,12,31,Florida,Duval County,5,17,12756,4634,8122
50,12,31,Florida,Duval County,5,18,10109,2824,7285
50,12,31,Florida,Duval County,5,99,809633,391510,418123
50,12,31,Florida,Duval County,6,0,11884,6075,5809
50,12,31,Florida,Duval County,6,1,47194,23799,23395
50,12,31,Florida,Duval County,6,2,54661,27931,26730
50,12,31,Florida,Duval County,6,3,59548,30303,29245
50,12,31,Florida,Duval County,6,4,57402,29351,28051
50,12,31,Florida,Duval County,6,5,63752,31818,31934
50,12,31,Florida,Duval County,6,6,60002,29190,30812
50,12,31,Florida,Duval County,6,7,61239,30436,30803
50,12,31,Florida,Duval County,6,8,60736,29967,30769
50,12,31,Florida,Duval County,6,9,66242,32506,33736
50,12,31,Florida,Duval County,6,10,62579,30185,32394
50,12,31,Florida,Duval County,6,11,53836,25672,28164
50,12,31,Florida,Duval County,6,12,45070,21467,23603
50,12,31,Florida,Duval County,6,13,31767,14633,17134
50,12,31,Florida,Duval County,6,14,23821,10965,12856
50,12,31,Florida,Duval County,6,15,19759,8488,11271
50,12,31,Florida,Duval County,6,16,17282,6771,10511
50,12,31,Florida,Duval County,6,17,13149,4761,8388
50,12,31,Florida,Duval County,6,18,10147,2837,7310
50,12,31,Florida,Duval County,6,99,820070,397155,422915
50,12,31,Florida,Duval County,7,0,12027,6175,5852
50,12,31,Florida,Duval County,7,1,47282,23937,23345
50,12,31,Florida,Duval County,7,2,54613,27635,26978
50,12,31,Florida,Duval County,7,3,58223,29655,28568
50,12,31,Florida,Duval County,7,4,58596,29905,28691
50,12,31,Florida,Duval County,7,5,64606,32583,32023
50,12,31,Florida,Duval County,7,6,62406,30214,32192
50,12,31,Florida,Duval County,7,7,59667,29627,30040
50,12,31,Florida,Duval County,7,8,60180,29600,30580
50,12,31,Florida,Duval County,7,9,65720,32253,33467
50,12,31,Florida,Duval County,7,10,63768,30852,32916
50,12,31,Florida,Duval County,7,11,55567,26502,29065
50,12,31,Florida,Duval County,7,12,47739,22717,25022
50,12,31,Florida,Duval County,7,13,33015,15252,17763
50,12,31,Florida,Duval County,7,14,24722,11235,13487
50,12,31,Florida,Duval County,7,15,19843,8585,11258
50,12,31,Florida,Duval County,7,16,17174,6815,10359
50,12,31,Florida,Duval County,7,17,13224,4766,8458
50,12,31,Florida,Duval County,7,18,10616,3045,7571
50,12,31,Florida,Duval County,7,99,828988,401353,427635
50,12,31,Florida,Duval County,8,0,12390,6363,6027
50,12,31,Florida,Duval County,8,1,47216,24149,23067
50,12,31,Florida,Duval County,8,2,55307,27904,27403
50,12,31,Florida,Duval County,8,3,57230,29043,28187
50,12,31,Florida,Duval County,8,4,59846,30479,29367
50,12,31,Florida,Duval County,8,5,65367,33295,32072
50,12,31,Florida,Duval County,8,6,66000,31935,34065
50,12,31,Florida,Duval County,8,7,58016,28855,29161
50,12,31,Florida,Duval County,8,8,60821,29925,30896
50,12,31,Florida,Duval County,8,9,64546,31641,32905
50,12,31,Florida,Duval County,8,10,65176,31730,33446
50,12,31,Florida,Duval County,8,11,57154,27140,30014
50,12,31,Florida,Duval County,8,12,50742,23992,26750
50,12,31,Florida,Duval County,8,13,34503,15942,18561
50,12,31,Florida,Duval County,8,14,25822,11792,14030
50,12,31,Florida,Duval County,8,15,20217,8785,11432
50,12,31,Florida,Duval County,8,16,17128,6885,10243
50,12,31,Florida,Duval County,8,17,13499,4902,8597
50,12,31,Florida,Duval County,8,18,11118,3253,7865
50,12,31,Florida,Duval County,8,99,842098,408010,434088
50,12,31,Florida,Duval County,9,0,12383,6360,6023
50,12,31,Florida,Duval County,9,1,47691,24441,23250
50,12,31,Florida,Duval County,9,2,55327,27926,27401
50,12,31,Florida,Duval County,9,3,56451,28494,27957
50,12,31,Florida,Duval County,9,4,60084,30574,29510
50,12,31,Florida,Duval County,9,5,66280,33825,32455
50,12,31,Florida,Duval County,9,6,68292,33065,35227
50,12,31,Florida,Duval County,9,7,57195,28463,28732
50,12,31,Florida,Duval County,9,8,61152,30039,31113
50,12,31,Florida,Duval County,9,9,62829,30767,32062
50,12,31,Florida,Duval County,9,10,65405,31793,33612
50,12,31,Florida,Duval County,9,11,59429,28383,31046
50,12,31,Florida,Duval County,9,12,51165,24048,27117
50,12,31,Florida,Duval County,9,13,37934,17703,20231
50,12,31,Florida,Duval County,9,14,26809,12209,14600
50,12,31,Florida,Duval County,9,15,20464,8862,11602
50,12,31,Florida,Duval County,9,16,16928,7024,9904
50,12,31,Florida,Duval County,9,17,13563,4993,8570
50,12,31,Florida,Duval County,9,18,11652,3470,8182
50,12,31,Florida,Duval County,9,99,851033,412439,438594
50,12,31,Florida,Duval County,10,0,12087,6162,5925
50,12,31,Florida,Duval County,10,1,47458,24436,23022
50,12,31,Florida,Duval County,10,2,55310,28088,27222
50,12,31,Florida,Duval County,10,3,55542,27988,27554
50,12,31,Florida,Duval County,10,4,60113,30602,29511
50,12,31,Florida,Duval County,10,5,66117,33617,32500
50,12,31,Florida,Duval County,10,6,68991,33646,35345
50,12,31,Florida,Duval County,10,7,57436,28457,28979
50,12,31,Florida,Duval County,10,8,60309,29618,30691
50,12,31,Florida,Duval County,10,9,60861,29815,31046
50,12,31,Florida,Duval County,10,10,65713,31998,33715
50,12,31,Florida,Duval County,10,11,61152,29294,31858
50,12,31,Florida,Duval County,10,12,51848,24336,27512
50,12,31,Florida,Duval County,10,13,40662,19006,21656
50,12,31,Florida,Duval County,10,14,28429,12898,15531
50,12,31,Florida,Duval County,10,15,20900,9204,11696
50,12,31,Florida,Duval County,10,16,16819,6969,9850
50,12,31,Florida,Duval County,10,17,13465,4942,8523
50,12,31,Florida,Duval County,10,18,12225,3680,8545
50,12,31,Florida,Duval County,10,99,855437,414756,440681
50,12,31,Florida,Duval County,11,0,11920,5997,5923
50,12,31,Florida,Duval County,11,1,47673,24518,23155
50,12,31,Florida,Duval County,11,2,55178,27956,27222
50,12,31,Florida,Duval County,11,3,55086,27946,27140
50,12,31,Florida,Duval County,11,4,59273,29984,29289
50,12,31,Florida,Duval County,11,5,65920,33554,32366
50,12,31,Florida,Duval County,11,6,69107,33979,35128
50,12,31,Florida,Duval County,11,7,58671,28866,29805
50,12,31,Florida,Duval County,11,8,59278,29211,30067
50,12,31,Florida,Duval County,11,9,59129,29192,29937
50,12,31,Florida,Duval County,11,10,65772,31877,33895
50,12,31,Florida,Duval County,11,11,62127,29763,32364
50,12,31,Florida,Duval County,11,12,53209,25129,28080
50,12,31,Florida,Duval County,11,13,43190,20285,22905
50,12,31,Florida,Duval County,11,14,30016,13452,16564
50,12,31,Florida,Duval County,11,15,21669,9655,12014
50,12,31,Florida,Duval County,11,16,16745,6942,9803
50,12,31,Florida,Duval County,11,17,13316,4995,8321
50,12,31,Florida,Duval County,11,18,12516,3809,8707
50,12,31,Florida,Duval County,11,99,859795,417110,442685
50,12,31,Florida,Duval County,12,0,11851,5971,5880
50,12,31,Florida,Duval County,12,1,47650,24415,23235
50,12,31,Florida,Duval County,12,2,55355,28186,27169
50,12,31,Florida,Duval County,12,3,55072,27808,27264
50,12,31,Florida,Duval County,12,4,58187,29480,28707
50,12,31,Florida,Duval County,12,5,66043,33486,32557
50,12,31,Florida,Duval County,12,6,68856,34142,34714
50,12,31,Florida,Duval County,12,7,59999,29539,30460
50,12,31,Florida,Duval County,12,8,58323,28788,29535
50,12,31,Florida,Duval County,12,9,58625,28868,29757
50,12,31,Florida,Duval County,12,10,65294,31740,33554
50,12,31,Florida,Duval County,12,11,63074,30290,32784
50,12,31,Florida,Duval County,12,12,54525,25696,28829
50,12,31,Florida,Duval County,12,13,45240,21271,23969
50,12,31,Florida,Duval County,12,14,31081,14018,17063
50,12,31,Florida,Duval County,12,15,22182,9807,12375
50,12,31,Florida,Duval County,12,16,16877,7043,9834
50,12,31,Florida,Duval County,12,17,13259,4982,8277
50,12,31,Florida,Duval County,12,18,12770,3895,8875
50,12,31,Florida,Duval County,12,99,864263,419425,444838
50,12,31,Florida,Duval County,13,0,11880,5989,5891
50,12,31,Florida,Duval County,13,1,47659,24411,23248
50,12,31,Florida,Duval County,13,2,55409,28214,27195
50,12,31,Florida,Duval County,13,3,55053,27795,27258
50,12,31,Florida,Duval County,13,4,57922,29349,28573
50,12,31,Florida,Duval County,13,5,66298,33621,32677
50,12,31,Florida,Duval County,13,6,69038,34286,34752
50,12,31,Florida,Duval County,13,7,60444,29773,30671
50,12,31,Florida,Duval County,13,8,58016,28642,29374
50,12,31,Florida,Duval County,13,9,58608,28852,29756
50,12,31,Florida,Duval County,13,10,65101,31646,33455
50,12,31,Florida,Duval County,13,11,63272,30386,32886
50,12,31,Florida,Duval County,13,12,54845,25847,28998
50,12,31,Florida,Duval County,13,13,45723,21494,24229
50,12,31,Florida,Duval County,13,14,31283,14108,17175
50,12,31,Florida,Duval County,13,15,22306,9868,12438
50,12,31,Florida,Duval County,13,16,16870,7042,9828
50,12,31,Florida,Duval County,13,17,13283,5003,8280
50,12,31,Florida,Duval County,13,18,12866,3935,8931
50,12,31,Florida,Duval County,13,99,865876,420261,445615
50,12,33,Florida,Escambia County,1,0,3580,1844,1736
50,12,33,Florida,Escambia County,1,1,14334,7304,7030
50,12,33,Florida,Escambia County,1,2,19514,9980,9534
50,12,33,Florida,Escambia County,1,3,20020,10128,9892
50,12,33,Florida,Escambia County,1,4,24197,13131,11066
50,12,33,Florida,Escambia County,1,5,23461,12713,10748
50,12,33,Florida,Escambia County,1,6,20432,11076,9356
50,12,33,Florida,Escambia County,1,7,19813,10404,9409
50,12,33,Florida,Escambia County,1,8,22575,11448,11127
50,12,33,Florida,Escambia County,1,9,22411,11171,11240
50,12,33,Florida,Escambia County,1,10,19791,9589,10202
50,12,33,Florida,Escambia County,1,11,18104,8665,9439
50,12,33,Florida,Escambia County,1,12,14553,6811,7742
50,12,33,Florida,Escambia County,1,13,12459,5862,6597
50,12,33,Florida,Escambia County,1,14,11185,5084,6101
50,12,33,Florida,Escambia County,1,15,10173,4372,5801
50,12,33,Florida,Escambia County,1,16,8307,3441,4866
50,12,33,Florida,Escambia County,1,17,5343,1992,3351
50,12,33,Florida,Escambia County,1,18,4163,1172,2991
50,12,33,Florida,Escambia County,1,99,294415,146187,148228
50,12,33,Florida,Escambia County,2,0,3606,1860,1746
50,12,33,Florida,Escambia County,2,1,14245,7252,6993
50,12,33,Florida,Escambia County,2,2,19392,9918,9474
50,12,33,Florida,Escambia County,2,3,20111,10173,9938
50,12,33,Florida,Escambia County,2,4,24227,13146,11081
50,12,33,Florida,Escambia County,2,5,23609,12768,10841
50,12,33,Florida,Escambia County,2,6,20240,10969,9271
50,12,33,Florida,Escambia County,2,7,19770,10378,9392
50,12,33,Florida,Escambia County,2,8,22461,11389,11072
50,12,33,Florida,Escambia County,2,9,22474,11194,11280
50,12,33,Florida,Escambia County,2,10,19926,9666,10260
50,12,33,Florida,Escambia County,2,11,18319,8770,9549
50,12,33,Florida,Escambia County,2,12,14632,6859,7773
50,12,33,Florida,Escambia County,2,13,12500,5882,6618
50,12,33,Florida,Escambia County,2,14,11177,5078,6099
50,12,33,Florida,Escambia County,2,15,10155,4366,5789
50,12,33,Florida,Escambia County,2,16,8324,3452,4872
50,12,33,Florida,Escambia County,2,17,5378,2008,3370
50,12,33,Florida,Escambia County,2,18,4179,1178,3001
50,12,33,Florida,Escambia County,2,99,294725,146306,148419
50,12,33,Florida,Escambia County,3,0,3793,1932,1861
50,12,33,Florida,Escambia County,3,1,14087,7236,6851
50,12,33,Florida,Escambia County,3,2,18687,9582,9105
50,12,33,Florida,Escambia County,3,3,20092,10159,9933
50,12,33,Florida,Escambia County,3,4,25257,14080,11177
50,12,33,Florida,Escambia County,3,5,24903,13414,11489
50,12,33,Florida,Escambia County,3,6,19575,10646,8929
50,12,33,Florida,Escambia County,3,7,19756,10484,9272
50,12,33,Florida,Escambia County,3,8,21827,11140,10687
50,12,33,Florida,Escambia County,3,9,22631,11314,11317
50,12,33,Florida,Escambia County,3,10,20482,9973,10509
50,12,33,Florida,Escambia County,3,11,19257,9223,10034
50,12,33,Florida,Escambia County,3,12,14965,7064,7901
50,12,33,Florida,Escambia County,3,13,12774,6039,6735
50,12,33,Florida,Escambia County,3,14,11237,5120,6117
50,12,33,Florida,Escambia County,3,15,10072,4368,5704
50,12,33,Florida,Escambia County,3,16,8446,3451,4995
50,12,33,Florida,Escambia County,3,17,5629,2164,3465
50,12,33,Florida,Escambia County,3,18,4306,1225,3081
50,12,33,Florida,Escambia County,3,99,297776,148614,149162
50,12,33,Florida,Escambia County,4,0,3747,1901,1846
50,12,33,Florida,Escambia County,4,1,14097,7223,6874
50,12,33,Florida,Escambia County,4,2,18022,9255,8767
50,12,33,Florida,Escambia County,4,3,20073,10186,9887
50,12,33,Florida,Escambia County,4,4,25328,14293,11035
50,12,33,Florida,Escambia County,4,5,25631,13812,11819
50,12,33,Florida,Escambia County,4,6,18921,10202,8719
50,12,33,Florida,Escambia County,4,7,19480,10226,9254
50,12,33,Florida,Escambia County,4,8,20521,10437,10084
50,12,33,Florida,Escambia County,4,9,22434,11087,11347
50,12,33,Florida,Escambia County,4,10,20761,10171,10590
50,12,33,Florida,Escambia County,4,11,19145,9141,10004
50,12,33,Florida,Escambia County,4,12,16320,7751,8569
50,12,33,Florida,Escambia County,4,13,13141,6189,6952
50,12,33,Florida,Escambia County,4,14,11267,5173,6094
50,12,33,Florida,Escambia County,4,15,10177,4508,5669
50,12,33,Florida,Escambia County,4,16,8394,3389,5005
50,12,33,Florida,Escambia County,4,17,5795,2283,3512
50,12,33,Florida,Escambia County,4,18,4314,1288,3026
50,12,33,Florida,Escambia County,4,99,297568,148515,149053
50,12,33,Florida,Escambia County,5,0,3763,1962,1801
50,12,33,Florida,Escambia County,5,1,14221,7252,6969
50,12,33,Florida,Escambia County,5,2,17489,8971,8518
50,12,33,Florida,Escambia County,5,3,19981,10149,9832
50,12,33,Florida,Escambia County,5,4,24773,13856,10917
50,12,33,Florida,Escambia County,5,5,25362,13493,11869
50,12,33,Florida,Escambia County,5,6,18783,9997,8786
50,12,33,Florida,Escambia County,5,7,19002,9927,9075
50,12,33,Florida,Escambia County,5,8,19206,9703,9503
50,12,33,Florida,Escambia County,5,9,22146,10870,11276
50,12,33,Florida,Escambia County,5,10,21429,10455,10974
50,12,33,Florida,Escambia County,5,11,19323,9331,9992
50,12,33,Florida,Escambia County,5,12,16961,8071,8890
50,12,33,Florida,Escambia County,5,13,13781,6453,7328
50,12,33,Florida,Escambia County,5,14,11464,5363,6101
50,12,33,Florida,Escambia County,5,15,10212,4514,5698
50,12,33,Florida,Escambia County,5,16,8426,3401,5025
50,12,33,Florida,Escambia County,5,17,5899,2307,3592
50,12,33,Florida,Escambia County,5,18,4382,1348,3034
50,12,33,Florida,Escambia County,5,99,296603,147423,149180
50,12,33,Florida,Escambia County,6,0,3808,1912,1896
50,12,33,Florida,Escambia County,6,1,14470,7490,6980
50,12,33,Florida,Escambia County,6,2,17205,8717,8488
50,12,33,Florida,Escambia County,6,3,19867,10157,9710
50,12,33,Florida,Escambia County,6,4,24529,13546,10983
50,12,33,Florida,Escambia County,6,5,25962,13843,12119
50,12,33,Florida,Escambia County,6,6,19025,10002,9023
50,12,33,Florida,Escambia County,6,7,18625,9718,8907
50,12,33,Florida,Escambia County,6,8,18659,9375,9284
50,12,33,Florida,Escambia County,6,9,21949,10689,11260
50,12,33,Florida,Escambia County,6,10,21858,10736,11122
50,12,33,Florida,Escambia County,6,11,19763,9466,10297
50,12,33,Florida,Escambia County,6,12,17559,8384,9175
50,12,33,Florida,Escambia County,6,13,14232,6631,7601
50,12,33,Florida,Escambia County,6,14,11926,5647,6279
50,12,33,Florida,Escambia County,6,15,9964,4403,5561
50,12,33,Florida,Escambia County,6,16,8364,3394,4970
50,12,33,Florida,Escambia County,6,17,5966,2310,3656
50,12,33,Florida,Escambia County,6,18,4494,1439,3055
50,12,33,Florida,Escambia County,6,99,298225,147859,150366
50,12,33,Florida,Escambia County,7,0,3749,1943,1806
50,12,33,Florida,Escambia County,7,1,14451,7359,7092
50,12,33,Florida,Escambia County,7,2,16879,8605,8274
50,12,33,Florida,Escambia County,7,3,19198,9844,9354
50,12,33,Florida,Escambia County,7,4,24531,13412,11119
50,12,33,Florida,Escambia County,7,5,26157,14060,12097
50,12,33,Florida,Escambia County,7,6,19338,10014,9324
50,12,33,Florida,Escambia County,7,7,17918,9278,8640
50,12,33,Florida,Escambia County,7,8,18178,9201,8977
50,12,33,Florida,Escambia County,7,9,21204,10298,10906
50,12,33,Florida,Escambia County,7,10,22284,11022,11262
50,12,33,Florida,Escambia County,7,11,20181,9666,10515
50,12,33,Florida,Escambia County,7,12,18517,8855,9662
50,12,33,Florida,Escambia County,7,13,14592,6816,7776
50,12,33,Florida,Escambia County,7,14,12046,5688,6358
50,12,33,Florida,Escambia County,7,15,9997,4404,5593
50,12,33,Florida,Escambia County,7,16,8409,3458,4951
50,12,33,Florida,Escambia County,7,17,6047,2369,3678
50,12,33,Florida,Escambia County,7,18,4663,1480,3183
50,12,33,Florida,Escambia County,7,99,298339,147772,150567
50,12,33,Florida,Escambia County,8,0,3998,1992,2006
50,12,33,Florida,Escambia County,8,1,14352,7342,7010
50,12,33,Florida,Escambia County,8,2,17006,8662,8344
50,12,33,Florida,Escambia County,8,3,18722,9615,9107
50,12,33,Florida,Escambia County,8,4,25058,13665,11393
50,12,33,Florida,Escambia County,8,5,27173,14842,12331
50,12,33,Florida,Escambia County,8,6,20245,10488,9757
50,12,33,Florida,Escambia County,8,7,17327,9108,8219
50,12,33,Florida,Escambia County,8,8,18073,9176,8897
50,12,33,Florida,Escambia County,8,9,20667,10161,10506
50,12,33,Florida,Escambia County,8,10,22415,11142,11273
50,12,33,Florida,Escambia County,8,11,20560,9914,10646
50,12,33,Florida,Escambia County,8,12,19347,9243,10104
50,12,33,Florida,Escambia County,8,13,14631,6852,7779
50,12,33,Florida,Escambia County,8,14,11931,5584,6347
50,12,33,Florida,Escambia County,8,15,9832,4331,5501
50,12,33,Florida,Escambia County,8,16,8229,3470,4759
50,12,33,Florida,Escambia County,8,17,6043,2333,3710
50,12,33,Florida,Escambia County,8,18,4786,1562,3224
50,12,33,Florida,Escambia County,8,99,300395,149482,150913
50,12,33,Florida,Escambia County,9,0,3973,2011,1962
50,12,33,Florida,Escambia County,9,1,14541,7460,7081
50,12,33,Florida,Escambia County,9,2,16947,8654,8293
50,12,33,Florida,Escambia County,9,3,18110,9291,8819
50,12,33,Florida,Escambia County,9,4,24166,13011,11155
50,12,33,Florida,Escambia County,9,5,26237,14059,12178
50,12,33,Florida,Escambia County,9,6,20444,10415,10029
50,12,33,Florida,Escambia County,9,7,16801,8796,8005
50,12,33,Florida,Escambia County,9,8,17831,8953,8878
50,12,33,Florida,Escambia County,9,9,19387,9541,9846
50,12,33,Florida,Escambia County,9,10,22356,11107,11249
50,12,33,Florida,Escambia County,9,11,20848,10056,10792
50,12,33,Florida,Escambia County,9,12,19023,9082,9941
50,12,33,Florida,Escambia County,9,13,15650,7358,8292
50,12,33,Florida,Escambia County,9,14,12134,5637,6497
50,12,33,Florida,Escambia County,9,15,9735,4329,5406
50,12,33,Florida,Escambia County,9,16,8277,3567,4710
50,12,33,Florida,Escambia County,9,17,6001,2297,3704
50,12,33,Florida,Escambia County,9,18,4932,1629,3303
50,12,33,Florida,Escambia County,9,99,297393,147253,150140
50,12,33,Florida,Escambia County,10,0,3864,1954,1910
50,12,33,Florida,Escambia County,10,1,14737,7440,7297
50,12,33,Florida,Escambia County,10,2,16960,8701,8259
50,12,33,Florida,Escambia County,10,3,17509,8904,8605
50,12,33,Florida,Escambia County,10,4,23976,12859,11117
50,12,33,Florida,Escambia County,10,5,26292,13932,12360
50,12,33,Florida,Escambia County,10,6,20563,10535,10028
50,12,33,Florida,Escambia County,10,7,16652,8643,8009
50,12,33,Florida,Escambia County,10,8,17445,8844,8601
50,12,33,Florida,Escambia County,10,9,18425,9137,9288
50,12,33,Florida,Escambia County,10,10,21964,10895,11069
50,12,33,Florida,Escambia County,10,11,21415,10357,11058
50,12,33,Florida,Escambia County,10,12,18963,9088,9875
50,12,33,Florida,Escambia County,10,13,16200,7645,8555
50,12,33,Florida,Escambia County,10,14,12619,5779,6840
50,12,33,Florida,Escambia County,10,15,9904,4479,5425
50,12,33,Florida,Escambia County,10,16,8247,3569,4678
50,12,33,Florida,Escambia County,10,17,6004,2270,3734
50,12,33,Florida,Escambia County,10,18,5115,1741,3374
50,12,33,Florida,Escambia County,10,99,296854,146772,150082
50,12,33,Florida,Escambia County,11,0,3798,1918,1880
50,12,33,Florida,Escambia County,11,1,14924,7537,7387
50,12,33,Florida,Escambia County,11,2,17055,8711,8344
50,12,33,Florida,Escambia County,11,3,17122,8672,8450
50,12,33,Florida,Escambia County,11,4,23817,12815,11002
50,12,33,Florida,Escambia County,11,5,26268,13897,12371
50,12,33,Florida,Escambia County,11,6,20785,10700,10085
50,12,33,Florida,Escambia County,11,7,16775,8569,8206
50,12,33,Florida,Escambia County,11,8,17078,8704,8374
50,12,33,Florida,Escambia County,11,9,17796,8835,8961
50,12,33,Florida,Escambia County,11,10,21590,10742,10848
50,12,33,Florida,Escambia County,11,11,21667,10558,11109
50,12,33,Florida,Escambia County,11,12,19196,9153,10043
50,12,33,Florida,Escambia County,11,13,16673,7847,8826
50,12,33,Florida,Escambia County,11,14,13013,5978,7035
50,12,33,Florida,Escambia County,11,15,10186,4680,5506
50,12,33,Florida,Escambia County,11,16,8067,3463,4604
50,12,33,Florida,Escambia County,11,17,5962,2305,3657
50,12,33,Florida,Escambia County,11,18,5243,1771,3472
50,12,33,Florida,Escambia County,11,99,297015,146855,150160
50,12,33,Florida,Escambia County,12,0,3782,1913,1869
50,12,33,Florida,Escambia County,12,1,15005,7563,7442
50,12,33,Florida,Escambia County,12,2,17210,8793,8417
50,12,33,Florida,Escambia County,12,3,17092,8664,8428
50,12,33,Florida,Escambia County,12,4,23216,12492,10724
50,12,33,Florida,Escambia County,12,5,26402,13838,12564
50,12,33,Florida,Escambia County,12,6,20975,10896,10079
50,12,33,Florida,Escambia County,12,7,17141,8736,8405
50,12,33,Florida,Escambia County,12,8,16632,8443,8189
50,12,33,Florida,Escambia County,12,9,17380,8650,8730
50,12,33,Florida,Escambia County,12,10,21194,10554,10640
50,12,33,Florida,Escambia County,12,11,22000,10779,11221
50,12,33,Florida,Escambia County,12,12,19379,9224,10155
50,12,33,Florida,Escambia County,12,13,17282,8136,9146
50,12,33,Florida,Escambia County,12,14,13276,6099,7177
50,12,33,Florida,Escambia County,12,15,10208,4673,5535
50,12,33,Florida,Escambia County,12,16,8097,3483,4614
50,12,33,Florida,Escambia County,12,17,6019,2377,3642
50,12,33,Florida,Escambia County,12,18,5329,1806,3523
50,12,33,Florida,Escambia County,12,99,297619,147119,150500
50,12,33,Florida,Escambia County,13,0,3788,1918,1870
50,12,33,Florida,Escambia County,13,1,14986,7550,7436
50,12,33,Florida,Escambia County,13,2,17210,8793,8417
50,12,33,Florida,Escambia County,13,3,17072,8651,8421
50,12,33,Florida,Escambia County,13,4,23114,12435,10679
50,12,33,Florida,Escambia County,13,5,26474,13878,12596
50,12,33,Florida,Escambia County,13,6,21028,10935,10093
50,12,33,Florida,Escambia County,13,7,17273,8807,8466
50,12,33,Florida,Escambia County,13,8,16525,8391,8134
50,12,33,Florida,Escambia County,13,9,17365,8635,8730
50,12,33,Florida,Escambia County,13,10,21119,10518,10601
50,12,33,Florida,Escambia County,13,11,22053,10809,11244
50,12,33,Florida,Escambia County,13,12,19478,9270,10208
50,12,33,Florida,Escambia County,13,13,17453,8214,9239
50,12,33,Florida,Escambia County,13,14,13359,6134,7225
50,12,33,Florida,Escambia County,13,15,10264,4700,5564
50,12,33,Florida,Escambia County,13,16,8090,3481,4609
50,12,33,Florida,Escambia County,13,17,6027,2388,3639
50,12,33,Florida,Escambia County,13,18,5365,1823,3542
50,12,33,Florida,Escambia County,13,99,298043,147330,150713
50,12,35,Florida,Flagler County,1,0,371,180,191
50,12,35,Florida,Flagler County,1,1,1688,868,820
50,12,35,Florida,Flagler County,1,2,2381,1197,1184
50,12,35,Florida,Flagler County,1,3,2815,1448,1367
50,12,35,Florida,Flagler County,1,4,2504,1290,1214
50,12,35,Florida,Flagler County,1,5,1559,797,762
50,12,35,Florida,Flagler County,1,6,1762,858,904
50,12,35,Florida,Flagler County,1,7,2253,1088,1165
50,12,35,Florida,Flagler County,1,8,2886,1358,1528
50,12,35,Florida,Flagler County,1,9,3231,1502,1729
50,12,35,Florida,Flagler County,1,10,3234,1521,1713
50,12,35,Florida,Flagler County,1,11,3365,1529,1836
50,12,35,Florida,Flagler County,1,12,3506,1582,1924
50,12,35,Florida,Flagler County,1,13,3999,1827,2172
50,12,35,Florida,Flagler County,1,14,4354,2125,2229
50,12,35,Florida,Flagler County,1,15,4148,1998,2150
50,12,35,Florida,Flagler County,1,16,3246,1622,1624
50,12,35,Florida,Flagler County,1,17,1553,743,810
50,12,35,Florida,Flagler County,1,18,963,346,617
50,12,35,Florida,Flagler County,1,99,49818,23879,25939
50,12,35,Florida,Flagler County,2,0,381,186,195
50,12,35,Florida,Flagler County,2,1,1706,875,831
50,12,35,Florida,Flagler County,2,2,2404,1207,1197
50,12,35,Florida,Flagler County,2,3,2863,1470,1393
50,12,35,Florida,Flagler County,2,4,2553,1317,1236
50,12,35,Florida,Flagler County,2,5,1602,819,783
50,12,35,Florida,Flagler County,2,6,1769,860,909
50,12,35,Florida,Flagler County,2,7,2278,1102,1176
50,12,35,Florida,Flagler County,2,8,2912,1370,1542
50,12,35,Florida,Flagler County,2,9,3278,1524,1754
50,12,35,Florida,Flagler County,2,10,3293,1550,1743
50,12,35,Florida,Flagler County,2,11,3449,1568,1881
50,12,35,Florida,Flagler County,2,12,3582,1618,1964
50,12,35,Florida,Flagler County,2,13,4069,1859,2210
50,12,35,Florida,Flagler County,2,14,4384,2142,2242
50,12,35,Florida,Flagler County,2,15,4187,2023,2164
50,12,35,Florida,Flagler County,2,16,3285,1644,1641
50,12,35,Florida,Flagler County,2,17,1581,757,824
50,12,35,Florida,Flagler County,2,18,1003,357,646
50,12,35,Florida,Flagler County,2,99,50579,24248,26331
50,12,35,Florida,Flagler County,3,0,414,212,202
50,12,35,Florida,Flagler County,3,1,1807,935,872
50,12,35,Florida,Flagler County,3,2,2591,1302,1289
50,12,35,Florida,Flagler County,3,3,3062,1584,1478
50,12,35,Florida,Flagler County,3,4,2784,1428,1356
50,12,35,Florida,Flagler County,3,5,1840,962,878
50,12,35,Florida,Flagler County,3,6,1928,935,993
50,12,35,Florida,Flagler County,3,7,2436,1154,1282
50,12,35,Florida,Flagler County,3,8,3058,1439,1619
50,12,35,Florida,Flagler County,3,9,3510,1655,1855
50,12,35,Florida,Flagler County,3,10,3538,1643,1895
50,12,35,Florida,Flagler County,3,11,3770,1732,2038
50,12,35,Florida,Flagler County,3,12,3805,1755,2050
50,12,35,Florida,Flagler County,3,13,4285,1967,2318
50,12,35,Florida,Flagler County,3,14,4594,2239,2355
50,12,35,Florida,Flagler County,3,15,4283,2094,2189
50,12,35,Florida,Flagler County,3,16,3288,1602,1686
50,12,35,Florida,Flagler County,3,17,1820,890,930
50,12,35,Florida,Flagler County,3,18,1131,419,712
50,12,35,Florida,Flagler County,3,99,53944,25947,27997
50,12,35,Florida,Flagler County,4,0,493,248,245
50,12,35,Florida,Flagler County,4,1,1963,997,966
50,12,35,Florida,Flagler County,4,2,2731,1366,1365
50,12,35,Florida,Flagler County,4,3,3244,1677,1567
50,12,35,Florida,Flagler County,4,4,3056,1544,1512
50,12,35,Florida,Flagler County,4,5,2048,1074,974
50,12,35,Florida,Flagler County,4,6,2073,969,1104
50,12,35,Florida,Flagler County,4,7,2616,1262,1354
50,12,35,Florida,Flagler County,4,8,3221,1550,1671
50,12,35,Florida,Flagler County,4,9,3697,1745,1952
50,12,35,Florida,Flagler County,4,10,3831,1762,2069
50,12,35,Florida,Flagler County,4,11,3936,1778,2158
50,12,35,Florida,Flagler County,4,12,4431,2063,2368
50,12,35,Florida,Flagler County,4,13,4696,2196,2500
50,12,35,Florida,Flagler County,4,14,4733,2333,2400
50,12,35,Florida,Flagler County,4,15,4459,2194,2265
50,12,35,Florida,Flagler County,4,16,3458,1675,1783
50,12,35,Florida,Flagler County,4,17,1983,1008,975
50,12,35,Florida,Flagler County,4,18,1236,449,787
50,12,35,Florida,Flagler County,4,99,57905,27890,30015
50,12,35,Florida,Flagler County,5,0,590,293,297
50,12,35,Florida,Flagler County,5,1,2145,1091,1054
50,12,35,Florida,Flagler County,5,2,3034,1518,1516
50,12,35,Florida,Flagler County,5,3,3515,1831,1684
50,12,35,Florida,Flagler County,5,4,3280,1700,1580
50,12,35,Florida,Flagler County,5,5,2335,1195,1140
50,12,35,Florida,Flagler County,5,6,2326,1130,1196
50,12,35,Florida,Flagler County,5,7,2869,1392,1477
50,12,35,Florida,Flagler County,5,8,3450,1649,1801
50,12,35,Florida,Flagler County,5,9,3960,1893,2067
50,12,35,Florida,Flagler County,5,10,4223,1964,2259
50,12,35,Florida,Flagler County,5,11,4264,1910,2354
50,12,35,Florida,Flagler County,5,12,4869,2242,2627
50,12,35,Florida,Flagler County,5,13,5230,2461,2769
50,12,35,Florida,Flagler County,5,14,5094,2508,2586
50,12,35,Florida,Flagler County,5,15,4665,2357,2308
50,12,35,Florida,Flagler County,5,16,3691,1749,1942
50,12,35,Florida,Flagler County,5,17,2088,1071,1017
50,12,35,Florida,Flagler County,5,18,1319,465,854
50,12,35,Florida,Flagler County,5,99,62947,30419,32528
50,12,35,Florida,Flagler County,6,0,592,300,292
50,12,35,Florida,Flagler County,6,1,2520,1255,1265
50,12,35,Florida,Flagler County,6,2,3353,1700,1653
50,12,35,Florida,Flagler County,6,3,3949,2035,1914
50,12,35,Florida,Flagler County,6,4,3635,1918,1717
50,12,35,Florida,Flagler County,6,5,2686,1353,1333
50,12,35,Florida,Flagler County,6,6,2599,1262,1337
50,12,35,Florida,Flagler County,6,7,3256,1584,1672
50,12,35,Florida,Flagler County,6,8,3779,1825,1954
50,12,35,Florida,Flagler County,6,9,4442,2091,2351
50,12,35,Florida,Flagler County,6,10,4686,2177,2509
50,12,35,Florida,Flagler County,6,11,4778,2171,2607
50,12,35,Florida,Flagler County,6,12,5557,2519,3038
50,12,35,Florida,Flagler County,6,13,5684,2690,2994
50,12,35,Florida,Flagler County,6,14,5536,2712,2824
50,12,35,Florida,Flagler County,6,15,4801,2452,2349
50,12,35,Florida,Flagler County,6,16,3807,1796,2011
50,12,35,Florida,Flagler County,6,17,2327,1142,1185
50,12,35,Florida,Flagler County,6,18,1400,531,869
50,12,35,Florida,Flagler County,6,99,69387,33513,35874
50,12,35,Florida,Flagler County,7,0,756,400,356
50,12,35,Florida,Flagler County,7,1,2885,1409,1476
50,12,35,Florida,Flagler County,7,2,3883,1999,1884
50,12,35,Florida,Flagler County,7,3,4424,2229,2195
50,12,35,Florida,Flagler County,7,4,4124,2170,1954
50,12,35,Florida,Flagler County,7,5,3105,1553,1552
50,12,35,Florida,Flagler County,7,6,3098,1498,1600
50,12,35,Florida,Flagler County,7,7,3732,1827,1905
50,12,35,Florida,Flagler County,7,8,4291,2067,2224
50,12,35,Florida,Flagler County,7,9,4910,2339,2571
50,12,35,Florida,Flagler County,7,10,5192,2401,2791
50,12,35,Florida,Flagler County,7,11,5231,2390,2841
50,12,35,Florida,Flagler County,7,12,6280,2832,3448
50,12,35,Florida,Flagler County,7,13,6175,2935,3240
50,12,35,Florida,Flagler County,7,14,5919,2902,3017
50,12,35,Florida,Flagler County,7,15,4991,2523,2468
50,12,35,Florida,Flagler County,7,16,3924,1860,2064
50,12,35,Florida,Flagler County,7,17,2563,1253,1310
50,12,35,Florida,Flagler County,7,18,1525,585,940
50,12,35,Florida,Flagler County,7,99,77008,37172,39836
50,12,35,Florida,Flagler County,8,0,885,482,403
50,12,35,Florida,Flagler County,8,1,3239,1623,1616
50,12,35,Florida,Flagler County,8,2,4403,2256,2147
50,12,35,Florida,Flagler County,8,3,4923,2479,2444
50,12,35,Florida,Flagler County,8,4,4677,2506,2171
50,12,35,Florida,Flagler County,8,5,3444,1716,1728
50,12,35,Florida,Flagler County,8,6,3745,1827,1918
50,12,35,Florida,Flagler County,8,7,4083,2005,2078
50,12,35,Florida,Flagler County,8,8,4835,2357,2478
50,12,35,Florida,Flagler County,8,9,5418,2593,2825
50,12,35,Florida,Flagler County,8,10,5696,2668,3028
50,12,35,Florida,Flagler County,8,11,5784,2628,3156
50,12,35,Florida,Flagler County,8,12,6750,3007,3743
50,12,35,Florida,Flagler County,8,13,6555,3177,3378
50,12,35,Florida,Flagler County,8,14,6261,3088,3173
50,12,35,Florida,Flagler County,8,15,5263,2635,2628
50,12,35,Florida,Flagler County,8,16,4058,1942,2116
50,12,35,Florida,Flagler County,8,17,2589,1216,1373
50,12,35,Florida,Flagler County,8,18,1731,675,1056
50,12,35,Florida,Flagler County,8,99,84339,40880,43459
50,12,35,Florida,Flagler County,9,0,1113,560,553
50,12,35,Florida,Flagler County,9,1,3544,1802,1742
50,12,35,Florida,Flagler County,9,2,4867,2524,2343
50,12,35,Florida,Flagler County,9,3,5326,2692,2634
50,12,35,Florida,Flagler County,9,4,5115,2707,2408
50,12,35,Florida,Flagler County,9,5,3843,1924,1919
50,12,35,Florida,Flagler County,9,6,4244,2036,2208
50,12,35,Florida,Flagler County,9,7,4473,2195,2278
50,12,35,Florida,Flagler County,9,8,5178,2534,2644
50,12,35,Florida,Flagler County,9,9,5743,2756,2987
50,12,35,Florida,Flagler County,9,10,6011,2827,3184
50,12,35,Florida,Flagler County,9,11,6122,2755,3367
50,12,35,Florida,Flagler County,9,12,6812,3037,3775
50,12,35,Florida,Flagler County,9,13,7247,3444,3803
50,12,35,Florida,Flagler County,9,14,6701,3288,3413
50,12,35,Florida,Flagler County,9,15,5327,2688,2639
50,12,35,Florida,Flagler County,9,16,4207,2033,2174
50,12,35,Florida,Flagler County,9,17,2731,1243,1488
50,12,35,Florida,Flagler County,9,18,1912,756,1156
50,12,35,Florida,Flagler County,9,99,90516,43801,46715
50,12,35,Florida,Flagler County,10,0,1113,555,558
50,12,35,Florida,Flagler County,10,1,3812,1886,1926
50,12,35,Florida,Flagler County,10,2,5007,2538,2469
50,12,35,Florida,Flagler County,10,3,5498,2819,2679
50,12,35,Florida,Flagler County,10,4,5443,2853,2590
50,12,35,Florida,Flagler County,10,5,3917,1943,1974
50,12,35,Florida,Flagler County,10,6,4420,2121,2299
50,12,35,Florida,Flagler County,10,7,4653,2288,2365
50,12,35,Florida,Flagler County,10,8,5282,2570,2712
50,12,35,Florida,Flagler County,10,9,5755,2691,3064
50,12,35,Florida,Flagler County,10,10,6145,2889,3256
50,12,35,Florida,Flagler County,10,11,6369,2898,3471
50,12,35,Florida,Flagler County,10,12,6862,3053,3809
50,12,35,Florida,Flagler County,10,13,7463,3473,3990
50,12,35,Florida,Flagler County,10,14,7090,3443,3647
50,12,35,Florida,Flagler County,10,15,5538,2792,2746
50,12,35,Florida,Flagler County,10,16,4224,2053,2171
50,12,35,Florida,Flagler County,10,17,2932,1351,1581
50,12,35,Florida,Flagler County,10,18,2023,789,1234
50,12,35,Florida,Flagler County,10,99,93546,45005,48541
50,12,35,Florida,Flagler County,11,0,921,469,452
50,12,35,Florida,Flagler County,11,1,3923,2006,1917
50,12,35,Florida,Flagler County,11,2,5056,2539,2517
50,12,35,Florida,Flagler County,11,3,5543,2890,2653
50,12,35,Florida,Flagler County,11,4,5563,2905,2658
50,12,35,Florida,Flagler County,11,5,3856,1931,1925
50,12,35,Florida,Flagler County,11,6,4410,2102,2308
50,12,35,Florida,Flagler County,11,7,4612,2242,2370
50,12,35,Florida,Flagler County,11,8,5269,2559,2710
50,12,35,Florida,Flagler County,11,9,5655,2683,2972
50,12,35,Florida,Flagler County,11,10,6177,2875,3302
50,12,35,Florida,Flagler County,11,11,6449,2941,3508
50,12,35,Florida,Flagler County,11,12,6846,3072,3774
50,12,35,Florida,Flagler County,11,13,7699,3556,4143
50,12,35,Florida,Flagler County,11,14,7309,3542,3767
50,12,35,Florida,Flagler County,11,15,5888,2937,2951
50,12,35,Florida,Flagler County,11,16,4267,2093,2174
50,12,35,Florida,Flagler County,11,17,3011,1394,1617
50,12,35,Florida,Flagler County,11,18,2246,876,1370
50,12,35,Florida,Flagler County,11,99,94700,45612,49088
50,12,35,Florida,Flagler County,12,0,865,431,434
50,12,35,Florida,Flagler County,12,1,3901,2003,1898
50,12,35,Florida,Flagler County,12,2,5153,2598,2555
50,12,35,Florida,Flagler County,12,3,5571,2918,2653
50,12,35,Florida,Flagler County,12,4,5572,2868,2704
50,12,35,Florida,Flagler County,12,5,3959,1983,1976
50,12,35,Florida,Flagler County,12,6,4300,2059,2241
50,12,35,Florida,Flagler County,12,7,4711,2297,2414
50,12,35,Florida,Flagler County,12,8,5143,2458,2685
50,12,35,Florida,Flagler County,12,9,5620,2688,2932
50,12,35,Florida,Flagler County,12,10,6142,2864,3278
50,12,35,Florida,Flagler County,12,11,6529,2957,3572
50,12,35,Florida,Flagler County,12,12,6864,3058,3806
50,12,35,Florida,Flagler County,12,13,7961,3651,4310
50,12,35,Florida,Flagler County,12,14,7528,3660,3868
50,12,35,Florida,Flagler County,12,15,6065,3041,3024
50,12,35,Florida,Flagler County,12,16,4327,2105,2222
50,12,35,Florida,Flagler County,12,17,3078,1431,1647
50,12,35,Florida,Flagler County,12,18,2407,946,1461
50,12,35,Florida,Flagler County,12,99,95696,46016,49680
50,12,35,Florida,Flagler County,13,0,865,429,436
50,12,35,Florida,Flagler County,13,1,3900,2000,1900
50,12,35,Florida,Flagler County,13,2,5156,2600,2556
50,12,35,Florida,Flagler County,13,3,5578,2922,2656
50,12,35,Florida,Flagler County,13,4,5549,2854,2695
50,12,35,Florida,Flagler County,13,5,3982,1995,1987
50,12,35,Florida,Flagler County,13,6,4317,2069,2248
50,12,35,Florida,Flagler County,13,7,4750,2319,2431
50,12,35,Florida,Flagler County,13,8,5114,2441,2673
50,12,35,Florida,Flagler County,13,9,5614,2685,2929
50,12,35,Florida,Flagler County,13,10,6127,2859,3268
50,12,35,Florida,Flagler County,13,11,6541,2964,3577
50,12,35,Florida,Flagler County,13,12,6900,3073,3827
50,12,35,Florida,Flagler County,13,13,8040,3688,4352
50,12,35,Florida,Flagler County,13,14,7576,3681,3895
50,12,35,Florida,Flagler County,13,15,6093,3054,3039
50,12,35,Florida,Flagler County,13,16,4319,2100,2219
50,12,35,Florida,Flagler County,13,17,3081,1435,1646
50,12,35,Florida,Flagler County,13,18,2426,957,1469
50,12,35,Florida,Flagler County,13,99,95928,46125,49803
50,12,37,Florida,Franklin County,1,0,117,57,60
50,12,37,Florida,Franklin County,1,1,392,204,188
50,12,37,Florida,Franklin County,1,2,516,265,251
50,12,37,Florida,Franklin County,1,3,620,314,306
50,12,37,Florida,Franklin County,1,4,566,287,279
50,12,37,Florida,Franklin County,1,5,475,248,227
50,12,37,Florida,Franklin County,1,6,529,282,247
50,12,37,Florida,Franklin County,1,7,560,313,247
50,12,37,Florida,Franklin County,1,8,739,393,346
50,12,37,Florida,Franklin County,1,9,729,383,346
50,12,37,Florida,Franklin County,1,10,708,352,356
50,12,37,Florida,Franklin County,1,11,720,363,357
50,12,37,Florida,Franklin County,1,12,738,385,353
50,12,37,Florida,Franklin County,1,13,687,356,331
50,12,37,Florida,Franklin County,1,14,523,276,247
50,12,37,Florida,Franklin County,1,15,454,231,223
50,12,37,Florida,Franklin County,1,16,321,159,162
50,12,37,Florida,Franklin County,1,17,227,77,150
50,12,37,Florida,Franklin County,1,18,206,69,137
50,12,37,Florida,Franklin County,1,99,9827,5014,4813
50,12,37,Florida,Franklin County,2,0,117,57,60
50,12,37,Florida,Franklin County,2,1,392,204,188
50,12,37,Florida,Franklin County,2,2,515,265,250
50,12,37,Florida,Franklin County,2,3,619,313,306
50,12,37,Florida,Franklin County,2,4,565,287,278
50,12,37,Florida,Franklin County,2,5,477,249,228
50,12,37,Florida,Franklin County,2,6,524,280,244
50,12,37,Florida,Franklin County,2,7,559,313,246
50,12,37,Florida,Franklin County,2,8,737,393,344
50,12,37,Florida,Franklin County,2,9,728,382,346
50,12,37,Florida,Franklin County,2,10,711,353,358
50,12,37,Florida,Franklin County,2,11,728,367,361
50,12,37,Florida,Franklin County,2,12,742,387,355
50,12,37,Florida,Franklin County,2,13,690,356,334
50,12,37,Florida,Franklin County,2,14,522,274,248
50,12,37,Florida,Franklin County,2,15,455,231,224
50,12,37,Florida,Franklin County,2,16,321,160,161
50,12,37,Florida,Franklin County,2,17,231,77,154
50,12,37,Florida,Franklin County,2,18,206,69,137
50,12,37,Florida,Franklin County,2,99,9839,5017,4822
50,12,37,Florida,Franklin County,3,0,100,56,44
50,12,37,Florida,Franklin County,3,1,421,211,210
50,12,37,Florida,Franklin County,3,2,515,256,259
50,12,37,Florida,Franklin County,3,3,592,307,285
50,12,37,Florida,Franklin County,3,4,572,292,280
50,12,37,Florida,Franklin County,3,5,501,247,254
50,12,37,Florida,Franklin County,3,6,535,298,237
50,12,37,Florida,Franklin County,3,7,557,303,254
50,12,37,Florida,Franklin County,3,8,712,378,334
50,12,37,Florida,Franklin County,3,9,745,396,349
50,12,37,Florida,Franklin County,3,10,706,361,345
50,12,37,Florida,Franklin County,3,11,756,356,400
50,12,37,Florida,Franklin County,3,12,758,408,350
50,12,37,Florida,Franklin County,3,13,715,355,360
50,12,37,Florida,Franklin County,3,14,554,305,249
50,12,37,Florida,Franklin County,3,15,458,245,213
50,12,37,Florida,Franklin County,3,16,329,173,156
50,12,37,Florida,Franklin County,3,17,207,71,136
50,12,37,Florida,Franklin County,3,18,177,59,118
50,12,37,Florida,Franklin County,3,99,9910,5077,4833
50,12,37,Florida,Franklin County,4,0,106,45,61
50,12,37,Florida,Franklin County,4,1,403,195,208
50,12,37,Florida,Franklin County,4,2,512,248,264
50,12,37,Florida,Franklin County,4,3,606,314,292
50,12,37,Florida,Franklin County,4,4,579,300,279
50,12,37,Florida,Franklin County,4,5,517,268,249
50,12,37,Florida,Franklin County,4,6,525,301,224
50,12,37,Florida,Franklin County,4,7,570,304,266
50,12,37,Florida,Franklin County,4,8,711,385,326
50,12,37,Florida,Franklin County,4,9,755,394,361
50,12,37,Florida,Franklin County,4,10,716,368,348
50,12,37,Florida,Franklin County,4,11,756,353,403
50,12,37,Florida,Franklin County,4,12,778,403,375
50,12,37,Florida,Franklin County,4,13,747,402,345
50,12,37,Florida,Franklin County,4,14,555,303,252
50,12,37,Florida,Franklin County,4,15,437,232,205
50,12,37,Florida,Franklin County,4,16,330,172,158
50,12,37,Florida,Franklin County,4,17,192,69,123
50,12,37,Florida,Franklin County,4,18,177,53,124
50,12,37,Florida,Franklin County,4,99,9972,5109,4863
50,12,37,Florida,Franklin County,5,0,99,50,49
50,12,37,Florida,Franklin County,5,1,399,180,219
50,12,37,Florida,Franklin County,5,2,504,252,252
50,12,37,Florida,Franklin County,5,3,571,283,288
50,12,37,Florida,Franklin County,5,4,589,295,294
50,12,37,Florida,Franklin County,5,5,513,280,233
50,12,37,Florida,Franklin County,5,6,548,317,231
50,12,37,Florida,Franklin County,5,7,572,310,262
50,12,37,Florida,Franklin County,5,8,673,364,309
50,12,37,Florida,Franklin County,5,9,760,411,349
50,12,37,Florida,Franklin County,5,10,735,372,363
50,12,37,Florida,Franklin County,5,11,765,368,397
50,12,37,Florida,Franklin County,5,12,795,394,401
50,12,37,Florida,Franklin County,5,13,779,448,331
50,12,37,Florida,Franklin County,5,14,574,280,294
50,12,37,Florida,Franklin County,5,15,425,236,189
50,12,37,Florida,Franklin County,5,16,345,177,168
50,12,37,Florida,Franklin County,5,17,207,86,121
50,12,37,Florida,Franklin County,5,18,172,50,122
50,12,37,Florida,Franklin County,5,99,10025,5153,4872
50,12,37,Florida,Franklin County,6,0,129,61,68
50,12,37,Florida,Franklin County,6,1,397,164,233
50,12,37,Florida,Franklin County,6,2,526,263,263
50,12,37,Florida,Franklin County,6,3,542,267,275
50,12,37,Florida,Franklin County,6,4,609,314,295
50,12,37,Florida,Franklin County,6,5,539,275,264
50,12,37,Florida,Franklin County,6,6,551,329,222
50,12,37,Florida,Franklin County,6,7,568,299,269
50,12,37,Florida,Franklin County,6,8,629,346,283
50,12,37,Florida,Franklin County,6,9,788,410,378
50,12,37,Florida,Franklin County,6,10,750,389,361
50,12,37,Florida,Franklin County,6,11,777,379,398
50,12,37,Florida,Franklin County,6,12,805,391,414
50,12,37,Florida,Franklin County,6,13,791,457,334
50,12,37,Florida,Franklin County,6,14,605,303,302
50,12,37,Florida,Franklin County,6,15,392,200,192
50,12,37,Florida,Franklin County,6,16,337,168,169
50,12,37,Florida,Franklin County,6,17,208,99,109
50,12,37,Florida,Franklin County,6,18,147,38,109
50,12,37,Florida,Franklin County,6,99,10090,5152,4938
50,12,37,Florida,Franklin County,7,0,111,61,50
50,12,37,Florida,Franklin County,7,1,418,183,235
50,12,37,Florida,Franklin County,7,2,531,264,267
50,12,37,Florida,Franklin County,7,3,547,272,275
50,12,37,Florida,Franklin County,7,4,627,323,304
50,12,37,Florida,Franklin County,7,5,571,302,269
50,12,37,Florida,Franklin County,7,6,590,339,251
50,12,37,Florida,Franklin County,7,7,527,285,242
50,12,37,Florida,Franklin County,7,8,614,346,268
50,12,37,Florida,Franklin County,7,9,780,410,370
50,12,37,Florida,Franklin County,7,10,760,401,359
50,12,37,Florida,Franklin County,7,11,772,370,402
50,12,37,Florida,Franklin County,7,12,801,391,410
50,12,37,Florida,Franklin County,7,13,837,466,371
50,12,37,Florida,Franklin County,7,14,622,308,314
50,12,37,Florida,Franklin County,7,15,367,199,168
50,12,37,Florida,Franklin County,7,16,336,163,173
50,12,37,Florida,Franklin County,7,17,225,116,109
50,12,37,Florida,Franklin County,7,18,162,43,119
50,12,37,Florida,Franklin County,7,99,10198,5242,4956
50,12,37,Florida,Franklin County,8,0,131,72,59
50,12,37,Florida,Franklin County,8,1,421,187,234
50,12,37,Florida,Franklin County,8,2,530,277,253
50,12,37,Florida,Franklin County,8,3,549,276,273
50,12,37,Florida,Franklin County,8,4,589,301,288
50,12,37,Florida,Franklin County,8,5,697,425,272
50,12,37,Florida,Franklin County,8,6,863,589,274
50,12,37,Florida,Franklin County,8,7,734,481,253
50,12,37,Florida,Franklin County,8,8,764,481,283
50,12,37,Florida,Franklin County,8,9,853,500,353
50,12,37,Florida,Franklin County,8,10,834,471,363
50,12,37,Florida,Franklin County,8,11,813,423,390
50,12,37,Florida,Franklin County,8,12,885,426,459
50,12,37,Florida,Franklin County,8,13,855,482,373
50,12,37,Florida,Franklin County,8,14,657,320,337
50,12,37,Florida,Franklin County,8,15,412,225,187
50,12,37,Florida,Franklin County,8,16,324,157,167
50,12,37,Florida,Franklin County,8,17,226,111,115
50,12,37,Florida,Franklin County,8,18,171,49,122
50,12,37,Florida,Franklin County,8,99,11308,6253,5055
50,12,37,Florida,Franklin County,9,0,120,59,61
50,12,37,Florida,Franklin County,9,1,439,215,224
50,12,37,Florida,Franklin County,9,2,518,270,248
50,12,37,Florida,Franklin County,9,3,546,280,266
50,12,37,Florida,Franklin County,9,4,569,295,274
50,12,37,Florida,Franklin County,9,5,718,462,256
50,12,37,Florida,Franklin County,9,6,937,667,270
50,12,37,Florida,Franklin County,9,7,782,539,243
50,12,37,Florida,Franklin County,9,8,783,516,267
50,12,37,Florida,Franklin County,9,9,846,511,335
50,12,37,Florida,Franklin County,9,10,872,510,362
50,12,37,Florida,Franklin County,9,11,802,416,386
50,12,37,Florida,Franklin County,9,12,885,441,444
50,12,37,Florida,Franklin County,9,13,845,454,391
50,12,37,Florida,Franklin County,9,14,674,351,323
50,12,37,Florida,Franklin County,9,15,452,254,198
50,12,37,Florida,Franklin County,9,16,326,158,168
50,12,37,Florida,Franklin County,9,17,208,96,112
50,12,37,Florida,Franklin County,9,18,169,53,116
50,12,37,Florida,Franklin County,9,99,11491,6547,4944
50,12,37,Florida,Franklin County,10,0,128,60,68
50,12,37,Florida,Franklin County,10,1,466,243,223
50,12,37,Florida,Franklin County,10,2,505,266,239
50,12,37,Florida,Franklin County,10,3,515,267,248
50,12,37,Florida,Franklin County,10,4,556,289,267
50,12,37,Florida,Franklin County,10,5,732,465,267
50,12,37,Florida,Franklin County,10,6,945,690,255
50,12,37,Florida,Franklin County,10,7,778,545,233
50,12,37,Florida,Franklin County,10,8,759,489,270
50,12,37,Florida,Franklin County,10,9,827,494,333
50,12,37,Florida,Franklin County,10,10,860,506,354
50,12,37,Florida,Franklin County,10,11,809,423,386
50,12,37,Florida,Franklin County,10,12,875,446,429
50,12,37,Florida,Franklin County,10,13,828,424,404
50,12,37,Florida,Franklin County,10,14,706,389,317
50,12,37,Florida,Franklin County,10,15,473,233,240
50,12,37,Florida,Franklin County,10,16,330,171,159
50,12,37,Florida,Franklin County,10,17,223,107,116
50,12,37,Florida,Franklin County,10,18,169,60,109
50,12,37,Florida,Franklin County,10,99,11484,6567,4917
50,12,37,Florida,Franklin County,11,0,115,62,53
50,12,37,Florida,Franklin County,11,1,440,228,212
50,12,37,Florida,Franklin County,11,2,495,259,236
50,12,37,Florida,Franklin County,11,3,520,280,240
50,12,37,Florida,Franklin County,11,4,528,271,257
50,12,37,Florida,Franklin County,11,5,738,465,273
50,12,37,Florida,Franklin County,11,6,956,702,254
50,12,37,Florida,Franklin County,11,7,815,577,238
50,12,37,Florida,Franklin County,11,8,769,511,258
50,12,37,Florida,Franklin County,11,9,755,474,281
50,12,37,Florida,Franklin County,11,10,905,536,369
50,12,37,Florida,Franklin County,11,11,827,441,386
50,12,37,Florida,Franklin County,11,12,863,436,427
50,12,37,Florida,Franklin County,11,13,817,411,406
50,12,37,Florida,Franklin County,11,14,711,393,318
50,12,37,Florida,Franklin County,11,15,526,265,261
50,12,37,Florida,Franklin County,11,16,316,167,149
50,12,37,Florida,Franklin County,11,17,231,115,116
50,12,37,Florida,Franklin County,11,18,188,67,121
50,12,37,Florida,Franklin County,11,99,11515,6660,4855
50,12,37,Florida,Franklin County,12,0,120,60,60
50,12,37,Florida,Franklin County,12,1,473,239,234
50,12,37,Florida,Franklin County,12,2,525,280,245
50,12,37,Florida,Franklin County,12,3,539,281,258
50,12,37,Florida,Franklin County,12,4,514,265,249
50,12,37,Florida,Franklin County,12,5,692,455,237
50,12,37,Florida,Franklin County,12,6,952,696,256
50,12,37,Florida,Franklin County,12,7,847,584,263
50,12,37,Florida,Franklin County,12,8,749,502,247
50,12,37,Florida,Franklin County,12,9,737,461,276
50,12,37,Florida,Franklin County,12,10,880,520,360
50,12,37,Florida,Franklin County,12,11,836,440,396
50,12,37,Florida,Franklin County,12,12,844,431,413
50,12,37,Florida,Franklin County,12,13,826,419,407
50,12,37,Florida,Franklin County,12,14,728,392,336
50,12,37,Florida,Franklin County,12,15,553,281,272
50,12,37,Florida,Franklin County,12,16,330,177,153
50,12,37,Florida,Franklin County,12,17,214,105,109
50,12,37,Florida,Franklin County,12,18,190,68,122
50,12,37,Florida,Franklin County,12,99,11549,6656,4893
50,12,37,Florida,Franklin County,13,0,118,59,59
50,12,37,Florida,Franklin County,13,1,486,243,243
50,12,37,Florida,Franklin County,13,2,515,275,240
50,12,37,Florida,Franklin County,13,3,542,286,256
50,12,37,Florida,Franklin County,13,4,518,267,251
50,12,37,Florida,Franklin County,13,5,695,456,239
50,12,37,Florida,Franklin County,13,6,957,701,256
50,12,37,Florida,Franklin County,13,7,844,583,261
50,12,37,Florida,Franklin County,13,8,749,507,242
50,12,37,Florida,Franklin County,13,9,737,457,280
50,12,37,Florida,Franklin County,13,10,877,521,356
50,12,37,Florida,Franklin County,13,11,829,441,388
50,12,37,Florida,Franklin County,13,12,845,432,413
50,12,37,Florida,Franklin County,13,13,828,421,407
50,12,37,Florida,Franklin County,13,14,733,395,338
50,12,37,Florida,Franklin County,13,15,552,281,271
50,12,37,Florida,Franklin County,13,16,327,176,151
50,12,37,Florida,Franklin County,13,17,211,105,106
50,12,37,Florida,Franklin County,13,18,191,69,122
50,12,37,Florida,Franklin County,13,99,11554,6675,4879
50,12,39,Florida,Gadsden County,1,0,613,318,295
50,12,39,Florida,Gadsden County,1,1,2407,1217,1190
50,12,39,Florida,Gadsden County,1,2,3321,1674,1647
50,12,39,Florida,Gadsden County,1,3,3438,1784,1654
50,12,39,Florida,Gadsden County,1,4,3554,1804,1750
50,12,39,Florida,Gadsden County,1,5,2846,1436,1410
50,12,39,Florida,Gadsden County,1,6,2965,1386,1579
50,12,39,Florida,Gadsden County,1,7,3026,1393,1633
50,12,39,Florida,Gadsden County,1,8,3455,1643,1812
50,12,39,Florida,Gadsden County,1,9,3565,1680,1885
50,12,39,Florida,Gadsden County,1,10,3425,1657,1768
50,12,39,Florida,Gadsden County,1,11,2796,1311,1485
50,12,39,Florida,Gadsden County,1,12,2247,1013,1234
50,12,39,Florida,Gadsden County,1,13,1873,863,1010
50,12,39,Florida,Gadsden County,1,14,1641,764,877
50,12,39,Florida,Gadsden County,1,15,1402,577,825
50,12,39,Florida,Gadsden County,1,16,1043,412,631
50,12,39,Florida,Gadsden County,1,17,739,279,460
50,12,39,Florida,Gadsden County,1,18,661,202,459
50,12,39,Florida,Gadsden County,1,99,45017,21413,23604
50,12,39,Florida,Gadsden County,2,0,618,321,297
50,12,39,Florida,Gadsden County,2,1,2382,1204,1178
50,12,39,Florida,Gadsden County,2,2,3294,1662,1632
50,12,39,Florida,Gadsden County,2,3,3447,1787,1660
50,12,39,Florida,Gadsden County,2,4,3553,1802,1751
50,12,39,Florida,Gadsden County,2,5,2861,1446,1415
50,12,39,Florida,Gadsden County,2,6,2937,1373,1564
50,12,39,Florida,Gadsden County,2,7,3007,1387,1620
50,12,39,Florida,Gadsden County,2,8,3420,1627,1793
50,12,39,Florida,Gadsden County,2,9,3557,1679,1878
50,12,39,Florida,Gadsden County,2,10,3433,1662,1771
50,12,39,Florida,Gadsden County,2,11,2825,1328,1497
50,12,39,Florida,Gadsden County,2,12,2253,1015,1238
50,12,39,Florida,Gadsden County,2,13,1874,865,1009
50,12,39,Florida,Gadsden County,2,14,1637,763,874
50,12,39,Florida,Gadsden County,2,15,1400,577,823
50,12,39,Florida,Gadsden County,2,16,1045,412,633
50,12,39,Florida,Gadsden County,2,17,746,282,464
50,12,39,Florida,Gadsden County,2,18,661,203,458
50,12,39,Florida,Gadsden County,2,99,44950,21395,23555
50,12,39,Florida,Gadsden County,3,0,688,331,357
50,12,39,Florida,Gadsden County,3,1,2416,1263,1153
50,12,39,Florida,Gadsden County,3,2,3147,1577,1570
50,12,39,Florida,Gadsden County,3,3,3401,1730,1671
50,12,39,Florida,Gadsden County,3,4,3413,1735,1678
50,12,39,Florida,Gadsden County,3,5,2987,1573,1414
50,12,39,Florida,Gadsden County,3,6,2883,1346,1537
50,12,39,Florida,Gadsden County,3,7,2995,1386,1609
50,12,39,Florida,Gadsden County,3,8,3344,1595,1749
50,12,39,Florida,Gadsden County,3,9,3507,1645,1862
50,12,39,Florida,Gadsden County,3,10,3514,1677,1837
50,12,39,Florida,Gadsden County,3,11,3048,1481,1567
50,12,39,Florida,Gadsden County,3,12,2328,1073,1255
50,12,39,Florida,Gadsden County,3,13,1923,889,1034
50,12,39,Florida,Gadsden County,3,14,1691,777,914
50,12,39,Florida,Gadsden County,3,15,1416,601,815
50,12,39,Florida,Gadsden County,3,16,1059,429,630
50,12,39,Florida,Gadsden County,3,17,734,266,468
50,12,39,Florida,Gadsden County,3,18,659,188,471
50,12,39,Florida,Gadsden County,3,99,45153,21562,23591
50,12,39,Florida,Gadsden County,4,0,681,352,329
50,12,39,Florida,Gadsden County,4,1,2466,1267,1199
50,12,39,Florida,Gadsden County,4,2,2971,1515,1456
50,12,39,Florida,Gadsden County,4,3,3436,1745,1691
50,12,39,Florida,Gadsden County,4,4,3235,1623,1612
50,12,39,Florida,Gadsden County,4,5,3050,1606,1444
50,12,39,Florida,Gadsden County,4,6,2828,1331,1497
50,12,39,Florida,Gadsden County,4,7,2970,1399,1571
50,12,39,Florida,Gadsden County,4,8,3101,1462,1639
50,12,39,Florida,Gadsden County,4,9,3452,1637,1815
50,12,39,Florida,Gadsden County,4,10,3572,1705,1867
50,12,39,Florida,Gadsden County,4,11,3061,1526,1535
50,12,39,Florida,Gadsden County,4,12,2476,1159,1317
50,12,39,Florida,Gadsden County,4,13,1971,921,1050
50,12,39,Florida,Gadsden County,4,14,1671,737,934
50,12,39,Florida,Gadsden County,4,15,1418,611,807
50,12,39,Florida,Gadsden County,4,16,1048,444,604
50,12,39,Florida,Gadsden County,4,17,737,263,474
50,12,39,Florida,Gadsden County,4,18,618,179,439
50,12,39,Florida,Gadsden County,4,99,44762,21482,23280
50,12,39,Florida,Gadsden County,5,0,691,351,340
50,12,39,Florida,Gadsden County,5,1,2482,1249,1233
50,12,39,Florida,Gadsden County,5,2,2885,1480,1405
50,12,39,Florida,Gadsden County,5,3,3439,1743,1696
50,12,39,Florida,Gadsden County,5,4,3205,1630,1575
50,12,39,Florida,Gadsden County,5,5,3158,1662,1496
50,12,39,Florida,Gadsden County,5,6,2729,1325,1404
50,12,39,Florida,Gadsden County,5,7,3026,1433,1593
50,12,39,Florida,Gadsden County,5,8,2931,1388,1543
50,12,39,Florida,Gadsden County,5,9,3459,1624,1835
50,12,39,Florida,Gadsden County,5,10,3562,1702,1860
50,12,39,Florida,Gadsden County,5,11,3242,1630,1612
50,12,39,Florida,Gadsden County,5,12,2587,1238,1349
50,12,39,Florida,Gadsden County,5,13,2013,943,1070
50,12,39,Florida,Gadsden County,5,14,1718,751,967
50,12,39,Florida,Gadsden County,5,15,1429,639,790
50,12,39,Florida,Gadsden County,5,16,1066,434,632
50,12,39,Florida,Gadsden County,5,17,704,261,443
50,12,39,Florida,Gadsden County,5,18,626,185,441
50,12,39,Florida,Gadsden County,5,99,44952,21668,23284
50,12,39,Florida,Gadsden County,6,0,641,320,321
50,12,39,Florida,Gadsden County,6,1,2524,1268,1256
50,12,39,Florida,Gadsden County,6,2,2890,1493,1397
50,12,39,Florida,Gadsden County,6,3,3339,1683,1656
50,12,39,Florida,Gadsden County,6,4,3187,1621,1566
50,12,39,Florida,Gadsden County,6,5,3202,1711,1491
50,12,39,Florida,Gadsden County,6,6,2766,1358,1408
50,12,39,Florida,Gadsden County,6,7,2943,1424,1519
50,12,39,Florida,Gadsden County,6,8,2916,1387,1529
50,12,39,Florida,Gadsden County,6,9,3385,1596,1789
50,12,39,Florida,Gadsden County,6,10,3484,1656,1828
50,12,39,Florida,Gadsden County,6,11,3408,1689,1719
50,12,39,Florida,Gadsden County,6,12,2741,1348,1393
50,12,39,Florida,Gadsden County,6,13,2115,999,1116
50,12,39,Florida,Gadsden County,6,14,1739,779,960
50,12,39,Florida,Gadsden County,6,15,1405,629,776
50,12,39,Florida,Gadsden County,6,16,1105,442,663
50,12,39,Florida,Gadsden County,6,17,728,269,459
50,12,39,Florida,Gadsden County,6,18,611,179,432
50,12,39,Florida,Gadsden County,6,99,45129,21851,23278
50,12,39,Florida,Gadsden County,7,0,647,335,312
50,12,39,Florida,Gadsden County,7,1,2576,1284,1292
50,12,39,Florida,Gadsden County,7,2,2887,1493,1394
50,12,39,Florida,Gadsden County,7,3,3171,1589,1582
50,12,39,Florida,Gadsden County,7,4,3222,1624,1598
50,12,39,Florida,Gadsden County,7,5,3090,1641,1449
50,12,39,Florida,Gadsden County,7,6,2738,1351,1387
50,12,39,Florida,Gadsden County,7,7,2904,1385,1519
50,12,39,Florida,Gadsden County,7,8,2894,1417,1477
50,12,39,Florida,Gadsden County,7,9,3310,1572,1738
50,12,39,Florida,Gadsden County,7,10,3438,1635,1803
50,12,39,Florida,Gadsden County,7,11,3539,1804,1735
50,12,39,Florida,Gadsden County,7,12,2934,1414,1520
50,12,39,Florida,Gadsden County,7,13,2155,997,1158
50,12,39,Florida,Gadsden County,7,14,1859,864,995
50,12,39,Florida,Gadsden County,7,15,1418,666,752
50,12,39,Florida,Gadsden County,7,16,1141,433,708
50,12,39,Florida,Gadsden County,7,17,711,269,442
50,12,39,Florida,Gadsden County,7,18,624,184,440
50,12,39,Florida,Gadsden County,7,99,45258,21957,23301
50,12,39,Florida,Gadsden County,8,0,703,364,339
50,12,39,Florida,Gadsden County,8,1,2439,1223,1216
50,12,39,Florida,Gadsden County,8,2,3031,1506,1525
50,12,39,Florida,Gadsden County,8,3,3049,1526,1523
50,12,39,Florida,Gadsden County,8,4,3172,1584,1588
50,12,39,Florida,Gadsden County,8,5,2994,1567,1427
50,12,39,Florida,Gadsden County,8,6,2805,1402,1403
50,12,39,Florida,Gadsden County,8,7,2829,1369,1460
50,12,39,Florida,Gadsden County,8,8,2826,1364,1462
50,12,39,Florida,Gadsden County,8,9,3287,1597,1690
50,12,39,Florida,Gadsden County,8,10,3359,1571,1788
50,12,39,Florida,Gadsden County,8,11,3645,1858,1787
50,12,39,Florida,Gadsden County,8,12,3076,1480,1596
50,12,39,Florida,Gadsden County,8,13,2233,1057,1176
50,12,39,Florida,Gadsden County,8,14,1850,859,991
50,12,39,Florida,Gadsden County,8,15,1481,690,791
50,12,39,Florida,Gadsden County,8,16,1141,452,689
50,12,39,Florida,Gadsden County,8,17,720,280,440
50,12,39,Florida,Gadsden County,8,18,618,174,444
50,12,39,Florida,Gadsden County,8,99,45258,21923,23335
50,12,39,Florida,Gadsden County,9,0,691,340,351
50,12,39,Florida,Gadsden County,9,1,2505,1285,1220
50,12,39,Florida,Gadsden County,9,2,3086,1546,1540
50,12,39,Florida,Gadsden County,9,3,2954,1492,1462
50,12,39,Florida,Gadsden County,9,4,3325,1631,1694
50,12,39,Florida,Gadsden County,9,5,2940,1539,1401
50,12,39,Florida,Gadsden County,9,6,2964,1486,1478
50,12,39,Florida,Gadsden County,9,7,2784,1342,1442
50,12,39,Florida,Gadsden County,9,8,2915,1415,1500
50,12,39,Florida,Gadsden County,9,9,3121,1504,1617
50,12,39,Florida,Gadsden County,9,10,3384,1584,1800
50,12,39,Florida,Gadsden County,9,11,3740,1900,1840
50,12,39,Florida,Gadsden County,9,12,3152,1528,1624
50,12,39,Florida,Gadsden County,9,13,2406,1159,1247
50,12,39,Florida,Gadsden County,9,14,1888,867,1021
50,12,39,Florida,Gadsden County,9,15,1481,675,806
50,12,39,Florida,Gadsden County,9,16,1202,491,711
50,12,39,Florida,Gadsden County,9,17,700,281,419
50,12,39,Florida,Gadsden County,9,18,629,174,455
50,12,39,Florida,Gadsden County,9,99,45867,22239,23628
50,12,39,Florida,Gadsden County,10,0,695,355,340
50,12,39,Florida,Gadsden County,10,1,2553,1292,1261
50,12,39,Florida,Gadsden County,10,2,3083,1565,1518
50,12,39,Florida,Gadsden County,10,3,2896,1487,1409
50,12,39,Florida,Gadsden County,10,4,3364,1673,1691
50,12,39,Florida,Gadsden County,10,5,2845,1519,1326
50,12,39,Florida,Gadsden County,10,6,3072,1548,1524
50,12,39,Florida,Gadsden County,10,7,2801,1366,1435
50,12,39,Florida,Gadsden County,10,8,2995,1457,1538
50,12,39,Florida,Gadsden County,10,9,2993,1472,1521
50,12,39,Florida,Gadsden County,10,10,3377,1594,1783
50,12,39,Florida,Gadsden County,10,11,3727,1893,1834
50,12,39,Florida,Gadsden County,10,12,3350,1625,1725
50,12,39,Florida,Gadsden County,10,13,2512,1212,1300
50,12,39,Florida,Gadsden County,10,14,1949,912,1037
50,12,39,Florida,Gadsden County,10,15,1506,683,823
50,12,39,Florida,Gadsden County,10,16,1240,521,719
50,12,39,Florida,Gadsden County,10,17,728,283,445
50,12,39,Florida,Gadsden County,10,18,633,185,448
50,12,39,Florida,Gadsden County,10,99,46319,22642,23677
50,12,39,Florida,Gadsden County,11,0,649,310,339
50,12,39,Florida,Gadsden County,11,1,2540,1273,1267
50,12,39,Florida,Gadsden County,11,2,3041,1556,1485
50,12,39,Florida,Gadsden County,11,3,2943,1502,1441
50,12,39,Florida,Gadsden County,11,4,3252,1631,1621
50,12,39,Florida,Gadsden County,11,5,2730,1433,1297
50,12,39,Florida,Gadsden County,11,6,3103,1536,1567
50,12,39,Florida,Gadsden County,11,7,2787,1398,1389
50,12,39,Florida,Gadsden County,11,8,2939,1431,1508
50,12,39,Florida,Gadsden County,11,9,2990,1447,1543
50,12,39,Florida,Gadsden County,11,10,3334,1612,1722
50,12,39,Florida,Gadsden County,11,11,3638,1835,1803
50,12,39,Florida,Gadsden County,11,12,3448,1653,1795
50,12,39,Florida,Gadsden County,11,13,2653,1299,1354
50,12,39,Florida,Gadsden County,11,14,2078,960,1118
50,12,39,Florida,Gadsden County,11,15,1531,693,838
50,12,39,Florida,Gadsden County,11,16,1226,521,705
50,12,39,Florida,Gadsden County,11,17,743,297,446
50,12,39,Florida,Gadsden County,11,18,639,187,452
50,12,39,Florida,Gadsden County,11,99,46264,22574,23690
50,12,39,Florida,Gadsden County,12,0,639,310,329
50,12,39,Florida,Gadsden County,12,1,2574,1298,1276
50,12,39,Florida,Gadsden County,12,2,3109,1569,1540
50,12,39,Florida,Gadsden County,12,3,2969,1510,1459
50,12,39,Florida,Gadsden County,12,4,3168,1586,1582
50,12,39,Florida,Gadsden County,12,5,2691,1404,1287
50,12,39,Florida,Gadsden County,12,6,2995,1493,1502
50,12,39,Florida,Gadsden County,12,7,2805,1415,1390
50,12,39,Florida,Gadsden County,12,8,2906,1392,1514
50,12,39,Florida,Gadsden County,12,9,2950,1467,1483
50,12,39,Florida,Gadsden County,12,10,3324,1605,1719
50,12,39,Florida,Gadsden County,12,11,3642,1839,1803
50,12,39,Florida,Gadsden County,12,12,3502,1716,1786
50,12,39,Florida,Gadsden County,12,13,2792,1342,1450
50,12,39,Florida,Gadsden County,12,14,2094,950,1144
50,12,39,Florida,Gadsden County,12,15,1608,743,865
50,12,39,Florida,Gadsden County,12,16,1184,506,678
50,12,39,Florida,Gadsden County,12,17,764,299,465
50,12,39,Florida,Gadsden County,12,18,673,203,470
50,12,39,Florida,Gadsden County,12,99,46389,22647,23742
50,12,39,Florida,Gadsden County,13,0,631,306,325
50,12,39,Florida,Gadsden County,13,1,2569,1294,1275
50,12,39,Florida,Gadsden County,13,2,3096,1566,1530
50,12,39,Florida,Gadsden County,13,3,2974,1517,1457
50,12,39,Florida,Gadsden County,13,4,3156,1579,1577
50,12,39,Florida,Gadsden County,13,5,2716,1422,1294
50,12,39,Florida,Gadsden County,13,6,2982,1488,1494
50,12,39,Florida,Gadsden County,13,7,2817,1424,1393
50,12,39,Florida,Gadsden County,13,8,2900,1389,1511
50,12,39,Florida,Gadsden County,13,9,2957,1470,1487
50,12,39,Florida,Gadsden County,13,10,3317,1606,1711
50,12,39,Florida,Gadsden County,13,11,3649,1846,1803
50,12,39,Florida,Gadsden County,13,12,3515,1723,1792
50,12,39,Florida,Gadsden County,13,13,2822,1357,1465
50,12,39,Florida,Gadsden County,13,14,2105,953,1152
50,12,39,Florida,Gadsden County,13,15,1614,746,868
50,12,39,Florida,Gadsden County,13,16,1181,502,679
50,12,39,Florida,Gadsden County,13,17,770,302,468
50,12,39,Florida,Gadsden County,13,18,678,205,473
50,12,39,Florida,Gadsden County,13,99,46449,22695,23754
50,12,41,Florida,Gilchrist County,1,0,163,85,78
50,12,41,Florida,Gilchrist County,1,1,664,332,332
50,12,41,Florida,Gilchrist County,1,2,974,498,476
50,12,41,Florida,Gilchrist County,1,3,1075,543,532
50,12,41,Florida,Gilchrist County,1,4,1156,702,454
50,12,41,Florida,Gilchrist County,1,5,1547,1217,330
50,12,41,Florida,Gilchrist County,1,6,758,358,400
50,12,41,Florida,Gilchrist County,1,7,806,394,412
50,12,41,Florida,Gilchrist County,1,8,971,469,502
50,12,41,Florida,Gilchrist County,1,9,1051,521,530
50,12,41,Florida,Gilchrist County,1,10,920,454,466
50,12,41,Florida,Gilchrist County,1,11,887,452,435
50,12,41,Florida,Gilchrist County,1,12,793,387,406
50,12,41,Florida,Gilchrist County,1,13,696,342,354
50,12,41,Florida,Gilchrist County,1,14,609,305,304
50,12,41,Florida,Gilchrist County,1,15,535,244,291
50,12,41,Florida,Gilchrist County,1,16,387,180,207
50,12,41,Florida,Gilchrist County,1,17,245,96,149
50,12,41,Florida,Gilchrist County,1,18,192,56,136
50,12,41,Florida,Gilchrist County,1,99,14429,7635,6794
50,12,41,Florida,Gilchrist County,2,0,165,86,79
50,12,41,Florida,Gilchrist County,2,1,665,333,332
50,12,41,Florida,Gilchrist County,2,2,978,500,478
50,12,41,Florida,Gilchrist County,2,3,1080,546,534
50,12,41,Florida,Gilchrist County,2,4,1154,697,457
50,12,41,Florida,Gilchrist County,2,5,1498,1164,334
50,12,41,Florida,Gilchrist County,2,6,753,356,397
50,12,41,Florida,Gilchrist County,2,7,808,395,413
50,12,41,Florida,Gilchrist County,2,8,972,470,502
50,12,41,Florida,Gilchrist County,2,9,1059,525,534
50,12,41,Florida,Gilchrist County,2,10,930,459,471
50,12,41,Florida,Gilchrist County,2,11,899,459,440
50,12,41,Florida,Gilchrist County,2,12,800,391,409
50,12,41,Florida,Gilchrist County,2,13,703,346,357
50,12,41,Florida,Gilchrist County,2,14,613,307,306
50,12,41,Florida,Gilchrist County,2,15,537,245,292
50,12,41,Florida,Gilchrist County,2,16,394,183,211
50,12,41,Florida,Gilchrist County,2,17,245,97,148
50,12,41,Florida,Gilchrist County,2,18,190,56,134
50,12,41,Florida,Gilchrist County,2,99,14443,7615,6828
50,12,41,Florida,Gilchrist County,3,0,178,86,92
50,12,41,Florida,Gilchrist County,3,1,652,327,325
50,12,41,Florida,Gilchrist County,3,2,937,479,458
50,12,41,Florida,Gilchrist County,3,3,1033,542,491
50,12,41,Florida,Gilchrist County,3,4,1185,691,494
50,12,41,Florida,Gilchrist County,3,5,1310,975,335
50,12,41,Florida,Gilchrist County,3,6,710,344,366
50,12,41,Florida,Gilchrist County,3,7,799,379,420
50,12,41,Florida,Gilchrist County,3,8,928,446,482
50,12,41,Florida,Gilchrist County,3,9,1065,520,545
50,12,41,Florida,Gilchrist County,3,10,961,480,481
50,12,41,Florida,Gilchrist County,3,11,944,471,473
50,12,41,Florida,Gilchrist County,3,12,821,422,399
50,12,41,Florida,Gilchrist County,3,13,736,359,377
50,12,41,Florida,Gilchrist County,3,14,668,330,338
50,12,41,Florida,Gilchrist County,3,15,537,253,284
50,12,41,Florida,Gilchrist County,3,16,392,178,214
50,12,41,Florida,Gilchrist County,3,17,256,102,154
50,12,41,Florida,Gilchrist County,3,18,171,49,122
50,12,41,Florida,Gilchrist County,3,99,14283,7433,6850
50,12,41,Florida,Gilchrist County,4,0,181,99,82
50,12,41,Florida,Gilchrist County,4,1,671,348,323
50,12,41,Florida,Gilchrist County,4,2,921,464,457
50,12,41,Florida,Gilchrist County,4,3,1032,525,507
50,12,41,Florida,Gilchrist County,4,4,1171,676,495
50,12,41,Florida,Gilchrist County,4,5,1285,934,351
50,12,41,Florida,Gilchrist County,4,6,686,336,350
50,12,41,Florida,Gilchrist County,4,7,807,375,432
50,12,41,Florida,Gilchrist County,4,8,934,452,482
50,12,41,Florida,Gilchrist County,4,9,1121,537,584
50,12,41,Florida,Gilchrist County,4,10,998,508,490
50,12,41,Florida,Gilchrist County,4,11,907,446,461
50,12,41,Florida,Gilchrist County,4,12,909,467,442
50,12,41,Florida,Gilchrist County,4,13,753,358,395
50,12,41,Florida,Gilchrist County,4,14,701,338,363
50,12,41,Florida,Gilchrist County,4,15,537,264,273
50,12,41,Florida,Gilchrist County,4,16,434,202,232
50,12,41,Florida,Gilchrist County,4,17,271,108,163
50,12,41,Florida,Gilchrist County,4,18,183,52,131
50,12,41,Florida,Gilchrist County,4,99,14502,7489,7013
50,12,41,Florida,Gilchrist County,5,0,187,100,87
50,12,41,Florida,Gilchrist County,5,1,689,365,324
50,12,41,Florida,Gilchrist County,5,2,970,496,474
50,12,41,Florida,Gilchrist County,5,3,1062,524,538
50,12,41,Florida,Gilchrist County,5,4,1226,700,526
50,12,41,Florida,Gilchrist County,5,5,1295,918,377
50,12,41,Florida,Gilchrist County,5,6,682,317,365
50,12,41,Florida,Gilchrist County,5,7,834,385,449
50,12,41,Florida,Gilchrist County,5,8,955,482,473
50,12,41,Florida,Gilchrist County,5,9,1072,518,554
50,12,41,Florida,Gilchrist County,5,10,1116,549,567
50,12,41,Florida,Gilchrist County,5,11,937,468,469
50,12,41,Florida,Gilchrist County,5,12,960,496,464
50,12,41,Florida,Gilchrist County,5,13,809,393,416
50,12,41,Florida,Gilchrist County,5,14,749,363,386
50,12,41,Florida,Gilchrist County,5,15,544,274,270
50,12,41,Florida,Gilchrist County,5,16,447,201,246
50,12,41,Florida,Gilchrist County,5,17,287,115,172
50,12,41,Florida,Gilchrist County,5,18,190,54,136
50,12,41,Florida,Gilchrist County,5,99,15011,7718,7293
50,12,41,Florida,Gilchrist County,6,0,180,90,90
50,12,41,Florida,Gilchrist County,6,1,713,364,349
50,12,41,Florida,Gilchrist County,6,2,977,514,463
50,12,41,Florida,Gilchrist County,6,3,1076,526,550
50,12,41,Florida,Gilchrist County,6,4,1209,701,508
50,12,41,Florida,Gilchrist County,6,5,1335,956,379
50,12,41,Florida,Gilchrist County,6,6,722,333,389
50,12,41,Florida,Gilchrist County,6,7,807,386,421
50,12,41,Florida,Gilchrist County,6,8,948,463,485
50,12,41,Florida,Gilchrist County,6,9,1070,530,540
50,12,41,Florida,Gilchrist County,6,10,1153,582,571
50,12,41,Florida,Gilchrist County,6,11,942,453,489
50,12,41,Florida,Gilchrist County,6,12,1001,498,503
50,12,41,Florida,Gilchrist County,6,13,877,430,447
50,12,41,Florida,Gilchrist County,6,14,749,357,392
50,12,41,Florida,Gilchrist County,6,15,550,274,276
50,12,41,Florida,Gilchrist County,6,16,496,231,265
50,12,41,Florida,Gilchrist County,6,17,282,106,176
50,12,41,Florida,Gilchrist County,6,18,184,50,134
50,12,41,Florida,Gilchrist County,6,99,15271,7844,7427
50,12,41,Florida,Gilchrist County,7,0,198,94,104
50,12,41,Florida,Gilchrist County,7,1,735,371,364
50,12,41,Florida,Gilchrist County,7,2,967,523,444
50,12,41,Florida,Gilchrist County,7,3,1082,542,540
50,12,41,Florida,Gilchrist County,7,4,1256,751,505
50,12,41,Florida,Gilchrist County,7,5,1343,956,387
50,12,41,Florida,Gilchrist County,7,6,739,345,394
50,12,41,Florida,Gilchrist County,7,7,806,400,406
50,12,41,Florida,Gilchrist County,7,8,952,457,495
50,12,41,Florida,Gilchrist County,7,9,1084,540,544
50,12,41,Florida,Gilchrist County,7,10,1216,609,607
50,12,41,Florida,Gilchrist County,7,11,1046,508,538
50,12,41,Florida,Gilchrist County,7,12,1050,534,516
50,12,41,Florida,Gilchrist County,7,13,934,463,471
50,12,41,Florida,Gilchrist County,7,14,782,393,389
50,12,41,Florida,Gilchrist County,7,15,588,284,304
50,12,41,Florida,Gilchrist County,7,16,480,219,261
50,12,41,Florida,Gilchrist County,7,17,313,126,187
50,12,41,Florida,Gilchrist County,7,18,230,60,170
50,12,41,Florida,Gilchrist County,7,99,15801,8175,7626
50,12,41,Florida,Gilchrist County,8,0,175,83,92
50,12,41,Florida,Gilchrist County,8,1,718,344,374
50,12,41,Florida,Gilchrist County,8,2,978,522,456
50,12,41,Florida,Gilchrist County,8,3,1122,562,560
50,12,41,Florida,Gilchrist County,8,4,1280,792,488
50,12,41,Florida,Gilchrist County,8,5,1354,951,403
50,12,41,Florida,Gilchrist County,8,6,775,390,385
50,12,41,Florida,Gilchrist County,8,7,788,386,402
50,12,41,Florida,Gilchrist County,8,8,974,467,507
50,12,41,Florida,Gilchrist County,8,9,1089,543,546
50,12,41,Florida,Gilchrist County,8,10,1248,608,640
50,12,41,Florida,Gilchrist County,8,11,1124,546,578
50,12,41,Florida,Gilchrist County,8,12,1114,544,570
50,12,41,Florida,Gilchrist County,8,13,972,499,473
50,12,41,Florida,Gilchrist County,8,14,813,402,411
50,12,41,Florida,Gilchrist County,8,15,643,310,333
50,12,41,Florida,Gilchrist County,8,16,482,231,251
50,12,41,Florida,Gilchrist County,8,17,319,124,195
50,12,41,Florida,Gilchrist County,8,18,255,70,185
50,12,41,Florida,Gilchrist County,8,99,16223,8374,7849
50,12,41,Florida,Gilchrist County,9,0,194,92,102
50,12,41,Florida,Gilchrist County,9,1,670,320,350
50,12,41,Florida,Gilchrist County,9,2,996,513,483
50,12,41,Florida,Gilchrist County,9,3,1110,567,543
50,12,41,Florida,Gilchrist County,9,4,1341,811,530
50,12,41,Florida,Gilchrist County,9,5,1420,1004,416
50,12,41,Florida,Gilchrist County,9,6,805,413,392
50,12,41,Florida,Gilchrist County,9,7,733,344,389
50,12,41,Florida,Gilchrist County,9,8,1024,489,535
50,12,41,Florida,Gilchrist County,9,9,1112,570,542
50,12,41,Florida,Gilchrist County,9,10,1275,624,651
50,12,41,Florida,Gilchrist County,9,11,1165,580,585
50,12,41,Florida,Gilchrist County,9,12,1100,540,560
50,12,41,Florida,Gilchrist County,9,13,1053,532,521
50,12,41,Florida,Gilchrist County,9,14,854,423,431
50,12,41,Florida,Gilchrist County,9,15,652,308,344
50,12,41,Florida,Gilchrist County,9,16,504,241,263
50,12,41,Florida,Gilchrist County,9,17,337,142,195
50,12,41,Florida,Gilchrist County,9,18,265,66,199
50,12,41,Florida,Gilchrist County,9,99,16610,8579,8031
50,12,41,Florida,Gilchrist County,10,0,189,94,95
50,12,41,Florida,Gilchrist County,10,1,688,324,364
50,12,41,Florida,Gilchrist County,10,2,983,511,472
50,12,41,Florida,Gilchrist County,10,3,1126,548,578
50,12,41,Florida,Gilchrist County,10,4,1359,835,524
50,12,41,Florida,Gilchrist County,10,5,1454,1044,410
50,12,41,Florida,Gilchrist County,10,6,809,412,397
50,12,41,Florida,Gilchrist County,10,7,745,345,400
50,12,41,Florida,Gilchrist County,10,8,1009,477,532
50,12,41,Florida,Gilchrist County,10,9,1103,584,519
50,12,41,Florida,Gilchrist County,10,10,1190,572,618
50,12,41,Florida,Gilchrist County,10,11,1238,624,614
50,12,41,Florida,Gilchrist County,10,12,1100,536,564
50,12,41,Florida,Gilchrist County,10,13,1091,549,542
50,12,41,Florida,Gilchrist County,10,14,922,456,466
50,12,41,Florida,Gilchrist County,10,15,672,330,342
50,12,41,Florida,Gilchrist County,10,16,489,249,240
50,12,41,Florida,Gilchrist County,10,17,335,120,215
50,12,41,Florida,Gilchrist County,10,18,295,87,208
50,12,41,Florida,Gilchrist County,10,99,16797,8697,8100
50,12,41,Florida,Gilchrist County,11,0,193,109,84
50,12,41,Florida,Gilchrist County,11,1,687,305,382
50,12,41,Florida,Gilchrist County,11,2,949,498,451
50,12,41,Florida,Gilchrist County,11,3,1105,550,555
50,12,41,Florida,Gilchrist County,11,4,1351,841,510
50,12,41,Florida,Gilchrist County,11,5,1467,1046,421
50,12,41,Florida,Gilchrist County,11,6,811,416,395
50,12,41,Florida,Gilchrist County,11,7,794,391,403
50,12,41,Florida,Gilchrist County,11,8,949,455,494
50,12,41,Florida,Gilchrist County,11,9,1075,550,525
50,12,41,Florida,Gilchrist County,11,10,1194,597,597
50,12,41,Florida,Gilchrist County,11,11,1250,621,629
50,12,41,Florida,Gilchrist County,11,12,1076,516,560
50,12,41,Florida,Gilchrist County,11,13,1126,556,570
50,12,41,Florida,Gilchrist County,11,14,976,493,483
50,12,41,Florida,Gilchrist County,11,15,649,317,332
50,12,41,Florida,Gilchrist County,11,16,496,230,266
50,12,41,Florida,Gilchrist County,11,17,361,163,198
50,12,41,Florida,Gilchrist County,11,18,320,87,233
50,12,41,Florida,Gilchrist County,11,99,16829,8741,8088
50,12,41,Florida,Gilchrist County,12,0,181,101,80
50,12,41,Florida,Gilchrist County,12,1,728,348,380
50,12,41,Florida,Gilchrist County,12,2,955,480,475
50,12,41,Florida,Gilchrist County,12,3,1085,549,536
50,12,41,Florida,Gilchrist County,12,4,1381,861,520
50,12,41,Florida,Gilchrist County,12,5,1480,1067,413
50,12,41,Florida,Gilchrist County,12,6,832,434,398
50,12,41,Florida,Gilchrist County,12,7,781,382,399
50,12,41,Florida,Gilchrist County,12,8,900,431,469
50,12,41,Florida,Gilchrist County,12,9,1044,533,511
50,12,41,Florida,Gilchrist County,12,10,1183,598,585
50,12,41,Florida,Gilchrist County,12,11,1257,636,621
50,12,41,Florida,Gilchrist County,12,12,1157,559,598
50,12,41,Florida,Gilchrist County,12,13,1119,541,578
50,12,41,Florida,Gilchrist County,12,14,996,508,488
50,12,41,Florida,Gilchrist County,12,15,674,334,340
50,12,41,Florida,Gilchrist County,12,16,495,229,266
50,12,41,Florida,Gilchrist County,12,17,343,146,197
50,12,41,Florida,Gilchrist County,12,18,348,99,249
50,12,41,Florida,Gilchrist County,12,99,16939,8836,8103
50,12,41,Florida,Gilchrist County,13,0,181,100,81
50,12,41,Florida,Gilchrist County,13,1,737,351,386
50,12,41,Florida,Gilchrist County,13,2,945,475,470
50,12,41,Florida,Gilchrist County,13,3,1079,547,532
50,12,41,Florida,Gilchrist County,13,4,1386,863,523
50,12,41,Florida,Gilchrist County,13,5,1483,1071,412
50,12,41,Florida,Gilchrist County,13,6,838,440,398
50,12,41,Florida,Gilchrist County,13,7,781,381,400
50,12,41,Florida,Gilchrist County,13,8,895,431,464
50,12,41,Florida,Gilchrist County,13,9,1045,532,513
50,12,41,Florida,Gilchrist County,13,10,1182,597,585
50,12,41,Florida,Gilchrist County,13,11,1255,636,619
50,12,41,Florida,Gilchrist County,13,12,1165,563,602
50,12,41,Florida,Gilchrist County,13,13,1130,546,584
50,12,41,Florida,Gilchrist County,13,14,1001,510,491
50,12,41,Florida,Gilchrist County,13,15,674,334,340
50,12,41,Florida,Gilchrist County,13,16,488,225,263
50,12,41,Florida,Gilchrist County,13,17,343,147,196
50,12,41,Florida,Gilchrist County,13,18,348,99,249
50,12,41,Florida,Gilchrist County,13,99,16956,8848,8108
50,12,43,Florida,Glades County,1,0,120,73,47
50,12,43,Florida,Glades County,1,1,497,257,240
50,12,43,Florida,Glades County,1,2,655,334,321
50,12,43,Florida,Glades County,1,3,651,339,312
50,12,43,Florida,Glades County,1,4,641,328,313
50,12,43,Florida,Glades County,1,5,572,362,210
50,12,43,Florida,Glades County,1,6,691,452,239
50,12,43,Florida,Glades County,1,7,713,410,303
50,12,43,Florida,Glades County,1,8,710,432,278
50,12,43,Florida,Glades County,1,9,736,437,299
50,12,43,Florida,Glades County,1,10,614,342,272
50,12,43,Florida,Glades County,1,11,595,313,282
50,12,43,Florida,Glades County,1,12,671,326,345
50,12,43,Florida,Glades County,1,13,680,350,330
50,12,43,Florida,Glades County,1,14,675,376,299
50,12,43,Florida,Glades County,1,15,576,292,284
50,12,43,Florida,Glades County,1,16,375,202,173
50,12,43,Florida,Glades County,1,17,216,91,125
50,12,43,Florida,Glades County,1,18,143,63,80
50,12,43,Florida,Glades County,1,99,10531,5779,4752
50,12,43,Florida,Glades County,2,0,121,74,47
50,12,43,Florida,Glades County,2,1,502,259,243
50,12,43,Florida,Glades County,2,2,655,333,322
50,12,43,Florida,Glades County,2,3,652,339,313
50,12,43,Florida,Glades County,2,4,642,328,314
50,12,43,Florida,Glades County,2,5,571,360,211
50,12,43,Florida,Glades County,2,6,693,455,238
50,12,43,Florida,Glades County,2,7,714,411,303
50,12,43,Florida,Glades County,2,8,709,432,277
50,12,43,Florida,Glades County,2,9,739,438,301
50,12,43,Florida,Glades County,2,10,619,347,272
50,12,43,Florida,Glades County,2,11,598,315,283
50,12,43,Florida,Glades County,2,12,675,327,348
50,12,43,Florida,Glades County,2,13,683,353,330
50,12,43,Florida,Glades County,2,14,682,380,302
50,12,43,Florida,Glades County,2,15,583,296,287
50,12,43,Florida,Glades County,2,16,377,203,174
50,12,43,Florida,Glades County,2,17,219,92,127
50,12,43,Florida,Glades County,2,18,145,64,81
50,12,43,Florida,Glades County,2,99,10579,5806,4773
50,12,43,Florida,Glades County,3,0,112,60,52
50,12,43,Florida,Glades County,3,1,541,294,247
50,12,43,Florida,Glades County,3,2,627,321,306
50,12,43,Florida,Glades County,3,3,706,366,340
50,12,43,Florida,Glades County,3,4,635,333,302
50,12,43,Florida,Glades County,3,5,625,383,242
50,12,43,Florida,Glades County,3,6,699,453,246
50,12,43,Florida,Glades County,3,7,719,422,297
50,12,43,Florida,Glades County,3,8,695,432,263
50,12,43,Florida,Glades County,3,9,793,458,335
50,12,43,Florida,Glades County,3,10,666,381,285
50,12,43,Florida,Glades County,3,11,611,331,280
50,12,43,Florida,Glades County,3,12,698,342,356
50,12,43,Florida,Glades County,3,13,702,362,340
50,12,43,Florida,Glades County,3,14,711,387,324
50,12,43,Florida,Glades County,3,15,635,337,298
50,12,43,Florida,Glades County,3,16,390,215,175
50,12,43,Florida,Glades County,3,17,234,102,132
50,12,43,Florida,Glades County,3,18,149,60,89
50,12,43,Florida,Glades County,3,99,10948,6039,4909
50,12,43,Florida,Glades County,4,0,112,60,52
50,12,43,Florida,Glades County,4,1,551,301,250
50,12,43,Florida,Glades County,4,2,647,326,321
50,12,43,Florida,Glades County,4,3,702,362,340
50,12,43,Florida,Glades County,4,4,655,355,300
50,12,43,Florida,Glades County,4,5,659,386,273
50,12,43,Florida,Glades County,4,6,702,438,264
50,12,43,Florida,Glades County,4,7,715,442,273
50,12,43,Florida,Glades County,4,8,740,457,283
50,12,43,Florida,Glades County,4,9,764,461,303
50,12,43,Florida,Glades County,4,10,711,393,318
50,12,43,Florida,Glades County,4,11,609,343,266
50,12,43,Florida,Glades County,4,12,724,365,359
50,12,43,Florida,Glades County,4,13,731,364,367
50,12,43,Florida,Glades County,4,14,769,422,347
50,12,43,Florida,Glades County,4,15,659,343,316
50,12,43,Florida,Glades County,4,16,426,238,188
50,12,43,Florida,Glades County,4,17,251,109,142
50,12,43,Florida,Glades County,4,18,157,63,94
50,12,43,Florida,Glades County,4,99,11284,6228,5056
50,12,43,Florida,Glades County,5,0,111,55,56
50,12,43,Florida,Glades County,5,1,556,317,239
50,12,43,Florida,Glades County,5,2,660,351,309
50,12,43,Florida,Glades County,5,3,732,381,351
50,12,43,Florida,Glades County,5,4,643,348,295
50,12,43,Florida,Glades County,5,5,652,405,247
50,12,43,Florida,Glades County,5,6,713,466,247
50,12,43,Florida,Glades County,5,7,732,447,285
50,12,43,Florida,Glades County,5,8,765,462,303
50,12,43,Florida,Glades County,5,9,779,473,306
50,12,43,Florida,Glades County,5,10,734,420,314
50,12,43,Florida,Glades County,5,11,632,342,290
50,12,43,Florida,Glades County,5,12,721,364,357
50,12,43,Florida,Glades County,5,13,770,388,382
50,12,43,Florida,Glades County,5,14,776,429,347
50,12,43,Florida,Glades County,5,15,671,367,304
50,12,43,Florida,Glades County,5,16,433,226,207
50,12,43,Florida,Glades County,5,17,275,128,147
50,12,43,Florida,Glades County,5,18,159,65,94
50,12,43,Florida,Glades County,5,99,11514,6434,5080
50,12,43,Florida,Glades County,6,0,114,56,58
50,12,43,Florida,Glades County,6,1,568,314,254
50,12,43,Florida,Glades County,6,2,687,365,322
50,12,43,Florida,Glades County,6,3,741,390,351
50,12,43,Florida,Glades County,6,4,671,362,309
50,12,43,Florida,Glades County,6,5,675,415,260
50,12,43,Florida,Glades County,6,6,746,465,281
50,12,43,Florida,Glades County,6,7,741,434,307
50,12,43,Florida,Glades County,6,8,781,487,294
50,12,43,Florida,Glades County,6,9,795,486,309
50,12,43,Florida,Glades County,6,10,761,442,319
50,12,43,Florida,Glades County,6,11,658,366,292
50,12,43,Florida,Glades County,6,12,741,353,388
50,12,43,Florida,Glades County,6,13,798,408,390
50,12,43,Florida,Glades County,6,14,779,433,346
50,12,43,Florida,Glades County,6,15,721,412,309
50,12,43,Florida,Glades County,6,16,470,237,233
50,12,43,Florida,Glades County,6,17,293,142,151
50,12,43,Florida,Glades County,6,18,161,75,86
50,12,43,Florida,Glades County,6,99,11901,6642,5259
50,12,43,Florida,Glades County,7,0,136,76,60
50,12,43,Florida,Glades County,7,1,520,277,243
50,12,43,Florida,Glades County,7,2,761,412,349
50,12,43,Florida,Glades County,7,3,753,392,361
50,12,43,Florida,Glades County,7,4,699,383,316
50,12,43,Florida,Glades County,7,5,681,416,265
50,12,43,Florida,Glades County,7,6,774,491,283
50,12,43,Florida,Glades County,7,7,770,438,332
50,12,43,Florida,Glades County,7,8,759,457,302
50,12,43,Florida,Glades County,7,9,846,538,308
50,12,43,Florida,Glades County,7,10,812,475,337
50,12,43,Florida,Glades County,7,11,693,397,296
50,12,43,Florida,Glades County,7,12,777,392,385
50,12,43,Florida,Glades County,7,13,795,386,409
50,12,43,Florida,Glades County,7,14,850,465,385
50,12,43,Florida,Glades County,7,15,709,388,321
50,12,43,Florida,Glades County,7,16,511,280,231
50,12,43,Florida,Glades County,7,17,262,146,116
50,12,43,Florida,Glades County,7,18,176,79,97
50,12,43,Florida,Glades County,7,99,12284,6888,5396
50,12,43,Florida,Glades County,8,0,143,80,63
50,12,43,Florida,Glades County,8,1,503,278,225
50,12,43,Florida,Glades County,8,2,735,406,329
50,12,43,Florida,Glades County,8,3,718,374,344
50,12,43,Florida,Glades County,8,4,748,438,310
50,12,43,Florida,Glades County,8,5,662,402,260
50,12,43,Florida,Glades County,8,6,781,511,270
50,12,43,Florida,Glades County,8,7,722,427,295
50,12,43,Florida,Glades County,8,8,782,475,307
50,12,43,Florida,Glades County,8,9,856,543,313
50,12,43,Florida,Glades County,8,10,835,485,350
50,12,43,Florida,Glades County,8,11,727,414,313
50,12,43,Florida,Glades County,8,12,779,396,383
50,12,43,Florida,Glades County,8,13,856,447,409
50,12,43,Florida,Glades County,8,14,809,437,372
50,12,43,Florida,Glades County,8,15,706,358,348
50,12,43,Florida,Glades County,8,16,512,284,228
50,12,43,Florida,Glades County,8,17,253,152,101
50,12,43,Florida,Glades County,8,18,170,79,91
50,12,43,Florida,Glades County,8,99,12297,6986,5311
50,12,43,Florida,Glades County,9,0,149,84,65
50,12,43,Florida,Glades County,9,1,486,246,240
50,12,43,Florida,Glades County,9,2,739,401,338
50,12,43,Florida,Glades County,9,3,673,366,307
50,12,43,Florida,Glades County,9,4,717,406,311
50,12,43,Florida,Glades County,9,5,660,430,230
50,12,43,Florida,Glades County,9,6,775,497,278
50,12,43,Florida,Glades County,9,7,700,427,273
50,12,43,Florida,Glades County,9,8,742,472,270
50,12,43,Florida,Glades County,9,9,876,535,341
50,12,43,Florida,Glades County,9,10,853,512,341
50,12,43,Florida,Glades County,9,11,744,412,332
50,12,43,Florida,Glades County,9,12,813,422,391
50,12,43,Florida,Glades County,9,13,876,448,428
50,12,43,Florida,Glades County,9,14,853,451,402
50,12,43,Florida,Glades County,9,15,754,382,372
50,12,43,Florida,Glades County,9,16,505,288,217
50,12,43,Florida,Glades County,9,17,260,155,105
50,12,43,Florida,Glades County,9,18,182,81,101
50,12,43,Florida,Glades County,9,99,12357,7015,5342
50,12,43,Florida,Glades County,10,0,138,74,64
50,12,43,Florida,Glades County,10,1,549,293,256
50,12,43,Florida,Glades County,10,2,653,359,294
50,12,43,Florida,Glades County,10,3,710,382,328
50,12,43,Florida,Glades County,10,4,727,411,316
50,12,43,Florida,Glades County,10,5,686,453,233
50,12,43,Florida,Glades County,10,6,853,574,279
50,12,43,Florida,Glades County,10,7,800,488,312
50,12,43,Florida,Glades County,10,8,792,535,257
50,12,43,Florida,Glades County,10,9,900,556,344
50,12,43,Florida,Glades County,10,10,854,523,331
50,12,43,Florida,Glades County,10,11,790,463,327
50,12,43,Florida,Glades County,10,12,807,434,373
50,12,43,Florida,Glades County,10,13,859,438,421
50,12,43,Florida,Glades County,10,14,877,455,422
50,12,43,Florida,Glades County,10,15,777,392,385
50,12,43,Florida,Glades County,10,16,517,296,221
50,12,43,Florida,Glades County,10,17,286,161,125
50,12,43,Florida,Glades County,10,18,177,78,99
50,12,43,Florida,Glades County,10,99,12752,7365,5387
50,12,43,Florida,Glades County,11,0,136,66,70
50,12,43,Florida,Glades County,11,1,571,293,278
50,12,43,Florida,Glades County,11,2,629,320,309
50,12,43,Florida,Glades County,11,3,662,346,316
50,12,43,Florida,Glades County,11,4,705,410,295
50,12,43,Florida,Glades County,11,5,710,450,260
50,12,43,Florida,Glades County,11,6,849,572,277
50,12,43,Florida,Glades County,11,7,758,487,271
50,12,43,Florida,Glades County,11,8,794,539,255
50,12,43,Florida,Glades County,11,9,889,563,326
50,12,43,Florida,Glades County,11,10,878,544,334
50,12,43,Florida,Glades County,11,11,822,489,333
50,12,43,Florida,Glades County,11,12,832,443,389
50,12,43,Florida,Glades County,11,13,867,441,426
50,12,43,Florida,Glades County,11,14,911,474,437
50,12,43,Florida,Glades County,11,15,798,397,401
50,12,43,Florida,Glades County,11,16,526,301,225
50,12,43,Florida,Glades County,11,17,328,177,151
50,12,43,Florida,Glades County,11,18,174,71,103
50,12,43,Florida,Glades County,11,99,12839,7383,5456
50,12,43,Florida,Glades County,12,0,133,65,68
50,12,43,Florida,Glades County,12,1,585,292,293
50,12,43,Florida,Glades County,12,2,645,330,315
50,12,43,Florida,Glades County,12,3,661,354,307
50,12,43,Florida,Glades County,12,4,687,397,290
50,12,43,Florida,Glades County,12,5,718,454,264
50,12,43,Florida,Glades County,12,6,896,599,297
50,12,43,Florida,Glades County,12,7,778,525,253
50,12,43,Florida,Glades County,12,8,806,555,251
50,12,43,Florida,Glades County,12,9,856,525,331
50,12,43,Florida,Glades County,12,10,859,540,319
50,12,43,Florida,Glades County,12,11,810,482,328
50,12,43,Florida,Glades County,12,12,854,449,405
50,12,43,Florida,Glades County,12,13,829,436,393
50,12,43,Florida,Glades County,12,14,907,458,449
50,12,43,Florida,Glades County,12,15,821,433,388
50,12,43,Florida,Glades County,12,16,520,286,234
50,12,43,Florida,Glades County,12,17,333,180,153
50,12,43,Florida,Glades County,12,18,186,83,103
50,12,43,Florida,Glades County,12,99,12884,7443,5441
50,12,43,Florida,Glades County,13,0,122,58,64
50,12,43,Florida,Glades County,13,1,582,293,289
50,12,43,Florida,Glades County,13,2,638,329,309
50,12,43,Florida,Glades County,13,3,657,356,301
50,12,43,Florida,Glades County,13,4,686,395,291
50,12,43,Florida,Glades County,13,5,713,456,257
50,12,43,Florida,Glades County,13,6,889,592,297
50,12,43,Florida,Glades County,13,7,773,525,248
50,12,43,Florida,Glades County,13,8,811,557,254
50,12,43,Florida,Glades County,13,9,858,524,334
50,12,43,Florida,Glades County,13,10,858,543,315
50,12,43,Florida,Glades County,13,11,808,483,325
50,12,43,Florida,Glades County,13,12,850,445,405
50,12,43,Florida,Glades County,13,13,832,439,393
50,12,43,Florida,Glades County,13,14,913,458,455
50,12,43,Florida,Glades County,13,15,818,431,387
50,12,43,Florida,Glades County,13,16,514,279,235
50,12,43,Florida,Glades County,13,17,332,180,152
50,12,43,Florida,Glades County,13,18,188,85,103
50,12,43,Florida,Glades County,13,99,12842,7428,5414
50,12,45,Florida,Gulf County,1,0,137,71,66
50,12,45,Florida,Gulf County,1,1,537,289,248
50,12,45,Florida,Gulf County,1,2,807,424,383
50,12,45,Florida,Gulf County,1,3,869,427,442
50,12,45,Florida,Gulf County,1,4,826,450,376
50,12,45,Florida,Gulf County,1,5,763,480,283
50,12,45,Florida,Gulf County,1,6,1070,770,300
50,12,45,Florida,Gulf County,1,7,1081,730,351
50,12,45,Florida,Gulf County,1,8,1343,899,444
50,12,45,Florida,Gulf County,1,9,1271,806,465
50,12,45,Florida,Gulf County,1,10,1104,644,460
50,12,45,Florida,Gulf County,1,11,953,519,434
50,12,45,Florida,Gulf County,1,12,838,437,401
50,12,45,Florida,Gulf County,1,13,781,383,398
50,12,45,Florida,Gulf County,1,14,694,367,327
50,12,45,Florida,Gulf County,1,15,596,289,307
50,12,45,Florida,Gulf County,1,16,419,178,241
50,12,45,Florida,Gulf County,1,17,258,108,150
50,12,45,Florida,Gulf County,1,18,201,67,134
50,12,45,Florida,Gulf County,1,99,14548,8338,6210
50,12,45,Florida,Gulf County,2,0,137,71,66
50,12,45,Florida,Gulf County,2,1,535,287,248
50,12,45,Florida,Gulf County,2,2,805,422,383
50,12,45,Florida,Gulf County,2,3,881,432,449
50,12,45,Florida,Gulf County,2,4,835,456,379
50,12,45,Florida,Gulf County,2,5,771,485,286
50,12,45,Florida,Gulf County,2,6,1063,766,297
50,12,45,Florida,Gulf County,2,7,1076,725,351
50,12,45,Florida,Gulf County,2,8,1328,889,439
50,12,45,Florida,Gulf County,2,9,1264,800,464
50,12,45,Florida,Gulf County,2,10,1109,646,463
50,12,45,Florida,Gulf County,2,11,957,521,436
50,12,45,Florida,Gulf County,2,12,842,439,403
50,12,45,Florida,Gulf County,2,13,782,383,399
50,12,45,Florida,Gulf County,2,14,699,372,327
50,12,45,Florida,Gulf County,2,15,601,292,309
50,12,45,Florida,Gulf County,2,16,423,177,246
50,12,45,Florida,Gulf County,2,17,257,108,149
50,12,45,Florida,Gulf County,2,18,201,68,133
50,12,45,Florida,Gulf County,2,99,14566,8339,6227
50,12,45,Florida,Gulf County,3,0,115,60,55
50,12,45,Florida,Gulf County,3,1,509,264,245
50,12,45,Florida,Gulf County,3,2,761,403,358
50,12,45,Florida,Gulf County,3,3,881,419,462
50,12,45,Florida,Gulf County,3,4,816,466,350
50,12,45,Florida,Gulf County,3,5,821,540,281
50,12,45,Florida,Gulf County,3,6,1110,821,289
50,12,45,Florida,Gulf County,3,7,1088,760,328
50,12,45,Florida,Gulf County,3,8,1323,916,407
50,12,45,Florida,Gulf County,3,9,1346,865,481
50,12,45,Florida,Gulf County,3,10,1147,699,448
50,12,45,Florida,Gulf County,3,11,1037,568,469
50,12,45,Florida,Gulf County,3,12,838,445,393
50,12,45,Florida,Gulf County,3,13,847,418,429
50,12,45,Florida,Gulf County,3,14,753,398,355
50,12,45,Florida,Gulf County,3,15,576,277,299
50,12,45,Florida,Gulf County,3,16,446,192,254
50,12,45,Florida,Gulf County,3,17,248,100,148
50,12,45,Florida,Gulf County,3,18,206,74,132
50,12,45,Florida,Gulf County,3,99,14868,8685,6183
50,12,45,Florida,Gulf County,4,0,110,53,57
50,12,45,Florida,Gulf County,4,1,519,268,251
50,12,45,Florida,Gulf County,4,2,770,413,357
50,12,45,Florida,Gulf County,4,3,886,422,464
50,12,45,Florida,Gulf County,4,4,828,458,370
50,12,45,Florida,Gulf County,4,5,849,581,268
50,12,45,Florida,Gulf County,4,6,1054,778,276
50,12,45,Florida,Gulf County,4,7,1098,767,331
50,12,45,Florida,Gulf County,4,8,1279,867,412
50,12,45,Florida,Gulf County,4,9,1322,843,479
50,12,45,Florida,Gulf County,4,10,1157,716,441
50,12,45,Florida,Gulf County,4,11,1039,577,462
50,12,45,Florida,Gulf County,4,12,894,467,427
50,12,45,Florida,Gulf County,4,13,824,399,425
50,12,45,Florida,Gulf County,4,14,768,415,353
50,12,45,Florida,Gulf County,4,15,568,257,311
50,12,45,Florida,Gulf County,4,16,453,194,259
50,12,45,Florida,Gulf County,4,17,271,113,158
50,12,45,Florida,Gulf County,4,18,208,68,140
50,12,45,Florida,Gulf County,4,99,14897,8656,6241
50,12,45,Florida,Gulf County,5,0,126,60,66
50,12,45,Florida,Gulf County,5,1,510,260,250
50,12,45,Florida,Gulf County,5,2,738,390,348
50,12,45,Florida,Gulf County,5,3,901,455,446
50,12,45,Florida,Gulf County,5,4,823,437,386
50,12,45,Florida,Gulf County,5,5,878,615,263
50,12,45,Florida,Gulf County,5,6,1067,813,254
50,12,45,Florida,Gulf County,5,7,1126,807,319
50,12,45,Florida,Gulf County,5,8,1282,873,409
50,12,45,Florida,Gulf County,5,9,1359,884,475
50,12,45,Florida,Gulf County,5,10,1225,762,463
50,12,45,Florida,Gulf County,5,11,1072,603,469
50,12,45,Florida,Gulf County,5,12,974,529,445
50,12,45,Florida,Gulf County,5,13,850,422,428
50,12,45,Florida,Gulf County,5,14,755,377,378
50,12,45,Florida,Gulf County,5,15,620,291,329
50,12,45,Florida,Gulf County,5,16,477,228,249
50,12,45,Florida,Gulf County,5,17,262,104,158
50,12,45,Florida,Gulf County,5,18,221,75,146
50,12,45,Florida,Gulf County,5,99,15266,8985,6281
50,12,45,Florida,Gulf County,6,0,120,54,66
50,12,45,Florida,Gulf County,6,1,516,269,247
50,12,45,Florida,Gulf County,6,2,721,372,349
50,12,45,Florida,Gulf County,6,3,907,472,435
50,12,45,Florida,Gulf County,6,4,823,442,381
50,12,45,Florida,Gulf County,6,5,927,644,283
50,12,45,Florida,Gulf County,6,6,1124,845,279
50,12,45,Florida,Gulf County,6,7,1147,828,319
50,12,45,Florida,Gulf County,6,8,1206,834,372
50,12,45,Florida,Gulf County,6,9,1383,896,487
50,12,45,Florida,Gulf County,6,10,1269,789,480
50,12,45,Florida,Gulf County,6,11,1063,587,476
50,12,45,Florida,Gulf County,6,12,1015,572,443
50,12,45,Florida,Gulf County,6,13,876,438,438
50,12,45,Florida,Gulf County,6,14,759,378,381
50,12,45,Florida,Gulf County,6,15,652,319,333
50,12,45,Florida,Gulf County,6,16,463,227,236
50,12,45,Florida,Gulf County,6,17,264,96,168
50,12,45,Florida,Gulf County,6,18,220,75,145
50,12,45,Florida,Gulf County,6,99,15455,9137,6318
50,12,45,Florida,Gulf County,7,0,143,64,79
50,12,45,Florida,Gulf County,7,1,528,275,253
50,12,45,Florida,Gulf County,7,2,728,380,348
50,12,45,Florida,Gulf County,7,3,876,463,413
50,12,45,Florida,Gulf County,7,4,825,425,400
50,12,45,Florida,Gulf County,7,5,972,690,282
50,12,45,Florida,Gulf County,7,6,1193,883,310
50,12,45,Florida,Gulf County,7,7,1171,858,313
50,12,45,Florida,Gulf County,7,8,1229,857,372
50,12,45,Florida,Gulf County,7,9,1412,938,474
50,12,45,Florida,Gulf County,7,10,1300,805,495
50,12,45,Florida,Gulf County,7,11,1113,626,487
50,12,45,Florida,Gulf County,7,12,1070,590,480
50,12,45,Florida,Gulf County,7,13,830,437,393
50,12,45,Florida,Gulf County,7,14,807,384,423
50,12,45,Florida,Gulf County,7,15,632,320,312
50,12,45,Florida,Gulf County,7,16,461,227,234
50,12,45,Florida,Gulf County,7,17,272,87,185
50,12,45,Florida,Gulf County,7,18,219,84,135
50,12,45,Florida,Gulf County,7,99,15781,9393,6388
50,12,45,Florida,Gulf County,8,0,124,64,60
50,12,45,Florida,Gulf County,8,1,543,270,273
50,12,45,Florida,Gulf County,8,2,747,375,372
50,12,45,Florida,Gulf County,8,3,873,457,416
50,12,45,Florida,Gulf County,8,4,825,418,407
50,12,45,Florida,Gulf County,8,5,901,654,247
50,12,45,Florida,Gulf County,8,6,1225,892,333
50,12,45,Florida,Gulf County,8,7,1172,840,332
50,12,45,Florida,Gulf County,8,8,1211,818,393
50,12,45,Florida,Gulf County,8,9,1366,913,453
50,12,45,Florida,Gulf County,8,10,1320,822,498
50,12,45,Florida,Gulf County,8,11,1149,661,488
50,12,45,Florida,Gulf County,8,12,1101,586,515
50,12,45,Florida,Gulf County,8,13,865,459,406
50,12,45,Florida,Gulf County,8,14,832,413,419
50,12,45,Florida,Gulf County,8,15,637,313,324
50,12,45,Florida,Gulf County,8,16,444,206,238
50,12,45,Florida,Gulf County,8,17,288,106,182
50,12,45,Florida,Gulf County,8,18,233,78,155
50,12,45,Florida,Gulf County,8,99,15856,9345,6511
50,12,45,Florida,Gulf County,9,0,143,66,77
50,12,45,Florida,Gulf County,9,1,560,283,277
50,12,45,Florida,Gulf County,9,2,709,355,354
50,12,45,Florida,Gulf County,9,3,838,455,383
50,12,45,Florida,Gulf County,9,4,816,413,403
50,12,45,Florida,Gulf County,9,5,940,675,265
50,12,45,Florida,Gulf County,9,6,1232,910,322
50,12,45,Florida,Gulf County,9,7,1152,820,332
50,12,45,Florida,Gulf County,9,8,1192,827,365
50,12,45,Florida,Gulf County,9,9,1334,884,450
50,12,45,Florida,Gulf County,9,10,1340,840,500
50,12,45,Florida,Gulf County,9,11,1148,672,476
50,12,45,Florida,Gulf County,9,12,1125,610,515
50,12,45,Florida,Gulf County,9,13,923,488,435
50,12,45,Florida,Gulf County,9,14,835,423,412
50,12,45,Florida,Gulf County,9,15,643,320,323
50,12,45,Florida,Gulf County,9,16,433,193,240
50,12,45,Florida,Gulf County,9,17,316,127,189
50,12,45,Florida,Gulf County,9,18,229,84,145
50,12,45,Florida,Gulf County,9,99,15908,9445,6463
50,12,45,Florida,Gulf County,10,0,145,60,85
50,12,45,Florida,Gulf County,10,1,541,261,280
50,12,45,Florida,Gulf County,10,2,699,348,351
50,12,45,Florida,Gulf County,10,3,810,426,384
50,12,45,Florida,Gulf County,10,4,817,417,400
50,12,45,Florida,Gulf County,10,5,933,658,275
50,12,45,Florida,Gulf County,10,6,1209,916,293
50,12,45,Florida,Gulf County,10,7,1102,798,304
50,12,45,Florida,Gulf County,10,8,1178,814,364
50,12,45,Florida,Gulf County,10,9,1302,867,435
50,12,45,Florida,Gulf County,10,10,1329,842,487
50,12,45,Florida,Gulf County,10,11,1177,684,493
50,12,45,Florida,Gulf County,10,12,1136,623,513
50,12,45,Florida,Gulf County,10,13,982,522,460
50,12,45,Florida,Gulf County,10,14,837,414,423
50,12,45,Florida,Gulf County,10,15,648,310,338
50,12,45,Florida,Gulf County,10,16,452,214,238
50,12,45,Florida,Gulf County,10,17,342,152,190
50,12,45,Florida,Gulf County,10,18,212,69,143
50,12,45,Florida,Gulf County,10,99,15851,9395,6456
50,12,45,Florida,Gulf County,11,0,125,55,70
50,12,45,Florida,Gulf County,11,1,556,265,291
50,12,45,Florida,Gulf County,11,2,652,336,316
50,12,45,Florida,Gulf County,11,3,825,441,384
50,12,45,Florida,Gulf County,11,4,803,420,383
50,12,45,Florida,Gulf County,11,5,930,672,258
50,12,45,Florida,Gulf County,11,6,1252,957,295
50,12,45,Florida,Gulf County,11,7,1138,838,300
50,12,45,Florida,Gulf County,11,8,1172,816,356
50,12,45,Florida,Gulf County,11,9,1268,860,408
50,12,45,Florida,Gulf County,11,10,1334,864,470
50,12,45,Florida,Gulf County,11,11,1200,713,487
50,12,45,Florida,Gulf County,11,12,1111,590,521
50,12,45,Florida,Gulf County,11,13,1017,545,472
50,12,45,Florida,Gulf County,11,14,869,441,428
50,12,45,Florida,Gulf County,11,15,621,295,326
50,12,45,Florida,Gulf County,11,16,487,234,253
50,12,45,Florida,Gulf County,11,17,339,152,187
50,12,45,Florida,Gulf County,11,18,234,77,157
50,12,45,Florida,Gulf County,11,99,15933,9571,6362
50,12,45,Florida,Gulf County,12,0,119,53,66
50,12,45,Florida,Gulf County,12,1,530,259,271
50,12,45,Florida,Gulf County,12,2,649,324,325
50,12,45,Florida,Gulf County,12,3,808,426,382
50,12,45,Florida,Gulf County,12,4,752,403,349
50,12,45,Florida,Gulf County,12,5,926,652,274
50,12,45,Florida,Gulf County,12,6,1206,932,274
50,12,45,Florida,Gulf County,12,7,1154,831,323
50,12,45,Florida,Gulf County,12,8,1125,785,340
50,12,45,Florida,Gulf County,12,9,1241,828,413
50,12,45,Florida,Gulf County,12,10,1358,886,472
50,12,45,Florida,Gulf County,12,11,1215,715,500
50,12,45,Florida,Gulf County,12,12,1139,619,520
50,12,45,Florida,Gulf County,12,13,1054,552,502
50,12,45,Florida,Gulf County,12,14,854,444,410
50,12,45,Florida,Gulf County,12,15,652,299,353
50,12,45,Florida,Gulf County,12,16,488,244,244
50,12,45,Florida,Gulf County,12,17,349,149,200
50,12,45,Florida,Gulf County,12,18,244,83,161
50,12,45,Florida,Gulf County,12,99,15863,9484,6379
50,12,45,Florida,Gulf County,13,0,117,52,65
50,12,45,Florida,Gulf County,13,1,546,267,279
50,12,45,Florida,Gulf County,13,2,636,321,315
50,12,45,Florida,Gulf County,13,3,806,428,378
50,12,45,Florida,Gulf County,13,4,754,400,354
50,12,45,Florida,Gulf County,13,5,921,652,269
50,12,45,Florida,Gulf County,13,6,1208,934,274
50,12,45,Florida,Gulf County,13,7,1156,834,322
50,12,45,Florida,Gulf County,13,8,1117,786,331
50,12,45,Florida,Gulf County,13,9,1243,827,416
50,12,45,Florida,Gulf County,13,10,1352,884,468
50,12,45,Florida,Gulf County,13,11,1212,713,499
50,12,45,Florida,Gulf County,13,12,1142,621,521
50,12,45,Florida,Gulf County,13,13,1055,554,501
50,12,45,Florida,Gulf County,13,14,855,443,412
50,12,45,Florida,Gulf County,13,15,651,300,351
50,12,45,Florida,Gulf County,13,16,483,238,245
50,12,45,Florida,Gulf County,13,17,348,148,200
50,12,45,Florida,Gulf County,13,18,245,84,161
50,12,45,Florida,Gulf County,13,99,15847,9486,6361
50,12,47,Florida,Hamilton County,1,0,189,89,100
50,12,47,Florida,Hamilton County,1,1,650,346,304
50,12,47,Florida,Hamilton County,1,2,821,407,414
50,12,47,Florida,Hamilton County,1,3,888,449,439
50,12,47,Florida,Hamilton County,1,4,919,523,396
50,12,47,Florida,Hamilton County,1,5,1100,774,326
50,12,47,Florida,Hamilton County,1,6,1002,648,354
50,12,47,Florida,Hamilton County,1,7,1077,687,390
50,12,47,Florida,Hamilton County,1,8,1099,717,382
50,12,47,Florida,Hamilton County,1,9,1054,652,402
50,12,47,Florida,Hamilton County,1,10,1000,585,415
50,12,47,Florida,Hamilton County,1,11,845,471,374
50,12,47,Florida,Hamilton County,1,12,642,368,274
50,12,47,Florida,Hamilton County,1,13,546,279,267
50,12,47,Florida,Hamilton County,1,14,487,243,244
50,12,47,Florida,Hamilton County,1,15,366,176,190
50,12,47,Florida,Hamilton County,1,16,272,120,152
50,12,47,Florida,Hamilton County,1,17,193,80,113
50,12,47,Florida,Hamilton County,1,18,171,40,131
50,12,47,Florida,Hamilton County,1,99,13321,7654,5667
50,12,47,Florida,Hamilton County,2,0,189,89,100
50,12,47,Florida,Hamilton County,2,1,646,344,302
50,12,47,Florida,Hamilton County,2,2,817,404,413
50,12,47,Florida,Hamilton County,2,3,879,444,435
50,12,47,Florida,Hamilton County,2,4,918,532,386
50,12,47,Florida,Hamilton County,2,5,1106,780,326
50,12,47,Florida,Hamilton County,2,6,998,646,352
50,12,47,Florida,Hamilton County,2,7,1078,688,390
50,12,47,Florida,Hamilton County,2,8,1096,713,383
50,12,47,Florida,Hamilton County,2,9,1053,652,401
50,12,47,Florida,Hamilton County,2,10,1006,589,417
50,12,47,Florida,Hamilton County,2,11,855,477,378
50,12,47,Florida,Hamilton County,2,12,643,369,274
50,12,47,Florida,Hamilton County,2,13,549,282,267
50,12,47,Florida,Hamilton County,2,14,488,243,245
50,12,47,Florida,Hamilton County,2,15,370,176,194
50,12,47,Florida,Hamilton County,2,16,279,120,159
50,12,47,Florida,Hamilton County,2,17,193,80,113
50,12,47,Florida,Hamilton County,2,18,167,39,128
50,12,47,Florida,Hamilton County,2,99,13330,7667,5663
50,12,47,Florida,Hamilton County,3,0,167,95,72
50,12,47,Florida,Hamilton County,3,1,666,330,336
50,12,47,Florida,Hamilton County,3,2,819,430,389
50,12,47,Florida,Hamilton County,3,3,871,438,433
50,12,47,Florida,Hamilton County,3,4,972,576,396
50,12,47,Florida,Hamilton County,3,5,1187,847,340
50,12,47,Florida,Hamilton County,3,6,1034,711,323
50,12,47,Florida,Hamilton County,3,7,1123,701,422
50,12,47,Florida,Hamilton County,3,8,1127,760,367
50,12,47,Florida,Hamilton County,3,9,1063,666,397
50,12,47,Florida,Hamilton County,3,10,1032,608,424
50,12,47,Florida,Hamilton County,3,11,899,509,390
50,12,47,Florida,Hamilton County,3,12,693,396,297
50,12,47,Florida,Hamilton County,3,13,569,293,276
50,12,47,Florida,Hamilton County,3,14,480,234,246
50,12,47,Florida,Hamilton County,3,15,371,181,190
50,12,47,Florida,Hamilton County,3,16,296,135,161
50,12,47,Florida,Hamilton County,3,17,199,82,117
50,12,47,Florida,Hamilton County,3,18,165,44,121
50,12,47,Florida,Hamilton County,3,99,13733,8036,5697
50,12,47,Florida,Hamilton County,4,0,168,94,74
50,12,47,Florida,Hamilton County,4,1,650,323,327
50,12,47,Florida,Hamilton County,4,2,804,421,383
50,12,47,Florida,Hamilton County,4,3,864,431,433
50,12,47,Florida,Hamilton County,4,4,954,553,401
50,12,47,Florida,Hamilton County,4,5,1225,912,313
50,12,47,Florida,Hamilton County,4,6,1043,709,334
50,12,47,Florida,Hamilton County,4,7,1072,687,385
50,12,47,Florida,Hamilton County,4,8,1109,749,360
50,12,47,Florida,Hamilton County,4,9,1052,671,381
50,12,47,Florida,Hamilton County,4,10,1057,619,438
50,12,47,Florida,Hamilton County,4,11,899,517,382
50,12,47,Florida,Hamilton County,4,12,807,444,363
50,12,47,Florida,Hamilton County,4,13,571,293,278
50,12,47,Florida,Hamilton County,4,14,490,256,234
50,12,47,Florida,Hamilton County,4,15,372,172,200
50,12,47,Florida,Hamilton County,4,16,297,134,163
50,12,47,Florida,Hamilton County,4,17,206,87,119
50,12,47,Florida,Hamilton County,4,18,155,44,111
50,12,47,Florida,Hamilton County,4,99,13795,8116,5679
50,12,47,Florida,Hamilton County,5,0,154,78,76
50,12,47,Florida,Hamilton County,5,1,668,337,331
50,12,47,Florida,Hamilton County,5,2,792,414,378
50,12,47,Florida,Hamilton County,5,3,851,440,411
50,12,47,Florida,Hamilton County,5,4,947,558,389
50,12,47,Florida,Hamilton County,5,5,1296,947,349
50,12,47,Florida,Hamilton County,5,6,1077,755,322
50,12,47,Florida,Hamilton County,5,7,1033,664,369
50,12,47,Florida,Hamilton County,5,8,1083,739,344
50,12,47,Florida,Hamilton County,5,9,1044,658,386
50,12,47,Florida,Hamilton County,5,10,1081,628,453
50,12,47,Florida,Hamilton County,5,11,943,560,383
50,12,47,Florida,Hamilton County,5,12,864,471,393
50,12,47,Florida,Hamilton County,5,13,603,314,289
50,12,47,Florida,Hamilton County,5,14,521,263,258
50,12,47,Florida,Hamilton County,5,15,372,182,190
50,12,47,Florida,Hamilton County,5,16,293,125,168
50,12,47,Florida,Hamilton County,5,17,225,85,140
50,12,47,Florida,Hamilton County,5,18,163,48,115
50,12,47,Florida,Hamilton County,5,99,14010,8266,5744
50,12,47,Florida,Hamilton County,6,0,174,96,78
50,12,47,Florida,Hamilton County,6,1,638,335,303
50,12,47,Florida,Hamilton County,6,2,774,410,364
50,12,47,Florida,Hamilton County,6,3,848,430,418
50,12,47,Florida,Hamilton County,6,4,917,530,387
50,12,47,Florida,Hamilton County,6,5,1361,1029,332
50,12,47,Florida,Hamilton County,6,6,1091,764,327
50,12,47,Florida,Hamilton County,6,7,1036,685,351
50,12,47,Florida,Hamilton County,6,8,1089,731,358
50,12,47,Florida,Hamilton County,6,9,1010,634,376
50,12,47,Florida,Hamilton County,6,10,1068,646,422
50,12,47,Florida,Hamilton County,6,11,976,557,419
50,12,47,Florida,Hamilton County,6,12,891,491,400
50,12,47,Florida,Hamilton County,6,13,653,356,297
50,12,47,Florida,Hamilton County,6,14,542,271,271
50,12,47,Florida,Hamilton County,6,15,375,179,196
50,12,47,Florida,Hamilton County,6,16,279,122,157
50,12,47,Florida,Hamilton County,6,17,209,80,129
50,12,47,Florida,Hamilton County,6,18,170,47,123
50,12,47,Florida,Hamilton County,6,99,14101,8393,5708
50,12,47,Florida,Hamilton County,7,0,177,93,84
50,12,47,Florida,Hamilton County,7,1,620,354,266
50,12,47,Florida,Hamilton County,7,2,751,390,361
50,12,47,Florida,Hamilton County,7,3,825,418,407
50,12,47,Florida,Hamilton County,7,4,943,554,389
50,12,47,Florida,Hamilton County,7,5,1336,1019,317
50,12,47,Florida,Hamilton County,7,6,1048,733,315
50,12,47,Florida,Hamilton County,7,7,978,652,326
50,12,47,Florida,Hamilton County,7,8,1038,665,373
50,12,47,Florida,Hamilton County,7,9,1001,651,350
50,12,47,Florida,Hamilton County,7,10,1056,645,411
50,12,47,Florida,Hamilton County,7,11,993,563,430
50,12,47,Florida,Hamilton County,7,12,933,501,432
50,12,47,Florida,Hamilton County,7,13,699,380,319
50,12,47,Florida,Hamilton County,7,14,537,263,274
50,12,47,Florida,Hamilton County,7,15,404,192,212
50,12,47,Florida,Hamilton County,7,16,293,134,159
50,12,47,Florida,Hamilton County,7,17,221,83,138
50,12,47,Florida,Hamilton County,7,18,164,47,117
50,12,47,Florida,Hamilton County,7,99,14017,8337,5680
50,12,47,Florida,Hamilton County,8,0,169,75,94
50,12,47,Florida,Hamilton County,8,1,640,348,292
50,12,47,Florida,Hamilton County,8,2,793,404,389
50,12,47,Florida,Hamilton County,8,3,822,432,390
50,12,47,Florida,Hamilton County,8,4,997,578,419
50,12,47,Florida,Hamilton County,8,5,1386,1059,327
50,12,47,Florida,Hamilton County,8,6,1074,728,346
50,12,47,Florida,Hamilton County,8,7,980,646,334
50,12,47,Florida,Hamilton County,8,8,1032,659,373
50,12,47,Florida,Hamilton County,8,9,1037,678,359
50,12,47,Florida,Hamilton County,8,10,1077,648,429
50,12,47,Florida,Hamilton County,8,11,1039,587,452
50,12,47,Florida,Hamilton County,8,12,972,528,444
50,12,47,Florida,Hamilton County,8,13,740,387,353
50,12,47,Florida,Hamilton County,8,14,578,282,296
50,12,47,Florida,Hamilton County,8,15,428,193,235
50,12,47,Florida,Hamilton County,8,16,296,149,147
50,12,47,Florida,Hamilton County,8,17,195,73,122
50,12,47,Florida,Hamilton County,8,18,175,45,130
50,12,47,Florida,Hamilton County,8,99,14430,8499,5931
50,12,47,Florida,Hamilton County,9,0,158,82,76
50,12,47,Florida,Hamilton County,9,1,636,334,302
50,12,47,Florida,Hamilton County,9,2,812,414,398
50,12,47,Florida,Hamilton County,9,3,824,435,389
50,12,47,Florida,Hamilton County,9,4,1004,589,415
50,12,47,Florida,Hamilton County,9,5,1424,1081,343
50,12,47,Florida,Hamilton County,9,6,1087,764,323
50,12,47,Florida,Hamilton County,9,7,955,630,325
50,12,47,Florida,Hamilton County,9,8,1038,646,392
50,12,47,Florida,Hamilton County,9,9,988,644,344
50,12,47,Florida,Hamilton County,9,10,1067,652,415
50,12,47,Florida,Hamilton County,9,11,1085,626,459
50,12,47,Florida,Hamilton County,9,12,947,521,426
50,12,47,Florida,Hamilton County,9,13,802,422,380
50,12,47,Florida,Hamilton County,9,14,584,289,295
50,12,47,Florida,Hamilton County,9,15,450,218,232
50,12,47,Florida,Hamilton County,9,16,328,154,174
50,12,47,Florida,Hamilton County,9,17,213,75,138
50,12,47,Florida,Hamilton County,9,18,187,62,125
50,12,47,Florida,Hamilton County,9,99,14589,8638,5951
50,12,47,Florida,Hamilton County,10,0,151,82,69
50,12,47,Florida,Hamilton County,10,1,675,327,348
50,12,47,Florida,Hamilton County,10,2,796,414,382
50,12,47,Florida,Hamilton County,10,3,803,429,374
50,12,47,Florida,Hamilton County,10,4,1014,593,421
50,12,47,Florida,Hamilton County,10,5,1441,1103,338
50,12,47,Florida,Hamilton County,10,6,1102,783,319
50,12,47,Florida,Hamilton County,10,7,921,607,314
50,12,47,Florida,Hamilton County,10,8,1038,639,399
50,12,47,Florida,Hamilton County,10,9,979,635,344
50,12,47,Florida,Hamilton County,10,10,1075,644,431
50,12,47,Florida,Hamilton County,10,11,1123,637,486
50,12,47,Florida,Hamilton County,10,12,956,536,420
50,12,47,Florida,Hamilton County,10,13,837,423,414
50,12,47,Florida,Hamilton County,10,14,646,325,321
50,12,47,Florida,Hamilton County,10,15,480,214,266
50,12,47,Florida,Hamilton County,10,16,339,182,157
50,12,47,Florida,Hamilton County,10,17,201,87,114
50,12,47,Florida,Hamilton County,10,18,208,60,148
50,12,47,Florida,Hamilton County,10,99,14785,8720,6065
50,12,47,Florida,Hamilton County,11,0,138,78,60
50,12,47,Florida,Hamilton County,11,1,660,325,335
50,12,47,Florida,Hamilton County,11,2,823,437,386
50,12,47,Florida,Hamilton County,11,3,823,440,383
50,12,47,Florida,Hamilton County,11,4,1000,590,410
50,12,47,Florida,Hamilton County,11,5,1488,1134,354
50,12,47,Florida,Hamilton County,11,6,1090,777,313
50,12,47,Florida,Hamilton County,11,7,950,642,308
50,12,47,Florida,Hamilton County,11,8,1003,618,385
50,12,47,Florida,Hamilton County,11,9,971,611,360
50,12,47,Florida,Hamilton County,11,10,1055,631,424
50,12,47,Florida,Hamilton County,11,11,1140,666,474
50,12,47,Florida,Hamilton County,11,12,999,529,470
50,12,47,Florida,Hamilton County,11,13,870,438,432
50,12,47,Florida,Hamilton County,11,14,691,359,332
50,12,47,Florida,Hamilton County,11,15,483,221,262
50,12,47,Florida,Hamilton County,11,16,338,173,165
50,12,47,Florida,Hamilton County,11,17,213,81,132
50,12,47,Florida,Hamilton County,11,18,195,52,143
50,12,47,Florida,Hamilton County,11,99,14930,8802,6128
50,12,47,Florida,Hamilton County,12,0,145,81,64
50,12,47,Florida,Hamilton County,12,1,631,297,334
50,12,47,Florida,Hamilton County,12,2,781,419,362
50,12,47,Florida,Hamilton County,12,3,822,432,390
50,12,47,Florida,Hamilton County,12,4,971,578,393
50,12,47,Florida,Hamilton County,12,5,1519,1162,357
50,12,47,Florida,Hamilton County,12,6,1051,752,299
50,12,47,Florida,Hamilton County,12,7,911,614,297
50,12,47,Florida,Hamilton County,12,8,952,596,356
50,12,47,Florida,Hamilton County,12,9,962,590,372
50,12,47,Florida,Hamilton County,12,10,1050,644,406
50,12,47,Florida,Hamilton County,12,11,1128,668,460
50,12,47,Florida,Hamilton County,12,12,1009,530,479
50,12,47,Florida,Hamilton County,12,13,921,454,467
50,12,47,Florida,Hamilton County,12,14,705,367,338
50,12,47,Florida,Hamilton County,12,15,476,214,262
50,12,47,Florida,Hamilton County,12,16,361,179,182
50,12,47,Florida,Hamilton County,12,17,218,95,123
50,12,47,Florida,Hamilton County,12,18,186,49,137
50,12,47,Florida,Hamilton County,12,99,14799,8721,6078
50,12,47,Florida,Hamilton County,13,0,136,76,60
50,12,47,Florida,Hamilton County,13,1,640,301,339
50,12,47,Florida,Hamilton County,13,2,771,417,354
50,12,47,Florida,Hamilton County,13,3,813,433,380
50,12,47,Florida,Hamilton County,13,4,967,574,393
50,12,47,Florida,Hamilton County,13,5,1514,1162,352
50,12,47,Florida,Hamilton County,13,6,1053,759,294
50,12,47,Florida,Hamilton County,13,7,914,619,295
50,12,47,Florida,Hamilton County,13,8,943,594,349
50,12,47,Florida,Hamilton County,13,9,960,587,373
50,12,47,Florida,Hamilton County,13,10,1052,647,405
50,12,47,Florida,Hamilton County,13,11,1115,666,449
50,12,47,Florida,Hamilton County,13,12,1011,527,484
50,12,47,Florida,Hamilton County,13,13,928,459,469
50,12,47,Florida,Hamilton County,13,14,706,365,341
50,12,47,Florida,Hamilton County,13,15,470,213,257
50,12,47,Florida,Hamilton County,13,16,355,174,181
50,12,47,Florida,Hamilton County,13,17,213,93,120
50,12,47,Florida,Hamilton County,13,18,186,50,136
50,12,47,Florida,Hamilton County,13,99,14747,8716,6031
50,12,49,Florida,Hardee County,1,0,429,212,217
50,12,49,Florida,Hardee County,1,1,1636,841,795
50,12,49,Florida,Hardee County,1,2,2009,1015,994
50,12,49,Florida,Hardee County,1,3,2070,1114,956
50,12,49,Florida,Hardee County,1,4,2198,1219,979
50,12,49,Florida,Hardee County,1,5,2063,1277,786
50,12,49,Florida,Hardee County,1,6,2064,1261,803
50,12,49,Florida,Hardee County,1,7,1853,1119,734
50,12,49,Florida,Hardee County,1,8,1953,1146,807
50,12,49,Florida,Hardee County,1,9,1739,979,760
50,12,49,Florida,Hardee County,1,10,1515,836,679
50,12,49,Florida,Hardee County,1,11,1372,706,666
50,12,49,Florida,Hardee County,1,12,1204,599,605
50,12,49,Florida,Hardee County,1,13,1059,551,508
50,12,49,Florida,Hardee County,1,14,1026,487,539
50,12,49,Florida,Hardee County,1,15,1052,517,535
50,12,49,Florida,Hardee County,1,16,858,409,449
50,12,49,Florida,Hardee County,1,17,429,202,227
50,12,49,Florida,Hardee County,1,18,325,111,214
50,12,49,Florida,Hardee County,1,99,26854,14601,12253
50,12,49,Florida,Hardee County,2,0,435,215,220
50,12,49,Florida,Hardee County,2,1,1623,837,786
50,12,49,Florida,Hardee County,2,2,1991,1006,985
50,12,49,Florida,Hardee County,2,3,2069,1114,955
50,12,49,Florida,Hardee County,2,4,2198,1221,977
50,12,49,Florida,Hardee County,2,5,2070,1283,787
50,12,49,Florida,Hardee County,2,6,2045,1248,797
50,12,49,Florida,Hardee County,2,7,1838,1107,731
50,12,49,Florida,Hardee County,2,8,1935,1132,803
50,12,49,Florida,Hardee County,2,9,1738,977,761
50,12,49,Florida,Hardee County,2,10,1512,835,677
50,12,49,Florida,Hardee County,2,11,1377,708,669
50,12,49,Florida,Hardee County,2,12,1204,600,604
50,12,49,Florida,Hardee County,2,13,1056,550,506
50,12,49,Florida,Hardee County,2,14,1021,486,535
50,12,49,Florida,Hardee County,2,15,1048,516,532
50,12,49,Florida,Hardee County,2,16,854,409,445
50,12,49,Florida,Hardee County,2,17,430,203,227
50,12,49,Florida,Hardee County,2,18,325,111,214
50,12,49,Florida,Hardee County,2,99,26769,14558,12211
50,12,49,Florida,Hardee County,3,0,478,233,245
50,12,49,Florida,Hardee County,3,1,1613,813,800
50,12,49,Florida,Hardee County,3,2,1914,978,936
50,12,49,Florida,Hardee County,3,3,2041,1087,954
50,12,49,Florida,Hardee County,3,4,2107,1168,939
50,12,49,Florida,Hardee County,3,5,2068,1272,796
50,12,49,Florida,Hardee County,3,6,1958,1189,769
50,12,49,Florida,Hardee County,3,7,1800,1080,720
50,12,49,Florida,Hardee County,3,8,1858,1073,785
50,12,49,Florida,Hardee County,3,9,1730,964,766
50,12,49,Florida,Hardee County,3,10,1551,846,705
50,12,49,Florida,Hardee County,3,11,1354,718,636
50,12,49,Florida,Hardee County,3,12,1222,608,614
50,12,49,Florida,Hardee County,3,13,1071,554,517
50,12,49,Florida,Hardee County,3,14,986,469,517
50,12,49,Florida,Hardee County,3,15,988,491,497
50,12,49,Florida,Hardee County,3,16,852,411,441
50,12,49,Florida,Hardee County,3,17,461,214,247
50,12,49,Florida,Hardee County,3,18,326,108,218
50,12,49,Florida,Hardee County,3,99,26378,14276,12102
50,12,49,Florida,Hardee County,4,0,431,226,205
50,12,49,Florida,Hardee County,4,1,1693,851,842
50,12,49,Florida,Hardee County,4,2,1891,959,932
50,12,49,Florida,Hardee County,4,3,1996,1066,930
50,12,49,Florida,Hardee County,4,4,2100,1162,938
50,12,49,Florida,Hardee County,4,5,2219,1353,866
50,12,49,Florida,Hardee County,4,6,2032,1282,750
50,12,49,Florida,Hardee County,4,7,1842,1085,757
50,12,49,Florida,Hardee County,4,8,1876,1110,766
50,12,49,Florida,Hardee County,4,9,1795,989,806
50,12,49,Florida,Hardee County,4,10,1592,876,716
50,12,49,Florida,Hardee County,4,11,1373,733,640
50,12,49,Florida,Hardee County,4,12,1245,622,623
50,12,49,Florida,Hardee County,4,13,1101,577,524
50,12,49,Florida,Hardee County,4,14,986,483,503
50,12,49,Florida,Hardee County,4,15,936,454,482
50,12,49,Florida,Hardee County,4,16,868,422,446
50,12,49,Florida,Hardee County,4,17,481,222,259
50,12,49,Florida,Hardee County,4,18,330,118,212
50,12,49,Florida,Hardee County,4,99,26787,14590,12197
50,12,49,Florida,Hardee County,5,0,487,255,232
50,12,49,Florida,Hardee County,5,1,1662,834,828
50,12,49,Florida,Hardee County,5,2,1875,959,916
50,12,49,Florida,Hardee County,5,3,2005,1054,951
50,12,49,Florida,Hardee County,5,4,2073,1174,899
50,12,49,Florida,Hardee County,5,5,2243,1385,858
50,12,49,Florida,Hardee County,5,6,1978,1220,758
50,12,49,Florida,Hardee County,5,7,1838,1079,759
50,12,49,Florida,Hardee County,5,8,1808,1080,728
50,12,49,Florida,Hardee County,5,9,1791,1027,764
50,12,49,Florida,Hardee County,5,10,1583,836,747
50,12,49,Florida,Hardee County,5,11,1438,769,669
50,12,49,Florida,Hardee County,5,12,1257,630,627
50,12,49,Florida,Hardee County,5,13,1106,571,535
50,12,49,Florida,Hardee County,5,14,1006,523,483
50,12,49,Florida,Hardee County,5,15,921,438,483
50,12,49,Florida,Hardee County,5,16,852,403,449
50,12,49,Florida,Hardee County,5,17,505,229,276
50,12,49,Florida,Hardee County,5,18,337,126,211
50,12,49,Florida,Hardee County,5,99,26765,14592,12173
50,12,49,Florida,Hardee County,6,0,474,230,244
50,12,49,Florida,Hardee County,6,1,1718,869,849
50,12,49,Florida,Hardee County,6,2,1892,961,931
50,12,49,Florida,Hardee County,6,3,1987,1045,942
50,12,49,Florida,Hardee County,6,4,2051,1171,880
50,12,49,Florida,Hardee County,6,5,2232,1377,855
50,12,49,Florida,Hardee County,6,6,1982,1248,734
50,12,49,Florida,Hardee County,6,7,1840,1040,800
50,12,49,Florida,Hardee County,6,8,1751,1046,705
50,12,49,Florida,Hardee County,6,9,1845,1034,811
50,12,49,Florida,Hardee County,6,10,1603,836,767
50,12,49,Florida,Hardee County,6,11,1450,784,666
50,12,49,Florida,Hardee County,6,12,1292,639,653
50,12,49,Florida,Hardee County,6,13,1117,588,529
50,12,49,Florida,Hardee County,6,14,1015,520,495
50,12,49,Florida,Hardee County,6,15,881,403,478
50,12,49,Florida,Hardee County,6,16,849,415,434
50,12,49,Florida,Hardee County,6,17,557,256,301
50,12,49,Florida,Hardee County,6,18,311,121,190
50,12,49,Florida,Hardee County,6,99,26847,14583,12264
50,12,49,Florida,Hardee County,7,0,439,219,220
50,12,49,Florida,Hardee County,7,1,1739,879,860
50,12,49,Florida,Hardee County,7,2,1897,953,944
50,12,49,Florida,Hardee County,7,3,1927,986,941
50,12,49,Florida,Hardee County,7,4,2083,1205,878
50,12,49,Florida,Hardee County,7,5,2197,1352,845
50,12,49,Florida,Hardee County,7,6,2042,1308,734
50,12,49,Florida,Hardee County,7,7,1797,978,819
50,12,49,Florida,Hardee County,7,8,1742,1021,721
50,12,49,Florida,Hardee County,7,9,1794,1007,787
50,12,49,Florida,Hardee County,7,10,1629,832,797
50,12,49,Florida,Hardee County,7,11,1506,826,680
50,12,49,Florida,Hardee County,7,12,1346,682,664
50,12,49,Florida,Hardee County,7,13,1139,567,572
50,12,49,Florida,Hardee County,7,14,1048,549,499
50,12,49,Florida,Hardee County,7,15,911,440,471
50,12,49,Florida,Hardee County,7,16,805,393,412
50,12,49,Florida,Hardee County,7,17,519,241,278
50,12,49,Florida,Hardee County,7,18,314,114,200
50,12,49,Florida,Hardee County,7,99,26874,14552,12322
50,12,49,Florida,Hardee County,8,0,453,223,230
50,12,49,Florida,Hardee County,8,1,1703,851,852
50,12,49,Florida,Hardee County,8,2,2008,1001,1007
50,12,49,Florida,Hardee County,8,3,1929,1008,921
50,12,49,Florida,Hardee County,8,4,2108,1203,905
50,12,49,Florida,Hardee County,8,5,2241,1364,877
50,12,49,Florida,Hardee County,8,6,2102,1311,791
50,12,49,Florida,Hardee County,8,7,1703,911,792
50,12,49,Florida,Hardee County,8,8,1751,1017,734
50,12,49,Florida,Hardee County,8,9,1802,998,804
50,12,49,Florida,Hardee County,8,10,1682,848,834
50,12,49,Florida,Hardee County,8,11,1547,840,707
50,12,49,Florida,Hardee County,8,12,1353,698,655
50,12,49,Florida,Hardee County,8,13,1174,570,604
50,12,49,Florida,Hardee County,8,14,1026,542,484
50,12,49,Florida,Hardee County,8,15,877,407,470
50,12,49,Florida,Hardee County,8,16,775,382,393
50,12,49,Florida,Hardee County,8,17,490,229,261
50,12,49,Florida,Hardee County,8,18,325,106,219
50,12,49,Florida,Hardee County,8,99,27049,14509,12540
50,12,49,Florida,Hardee County,9,0,461,248,213
50,12,49,Florida,Hardee County,9,1,1740,838,902
50,12,49,Florida,Hardee County,9,2,1991,993,998
50,12,49,Florida,Hardee County,9,3,1959,1020,939
50,12,49,Florida,Hardee County,9,4,2163,1249,914
50,12,49,Florida,Hardee County,9,5,2251,1383,868
50,12,49,Florida,Hardee County,9,6,2194,1354,840
50,12,49,Florida,Hardee County,9,7,1668,903,765
50,12,49,Florida,Hardee County,9,8,1784,1043,741
50,12,49,Florida,Hardee County,9,9,1782,993,789
50,12,49,Florida,Hardee County,9,10,1732,886,846
50,12,49,Florida,Hardee County,9,11,1589,869,720
50,12,49,Florida,Hardee County,9,12,1388,732,656
50,12,49,Florida,Hardee County,9,13,1171,578,593
50,12,49,Florida,Hardee County,9,14,1142,613,529
50,12,49,Florida,Hardee County,9,15,898,417,481
50,12,49,Florida,Hardee County,9,16,725,353,372
50,12,49,Florida,Hardee County,9,17,508,236,272
50,12,49,Florida,Hardee County,9,18,343,124,219
50,12,49,Florida,Hardee County,9,99,27489,14832,12657
50,12,49,Florida,Hardee County,10,0,454,243,211
50,12,49,Florida,Hardee County,10,1,1798,901,897
50,12,49,Florida,Hardee County,10,2,2032,1007,1025
50,12,49,Florida,Hardee County,10,3,1996,1054,942
50,12,49,Florida,Hardee County,10,4,2178,1259,919
50,12,49,Florida,Hardee County,10,5,2232,1344,888
50,12,49,Florida,Hardee County,10,6,2210,1347,863
50,12,49,Florida,Hardee County,10,7,1644,853,791
50,12,49,Florida,Hardee County,10,8,1789,1043,746
50,12,49,Florida,Hardee County,10,9,1737,974,763
50,12,49,Florida,Hardee County,10,10,1735,893,842
50,12,49,Florida,Hardee County,10,11,1571,840,731
50,12,49,Florida,Hardee County,10,12,1421,756,665
50,12,49,Florida,Hardee County,10,13,1209,605,604
50,12,49,Florida,Hardee County,10,14,1147,593,554
50,12,49,Florida,Hardee County,10,15,911,452,459
50,12,49,Florida,Hardee County,10,16,681,310,371
50,12,49,Florida,Hardee County,10,17,497,232,265
50,12,49,Florida,Hardee County,10,18,361,134,227
50,12,49,Florida,Hardee County,10,99,27603,14840,12763
50,12,49,Florida,Hardee County,11,0,401,213,188
50,12,49,Florida,Hardee County,11,1,1815,925,890
50,12,49,Florida,Hardee County,11,2,2076,1034,1042
50,12,49,Florida,Hardee County,11,3,2019,1065,954
50,12,49,Florida,Hardee County,11,4,2171,1254,917
50,12,49,Florida,Hardee County,11,5,2210,1337,873
50,12,49,Florida,Hardee County,11,6,2173,1286,887
50,12,49,Florida,Hardee County,11,7,1648,871,777
50,12,49,Florida,Hardee County,11,8,1802,1015,787
50,12,49,Florida,Hardee County,11,9,1691,948,743
50,12,49,Florida,Hardee County,11,10,1796,916,880
50,12,49,Florida,Hardee County,11,11,1585,849,736
50,12,49,Florida,Hardee County,11,12,1454,779,675
50,12,49,Florida,Hardee County,11,13,1195,603,592
50,12,49,Florida,Hardee County,11,14,1159,600,559
50,12,49,Florida,Hardee County,11,15,945,461,484
50,12,49,Florida,Hardee County,11,16,651,300,351
50,12,49,Florida,Hardee County,11,17,482,232,250
50,12,49,Florida,Hardee County,11,18,388,141,247
50,12,49,Florida,Hardee County,11,99,27661,14829,12832
50,12,49,Florida,Hardee County,12,0,410,215,195
50,12,49,Florida,Hardee County,12,1,1817,937,880
50,12,49,Florida,Hardee County,12,2,2173,1076,1097
50,12,49,Florida,Hardee County,12,3,2041,1059,982
50,12,49,Florida,Hardee County,12,4,2178,1256,922
50,12,49,Florida,Hardee County,12,5,2202,1343,859
50,12,49,Florida,Hardee County,12,6,2106,1262,844
50,12,49,Florida,Hardee County,12,7,1664,880,784
50,12,49,Florida,Hardee County,12,8,1775,985,790
50,12,49,Florida,Hardee County,12,9,1687,948,739
50,12,49,Florida,Hardee County,12,10,1757,894,863
50,12,49,Florida,Hardee County,12,11,1597,870,727
50,12,49,Florida,Hardee County,12,12,1462,781,681
50,12,49,Florida,Hardee County,12,13,1287,660,627
50,12,49,Florida,Hardee County,12,14,1152,570,582
50,12,49,Florida,Hardee County,12,15,919,457,462
50,12,49,Florida,Hardee County,12,16,639,303,336
50,12,49,Florida,Hardee County,12,17,479,232,247
50,12,49,Florida,Hardee County,12,18,386,140,246
50,12,49,Florida,Hardee County,12,99,27731,14868,12863
50,12,49,Florida,Hardee County,13,0,406,213,193
50,12,49,Florida,Hardee County,13,1,1820,936,884
50,12,49,Florida,Hardee County,13,2,2177,1080,1097
50,12,49,Florida,Hardee County,13,3,2054,1072,982
50,12,49,Florida,Hardee County,13,4,2176,1251,925
50,12,49,Florida,Hardee County,13,5,2203,1352,851
50,12,49,Florida,Hardee County,13,6,2113,1266,847
50,12,49,Florida,Hardee County,13,7,1663,886,777
50,12,49,Florida,Hardee County,13,8,1780,988,792
50,12,49,Florida,Hardee County,13,9,1695,957,738
50,12,49,Florida,Hardee County,13,10,1760,901,859
50,12,49,Florida,Hardee County,13,11,1600,869,731
50,12,49,Florida,Hardee County,13,12,1458,777,681
50,12,49,Florida,Hardee County,13,13,1301,667,634
50,12,49,Florida,Hardee County,13,14,1164,576,588
50,12,49,Florida,Hardee County,13,15,922,459,463
50,12,49,Florida,Hardee County,13,16,638,300,338
50,12,49,Florida,Hardee County,13,17,482,233,249
50,12,49,Florida,Hardee County,13,18,389,142,247
50,12,49,Florida,Hardee County,13,99,27801,14925,12876
50,12,51,Florida,Hendry County,1,0,579,293,286
50,12,51,Florida,Hendry County,1,1,2243,1170,1073
50,12,51,Florida,Hendry County,1,2,3023,1544,1479
50,12,51,Florida,Hendry County,1,3,3098,1615,1483
50,12,51,Florida,Hendry County,1,4,3353,2067,1286
50,12,51,Florida,Hendry County,1,5,3392,2417,975
50,12,51,Florida,Hendry County,1,6,2702,1588,1114
50,12,51,Florida,Hendry County,1,7,2662,1501,1161
50,12,51,Florida,Hendry County,1,8,2587,1431,1156
50,12,51,Florida,Hendry County,1,9,2286,1245,1041
50,12,51,Florida,Hendry County,1,10,1976,1071,905
50,12,51,Florida,Hendry County,1,11,1804,912,892
50,12,51,Florida,Hendry County,1,12,1489,772,717
50,12,51,Florida,Hendry County,1,13,1353,721,632
50,12,51,Florida,Hendry County,1,14,1147,592,555
50,12,51,Florida,Hendry County,1,15,986,515,471
50,12,51,Florida,Hendry County,1,16,742,347,395
50,12,51,Florida,Hendry County,1,17,428,185,243
50,12,51,Florida,Hendry County,1,18,334,121,213
50,12,51,Florida,Hendry County,1,99,36184,20107,16077
50,12,51,Florida,Hendry County,2,0,587,298,289
50,12,51,Florida,Hendry County,2,1,2228,1164,1064
50,12,51,Florida,Hendry County,2,2,3013,1539,1474
50,12,51,Florida,Hendry County,2,3,3115,1621,1494
50,12,51,Florida,Hendry County,2,4,3352,2059,1293
50,12,51,Florida,Hendry County,2,5,3390,2407,983
50,12,51,Florida,Hendry County,2,6,2702,1590,1112
50,12,51,Florida,Hendry County,2,7,2672,1506,1166
50,12,51,Florida,Hendry County,2,8,2586,1432,1154
50,12,51,Florida,Hendry County,2,9,2293,1251,1042
50,12,51,Florida,Hendry County,2,10,1988,1078,910
50,12,51,Florida,Hendry County,2,11,1823,922,901
50,12,51,Florida,Hendry County,2,12,1496,777,719
50,12,51,Florida,Hendry County,2,13,1353,722,631
50,12,51,Florida,Hendry County,2,14,1153,596,557
50,12,51,Florida,Hendry County,2,15,987,516,471
50,12,51,Florida,Hendry County,2,16,749,351,398
50,12,51,Florida,Hendry County,2,17,432,187,245
50,12,51,Florida,Hendry County,2,18,336,122,214
50,12,51,Florida,Hendry County,2,99,36255,20138,16117
50,12,51,Florida,Hendry County,3,0,647,331,316
50,12,51,Florida,Hendry County,3,1,2191,1136,1055
50,12,51,Florida,Hendry County,3,2,2896,1488,1408
50,12,51,Florida,Hendry County,3,3,3115,1619,1496
50,12,51,Florida,Hendry County,3,4,3305,1959,1346
50,12,51,Florida,Hendry County,3,5,3185,2246,939
50,12,51,Florida,Hendry County,3,6,2619,1555,1064
50,12,51,Florida,Hendry County,3,7,2665,1490,1175
50,12,51,Florida,Hendry County,3,8,2626,1418,1208
50,12,51,Florida,Hendry County,3,9,2297,1248,1049
50,12,51,Florida,Hendry County,3,10,2059,1111,948
50,12,51,Florida,Hendry County,3,11,1853,948,905
50,12,51,Florida,Hendry County,3,12,1506,786,720
50,12,51,Florida,Hendry County,3,13,1371,718,653
50,12,51,Florida,Hendry County,3,14,1142,616,526
50,12,51,Florida,Hendry County,3,15,1030,527,503
50,12,51,Florida,Hendry County,3,16,760,363,397
50,12,51,Florida,Hendry County,3,17,443,202,241
50,12,51,Florida,Hendry County,3,18,319,111,208
50,12,51,Florida,Hendry County,3,99,36029,19872,16157
50,12,51,Florida,Hendry County,4,0,664,372,292
50,12,51,Florida,Hendry County,4,1,2288,1193,1095
50,12,51,Florida,Hendry County,4,2,2741,1382,1359
50,12,51,Florida,Hendry County,4,3,3102,1632,1470
50,12,51,Florida,Hendry County,4,4,3206,1825,1381
50,12,51,Florida,Hendry County,4,5,3152,2170,982
50,12,51,Florida,Hendry County,4,6,2554,1522,1032
50,12,51,Florida,Hendry County,4,7,2655,1505,1150
50,12,51,Florida,Hendry County,4,8,2637,1402,1235
50,12,51,Florida,Hendry County,4,9,2322,1246,1076
50,12,51,Florida,Hendry County,4,10,2152,1158,994
50,12,51,Florida,Hendry County,4,11,1859,954,905
50,12,51,Florida,Hendry County,4,12,1617,839,778
50,12,51,Florida,Hendry County,4,13,1363,724,639
50,12,51,Florida,Hendry County,4,14,1208,641,567
50,12,51,Florida,Hendry County,4,15,991,514,477
50,12,51,Florida,Hendry County,4,16,787,387,400
50,12,51,Florida,Hendry County,4,17,402,176,226
50,12,51,Florida,Hendry County,4,18,335,123,212
50,12,51,Florida,Hendry County,4,99,36035,19765,16270
50,12,51,Florida,Hendry County,5,0,642,322,320
50,12,51,Florida,Hendry County,5,1,2403,1280,1123
50,12,51,Florida,Hendry County,5,2,2765,1422,1343
50,12,51,Florida,Hendry County,5,3,3094,1606,1488
50,12,51,Florida,Hendry County,5,4,3109,1725,1384
50,12,51,Florida,Hendry County,5,5,3071,1991,1080
50,12,51,Florida,Hendry County,5,6,2601,1600,1001
50,12,51,Florida,Hendry County,5,7,2557,1456,1101
50,12,51,Florida,Hendry County,5,8,2676,1417,1259
50,12,51,Florida,Hendry County,5,9,2325,1235,1090
50,12,51,Florida,Hendry County,5,10,2172,1168,1004
50,12,51,Florida,Hendry County,5,11,1858,974,884
50,12,51,Florida,Hendry County,5,12,1653,839,814
50,12,51,Florida,Hendry County,5,13,1398,746,652
50,12,51,Florida,Hendry County,5,14,1228,674,554
50,12,51,Florida,Hendry County,5,15,1032,517,515
50,12,51,Florida,Hendry County,5,16,777,388,389
50,12,51,Florida,Hendry County,5,17,429,190,239
50,12,51,Florida,Hendry County,5,18,348,128,220
50,12,51,Florida,Hendry County,5,99,36138,19678,16460
50,12,51,Florida,Hendry County,6,0,658,368,290
50,12,51,Florida,Hendry County,6,1,2432,1241,1191
50,12,51,Florida,Hendry County,6,2,2739,1434,1305
50,12,51,Florida,Hendry County,6,3,3123,1630,1493
50,12,51,Florida,Hendry County,6,4,3186,1741,1445
50,12,51,Florida,Hendry County,6,5,3051,1934,1117
50,12,51,Florida,Hendry County,6,6,2653,1657,996
50,12,51,Florida,Hendry County,6,7,2568,1459,1109
50,12,51,Florida,Hendry County,6,8,2748,1473,1275
50,12,51,Florida,Hendry County,6,9,2427,1299,1128
50,12,51,Florida,Hendry County,6,10,2255,1216,1039
50,12,51,Florida,Hendry County,6,11,1971,1039,932
50,12,51,Florida,Hendry County,6,12,1745,883,862
50,12,51,Florida,Hendry County,6,13,1430,767,663
50,12,51,Florida,Hendry County,6,14,1274,701,573
50,12,51,Florida,Hendry County,6,15,1048,521,527
50,12,51,Florida,Hendry County,6,16,782,396,386
50,12,51,Florida,Hendry County,6,17,481,229,252
50,12,51,Florida,Hendry County,6,18,332,115,217
50,12,51,Florida,Hendry County,6,99,36903,20103,16800
50,12,51,Florida,Hendry County,7,0,681,355,326
50,12,51,Florida,Hendry County,7,1,2585,1320,1265
50,12,51,Florida,Hendry County,7,2,2710,1416,1294
50,12,51,Florida,Hendry County,7,3,3098,1581,1517
50,12,51,Florida,Hendry County,7,4,3353,1847,1506
50,12,51,Florida,Hendry County,7,5,3171,2006,1165
50,12,51,Florida,Hendry County,7,6,2777,1753,1024
50,12,51,Florida,Hendry County,7,7,2612,1455,1157
50,12,51,Florida,Hendry County,7,8,2795,1563,1232
50,12,51,Florida,Hendry County,7,9,2611,1375,1236
50,12,51,Florida,Hendry County,7,10,2399,1327,1072
50,12,51,Florida,Hendry County,7,11,2083,1113,970
50,12,51,Florida,Hendry County,7,12,1812,912,900
50,12,51,Florida,Hendry County,7,13,1413,748,665
50,12,51,Florida,Hendry County,7,14,1381,756,625
50,12,51,Florida,Hendry County,7,15,1057,540,517
50,12,51,Florida,Hendry County,7,16,804,402,402
50,12,51,Florida,Hendry County,7,17,507,252,255
50,12,51,Florida,Hendry County,7,18,352,119,233
50,12,51,Florida,Hendry County,7,99,38201,20840,17361
50,12,51,Florida,Hendry County,8,0,657,318,339
50,12,51,Florida,Hendry County,8,1,2577,1359,1218
50,12,51,Florida,Hendry County,8,2,2810,1421,1389
50,12,51,Florida,Hendry County,8,3,3070,1562,1508
50,12,51,Florida,Hendry County,8,4,3362,1841,1521
50,12,51,Florida,Hendry County,8,5,3155,1971,1184
50,12,51,Florida,Hendry County,8,6,2920,1811,1109
50,12,51,Florida,Hendry County,8,7,2594,1454,1140
50,12,51,Florida,Hendry County,8,8,2866,1613,1253
50,12,51,Florida,Hendry County,8,9,2659,1399,1260
50,12,51,Florida,Hendry County,8,10,2478,1350,1128
50,12,51,Florida,Hendry County,8,11,2199,1183,1016
50,12,51,Florida,Hendry County,8,12,1860,968,892
50,12,51,Florida,Hendry County,8,13,1431,725,706
50,12,51,Florida,Hendry County,8,14,1370,751,619
50,12,51,Florida,Hendry County,8,15,1060,560,500
50,12,51,Florida,Hendry County,8,16,831,412,419
50,12,51,Florida,Hendry County,8,17,505,248,257
50,12,51,Florida,Hendry County,8,18,372,137,235
50,12,51,Florida,Hendry County,8,99,38776,21083,17693
50,12,51,Florida,Hendry County,9,0,682,359,323
50,12,51,Florida,Hendry County,9,1,2553,1311,1242
50,12,51,Florida,Hendry County,9,2,2927,1508,1419
50,12,51,Florida,Hendry County,9,3,3006,1559,1447
50,12,51,Florida,Hendry County,9,4,3300,1794,1506
50,12,51,Florida,Hendry County,9,5,3072,1891,1181
50,12,51,Florida,Hendry County,9,6,2882,1782,1100
50,12,51,Florida,Hendry County,9,7,2663,1488,1175
50,12,51,Florida,Hendry County,9,8,2854,1611,1243
50,12,51,Florida,Hendry County,9,9,2702,1422,1280
50,12,51,Florida,Hendry County,9,10,2440,1317,1123
50,12,51,Florida,Hendry County,9,11,2283,1226,1057
50,12,51,Florida,Hendry County,9,12,1881,970,911
50,12,51,Florida,Hendry County,9,13,1551,803,748
50,12,51,Florida,Hendry County,9,14,1381,751,630
50,12,51,Florida,Hendry County,9,15,1105,589,516
50,12,51,Florida,Hendry County,9,16,799,385,414
50,12,51,Florida,Hendry County,9,17,550,282,268
50,12,51,Florida,Hendry County,9,18,375,135,240
50,12,51,Florida,Hendry County,9,99,39006,21183,17823
50,12,51,Florida,Hendry County,10,0,659,360,299
50,12,51,Florida,Hendry County,10,1,2530,1305,1225
50,12,51,Florida,Hendry County,10,2,2853,1459,1394
50,12,51,Florida,Hendry County,10,3,2995,1551,1444
50,12,51,Florida,Hendry County,10,4,3288,1761,1527
50,12,51,Florida,Hendry County,10,5,3016,1824,1192
50,12,51,Florida,Hendry County,10,6,2926,1779,1147
50,12,51,Florida,Hendry County,10,7,2640,1527,1113
50,12,51,Florida,Hendry County,10,8,2815,1593,1222
50,12,51,Florida,Hendry County,10,9,2721,1441,1280
50,12,51,Florida,Hendry County,10,10,2483,1376,1107
50,12,51,Florida,Hendry County,10,11,2350,1251,1099
50,12,51,Florida,Hendry County,10,12,1854,958,896
50,12,51,Florida,Hendry County,10,13,1637,824,813
50,12,51,Florida,Hendry County,10,14,1441,796,645
50,12,51,Florida,Hendry County,10,15,1159,630,529
50,12,51,Florida,Hendry County,10,16,878,412,466
50,12,51,Florida,Hendry County,10,17,516,267,249
50,12,51,Florida,Hendry County,10,18,416,163,253
50,12,51,Florida,Hendry County,10,99,39177,21277,17900
50,12,51,Florida,Hendry County,11,0,595,308,287
50,12,51,Florida,Hendry County,11,1,2516,1279,1237
50,12,51,Florida,Hendry County,11,2,2906,1497,1409
50,12,51,Florida,Hendry County,11,3,2843,1495,1348
50,12,51,Florida,Hendry County,11,4,3251,1728,1523
50,12,51,Florida,Hendry County,11,5,2991,1767,1224
50,12,51,Florida,Hendry County,11,6,2923,1774,1149
50,12,51,Florida,Hendry County,11,7,2664,1575,1089
50,12,51,Florida,Hendry County,11,8,2718,1510,1208
50,12,51,Florida,Hendry County,11,9,2659,1430,1229
50,12,51,Florida,Hendry County,11,10,2535,1394,1141
50,12,51,Florida,Hendry County,11,11,2394,1293,1101
50,12,51,Florida,Hendry County,11,12,1862,988,874
50,12,51,Florida,Hendry County,11,13,1703,849,854
50,12,51,Florida,Hendry County,11,14,1434,777,657
50,12,51,Florida,Hendry County,11,15,1176,639,537
50,12,51,Florida,Hendry County,11,16,842,412,430
50,12,51,Florida,Hendry County,11,17,560,281,279
50,12,51,Florida,Hendry County,11,18,438,182,256
50,12,51,Florida,Hendry County,11,99,39010,21178,17832
50,12,51,Florida,Hendry County,12,0,619,332,287
50,12,51,Florida,Hendry County,12,1,2512,1286,1226
50,12,51,Florida,Hendry County,12,2,2965,1522,1443
50,12,51,Florida,Hendry County,12,3,2863,1480,1383
50,12,51,Florida,Hendry County,12,4,3188,1672,1516
50,12,51,Florida,Hendry County,12,5,3004,1770,1234
50,12,51,Florida,Hendry County,12,6,2913,1770,1143
50,12,51,Florida,Hendry County,12,7,2663,1580,1083
50,12,51,Florida,Hendry County,12,8,2695,1481,1214
50,12,51,Florida,Hendry County,12,9,2571,1413,1158
50,12,51,Florida,Hendry County,12,10,2610,1429,1181
50,12,51,Florida,Hendry County,12,11,2398,1309,1089
50,12,51,Florida,Hendry County,12,12,1902,988,914
50,12,51,Florida,Hendry County,12,13,1746,877,869
50,12,51,Florida,Hendry County,12,14,1459,757,702
50,12,51,Florida,Hendry County,12,15,1149,612,537
50,12,51,Florida,Hendry County,12,16,832,428,404
50,12,51,Florida,Hendry County,12,17,577,291,286
50,12,51,Florida,Hendry County,12,18,474,201,273
50,12,51,Florida,Hendry County,12,99,39140,21198,17942
50,12,51,Florida,Hendry County,13,0,615,330,285
50,12,51,Florida,Hendry County,13,1,2516,1290,1226
50,12,51,Florida,Hendry County,13,2,2966,1530,1436
50,12,51,Florida,Hendry County,13,3,2875,1488,1387
50,12,51,Florida,Hendry County,13,4,3181,1661,1520
50,12,51,Florida,Hendry County,13,5,3013,1780,1233
50,12,51,Florida,Hendry County,13,6,2914,1765,1149
50,12,51,Florida,Hendry County,13,7,2656,1581,1075
50,12,51,Florida,Hendry County,13,8,2691,1478,1213
50,12,51,Florida,Hendry County,13,9,2572,1410,1162
50,12,51,Florida,Hendry County,13,10,2603,1427,1176
50,12,51,Florida,Hendry County,13,11,2400,1314,1086
50,12,51,Florida,Hendry County,13,12,1909,992,917
50,12,51,Florida,Hendry County,13,13,1763,886,877
50,12,51,Florida,Hendry County,13,14,1476,763,713
50,12,51,Florida,Hendry County,13,15,1150,610,540
50,12,51,Florida,Hendry County,13,16,823,419,404
50,12,51,Florida,Hendry County,13,17,579,290,289
50,12,51,Florida,Hendry County,13,18,478,203,275
50,12,51,Florida,Hendry County,13,99,39180,21217,17963
50,12,53,Florida,Hernando County,1,0,1095,582,513
50,12,53,Florida,Hernando County,1,1,4809,2467,2342
50,12,53,Florida,Hernando County,1,2,6810,3420,3390
50,12,53,Florida,Hernando County,1,3,7530,3839,3691
50,12,53,Florida,Hernando County,1,4,6802,3514,3288
50,12,53,Florida,Hernando County,1,5,4786,2268,2518
50,12,53,Florida,Hernando County,1,6,4980,2449,2531
50,12,53,Florida,Hernando County,1,7,6007,2843,3164
50,12,53,Florida,Hernando County,1,8,7515,3539,3976
50,12,53,Florida,Hernando County,1,9,8134,3802,4332
50,12,53,Florida,Hernando County,1,10,7599,3562,4037
50,12,53,Florida,Hernando County,1,11,7891,3627,4264
50,12,53,Florida,Hernando County,1,12,8004,3633,4371
50,12,53,Florida,Hernando County,1,13,8476,3841,4635
50,12,53,Florida,Hernando County,1,14,10143,4834,5309
50,12,53,Florida,Hernando County,1,15,11227,5296,5931
50,12,53,Florida,Hernando County,1,16,9888,4643,5245
50,12,53,Florida,Hernando County,1,17,5665,2655,3010
50,12,53,Florida,Hernando County,1,18,3434,1314,2120
50,12,53,Florida,Hernando County,1,99,130795,62128,68667
50,12,53,Florida,Hernando County,2,0,1116,593,523
50,12,53,Florida,Hernando County,2,1,4813,2468,2345
50,12,53,Florida,Hernando County,2,2,6824,3426,3398
50,12,53,Florida,Hernando County,2,3,7594,3871,3723
50,12,53,Florida,Hernando County,2,4,6857,3545,3312
50,12,53,Florida,Hernando County,2,5,4838,2296,2542
50,12,53,Florida,Hernando County,2,6,4957,2439,2518
50,12,53,Florida,Hernando County,2,7,6028,2856,3172
50,12,53,Florida,Hernando County,2,8,7520,3541,3979
50,12,53,Florida,Hernando County,2,9,8180,3825,4355
50,12,53,Florida,Hernando County,2,10,7678,3603,4075
50,12,53,Florida,Hernando County,2,11,8022,3690,4332
50,12,53,Florida,Hernando County,2,12,8091,3672,4419
50,12,53,Florida,Hernando County,2,13,8552,3878,4674
50,12,53,Florida,Hernando County,2,14,10101,4816,5285
50,12,53,Florida,Hernando County,2,15,11191,5286,5905
50,12,53,Florida,Hernando County,2,16,9880,4644,5236
50,12,53,Florida,Hernando County,2,17,5700,2676,3024
50,12,53,Florida,Hernando County,2,18,3448,1322,2126
50,12,53,Florida,Hernando County,2,99,131390,62447,68943
50,12,53,Florida,Hernando County,3,0,1223,606,617
50,12,53,Florida,Hernando County,3,1,4896,2527,2369
50,12,53,Florida,Hernando County,3,2,6933,3550,3383
50,12,53,Florida,Hernando County,3,3,7928,3994,3934
50,12,53,Florida,Hernando County,3,4,6998,3630,3368
50,12,53,Florida,Hernando County,3,5,5180,2481,2699
50,12,53,Florida,Hernando County,3,6,4975,2463,2512
50,12,53,Florida,Hernando County,3,7,6250,2982,3268
50,12,53,Florida,Hernando County,3,8,7663,3601,4062
50,12,53,Florida,Hernando County,3,9,8286,3884,4402
50,12,53,Florida,Hernando County,3,10,8027,3743,4284
50,12,53,Florida,Hernando County,3,11,8465,3941,4524
50,12,53,Florida,Hernando County,3,12,8303,3745,4558
50,12,53,Florida,Hernando County,3,13,8834,4073,4761
50,12,53,Florida,Hernando County,3,14,9970,4786,5184
50,12,53,Florida,Hernando County,3,15,10869,5171,5698
50,12,53,Florida,Hernando County,3,16,9825,4534,5291
50,12,53,Florida,Hernando County,3,17,5926,2788,3138
50,12,53,Florida,Hernando County,3,18,3576,1379,2197
50,12,53,Florida,Hernando County,3,99,134127,63878,70249
50,12,53,Florida,Hernando County,4,0,1284,661,623
50,12,53,Florida,Hernando County,4,1,5165,2626,2539
50,12,53,Florida,Hernando County,4,2,7071,3590,3481
50,12,53,Florida,Hernando County,4,3,8251,4162,4089
50,12,53,Florida,Hernando County,4,4,7308,3778,3530
50,12,53,Florida,Hernando County,4,5,5629,2705,2924
50,12,53,Florida,Hernando County,4,6,4994,2433,2561
50,12,53,Florida,Hernando County,4,7,6456,3048,3408
50,12,53,Florida,Hernando County,4,8,7710,3640,4070
50,12,53,Florida,Hernando County,4,9,8586,4054,4532
50,12,53,Florida,Hernando County,4,10,8533,3974,4559
50,12,53,Florida,Hernando County,4,11,8503,3869,4634
50,12,53,Florida,Hernando County,4,12,9027,4148,4879
50,12,53,Florida,Hernando County,4,13,9146,4176,4970
50,12,53,Florida,Hernando County,4,14,9998,4825,5173
50,12,53,Florida,Hernando County,4,15,10611,5091,5520
50,12,53,Florida,Hernando County,4,16,9666,4463,5203
50,12,53,Florida,Hernando County,4,17,6162,2868,3294
50,12,53,Florida,Hernando County,4,18,3718,1444,2274
50,12,53,Florida,Hernando County,4,99,137818,65555,72263
50,12,53,Florida,Hernando County,5,0,1310,675,635
50,12,53,Florida,Hernando County,5,1,5436,2778,2658
50,12,53,Florida,Hernando County,5,2,7363,3706,3657
50,12,53,Florida,Hernando County,5,3,8608,4319,4289
50,12,53,Florida,Hernando County,5,4,7687,4010,3677
50,12,53,Florida,Hernando County,5,5,6148,3051,3097
50,12,53,Florida,Hernando County,5,6,5289,2617,2672
50,12,53,Florida,Hernando County,5,7,6744,3240,3504
50,12,53,Florida,Hernando County,5,8,7823,3665,4158
50,12,53,Florida,Hernando County,5,9,8914,4247,4667
50,12,53,Florida,Hernando County,5,10,9178,4301,4877
50,12,53,Florida,Hernando County,5,11,8778,4007,4771
50,12,53,Florida,Hernando County,5,12,9296,4291,5005
50,12,53,Florida,Hernando County,5,13,9782,4508,5274
50,12,53,Florida,Hernando County,5,14,10112,4871,5241
50,12,53,Florida,Hernando County,5,15,10395,5016,5379
50,12,53,Florida,Hernando County,5,16,9630,4461,5169
50,12,53,Florida,Hernando County,5,17,6329,2898,3431
50,12,53,Florida,Hernando County,5,18,3864,1513,2351
50,12,53,Florida,Hernando County,5,99,142686,68174,74512
50,12,53,Florida,Hernando County,6,0,1409,733,676
50,12,53,Florida,Hernando County,6,1,5772,2942,2830
50,12,53,Florida,Hernando County,6,2,7815,3930,3885
50,12,53,Florida,Hernando County,6,3,8900,4474,4426
50,12,53,Florida,Hernando County,6,4,8227,4287,3940
50,12,53,Florida,Hernando County,6,5,6553,3239,3314
50,12,53,Florida,Hernando County,6,6,5914,2880,3034
50,12,53,Florida,Hernando County,6,7,7091,3396,3695
50,12,53,Florida,Hernando County,6,8,8216,3894,4322
50,12,53,Florida,Hernando County,6,9,9376,4457,4919
50,12,53,Florida,Hernando County,6,10,9719,4534,5185
50,12,53,Florida,Hernando County,6,11,9302,4264,5038
50,12,53,Florida,Hernando County,6,12,9987,4623,5364
50,12,53,Florida,Hernando County,6,13,10440,4790,5650
50,12,53,Florida,Hernando County,6,14,10533,5067,5466
50,12,53,Florida,Hernando County,6,15,10177,4945,5232
50,12,53,Florida,Hernando County,6,16,9571,4463,5108
50,12,53,Florida,Hernando County,6,17,6605,3015,3590
50,12,53,Florida,Hernando County,6,18,3986,1601,2385
50,12,53,Florida,Hernando County,6,99,149593,71534,78059
50,12,53,Florida,Hernando County,7,0,1573,752,821
50,12,53,Florida,Hernando County,7,1,6117,3145,2972
50,12,53,Florida,Hernando County,7,2,8319,4252,4067
50,12,53,Florida,Hernando County,7,3,9183,4622,4561
50,12,53,Florida,Hernando County,7,4,8913,4632,4281
50,12,53,Florida,Hernando County,7,5,6914,3383,3531
50,12,53,Florida,Hernando County,7,6,6468,3135,3333
50,12,53,Florida,Hernando County,7,7,7290,3524,3766
50,12,53,Florida,Hernando County,7,8,8655,4042,4613
50,12,53,Florida,Hernando County,7,9,10013,4814,5199
50,12,53,Florida,Hernando County,7,10,10437,4916,5521
50,12,53,Florida,Hernando County,7,11,10018,4654,5364
50,12,53,Florida,Hernando County,7,12,10760,4946,5814
50,12,53,Florida,Hernando County,7,13,11172,5186,5986
50,12,53,Florida,Hernando County,7,14,10790,5159,5631
50,12,53,Florida,Hernando County,7,15,10197,4976,5221
50,12,53,Florida,Hernando County,7,16,9402,4393,5009
50,12,53,Florida,Hernando County,7,17,6738,3023,3715
50,12,53,Florida,Hernando County,7,18,4197,1740,2457
50,12,53,Florida,Hernando County,7,99,157156,75294,81862
50,12,53,Florida,Hernando County,8,0,1643,845,798
50,12,53,Florida,Hernando County,8,1,6446,3244,3202
50,12,53,Florida,Hernando County,8,2,8854,4439,4415
50,12,53,Florida,Hernando County,8,3,9592,4857,4735
50,12,53,Florida,Hernando County,8,4,9460,4916,4544
50,12,53,Florida,Hernando County,8,5,7229,3526,3703
50,12,53,Florida,Hernando County,8,6,7063,3421,3642
50,12,53,Florida,Hernando County,8,7,7430,3571,3859
50,12,53,Florida,Hernando County,8,8,9183,4393,4790
50,12,53,Florida,Hernando County,8,9,10456,5010,5446
50,12,53,Florida,Hernando County,8,10,11098,5244,5854
50,12,53,Florida,Hernando County,8,11,10714,4955,5759
50,12,53,Florida,Hernando County,8,12,11500,5336,6164
50,12,53,Florida,Hernando County,8,13,11680,5409,6271
50,12,53,Florida,Hernando County,8,14,11239,5439,5800
50,12,53,Florida,Hernando County,8,15,10280,4996,5284
50,12,53,Florida,Hernando County,8,16,9339,4412,4927
50,12,53,Florida,Hernando County,8,17,6715,2951,3764
50,12,53,Florida,Hernando County,8,18,4477,1850,2627
50,12,53,Florida,Hernando County,8,99,164398,78814,85584
50,12,53,Florida,Hernando County,9,0,1771,934,837
50,12,53,Florida,Hernando County,9,1,6777,3380,3397
50,12,53,Florida,Hernando County,9,2,9388,4725,4663
50,12,53,Florida,Hernando County,9,3,9902,5011,4891
50,12,53,Florida,Hernando County,9,4,9875,5100,4775
50,12,53,Florida,Hernando County,9,5,7624,3780,3844
50,12,53,Florida,Hernando County,9,6,7505,3597,3908
50,12,53,Florida,Hernando County,9,7,7575,3649,3926
50,12,53,Florida,Hernando County,9,8,9726,4584,5142
50,12,53,Florida,Hernando County,9,9,10593,5179,5414
50,12,53,Florida,Hernando County,9,10,11445,5397,6048
50,12,53,Florida,Hernando County,9,11,11232,5272,5960
50,12,53,Florida,Hernando County,9,12,11449,5252,6197
50,12,53,Florida,Hernando County,9,13,12397,5813,6584
50,12,53,Florida,Hernando County,9,14,11501,5493,6008
50,12,53,Florida,Hernando County,9,15,10287,5016,5271
50,12,53,Florida,Hernando County,9,16,9182,4377,4805
50,12,53,Florida,Hernando County,9,17,6877,2969,3908
50,12,53,Florida,Hernando County,9,18,4785,1986,2799
50,12,53,Florida,Hernando County,9,99,169891,81514,88377
50,12,53,Florida,Hernando County,10,0,1777,950,827
50,12,53,Florida,Hernando County,10,1,7042,3553,3489
50,12,53,Florida,Hernando County,10,2,9297,4634,4663
50,12,53,Florida,Hernando County,10,3,10082,5143,4939
50,12,53,Florida,Hernando County,10,4,10157,5160,4997
50,12,53,Florida,Hernando County,10,5,7613,3748,3865
50,12,53,Florida,Hernando County,10,6,7855,3802,4053
50,12,53,Florida,Hernando County,10,7,7618,3675,3943
50,12,53,Florida,Hernando County,10,8,9637,4492,5145
50,12,53,Florida,Hernando County,10,9,10579,5133,5446
50,12,53,Florida,Hernando County,10,10,11603,5554,6049
50,12,53,Florida,Hernando County,10,11,11617,5462,6155
50,12,53,Florida,Hernando County,10,12,11494,5223,6271
50,12,53,Florida,Hernando County,10,13,12621,5907,6714
50,12,53,Florida,Hernando County,10,14,12082,5715,6367
50,12,53,Florida,Hernando County,10,15,10358,5016,5342
50,12,53,Florida,Hernando County,10,16,9041,4266,4775
50,12,53,Florida,Hernando County,10,17,6934,3064,3870
50,12,53,Florida,Hernando County,10,18,5030,2026,3004
50,12,53,Florida,Hernando County,10,99,172437,82523,89914
50,12,53,Florida,Hernando County,11,0,1627,839,788
50,12,53,Florida,Hernando County,11,1,7009,3512,3497
50,12,53,Florida,Hernando County,11,2,9154,4546,4608
50,12,53,Florida,Hernando County,11,3,10040,5126,4914
50,12,53,Florida,Hernando County,11,4,10036,5075,4961
50,12,53,Florida,Hernando County,11,5,7599,3753,3846
50,12,53,Florida,Hernando County,11,6,7688,3753,3935
50,12,53,Florida,Hernando County,11,7,7687,3707,3980
50,12,53,Florida,Hernando County,11,8,9246,4334,4912
50,12,53,Florida,Hernando County,11,9,10319,4960,5359
50,12,53,Florida,Hernando County,11,10,11716,5596,6120
50,12,53,Florida,Hernando County,11,11,11765,5522,6243
50,12,53,Florida,Hernando County,11,12,11438,5207,6231
50,12,53,Florida,Hernando County,11,13,12601,5870,6731
50,12,53,Florida,Hernando County,11,14,12427,5824,6603
50,12,53,Florida,Hernando County,11,15,10486,5084,5402
50,12,53,Florida,Hernando County,11,16,8847,4193,4654
50,12,53,Florida,Hernando County,11,17,7007,3131,3876
50,12,53,Florida,Hernando County,11,18,5258,2106,3152
50,12,53,Florida,Hernando County,11,99,171950,82138,89812
50,12,53,Florida,Hernando County,12,0,1578,820,758
50,12,53,Florida,Hernando County,12,1,6926,3497,3429
50,12,53,Florida,Hernando County,12,2,9240,4530,4710
50,12,53,Florida,Hernando County,12,3,10095,5142,4953
50,12,53,Florida,Hernando County,12,4,9957,5060,4897
50,12,53,Florida,Hernando County,12,5,7823,3877,3946
50,12,53,Florida,Hernando County,12,6,7581,3707,3874
50,12,53,Florida,Hernando County,12,7,7778,3707,4071
50,12,53,Florida,Hernando County,12,8,8914,4199,4715
50,12,53,Florida,Hernando County,12,9,10179,4896,5283
50,12,53,Florida,Hernando County,12,10,11772,5641,6131
50,12,53,Florida,Hernando County,12,11,11941,5638,6303
50,12,53,Florida,Hernando County,12,12,11520,5261,6259
50,12,53,Florida,Hernando County,12,13,12951,5985,6966
50,12,53,Florida,Hernando County,12,14,12680,5977,6703
50,12,53,Florida,Hernando County,12,15,10553,5082,5471
50,12,53,Florida,Hernando County,12,16,8836,4217,4619
50,12,53,Florida,Hernando County,12,17,6944,3089,3855
50,12,53,Florida,Hernando County,12,18,5510,2209,3301
50,12,53,Florida,Hernando County,12,99,172778,82534,90244
50,12,53,Florida,Hernando County,13,0,1577,820,757
50,12,53,Florida,Hernando County,13,1,6896,3480,3416
50,12,53,Florida,Hernando County,13,2,9235,4535,4700
50,12,53,Florida,Hernando County,13,3,10100,5147,4953
50,12,53,Florida,Hernando County,13,4,9900,5029,4871
50,12,53,Florida,Hernando County,13,5,7865,3903,3962
50,12,53,Florida,Hernando County,13,6,7616,3721,3895
50,12,53,Florida,Hernando County,13,7,7827,3741,4086
50,12,53,Florida,Hernando County,13,8,8843,4166,4677
50,12,53,Florida,Hernando County,13,9,10161,4889,5272
50,12,53,Florida,Hernando County,13,10,11712,5618,6094
50,12,53,Florida,Hernando County,13,11,11956,5645,6311
50,12,53,Florida,Hernando County,13,12,11575,5284,6291
50,12,53,Florida,Hernando County,13,13,13080,6049,7031
50,12,53,Florida,Hernando County,13,14,12763,6013,6750
50,12,53,Florida,Hernando County,13,15,10600,5105,5495
50,12,53,Florida,Hernando County,13,16,8808,4207,4601
50,12,53,Florida,Hernando County,13,17,6947,3097,3850
50,12,53,Florida,Hernando County,13,18,5547,2231,3316
50,12,53,Florida,Hernando County,13,99,173008,82680,90328
50,12,55,Florida,Highlands County,1,0,806,430,376
50,12,55,Florida,Highlands County,1,1,3403,1724,1679
50,12,55,Florida,Highlands County,1,2,4610,2374,2236
50,12,55,Florida,Highlands County,1,3,4814,2511,2303
50,12,55,Florida,Highlands County,1,4,4914,2677,2237
50,12,55,Florida,Highlands County,1,5,3679,2018,1661
50,12,55,Florida,Highlands County,1,6,3673,1925,1748
50,12,55,Florida,Highlands County,1,7,3797,1962,1835
50,12,55,Florida,Highlands County,1,8,4643,2296,2347
50,12,55,Florida,Highlands County,1,9,4783,2365,2418
50,12,55,Florida,Highlands County,1,10,4526,2181,2345
50,12,55,Florida,Highlands County,1,11,4414,2070,2344
50,12,55,Florida,Highlands County,1,12,4825,2168,2657
50,12,55,Florida,Highlands County,1,13,5659,2607,3052
50,12,55,Florida,Highlands County,1,14,6987,3246,3741
50,12,55,Florida,Highlands County,1,15,7932,3840,4092
50,12,55,Florida,Highlands County,1,16,6961,3220,3741
50,12,55,Florida,Highlands County,1,17,4170,1914,2256
50,12,55,Florida,Highlands County,1,18,2795,1088,1707
50,12,55,Florida,Highlands County,1,99,87391,42616,44775
50,12,55,Florida,Highlands County,2,0,817,437,380
50,12,55,Florida,Highlands County,2,1,3386,1714,1672
50,12,55,Florida,Highlands County,2,2,4579,2356,2223
50,12,55,Florida,Highlands County,2,3,4819,2511,2308
50,12,55,Florida,Highlands County,2,4,4920,2679,2241
50,12,55,Florida,Highlands County,2,5,3700,2031,1669
50,12,55,Florida,Highlands County,2,6,3644,1912,1732
50,12,55,Florida,Highlands County,2,7,3792,1961,1831
50,12,55,Florida,Highlands County,2,8,4621,2289,2332
50,12,55,Florida,Highlands County,2,9,4794,2369,2425
50,12,55,Florida,Highlands County,2,10,4545,2190,2355
50,12,55,Florida,Highlands County,2,11,4449,2086,2363
50,12,55,Florida,Highlands County,2,12,4844,2179,2665
50,12,55,Florida,Highlands County,2,13,5670,2613,3057
50,12,55,Florida,Highlands County,2,14,6967,3238,3729
50,12,55,Florida,Highlands County,2,15,7915,3839,4076
50,12,55,Florida,Highlands County,2,16,6959,3223,3736
50,12,55,Florida,Highlands County,2,17,4190,1926,2264
50,12,55,Florida,Highlands County,2,18,2806,1093,1713
50,12,55,Florida,Highlands County,2,99,87417,42646,44771
50,12,55,Florida,Highlands County,3,0,861,426,435
50,12,55,Florida,Highlands County,3,1,3465,1795,1670
50,12,55,Florida,Highlands County,3,2,4522,2315,2207
50,12,55,Florida,Highlands County,3,3,4918,2552,2366
50,12,55,Florida,Highlands County,3,4,4850,2608,2242
50,12,55,Florida,Highlands County,3,5,3864,2129,1735
50,12,55,Florida,Highlands County,3,6,3608,1912,1696
50,12,55,Florida,Highlands County,3,7,3801,1911,1890
50,12,55,Florida,Highlands County,3,8,4503,2249,2254
50,12,55,Florida,Highlands County,3,9,4935,2428,2507
50,12,55,Florida,Highlands County,3,10,4717,2313,2404
50,12,55,Florida,Highlands County,3,11,4783,2248,2535
50,12,55,Florida,Highlands County,3,12,4939,2225,2714
50,12,55,Florida,Highlands County,3,13,5832,2662,3170
50,12,55,Florida,Highlands County,3,14,6834,3211,3623
50,12,55,Florida,Highlands County,3,15,7849,3807,4042
50,12,55,Florida,Highlands County,3,16,6956,3253,3703
50,12,55,Florida,Highlands County,3,17,4390,2022,2368
50,12,55,Florida,Highlands County,3,18,2883,1147,1736
50,12,55,Florida,Highlands County,3,99,88510,43213,45297
50,12,55,Florida,Highlands County,4,0,906,466,440
50,12,55,Florida,Highlands County,4,1,3566,1789,1777
50,12,55,Florida,Highlands County,4,2,4468,2322,2146
50,12,55,Florida,Highlands County,4,3,5042,2586,2456
50,12,55,Florida,Highlands County,4,4,4945,2656,2289
50,12,55,Florida,Highlands County,4,5,3994,2174,1820
50,12,55,Florida,Highlands County,4,6,3646,1919,1727
50,12,55,Florida,Highlands County,4,7,3850,1927,1923
50,12,55,Florida,Highlands County,4,8,4482,2270,2212
50,12,55,Florida,Highlands County,4,9,4979,2429,2550
50,12,55,Florida,Highlands County,4,10,4920,2425,2495
50,12,55,Florida,Highlands County,4,11,4867,2271,2596
50,12,55,Florida,Highlands County,4,12,5256,2380,2876
50,12,55,Florida,Highlands County,4,13,5997,2721,3276
50,12,55,Florida,Highlands County,4,14,6940,3266,3674
50,12,55,Florida,Highlands County,4,15,7752,3770,3982
50,12,55,Florida,Highlands County,4,16,6783,3187,3596
50,12,55,Florida,Highlands County,4,17,4627,2123,2504
50,12,55,Florida,Highlands County,4,18,2919,1184,1735
50,12,55,Florida,Highlands County,4,99,89939,43865,46074
50,12,55,Florida,Highlands County,5,0,910,496,414
50,12,55,Florida,Highlands County,5,1,3515,1781,1734
50,12,55,Florida,Highlands County,5,2,4479,2284,2195
50,12,55,Florida,Highlands County,5,3,5081,2600,2481
50,12,55,Florida,Highlands County,5,4,4904,2628,2276
50,12,55,Florida,Highlands County,5,5,4159,2261,1898
50,12,55,Florida,Highlands County,5,6,3627,1928,1699
50,12,55,Florida,Highlands County,5,7,3906,1931,1975
50,12,55,Florida,Highlands County,5,8,4314,2190,2124
50,12,55,Florida,Highlands County,5,9,5092,2469,2623
50,12,55,Florida,Highlands County,5,10,5121,2566,2555
50,12,55,Florida,Highlands County,5,11,4985,2296,2689
50,12,55,Florida,Highlands County,5,12,5407,2479,2928
50,12,55,Florida,Highlands County,5,13,6279,2850,3429
50,12,55,Florida,Highlands County,5,14,6906,3263,3643
50,12,55,Florida,Highlands County,5,15,7659,3693,3966
50,12,55,Florida,Highlands County,5,16,6798,3242,3556
50,12,55,Florida,Highlands County,5,17,4786,2181,2605
50,12,55,Florida,Highlands County,5,18,3015,1243,1772
50,12,55,Florida,Highlands County,5,99,90943,44381,46562
50,12,55,Florida,Highlands County,6,0,978,506,472
50,12,55,Florida,Highlands County,6,1,3651,1863,1788
50,12,55,Florida,Highlands County,6,2,4482,2324,2158
50,12,55,Florida,Highlands County,6,3,5125,2609,2516
50,12,55,Florida,Highlands County,6,4,5034,2696,2338
50,12,55,Florida,Highlands County,6,5,4258,2359,1899
50,12,55,Florida,Highlands County,6,6,3820,2032,1788
50,12,55,Florida,Highlands County,6,7,3930,1918,2012
50,12,55,Florida,Highlands County,6,8,4232,2164,2068
50,12,55,Florida,Highlands County,6,9,5182,2539,2643
50,12,55,Florida,Highlands County,6,10,5346,2652,2694
50,12,55,Florida,Highlands County,6,11,5272,2427,2845
50,12,55,Florida,Highlands County,6,12,5690,2652,3038
50,12,55,Florida,Highlands County,6,13,6583,2962,3621
50,12,55,Florida,Highlands County,6,14,7343,3496,3847
50,12,55,Florida,Highlands County,6,15,7392,3551,3841
50,12,55,Florida,Highlands County,6,16,6854,3312,3542
50,12,55,Florida,Highlands County,6,17,4830,2184,2646
50,12,55,Florida,Highlands County,6,18,3077,1257,1820
50,12,55,Florida,Highlands County,6,99,93079,45503,47576
50,12,55,Florida,Highlands County,7,0,993,523,470
50,12,55,Florida,Highlands County,7,1,3769,1888,1881
50,12,55,Florida,Highlands County,7,2,4453,2311,2142
50,12,55,Florida,Highlands County,7,3,5127,2646,2481
50,12,55,Florida,Highlands County,7,4,5201,2780,2421
50,12,55,Florida,Highlands County,7,5,4420,2421,1999
50,12,55,Florida,Highlands County,7,6,3940,2085,1855
50,12,55,Florida,Highlands County,7,7,3990,1983,2007
50,12,55,Florida,Highlands County,7,8,4297,2164,2133
50,12,55,Florida,Highlands County,7,9,5202,2550,2652
50,12,55,Florida,Highlands County,7,10,5556,2745,2811
50,12,55,Florida,Highlands County,7,11,5590,2590,3000
50,12,55,Florida,Highlands County,7,12,5981,2796,3185
50,12,55,Florida,Highlands County,7,13,6907,3083,3824
50,12,55,Florida,Highlands County,7,14,7815,3759,4056
50,12,55,Florida,Highlands County,7,15,7426,3540,3886
50,12,55,Florida,Highlands County,7,16,6961,3405,3556
50,12,55,Florida,Highlands County,7,17,4770,2179,2591
50,12,55,Florida,Highlands County,7,18,3216,1291,1925
50,12,55,Florida,Highlands County,7,99,95614,46739,48875
50,12,55,Florida,Highlands County,8,0,1030,524,506
50,12,55,Florida,Highlands County,8,1,3895,2007,1888
50,12,55,Florida,Highlands County,8,2,4562,2344,2218
50,12,55,Florida,Highlands County,8,3,5208,2662,2546
50,12,55,Florida,Highlands County,8,4,5385,2857,2528
50,12,55,Florida,Highlands County,8,5,4507,2444,2063
50,12,55,Florida,Highlands County,8,6,4162,2176,1986
50,12,55,Florida,Highlands County,8,7,3991,2008,1983
50,12,55,Florida,Highlands County,8,8,4420,2171,2249
50,12,55,Florida,Highlands County,8,9,5166,2562,2604
50,12,55,Florida,Highlands County,8,10,5711,2783,2928
50,12,55,Florida,Highlands County,8,11,5766,2747,3019
50,12,55,Florida,Highlands County,8,12,6327,2913,3414
50,12,55,Florida,Highlands County,8,13,7014,3163,3851
50,12,55,Florida,Highlands County,8,14,8071,3915,4156
50,12,55,Florida,Highlands County,8,15,7470,3583,3887
50,12,55,Florida,Highlands County,8,16,6899,3357,3542
50,12,55,Florida,Highlands County,8,17,4750,2189,2561
50,12,55,Florida,Highlands County,8,18,3454,1399,2055
50,12,55,Florida,Highlands County,8,99,97788,47804,49984
50,12,55,Florida,Highlands County,9,0,1160,606,554
50,12,55,Florida,Highlands County,9,1,4050,2068,1982
50,12,55,Florida,Highlands County,9,2,4718,2406,2312
50,12,55,Florida,Highlands County,9,3,5084,2636,2448
50,12,55,Florida,Highlands County,9,4,5401,2868,2533
50,12,55,Florida,Highlands County,9,5,4538,2456,2082
50,12,55,Florida,Highlands County,9,6,4381,2272,2109
50,12,55,Florida,Highlands County,9,7,3962,2007,1955
50,12,55,Florida,Highlands County,9,8,4436,2193,2243
50,12,55,Florida,Highlands County,9,9,5087,2563,2524
50,12,55,Florida,Highlands County,9,10,5798,2828,2970
50,12,55,Florida,Highlands County,9,11,5908,2821,3087
50,12,55,Florida,Highlands County,9,12,6191,2803,3388
50,12,55,Florida,Highlands County,9,13,7322,3338,3984
50,12,55,Florida,Highlands County,9,14,8227,3932,4295
50,12,55,Florida,Highlands County,9,15,7527,3674,3853
50,12,55,Florida,Highlands County,9,16,6846,3340,3506
50,12,55,Florida,Highlands County,9,17,4716,2172,2544
50,12,55,Florida,Highlands County,9,18,3671,1499,2172
50,12,55,Florida,Highlands County,9,99,99023,48482,50541
50,12,55,Florida,Highlands County,10,0,1200,629,571
50,12,55,Florida,Highlands County,10,1,4077,2042,2035
50,12,55,Florida,Highlands County,10,2,4770,2466,2304
50,12,55,Florida,Highlands County,10,3,5110,2607,2503
50,12,55,Florida,Highlands County,10,4,5435,2889,2546
50,12,55,Florida,Highlands County,10,5,4463,2388,2075
50,12,55,Florida,Highlands County,10,6,4522,2362,2160
50,12,55,Florida,Highlands County,10,7,4070,2058,2012
50,12,55,Florida,Highlands County,10,8,4358,2170,2188
50,12,55,Florida,Highlands County,10,9,4922,2469,2453
50,12,55,Florida,Highlands County,10,10,5799,2834,2965
50,12,55,Florida,Highlands County,10,11,5986,2886,3100
50,12,55,Florida,Highlands County,10,12,6166,2788,3378
50,12,55,Florida,Highlands County,10,13,7226,3251,3975
50,12,55,Florida,Highlands County,10,14,8499,4055,4444
50,12,55,Florida,Highlands County,10,15,7512,3642,3870
50,12,55,Florida,Highlands County,10,16,6843,3378,3465
50,12,55,Florida,Highlands County,10,17,4735,2186,2549
50,12,55,Florida,Highlands County,10,18,3875,1551,2324
50,12,55,Florida,Highlands County,10,99,99568,48651,50917
50,12,55,Florida,Highlands County,11,0,1012,536,476
50,12,55,Florida,Highlands County,11,1,4110,2108,2002
50,12,55,Florida,Highlands County,11,2,4782,2469,2313
50,12,55,Florida,Highlands County,11,3,5018,2603,2415
50,12,55,Florida,Highlands County,11,4,5304,2783,2521
50,12,55,Florida,Highlands County,11,5,4486,2396,2090
50,12,55,Florida,Highlands County,11,6,4402,2294,2108
50,12,55,Florida,Highlands County,11,7,4144,2133,2011
50,12,55,Florida,Highlands County,11,8,4256,2073,2183
50,12,55,Florida,Highlands County,11,9,4712,2419,2293
50,12,55,Florida,Highlands County,11,10,5746,2781,2965
50,12,55,Florida,Highlands County,11,11,5977,2903,3074
50,12,55,Florida,Highlands County,11,12,6107,2784,3323
50,12,55,Florida,Highlands County,11,13,7251,3245,4006
50,12,55,Florida,Highlands County,11,14,8505,4002,4503
50,12,55,Florida,Highlands County,11,15,7755,3807,3948
50,12,55,Florida,Highlands County,11,16,6483,3152,3331
50,12,55,Florida,Highlands County,11,17,4887,2332,2555
50,12,55,Florida,Highlands County,11,18,4019,1612,2407
50,12,55,Florida,Highlands County,11,99,98956,48432,50524
50,12,55,Florida,Highlands County,12,0,972,513,459
50,12,55,Florida,Highlands County,12,1,4016,2070,1946
50,12,55,Florida,Highlands County,12,2,4858,2463,2395
50,12,55,Florida,Highlands County,12,3,4957,2558,2399
50,12,55,Florida,Highlands County,12,4,5211,2741,2470
50,12,55,Florida,Highlands County,12,5,4451,2393,2058
50,12,55,Florida,Highlands County,12,6,4415,2290,2125
50,12,55,Florida,Highlands County,12,7,4197,2125,2072
50,12,55,Florida,Highlands County,12,8,4210,2086,2124
50,12,55,Florida,Highlands County,12,9,4646,2377,2269
50,12,55,Florida,Highlands County,12,10,5641,2709,2932
50,12,55,Florida,Highlands County,12,11,6068,2961,3107
50,12,55,Florida,Highlands County,12,12,6083,2817,3266
50,12,55,Florida,Highlands County,12,13,7239,3227,4012
50,12,55,Florida,Highlands County,12,14,8487,3976,4511
50,12,55,Florida,Highlands County,12,15,7880,3862,4018
50,12,55,Florida,Highlands County,12,16,6393,3077,3316
50,12,55,Florida,Highlands County,12,17,4901,2362,2539
50,12,55,Florida,Highlands County,12,18,4161,1666,2495
50,12,55,Florida,Highlands County,12,99,98786,48273,50513
50,12,55,Florida,Highlands County,13,0,974,513,461
50,12,55,Florida,Highlands County,13,1,4013,2072,1941
50,12,55,Florida,Highlands County,13,2,4854,2469,2385
50,12,55,Florida,Highlands County,13,3,4953,2567,2386
50,12,55,Florida,Highlands County,13,4,5178,2720,2458
50,12,55,Florida,Highlands County,13,5,4458,2401,2057
50,12,55,Florida,Highlands County,13,6,4414,2284,2130
50,12,55,Florida,Highlands County,13,7,4200,2130,2070
50,12,55,Florida,Highlands County,13,8,4177,2071,2106
50,12,55,Florida,Highlands County,13,9,4633,2370,2263
50,12,55,Florida,Highlands County,13,10,5603,2688,2915
50,12,55,Florida,Highlands County,13,11,6052,2948,3104
50,12,55,Florida,Highlands County,13,12,6097,2824,3273
50,12,55,Florida,Highlands County,13,13,7281,3246,4035
50,12,55,Florida,Highlands County,13,14,8516,3988,4528
50,12,55,Florida,Highlands County,13,15,7881,3864,4017
50,12,55,Florida,Highlands County,13,16,6353,3057,3296
50,12,55,Florida,Highlands County,13,17,4890,2361,2529
50,12,55,Florida,Highlands County,13,18,4173,1677,2496
50,12,55,Florida,Highlands County,13,99,98700,48250,50450
50,12,57,Florida,Hillsborough County,1,0,13521,6878,6643
50,12,57,Florida,Hillsborough County,1,1,54923,28088,26835
50,12,57,Florida,Hillsborough County,1,2,72844,37281,35563
50,12,57,Florida,Hillsborough County,1,3,71264,36533,34731
50,12,57,Florida,Hillsborough County,1,4,67518,34505,33013
50,12,57,Florida,Hillsborough County,1,5,66141,32769,33372
50,12,57,Florida,Hillsborough County,1,6,73426,36628,36798
50,12,57,Florida,Hillsborough County,1,7,77480,38898,38582
50,12,57,Florida,Hillsborough County,1,8,85114,42251,42863
50,12,57,Florida,Hillsborough County,1,9,80586,39881,40705
50,12,57,Florida,Hillsborough County,1,10,70307,34232,36075
50,12,57,Florida,Hillsborough County,1,11,62160,30415,31745
50,12,57,Florida,Hillsborough County,1,12,46876,22544,24332
50,12,57,Florida,Hillsborough County,1,13,37145,17623,19522
50,12,57,Florida,Hillsborough County,1,14,33021,15492,17529
50,12,57,Florida,Hillsborough County,1,15,30764,13546,17218
50,12,57,Florida,Hillsborough County,1,16,25799,10603,15196
50,12,57,Florida,Hillsborough County,1,17,16837,6528,10309
50,12,57,Florida,Hillsborough County,1,18,13268,4104,9164
50,12,57,Florida,Hillsborough County,1,99,998994,488799,510195
50,12,57,Florida,Hillsborough County,2,0,13715,6984,6731
50,12,57,Florida,Hillsborough County,2,1,54795,28020,26775
50,12,57,Florida,Hillsborough County,2,2,72612,37153,35459
50,12,57,Florida,Hillsborough County,2,3,71849,36816,35033
50,12,57,Florida,Hillsborough County,2,4,67894,34698,33196
50,12,57,Florida,Hillsborough County,2,5,66978,33158,33820
50,12,57,Florida,Hillsborough County,2,6,73168,36484,36684
50,12,57,Florida,Hillsborough County,2,7,77616,38954,38662
50,12,57,Florida,Hillsborough County,2,8,85076,42223,42853
50,12,57,Florida,Hillsborough County,2,9,81060,40115,40945
50,12,57,Florida,Hillsborough County,2,10,70908,34533,36375
50,12,57,Florida,Hillsborough County,2,11,62998,30821,32177
50,12,57,Florida,Hillsborough County,2,12,47297,22757,24540
50,12,57,Florida,Hillsborough County,2,13,37427,17774,19653
50,12,57,Florida,Hillsborough County,2,14,33022,15495,17527
50,12,57,Florida,Hillsborough County,2,15,30820,13589,17231
50,12,57,Florida,Hillsborough County,2,16,25899,10648,15251
50,12,57,Florida,Hillsborough County,2,17,16973,6581,10392
50,12,57,Florida,Hillsborough County,2,18,13328,4125,9203
50,12,57,Florida,Hillsborough County,2,99,1003435,490928,512507
50,12,57,Florida,Hillsborough County,3,0,14809,7588,7221
50,12,57,Florida,Hillsborough County,3,1,55357,28361,26996
50,12,57,Florida,Hillsborough County,3,2,72266,37061,35205
50,12,57,Florida,Hillsborough County,3,3,74718,38225,36493
50,12,57,Florida,Hillsborough County,3,4,69238,35496,33742
50,12,57,Florida,Hillsborough County,3,5,71758,35265,36493
50,12,57,Florida,Hillsborough County,3,6,72755,36236,36519
50,12,57,Florida,Hillsborough County,3,7,79108,39420,39688
50,12,57,Florida,Hillsborough County,3,8,85174,42281,42893
50,12,57,Florida,Hillsborough County,3,9,83845,41510,42335
50,12,57,Florida,Hillsborough County,3,10,73614,35796,37818
50,12,57,Florida,Hillsborough County,3,11,66593,32500,34093
50,12,57,Florida,Hillsborough County,3,12,49243,23759,25484
50,12,57,Florida,Hillsborough County,3,13,38573,18304,20269
50,12,57,Florida,Hillsborough County,3,14,33372,15656,17716
50,12,57,Florida,Hillsborough County,3,15,30969,13825,17144
50,12,57,Florida,Hillsborough County,3,16,25806,10585,15221
50,12,57,Florida,Hillsborough County,3,17,17914,6994,10920
50,12,57,Florida,Hillsborough County,3,18,13273,4207,9066
50,12,57,Florida,Hillsborough County,3,99,1028385,503069,525316
50,12,57,Florida,Hillsborough County,4,0,14784,7516,7268
50,12,57,Florida,Hillsborough County,4,1,57213,29407,27806
50,12,57,Florida,Hillsborough County,4,2,72500,37044,35456
50,12,57,Florida,Hillsborough County,4,3,77021,39417,37604
50,12,57,Florida,Hillsborough County,4,4,71158,36715,34443
50,12,57,Florida,Hillsborough County,4,5,75294,36680,38614
50,12,57,Florida,Hillsborough County,4,6,74003,36794,37209
50,12,57,Florida,Hillsborough County,4,7,81111,40237,40874
50,12,57,Florida,Hillsborough County,4,8,84920,42064,42856
50,12,57,Florida,Hillsborough County,4,9,85666,42350,43316
50,12,57,Florida,Hillsborough County,4,10,76910,37454,39456
50,12,57,Florida,Hillsborough County,4,11,67046,32567,34479
50,12,57,Florida,Hillsborough County,4,12,54398,26313,28085
50,12,57,Florida,Hillsborough County,4,13,40264,19127,21137
50,12,57,Florida,Hillsborough County,4,14,33882,15877,18005
50,12,57,Florida,Hillsborough County,4,15,30749,13853,16896
50,12,57,Florida,Hillsborough County,4,16,25983,10698,15285
50,12,57,Florida,Hillsborough County,4,17,18465,7183,11282
50,12,57,Florida,Hillsborough County,4,18,13493,4388,9105
50,12,57,Florida,Hillsborough County,4,99,1054860,515684,539176
50,12,57,Florida,Hillsborough County,5,0,14817,7671,7146
50,12,57,Florida,Hillsborough County,5,1,58674,30050,28624
50,12,57,Florida,Hillsborough County,5,2,72128,36801,35327
50,12,57,Florida,Hillsborough County,5,3,78936,40452,38484
50,12,57,Florida,Hillsborough County,5,4,73542,37884,35658
50,12,57,Florida,Hillsborough County,5,5,78027,38086,39941
50,12,57,Florida,Hillsborough County,5,6,75583,37456,38127
50,12,57,Florida,Hillsborough County,5,7,81739,40542,41197
50,12,57,Florida,Hillsborough County,5,8,83848,41570,42278
50,12,57,Florida,Hillsborough County,5,9,87381,43235,44146
50,12,57,Florida,Hillsborough County,5,10,79340,38787,40553
50,12,57,Florida,Hillsborough County,5,11,68819,33327,35492
50,12,57,Florida,Hillsborough County,5,12,57300,27651,29649
50,12,57,Florida,Hillsborough County,5,13,42494,20210,22284
50,12,57,Florida,Hillsborough County,5,14,34765,16293,18472
50,12,57,Florida,Hillsborough County,5,15,30675,13897,16778
50,12,57,Florida,Hillsborough County,5,16,26373,10909,15464
50,12,57,Florida,Hillsborough County,5,17,18909,7420,11489
50,12,57,Florida,Hillsborough County,5,18,14112,4590,9522
50,12,57,Florida,Hillsborough County,5,99,1077462,526831,550631
50,12,57,Florida,Hillsborough County,6,0,15329,7972,7357
50,12,57,Florida,Hillsborough County,6,1,60478,30978,29500
50,12,57,Florida,Hillsborough County,6,2,73111,37328,35783
50,12,57,Florida,Hillsborough County,6,3,80515,41083,39432
50,12,57,Florida,Hillsborough County,6,4,76868,39593,37275
50,12,57,Florida,Hillsborough County,6,5,80912,39482,41430
50,12,57,Florida,Hillsborough County,6,6,79451,39384,40067
50,12,57,Florida,Hillsborough County,6,7,82351,40822,41529
50,12,57,Florida,Hillsborough County,6,8,83610,41572,42038
50,12,57,Florida,Hillsborough County,6,9,89922,44232,45690
50,12,57,Florida,Hillsborough County,6,10,81824,40222,41602
50,12,57,Florida,Hillsborough County,6,11,70827,34189,36638
50,12,57,Florida,Hillsborough County,6,12,60765,29455,31310
50,12,57,Florida,Hillsborough County,6,13,45034,21380,23654
50,12,57,Florida,Hillsborough County,6,14,35750,16570,19180
50,12,57,Florida,Hillsborough County,6,15,30843,14070,16773
50,12,57,Florida,Hillsborough County,6,16,26571,11183,15388
50,12,57,Florida,Hillsborough County,6,17,19373,7557,11816
50,12,57,Florida,Hillsborough County,6,18,14691,4817,9874
50,12,57,Florida,Hillsborough County,6,99,1108225,541889,566336
50,12,57,Florida,Hillsborough County,7,0,15931,8213,7718
50,12,57,Florida,Hillsborough County,7,1,62906,32365,30541
50,12,57,Florida,Hillsborough County,7,2,74345,37892,36453
50,12,57,Florida,Hillsborough County,7,3,81981,41894,40087
50,12,57,Florida,Hillsborough County,7,4,80534,41159,39375
50,12,57,Florida,Hillsborough County,7,5,83178,40788,42390
50,12,57,Florida,Hillsborough County,7,6,83352,41138,42214
50,12,57,Florida,Hillsborough County,7,7,82799,40918,41881
50,12,57,Florida,Hillsborough County,7,8,85649,42643,43006
50,12,57,Florida,Hillsborough County,7,9,91841,45198,46643
50,12,57,Florida,Hillsborough County,7,10,85072,41954,43118
50,12,57,Florida,Hillsborough County,7,11,73583,35348,38235
50,12,57,Florida,Hillsborough County,7,12,64236,31016,33220
50,12,57,Florida,Hillsborough County,7,13,47376,22617,24759
50,12,57,Florida,Hillsborough County,7,14,37365,17285,20080
50,12,57,Florida,Hillsborough County,7,15,31027,14120,16907
50,12,57,Florida,Hillsborough County,7,16,26859,11440,15419
50,12,57,Florida,Hillsborough County,7,17,19774,7814,11960
50,12,57,Florida,Hillsborough County,7,18,15346,5004,10342
50,12,57,Florida,Hillsborough County,7,99,1143154,558806,584348
50,12,57,Florida,Hillsborough County,8,0,16256,8368,7888
50,12,57,Florida,Hillsborough County,8,1,64142,33031,31111
50,12,57,Florida,Hillsborough County,8,2,76453,38937,37516
50,12,57,Florida,Hillsborough County,8,3,82674,42369,40305
50,12,57,Florida,Hillsborough County,8,4,84096,42999,41097
50,12,57,Florida,Hillsborough County,8,5,85428,41875,43553
50,12,57,Florida,Hillsborough County,8,6,87584,43017,44567
50,12,57,Florida,Hillsborough County,8,7,81667,40373,41294
50,12,57,Florida,Hillsborough County,8,8,87913,43566,44347
50,12,57,Florida,Hillsborough County,8,9,92128,45494,46634
50,12,57,Florida,Hillsborough County,8,10,88001,43468,44533
50,12,57,Florida,Hillsborough County,8,11,76417,36714,39703
50,12,57,Florida,Hillsborough County,8,12,67503,32483,35020
50,12,57,Florida,Hillsborough County,8,13,49232,23458,25774
50,12,57,Florida,Hillsborough County,8,14,38284,17720,20564
50,12,57,Florida,Hillsborough County,8,15,31203,14252,16951
50,12,57,Florida,Hillsborough County,8,16,26991,11540,15451
50,12,57,Florida,Hillsborough County,8,17,19735,7704,12031
50,12,57,Florida,Hillsborough County,8,18,16119,5333,10786
50,12,57,Florida,Hillsborough County,8,99,1171826,572701,599125
50,12,57,Florida,Hillsborough County,9,0,16665,8628,8037
50,12,57,Florida,Hillsborough County,9,1,63921,32881,31040
50,12,57,Florida,Hillsborough County,9,2,76964,39207,37757
50,12,57,Florida,Hillsborough County,9,3,82482,42154,40328
50,12,57,Florida,Hillsborough County,9,4,85854,43862,41992
50,12,57,Florida,Hillsborough County,9,5,86962,42863,44099
50,12,57,Florida,Hillsborough County,9,6,88880,43298,45582
50,12,57,Florida,Hillsborough County,9,7,80395,39653,40742
50,12,57,Florida,Hillsborough County,9,8,87911,43534,44377
50,12,57,Florida,Hillsborough County,9,9,90819,44863,45956
50,12,57,Florida,Hillsborough County,9,10,89390,44148,45242
50,12,57,Florida,Hillsborough County,9,11,78462,37723,40739
50,12,57,Florida,Hillsborough County,9,12,67999,32630,35369
50,12,57,Florida,Hillsborough County,9,13,53491,25509,27982
50,12,57,Florida,Hillsborough County,9,14,39641,18373,21268
50,12,57,Florida,Hillsborough County,9,15,31683,14421,17262
50,12,57,Florida,Hillsborough County,9,16,26623,11454,15169
50,12,57,Florida,Hillsborough County,9,17,19798,7764,12034
50,12,57,Florida,Hillsborough County,9,18,16746,5540,11206
50,12,57,Florida,Hillsborough County,9,99,1184686,578505,606181
50,12,57,Florida,Hillsborough County,10,0,16592,8550,8042
50,12,57,Florida,Hillsborough County,10,1,64022,32884,31138
50,12,57,Florida,Hillsborough County,10,2,77842,39618,38224
50,12,57,Florida,Hillsborough County,10,3,82166,42033,40133
50,12,57,Florida,Hillsborough County,10,4,87183,44471,42712
50,12,57,Florida,Hillsborough County,10,5,87918,43171,44747
50,12,57,Florida,Hillsborough County,10,6,89296,43435,45861
50,12,57,Florida,Hillsborough County,10,7,80184,39534,40650
50,12,57,Florida,Hillsborough County,10,8,87466,43214,44252
50,12,57,Florida,Hillsborough County,10,9,89177,43906,45271
50,12,57,Florida,Hillsborough County,10,10,90766,44851,45915
50,12,57,Florida,Hillsborough County,10,11,80338,38853,41485
50,12,57,Florida,Hillsborough County,10,12,69139,32977,36162
50,12,57,Florida,Hillsborough County,10,13,56280,26890,29390
50,12,57,Florida,Hillsborough County,10,14,41910,19452,22458
50,12,57,Florida,Hillsborough County,10,15,32438,14711,17727
50,12,57,Florida,Hillsborough County,10,16,26517,11525,14992
50,12,57,Florida,Hillsborough County,10,17,20278,7955,12323
50,12,57,Florida,Hillsborough County,10,18,17261,5793,11468
50,12,57,Florida,Hillsborough County,10,99,1196773,583823,612950
50,12,57,Florida,Hillsborough County,11,0,15888,8139,7749
50,12,57,Florida,Hillsborough County,11,1,64770,33184,31586
50,12,57,Florida,Hillsborough County,11,2,78695,40247,38448
50,12,57,Florida,Hillsborough County,11,3,82428,42250,40178
50,12,57,Florida,Hillsborough County,11,4,88631,45136,43495
50,12,57,Florida,Hillsborough County,11,5,89590,43698,45892
50,12,57,Florida,Hillsborough County,11,6,89614,43596,46018
50,12,57,Florida,Hillsborough County,11,7,81959,40364,41595
50,12,57,Florida,Hillsborough County,11,8,86844,42837,44007
50,12,57,Florida,Hillsborough County,11,9,87882,43371,44511
50,12,57,Florida,Hillsborough County,11,10,92409,45454,46955
50,12,57,Florida,Hillsborough County,11,11,82859,40357,42502
50,12,57,Florida,Hillsborough County,11,12,70618,33681,36937
50,12,57,Florida,Hillsborough County,11,13,59581,28398,31183
50,12,57,Florida,Hillsborough County,11,14,44308,20575,23733
50,12,57,Florida,Hillsborough County,11,15,33162,14923,18239
50,12,57,Florida,Hillsborough County,11,16,26574,11629,14945
50,12,57,Florida,Hillsborough County,11,17,20285,8026,12259
50,12,57,Florida,Hillsborough County,11,18,17953,5993,11960
50,12,57,Florida,Hillsborough County,11,99,1214050,591858,622192
50,12,57,Florida,Hillsborough County,12,0,15810,8136,7674
50,12,57,Florida,Hillsborough County,12,1,64649,33084,31565
50,12,57,Florida,Hillsborough County,12,2,79737,40719,39018
50,12,57,Florida,Hillsborough County,12,3,82835,42407,40428
50,12,57,Florida,Hillsborough County,12,4,88167,44848,43319
50,12,57,Florida,Hillsborough County,12,5,91853,44505,47348
50,12,57,Florida,Hillsborough County,12,6,90023,44008,46015
50,12,57,Florida,Hillsborough County,12,7,83854,41339,42515
50,12,57,Florida,Hillsborough County,12,8,86098,42426,43672
50,12,57,Florida,Hillsborough County,12,9,88244,43700,44544
50,12,57,Florida,Hillsborough County,12,10,93099,45817,47282
50,12,57,Florida,Hillsborough County,12,11,84959,41463,43496
50,12,57,Florida,Hillsborough County,12,12,72285,34443,37842
50,12,57,Florida,Hillsborough County,12,13,62376,29665,32711
50,12,57,Florida,Hillsborough County,12,14,45801,21342,24459
50,12,57,Florida,Hillsborough County,12,15,33971,15292,18679
50,12,57,Florida,Hillsborough County,12,16,26553,11607,14946
50,12,57,Florida,Hillsborough County,12,17,20347,8101,12246
50,12,57,Florida,Hillsborough County,12,18,18565,6182,12383
50,12,57,Florida,Hillsborough County,12,99,1229226,599084,630142
50,12,57,Florida,Hillsborough County,13,0,15877,8172,7705
50,12,57,Florida,Hillsborough County,13,1,64757,33131,31626
50,12,57,Florida,Hillsborough County,13,2,80045,40881,39164
50,12,57,Florida,Hillsborough County,13,3,83057,42518,40539
50,12,57,Florida,Hillsborough County,13,4,88005,44767,43238
50,12,57,Florida,Hillsborough County,13,5,92376,44766,47610
50,12,57,Florida,Hillsborough County,13,6,90346,44224,46122
50,12,57,Florida,Hillsborough County,13,7,84502,41684,42818
50,12,57,Florida,Hillsborough County,13,8,85863,42322,43541
50,12,57,Florida,Hillsborough County,13,9,88422,43790,44632
50,12,57,Florida,Hillsborough County,13,10,93053,45798,47255
50,12,57,Florida,Hillsborough County,13,11,85409,41684,43725
50,12,57,Florida,Hillsborough County,13,12,72829,34711,38118
50,12,57,Florida,Hillsborough County,13,13,63136,30032,33104
50,12,57,Florida,Hillsborough County,13,14,46185,21525,24660
50,12,57,Florida,Hillsborough County,13,15,34213,15409,18804
50,12,57,Florida,Hillsborough County,13,16,26595,11632,14963
50,12,57,Florida,Hillsborough County,13,17,20422,8148,12274
50,12,57,Florida,Hillsborough County,13,18,18754,6259,12495
50,12,57,Florida,Hillsborough County,13,99,1233846,601453,632393
50,12,59,Florida,Holmes County,1,0,209,105,104
50,12,59,Florida,Holmes County,1,1,818,421,397
50,12,59,Florida,Holmes County,1,2,1187,626,561
50,12,59,Florida,Holmes County,1,3,1271,661,610
50,12,59,Florida,Holmes County,1,4,1285,698,587
50,12,59,Florida,Holmes County,1,5,1148,734,414
50,12,59,Florida,Holmes County,1,6,1279,804,475
50,12,59,Florida,Holmes County,1,7,1389,817,572
50,12,59,Florida,Holmes County,1,8,1450,845,605
50,12,59,Florida,Holmes County,1,9,1321,728,593
50,12,59,Florida,Holmes County,1,10,1202,624,578
50,12,59,Florida,Holmes County,1,11,1225,625,600
50,12,59,Florida,Holmes County,1,12,1059,517,542
50,12,59,Florida,Holmes County,1,13,978,493,485
50,12,59,Florida,Holmes County,1,14,798,415,383
50,12,59,Florida,Holmes County,1,15,668,297,371
50,12,59,Florida,Holmes County,1,16,532,209,323
50,12,59,Florida,Holmes County,1,17,375,128,247
50,12,59,Florida,Holmes County,1,18,370,100,270
50,12,59,Florida,Holmes County,1,99,18564,9847,8717
50,12,59,Florida,Holmes County,2,0,210,105,105
50,12,59,Florida,Holmes County,2,1,816,420,396
50,12,59,Florida,Holmes County,2,2,1180,622,558
50,12,59,Florida,Holmes County,2,3,1273,661,612
50,12,59,Florida,Holmes County,2,4,1281,695,586
50,12,59,Florida,Holmes County,2,5,1154,736,418
50,12,59,Florida,Holmes County,2,6,1266,797,469
50,12,59,Florida,Holmes County,2,7,1380,810,570
50,12,59,Florida,Holmes County,2,8,1437,838,599
50,12,59,Florida,Holmes County,2,9,1315,725,590
50,12,59,Florida,Holmes County,2,10,1201,624,577
50,12,59,Florida,Holmes County,2,11,1234,630,604
50,12,59,Florida,Holmes County,2,12,1060,518,542
50,12,59,Florida,Holmes County,2,13,980,495,485
50,12,59,Florida,Holmes County,2,14,805,420,385
50,12,59,Florida,Holmes County,2,15,671,298,373
50,12,59,Florida,Holmes County,2,16,536,212,324
50,12,59,Florida,Holmes County,2,17,380,130,250
50,12,59,Florida,Holmes County,2,18,374,101,273
50,12,59,Florida,Holmes County,2,99,18553,9837,8716
50,12,59,Florida,Holmes County,3,0,226,125,101
50,12,59,Florida,Holmes County,3,1,816,415,401
50,12,59,Florida,Holmes County,3,2,1197,643,554
50,12,59,Florida,Holmes County,3,3,1260,649,611
50,12,59,Florida,Holmes County,3,4,1264,677,587
50,12,59,Florida,Holmes County,3,5,1254,794,460
50,12,59,Florida,Holmes County,3,6,1291,807,484
50,12,59,Florida,Holmes County,3,7,1355,797,558
50,12,59,Florida,Holmes County,3,8,1359,781,578
50,12,59,Florida,Holmes County,3,9,1379,758,621
50,12,59,Florida,Holmes County,3,10,1197,634,563
50,12,59,Florida,Holmes County,3,11,1260,658,602
50,12,59,Florida,Holmes County,3,12,1088,535,553
50,12,59,Florida,Holmes County,3,13,964,479,485
50,12,59,Florida,Holmes County,3,14,873,440,433
50,12,59,Florida,Holmes County,3,15,684,316,368
50,12,59,Florida,Holmes County,3,16,571,228,343
50,12,59,Florida,Holmes County,3,17,368,128,240
50,12,59,Florida,Holmes County,3,18,351,98,253
50,12,59,Florida,Holmes County,3,99,18757,9962,8795
50,12,59,Florida,Holmes County,4,0,218,110,108
50,12,59,Florida,Holmes County,4,1,828,432,396
50,12,59,Florida,Holmes County,4,2,1210,627,583
50,12,59,Florida,Holmes County,4,3,1249,655,594
50,12,59,Florida,Holmes County,4,4,1264,692,572
50,12,59,Florida,Holmes County,4,5,1224,780,444
50,12,59,Florida,Holmes County,4,6,1274,793,481
50,12,59,Florida,Holmes County,4,7,1331,776,555
50,12,59,Florida,Holmes County,4,8,1384,804,580
50,12,59,Florida,Holmes County,4,9,1372,756,616
50,12,59,Florida,Holmes County,4,10,1237,642,595
50,12,59,Florida,Holmes County,4,11,1253,670,583
50,12,59,Florida,Holmes County,4,12,1165,582,583
50,12,59,Florida,Holmes County,4,13,974,493,481
50,12,59,Florida,Holmes County,4,14,909,446,463
50,12,59,Florida,Holmes County,4,15,726,339,387
50,12,59,Florida,Holmes County,4,16,555,234,321
50,12,59,Florida,Holmes County,4,17,375,131,244
50,12,59,Florida,Holmes County,4,18,332,90,242
50,12,59,Florida,Holmes County,4,99,18880,10052,8828
50,12,59,Florida,Holmes County,5,0,230,119,111
50,12,59,Florida,Holmes County,5,1,842,419,423
50,12,59,Florida,Holmes County,5,2,1205,631,574
50,12,59,Florida,Holmes County,5,3,1255,643,612
50,12,59,Florida,Holmes County,5,4,1319,723,596
50,12,59,Florida,Holmes County,5,5,1266,829,437
50,12,59,Florida,Holmes County,5,6,1290,815,475
50,12,59,Florida,Holmes County,5,7,1358,794,564
50,12,59,Florida,Holmes County,5,8,1365,781,584
50,12,59,Florida,Holmes County,5,9,1362,744,618
50,12,59,Florida,Holmes County,5,10,1311,700,611
50,12,59,Florida,Holmes County,5,11,1244,645,599
50,12,59,Florida,Holmes County,5,12,1187,599,588
50,12,59,Florida,Holmes County,5,13,1050,517,533
50,12,59,Florida,Holmes County,5,14,929,463,466
50,12,59,Florida,Holmes County,5,15,752,360,392
50,12,59,Florida,Holmes County,5,16,586,255,331
50,12,59,Florida,Holmes County,5,17,398,145,253
50,12,59,Florida,Holmes County,5,18,305,94,211
50,12,59,Florida,Holmes County,5,99,19254,10276,8978
50,12,59,Florida,Holmes County,6,0,232,119,113
50,12,59,Florida,Holmes County,6,1,808,412,396
50,12,59,Florida,Holmes County,6,2,1165,605,560
50,12,59,Florida,Holmes County,6,3,1273,666,607
50,12,59,Florida,Holmes County,6,4,1322,739,583
50,12,59,Florida,Holmes County,6,5,1271,816,455
50,12,59,Florida,Holmes County,6,6,1226,774,452
50,12,59,Florida,Holmes County,6,7,1356,796,560
50,12,59,Florida,Holmes County,6,8,1322,753,569
50,12,59,Florida,Holmes County,6,9,1361,741,620
50,12,59,Florida,Holmes County,6,10,1335,727,608
50,12,59,Florida,Holmes County,6,11,1260,636,624
50,12,59,Florida,Holmes County,6,12,1221,627,594
50,12,59,Florida,Holmes County,6,13,1112,546,566
50,12,59,Florida,Holmes County,6,14,995,512,483
50,12,59,Florida,Holmes County,6,15,768,378,390
50,12,59,Florida,Holmes County,6,16,574,246,328
50,12,59,Florida,Holmes County,6,17,429,164,265
50,12,59,Florida,Holmes County,6,18,289,77,212
50,12,59,Florida,Holmes County,6,99,19319,10334,8985
50,12,59,Florida,Holmes County,7,0,261,117,144
50,12,59,Florida,Holmes County,7,1,835,444,391
50,12,59,Florida,Holmes County,7,2,1118,585,533
50,12,59,Florida,Holmes County,7,3,1325,679,646
50,12,59,Florida,Holmes County,7,4,1292,729,563
50,12,59,Florida,Holmes County,7,5,1298,835,463
50,12,59,Florida,Holmes County,7,6,1245,755,490
50,12,59,Florida,Holmes County,7,7,1281,758,523
50,12,59,Florida,Holmes County,7,8,1293,738,555
50,12,59,Florida,Holmes County,7,9,1390,757,633
50,12,59,Florida,Holmes County,7,10,1379,751,628
50,12,59,Florida,Holmes County,7,11,1283,642,641
50,12,59,Florida,Holmes County,7,12,1281,671,610
50,12,59,Florida,Holmes County,7,13,1125,535,590
50,12,59,Florida,Holmes County,7,14,1014,513,501
50,12,59,Florida,Holmes County,7,15,830,429,401
50,12,59,Florida,Holmes County,7,16,541,238,303
50,12,59,Florida,Holmes County,7,17,417,151,266
50,12,59,Florida,Holmes County,7,18,315,92,223
50,12,59,Florida,Holmes County,7,99,19523,10419,9104
50,12,59,Florida,Holmes County,8,0,250,118,132
50,12,59,Florida,Holmes County,8,1,891,465,426
50,12,59,Florida,Holmes County,8,2,1142,606,536
50,12,59,Florida,Holmes County,8,3,1341,719,622
50,12,59,Florida,Holmes County,8,4,1299,711,588
50,12,59,Florida,Holmes County,8,5,1280,787,493
50,12,59,Florida,Holmes County,8,6,1281,769,512
50,12,59,Florida,Holmes County,8,7,1300,766,534
50,12,59,Florida,Holmes County,8,8,1268,711,557
50,12,59,Florida,Holmes County,8,9,1341,729,612
50,12,59,Florida,Holmes County,8,10,1477,801,676
50,12,59,Florida,Holmes County,8,11,1304,652,652
50,12,59,Florida,Holmes County,8,12,1349,715,634
50,12,59,Florida,Holmes County,8,13,1154,552,602
50,12,59,Florida,Holmes County,8,14,986,500,486
50,12,59,Florida,Holmes County,8,15,878,430,448
50,12,59,Florida,Holmes County,8,16,541,245,296
50,12,59,Florida,Holmes County,8,17,452,181,271
50,12,59,Florida,Holmes County,8,18,290,90,200
50,12,59,Florida,Holmes County,8,99,19824,10547,9277
50,12,59,Florida,Holmes County,9,0,231,109,122
50,12,59,Florida,Holmes County,9,1,910,475,435
50,12,59,Florida,Holmes County,9,2,1140,585,555
50,12,59,Florida,Holmes County,9,3,1302,691,611
50,12,59,Florida,Holmes County,9,4,1328,721,607
50,12,59,Florida,Holmes County,9,5,1302,814,488
50,12,59,Florida,Holmes County,9,6,1290,763,527
50,12,59,Florida,Holmes County,9,7,1229,732,497
50,12,59,Florida,Holmes County,9,8,1256,702,554
50,12,59,Florida,Holmes County,9,9,1428,771,657
50,12,59,Florida,Holmes County,9,10,1443,783,660
50,12,59,Florida,Holmes County,9,11,1376,687,689
50,12,59,Florida,Holmes County,9,12,1334,728,606
50,12,59,Florida,Holmes County,9,13,1193,564,629
50,12,59,Florida,Holmes County,9,14,990,502,488
50,12,59,Florida,Holmes County,9,15,924,440,484
50,12,59,Florida,Holmes County,9,16,570,261,309
50,12,59,Florida,Holmes County,9,17,441,174,267
50,12,59,Florida,Holmes County,9,18,304,106,198
50,12,59,Florida,Holmes County,9,99,19991,10608,9383
50,12,59,Florida,Holmes County,10,0,255,135,120
50,12,59,Florida,Holmes County,10,1,912,471,441
50,12,59,Florida,Holmes County,10,2,1186,612,574
50,12,59,Florida,Holmes County,10,3,1281,682,599
50,12,59,Florida,Holmes County,10,4,1314,718,596
50,12,59,Florida,Holmes County,10,5,1313,823,490
50,12,59,Florida,Holmes County,10,6,1302,787,515
50,12,59,Florida,Holmes County,10,7,1184,696,488
50,12,59,Florida,Holmes County,10,8,1294,738,556
50,12,59,Florida,Holmes County,10,9,1387,752,635
50,12,59,Florida,Holmes County,10,10,1436,787,649
50,12,59,Florida,Holmes County,10,11,1395,696,699
50,12,59,Florida,Holmes County,10,12,1335,685,650
50,12,59,Florida,Holmes County,10,13,1252,618,634
50,12,59,Florida,Holmes County,10,14,1040,507,533
50,12,59,Florida,Holmes County,10,15,895,428,467
50,12,59,Florida,Holmes County,10,16,594,273,321
50,12,59,Florida,Holmes County,10,17,456,188,268
50,12,59,Florida,Holmes County,10,18,310,112,198
50,12,59,Florida,Holmes County,10,99,20141,10708,9433
50,12,59,Florida,Holmes County,11,0,245,124,121
50,12,59,Florida,Holmes County,11,1,919,479,440
50,12,59,Florida,Holmes County,11,2,1174,595,579
50,12,59,Florida,Holmes County,11,3,1197,635,562
50,12,59,Florida,Holmes County,11,4,1332,741,591
50,12,59,Florida,Holmes County,11,5,1307,831,476
50,12,59,Florida,Holmes County,11,6,1327,794,533
50,12,59,Florida,Holmes County,11,7,1143,678,465
50,12,59,Florida,Holmes County,11,8,1275,714,561
50,12,59,Florida,Holmes County,11,9,1407,778,629
50,12,59,Florida,Holmes County,11,10,1421,792,629
50,12,59,Florida,Holmes County,11,11,1441,734,707
50,12,59,Florida,Holmes County,11,12,1340,681,659
50,12,59,Florida,Holmes County,11,13,1241,616,625
50,12,59,Florida,Holmes County,11,14,1090,524,566
50,12,59,Florida,Holmes County,11,15,934,455,479
50,12,59,Florida,Holmes County,11,16,598,284,314
50,12,59,Florida,Holmes County,11,17,425,175,250
50,12,59,Florida,Holmes County,11,18,331,118,213
50,12,59,Florida,Holmes County,11,99,20147,10748,9399
50,12,59,Florida,Holmes County,12,0,237,116,121
50,12,59,Florida,Holmes County,12,1,899,479,420
50,12,59,Florida,Holmes County,12,2,1130,588,542
50,12,59,Florida,Holmes County,12,3,1186,629,557
50,12,59,Florida,Holmes County,12,4,1310,722,588
50,12,59,Florida,Holmes County,12,5,1280,804,476
50,12,59,Florida,Holmes County,12,6,1255,759,496
50,12,59,Florida,Holmes County,12,7,1091,634,457
50,12,59,Florida,Holmes County,12,8,1220,675,545
50,12,59,Florida,Holmes County,12,9,1367,756,611
50,12,59,Florida,Holmes County,12,10,1430,798,632
50,12,59,Florida,Holmes County,12,11,1466,736,730
50,12,59,Florida,Holmes County,12,12,1343,678,665
50,12,59,Florida,Holmes County,12,13,1288,641,647
50,12,59,Florida,Holmes County,12,14,1102,529,573
50,12,59,Florida,Holmes County,12,15,919,440,479
50,12,59,Florida,Holmes County,12,16,638,317,321
50,12,59,Florida,Holmes County,12,17,425,178,247
50,12,59,Florida,Holmes County,12,18,341,115,226
50,12,59,Florida,Holmes County,12,99,19927,10594,9333
50,12,59,Florida,Holmes County,13,0,231,114,117
50,12,59,Florida,Holmes County,13,1,893,475,418
50,12,59,Florida,Holmes County,13,2,1120,585,535
50,12,59,Florida,Holmes County,13,3,1184,632,552
50,12,59,Florida,Holmes County,13,4,1305,718,587
50,12,59,Florida,Holmes County,13,5,1280,805,475
50,12,59,Florida,Holmes County,13,6,1251,761,490
50,12,59,Florida,Holmes County,13,7,1093,637,456
50,12,59,Florida,Holmes County,13,8,1212,672,540
50,12,59,Florida,Holmes County,13,9,1351,748,603
50,12,59,Florida,Holmes County,13,10,1424,791,633
50,12,59,Florida,Holmes County,13,11,1462,737,725
50,12,59,Florida,Holmes County,13,12,1341,678,663
50,12,59,Florida,Holmes County,13,13,1295,646,649
50,12,59,Florida,Holmes County,13,14,1103,526,577
50,12,59,Florida,Holmes County,13,15,912,437,475
50,12,59,Florida,Holmes County,13,16,636,312,324
50,12,59,Florida,Holmes County,13,17,421,176,245
50,12,59,Florida,Holmes County,13,18,341,116,225
50,12,59,Florida,Holmes County,13,99,19855,10566,9289
50,12,61,Florida,Indian River County,1,0,987,520,467
50,12,61,Florida,Indian River County,1,1,4270,2196,2074
50,12,61,Florida,Indian River County,1,2,6012,3070,2942
50,12,61,Florida,Indian River County,1,3,6397,3276,3121
50,12,61,Florida,Indian River County,1,4,6352,3497,2855
50,12,61,Florida,Indian River County,1,5,4429,2371,2058
50,12,61,Florida,Indian River County,1,6,4797,2492,2305
50,12,61,Florida,Indian River County,1,7,5622,2799,2823
50,12,61,Florida,Indian River County,1,8,7025,3443,3582
50,12,61,Florida,Indian River County,1,9,7691,3698,3993
50,12,61,Florida,Indian River County,1,10,7010,3448,3562
50,12,61,Florida,Indian River County,1,11,6713,3144,3569
50,12,61,Florida,Indian River County,1,12,6164,2766,3398
50,12,61,Florida,Indian River County,1,13,6446,2958,3488
50,12,61,Florida,Indian River County,1,14,7777,3596,4181
50,12,61,Florida,Indian River County,1,15,8664,4000,4664
50,12,61,Florida,Indian River County,1,16,7840,3630,4210
50,12,61,Florida,Indian River County,1,17,5156,2342,2814
50,12,61,Florida,Indian River County,1,18,3525,1346,2179
50,12,61,Florida,Indian River County,1,99,112877,54592,58285
50,12,61,Florida,Indian River County,2,0,998,524,474
50,12,61,Florida,Indian River County,2,1,4273,2195,2078
50,12,61,Florida,Indian River County,2,2,6008,3069,2939
50,12,61,Florida,Indian River County,2,3,6449,3298,3151
50,12,61,Florida,Indian River County,2,4,6390,3521,2869
50,12,61,Florida,Indian River County,2,5,4467,2390,2077
50,12,61,Florida,Indian River County,2,6,4775,2483,2292
50,12,61,Florida,Indian River County,2,7,5635,2806,2829
50,12,61,Florida,Indian River County,2,8,7020,3442,3578
50,12,61,Florida,Indian River County,2,9,7731,3718,4013
50,12,61,Florida,Indian River County,2,10,7066,3476,3590
50,12,61,Florida,Indian River County,2,11,6801,3186,3615
50,12,61,Florida,Indian River County,2,12,6218,2791,3427
50,12,61,Florida,Indian River County,2,13,6494,2982,3512
50,12,61,Florida,Indian River County,2,14,7752,3587,4165
50,12,61,Florida,Indian River County,2,15,8656,4005,4651
50,12,61,Florida,Indian River County,2,16,7853,3639,4214
50,12,61,Florida,Indian River County,2,17,5193,2363,2830
50,12,61,Florida,Indian River County,2,18,3544,1357,2187
50,12,61,Florida,Indian River County,2,99,113323,54832,58491
50,12,61,Florida,Indian River County,3,0,1099,578,521
50,12,61,Florida,Indian River County,3,1,4336,2255,2081
50,12,61,Florida,Indian River County,3,2,5973,3072,2901
50,12,61,Florida,Indian River County,3,3,6646,3390,3256
50,12,61,Florida,Indian River County,3,4,6563,3607,2956
50,12,61,Florida,Indian River County,3,5,4740,2517,2223
50,12,61,Florida,Indian River County,3,6,4745,2482,2263
50,12,61,Florida,Indian River County,3,7,5604,2805,2799
50,12,61,Florida,Indian River County,3,8,6907,3362,3545
50,12,61,Florida,Indian River County,3,9,7912,3847,4065
50,12,61,Florida,Indian River County,3,10,7406,3602,3804
50,12,61,Florida,Indian River County,3,11,7234,3372,3862
50,12,61,Florida,Indian River County,3,12,6480,2948,3532
50,12,61,Florida,Indian River County,3,13,6665,3024,3641
50,12,61,Florida,Indian River County,3,14,7516,3520,3996
50,12,61,Florida,Indian River County,3,15,8666,3996,4670
50,12,61,Florida,Indian River County,3,16,7853,3653,4200
50,12,61,Florida,Indian River County,3,17,5396,2452,2944
50,12,61,Florida,Indian River County,3,18,3715,1423,2292
50,12,61,Florida,Indian River County,3,99,115456,55905,59551
50,12,61,Florida,Indian River County,4,0,1127,579,548
50,12,61,Florida,Indian River County,4,1,4499,2355,2144
50,12,61,Florida,Indian River County,4,2,5987,3078,2909
50,12,61,Florida,Indian River County,4,3,6776,3475,3301
50,12,61,Florida,Indian River County,4,4,6821,3753,3068
50,12,61,Florida,Indian River County,4,5,5065,2666,2399
50,12,61,Florida,Indian River County,4,6,4766,2465,2301
50,12,61,Florida,Indian River County,4,7,5737,2907,2830
50,12,61,Florida,Indian River County,4,8,6669,3214,3455
50,12,61,Florida,Indian River County,4,9,8119,3978,4141
50,12,61,Florida,Indian River County,4,10,7743,3699,4044
50,12,61,Florida,Indian River County,4,11,7426,3528,3898
50,12,61,Florida,Indian River County,4,12,7151,3259,3892
50,12,61,Florida,Indian River County,4,13,6904,3105,3799
50,12,61,Florida,Indian River County,4,14,7446,3482,3964
50,12,61,Florida,Indian River County,4,15,8534,3936,4598
50,12,61,Florida,Indian River County,4,16,7983,3727,4256
50,12,61,Florida,Indian River County,4,17,5500,2470,3030
50,12,61,Florida,Indian River County,4,18,3891,1494,2397
50,12,61,Florida,Indian River County,4,99,118144,57170,60974
50,12,61,Florida,Indian River County,5,0,1144,600,544
50,12,61,Florida,Indian River County,5,1,4579,2424,2155
50,12,61,Florida,Indian River County,5,2,6069,3114,2955
50,12,61,Florida,Indian River County,5,3,6885,3510,3375
50,12,61,Florida,Indian River County,5,4,6978,3825,3153
50,12,61,Florida,Indian River County,5,5,5262,2785,2477
50,12,61,Florida,Indian River County,5,6,4852,2531,2321
50,12,61,Florida,Indian River County,5,7,5729,2876,2853
50,12,61,Florida,Indian River County,5,8,6547,3172,3375
50,12,61,Florida,Indian River County,5,9,8095,3944,4151
50,12,61,Florida,Indian River County,5,10,8159,3879,4280
50,12,61,Florida,Indian River County,5,11,7616,3676,3940
50,12,61,Florida,Indian River County,5,12,7535,3396,4139
50,12,61,Florida,Indian River County,5,13,7389,3333,4056
50,12,61,Florida,Indian River County,5,14,7539,3496,4043
50,12,61,Florida,Indian River County,5,15,8350,3902,4448
50,12,61,Florida,Indian River County,5,16,7970,3738,4232
50,12,61,Florida,Indian River County,5,17,5660,2482,3178
50,12,61,Florida,Indian River County,5,18,4092,1607,2485
50,12,61,Florida,Indian River County,5,99,120450,58290,62160
50,12,61,Florida,Indian River County,6,0,1195,623,572
50,12,61,Florida,Indian River County,6,1,4795,2543,2252
50,12,61,Florida,Indian River County,6,2,6288,3218,3070
50,12,61,Florida,Indian River County,6,3,7045,3610,3435
50,12,61,Florida,Indian River County,6,4,7287,3990,3297
50,12,61,Florida,Indian River County,6,5,5640,2973,2667
50,12,61,Florida,Indian River County,6,6,5024,2609,2415
50,12,61,Florida,Indian River County,6,7,5708,2847,2861
50,12,61,Florida,Indian River County,6,8,6747,3323,3424
50,12,61,Florida,Indian River County,6,9,8277,3985,4292
50,12,61,Florida,Indian River County,6,10,8593,4124,4469
50,12,61,Florida,Indian River County,6,11,8036,3865,4171
50,12,61,Florida,Indian River County,6,12,8188,3672,4516
50,12,61,Florida,Indian River County,6,13,7898,3604,4294
50,12,61,Florida,Indian River County,6,14,7745,3585,4160
50,12,61,Florida,Indian River County,6,15,8423,3949,4474
50,12,61,Florida,Indian River County,6,16,8013,3708,4305
50,12,61,Florida,Indian River County,6,17,5884,2583,3301
50,12,61,Florida,Indian River County,6,18,4215,1688,2527
50,12,61,Florida,Indian River County,6,99,125001,60499,64502
50,12,61,Florida,Indian River County,7,0,1249,625,624
50,12,61,Florida,Indian River County,7,1,5012,2613,2399
50,12,61,Florida,Indian River County,7,2,6481,3319,3162
50,12,61,Florida,Indian River County,7,3,7212,3656,3556
50,12,61,Florida,Indian River County,7,4,7425,4049,3376
50,12,61,Florida,Indian River County,7,5,5844,3093,2751
50,12,61,Florida,Indian River County,7,6,5396,2778,2618
50,12,61,Florida,Indian River County,7,7,5706,2854,2852
50,12,61,Florida,Indian River County,7,8,6807,3332,3475
50,12,61,Florida,Indian River County,7,9,8302,4027,4275
50,12,61,Florida,Indian River County,7,10,9024,4324,4700
50,12,61,Florida,Indian River County,7,11,8365,4016,4349
50,12,61,Florida,Indian River County,7,12,8762,4022,4740
50,12,61,Florida,Indian River County,7,13,8238,3693,4545
50,12,61,Florida,Indian River County,7,14,7961,3704,4257
50,12,61,Florida,Indian River County,7,15,8133,3830,4303
50,12,61,Florida,Indian River County,7,16,7791,3598,4193
50,12,61,Florida,Indian River County,7,17,6071,2716,3355
50,12,61,Florida,Indian River County,7,18,4176,1655,2521
50,12,61,Florida,Indian River County,7,99,127955,61904,66051
50,12,61,Florida,Indian River County,8,0,1359,700,659
50,12,61,Florida,Indian River County,8,1,5222,2705,2517
50,12,61,Florida,Indian River County,8,2,6639,3425,3214
50,12,61,Florida,Indian River County,8,3,7245,3676,3569
50,12,61,Florida,Indian River County,8,4,7778,4275,3503
50,12,61,Florida,Indian River County,8,5,6118,3246,2872
50,12,61,Florida,Indian River County,8,6,5773,2961,2812
50,12,61,Florida,Indian River County,8,7,5783,2895,2888
50,12,61,Florida,Indian River County,8,8,6877,3433,3444
50,12,61,Florida,Indian River County,8,9,8232,3990,4242
50,12,61,Florida,Indian River County,8,10,9383,4504,4879
50,12,61,Florida,Indian River County,8,11,8716,4210,4506
50,12,61,Florida,Indian River County,8,12,9356,4261,5095
50,12,61,Florida,Indian River County,8,13,8525,3862,4663
50,12,61,Florida,Indian River County,8,14,8103,3704,4399
50,12,61,Florida,Indian River County,8,15,7880,3733,4147
50,12,61,Florida,Indian River County,8,16,7909,3644,4265
50,12,61,Florida,Indian River County,8,17,6086,2745,3341
50,12,61,Florida,Indian River County,8,18,4479,1761,2718
50,12,61,Florida,Indian River County,8,99,131463,63730,67733
50,12,61,Florida,Indian River County,9,0,1353,676,677
50,12,61,Florida,Indian River County,9,1,5339,2758,2581
50,12,61,Florida,Indian River County,9,2,6856,3535,3321
50,12,61,Florida,Indian River County,9,3,7439,3797,3642
50,12,61,Florida,Indian River County,9,4,7876,4347,3529
50,12,61,Florida,Indian River County,9,5,6248,3281,2967
50,12,61,Florida,Indian River County,9,6,6135,3159,2976
50,12,61,Florida,Indian River County,9,7,5832,2906,2926
50,12,61,Florida,Indian River County,9,8,7094,3544,3550
50,12,61,Florida,Indian River County,9,9,8056,3852,4204
50,12,61,Florida,Indian River County,9,10,9538,4627,4911
50,12,61,Florida,Indian River County,9,11,9067,4344,4723
50,12,61,Florida,Indian River County,9,12,9339,4327,5012
50,12,61,Florida,Indian River County,9,13,9191,4159,5032
50,12,61,Florida,Indian River County,9,14,8544,3876,4668
50,12,61,Florida,Indian River County,9,15,7843,3726,4117
50,12,61,Florida,Indian River County,9,16,7855,3632,4223
50,12,61,Florida,Indian River County,9,17,6235,2836,3399
50,12,61,Florida,Indian River County,9,18,4724,1885,2839
50,12,61,Florida,Indian River County,9,99,134564,65267,69297
50,12,61,Florida,Indian River County,10,0,1303,655,648
50,12,61,Florida,Indian River County,10,1,5359,2699,2660
50,12,61,Florida,Indian River County,10,2,6913,3586,3327
50,12,61,Florida,Indian River County,10,3,7513,3830,3683
50,12,61,Florida,Indian River County,10,4,8031,4383,3648
50,12,61,Florida,Indian River County,10,5,6119,3238,2881
50,12,61,Florida,Indian River County,10,6,6382,3283,3099
50,12,61,Florida,Indian River County,10,7,5838,2922,2916
50,12,61,Florida,Indian River County,10,8,6986,3436,3550
50,12,61,Florida,Indian River County,10,9,7837,3820,4017
50,12,61,Florida,Indian River County,10,10,9539,4579,4960
50,12,61,Florida,Indian River County,10,11,9424,4486,4938
50,12,61,Florida,Indian River County,10,12,9320,4346,4974
50,12,61,Florida,Indian River County,10,13,9503,4275,5228
50,12,61,Florida,Indian River County,10,14,8997,4162,4835
50,12,61,Florida,Indian River County,10,15,8035,3768,4267
50,12,61,Florida,Indian River County,10,16,7750,3598,4152
50,12,61,Florida,Indian River County,10,17,6327,2925,3402
50,12,61,Florida,Indian River County,10,18,5101,2031,3070
50,12,61,Florida,Indian River County,10,99,136277,66022,70255
50,12,61,Florida,Indian River County,11,0,1214,610,604
50,12,61,Florida,Indian River County,11,1,5346,2672,2674
50,12,61,Florida,Indian River County,11,2,6937,3595,3342
50,12,61,Florida,Indian River County,11,3,7498,3802,3696
50,12,61,Florida,Indian River County,11,4,7997,4383,3614
50,12,61,Florida,Indian River County,11,5,6008,3161,2847
50,12,61,Florida,Indian River County,11,6,6446,3353,3093
50,12,61,Florida,Indian River County,11,7,5870,2913,2957
50,12,61,Florida,Indian River County,11,8,6709,3307,3402
50,12,61,Florida,Indian River County,11,9,7835,3817,4018
50,12,61,Florida,Indian River County,11,10,9331,4462,4869
50,12,61,Florida,Indian River County,11,11,9617,4577,5040
50,12,61,Florida,Indian River County,11,12,9460,4394,5066
50,12,61,Florida,Indian River County,11,13,9820,4398,5422
50,12,61,Florida,Indian River County,11,14,9391,4368,5023
50,12,61,Florida,Indian River County,11,15,8176,3813,4363
50,12,61,Florida,Indian River County,11,16,7646,3573,4073
50,12,61,Florida,Indian River County,11,17,6292,2884,3408
50,12,61,Florida,Indian River County,11,18,5423,2208,3215
50,12,61,Florida,Indian River County,11,99,137016,66290,70726
50,12,61,Florida,Indian River County,12,0,1191,600,591
50,12,61,Florida,Indian River County,12,1,5317,2654,2663
50,12,61,Florida,Indian River County,12,2,7024,3610,3414
50,12,61,Florida,Indian River County,12,3,7463,3813,3650
50,12,61,Florida,Indian River County,12,4,8012,4383,3629
50,12,61,Florida,Indian River County,12,5,6037,3156,2881
50,12,61,Florida,Indian River County,12,6,6421,3345,3076
50,12,61,Florida,Indian River County,12,7,6034,2996,3038
50,12,61,Florida,Indian River County,12,8,6551,3245,3306
50,12,61,Florida,Indian River County,12,9,7664,3691,3973
50,12,61,Florida,Indian River County,12,10,9168,4414,4754
50,12,61,Florida,Indian River County,12,11,9809,4644,5165
50,12,61,Florida,Indian River County,12,12,9581,4465,5116
50,12,61,Florida,Indian River County,12,13,10252,4635,5617
50,12,61,Florida,Indian River County,12,14,9651,4469,5182
50,12,61,Florida,Indian River County,12,15,8385,3937,4448
50,12,61,Florida,Indian River County,12,16,7535,3535,4000
50,12,61,Florida,Indian River County,12,17,6255,2797,3458
50,12,61,Florida,Indian River County,12,18,5678,2359,3319
50,12,61,Florida,Indian River County,12,99,138028,66748,71280
50,12,61,Florida,Indian River County,13,0,1190,599,591
50,12,61,Florida,Indian River County,13,1,5309,2654,2655
50,12,61,Florida,Indian River County,13,2,7030,3619,3411
50,12,61,Florida,Indian River County,13,3,7463,3813,3650
50,12,61,Florida,Indian River County,13,4,7972,4363,3609
50,12,61,Florida,Indian River County,13,5,6048,3159,2889
50,12,61,Florida,Indian River County,13,6,6446,3362,3084
50,12,61,Florida,Indian River County,13,7,6063,3016,3047
50,12,61,Florida,Indian River County,13,8,6509,3225,3284
50,12,61,Florida,Indian River County,13,9,7654,3685,3969
50,12,61,Florida,Indian River County,13,10,9130,4396,4734
50,12,61,Florida,Indian River County,13,11,9832,4653,5179
50,12,61,Florida,Indian River County,13,12,9634,4489,5145
50,12,61,Florida,Indian River County,13,13,10356,4688,5668
50,12,61,Florida,Indian River County,13,14,9717,4502,5215
50,12,61,Florida,Indian River County,13,15,8423,3954,4469
50,12,61,Florida,Indian River County,13,16,7517,3528,3989
50,12,61,Florida,Indian River County,13,17,6260,2805,3455
50,12,61,Florida,Indian River County,13,18,5715,2380,3335
50,12,61,Florida,Indian River County,13,99,138268,66890,71378
50,12,63,Florida,Jackson County,1,0,553,275,278
50,12,63,Florida,Jackson County,1,1,2007,1008,999
50,12,63,Florida,Jackson County,1,2,2856,1437,1419
50,12,63,Florida,Jackson County,1,3,2913,1515,1398
50,12,63,Florida,Jackson County,1,4,3537,1944,1593
50,12,63,Florida,Jackson County,1,5,3130,1859,1271
50,12,63,Florida,Jackson County,1,6,3199,1904,1295
50,12,63,Florida,Jackson County,1,7,3282,1905,1377
50,12,63,Florida,Jackson County,1,8,3744,2164,1580
50,12,63,Florida,Jackson County,1,9,3603,1992,1611
50,12,63,Florida,Jackson County,1,10,3460,1882,1578
50,12,63,Florida,Jackson County,1,11,3014,1589,1425
50,12,63,Florida,Jackson County,1,12,2559,1215,1344
50,12,63,Florida,Jackson County,1,13,2118,1075,1043
50,12,63,Florida,Jackson County,1,14,1936,909,1027
50,12,63,Florida,Jackson County,1,15,1685,747,938
50,12,63,Florida,Jackson County,1,16,1334,537,797
50,12,63,Florida,Jackson County,1,17,965,335,630
50,12,63,Florida,Jackson County,1,18,886,255,631
50,12,63,Florida,Jackson County,1,99,46781,24547,22234
50,12,63,Florida,Jackson County,2,0,557,277,280
50,12,63,Florida,Jackson County,2,1,1994,1004,990
50,12,63,Florida,Jackson County,2,2,2835,1427,1408
50,12,63,Florida,Jackson County,2,3,2917,1515,1402
50,12,63,Florida,Jackson County,2,4,3528,1935,1593
50,12,63,Florida,Jackson County,2,5,3138,1858,1280
50,12,63,Florida,Jackson County,2,6,3155,1875,1280
50,12,63,Florida,Jackson County,2,7,3262,1891,1371
50,12,63,Florida,Jackson County,2,8,3725,2152,1573
50,12,63,Florida,Jackson County,2,9,3600,1991,1609
50,12,63,Florida,Jackson County,2,10,3469,1884,1585
50,12,63,Florida,Jackson County,2,11,3039,1601,1438
50,12,63,Florida,Jackson County,2,12,2567,1220,1347
50,12,63,Florida,Jackson County,2,13,2119,1076,1043
50,12,63,Florida,Jackson County,2,14,1928,906,1022
50,12,63,Florida,Jackson County,2,15,1678,746,932
50,12,63,Florida,Jackson County,2,16,1336,537,799
50,12,63,Florida,Jackson County,2,17,970,337,633
50,12,63,Florida,Jackson County,2,18,884,255,629
50,12,63,Florida,Jackson County,2,99,46701,24487,22214
50,12,63,Florida,Jackson County,3,0,531,272,259
50,12,63,Florida,Jackson County,3,1,2021,1007,1014
50,12,63,Florida,Jackson County,3,2,2689,1358,1331
50,12,63,Florida,Jackson County,3,3,2938,1497,1441
50,12,63,Florida,Jackson County,3,4,3260,1801,1459
50,12,63,Florida,Jackson County,3,5,3227,1891,1336
50,12,63,Florida,Jackson County,3,6,3030,1815,1215
50,12,63,Florida,Jackson County,3,7,3169,1828,1341
50,12,63,Florida,Jackson County,3,8,3509,2029,1480
50,12,63,Florida,Jackson County,3,9,3641,2022,1619
50,12,63,Florida,Jackson County,3,10,3439,1868,1571
50,12,63,Florida,Jackson County,3,11,3135,1655,1480
50,12,63,Florida,Jackson County,3,12,2660,1298,1362
50,12,63,Florida,Jackson County,3,13,2173,1085,1088
50,12,63,Florida,Jackson County,3,14,1988,941,1047
50,12,63,Florida,Jackson County,3,15,1653,756,897
50,12,63,Florida,Jackson County,3,16,1334,535,799
50,12,63,Florida,Jackson County,3,17,984,344,640
50,12,63,Florida,Jackson County,3,18,861,250,611
50,12,63,Florida,Jackson County,3,99,46242,24252,21990
50,12,63,Florida,Jackson County,4,0,535,261,274
50,12,63,Florida,Jackson County,4,1,2116,1065,1051
50,12,63,Florida,Jackson County,4,2,2509,1249,1260
50,12,63,Florida,Jackson County,4,3,2942,1501,1441
50,12,63,Florida,Jackson County,4,4,3138,1719,1419
50,12,63,Florida,Jackson County,4,5,3270,1895,1375
50,12,63,Florida,Jackson County,4,6,3009,1800,1209
50,12,63,Florida,Jackson County,4,7,3130,1786,1344
50,12,63,Florida,Jackson County,4,8,3345,1926,1419
50,12,63,Florida,Jackson County,4,9,3629,2062,1567
50,12,63,Florida,Jackson County,4,10,3490,1883,1607
50,12,63,Florida,Jackson County,4,11,3136,1661,1475
50,12,63,Florida,Jackson County,4,12,2821,1383,1438
50,12,63,Florida,Jackson County,4,13,2253,1123,1130
50,12,63,Florida,Jackson County,4,14,1990,979,1011
50,12,63,Florida,Jackson County,4,15,1673,726,947
50,12,63,Florida,Jackson County,4,16,1345,563,782
50,12,63,Florida,Jackson County,4,17,970,362,608
50,12,63,Florida,Jackson County,4,18,838,231,607
50,12,63,Florida,Jackson County,4,99,46139,24175,21964
50,12,63,Florida,Jackson County,5,0,527,255,272
50,12,63,Florida,Jackson County,5,1,2069,1027,1042
50,12,63,Florida,Jackson County,5,2,2487,1266,1221
50,12,63,Florida,Jackson County,5,3,2901,1486,1415
50,12,63,Florida,Jackson County,5,4,3048,1647,1401
50,12,63,Florida,Jackson County,5,5,3326,1969,1357
50,12,63,Florida,Jackson County,5,6,2926,1770,1156
50,12,63,Florida,Jackson County,5,7,3100,1822,1278
50,12,63,Florida,Jackson County,5,8,3324,1921,1403
50,12,63,Florida,Jackson County,5,9,3632,2064,1568
50,12,63,Florida,Jackson County,5,10,3531,1924,1607
50,12,63,Florida,Jackson County,5,11,3226,1755,1471
50,12,63,Florida,Jackson County,5,12,2921,1454,1467
50,12,63,Florida,Jackson County,5,13,2366,1140,1226
50,12,63,Florida,Jackson County,5,14,2009,1020,989
50,12,63,Florida,Jackson County,5,15,1716,737,979
50,12,63,Florida,Jackson County,5,16,1294,552,742
50,12,63,Florida,Jackson County,5,17,1034,391,643
50,12,63,Florida,Jackson County,5,18,837,236,601
50,12,63,Florida,Jackson County,5,99,46274,24436,21838
50,12,63,Florida,Jackson County,6,0,533,257,276
50,12,63,Florida,Jackson County,6,1,2123,1054,1069
50,12,63,Florida,Jackson County,6,2,2497,1281,1216
50,12,63,Florida,Jackson County,6,3,2918,1506,1412
50,12,63,Florida,Jackson County,6,4,3047,1646,1401
50,12,63,Florida,Jackson County,6,5,3428,2023,1405
50,12,63,Florida,Jackson County,6,6,2916,1770,1146
50,12,63,Florida,Jackson County,6,7,3040,1820,1220
50,12,63,Florida,Jackson County,6,8,3339,1949,1390
50,12,63,Florida,Jackson County,6,9,3679,2128,1551
50,12,63,Florida,Jackson County,6,10,3588,1960,1628
50,12,63,Florida,Jackson County,6,11,3306,1758,1548
50,12,63,Florida,Jackson County,6,12,3001,1552,1449
50,12,63,Florida,Jackson County,6,13,2519,1216,1303
50,12,63,Florida,Jackson County,6,14,2047,1031,1016
50,12,63,Florida,Jackson County,6,15,1777,786,991
50,12,63,Florida,Jackson County,6,16,1293,544,749
50,12,63,Florida,Jackson County,6,17,1014,388,626
50,12,63,Florida,Jackson County,6,18,881,245,636
50,12,63,Florida,Jackson County,6,99,46946,24914,22032
50,12,63,Florida,Jackson County,7,0,588,303,285
50,12,63,Florida,Jackson County,7,1,2198,1089,1109
50,12,63,Florida,Jackson County,7,2,2581,1318,1263
50,12,63,Florida,Jackson County,7,3,2898,1492,1406
50,12,63,Florida,Jackson County,7,4,3107,1672,1435
50,12,63,Florida,Jackson County,7,5,3405,2001,1404
50,12,63,Florida,Jackson County,7,6,3081,1844,1237
50,12,63,Florida,Jackson County,7,7,3087,1874,1213
50,12,63,Florida,Jackson County,7,8,3375,1975,1400
50,12,63,Florida,Jackson County,7,9,3630,2123,1507
50,12,63,Florida,Jackson County,7,10,3680,2009,1671
50,12,63,Florida,Jackson County,7,11,3494,1865,1629
50,12,63,Florida,Jackson County,7,12,3058,1604,1454
50,12,63,Florida,Jackson County,7,13,2623,1255,1368
50,12,63,Florida,Jackson County,7,14,2115,1070,1045
50,12,63,Florida,Jackson County,7,15,1829,822,1007
50,12,63,Florida,Jackson County,7,16,1299,537,762
50,12,63,Florida,Jackson County,7,17,986,365,621
50,12,63,Florida,Jackson County,7,18,896,259,637
50,12,63,Florida,Jackson County,7,99,47930,25477,22453
50,12,63,Florida,Jackson County,8,0,520,259,261
50,12,63,Florida,Jackson County,8,1,2207,1113,1094
50,12,63,Florida,Jackson County,8,2,2626,1358,1268
50,12,63,Florida,Jackson County,8,3,2824,1455,1369
50,12,63,Florida,Jackson County,8,4,3224,1715,1509
50,12,63,Florida,Jackson County,8,5,3294,1938,1356
50,12,63,Florida,Jackson County,8,6,3064,1825,1239
50,12,63,Florida,Jackson County,8,7,3057,1845,1212
50,12,63,Florida,Jackson County,8,8,3409,2026,1383
50,12,63,Florida,Jackson County,8,9,3549,2082,1467
50,12,63,Florida,Jackson County,8,10,3725,2040,1685
50,12,63,Florida,Jackson County,8,11,3562,1909,1653
50,12,63,Florida,Jackson County,8,12,3187,1660,1527
50,12,63,Florida,Jackson County,8,13,2732,1325,1407
50,12,63,Florida,Jackson County,8,14,2206,1091,1115
50,12,63,Florida,Jackson County,8,15,1848,843,1005
50,12,63,Florida,Jackson County,8,16,1279,564,715
50,12,63,Florida,Jackson County,8,17,1047,411,636
50,12,63,Florida,Jackson County,8,18,905,257,648
50,12,63,Florida,Jackson County,8,99,48265,25716,22549
50,12,63,Florida,Jackson County,9,0,570,274,296
50,12,63,Florida,Jackson County,9,1,2138,1111,1027
50,12,63,Florida,Jackson County,9,2,2730,1408,1322
50,12,63,Florida,Jackson County,9,3,2722,1383,1339
50,12,63,Florida,Jackson County,9,4,3232,1719,1513
50,12,63,Florida,Jackson County,9,5,3227,1916,1311
50,12,63,Florida,Jackson County,9,6,3062,1811,1251
50,12,63,Florida,Jackson County,9,7,3034,1844,1190
50,12,63,Florida,Jackson County,9,8,3420,2048,1372
50,12,63,Florida,Jackson County,9,9,3413,1995,1418
50,12,63,Florida,Jackson County,9,10,3729,2055,1674
50,12,63,Florida,Jackson County,9,11,3591,1942,1649
50,12,63,Florida,Jackson County,9,12,3201,1678,1523
50,12,63,Florida,Jackson County,9,13,2898,1412,1486
50,12,63,Florida,Jackson County,9,14,2233,1079,1154
50,12,63,Florida,Jackson County,9,15,1840,864,976
50,12,63,Florida,Jackson County,9,16,1331,533,798
50,12,63,Florida,Jackson County,9,17,1085,485,600
50,12,63,Florida,Jackson County,9,18,912,257,655
50,12,63,Florida,Jackson County,9,99,48368,25814,22554
50,12,63,Florida,Jackson County,10,0,562,283,279
50,12,63,Florida,Jackson County,10,1,2155,1144,1011
50,12,63,Florida,Jackson County,10,2,2730,1399,1331
50,12,63,Florida,Jackson County,10,3,2697,1389,1308
50,12,63,Florida,Jackson County,10,4,3320,1749,1571
50,12,63,Florida,Jackson County,10,5,3294,2028,1266
50,12,63,Florida,Jackson County,10,6,3311,2022,1289
50,12,63,Florida,Jackson County,10,7,3215,2040,1175
50,12,63,Florida,Jackson County,10,8,3678,2340,1338
50,12,63,Florida,Jackson County,10,9,3602,2187,1415
50,12,63,Florida,Jackson County,10,10,3884,2260,1624
50,12,63,Florida,Jackson County,10,11,3698,2046,1652
50,12,63,Florida,Jackson County,10,12,3368,1813,1555
50,12,63,Florida,Jackson County,10,13,3041,1536,1505
50,12,63,Florida,Jackson County,10,14,2331,1102,1229
50,12,63,Florida,Jackson County,10,15,1890,895,995
50,12,63,Florida,Jackson County,10,16,1403,558,845
50,12,63,Florida,Jackson County,10,17,1074,466,608
50,12,63,Florida,Jackson County,10,18,1019,304,715
50,12,63,Florida,Jackson County,10,99,50272,27561,22711
50,12,63,Florida,Jackson County,11,0,517,261,256
50,12,63,Florida,Jackson County,11,1,2188,1146,1042
50,12,63,Florida,Jackson County,11,2,2773,1444,1329
50,12,63,Florida,Jackson County,11,3,2719,1381,1338
50,12,63,Florida,Jackson County,11,4,3287,1726,1561
50,12,63,Florida,Jackson County,11,5,3267,2021,1246
50,12,63,Florida,Jackson County,11,6,3233,1974,1259
50,12,63,Florida,Jackson County,11,7,3152,1970,1182
50,12,63,Florida,Jackson County,11,8,3621,2317,1304
50,12,63,Florida,Jackson County,11,9,3507,2126,1381
50,12,63,Florida,Jackson County,11,10,3919,2293,1626
50,12,63,Florida,Jackson County,11,11,3745,2062,1683
50,12,63,Florida,Jackson County,11,12,3361,1776,1585
50,12,63,Florida,Jackson County,11,13,3023,1577,1446
50,12,63,Florida,Jackson County,11,14,2437,1144,1293
50,12,63,Florida,Jackson County,11,15,1846,863,983
50,12,63,Florida,Jackson County,11,16,1426,603,823
50,12,63,Florida,Jackson County,11,17,1066,429,637
50,12,63,Florida,Jackson County,11,18,977,300,677
50,12,63,Florida,Jackson County,11,99,50064,27413,22651
50,12,63,Florida,Jackson County,12,0,498,246,252
50,12,63,Florida,Jackson County,12,1,2112,1091,1021
50,12,63,Florida,Jackson County,12,2,2769,1454,1315
50,12,63,Florida,Jackson County,12,3,2697,1375,1322
50,12,63,Florida,Jackson County,12,4,3170,1650,1520
50,12,63,Florida,Jackson County,12,5,3237,1993,1244
50,12,63,Florida,Jackson County,12,6,3148,1912,1236
50,12,63,Florida,Jackson County,12,7,3196,1988,1208
50,12,63,Florida,Jackson County,12,8,3636,2322,1314
50,12,63,Florida,Jackson County,12,9,3451,2113,1338
50,12,63,Florida,Jackson County,12,10,3783,2217,1566
50,12,63,Florida,Jackson County,12,11,3754,2073,1681
50,12,63,Florida,Jackson County,12,12,3461,1845,1616
50,12,63,Florida,Jackson County,12,13,3033,1584,1449
50,12,63,Florida,Jackson County,12,14,2478,1177,1301
50,12,63,Florida,Jackson County,12,15,1877,863,1014
50,12,63,Florida,Jackson County,12,16,1428,613,815
50,12,63,Florida,Jackson County,12,17,1049,431,618
50,12,63,Florida,Jackson County,12,18,969,305,664
50,12,63,Florida,Jackson County,12,99,49746,27252,22494
50,12,63,Florida,Jackson County,13,0,497,248,249
50,12,63,Florida,Jackson County,13,1,2099,1086,1013
50,12,63,Florida,Jackson County,13,2,2759,1449,1310
50,12,63,Florida,Jackson County,13,3,2677,1370,1307
50,12,63,Florida,Jackson County,13,4,3150,1636,1514
50,12,63,Florida,Jackson County,13,5,3231,1990,1241
50,12,63,Florida,Jackson County,13,6,3154,1919,1235
50,12,63,Florida,Jackson County,13,7,3196,1988,1208
50,12,63,Florida,Jackson County,13,8,3621,2310,1311
50,12,63,Florida,Jackson County,13,9,3442,2108,1334
50,12,63,Florida,Jackson County,13,10,3769,2207,1562
50,12,63,Florida,Jackson County,13,11,3753,2072,1681
50,12,63,Florida,Jackson County,13,12,3478,1856,1622
50,12,63,Florida,Jackson County,13,13,3056,1592,1464
50,12,63,Florida,Jackson County,13,14,2494,1185,1309
50,12,63,Florida,Jackson County,13,15,1879,862,1017
50,12,63,Florida,Jackson County,13,16,1426,610,816
50,12,63,Florida,Jackson County,13,17,1048,430,618
50,12,63,Florida,Jackson County,13,18,972,308,664
50,12,63,Florida,Jackson County,13,99,49701,27226,22475
50,12,65,Florida,Jefferson County,1,0,160,70,90
50,12,65,Florida,Jefferson County,1,1,519,285,234
50,12,65,Florida,Jefferson County,1,2,797,385,412
50,12,65,Florida,Jefferson County,1,3,871,427,444
50,12,65,Florida,Jefferson County,1,4,894,488,406
50,12,65,Florida,Jefferson County,1,5,736,407,329
50,12,65,Florida,Jefferson County,1,6,750,407,343
50,12,65,Florida,Jefferson County,1,7,845,458,387
50,12,65,Florida,Jefferson County,1,8,988,550,438
50,12,65,Florida,Jefferson County,1,9,1141,603,538
50,12,65,Florida,Jefferson County,1,10,1019,535,484
50,12,65,Florida,Jefferson County,1,11,998,507,491
50,12,65,Florida,Jefferson County,1,12,749,386,363
50,12,65,Florida,Jefferson County,1,13,548,264,284
50,12,65,Florida,Jefferson County,1,14,519,239,280
50,12,65,Florida,Jefferson County,1,15,476,222,254
50,12,65,Florida,Jefferson County,1,16,394,172,222
50,12,65,Florida,Jefferson County,1,17,244,89,155
50,12,65,Florida,Jefferson County,1,18,228,72,156
50,12,65,Florida,Jefferson County,1,99,12876,6566,6310
50,12,65,Florida,Jefferson County,2,0,160,70,90
50,12,65,Florida,Jefferson County,2,1,518,284,234
50,12,65,Florida,Jefferson County,2,2,797,383,414
50,12,65,Florida,Jefferson County,2,3,869,424,445
50,12,65,Florida,Jefferson County,2,4,909,503,406
50,12,65,Florida,Jefferson County,2,5,740,409,331
50,12,65,Florida,Jefferson County,2,6,743,403,340
50,12,65,Florida,Jefferson County,2,7,845,460,385
50,12,65,Florida,Jefferson County,2,8,982,547,435
50,12,65,Florida,Jefferson County,2,9,1140,603,537
50,12,65,Florida,Jefferson County,2,10,1025,538,487
50,12,65,Florida,Jefferson County,2,11,1003,509,494
50,12,65,Florida,Jefferson County,2,12,751,387,364
50,12,65,Florida,Jefferson County,2,13,548,264,284
50,12,65,Florida,Jefferson County,2,14,519,240,279
50,12,65,Florida,Jefferson County,2,15,476,222,254
50,12,65,Florida,Jefferson County,2,16,394,172,222
50,12,65,Florida,Jefferson County,2,17,244,89,155
50,12,65,Florida,Jefferson County,2,18,228,72,156
50,12,65,Florida,Jefferson County,2,99,12891,6579,6312
50,12,65,Florida,Jefferson County,3,0,142,73,69
50,12,65,Florida,Jefferson County,3,1,546,285,261
50,12,65,Florida,Jefferson County,3,2,764,373,391
50,12,65,Florida,Jefferson County,3,3,865,410,455
50,12,65,Florida,Jefferson County,3,4,902,494,408
50,12,65,Florida,Jefferson County,3,5,738,419,319
50,12,65,Florida,Jefferson County,3,6,722,376,346
50,12,65,Florida,Jefferson County,3,7,869,470,399
50,12,65,Florida,Jefferson County,3,8,920,520,400
50,12,65,Florida,Jefferson County,3,9,1124,614,510
50,12,65,Florida,Jefferson County,3,10,1035,533,502
50,12,65,Florida,Jefferson County,3,11,995,504,491
50,12,65,Florida,Jefferson County,3,12,802,401,401
50,12,65,Florida,Jefferson County,3,13,593,296,297
50,12,65,Florida,Jefferson County,3,14,511,250,261
50,12,65,Florida,Jefferson County,3,15,499,221,278
50,12,65,Florida,Jefferson County,3,16,386,162,224
50,12,65,Florida,Jefferson County,3,17,255,91,164
50,12,65,Florida,Jefferson County,3,18,203,60,143
50,12,65,Florida,Jefferson County,3,99,12871,6552,6319
50,12,65,Florida,Jefferson County,4,0,155,78,77
50,12,65,Florida,Jefferson County,4,1,618,317,301
50,12,65,Florida,Jefferson County,4,2,766,383,383
50,12,65,Florida,Jefferson County,4,3,889,434,455
50,12,65,Florida,Jefferson County,4,4,911,493,418
50,12,65,Florida,Jefferson County,4,5,781,417,364
50,12,65,Florida,Jefferson County,4,6,752,403,349
50,12,65,Florida,Jefferson County,4,7,886,474,412
50,12,65,Florida,Jefferson County,4,8,942,524,418
50,12,65,Florida,Jefferson County,4,9,1099,593,506
50,12,65,Florida,Jefferson County,4,10,1108,569,539
50,12,65,Florida,Jefferson County,4,11,979,504,475
50,12,65,Florida,Jefferson County,4,12,911,445,466
50,12,65,Florida,Jefferson County,4,13,624,314,310
50,12,65,Florida,Jefferson County,4,14,513,242,271
50,12,65,Florida,Jefferson County,4,15,521,246,275
50,12,65,Florida,Jefferson County,4,16,380,158,222
50,12,65,Florida,Jefferson County,4,17,271,103,168
50,12,65,Florida,Jefferson County,4,18,210,62,148
50,12,65,Florida,Jefferson County,4,99,13316,6759,6557
50,12,65,Florida,Jefferson County,5,0,152,83,69
50,12,65,Florida,Jefferson County,5,1,609,305,304
50,12,65,Florida,Jefferson County,5,2,746,378,368
50,12,65,Florida,Jefferson County,5,3,911,462,449
50,12,65,Florida,Jefferson County,5,4,871,460,411
50,12,65,Florida,Jefferson County,5,5,816,436,380
50,12,65,Florida,Jefferson County,5,6,741,423,318
50,12,65,Florida,Jefferson County,5,7,887,488,399
50,12,65,Florida,Jefferson County,5,8,937,505,432
50,12,65,Florida,Jefferson County,5,9,1130,619,511
50,12,65,Florida,Jefferson County,5,10,1122,595,527
50,12,65,Florida,Jefferson County,5,11,1057,546,511
50,12,65,Florida,Jefferson County,5,12,977,473,504
50,12,65,Florida,Jefferson County,5,13,668,345,323
50,12,65,Florida,Jefferson County,5,14,534,252,282
50,12,65,Florida,Jefferson County,5,15,531,249,282
50,12,65,Florida,Jefferson County,5,16,408,173,235
50,12,65,Florida,Jefferson County,5,17,272,114,158
50,12,65,Florida,Jefferson County,5,18,233,64,169
50,12,65,Florida,Jefferson County,5,99,13602,6970,6632
50,12,65,Florida,Jefferson County,6,0,152,73,79
50,12,65,Florida,Jefferson County,6,1,673,343,330
50,12,65,Florida,Jefferson County,6,2,701,366,335
50,12,65,Florida,Jefferson County,6,3,859,413,446
50,12,65,Florida,Jefferson County,6,4,882,463,419
50,12,65,Florida,Jefferson County,6,5,834,460,374
50,12,65,Florida,Jefferson County,6,6,777,465,312
50,12,65,Florida,Jefferson County,6,7,964,569,395
50,12,65,Florida,Jefferson County,6,8,940,531,409
50,12,65,Florida,Jefferson County,6,9,1205,691,514
50,12,65,Florida,Jefferson County,6,10,1155,620,535
50,12,65,Florida,Jefferson County,6,11,1096,574,522
50,12,65,Florida,Jefferson County,6,12,1023,496,527
50,12,65,Florida,Jefferson County,6,13,720,375,345
50,12,65,Florida,Jefferson County,6,14,550,279,271
50,12,65,Florida,Jefferson County,6,15,527,233,294
50,12,65,Florida,Jefferson County,6,16,430,202,228
50,12,65,Florida,Jefferson County,6,17,297,118,179
50,12,65,Florida,Jefferson County,6,18,245,70,175
50,12,65,Florida,Jefferson County,6,99,14030,7341,6689
50,12,65,Florida,Jefferson County,7,0,179,91,88
50,12,65,Florida,Jefferson County,7,1,624,314,310
50,12,65,Florida,Jefferson County,7,2,751,395,356
50,12,65,Florida,Jefferson County,7,3,799,394,405
50,12,65,Florida,Jefferson County,7,4,903,474,429
50,12,65,Florida,Jefferson County,7,5,860,473,387
50,12,65,Florida,Jefferson County,7,6,816,486,330
50,12,65,Florida,Jefferson County,7,7,907,533,374
50,12,65,Florida,Jefferson County,7,8,923,525,398
50,12,65,Florida,Jefferson County,7,9,1146,656,490
50,12,65,Florida,Jefferson County,7,10,1185,632,553
50,12,65,Florida,Jefferson County,7,11,1096,580,516
50,12,65,Florida,Jefferson County,7,12,1116,542,574
50,12,65,Florida,Jefferson County,7,13,824,423,401
50,12,65,Florida,Jefferson County,7,14,612,299,313
50,12,65,Florida,Jefferson County,7,15,491,223,268
50,12,65,Florida,Jefferson County,7,16,407,198,209
50,12,65,Florida,Jefferson County,7,17,316,118,198
50,12,65,Florida,Jefferson County,7,18,255,82,173
50,12,65,Florida,Jefferson County,7,99,14210,7438,6772
50,12,65,Florida,Jefferson County,8,0,172,97,75
50,12,65,Florida,Jefferson County,8,1,611,323,288
50,12,65,Florida,Jefferson County,8,2,772,412,360
50,12,65,Florida,Jefferson County,8,3,757,362,395
50,12,65,Florida,Jefferson County,8,4,934,468,466
50,12,65,Florida,Jefferson County,8,5,852,468,384
50,12,65,Florida,Jefferson County,8,6,830,494,336
50,12,65,Florida,Jefferson County,8,7,909,547,362
50,12,65,Florida,Jefferson County,8,8,923,521,402
50,12,65,Florida,Jefferson County,8,9,1141,659,482
50,12,65,Florida,Jefferson County,8,10,1232,658,574
50,12,65,Florida,Jefferson County,8,11,1139,587,552
50,12,65,Florida,Jefferson County,8,12,1141,568,573
50,12,65,Florida,Jefferson County,8,13,892,461,431
50,12,65,Florida,Jefferson County,8,14,636,321,315
50,12,65,Florida,Jefferson County,8,15,508,243,265
50,12,65,Florida,Jefferson County,8,16,421,191,230
50,12,65,Florida,Jefferson County,8,17,331,120,211
50,12,65,Florida,Jefferson County,8,18,260,95,165
50,12,65,Florida,Jefferson County,8,99,14461,7595,6866
50,12,65,Florida,Jefferson County,9,0,185,93,92
50,12,65,Florida,Jefferson County,9,1,558,307,251
50,12,65,Florida,Jefferson County,9,2,780,400,380
50,12,65,Florida,Jefferson County,9,3,708,331,377
50,12,65,Florida,Jefferson County,9,4,905,466,439
50,12,65,Florida,Jefferson County,9,5,823,457,366
50,12,65,Florida,Jefferson County,9,6,832,501,331
50,12,65,Florida,Jefferson County,9,7,877,534,343
50,12,65,Florida,Jefferson County,9,8,872,489,383
50,12,65,Florida,Jefferson County,9,9,1116,641,475
50,12,65,Florida,Jefferson County,9,10,1221,653,568
50,12,65,Florida,Jefferson County,9,11,1191,607,584
50,12,65,Florida,Jefferson County,9,12,1159,583,576
50,12,65,Florida,Jefferson County,9,13,958,480,478
50,12,65,Florida,Jefferson County,9,14,672,331,341
50,12,65,Florida,Jefferson County,9,15,521,250,271
50,12,65,Florida,Jefferson County,9,16,436,205,231
50,12,65,Florida,Jefferson County,9,17,305,111,194
50,12,65,Florida,Jefferson County,9,18,264,102,162
50,12,65,Florida,Jefferson County,9,99,14383,7541,6842
50,12,65,Florida,Jefferson County,10,0,198,108,90
50,12,65,Florida,Jefferson County,10,1,606,310,296
50,12,65,Florida,Jefferson County,10,2,808,409,399
50,12,65,Florida,Jefferson County,10,3,717,365,352
50,12,65,Florida,Jefferson County,10,4,867,451,416
50,12,65,Florida,Jefferson County,10,5,782,405,377
50,12,65,Florida,Jefferson County,10,6,853,501,352
50,12,65,Florida,Jefferson County,10,7,894,541,353
50,12,65,Florida,Jefferson County,10,8,901,523,378
50,12,65,Florida,Jefferson County,10,9,1055,598,457
50,12,65,Florida,Jefferson County,10,10,1199,655,544
50,12,65,Florida,Jefferson County,10,11,1218,650,568
50,12,65,Florida,Jefferson County,10,12,1227,583,644
50,12,65,Florida,Jefferson County,10,13,1004,510,494
50,12,65,Florida,Jefferson County,10,14,729,364,365
50,12,65,Florida,Jefferson County,10,15,505,252,253
50,12,65,Florida,Jefferson County,10,16,440,207,233
50,12,65,Florida,Jefferson County,10,17,322,121,201
50,12,65,Florida,Jefferson County,10,18,281,102,179
50,12,65,Florida,Jefferson County,10,99,14606,7655,6951
50,12,65,Florida,Jefferson County,11,0,154,87,67
50,12,65,Florida,Jefferson County,11,1,636,331,305
50,12,65,Florida,Jefferson County,11,2,808,393,415
50,12,65,Florida,Jefferson County,11,3,720,382,338
50,12,65,Florida,Jefferson County,11,4,813,416,397
50,12,65,Florida,Jefferson County,11,5,819,436,383
50,12,65,Florida,Jefferson County,11,6,828,500,328
50,12,65,Florida,Jefferson County,11,7,915,549,366
50,12,65,Florida,Jefferson County,11,8,919,538,381
50,12,65,Florida,Jefferson County,11,9,1023,572,451
50,12,65,Florida,Jefferson County,11,10,1219,686,533
50,12,65,Florida,Jefferson County,11,11,1234,645,589
50,12,65,Florida,Jefferson County,11,12,1217,571,646
50,12,65,Florida,Jefferson County,11,13,1037,529,508
50,12,65,Florida,Jefferson County,11,14,812,399,413
50,12,65,Florida,Jefferson County,11,15,531,265,266
50,12,65,Florida,Jefferson County,11,16,406,174,232
50,12,65,Florida,Jefferson County,11,17,327,135,192
50,12,65,Florida,Jefferson County,11,18,286,94,192
50,12,65,Florida,Jefferson County,11,99,14704,7702,7002
50,12,65,Florida,Jefferson County,12,0,153,84,69
50,12,65,Florida,Jefferson County,12,1,624,322,302
50,12,65,Florida,Jefferson County,12,2,766,392,374
50,12,65,Florida,Jefferson County,12,3,756,391,365
50,12,65,Florida,Jefferson County,12,4,765,387,378
50,12,65,Florida,Jefferson County,12,5,810,433,377
50,12,65,Florida,Jefferson County,12,6,827,509,318
50,12,65,Florida,Jefferson County,12,7,942,570,372
50,12,65,Florida,Jefferson County,12,8,905,525,380
50,12,65,Florida,Jefferson County,12,9,1015,566,449
50,12,65,Florida,Jefferson County,12,10,1152,645,507
50,12,65,Florida,Jefferson County,12,11,1275,659,616
50,12,65,Florida,Jefferson County,12,12,1233,579,654
50,12,65,Florida,Jefferson County,12,13,1106,577,529
50,12,65,Florida,Jefferson County,12,14,849,416,433
50,12,65,Florida,Jefferson County,12,15,564,275,289
50,12,65,Florida,Jefferson County,12,16,387,163,224
50,12,65,Florida,Jefferson County,12,17,337,138,199
50,12,65,Florida,Jefferson County,12,18,295,96,199
50,12,65,Florida,Jefferson County,12,99,14761,7727,7034
50,12,65,Florida,Jefferson County,13,0,152,84,68
50,12,65,Florida,Jefferson County,13,1,630,325,305
50,12,65,Florida,Jefferson County,13,2,760,391,369
50,12,65,Florida,Jefferson County,13,3,756,397,359
50,12,65,Florida,Jefferson County,13,4,772,393,379
50,12,65,Florida,Jefferson County,13,5,811,435,376
50,12,65,Florida,Jefferson County,13,6,825,510,315
50,12,65,Florida,Jefferson County,13,7,941,570,371
50,12,65,Florida,Jefferson County,13,8,902,524,378
50,12,65,Florida,Jefferson County,13,9,1008,563,445
50,12,65,Florida,Jefferson County,13,10,1148,640,508
50,12,65,Florida,Jefferson County,13,11,1274,659,615
50,12,65,Florida,Jefferson County,13,12,1238,584,654
50,12,65,Florida,Jefferson County,13,13,1114,582,532
50,12,65,Florida,Jefferson County,13,14,853,418,435
50,12,65,Florida,Jefferson County,13,15,560,273,287
50,12,65,Florida,Jefferson County,13,16,386,161,225
50,12,65,Florida,Jefferson County,13,17,337,139,198
50,12,65,Florida,Jefferson County,13,18,296,97,199
50,12,65,Florida,Jefferson County,13,99,14763,7745,7018
50,12,67,Florida,Lafayette County,1,0,74,43,31
50,12,67,Florida,Lafayette County,1,1,315,179,136
50,12,67,Florida,Lafayette County,1,2,431,227,204
50,12,67,Florida,Lafayette County,1,3,420,223,197
50,12,67,Florida,Lafayette County,1,4,486,277,209
50,12,67,Florida,Lafayette County,1,5,548,405,143
50,12,67,Florida,Lafayette County,1,6,643,469,174
50,12,67,Florida,Lafayette County,1,7,613,429,184
50,12,67,Florida,Lafayette County,1,8,608,416,192
50,12,67,Florida,Lafayette County,1,9,521,333,188
50,12,67,Florida,Lafayette County,1,10,420,229,191
50,12,67,Florida,Lafayette County,1,11,416,235,181
50,12,67,Florida,Lafayette County,1,12,336,172,164
50,12,67,Florida,Lafayette County,1,13,319,165,154
50,12,67,Florida,Lafayette County,1,14,281,152,129
50,12,67,Florida,Lafayette County,1,15,215,107,108
50,12,67,Florida,Lafayette County,1,16,172,69,103
50,12,67,Florida,Lafayette County,1,17,111,50,61
50,12,67,Florida,Lafayette County,1,18,90,19,71
50,12,67,Florida,Lafayette County,1,99,7019,4199,2820
50,12,67,Florida,Lafayette County,2,0,74,43,31
50,12,67,Florida,Lafayette County,2,1,315,179,136
50,12,67,Florida,Lafayette County,2,2,434,229,205
50,12,67,Florida,Lafayette County,2,3,422,223,199
50,12,67,Florida,Lafayette County,2,4,489,279,210
50,12,67,Florida,Lafayette County,2,5,545,401,144
50,12,67,Florida,Lafayette County,2,6,634,461,173
50,12,67,Florida,Lafayette County,2,7,607,423,184
50,12,67,Florida,Lafayette County,2,8,602,411,191
50,12,67,Florida,Lafayette County,2,9,519,330,189
50,12,67,Florida,Lafayette County,2,10,422,229,193
50,12,67,Florida,Lafayette County,2,11,422,238,184
50,12,67,Florida,Lafayette County,2,12,340,173,167
50,12,67,Florida,Lafayette County,2,13,319,165,154
50,12,67,Florida,Lafayette County,2,14,274,148,126
50,12,67,Florida,Lafayette County,2,15,213,107,106
50,12,67,Florida,Lafayette County,2,16,171,69,102
50,12,67,Florida,Lafayette County,2,17,116,52,64
50,12,67,Florida,Lafayette County,2,18,93,19,74
50,12,67,Florida,Lafayette County,2,99,7011,4179,2832
50,12,67,Florida,Lafayette County,3,0,110,53,57
50,12,67,Florida,Lafayette County,3,1,315,164,151
50,12,67,Florida,Lafayette County,3,2,417,224,193
50,12,67,Florida,Lafayette County,3,3,439,232,207
50,12,67,Florida,Lafayette County,3,4,463,268,195
50,12,67,Florida,Lafayette County,3,5,596,430,166
50,12,67,Florida,Lafayette County,3,6,621,448,173
50,12,67,Florida,Lafayette County,3,7,590,423,167
50,12,67,Florida,Lafayette County,3,8,619,410,209
50,12,67,Florida,Lafayette County,3,9,533,336,197
50,12,67,Florida,Lafayette County,3,10,440,242,198
50,12,67,Florida,Lafayette County,3,11,415,230,185
50,12,67,Florida,Lafayette County,3,12,380,192,188
50,12,67,Florida,Lafayette County,3,13,333,177,156
50,12,67,Florida,Lafayette County,3,14,276,147,129
50,12,67,Florida,Lafayette County,3,15,224,115,109
50,12,67,Florida,Lafayette County,3,16,191,75,116
50,12,67,Florida,Lafayette County,3,17,109,44,65
50,12,67,Florida,Lafayette County,3,18,82,19,63
50,12,67,Florida,Lafayette County,3,99,7153,4229,2924
50,12,67,Florida,Lafayette County,4,0,95,47,48
50,12,67,Florida,Lafayette County,4,1,347,182,165
50,12,67,Florida,Lafayette County,4,2,444,241,203
50,12,67,Florida,Lafayette County,4,3,450,229,221
50,12,67,Florida,Lafayette County,4,4,446,251,195
50,12,67,Florida,Lafayette County,4,5,629,445,184
50,12,67,Florida,Lafayette County,4,6,602,444,158
50,12,67,Florida,Lafayette County,4,7,602,432,170
50,12,67,Florida,Lafayette County,4,8,617,409,208
50,12,67,Florida,Lafayette County,4,9,539,336,203
50,12,67,Florida,Lafayette County,4,10,437,244,193
50,12,67,Florida,Lafayette County,4,11,424,239,185
50,12,67,Florida,Lafayette County,4,12,430,228,202
50,12,67,Florida,Lafayette County,4,13,325,173,152
50,12,67,Florida,Lafayette County,4,14,285,148,137
50,12,67,Florida,Lafayette County,4,15,230,121,109
50,12,67,Florida,Lafayette County,4,16,174,68,106
50,12,67,Florida,Lafayette County,4,17,122,53,69
50,12,67,Florida,Lafayette County,4,18,89,22,67
50,12,67,Florida,Lafayette County,4,99,7287,4312,2975
50,12,67,Florida,Lafayette County,5,0,73,34,39
50,12,67,Florida,Lafayette County,5,1,366,194,172
50,12,67,Florida,Lafayette County,5,2,417,232,185
50,12,67,Florida,Lafayette County,5,3,426,215,211
50,12,67,Florida,Lafayette County,5,4,460,265,195
50,12,67,Florida,Lafayette County,5,5,685,494,191
50,12,67,Florida,Lafayette County,5,6,570,438,132
50,12,67,Florida,Lafayette County,5,7,656,443,213
50,12,67,Florida,Lafayette County,5,8,597,400,197
50,12,67,Florida,Lafayette County,5,9,551,363,188
50,12,67,Florida,Lafayette County,5,10,472,270,202
50,12,67,Florida,Lafayette County,5,11,418,228,190
50,12,67,Florida,Lafayette County,5,12,442,240,202
50,12,67,Florida,Lafayette County,5,13,325,163,162
50,12,67,Florida,Lafayette County,5,14,276,145,131
50,12,67,Florida,Lafayette County,5,15,231,113,118
50,12,67,Florida,Lafayette County,5,16,175,76,99
50,12,67,Florida,Lafayette County,5,17,126,56,70
50,12,67,Florida,Lafayette County,5,18,90,20,70
50,12,67,Florida,Lafayette County,5,99,7356,4389,2967
50,12,67,Florida,Lafayette County,6,0,100,51,49
50,12,67,Florida,Lafayette County,6,1,365,182,183
50,12,67,Florida,Lafayette County,6,2,438,262,176
50,12,67,Florida,Lafayette County,6,3,457,231,226
50,12,67,Florida,Lafayette County,6,4,459,274,185
50,12,67,Florida,Lafayette County,6,5,721,525,196
50,12,67,Florida,Lafayette County,6,6,609,461,148
50,12,67,Florida,Lafayette County,6,7,649,454,195
50,12,67,Florida,Lafayette County,6,8,619,428,191
50,12,67,Florida,Lafayette County,6,9,588,385,203
50,12,67,Florida,Lafayette County,6,10,505,309,196
50,12,67,Florida,Lafayette County,6,11,424,219,205
50,12,67,Florida,Lafayette County,6,12,442,246,196
50,12,67,Florida,Lafayette County,6,13,349,177,172
50,12,67,Florida,Lafayette County,6,14,290,152,138
50,12,67,Florida,Lafayette County,6,15,234,118,116
50,12,67,Florida,Lafayette County,6,16,172,77,95
50,12,67,Florida,Lafayette County,6,17,124,49,75
50,12,67,Florida,Lafayette County,6,18,85,18,67
50,12,67,Florida,Lafayette County,6,99,7630,4618,3012
50,12,67,Florida,Lafayette County,7,0,110,48,62
50,12,67,Florida,Lafayette County,7,1,384,197,187
50,12,67,Florida,Lafayette County,7,2,450,259,191
50,12,67,Florida,Lafayette County,7,3,451,224,227
50,12,67,Florida,Lafayette County,7,4,493,291,202
50,12,67,Florida,Lafayette County,7,5,783,603,180
50,12,67,Florida,Lafayette County,7,6,671,528,143
50,12,67,Florida,Lafayette County,7,7,696,497,199
50,12,67,Florida,Lafayette County,7,8,673,478,195
50,12,67,Florida,Lafayette County,7,9,636,416,220
50,12,67,Florida,Lafayette County,7,10,575,367,208
50,12,67,Florida,Lafayette County,7,11,443,246,197
50,12,67,Florida,Lafayette County,7,12,452,249,203
50,12,67,Florida,Lafayette County,7,13,382,203,179
50,12,67,Florida,Lafayette County,7,14,301,145,156
50,12,67,Florida,Lafayette County,7,15,245,133,112
50,12,67,Florida,Lafayette County,7,16,177,79,98
50,12,67,Florida,Lafayette County,7,17,124,49,75
50,12,67,Florida,Lafayette County,7,18,85,27,58
50,12,67,Florida,Lafayette County,7,99,8131,5039,3092
50,12,67,Florida,Lafayette County,8,0,97,50,47
50,12,67,Florida,Lafayette County,8,1,359,187,172
50,12,67,Florida,Lafayette County,8,2,492,266,226
50,12,67,Florida,Lafayette County,8,3,470,250,220
50,12,67,Florida,Lafayette County,8,4,522,297,225
50,12,67,Florida,Lafayette County,8,5,762,578,184
50,12,67,Florida,Lafayette County,8,6,707,534,173
50,12,67,Florida,Lafayette County,8,7,689,491,198
50,12,67,Florida,Lafayette County,8,8,671,479,192
50,12,67,Florida,Lafayette County,8,9,639,411,228
50,12,67,Florida,Lafayette County,8,10,592,387,205
50,12,67,Florida,Lafayette County,8,11,483,273,210
50,12,67,Florida,Lafayette County,8,12,468,257,211
50,12,67,Florida,Lafayette County,8,13,393,207,186
50,12,67,Florida,Lafayette County,8,14,334,164,170
50,12,67,Florida,Lafayette County,8,15,248,130,118
50,12,67,Florida,Lafayette County,8,16,194,86,108
50,12,67,Florida,Lafayette County,8,17,137,56,81
50,12,67,Florida,Lafayette County,8,18,84,26,58
50,12,67,Florida,Lafayette County,8,99,8341,5129,3212
50,12,67,Florida,Lafayette County,9,0,91,38,53
50,12,67,Florida,Lafayette County,9,1,381,202,179
50,12,67,Florida,Lafayette County,9,2,485,246,239
50,12,67,Florida,Lafayette County,9,3,460,244,216
50,12,67,Florida,Lafayette County,9,4,513,308,205
50,12,67,Florida,Lafayette County,9,5,751,589,162
50,12,67,Florida,Lafayette County,9,6,691,494,197
50,12,67,Florida,Lafayette County,9,7,672,487,185
50,12,67,Florida,Lafayette County,9,8,691,484,207
50,12,67,Florida,Lafayette County,9,9,642,423,219
50,12,67,Florida,Lafayette County,9,10,606,391,215
50,12,67,Florida,Lafayette County,9,11,478,268,210
50,12,67,Florida,Lafayette County,9,12,483,277,206
50,12,67,Florida,Lafayette County,9,13,426,228,198
50,12,67,Florida,Lafayette County,9,14,345,168,177
50,12,67,Florida,Lafayette County,9,15,269,143,126
50,12,67,Florida,Lafayette County,9,16,199,97,102
50,12,67,Florida,Lafayette County,9,17,133,44,89
50,12,67,Florida,Lafayette County,9,18,82,33,49
50,12,67,Florida,Lafayette County,9,99,8398,5164,3234
50,12,67,Florida,Lafayette County,10,0,94,42,52
50,12,67,Florida,Lafayette County,10,1,416,218,198
50,12,67,Florida,Lafayette County,10,2,514,261,253
50,12,67,Florida,Lafayette County,10,3,470,246,224
50,12,67,Florida,Lafayette County,10,4,500,298,202
50,12,67,Florida,Lafayette County,10,5,751,588,163
50,12,67,Florida,Lafayette County,10,6,697,483,214
50,12,67,Florida,Lafayette County,10,7,619,452,167
50,12,67,Florida,Lafayette County,10,8,720,494,226
50,12,67,Florida,Lafayette County,10,9,624,409,215
50,12,67,Florida,Lafayette County,10,10,615,413,202
50,12,67,Florida,Lafayette County,10,11,499,291,208
50,12,67,Florida,Lafayette County,10,12,484,279,205
50,12,67,Florida,Lafayette County,10,13,419,220,199
50,12,67,Florida,Lafayette County,10,14,336,157,179
50,12,67,Florida,Lafayette County,10,15,261,136,125
50,12,67,Florida,Lafayette County,10,16,214,97,117
50,12,67,Florida,Lafayette County,10,17,142,61,81
50,12,67,Florida,Lafayette County,10,18,90,34,56
50,12,67,Florida,Lafayette County,10,99,8465,5179,3286
50,12,67,Florida,Lafayette County,11,0,98,45,53
50,12,67,Florida,Lafayette County,11,1,383,211,172
50,12,67,Florida,Lafayette County,11,2,528,260,268
50,12,67,Florida,Lafayette County,11,3,459,235,224
50,12,67,Florida,Lafayette County,11,4,534,316,218
50,12,67,Florida,Lafayette County,11,5,728,556,172
50,12,67,Florida,Lafayette County,11,6,671,470,201
50,12,67,Florida,Lafayette County,11,7,607,438,169
50,12,67,Florida,Lafayette County,11,8,728,497,231
50,12,67,Florida,Lafayette County,11,9,603,408,195
50,12,67,Florida,Lafayette County,11,10,628,403,225
50,12,67,Florida,Lafayette County,11,11,507,305,202
50,12,67,Florida,Lafayette County,11,12,464,244,220
50,12,67,Florida,Lafayette County,11,13,424,228,196
50,12,67,Florida,Lafayette County,11,14,331,165,166
50,12,67,Florida,Lafayette County,11,15,288,136,152
50,12,67,Florida,Lafayette County,11,16,216,104,112
50,12,67,Florida,Lafayette County,11,17,131,57,74
50,12,67,Florida,Lafayette County,11,18,107,35,72
50,12,67,Florida,Lafayette County,11,99,8435,5113,3322
50,12,67,Florida,Lafayette County,12,0,95,43,52
50,12,67,Florida,Lafayette County,12,1,392,206,186
50,12,67,Florida,Lafayette County,12,2,541,268,273
50,12,67,Florida,Lafayette County,12,3,466,232,234
50,12,67,Florida,Lafayette County,12,4,541,321,220
50,12,67,Florida,Lafayette County,12,5,813,636,177
50,12,67,Florida,Lafayette County,12,6,732,536,196
50,12,67,Florida,Lafayette County,12,7,692,504,188
50,12,67,Florida,Lafayette County,12,8,733,508,225
50,12,67,Florida,Lafayette County,12,9,630,439,191
50,12,67,Florida,Lafayette County,12,10,665,435,230
50,12,67,Florida,Lafayette County,12,11,560,340,220
50,12,67,Florida,Lafayette County,12,12,497,273,224
50,12,67,Florida,Lafayette County,12,13,429,231,198
50,12,67,Florida,Lafayette County,12,14,357,179,178
50,12,67,Florida,Lafayette County,12,15,284,135,149
50,12,67,Florida,Lafayette County,12,16,208,108,100
50,12,67,Florida,Lafayette County,12,17,123,51,72
50,12,67,Florida,Lafayette County,12,18,112,36,76
50,12,67,Florida,Lafayette County,12,99,8870,5481,3389
50,12,67,Florida,Lafayette County,13,0,97,44,53
50,12,67,Florida,Lafayette County,13,1,403,208,195
50,12,67,Florida,Lafayette County,13,2,545,274,271
50,12,67,Florida,Lafayette County,13,3,468,234,234
50,12,67,Florida,Lafayette County,13,4,544,322,222
50,12,67,Florida,Lafayette County,13,5,810,634,176
50,12,67,Florida,Lafayette County,13,6,736,537,199
50,12,67,Florida,Lafayette County,13,7,691,505,186
50,12,67,Florida,Lafayette County,13,8,735,507,228
50,12,67,Florida,Lafayette County,13,9,631,440,191
50,12,67,Florida,Lafayette County,13,10,660,433,227
50,12,67,Florida,Lafayette County,13,11,560,339,221
50,12,67,Florida,Lafayette County,13,12,506,279,227
50,12,67,Florida,Lafayette County,13,13,431,233,198
50,12,67,Florida,Lafayette County,13,14,354,177,177
50,12,67,Florida,Lafayette County,13,15,281,133,148
50,12,67,Florida,Lafayette County,13,16,205,105,100
50,12,67,Florida,Lafayette County,13,17,122,52,70
50,12,67,Florida,Lafayette County,13,18,112,36,76
50,12,67,Florida,Lafayette County,13,99,8891,5492,3399
50,12,69,Florida,Lake County,1,0,2177,1159,1018
50,12,69,Florida,Lake County,1,1,8811,4514,4297
50,12,69,Florida,Lake County,1,2,12275,6298,5977
50,12,69,Florida,Lake County,1,3,12480,6284,6196
50,12,69,Florida,Lake County,1,4,10844,5655,5189
50,12,69,Florida,Lake County,1,5,8281,4146,4135
50,12,69,Florida,Lake County,1,6,9806,4847,4959
50,12,69,Florida,Lake County,1,7,11695,5773,5922
50,12,69,Florida,Lake County,1,8,14311,7211,7100
50,12,69,Florida,Lake County,1,9,14164,7036,7128
50,12,69,Florida,Lake County,1,10,12438,6158,6280
50,12,69,Florida,Lake County,1,11,11966,5601,6365
50,12,69,Florida,Lake County,1,12,12097,5480,6617
50,12,69,Florida,Lake County,1,13,13511,6112,7399
50,12,69,Florida,Lake County,1,14,15084,7222,7862
50,12,69,Florida,Lake County,1,15,15165,7405,7760
50,12,69,Florida,Lake County,1,16,12398,5691,6707
50,12,69,Florida,Lake County,1,17,7229,3226,4003
50,12,69,Florida,Lake County,1,18,5686,1998,3688
50,12,69,Florida,Lake County,1,99,210418,101816,108602
50,12,69,Florida,Lake County,2,0,2232,1188,1044
50,12,69,Florida,Lake County,2,1,8859,4538,4321
50,12,69,Florida,Lake County,2,2,12332,6332,6000
50,12,69,Florida,Lake County,2,3,12663,6375,6288
50,12,69,Florida,Lake County,2,4,10990,5733,5257
50,12,69,Florida,Lake County,2,5,8439,4222,4217
50,12,69,Florida,Lake County,2,6,9818,4852,4966
50,12,69,Florida,Lake County,2,7,11803,5827,5976
50,12,69,Florida,Lake County,2,8,14395,7254,7141
50,12,69,Florida,Lake County,2,9,14338,7120,7218
50,12,69,Florida,Lake County,2,10,12643,6260,6383
50,12,69,Florida,Lake County,2,11,12221,5719,6502
50,12,69,Florida,Lake County,2,12,12297,5576,6721
50,12,69,Florida,Lake County,2,13,13708,6206,7502
50,12,69,Florida,Lake County,2,14,15106,7235,7871
50,12,69,Florida,Lake County,2,15,15131,7405,7726
50,12,69,Florida,Lake County,2,16,12397,5695,6702
50,12,69,Florida,Lake County,2,17,7278,3250,4028
50,12,69,Florida,Lake County,2,18,5697,2005,3692
50,12,69,Florida,Lake County,2,99,212347,102792,109555
50,12,69,Florida,Lake County,3,0,2446,1241,1205
50,12,69,Florida,Lake County,3,1,9305,4825,4480
50,12,69,Florida,Lake County,3,2,12619,6388,6231
50,12,69,Florida,Lake County,3,3,13525,6847,6678
50,12,69,Florida,Lake County,3,4,11443,5944,5499
50,12,69,Florida,Lake County,3,5,9196,4603,4593
50,12,69,Florida,Lake County,3,6,9869,4876,4993
50,12,69,Florida,Lake County,3,7,12535,6179,6356
50,12,69,Florida,Lake County,3,8,14673,7361,7312
50,12,69,Florida,Lake County,3,9,15264,7665,7599
50,12,69,Florida,Lake County,3,10,13600,6748,6852
50,12,69,Florida,Lake County,3,11,13320,6185,7135
50,12,69,Florida,Lake County,3,12,13152,5859,7293
50,12,69,Florida,Lake County,3,13,14897,6870,8027
50,12,69,Florida,Lake County,3,14,15790,7569,8221
50,12,69,Florida,Lake County,3,15,15133,7445,7688
50,12,69,Florida,Lake County,3,16,12413,5699,6714
50,12,69,Florida,Lake County,3,17,7485,3374,4111
50,12,69,Florida,Lake County,3,18,5632,1976,3656
50,12,69,Florida,Lake County,3,99,222297,107654,114643
50,12,69,Florida,Lake County,4,0,2564,1308,1256
50,12,69,Florida,Lake County,4,1,10025,5143,4882
50,12,69,Florida,Lake County,4,2,13014,6681,6333
50,12,69,Florida,Lake County,4,3,14264,7182,7082
50,12,69,Florida,Lake County,4,4,12016,6218,5798
50,12,69,Florida,Lake County,4,5,9908,4991,4917
50,12,69,Florida,Lake County,4,6,10372,5050,5322
50,12,69,Florida,Lake County,4,7,13385,6638,6747
50,12,69,Florida,Lake County,4,8,15000,7462,7538
50,12,69,Florida,Lake County,4,9,15813,7995,7818
50,12,69,Florida,Lake County,4,10,14598,7139,7459
50,12,69,Florida,Lake County,4,11,13710,6440,7270
50,12,69,Florida,Lake County,4,12,14524,6554,7970
50,12,69,Florida,Lake County,4,13,15373,7034,8339
50,12,69,Florida,Lake County,4,14,16341,7895,8446
50,12,69,Florida,Lake County,4,15,15008,7387,7621
50,12,69,Florida,Lake County,4,16,12336,5712,6624
50,12,69,Florida,Lake County,4,17,7710,3416,4294
50,12,69,Florida,Lake County,4,18,5558,1965,3593
50,12,69,Florida,Lake County,4,99,231519,112210,119309
50,12,69,Florida,Lake County,5,0,2750,1397,1353
50,12,69,Florida,Lake County,5,1,10694,5457,5237
50,12,69,Florida,Lake County,5,2,13442,6878,6564
50,12,69,Florida,Lake County,5,3,14953,7629,7324
50,12,69,Florida,Lake County,5,4,12754,6566,6188
50,12,69,Florida,Lake County,5,5,10544,5381,5163
50,12,69,Florida,Lake County,5,6,10878,5296,5582
50,12,69,Florida,Lake County,5,7,13682,6782,6900
50,12,69,Florida,Lake County,5,8,15362,7619,7743
50,12,69,Florida,Lake County,5,9,16576,8362,8214
50,12,69,Florida,Lake County,5,10,15641,7672,7969
50,12,69,Florida,Lake County,5,11,14365,6686,7679
50,12,69,Florida,Lake County,5,12,15197,6964,8233
50,12,69,Florida,Lake County,5,13,16410,7560,8850
50,12,69,Florida,Lake County,5,14,17148,8185,8963
50,12,69,Florida,Lake County,5,15,14939,7376,7563
50,12,69,Florida,Lake County,5,16,12403,5824,6579
50,12,69,Florida,Lake County,5,17,8002,3511,4491
50,12,69,Florida,Lake County,5,18,5749,2006,3743
50,12,69,Florida,Lake County,5,99,241489,117151,124338
50,12,69,Florida,Lake County,6,0,2958,1559,1399
50,12,69,Florida,Lake County,6,1,11414,5766,5648
50,12,69,Florida,Lake County,6,2,14166,7249,6917
50,12,69,Florida,Lake County,6,3,15698,8026,7672
50,12,69,Florida,Lake County,6,4,13801,7131,6670
50,12,69,Florida,Lake County,6,5,11298,5780,5518
50,12,69,Florida,Lake County,6,6,11606,5629,5977
50,12,69,Florida,Lake County,6,7,14132,7017,7115
50,12,69,Florida,Lake County,6,8,15883,7858,8025
50,12,69,Florida,Lake County,6,9,17508,8887,8621
50,12,69,Florida,Lake County,6,10,16627,8139,8488
50,12,69,Florida,Lake County,6,11,15305,7122,8183
50,12,69,Florida,Lake County,6,12,16424,7614,8810
50,12,69,Florida,Lake County,6,13,17458,7959,9499
50,12,69,Florida,Lake County,6,14,18245,8671,9574
50,12,69,Florida,Lake County,6,15,15144,7524,7620
50,12,69,Florida,Lake County,6,16,12631,5911,6720
50,12,69,Florida,Lake County,6,17,8495,3734,4761
50,12,69,Florida,Lake County,6,18,5832,2056,3776
50,12,69,Florida,Lake County,6,99,254625,123632,130993
50,12,69,Florida,Lake County,7,0,3042,1559,1483
50,12,69,Florida,Lake County,7,1,12133,6132,6001
50,12,69,Florida,Lake County,7,2,14736,7524,7212
50,12,69,Florida,Lake County,7,3,16426,8444,7982
50,12,69,Florida,Lake County,7,4,14927,7665,7262
50,12,69,Florida,Lake County,7,5,11915,6074,5841
50,12,69,Florida,Lake County,7,6,12378,5961,6417
50,12,69,Florida,Lake County,7,7,14408,7029,7379
50,12,69,Florida,Lake County,7,8,16532,8118,8414
50,12,69,Florida,Lake County,7,9,18424,9334,9090
50,12,69,Florida,Lake County,7,10,17917,8837,9080
50,12,69,Florida,Lake County,7,11,16246,7595,8651
50,12,69,Florida,Lake County,7,12,17749,8059,9690
50,12,69,Florida,Lake County,7,13,18316,8473,9843
50,12,69,Florida,Lake County,7,14,18931,8956,9975
50,12,69,Florida,Lake County,7,15,15713,7814,7899
50,12,69,Florida,Lake County,7,16,12745,6102,6643
50,12,69,Florida,Lake County,7,17,8879,3897,4982
50,12,69,Florida,Lake County,7,18,6170,2198,3972
50,12,69,Florida,Lake County,7,99,267587,129771,137816
50,12,69,Florida,Lake County,8,0,3327,1716,1611
50,12,69,Florida,Lake County,8,1,12605,6449,6156
50,12,69,Florida,Lake County,8,2,15728,8074,7654
50,12,69,Florida,Lake County,8,3,16908,8706,8202
50,12,69,Florida,Lake County,8,4,15915,8166,7749
50,12,69,Florida,Lake County,8,5,12230,6231,5999
50,12,69,Florida,Lake County,8,6,13453,6470,6983
50,12,69,Florida,Lake County,8,7,14432,7071,7361
50,12,69,Florida,Lake County,8,8,17480,8520,8960
50,12,69,Florida,Lake County,8,9,18731,9433,9298
50,12,69,Florida,Lake County,8,10,19138,9539,9599
50,12,69,Florida,Lake County,8,11,17297,8155,9142
50,12,69,Florida,Lake County,8,12,18804,8535,10269
50,12,69,Florida,Lake County,8,13,18911,8668,10243
50,12,69,Florida,Lake County,8,14,20099,9515,10584
50,12,69,Florida,Lake County,8,15,16720,8359,8361
50,12,69,Florida,Lake County,8,16,13373,6393,6980
50,12,69,Florida,Lake County,8,17,9440,4184,5256
50,12,69,Florida,Lake County,8,18,6738,2448,4290
50,12,69,Florida,Lake County,8,99,281329,136632,144697
50,12,69,Florida,Lake County,9,0,3412,1788,1624
50,12,69,Florida,Lake County,9,1,13122,6688,6434
50,12,69,Florida,Lake County,9,2,16513,8474,8039
50,12,69,Florida,Lake County,9,3,17176,8859,8317
50,12,69,Florida,Lake County,9,4,16664,8503,8161
50,12,69,Florida,Lake County,9,5,12922,6699,6223
50,12,69,Florida,Lake County,9,6,14129,6756,7373
50,12,69,Florida,Lake County,9,7,14601,7162,7439
50,12,69,Florida,Lake County,9,8,17882,8788,9094
50,12,69,Florida,Lake County,9,9,18954,9468,9486
50,12,69,Florida,Lake County,9,10,19596,9812,9784
50,12,69,Florida,Lake County,9,11,18189,8507,9682
50,12,69,Florida,Lake County,9,12,18878,8653,10225
50,12,69,Florida,Lake County,9,13,20084,9239,10845
50,12,69,Florida,Lake County,9,14,20455,9667,10788
50,12,69,Florida,Lake County,9,15,17228,8565,8663
50,12,69,Florida,Lake County,9,16,13361,6390,6971
50,12,69,Florida,Lake County,9,17,9668,4341,5327
50,12,69,Florida,Lake County,9,18,7075,2575,4500
50,12,69,Florida,Lake County,9,99,289909,140934,148975
50,12,69,Florida,Lake County,10,0,3403,1747,1656
50,12,69,Florida,Lake County,10,1,13241,6806,6435
50,12,69,Florida,Lake County,10,2,16682,8531,8151
50,12,69,Florida,Lake County,10,3,17298,8899,8399
50,12,69,Florida,Lake County,10,4,17172,8840,8332
50,12,69,Florida,Lake County,10,5,13148,6689,6459
50,12,69,Florida,Lake County,10,6,14213,6919,7294
50,12,69,Florida,Lake County,10,7,14619,7170,7449
50,12,69,Florida,Lake County,10,8,17788,8710,9078
50,12,69,Florida,Lake County,10,9,18782,9319,9463
50,12,69,Florida,Lake County,10,10,19934,9945,9989
50,12,69,Florida,Lake County,10,11,18813,8951,9862
50,12,69,Florida,Lake County,10,12,18591,8477,10114
50,12,69,Florida,Lake County,10,13,20383,9352,11031
50,12,69,Florida,Lake County,10,14,21035,9931,11104
50,12,69,Florida,Lake County,10,15,17573,8618,8955
50,12,69,Florida,Lake County,10,16,13511,6555,6956
50,12,69,Florida,Lake County,10,17,9921,4439,5482
50,12,69,Florida,Lake County,10,18,7547,2810,4737
50,12,69,Florida,Lake County,10,99,293654,142708,150946
50,12,69,Florida,Lake County,11,0,3132,1583,1549
50,12,69,Florida,Lake County,11,1,13352,6855,6497
50,12,69,Florida,Lake County,11,2,16854,8596,8258
50,12,69,Florida,Lake County,11,3,17401,8950,8451
50,12,69,Florida,Lake County,11,4,17270,8895,8375
50,12,69,Florida,Lake County,11,5,13251,6779,6472
50,12,69,Florida,Lake County,11,6,14337,6962,7375
50,12,69,Florida,Lake County,11,7,14672,7170,7502
50,12,69,Florida,Lake County,11,8,17313,8444,8869
50,12,69,Florida,Lake County,11,9,18557,9209,9348
50,12,69,Florida,Lake County,11,10,20176,10036,10140
50,12,69,Florida,Lake County,11,11,19025,9123,9902
50,12,69,Florida,Lake County,11,12,18593,8542,10051
50,12,69,Florida,Lake County,11,13,20608,9379,11229
50,12,69,Florida,Lake County,11,14,21117,9807,11310
50,12,69,Florida,Lake County,11,15,18018,8814,9204
50,12,69,Florida,Lake County,11,16,13679,6680,6999
50,12,69,Florida,Lake County,11,17,10105,4494,5611
50,12,69,Florida,Lake County,11,18,8051,3071,4980
50,12,69,Florida,Lake County,11,99,295511,143389,152122
50,12,69,Florida,Lake County,12,0,3023,1548,1475
50,12,69,Florida,Lake County,12,1,13210,6756,6454
50,12,69,Florida,Lake County,12,2,17115,8701,8414
50,12,69,Florida,Lake County,12,3,17575,9077,8498
50,12,69,Florida,Lake County,12,4,17224,8832,8392
50,12,69,Florida,Lake County,12,5,13499,6850,6649
50,12,69,Florida,Lake County,12,6,14268,6937,7331
50,12,69,Florida,Lake County,12,7,14644,7140,7504
50,12,69,Florida,Lake County,12,8,16841,8114,8727
50,12,69,Florida,Lake County,12,9,18465,9172,9293
50,12,69,Florida,Lake County,12,10,20321,10126,10195
50,12,69,Florida,Lake County,12,11,19430,9359,10071
50,12,69,Florida,Lake County,12,12,18640,8658,9982
50,12,69,Florida,Lake County,12,13,20972,9472,11500
50,12,69,Florida,Lake County,12,14,21120,9813,11307
50,12,69,Florida,Lake County,12,15,17992,8684,9308
50,12,69,Florida,Lake County,12,16,14102,6879,7223
50,12,69,Florida,Lake County,12,17,10228,4613,5615
50,12,69,Florida,Lake County,12,18,8383,3206,5177
50,12,69,Florida,Lake County,12,99,297052,143937,153115
50,12,69,Florida,Lake County,13,0,3038,1555,1483
50,12,69,Florida,Lake County,13,1,13218,6754,6464
50,12,69,Florida,Lake County,13,2,17161,8728,8433
50,12,69,Florida,Lake County,13,3,17600,9084,8516
50,12,69,Florida,Lake County,13,4,17175,8806,8369
50,12,69,Florida,Lake County,13,5,13561,6886,6675
50,12,69,Florida,Lake County,13,6,14323,6971,7352
50,12,69,Florida,Lake County,13,7,14751,7202,7549
50,12,69,Florida,Lake County,13,8,16757,8075,8682
50,12,69,Florida,Lake County,13,9,18466,9170,9296
50,12,69,Florida,Lake County,13,10,20265,10101,10164
50,12,69,Florida,Lake County,13,11,19503,9391,10112
50,12,69,Florida,Lake County,13,12,18768,8718,10050
50,12,69,Florida,Lake County,13,13,21209,9583,11626
50,12,69,Florida,Lake County,13,14,21279,9888,11391
50,12,69,Florida,Lake County,13,15,18090,8732,9358
50,12,69,Florida,Lake County,13,16,14097,6881,7216
50,12,69,Florida,Lake County,13,17,10244,4630,5614
50,12,69,Florida,Lake County,13,18,8445,3238,5207
50,12,69,Florida,Lake County,13,99,297950,144393,153557
50,12,71,Florida,Lee County,1,0,4589,2355,2234
50,12,71,Florida,Lee County,1,1,18381,9415,8966
50,12,71,Florida,Lee County,1,2,24225,12576,11649
50,12,71,Florida,Lee County,1,3,25037,12786,12251
50,12,71,Florida,Lee County,1,4,22502,11826,10676
50,12,71,Florida,Lee County,1,5,18816,9880,8936
50,12,71,Florida,Lee County,1,6,21802,11144,10658
50,12,71,Florida,Lee County,1,7,24694,12590,12104
50,12,71,Florida,Lee County,1,8,29499,14741,14758
50,12,71,Florida,Lee County,1,9,29733,14654,15079
50,12,71,Florida,Lee County,1,10,27350,13183,14167
50,12,71,Florida,Lee County,1,11,27481,12873,14608
50,12,71,Florida,Lee County,1,12,26816,12523,14293
50,12,71,Florida,Lee County,1,13,27861,12960,14901
50,12,71,Florida,Lee County,1,14,29925,14414,15511
50,12,71,Florida,Lee County,1,15,30644,14774,15870
50,12,71,Florida,Lee County,1,16,25154,11831,13323
50,12,71,Florida,Lee County,1,17,15482,6956,8526
50,12,71,Florida,Lee County,1,18,10919,4032,6887
50,12,71,Florida,Lee County,1,99,440910,215513,225397
50,12,71,Florida,Lee County,2,0,4683,2409,2274
50,12,71,Florida,Lee County,2,1,18414,9428,8986
50,12,71,Florida,Lee County,2,2,24234,12585,11649
50,12,71,Florida,Lee County,2,3,25319,12922,12397
50,12,71,Florida,Lee County,2,4,22764,11959,10805
50,12,71,Florida,Lee County,2,5,19153,10055,9098
50,12,71,Florida,Lee County,2,6,21803,11152,10651
50,12,71,Florida,Lee County,2,7,24842,12677,12165
50,12,71,Florida,Lee County,2,8,29568,14780,14788
50,12,71,Florida,Lee County,2,9,29989,14789,15200
50,12,71,Florida,Lee County,2,10,27688,13349,14339
50,12,71,Florida,Lee County,2,11,27934,13084,14850
50,12,71,Florida,Lee County,2,12,27156,12684,14472
50,12,71,Florida,Lee County,2,13,28160,13096,15064
50,12,71,Florida,Lee County,2,14,29958,14441,15517
50,12,71,Florida,Lee County,2,15,30731,14842,15889
50,12,71,Florida,Lee County,2,16,25272,11901,13371
50,12,71,Florida,Lee County,2,17,15644,7033,8611
50,12,71,Florida,Lee County,2,18,10999,4067,6932
50,12,71,Florida,Lee County,2,99,444311,217253,227058
50,12,71,Florida,Lee County,3,0,5315,2702,2613
50,12,71,Florida,Lee County,3,1,19096,9744,9352
50,12,71,Florida,Lee County,3,2,24677,12792,11885
50,12,71,Florida,Lee County,3,3,26616,13539,13077
50,12,71,Florida,Lee County,3,4,23653,12474,11179
50,12,71,Florida,Lee County,3,5,21053,10958,10095
50,12,71,Florida,Lee County,3,6,21873,11170,10703
50,12,71,Florida,Lee County,3,7,25899,13211,12688
50,12,71,Florida,Lee County,3,8,29854,14949,14905
50,12,71,Florida,Lee County,3,9,31459,15636,15823
50,12,71,Florida,Lee County,3,10,29221,14133,15088
50,12,71,Florida,Lee County,3,11,29953,14004,15949
50,12,71,Florida,Lee County,3,12,28611,13273,15338
50,12,71,Florida,Lee County,3,13,29312,13678,15634
50,12,71,Florida,Lee County,3,14,30341,14710,15631
50,12,71,Florida,Lee County,3,15,31105,15090,16015
50,12,71,Florida,Lee County,3,16,25457,12010,13447
50,12,71,Florida,Lee County,3,17,16151,7274,8877
50,12,71,Florida,Lee County,3,18,11391,4277,7114
50,12,71,Florida,Lee County,3,99,461037,225624,235413
50,12,71,Florida,Lee County,4,0,5480,2790,2690
50,12,71,Florida,Lee County,4,1,20307,10411,9896
50,12,71,Florida,Lee County,4,2,25145,12910,12235
50,12,71,Florida,Lee County,4,3,27579,14076,13503
50,12,71,Florida,Lee County,4,4,25090,13189,11901
50,12,71,Florida,Lee County,4,5,22625,11694,10931
50,12,71,Florida,Lee County,4,6,22502,11541,10961
50,12,71,Florida,Lee County,4,7,27053,13769,13284
50,12,71,Florida,Lee County,4,8,29995,15026,14969
50,12,71,Florida,Lee County,4,9,32618,16239,16379
50,12,71,Florida,Lee County,4,10,31055,14997,16058
50,12,71,Florida,Lee County,4,11,30548,14331,16217
50,12,71,Florida,Lee County,4,12,31316,14523,16793
50,12,71,Florida,Lee County,4,13,31336,14741,16595
50,12,71,Florida,Lee County,4,14,30929,14927,16002
50,12,71,Florida,Lee County,4,15,30933,15076,15857
50,12,71,Florida,Lee County,4,16,25939,12276,13663
50,12,71,Florida,Lee County,4,17,16715,7529,9186
50,12,71,Florida,Lee County,4,18,11724,4499,7225
50,12,71,Florida,Lee County,4,99,478889,234544,244345
50,12,71,Florida,Lee County,5,0,5537,2836,2701
50,12,71,Florida,Lee County,5,1,21211,10796,10415
50,12,71,Florida,Lee County,5,2,25762,13261,12501
50,12,71,Florida,Lee County,5,3,28522,14584,13938
50,12,71,Florida,Lee County,5,4,26793,13923,12870
50,12,71,Florida,Lee County,5,5,24540,12708,11832
50,12,71,Florida,Lee County,5,6,23610,12166,11444
50,12,71,Florida,Lee County,5,7,27605,14076,13529
50,12,71,Florida,Lee County,5,8,30291,15283,15008
50,12,71,Florida,Lee County,5,9,33963,16828,17135
50,12,71,Florida,Lee County,5,10,32690,15846,16844
50,12,71,Florida,Lee County,5,11,31543,14806,16737
50,12,71,Florida,Lee County,5,12,33281,15474,17807
50,12,71,Florida,Lee County,5,13,33687,15725,17962
50,12,71,Florida,Lee County,5,14,31837,15529,16308
50,12,71,Florida,Lee County,5,15,30954,15067,15887
50,12,71,Florida,Lee County,5,16,26632,12695,13937
50,12,71,Florida,Lee County,5,17,16991,7652,9339
50,12,71,Florida,Lee County,5,18,12213,4686,7527
50,12,71,Florida,Lee County,5,99,497662,243941,253721
50,12,71,Florida,Lee County,6,0,5782,3055,2727
50,12,71,Florida,Lee County,6,1,22483,11434,11049
50,12,71,Florida,Lee County,6,2,26804,13794,13010
50,12,71,Florida,Lee County,6,3,29827,15237,14590
50,12,71,Florida,Lee County,6,4,28834,14906,13928
50,12,71,Florida,Lee County,6,5,26249,13580,12669
50,12,71,Florida,Lee County,6,6,25613,13206,12407
50,12,71,Florida,Lee County,6,7,28586,14592,13994
50,12,71,Florida,Lee County,6,8,31026,15714,15312
50,12,71,Florida,Lee County,6,9,35586,17755,17831
50,12,71,Florida,Lee County,6,10,34716,16826,17890
50,12,71,Florida,Lee County,6,11,33184,15666,17518
50,12,71,Florida,Lee County,6,12,35654,16525,19129
50,12,71,Florida,Lee County,6,13,35926,16798,19128
50,12,71,Florida,Lee County,6,14,33725,16415,17310
50,12,71,Florida,Lee County,6,15,31051,15147,15904
50,12,71,Florida,Lee County,6,16,26909,12896,14013
50,12,71,Florida,Lee County,6,17,17839,8026,9813
50,12,71,Florida,Lee County,6,18,12637,4893,7744
50,12,71,Florida,Lee County,6,99,522431,256465,265966
50,12,71,Florida,Lee County,7,0,6381,3323,3058
50,12,71,Florida,Lee County,7,1,24536,12473,12063
50,12,71,Florida,Lee County,7,2,28580,14701,13879
50,12,71,Florida,Lee County,7,3,31245,16016,15229
50,12,71,Florida,Lee County,7,4,31140,16082,15058
50,12,71,Florida,Lee County,7,5,28303,14557,13746
50,12,71,Florida,Lee County,7,6,28665,14805,13860
50,12,71,Florida,Lee County,7,7,30120,15230,14890
50,12,71,Florida,Lee County,7,8,32808,16672,16136
50,12,71,Florida,Lee County,7,9,37599,18798,18801
50,12,71,Florida,Lee County,7,10,37188,18129,19059
50,12,71,Florida,Lee County,7,11,35582,16811,18771
50,12,71,Florida,Lee County,7,12,38552,17870,20682
50,12,71,Florida,Lee County,7,13,38197,18031,20166
50,12,71,Florida,Lee County,7,14,35624,17215,18409
50,12,71,Florida,Lee County,7,15,31217,15295,15922
50,12,71,Florida,Lee County,7,16,27390,13277,14113
50,12,71,Florida,Lee County,7,17,18752,8437,10315
50,12,71,Florida,Lee County,7,18,13150,5040,8110
50,12,71,Florida,Lee County,7,99,555029,272762,282267
50,12,71,Florida,Lee County,8,0,7037,3603,3434
50,12,71,Florida,Lee County,8,1,26170,13321,12849
50,12,71,Florida,Lee County,8,2,30648,15728,14920
50,12,71,Florida,Lee County,8,3,32548,16626,15922
50,12,71,Florida,Lee County,8,4,33373,17191,16182
50,12,71,Florida,Lee County,8,5,30252,15577,14675
50,12,71,Florida,Lee County,8,6,32522,16872,15650
50,12,71,Florida,Lee County,8,7,31419,15891,15528
50,12,71,Florida,Lee County,8,8,35028,17860,17168
50,12,71,Florida,Lee County,8,9,38699,19390,19309
50,12,71,Florida,Lee County,8,10,39472,19423,20049
50,12,71,Florida,Lee County,8,11,37370,17737,19633
50,12,71,Florida,Lee County,8,12,40709,18848,21861
50,12,71,Florida,Lee County,8,13,39952,18813,21139
50,12,71,Florida,Lee County,8,14,36719,17785,18934
50,12,71,Florida,Lee County,8,15,31177,15318,15859
50,12,71,Florida,Lee County,8,16,27280,13257,14023
50,12,71,Florida,Lee County,8,17,18669,8445,10224
50,12,71,Florida,Lee County,8,18,13634,5266,8368
50,12,71,Florida,Lee County,8,99,582678,286951,295727
50,12,71,Florida,Lee County,9,0,7518,3872,3646
50,12,71,Florida,Lee County,9,1,27199,13843,13356
50,12,71,Florida,Lee County,9,2,32462,16648,15814
50,12,71,Florida,Lee County,9,3,33720,17155,16565
50,12,71,Florida,Lee County,9,4,34895,18059,16836
50,12,71,Florida,Lee County,9,5,32369,16652,15717
50,12,71,Florida,Lee County,9,6,34619,17975,16644
50,12,71,Florida,Lee County,9,7,32711,16630,16081
50,12,71,Florida,Lee County,9,8,36732,18778,17954
50,12,71,Florida,Lee County,9,9,39068,19712,19356
50,12,71,Florida,Lee County,9,10,40480,19913,20567
50,12,71,Florida,Lee County,9,11,39015,18543,20472
50,12,71,Florida,Lee County,9,12,40395,18739,21656
50,12,71,Florida,Lee County,9,13,42347,19834,22513
50,12,71,Florida,Lee County,9,14,38921,18897,20024
50,12,71,Florida,Lee County,9,15,31950,15656,16294
50,12,71,Florida,Lee County,9,16,26872,13051,13821
50,12,71,Florida,Lee County,9,17,19219,8763,10456
50,12,71,Florida,Lee County,9,18,14224,5542,8682
50,12,71,Florida,Lee County,9,99,604716,298262,306454
50,12,71,Florida,Lee County,10,0,7384,3837,3547
50,12,71,Florida,Lee County,10,1,27294,13823,13471
50,12,71,Florida,Lee County,10,2,33054,17058,15996
50,12,71,Florida,Lee County,10,3,34032,17296,16736
50,12,71,Florida,Lee County,10,4,35261,18097,17164
50,12,71,Florida,Lee County,10,5,32686,16691,15995
50,12,71,Florida,Lee County,10,6,34758,17957,16801
50,12,71,Florida,Lee County,10,7,32465,16452,16013
50,12,71,Florida,Lee County,10,8,36269,18498,17771
50,12,71,Florida,Lee County,10,9,37925,19082,18843
50,12,71,Florida,Lee County,10,10,40835,20057,20778
50,12,71,Florida,Lee County,10,11,39525,18829,20696
50,12,71,Florida,Lee County,10,12,40057,18452,21605
50,12,71,Florida,Lee County,10,13,43755,20408,23347
50,12,71,Florida,Lee County,10,14,41430,19936,21494
50,12,71,Florida,Lee County,10,15,32937,16396,16541
50,12,71,Florida,Lee County,10,16,26849,12963,13886
50,12,71,Florida,Lee County,10,17,19727,9083,10644
50,12,71,Florida,Lee County,10,18,14741,5836,8905
50,12,71,Florida,Lee County,10,99,610984,300751,310233
50,12,71,Florida,Lee County,11,0,6694,3449,3245
50,12,71,Florida,Lee County,11,1,26714,13568,13146
50,12,71,Florida,Lee County,11,2,32850,16872,15978
50,12,71,Florida,Lee County,11,3,33659,17135,16524
50,12,71,Florida,Lee County,11,4,35299,18043,17256
50,12,71,Florida,Lee County,11,5,32531,16344,16187
50,12,71,Florida,Lee County,11,6,33891,17424,16467
50,12,71,Florida,Lee County,11,7,32007,16278,15729
50,12,71,Florida,Lee County,11,8,35243,17835,17408
50,12,71,Florida,Lee County,11,9,36483,18336,18147
50,12,71,Florida,Lee County,11,10,40769,20021,20748
50,12,71,Florida,Lee County,11,11,40176,19166,21010
50,12,71,Florida,Lee County,11,12,40113,18493,21620
50,12,71,Florida,Lee County,11,13,44846,20799,24047
50,12,71,Florida,Lee County,11,14,43407,20916,22491
50,12,71,Florida,Lee County,11,15,34715,17221,17494
50,12,71,Florida,Lee County,11,16,26939,13020,13919
50,12,71,Florida,Lee County,11,17,20075,9318,10757
50,12,71,Florida,Lee County,11,18,15886,6315,9571
50,12,71,Florida,Lee County,11,99,612297,300553,311744
50,12,71,Florida,Lee County,12,0,6477,3341,3136
50,12,71,Florida,Lee County,12,1,26389,13449,12940
50,12,71,Florida,Lee County,12,2,33330,17156,16174
50,12,71,Florida,Lee County,12,3,33995,17256,16739
50,12,71,Florida,Lee County,12,4,35161,17987,17174
50,12,71,Florida,Lee County,12,5,32993,16707,16286
50,12,71,Florida,Lee County,12,6,33570,17116,16454
50,12,71,Florida,Lee County,12,7,32308,16412,15896
50,12,71,Florida,Lee County,12,8,34235,17179,17056
50,12,71,Florida,Lee County,12,9,36241,18198,18043
50,12,71,Florida,Lee County,12,10,40732,20010,20722
50,12,71,Florida,Lee County,12,11,41025,19593,21432
50,12,71,Florida,Lee County,12,12,40665,18788,21877
50,12,71,Florida,Lee County,12,13,46527,21540,24987
50,12,71,Florida,Lee County,12,14,45024,21778,23246
50,12,71,Florida,Lee County,12,15,35886,17737,18149
50,12,71,Florida,Lee County,12,16,27131,13234,13897
50,12,71,Florida,Lee County,12,17,20464,9470,10994
50,12,71,Florida,Lee County,12,18,16601,6649,9952
50,12,71,Florida,Lee County,12,99,618754,303600,315154
50,12,71,Florida,Lee County,13,0,6486,3344,3142
50,12,71,Florida,Lee County,13,1,26360,13433,12927
50,12,71,Florida,Lee County,13,2,33400,17195,16205
50,12,71,Florida,Lee County,13,3,34008,17255,16753
50,12,71,Florida,Lee County,13,4,35022,17922,17100
50,12,71,Florida,Lee County,13,5,33119,16776,16343
50,12,71,Florida,Lee County,13,6,33640,17173,16467
50,12,71,Florida,Lee County,13,7,32510,16522,15988
50,12,71,Florida,Lee County,13,8,34056,17099,16957
50,12,71,Florida,Lee County,13,9,36231,18192,18039
50,12,71,Florida,Lee County,13,10,40609,19948,20661
50,12,71,Florida,Lee County,13,11,41146,19651,21495
50,12,71,Florida,Lee County,13,12,40909,18900,22009
50,12,71,Florida,Lee County,13,13,47011,21777,25234
50,12,71,Florida,Lee County,13,14,45318,21921,23397
50,12,71,Florida,Lee County,13,15,36062,17835,18227
50,12,71,Florida,Lee County,13,16,27085,13220,13865
50,12,71,Florida,Lee County,13,17,20473,9495,10978
50,12,71,Florida,Lee County,13,18,16706,6704,10002
50,12,71,Florida,Lee County,13,99,620151,304362,315789
50,12,73,Florida,Leon County,1,0,2745,1395,1350
50,12,73,Florida,Leon County,1,1,10988,5599,5389
50,12,73,Florida,Leon County,1,2,14169,7205,6964
50,12,73,Florida,Leon County,1,3,14412,7374,7038
50,12,73,Florida,Leon County,1,4,24541,11278,13263
50,12,73,Florida,Leon County,1,5,35466,16960,18506
50,12,73,Florida,Leon County,1,6,19340,9640,9700
50,12,73,Florida,Leon County,1,7,15986,7887,8099
50,12,73,Florida,Leon County,1,8,16718,7862,8856
50,12,73,Florida,Leon County,1,9,17254,8120,9134
50,12,73,Florida,Leon County,1,10,16736,7849,8887
50,12,73,Florida,Leon County,1,11,14592,7098,7494
50,12,73,Florida,Leon County,1,12,9835,4763,5072
50,12,73,Florida,Leon County,1,13,6829,3206,3623
50,12,73,Florida,Leon County,1,14,5458,2520,2938
50,12,73,Florida,Leon County,1,15,4979,2129,2850
50,12,73,Florida,Leon County,1,16,4167,1622,2545
50,12,73,Florida,Leon County,1,17,2884,1019,1865
50,12,73,Florida,Leon County,1,18,2410,640,1770
50,12,73,Florida,Leon County,1,99,239509,114166,125343
50,12,73,Florida,Leon County,2,0,2764,1405,1359
50,12,73,Florida,Leon County,2,1,10945,5573,5372
50,12,73,Florida,Leon County,2,2,14106,7171,6935
50,12,73,Florida,Leon County,2,3,14507,7422,7085
50,12,73,Florida,Leon County,2,4,24799,11382,13417
50,12,73,Florida,Leon County,2,5,35755,17084,18671
50,12,73,Florida,Leon County,2,6,19270,9602,9668
50,12,73,Florida,Leon County,2,7,16044,7918,8126
50,12,73,Florida,Leon County,2,8,16670,7848,8822
50,12,73,Florida,Leon County,2,9,17327,8156,9171
50,12,73,Florida,Leon County,2,10,16863,7910,8953
50,12,73,Florida,Leon County,2,11,14768,7185,7583
50,12,73,Florida,Leon County,2,12,9895,4794,5101
50,12,73,Florida,Leon County,2,13,6867,3224,3643
50,12,73,Florida,Leon County,2,14,5467,2523,2944
50,12,73,Florida,Leon County,2,15,4991,2137,2854
50,12,73,Florida,Leon County,2,16,4200,1636,2564
50,12,73,Florida,Leon County,2,17,2912,1032,1880
50,12,73,Florida,Leon County,2,18,2421,644,1777
50,12,73,Florida,Leon County,2,99,240571,114646,125925
50,12,73,Florida,Leon County,3,0,2933,1484,1449
50,12,73,Florida,Leon County,3,1,10765,5443,5322
50,12,73,Florida,Leon County,3,2,13780,7026,6754
50,12,73,Florida,Leon County,3,3,14614,7366,7248
50,12,73,Florida,Leon County,3,4,25452,11634,13818
50,12,73,Florida,Leon County,3,5,38610,18541,20069
50,12,73,Florida,Leon County,3,6,17098,8499,8599
50,12,73,Florida,Leon County,3,7,16260,7974,8286
50,12,73,Florida,Leon County,3,8,15891,7507,8384
50,12,73,Florida,Leon County,3,9,17109,8025,9084
50,12,73,Florida,Leon County,3,10,16774,7817,8957
50,12,73,Florida,Leon County,3,11,15572,7531,8041
50,12,73,Florida,Leon County,3,12,10319,5056,5263
50,12,73,Florida,Leon County,3,13,7238,3418,3820
50,12,73,Florida,Leon County,3,14,5612,2589,3023
50,12,73,Florida,Leon County,3,15,4967,2144,2823
50,12,73,Florida,Leon County,3,16,4150,1569,2581
50,12,73,Florida,Leon County,3,17,3006,1108,1898
50,12,73,Florida,Leon County,3,18,2433,684,1749
50,12,73,Florida,Leon County,3,99,242583,115415,127168
50,12,73,Florida,Leon County,4,0,2756,1432,1324
50,12,73,Florida,Leon County,4,1,10909,5552,5357
50,12,73,Florida,Leon County,4,2,13624,6872,6752
50,12,73,Florida,Leon County,4,3,14611,7448,7163
50,12,73,Florida,Leon County,4,4,25539,11718,13821
50,12,73,Florida,Leon County,4,5,41396,19750,21646
50,12,73,Florida,Leon County,4,6,16026,7986,8040
50,12,73,Florida,Leon County,4,7,16726,8180,8546
50,12,73,Florida,Leon County,4,8,15237,7241,7996
50,12,73,Florida,Leon County,4,9,16845,7865,8980
50,12,73,Florida,Leon County,4,10,16698,7773,8925
50,12,73,Florida,Leon County,4,11,15709,7513,8196
50,12,73,Florida,Leon County,4,12,11522,5620,5902
50,12,73,Florida,Leon County,4,13,7543,3615,3928
50,12,73,Florida,Leon County,4,14,5676,2598,3078
50,12,73,Florida,Leon County,4,15,4872,2110,2762
50,12,73,Florida,Leon County,4,16,4130,1586,2544
50,12,73,Florida,Leon County,4,17,3135,1157,1978
50,12,73,Florida,Leon County,4,18,2450,687,1763
50,12,73,Florida,Leon County,4,99,245404,116703,128701
50,12,73,Florida,Leon County,5,0,2887,1483,1404
50,12,73,Florida,Leon County,5,1,11054,5641,5413
50,12,73,Florida,Leon County,5,2,13541,6765,6776
50,12,73,Florida,Leon County,5,3,14722,7501,7221
50,12,73,Florida,Leon County,5,4,26127,11963,14164
50,12,73,Florida,Leon County,5,5,43766,20984,22782
50,12,73,Florida,Leon County,5,6,15893,7878,8015
50,12,73,Florida,Leon County,5,7,16977,8264,8713
50,12,73,Florida,Leon County,5,8,14850,7107,7743
50,12,73,Florida,Leon County,5,9,16715,7864,8851
50,12,73,Florida,Leon County,5,10,16765,7821,8944
50,12,73,Florida,Leon County,5,11,16049,7580,8469
50,12,73,Florida,Leon County,5,12,12399,6088,6311
50,12,73,Florida,Leon County,5,13,8148,3845,4303
50,12,73,Florida,Leon County,5,14,5796,2678,3118
50,12,73,Florida,Leon County,5,15,4929,2191,2738
50,12,73,Florida,Leon County,5,16,4221,1659,2562
50,12,73,Florida,Leon County,5,17,3245,1167,2078
50,12,73,Florida,Leon County,5,18,2589,716,1873
50,12,73,Florida,Leon County,5,99,250673,119195,131478
50,12,73,Florida,Leon County,6,0,2927,1491,1436
50,12,73,Florida,Leon County,6,1,11540,5875,5665
50,12,73,Florida,Leon County,6,2,13512,6745,6767
50,12,73,Florida,Leon County,6,3,14745,7534,7211
50,12,73,Florida,Leon County,6,4,25988,11944,14044
50,12,73,Florida,Leon County,6,5,44909,21459,23450
50,12,73,Florida,Leon County,6,6,16135,8038,8097
50,12,73,Florida,Leon County,6,7,17034,8218,8816
50,12,73,Florida,Leon County,6,8,14756,7153,7603
50,12,73,Florida,Leon County,6,9,16605,7777,8828
50,12,73,Florida,Leon County,6,10,16748,7736,9012
50,12,73,Florida,Leon County,6,11,16298,7725,8573
50,12,73,Florida,Leon County,6,12,13257,6450,6807
50,12,73,Florida,Leon County,6,13,8624,4083,4541
50,12,73,Florida,Leon County,6,14,6037,2760,3277
50,12,73,Florida,Leon County,6,15,4877,2171,2706
50,12,73,Florida,Leon County,6,16,4236,1733,2503
50,12,73,Florida,Leon County,6,17,3311,1139,2172
50,12,73,Florida,Leon County,6,18,2649,767,1882
50,12,73,Florida,Leon County,6,99,254188,120798,133390
50,12,73,Florida,Leon County,7,0,2907,1485,1422
50,12,73,Florida,Leon County,7,1,11711,5962,5749
50,12,73,Florida,Leon County,7,2,13774,6925,6849
50,12,73,Florida,Leon County,7,3,14660,7467,7193
50,12,73,Florida,Leon County,7,4,25930,11889,14041
50,12,73,Florida,Leon County,7,5,45571,21848,23723
50,12,73,Florida,Leon County,7,6,16942,8517,8425
50,12,73,Florida,Leon County,7,7,17011,8192,8819
50,12,73,Florida,Leon County,7,8,14985,7283,7702
50,12,73,Florida,Leon County,7,9,16126,7547,8579
50,12,73,Florida,Leon County,7,10,17018,7941,9077
50,12,73,Florida,Leon County,7,11,16343,7628,8715
50,12,73,Florida,Leon County,7,12,14200,6893,7307
50,12,73,Florida,Leon County,7,13,9276,4452,4824
50,12,73,Florida,Leon County,7,14,6261,2890,3371
50,12,73,Florida,Leon County,7,15,4920,2164,2756
50,12,73,Florida,Leon County,7,16,4314,1754,2560
50,12,73,Florida,Leon County,7,17,3326,1166,2160
50,12,73,Florida,Leon County,7,18,2808,813,1995
50,12,73,Florida,Leon County,7,99,258083,122816,135267
50,12,73,Florida,Leon County,8,0,2915,1474,1441
50,12,73,Florida,Leon County,8,1,11828,6038,5790
50,12,73,Florida,Leon County,8,2,14084,7082,7002
50,12,73,Florida,Leon County,8,3,14396,7379,7017
50,12,73,Florida,Leon County,8,4,26431,12117,14314
50,12,73,Florida,Leon County,8,5,46130,22130,24000
50,12,73,Florida,Leon County,8,6,18604,9402,9202
50,12,73,Florida,Leon County,8,7,16244,7780,8464
50,12,73,Florida,Leon County,8,8,15492,7517,7975
50,12,73,Florida,Leon County,8,9,15720,7378,8342
50,12,73,Florida,Leon County,8,10,17105,7937,9168
50,12,73,Florida,Leon County,8,11,16558,7703,8855
50,12,73,Florida,Leon County,8,12,15232,7310,7922
50,12,73,Florida,Leon County,8,13,9893,4791,5102
50,12,73,Florida,Leon County,8,14,6655,3090,3565
50,12,73,Florida,Leon County,8,15,5152,2251,2901
50,12,73,Florida,Leon County,8,16,4279,1750,2529
50,12,73,Florida,Leon County,8,17,3349,1164,2185
50,12,73,Florida,Leon County,8,18,3009,920,2089
50,12,73,Florida,Leon County,8,99,263076,125213,137863
50,12,73,Florida,Leon County,9,0,2931,1466,1465
50,12,73,Florida,Leon County,9,1,11945,6141,5804
50,12,73,Florida,Leon County,9,2,14375,7252,7123
50,12,73,Florida,Leon County,9,3,14461,7402,7059
50,12,73,Florida,Leon County,9,4,27377,12596,14781
50,12,73,Florida,Leon County,9,5,46018,22083,23935
50,12,73,Florida,Leon County,9,6,20395,10276,10119
50,12,73,Florida,Leon County,9,7,15993,7672,8321
50,12,73,Florida,Leon County,9,8,15887,7698,8189
50,12,73,Florida,Leon County,9,9,15463,7326,8137
50,12,73,Florida,Leon County,9,10,17147,7921,9226
50,12,73,Florida,Leon County,9,11,16746,7780,8966
50,12,73,Florida,Leon County,9,12,15466,7390,8076
50,12,73,Florida,Leon County,9,13,11112,5319,5793
50,12,73,Florida,Leon County,9,14,7060,3304,3756
50,12,73,Florida,Leon County,9,15,5266,2300,2966
50,12,73,Florida,Leon County,9,16,4213,1739,2474
50,12,73,Florida,Leon County,9,17,3464,1237,2227
50,12,73,Florida,Leon County,9,18,3200,983,2217
50,12,73,Florida,Leon County,9,99,268519,127885,140634
50,12,73,Florida,Leon County,10,0,2910,1471,1439
50,12,73,Florida,Leon County,10,1,11897,6122,5775
50,12,73,Florida,Leon County,10,2,14604,7384,7220
50,12,73,Florida,Leon County,10,3,14563,7411,7152
50,12,73,Florida,Leon County,10,4,27468,12636,14832
50,12,73,Florida,Leon County,10,5,45427,21711,23716
50,12,73,Florida,Leon County,10,6,21824,11009,10815
50,12,73,Florida,Leon County,10,7,15889,7622,8267
50,12,73,Florida,Leon County,10,8,15689,7565,8124
50,12,73,Florida,Leon County,10,9,15100,7182,7918
50,12,73,Florida,Leon County,10,10,17061,7953,9108
50,12,73,Florida,Leon County,10,11,16852,7800,9052
50,12,73,Florida,Leon County,10,12,15682,7359,8323
50,12,73,Florida,Leon County,10,13,11984,5821,6163
50,12,73,Florida,Leon County,10,14,7669,3555,4114
50,12,73,Florida,Leon County,10,15,5409,2385,3024
50,12,73,Florida,Leon County,10,16,4324,1820,2504
50,12,73,Florida,Leon County,10,17,3514,1297,2217
50,12,73,Florida,Leon County,10,18,3264,972,2292
50,12,73,Florida,Leon County,10,99,271130,129075,142055
50,12,73,Florida,Leon County,11,0,2984,1516,1468
50,12,73,Florida,Leon County,11,1,12217,6220,5997
50,12,73,Florida,Leon County,11,2,14629,7405,7224
50,12,73,Florida,Leon County,11,3,14606,7441,7165
50,12,73,Florida,Leon County,11,4,27437,12603,14834
50,12,73,Florida,Leon County,11,5,44507,21327,23180
50,12,73,Florida,Leon County,11,6,22739,11354,11385
50,12,73,Florida,Leon County,11,7,16048,7727,8321
50,12,73,Florida,Leon County,11,8,15454,7357,8097
50,12,73,Florida,Leon County,11,9,14920,7201,7719
50,12,73,Florida,Leon County,11,10,16783,7783,9000
50,12,73,Florida,Leon County,11,11,16900,7782,9118
50,12,73,Florida,Leon County,11,12,15982,7523,8459
50,12,73,Florida,Leon County,11,13,12874,6206,6668
50,12,73,Florida,Leon County,11,14,8255,3850,4405
50,12,73,Florida,Leon County,11,15,5663,2490,3173
50,12,73,Florida,Leon County,11,16,4301,1825,2476
50,12,73,Florida,Leon County,11,17,3594,1359,2235
50,12,73,Florida,Leon County,11,18,3370,996,2374
50,12,73,Florida,Leon County,11,99,273263,129965,143298
50,12,73,Florida,Leon County,12,0,3017,1545,1472
50,12,73,Florida,Leon County,12,1,12333,6304,6029
50,12,73,Florida,Leon County,12,2,14877,7496,7381
50,12,73,Florida,Leon County,12,3,14690,7558,7132
50,12,73,Florida,Leon County,12,4,27231,12509,14722
50,12,73,Florida,Leon County,12,5,43722,21010,22712
50,12,73,Florida,Leon County,12,6,23281,11587,11694
50,12,73,Florida,Leon County,12,7,16673,8008,8665
50,12,73,Florida,Leon County,12,8,15350,7314,8036
50,12,73,Florida,Leon County,12,9,15010,7244,7766
50,12,73,Florida,Leon County,12,10,16437,7650,8787
50,12,73,Florida,Leon County,12,11,17156,7945,9211
50,12,73,Florida,Leon County,12,12,16092,7475,8617
50,12,73,Florida,Leon County,12,13,13638,6548,7090
50,12,73,Florida,Leon County,12,14,8787,4132,4655
50,12,73,Florida,Leon County,12,15,5846,2583,3263
50,12,73,Florida,Leon County,12,16,4329,1823,2506
50,12,73,Florida,Leon County,12,17,3601,1381,2220
50,12,73,Florida,Leon County,12,18,3417,1022,2395
50,12,73,Florida,Leon County,12,99,275487,131134,144353
50,12,73,Florida,Leon County,13,0,3029,1552,1477
50,12,73,Florida,Leon County,13,1,12349,6308,6041
50,12,73,Florida,Leon County,13,2,14893,7504,7389
50,12,73,Florida,Leon County,13,3,14689,7556,7133
50,12,73,Florida,Leon County,13,4,27114,12458,14656
50,12,73,Florida,Leon County,13,5,43914,21108,22806
50,12,73,Florida,Leon County,13,6,23359,11645,11714
50,12,73,Florida,Leon County,13,7,16789,8071,8718
50,12,73,Florida,Leon County,13,8,15270,7274,7996
50,12,73,Florida,Leon County,13,9,15000,7239,7761
50,12,73,Florida,Leon County,13,10,16381,7622,8759
50,12,73,Florida,Leon County,13,11,17205,7967,9238
50,12,73,Florida,Leon County,13,12,16190,7519,8671
50,12,73,Florida,Leon County,13,13,13774,6616,7158
50,12,73,Florida,Leon County,13,14,8844,4157,4687
50,12,73,Florida,Leon County,13,15,5880,2600,3280
50,12,73,Florida,Leon County,13,16,4326,1822,2504
50,12,73,Florida,Leon County,13,17,3611,1390,2221
50,12,73,Florida,Leon County,13,18,3441,1032,2409
50,12,73,Florida,Leon County,13,99,276058,131440,144618
50,12,75,Florida,Levy County,1,0,401,204,197
50,12,75,Florida,Levy County,1,1,1574,833,741
50,12,75,Florida,Levy County,1,2,2229,1137,1092
50,12,75,Florida,Levy County,1,3,2394,1212,1182
50,12,75,Florida,Levy County,1,4,2346,1187,1159
50,12,75,Florida,Levy County,1,5,1562,785,777
50,12,75,Florida,Levy County,1,6,1753,819,934
50,12,75,Florida,Levy County,1,7,1989,903,1086
50,12,75,Florida,Levy County,1,8,2381,1112,1269
50,12,75,Florida,Levy County,1,9,2508,1117,1391
50,12,75,Florida,Levy County,1,10,2371,1141,1230
50,12,75,Florida,Levy County,1,11,2353,1103,1250
50,12,75,Florida,Levy County,1,12,2248,1086,1162
50,12,75,Florida,Levy County,1,13,2173,1091,1082
50,12,75,Florida,Levy County,1,14,1839,940,899
50,12,75,Florida,Levy County,1,15,1713,883,830
50,12,75,Florida,Levy County,1,16,1315,589,726
50,12,75,Florida,Levy County,1,17,767,355,412
50,12,75,Florida,Levy County,1,18,532,198,334
50,12,75,Florida,Levy County,1,99,34448,16695,17753
50,12,75,Florida,Levy County,2,0,411,209,202
50,12,75,Florida,Levy County,2,1,1576,835,741
50,12,75,Florida,Levy County,2,2,2226,1135,1091
50,12,75,Florida,Levy County,2,3,2410,1219,1191
50,12,75,Florida,Levy County,2,4,2374,1214,1160
50,12,75,Florida,Levy County,2,5,1585,797,788
50,12,75,Florida,Levy County,2,6,1743,815,928
50,12,75,Florida,Levy County,2,7,1992,904,1088
50,12,75,Florida,Levy County,2,8,2372,1108,1264
50,12,75,Florida,Levy County,2,9,2520,1124,1396
50,12,75,Florida,Levy County,2,10,2395,1153,1242
50,12,75,Florida,Levy County,2,11,2384,1119,1265
50,12,75,Florida,Levy County,2,12,2267,1097,1170
50,12,75,Florida,Levy County,2,13,2188,1100,1088
50,12,75,Florida,Levy County,2,14,1841,942,899
50,12,75,Florida,Levy County,2,15,1721,887,834
50,12,75,Florida,Levy County,2,16,1324,594,730
50,12,75,Florida,Levy County,2,17,778,361,417
50,12,75,Florida,Levy County,2,18,537,200,337
50,12,75,Florida,Levy County,2,99,34644,16813,17831
50,12,75,Florida,Levy County,3,0,444,224,220
50,12,75,Florida,Levy County,3,1,1537,806,731
50,12,75,Florida,Levy County,3,2,2215,1133,1082
50,12,75,Florida,Levy County,3,3,2495,1268,1227
50,12,75,Florida,Levy County,3,4,2343,1218,1125
50,12,75,Florida,Levy County,3,5,1685,836,849
50,12,75,Florida,Levy County,3,6,1651,773,878
50,12,75,Florida,Levy County,3,7,1969,916,1053
50,12,75,Florida,Levy County,3,8,2368,1099,1269
50,12,75,Florida,Levy County,3,9,2565,1174,1391
50,12,75,Florida,Levy County,3,10,2534,1184,1350
50,12,75,Florida,Levy County,3,11,2461,1165,1296
50,12,75,Florida,Levy County,3,12,2324,1082,1242
50,12,75,Florida,Levy County,3,13,2261,1145,1116
50,12,75,Florida,Levy County,3,14,1894,952,942
50,12,75,Florida,Levy County,3,15,1750,906,844
50,12,75,Florida,Levy County,3,16,1307,604,703
50,12,75,Florida,Levy County,3,17,778,346,432
50,12,75,Florida,Levy County,3,18,537,211,326
50,12,75,Florida,Levy County,3,99,35118,17042,18076
50,12,75,Florida,Levy County,4,0,398,211,187
50,12,75,Florida,Levy County,4,1,1664,868,796
50,12,75,Florida,Levy County,4,2,2174,1120,1054
50,12,75,Florida,Levy County,4,3,2542,1313,1229
50,12,75,Florida,Levy County,4,4,2351,1232,1119
50,12,75,Florida,Levy County,4,5,1810,871,939
50,12,75,Florida,Levy County,4,6,1646,784,862
50,12,75,Florida,Levy County,4,7,2017,948,1069
50,12,75,Florida,Levy County,4,8,2306,1047,1259
50,12,75,Florida,Levy County,4,9,2622,1259,1363
50,12,75,Florida,Levy County,4,10,2665,1232,1433
50,12,75,Florida,Levy County,4,11,2522,1191,1331
50,12,75,Florida,Levy County,4,12,2456,1165,1291
50,12,75,Florida,Levy County,4,13,2382,1196,1186
50,12,75,Florida,Levy County,4,14,2008,1027,981
50,12,75,Florida,Levy County,4,15,1692,866,826
50,12,75,Florida,Levy County,4,16,1320,641,679
50,12,75,Florida,Levy County,4,17,846,374,472
50,12,75,Florida,Levy County,4,18,543,218,325
50,12,75,Florida,Levy County,4,99,35964,17563,18401
50,12,75,Florida,Levy County,5,0,453,238,215
50,12,75,Florida,Levy County,5,1,1669,853,816
50,12,75,Florida,Levy County,5,2,2155,1138,1017
50,12,75,Florida,Levy County,5,3,2534,1318,1216
50,12,75,Florida,Levy County,5,4,2339,1176,1163
50,12,75,Florida,Levy County,5,5,1902,942,960
50,12,75,Florida,Levy County,5,6,1633,778,855
50,12,75,Florida,Levy County,5,7,2041,982,1059
50,12,75,Florida,Levy County,5,8,2272,1042,1230
50,12,75,Florida,Levy County,5,9,2674,1253,1421
50,12,75,Florida,Levy County,5,10,2700,1250,1450
50,12,75,Florida,Levy County,5,11,2605,1221,1384
50,12,75,Florida,Levy County,5,12,2537,1209,1328
50,12,75,Florida,Levy County,5,13,2528,1258,1270
50,12,75,Florida,Levy County,5,14,2041,1047,994
50,12,75,Florida,Levy County,5,15,1678,858,820
50,12,75,Florida,Levy County,5,16,1398,709,689
50,12,75,Florida,Levy County,5,17,829,359,470
50,12,75,Florida,Levy County,5,18,542,213,329
50,12,75,Florida,Levy County,5,99,36530,17844,18686
50,12,75,Florida,Levy County,6,0,477,248,229
50,12,75,Florida,Levy County,6,1,1680,879,801
50,12,75,Florida,Levy County,6,2,2235,1173,1062
50,12,75,Florida,Levy County,6,3,2527,1299,1228
50,12,75,Florida,Levy County,6,4,2405,1203,1202
50,12,75,Florida,Levy County,6,5,1963,985,978
50,12,75,Florida,Levy County,6,6,1762,862,900
50,12,75,Florida,Levy County,6,7,2064,982,1082
50,12,75,Florida,Levy County,6,8,2225,1044,1181
50,12,75,Florida,Levy County,6,9,2729,1274,1455
50,12,75,Florida,Levy County,6,10,2838,1341,1497
50,12,75,Florida,Levy County,6,11,2663,1260,1403
50,12,75,Florida,Levy County,6,12,2630,1239,1391
50,12,75,Florida,Levy County,6,13,2647,1310,1337
50,12,75,Florida,Levy County,6,14,2160,1099,1061
50,12,75,Florida,Levy County,6,15,1663,847,816
50,12,75,Florida,Levy County,6,16,1392,699,693
50,12,75,Florida,Levy County,6,17,848,379,469
50,12,75,Florida,Levy County,6,18,602,236,366
50,12,75,Florida,Levy County,6,99,37510,18359,19151
50,12,75,Florida,Levy County,7,0,482,253,229
50,12,75,Florida,Levy County,7,1,1649,858,791
50,12,75,Florida,Levy County,7,2,2233,1172,1061
50,12,75,Florida,Levy County,7,3,2537,1296,1241
50,12,75,Florida,Levy County,7,4,2503,1274,1229
50,12,75,Florida,Levy County,7,5,2013,995,1018
50,12,75,Florida,Levy County,7,6,1828,875,953
50,12,75,Florida,Levy County,7,7,1957,928,1029
50,12,75,Florida,Levy County,7,8,2249,1063,1186
50,12,75,Florida,Levy County,7,9,2765,1300,1465
50,12,75,Florida,Levy County,7,10,2914,1326,1588
50,12,75,Florida,Levy County,7,11,2764,1343,1421
50,12,75,Florida,Levy County,7,12,2859,1329,1530
50,12,75,Florida,Levy County,7,13,2680,1323,1357
50,12,75,Florida,Levy County,7,14,2303,1191,1112
50,12,75,Florida,Levy County,7,15,1737,866,871
50,12,75,Florida,Levy County,7,16,1393,730,663
50,12,75,Florida,Levy County,7,17,877,371,506
50,12,75,Florida,Levy County,7,18,612,253,359
50,12,75,Florida,Levy County,7,99,38355,18746,19609
50,12,75,Florida,Levy County,8,0,539,280,259
50,12,75,Florida,Levy County,8,1,1676,874,802
50,12,75,Florida,Levy County,8,2,2341,1228,1113
50,12,75,Florida,Levy County,8,3,2544,1283,1261
50,12,75,Florida,Levy County,8,4,2612,1332,1280
50,12,75,Florida,Levy County,8,5,2046,1031,1015
50,12,75,Florida,Levy County,8,6,1955,908,1047
50,12,75,Florida,Levy County,8,7,1961,937,1024
50,12,75,Florida,Levy County,8,8,2273,1095,1178
50,12,75,Florida,Levy County,8,9,2723,1275,1448
50,12,75,Florida,Levy County,8,10,3005,1401,1604
50,12,75,Florida,Levy County,8,11,2936,1428,1508
50,12,75,Florida,Levy County,8,12,2986,1403,1583
50,12,75,Florida,Levy County,8,13,2774,1332,1442
50,12,75,Florida,Levy County,8,14,2370,1248,1122
50,12,75,Florida,Levy County,8,15,1814,895,919
50,12,75,Florida,Levy County,8,16,1395,746,649
50,12,75,Florida,Levy County,8,17,884,372,512
50,12,75,Florida,Levy County,8,18,613,243,370
50,12,75,Florida,Levy County,8,99,39447,19311,20136
50,12,75,Florida,Levy County,9,0,567,294,273
50,12,75,Florida,Levy County,9,1,1752,940,812
50,12,75,Florida,Levy County,9,2,2345,1214,1131
50,12,75,Florida,Levy County,9,3,2494,1243,1251
50,12,75,Florida,Levy County,9,4,2703,1405,1298
50,12,75,Florida,Levy County,9,5,1964,997,967
50,12,75,Florida,Levy County,9,6,2081,965,1116
50,12,75,Florida,Levy County,9,7,1933,919,1014
50,12,75,Florida,Levy County,9,8,2331,1116,1215
50,12,75,Florida,Levy County,9,9,2662,1224,1438
50,12,75,Florida,Levy County,9,10,3092,1497,1595
50,12,75,Florida,Levy County,9,11,3051,1443,1608
50,12,75,Florida,Levy County,9,12,3001,1414,1587
50,12,75,Florida,Levy County,9,13,2881,1391,1490
50,12,75,Florida,Levy County,9,14,2518,1299,1219
50,12,75,Florida,Levy County,9,15,1875,944,931
50,12,75,Florida,Levy County,9,16,1347,711,636
50,12,75,Florida,Levy County,9,17,964,422,542
50,12,75,Florida,Levy County,9,18,643,267,376
50,12,75,Florida,Levy County,9,99,40204,19705,20499
50,12,75,Florida,Levy County,10,0,581,303,278
50,12,75,Florida,Levy County,10,1,1832,973,859
50,12,75,Florida,Levy County,10,2,2354,1222,1132
50,12,75,Florida,Levy County,10,3,2443,1250,1193
50,12,75,Florida,Levy County,10,4,2697,1386,1311
50,12,75,Florida,Levy County,10,5,2085,1038,1047
50,12,75,Florida,Levy County,10,6,2122,1002,1120
50,12,75,Florida,Levy County,10,7,1922,942,980
50,12,75,Florida,Levy County,10,8,2336,1117,1219
50,12,75,Florida,Levy County,10,9,2509,1177,1332
50,12,75,Florida,Levy County,10,10,3171,1512,1659
50,12,75,Florida,Levy County,10,11,3131,1495,1636
50,12,75,Florida,Levy County,10,12,3054,1448,1606
50,12,75,Florida,Levy County,10,13,3014,1432,1582
50,12,75,Florida,Levy County,10,14,2654,1363,1291
50,12,75,Florida,Levy County,10,15,1885,972,913
50,12,75,Florida,Levy County,10,16,1358,708,650
50,12,75,Florida,Levy County,10,17,1036,461,575
50,12,75,Florida,Levy County,10,18,625,251,374
50,12,75,Florida,Levy County,10,99,40809,20052,20757
50,12,75,Florida,Levy County,11,0,499,249,250
50,12,75,Florida,Levy County,11,1,1905,1004,901
50,12,75,Florida,Levy County,11,2,2302,1201,1101
50,12,75,Florida,Levy County,11,3,2464,1281,1183
50,12,75,Florida,Levy County,11,4,2650,1374,1276
50,12,75,Florida,Levy County,11,5,2078,1030,1048
50,12,75,Florida,Levy County,11,6,2109,1011,1098
50,12,75,Florida,Levy County,11,7,1953,959,994
50,12,75,Florida,Levy County,11,8,2305,1089,1216
50,12,75,Florida,Levy County,11,9,2366,1114,1252
50,12,75,Florida,Levy County,11,10,3141,1486,1655
50,12,75,Florida,Levy County,11,11,3179,1529,1650
50,12,75,Florida,Levy County,11,12,3116,1476,1640
50,12,75,Florida,Levy County,11,13,3057,1450,1607
50,12,75,Florida,Levy County,11,14,2691,1380,1311
50,12,75,Florida,Levy County,11,15,2015,1038,977
50,12,75,Florida,Levy County,11,16,1395,717,678
50,12,75,Florida,Levy County,11,17,1009,459,550
50,12,75,Florida,Levy County,11,18,646,268,378
50,12,75,Florida,Levy County,11,99,40880,20115,20765
50,12,75,Florida,Levy County,12,0,465,236,229
50,12,75,Florida,Levy County,12,1,1834,965,869
50,12,75,Florida,Levy County,12,2,2300,1196,1104
50,12,75,Florida,Levy County,12,3,2426,1273,1153
50,12,75,Florida,Levy County,12,4,2591,1335,1256
50,12,75,Florida,Levy County,12,5,2086,1044,1042
50,12,75,Florida,Levy County,12,6,2066,985,1081
50,12,75,Florida,Levy County,12,7,2031,987,1044
50,12,75,Florida,Levy County,12,8,2223,1072,1151
50,12,75,Florida,Levy County,12,9,2371,1112,1259
50,12,75,Florida,Levy County,12,10,3055,1449,1606
50,12,75,Florida,Levy County,12,11,3135,1487,1648
50,12,75,Florida,Levy County,12,12,3151,1496,1655
50,12,75,Florida,Levy County,12,13,3153,1499,1654
50,12,75,Florida,Levy County,12,14,2717,1383,1334
50,12,75,Florida,Levy County,12,15,2093,1092,1001
50,12,75,Florida,Levy County,12,16,1413,734,679
50,12,75,Florida,Levy County,12,17,1018,467,551
50,12,75,Florida,Levy County,12,18,673,266,407
50,12,75,Florida,Levy County,12,99,40801,20078,20723
50,12,75,Florida,Levy County,13,0,463,236,227
50,12,75,Florida,Levy County,13,1,1829,962,867
50,12,75,Florida,Levy County,13,2,2292,1190,1102
50,12,75,Florida,Levy County,13,3,2412,1263,1149
50,12,75,Florida,Levy County,13,4,2571,1328,1243
50,12,75,Florida,Levy County,13,5,2086,1043,1043
50,12,75,Florida,Levy County,13,6,2071,993,1078
50,12,75,Florida,Levy County,13,7,2035,987,1048
50,12,75,Florida,Levy County,13,8,2209,1064,1145
50,12,75,Florida,Levy County,13,9,2359,1107,1252
50,12,75,Florida,Levy County,13,10,3040,1446,1594
50,12,75,Florida,Levy County,13,11,3124,1480,1644
50,12,75,Florida,Levy County,13,12,3159,1500,1659
50,12,75,Florida,Levy County,13,13,3173,1506,1667
50,12,75,Florida,Levy County,13,14,2729,1386,1343
50,12,75,Florida,Levy County,13,15,2091,1093,998
50,12,75,Florida,Levy County,13,16,1406,728,678
50,12,75,Florida,Levy County,13,17,1012,464,548
50,12,75,Florida,Levy County,13,18,674,266,408
50,12,75,Florida,Levy County,13,99,40735,20042,20693
50,12,77,Florida,Liberty County,1,0,81,38,43
50,12,77,Florida,Liberty County,1,1,303,162,141
50,12,77,Florida,Liberty County,1,2,414,218,196
50,12,77,Florida,Liberty County,1,3,437,214,223
50,12,77,Florida,Liberty County,1,4,461,240,221
50,12,77,Florida,Liberty County,1,5,492,317,175
50,12,77,Florida,Liberty County,1,6,672,499,173
50,12,77,Florida,Liberty County,1,7,644,458,186
50,12,77,Florida,Liberty County,1,8,681,456,225
50,12,77,Florida,Liberty County,1,9,647,420,227
50,12,77,Florida,Liberty County,1,10,444,260,184
50,12,77,Florida,Liberty County,1,11,404,221,183
50,12,77,Florida,Liberty County,1,12,327,173,154
50,12,77,Florida,Liberty County,1,13,294,148,146
50,12,77,Florida,Liberty County,1,14,231,114,117
50,12,77,Florida,Liberty County,1,15,201,97,104
50,12,77,Florida,Liberty County,1,16,142,67,75
50,12,77,Florida,Liberty County,1,17,80,26,54
50,12,77,Florida,Liberty County,1,18,56,22,34
50,12,77,Florida,Liberty County,1,99,7011,4150,2861
50,12,77,Florida,Liberty County,2,0,81,38,43
50,12,77,Florida,Liberty County,2,1,298,159,139
50,12,77,Florida,Liberty County,2,2,406,214,192
50,12,77,Florida,Liberty County,2,3,434,213,221
50,12,77,Florida,Liberty County,2,4,473,254,219
50,12,77,Florida,Liberty County,2,5,492,317,175
50,12,77,Florida,Liberty County,2,6,665,495,170
50,12,77,Florida,Liberty County,2,7,641,457,184
50,12,77,Florida,Liberty County,2,8,676,454,222
50,12,77,Florida,Liberty County,2,9,642,417,225
50,12,77,Florida,Liberty County,2,10,446,262,184
50,12,77,Florida,Liberty County,2,11,402,220,182
50,12,77,Florida,Liberty County,2,12,325,172,153
50,12,77,Florida,Liberty County,2,13,294,148,146
50,12,77,Florida,Liberty County,2,14,231,114,117
50,12,77,Florida,Liberty County,2,15,202,98,104
50,12,77,Florida,Liberty County,2,16,142,67,75
50,12,77,Florida,Liberty County,2,17,81,26,55
50,12,77,Florida,Liberty County,2,18,58,23,35
50,12,77,Florida,Liberty County,2,99,6989,4148,2841
50,12,77,Florida,Liberty County,3,0,82,41,41
50,12,77,Florida,Liberty County,3,1,311,155,156
50,12,77,Florida,Liberty County,3,2,400,208,192
50,12,77,Florida,Liberty County,3,3,421,225,196
50,12,77,Florida,Liberty County,3,4,468,239,229
50,12,77,Florida,Liberty County,3,5,527,327,200
50,12,77,Florida,Liberty County,3,6,666,486,180
50,12,77,Florida,Liberty County,3,7,613,438,175
50,12,77,Florida,Liberty County,3,8,673,447,226
50,12,77,Florida,Liberty County,3,9,646,416,230
50,12,77,Florida,Liberty County,3,10,483,288,195
50,12,77,Florida,Liberty County,3,11,407,232,175
50,12,77,Florida,Liberty County,3,12,346,184,162
50,12,77,Florida,Liberty County,3,13,286,145,141
50,12,77,Florida,Liberty County,3,14,232,117,115
50,12,77,Florida,Liberty County,3,15,197,102,95
50,12,77,Florida,Liberty County,3,16,148,63,85
50,12,77,Florida,Liberty County,3,17,89,31,58
50,12,77,Florida,Liberty County,3,18,54,22,32
50,12,77,Florida,Liberty County,3,99,7049,4166,2883
50,12,77,Florida,Liberty County,4,0,90,45,45
50,12,77,Florida,Liberty County,4,1,323,163,160
50,12,77,Florida,Liberty County,4,2,411,224,187
50,12,77,Florida,Liberty County,4,3,428,237,191
50,12,77,Florida,Liberty County,4,4,469,247,222
50,12,77,Florida,Liberty County,4,5,544,352,192
50,12,77,Florida,Liberty County,4,6,686,504,182
50,12,77,Florida,Liberty County,4,7,628,443,185
50,12,77,Florida,Liberty County,4,8,682,452,230
50,12,77,Florida,Liberty County,4,9,643,430,213
50,12,77,Florida,Liberty County,4,10,534,315,219
50,12,77,Florida,Liberty County,4,11,413,242,171
50,12,77,Florida,Liberty County,4,12,362,199,163
50,12,77,Florida,Liberty County,4,13,286,144,142
50,12,77,Florida,Liberty County,4,14,230,116,114
50,12,77,Florida,Liberty County,4,15,201,101,100
50,12,77,Florida,Liberty County,4,16,162,71,91
50,12,77,Florida,Liberty County,4,17,82,37,45
50,12,77,Florida,Liberty County,4,18,57,22,35
50,12,77,Florida,Liberty County,4,99,7231,4344,2887
50,12,77,Florida,Liberty County,5,0,90,40,50
50,12,77,Florida,Liberty County,5,1,324,159,165
50,12,77,Florida,Liberty County,5,2,384,205,179
50,12,77,Florida,Liberty County,5,3,458,248,210
50,12,77,Florida,Liberty County,5,4,445,244,201
50,12,77,Florida,Liberty County,5,5,544,345,199
50,12,77,Florida,Liberty County,5,6,673,498,175
50,12,77,Florida,Liberty County,5,7,619,442,177
50,12,77,Florida,Liberty County,5,8,652,443,209
50,12,77,Florida,Liberty County,5,9,653,434,219
50,12,77,Florida,Liberty County,5,10,600,356,244
50,12,77,Florida,Liberty County,5,11,433,263,170
50,12,77,Florida,Liberty County,5,12,387,212,175
50,12,77,Florida,Liberty County,5,13,298,144,154
50,12,77,Florida,Liberty County,5,14,239,124,115
50,12,77,Florida,Liberty County,5,15,205,105,100
50,12,77,Florida,Liberty County,5,16,157,71,86
50,12,77,Florida,Liberty County,5,17,97,45,52
50,12,77,Florida,Liberty County,5,18,67,24,43
50,12,77,Florida,Liberty County,5,99,7325,4402,2923
50,12,77,Florida,Liberty County,6,0,86,36,50
50,12,77,Florida,Liberty County,6,1,329,160,169
50,12,77,Florida,Liberty County,6,2,414,225,189
50,12,77,Florida,Liberty County,6,3,433,256,177
50,12,77,Florida,Liberty County,6,4,453,245,208
50,12,77,Florida,Liberty County,6,5,544,355,189
50,12,77,Florida,Liberty County,6,6,679,500,179
50,12,77,Florida,Liberty County,6,7,638,454,184
50,12,77,Florida,Liberty County,6,8,643,440,203
50,12,77,Florida,Liberty County,6,9,655,438,217
50,12,77,Florida,Liberty County,6,10,613,370,243
50,12,77,Florida,Liberty County,6,11,474,292,182
50,12,77,Florida,Liberty County,6,12,390,216,174
50,12,77,Florida,Liberty County,6,13,309,165,144
50,12,77,Florida,Liberty County,6,14,248,117,131
50,12,77,Florida,Liberty County,6,15,194,104,90
50,12,77,Florida,Liberty County,6,16,174,76,98
50,12,77,Florida,Liberty County,6,17,109,47,62
50,12,77,Florida,Liberty County,6,18,64,24,40
50,12,77,Florida,Liberty County,6,99,7449,4520,2929
50,12,77,Florida,Liberty County,7,0,92,47,45
50,12,77,Florida,Liberty County,7,1,340,172,168
50,12,77,Florida,Liberty County,7,2,442,233,209
50,12,77,Florida,Liberty County,7,3,460,265,195
50,12,77,Florida,Liberty County,7,4,482,256,226
50,12,77,Florida,Liberty County,7,5,547,359,188
50,12,77,Florida,Liberty County,7,6,742,537,205
50,12,77,Florida,Liberty County,7,7,667,488,179
50,12,77,Florida,Liberty County,7,8,660,458,202
50,12,77,Florida,Liberty County,7,9,682,447,235
50,12,77,Florida,Liberty County,7,10,685,426,259
50,12,77,Florida,Liberty County,7,11,496,298,198
50,12,77,Florida,Liberty County,7,12,417,242,175
50,12,77,Florida,Liberty County,7,13,338,177,161
50,12,77,Florida,Liberty County,7,14,240,130,110
50,12,77,Florida,Liberty County,7,15,201,101,100
50,12,77,Florida,Liberty County,7,16,167,74,93
50,12,77,Florida,Liberty County,7,17,104,52,52
50,12,77,Florida,Liberty County,7,18,58,18,40
50,12,77,Florida,Liberty County,7,99,7820,4780,3040
50,12,77,Florida,Liberty County,8,0,103,54,49
50,12,77,Florida,Liberty County,8,1,331,170,161
50,12,77,Florida,Liberty County,8,2,498,270,228
50,12,77,Florida,Liberty County,8,3,459,269,190
50,12,77,Florida,Liberty County,8,4,463,245,218
50,12,77,Florida,Liberty County,8,5,554,361,193
50,12,77,Florida,Liberty County,8,6,754,520,234
50,12,77,Florida,Liberty County,8,7,687,502,185
50,12,77,Florida,Liberty County,8,8,656,447,209
50,12,77,Florida,Liberty County,8,9,656,438,218
50,12,77,Florida,Liberty County,8,10,712,453,259
50,12,77,Florida,Liberty County,8,11,531,320,211
50,12,77,Florida,Liberty County,8,12,437,258,179
50,12,77,Florida,Liberty County,8,13,358,193,165
50,12,77,Florida,Liberty County,8,14,255,136,119
50,12,77,Florida,Liberty County,8,15,209,109,100
50,12,77,Florida,Liberty County,8,16,172,76,96
50,12,77,Florida,Liberty County,8,17,117,48,69
50,12,77,Florida,Liberty County,8,18,59,22,37
50,12,77,Florida,Liberty County,8,99,8011,4891,3120
50,12,77,Florida,Liberty County,9,0,98,50,48
50,12,77,Florida,Liberty County,9,1,363,186,177
50,12,77,Florida,Liberty County,9,2,505,265,240
50,12,77,Florida,Liberty County,9,3,464,275,189
50,12,77,Florida,Liberty County,9,4,471,261,210
50,12,77,Florida,Liberty County,9,5,571,364,207
50,12,77,Florida,Liberty County,9,6,740,511,229
50,12,77,Florida,Liberty County,9,7,655,479,176
50,12,77,Florida,Liberty County,9,8,661,449,212
50,12,77,Florida,Liberty County,9,9,645,439,206
50,12,77,Florida,Liberty County,9,10,700,453,247
50,12,77,Florida,Liberty County,9,11,594,346,248
50,12,77,Florida,Liberty County,9,12,444,257,187
50,12,77,Florida,Liberty County,9,13,371,200,171
50,12,77,Florida,Liberty County,9,14,267,135,132
50,12,77,Florida,Liberty County,9,15,215,115,100
50,12,77,Florida,Liberty County,9,16,161,64,97
50,12,77,Florida,Liberty County,9,17,125,51,74
50,12,77,Florida,Liberty County,9,18,63,23,40
50,12,77,Florida,Liberty County,9,99,8113,4923,3190
50,12,77,Florida,Liberty County,10,0,100,52,48
50,12,77,Florida,Liberty County,10,1,371,189,182
50,12,77,Florida,Liberty County,10,2,545,274,271
50,12,77,Florida,Liberty County,10,3,465,275,190
50,12,77,Florida,Liberty County,10,4,499,276,223
50,12,77,Florida,Liberty County,10,5,580,369,211
50,12,77,Florida,Liberty County,10,6,726,513,213
50,12,77,Florida,Liberty County,10,7,684,485,199
50,12,77,Florida,Liberty County,10,8,676,452,224
50,12,77,Florida,Liberty County,10,9,641,438,203
50,12,77,Florida,Liberty County,10,10,714,465,249
50,12,77,Florida,Liberty County,10,11,614,364,250
50,12,77,Florida,Liberty County,10,12,462,276,186
50,12,77,Florida,Liberty County,10,13,378,208,170
50,12,77,Florida,Liberty County,10,14,275,122,153
50,12,77,Florida,Liberty County,10,15,249,148,101
50,12,77,Florida,Liberty County,10,16,155,68,87
50,12,77,Florida,Liberty County,10,17,123,52,71
50,12,77,Florida,Liberty County,10,18,66,20,46
50,12,77,Florida,Liberty County,10,99,8323,5046,3277
50,12,77,Florida,Liberty County,11,0,88,42,46
50,12,77,Florida,Liberty County,11,1,352,193,159
50,12,77,Florida,Liberty County,11,2,519,252,267
50,12,77,Florida,Liberty County,11,3,487,291,196
50,12,77,Florida,Liberty County,11,4,499,292,207
50,12,77,Florida,Liberty County,11,5,549,354,195
50,12,77,Florida,Liberty County,11,6,733,521,212
50,12,77,Florida,Liberty County,11,7,678,468,210
50,12,77,Florida,Liberty County,11,8,685,457,228
50,12,77,Florida,Liberty County,11,9,638,439,199
50,12,77,Florida,Liberty County,11,10,715,460,255
50,12,77,Florida,Liberty County,11,11,630,380,250
50,12,77,Florida,Liberty County,11,12,507,298,209
50,12,77,Florida,Liberty County,11,13,389,216,173
50,12,77,Florida,Liberty County,11,14,286,142,144
50,12,77,Florida,Liberty County,11,15,243,134,109
50,12,77,Florida,Liberty County,11,16,163,83,80
50,12,77,Florida,Liberty County,11,17,126,48,78
50,12,77,Florida,Liberty County,11,18,60,20,40
50,12,77,Florida,Liberty County,11,99,8347,5090,3257
50,12,77,Florida,Liberty County,12,0,86,42,44
50,12,77,Florida,Liberty County,12,1,376,198,178
50,12,77,Florida,Liberty County,12,2,493,259,234
50,12,77,Florida,Liberty County,12,3,517,296,221
50,12,77,Florida,Liberty County,12,4,493,290,203
50,12,77,Florida,Liberty County,12,5,548,355,193
50,12,77,Florida,Liberty County,12,6,715,510,205
50,12,77,Florida,Liberty County,12,7,672,464,208
50,12,77,Florida,Liberty County,12,8,676,454,222
50,12,77,Florida,Liberty County,12,9,635,427,208
50,12,77,Florida,Liberty County,12,10,721,461,260
50,12,77,Florida,Liberty County,12,11,647,398,249
50,12,77,Florida,Liberty County,12,12,503,290,213
50,12,77,Florida,Liberty County,12,13,395,224,171
50,12,77,Florida,Liberty County,12,14,303,151,152
50,12,77,Florida,Liberty County,12,15,236,129,107
50,12,77,Florida,Liberty County,12,16,175,81,94
50,12,77,Florida,Liberty County,12,17,109,40,69
50,12,77,Florida,Liberty County,12,18,65,23,42
50,12,77,Florida,Liberty County,12,99,8365,5092,3273
50,12,77,Florida,Liberty County,13,0,84,42,42
50,12,77,Florida,Liberty County,13,1,378,201,177
50,12,77,Florida,Liberty County,13,2,483,256,227
50,12,77,Florida,Liberty County,13,3,509,291,218
50,12,77,Florida,Liberty County,13,4,502,296,206
50,12,77,Florida,Liberty County,13,5,545,352,193
50,12,77,Florida,Liberty County,13,6,717,508,209
50,12,77,Florida,Liberty County,13,7,667,463,204
50,12,77,Florida,Liberty County,13,8,684,458,226
50,12,77,Florida,Liberty County,13,9,634,431,203
50,12,77,Florida,Liberty County,13,10,712,459,253
50,12,77,Florida,Liberty County,13,11,645,398,247
50,12,77,Florida,Liberty County,13,12,507,293,214
50,12,77,Florida,Liberty County,13,13,401,229,172
50,12,77,Florida,Liberty County,13,14,310,154,156
50,12,77,Florida,Liberty County,13,15,231,127,104
50,12,77,Florida,Liberty County,13,16,173,78,95
50,12,77,Florida,Liberty County,13,17,106,38,68
50,12,77,Florida,Liberty County,13,18,67,24,43
50,12,77,Florida,Liberty County,13,99,8355,5098,3257
50,12,79,Florida,Madison County,1,0,224,116,108
50,12,79,Florida,Madison County,1,1,848,440,408
50,12,79,Florida,Madison County,1,2,1217,622,595
50,12,79,Florida,Madison County,1,3,1464,750,714
50,12,79,Florida,Madison County,1,4,1497,849,648
50,12,79,Florida,Madison County,1,5,1213,711,502
50,12,79,Florida,Madison County,1,6,1305,758,547
50,12,79,Florida,Madison County,1,7,1237,719,518
50,12,79,Florida,Madison County,1,8,1405,813,592
50,12,79,Florida,Madison County,1,9,1341,707,634
50,12,79,Florida,Madison County,1,10,1282,633,649
50,12,79,Florida,Madison County,1,11,1126,592,534
50,12,79,Florida,Madison County,1,12,932,447,485
50,12,79,Florida,Madison County,1,13,905,439,466
50,12,79,Florida,Madison County,1,14,734,350,384
50,12,79,Florida,Madison County,1,15,680,302,378
50,12,79,Florida,Madison County,1,16,555,205,350
50,12,79,Florida,Madison County,1,17,375,144,231
50,12,79,Florida,Madison County,1,18,380,106,274
50,12,79,Florida,Madison County,1,99,18720,9703,9017
50,12,79,Florida,Madison County,2,0,226,117,109
50,12,79,Florida,Madison County,2,1,843,438,405
50,12,79,Florida,Madison County,2,2,1208,618,590
50,12,79,Florida,Madison County,2,3,1467,750,717
50,12,79,Florida,Madison County,2,4,1498,850,648
50,12,79,Florida,Madison County,2,5,1225,716,509
50,12,79,Florida,Madison County,2,6,1297,754,543
50,12,79,Florida,Madison County,2,7,1233,717,516
50,12,79,Florida,Madison County,2,8,1395,807,588
50,12,79,Florida,Madison County,2,9,1346,709,637
50,12,79,Florida,Madison County,2,10,1287,635,652
50,12,79,Florida,Madison County,2,11,1135,598,537
50,12,79,Florida,Madison County,2,12,935,449,486
50,12,79,Florida,Madison County,2,13,906,440,466
50,12,79,Florida,Madison County,2,14,734,351,383
50,12,79,Florida,Madison County,2,15,680,302,378
50,12,79,Florida,Madison County,2,16,558,205,353
50,12,79,Florida,Madison County,2,17,380,146,234
50,12,79,Florida,Madison County,2,18,381,107,274
50,12,79,Florida,Madison County,2,99,18734,9709,9025
50,12,79,Florida,Madison County,3,0,242,117,125
50,12,79,Florida,Madison County,3,1,886,475,411
50,12,79,Florida,Madison County,3,2,1110,557,553
50,12,79,Florida,Madison County,3,3,1474,754,720
50,12,79,Florida,Madison County,3,4,1501,832,669
50,12,79,Florida,Madison County,3,5,1265,736,529
50,12,79,Florida,Madison County,3,6,1247,716,531
50,12,79,Florida,Madison County,3,7,1254,734,520
50,12,79,Florida,Madison County,3,8,1330,757,573
50,12,79,Florida,Madison County,3,9,1344,713,631
50,12,79,Florida,Madison County,3,10,1335,671,664
50,12,79,Florida,Madison County,3,11,1236,656,580
50,12,79,Florida,Madison County,3,12,916,451,465
50,12,79,Florida,Madison County,3,13,929,438,491
50,12,79,Florida,Madison County,3,14,797,384,413
50,12,79,Florida,Madison County,3,15,670,307,363
50,12,79,Florida,Madison County,3,16,563,219,344
50,12,79,Florida,Madison County,3,17,375,141,234
50,12,79,Florida,Madison County,3,18,385,103,282
50,12,79,Florida,Madison County,3,99,18859,9761,9098
50,12,79,Florida,Madison County,4,0,214,111,103
50,12,79,Florida,Madison County,4,1,887,443,444
50,12,79,Florida,Madison County,4,2,1052,546,506
50,12,79,Florida,Madison County,4,3,1435,751,684
50,12,79,Florida,Madison County,4,4,1510,823,687
50,12,79,Florida,Madison County,4,5,1235,717,518
50,12,79,Florida,Madison County,4,6,1225,714,511
50,12,79,Florida,Madison County,4,7,1244,731,513
50,12,79,Florida,Madison County,4,8,1259,720,539
50,12,79,Florida,Madison County,4,9,1318,708,610
50,12,79,Florida,Madison County,4,10,1373,682,691
50,12,79,Florida,Madison County,4,11,1261,657,604
50,12,79,Florida,Madison County,4,12,990,515,475
50,12,79,Florida,Madison County,4,13,913,423,490
50,12,79,Florida,Madison County,4,14,838,410,428
50,12,79,Florida,Madison County,4,15,639,290,349
50,12,79,Florida,Madison County,4,16,570,218,352
50,12,79,Florida,Madison County,4,17,390,140,250
50,12,79,Florida,Madison County,4,18,354,98,256
50,12,79,Florida,Madison County,4,99,18707,9697,9010
50,12,79,Florida,Madison County,5,0,247,116,131
50,12,79,Florida,Madison County,5,1,932,466,466
50,12,79,Florida,Madison County,5,2,1019,529,490
50,12,79,Florida,Madison County,5,3,1342,703,639
50,12,79,Florida,Madison County,5,4,1490,832,658
50,12,79,Florida,Madison County,5,5,1256,727,529
50,12,79,Florida,Madison County,5,6,1232,726,506
50,12,79,Florida,Madison County,5,7,1257,734,523
50,12,79,Florida,Madison County,5,8,1225,716,509
50,12,79,Florida,Madison County,5,9,1318,715,603
50,12,79,Florida,Madison County,5,10,1354,688,666
50,12,79,Florida,Madison County,5,11,1289,646,643
50,12,79,Florida,Madison County,5,12,1052,564,488
50,12,79,Florida,Madison County,5,13,952,446,506
50,12,79,Florida,Madison County,5,14,821,406,415
50,12,79,Florida,Madison County,5,15,633,278,355
50,12,79,Florida,Madison County,5,16,577,236,341
50,12,79,Florida,Madison County,5,17,406,149,257
50,12,79,Florida,Madison County,5,18,376,102,274
50,12,79,Florida,Madison County,5,99,18778,9779,8999
50,12,79,Florida,Madison County,6,0,230,117,113
50,12,79,Florida,Madison County,6,1,978,473,505
50,12,79,Florida,Madison County,6,2,1039,540,499
50,12,79,Florida,Madison County,6,3,1294,686,608
50,12,79,Florida,Madison County,6,4,1544,841,703
50,12,79,Florida,Madison County,6,5,1321,753,568
50,12,79,Florida,Madison County,6,6,1219,753,466
50,12,79,Florida,Madison County,6,7,1249,733,516
50,12,79,Florida,Madison County,6,8,1243,723,520
50,12,79,Florida,Madison County,6,9,1339,738,601
50,12,79,Florida,Madison County,6,10,1334,696,638
50,12,79,Florida,Madison County,6,11,1337,662,675
50,12,79,Florida,Madison County,6,12,1151,628,523
50,12,79,Florida,Madison County,6,13,962,443,519
50,12,79,Florida,Madison County,6,14,839,416,423
50,12,79,Florida,Madison County,6,15,649,281,368
50,12,79,Florida,Madison County,6,16,554,234,320
50,12,79,Florida,Madison County,6,17,426,144,282
50,12,79,Florida,Madison County,6,18,367,110,257
50,12,79,Florida,Madison County,6,99,19075,9971,9104
50,12,79,Florida,Madison County,7,0,253,117,136
50,12,79,Florida,Madison County,7,1,987,464,523
50,12,79,Florida,Madison County,7,2,1055,563,492
50,12,79,Florida,Madison County,7,3,1203,629,574
50,12,79,Florida,Madison County,7,4,1503,814,689
50,12,79,Florida,Madison County,7,5,1286,740,546
50,12,79,Florida,Madison County,7,6,1234,734,500
50,12,79,Florida,Madison County,7,7,1206,705,501
50,12,79,Florida,Madison County,7,8,1186,684,502
50,12,79,Florida,Madison County,7,9,1384,770,614
50,12,79,Florida,Madison County,7,10,1333,683,650
50,12,79,Florida,Madison County,7,11,1377,690,687
50,12,79,Florida,Madison County,7,12,1188,626,562
50,12,79,Florida,Madison County,7,13,1008,485,523
50,12,79,Florida,Madison County,7,14,884,423,461
50,12,79,Florida,Madison County,7,15,649,304,345
50,12,79,Florida,Madison County,7,16,524,228,296
50,12,79,Florida,Madison County,7,17,450,151,299
50,12,79,Florida,Madison County,7,18,360,104,256
50,12,79,Florida,Madison County,7,99,19070,9914,9156
50,12,79,Florida,Madison County,8,0,258,114,144
50,12,79,Florida,Madison County,8,1,978,486,492
50,12,79,Florida,Madison County,8,2,1117,570,547
50,12,79,Florida,Madison County,8,3,1158,592,566
50,12,79,Florida,Madison County,8,4,1496,806,690
50,12,79,Florida,Madison County,8,5,1277,741,536
50,12,79,Florida,Madison County,8,6,1289,764,525
50,12,79,Florida,Madison County,8,7,1151,678,473
50,12,79,Florida,Madison County,8,8,1214,693,521
50,12,79,Florida,Madison County,8,9,1350,728,622
50,12,79,Florida,Madison County,8,10,1379,723,656
50,12,79,Florida,Madison County,8,11,1392,709,683
50,12,79,Florida,Madison County,8,12,1316,704,612
50,12,79,Florida,Madison County,8,13,982,474,508
50,12,79,Florida,Madison County,8,14,950,465,485
50,12,79,Florida,Madison County,8,15,687,322,365
50,12,79,Florida,Madison County,8,16,502,213,289
50,12,79,Florida,Madison County,8,17,444,165,279
50,12,79,Florida,Madison County,8,18,359,97,262
50,12,79,Florida,Madison County,8,99,19299,10044,9255
50,12,79,Florida,Madison County,9,0,281,131,150
50,12,79,Florida,Madison County,9,1,969,462,507
50,12,79,Florida,Madison County,9,2,1131,583,548
50,12,79,Florida,Madison County,9,3,1118,576,542
50,12,79,Florida,Madison County,9,4,1458,793,665
50,12,79,Florida,Madison County,9,5,1265,698,567
50,12,79,Florida,Madison County,9,6,1286,771,515
50,12,79,Florida,Madison County,9,7,1158,659,499
50,12,79,Florida,Madison County,9,8,1215,695,520
50,12,79,Florida,Madison County,9,9,1314,725,589
50,12,79,Florida,Madison County,9,10,1374,740,634
50,12,79,Florida,Madison County,9,11,1405,710,695
50,12,79,Florida,Madison County,9,12,1353,708,645
50,12,79,Florida,Madison County,9,13,1064,544,520
50,12,79,Florida,Madison County,9,14,922,439,483
50,12,79,Florida,Madison County,9,15,730,359,371
50,12,79,Florida,Madison County,9,16,497,212,285
50,12,79,Florida,Madison County,9,17,433,164,269
50,12,79,Florida,Madison County,9,18,349,93,256
50,12,79,Florida,Madison County,9,99,19322,10062,9260
50,12,79,Florida,Madison County,10,0,286,129,157
50,12,79,Florida,Madison County,10,1,989,501,488
50,12,79,Florida,Madison County,10,2,1088,545,543
50,12,79,Florida,Madison County,10,3,1082,549,533
50,12,79,Florida,Madison County,10,4,1431,771,660
50,12,79,Florida,Madison County,10,5,1263,691,572
50,12,79,Florida,Madison County,10,6,1293,765,528
50,12,79,Florida,Madison County,10,7,1158,680,478
50,12,79,Florida,Madison County,10,8,1191,680,511
50,12,79,Florida,Madison County,10,9,1268,689,579
50,12,79,Florida,Madison County,10,10,1370,742,628
50,12,79,Florida,Madison County,10,11,1399,728,671
50,12,79,Florida,Madison County,10,12,1335,661,674
50,12,79,Florida,Madison County,10,13,1166,626,540
50,12,79,Florida,Madison County,10,14,932,444,488
50,12,79,Florida,Madison County,10,15,754,368,386
50,12,79,Florida,Madison County,10,16,505,210,295
50,12,79,Florida,Madison County,10,17,455,160,295
50,12,79,Florida,Madison County,10,18,382,102,280
50,12,79,Florida,Madison County,10,99,19347,10041,9306
50,12,79,Florida,Madison County,11,0,240,115,125
50,12,79,Florida,Madison County,11,1,1019,514,505
50,12,79,Florida,Madison County,11,2,1072,542,530
50,12,79,Florida,Madison County,11,3,1085,565,520
50,12,79,Florida,Madison County,11,4,1389,771,618
50,12,79,Florida,Madison County,11,5,1288,708,580
50,12,79,Florida,Madison County,11,6,1285,765,520
50,12,79,Florida,Madison County,11,7,1116,655,461
50,12,79,Florida,Madison County,11,8,1178,676,502
50,12,79,Florida,Madison County,11,9,1265,705,560
50,12,79,Florida,Madison County,11,10,1421,780,641
50,12,79,Florida,Madison County,11,11,1336,711,625
50,12,79,Florida,Madison County,11,12,1341,650,691
50,12,79,Florida,Madison County,11,13,1232,660,572
50,12,79,Florida,Madison County,11,14,963,462,501
50,12,79,Florida,Madison County,11,15,763,368,395
50,12,79,Florida,Madison County,11,16,519,225,294
50,12,79,Florida,Madison County,11,17,441,178,263
50,12,79,Florida,Madison County,11,18,376,101,275
50,12,79,Florida,Madison County,11,99,19329,10151,9178
50,12,79,Florida,Madison County,12,0,229,104,125
50,12,79,Florida,Madison County,12,1,986,504,482
50,12,79,Florida,Madison County,12,2,1075,544,531
50,12,79,Florida,Madison County,12,3,1100,562,538
50,12,79,Florida,Madison County,12,4,1346,737,609
50,12,79,Florida,Madison County,12,5,1279,693,586
50,12,79,Florida,Madison County,12,6,1285,768,517
50,12,79,Florida,Madison County,12,7,1108,632,476
50,12,79,Florida,Madison County,12,8,1145,652,493
50,12,79,Florida,Madison County,12,9,1209,656,553
50,12,79,Florida,Madison County,12,10,1429,793,636
50,12,79,Florida,Madison County,12,11,1358,711,647
50,12,79,Florida,Madison County,12,12,1354,660,694
50,12,79,Florida,Madison County,12,13,1276,683,593
50,12,79,Florida,Madison County,12,14,976,470,506
50,12,79,Florida,Madison County,12,15,760,362,398
50,12,79,Florida,Madison County,12,16,524,232,292
50,12,79,Florida,Madison County,12,17,397,172,225
50,12,79,Florida,Madison County,12,18,388,100,288
50,12,79,Florida,Madison County,12,99,19224,10035,9189
50,12,79,Florida,Madison County,13,0,228,105,123
50,12,79,Florida,Madison County,13,1,984,506,478
50,12,79,Florida,Madison County,13,2,1073,545,528
50,12,79,Florida,Madison County,13,3,1096,558,538
50,12,79,Florida,Madison County,13,4,1351,736,615
50,12,79,Florida,Madison County,13,5,1273,686,587
50,12,79,Florida,Madison County,13,6,1280,764,516
50,12,79,Florida,Madison County,13,7,1104,628,476
50,12,79,Florida,Madison County,13,8,1147,655,492
50,12,79,Florida,Madison County,13,9,1210,659,551
50,12,79,Florida,Madison County,13,10,1419,791,628
50,12,79,Florida,Madison County,13,11,1355,711,644
50,12,79,Florida,Madison County,13,12,1356,664,692
50,12,79,Florida,Madison County,13,13,1285,689,596
50,12,79,Florida,Madison County,13,14,982,471,511
50,12,79,Florida,Madison County,13,15,758,360,398
50,12,79,Florida,Madison County,13,16,523,229,294
50,12,79,Florida,Madison County,13,17,392,169,223
50,12,79,Florida,Madison County,13,18,389,100,289
50,12,79,Florida,Madison County,13,99,19205,10026,9179
50,12,81,Florida,Manatee County,1,0,3042,1575,1467
50,12,81,Florida,Manatee County,1,1,11859,5997,5862
50,12,81,Florida,Manatee County,1,2,15413,7889,7524
50,12,81,Florida,Manatee County,1,3,15630,8080,7550
50,12,81,Florida,Manatee County,1,4,14018,7407,6611
50,12,81,Florida,Manatee County,1,5,11904,6259,5645
50,12,81,Florida,Manatee County,1,6,13608,6816,6792
50,12,81,Florida,Manatee County,1,7,15414,7801,7613
50,12,81,Florida,Manatee County,1,8,17854,8908,8946
50,12,81,Florida,Manatee County,1,9,18190,9016,9174
50,12,81,Florida,Manatee County,1,10,16746,8124,8622
50,12,81,Florida,Manatee County,1,11,15831,7447,8384
50,12,81,Florida,Manatee County,1,12,14480,6727,7753
50,12,81,Florida,Manatee County,1,13,14392,6647,7745
50,12,81,Florida,Manatee County,1,14,15699,7325,8374
50,12,81,Florida,Manatee County,1,15,17305,7918,9387
50,12,81,Florida,Manatee County,1,16,14960,6727,8233
50,12,81,Florida,Manatee County,1,17,9917,4153,5764
50,12,81,Florida,Manatee County,1,18,7734,2729,5005
50,12,81,Florida,Manatee County,1,99,263996,127545,136451
50,12,81,Florida,Manatee County,2,0,3107,1606,1501
50,12,81,Florida,Manatee County,2,1,11878,6002,5876
50,12,81,Florida,Manatee County,2,2,15443,7905,7538
50,12,81,Florida,Manatee County,2,3,15794,8162,7632
50,12,81,Florida,Manatee County,2,4,14140,7462,6678
50,12,81,Florida,Manatee County,2,5,12064,6336,5728
50,12,81,Florida,Manatee County,2,6,13600,6807,6793
50,12,81,Florida,Manatee County,2,7,15509,7850,7659
50,12,81,Florida,Manatee County,2,8,17891,8931,8960
50,12,81,Florida,Manatee County,2,9,18342,9097,9245
50,12,81,Florida,Manatee County,2,10,16941,8214,8727
50,12,81,Florida,Manatee County,2,11,16079,7562,8517
50,12,81,Florida,Manatee County,2,12,14659,6807,7852
50,12,81,Florida,Manatee County,2,13,14542,6720,7822
50,12,81,Florida,Manatee County,2,14,15651,7306,8345
50,12,81,Florida,Manatee County,2,15,17287,7926,9361
50,12,81,Florida,Manatee County,2,16,14987,6750,8237
50,12,81,Florida,Manatee County,2,17,9981,4189,5792
50,12,81,Florida,Manatee County,2,18,7749,2737,5012
50,12,81,Florida,Manatee County,2,99,265644,128369,137275
50,12,81,Florida,Manatee County,3,0,3271,1708,1563
50,12,81,Florida,Manatee County,3,1,12128,6182,5946
50,12,81,Florida,Manatee County,3,2,15642,8066,7576
50,12,81,Florida,Manatee County,3,3,16407,8469,7938
50,12,81,Florida,Manatee County,3,4,14446,7604,6842
50,12,81,Florida,Manatee County,3,5,12801,6588,6213
50,12,81,Florida,Manatee County,3,6,13321,6733,6588
50,12,81,Florida,Manatee County,3,7,15842,7967,7875
50,12,81,Florida,Manatee County,3,8,17753,8903,8850
50,12,81,Florida,Manatee County,3,9,19152,9480,9672
50,12,81,Florida,Manatee County,3,10,17851,8677,9174
50,12,81,Florida,Manatee County,3,11,17169,8093,9076
50,12,81,Florida,Manatee County,3,12,15458,7178,8280
50,12,81,Florida,Manatee County,3,13,15031,6892,8139
50,12,81,Florida,Manatee County,3,14,15740,7399,8341
50,12,81,Florida,Manatee County,3,15,17112,7902,9210
50,12,81,Florida,Manatee County,3,16,15214,6905,8309
50,12,81,Florida,Manatee County,3,17,10228,4372,5856
50,12,81,Florida,Manatee County,3,18,7715,2737,4978
50,12,81,Florida,Manatee County,3,99,272281,131855,140426
50,12,81,Florida,Manatee County,4,0,3288,1599,1689
50,12,81,Florida,Manatee County,4,1,12712,6497,6215
50,12,81,Florida,Manatee County,4,2,15808,8087,7721
50,12,81,Florida,Manatee County,4,3,16944,8771,8173
50,12,81,Florida,Manatee County,4,4,14838,7788,7050
50,12,81,Florida,Manatee County,4,5,13460,6847,6613
50,12,81,Florida,Manatee County,4,6,13557,6790,6767
50,12,81,Florida,Manatee County,4,7,16258,8194,8064
50,12,81,Florida,Manatee County,4,8,17752,8971,8781
50,12,81,Florida,Manatee County,4,9,19623,9641,9982
50,12,81,Florida,Manatee County,4,10,18814,9152,9662
50,12,81,Florida,Manatee County,4,11,17619,8328,9291
50,12,81,Florida,Manatee County,4,12,17084,7972,9112
50,12,81,Florida,Manatee County,4,13,15844,7274,8570
50,12,81,Florida,Manatee County,4,14,15909,7410,8499
50,12,81,Florida,Manatee County,4,15,16885,7844,9041
50,12,81,Florida,Manatee County,4,16,15293,7020,8273
50,12,81,Florida,Manatee County,4,17,10447,4503,5944
50,12,81,Florida,Manatee County,4,18,7815,2842,4973
50,12,81,Florida,Manatee County,4,99,279950,135530,144420
50,12,81,Florida,Manatee County,5,0,3386,1698,1688
50,12,81,Florida,Manatee County,5,1,13021,6578,6443
50,12,81,Florida,Manatee County,5,2,15935,8139,7796
50,12,81,Florida,Manatee County,5,3,17451,9002,8449
50,12,81,Florida,Manatee County,5,4,15644,8167,7477
50,12,81,Florida,Manatee County,5,5,14039,7188,6851
50,12,81,Florida,Manatee County,5,6,13481,6747,6734
50,12,81,Florida,Manatee County,5,7,16475,8237,8238
50,12,81,Florida,Manatee County,5,8,17688,8840,8848
50,12,81,Florida,Manatee County,5,9,19969,9824,10145
50,12,81,Florida,Manatee County,5,10,19601,9528,10073
50,12,81,Florida,Manatee County,5,11,18145,8629,9516
50,12,81,Florida,Manatee County,5,12,17984,8379,9605
50,12,81,Florida,Manatee County,5,13,17035,7882,9153
50,12,81,Florida,Manatee County,5,14,16430,7681,8749
50,12,81,Florida,Manatee County,5,15,16560,7674,8886
50,12,81,Florida,Manatee County,5,16,15499,7160,8339
50,12,81,Florida,Manatee County,5,17,10688,4646,6042
50,12,81,Florida,Manatee County,5,18,7969,2933,5036
50,12,81,Florida,Manatee County,5,99,287000,138932,148068
50,12,81,Florida,Manatee County,6,0,3536,1757,1779
50,12,81,Florida,Manatee County,6,1,13460,6761,6699
50,12,81,Florida,Manatee County,6,2,16345,8319,8026
50,12,81,Florida,Manatee County,6,3,17797,9106,8691
50,12,81,Florida,Manatee County,6,4,16486,8669,7817
50,12,81,Florida,Manatee County,6,5,14533,7457,7076
50,12,81,Florida,Manatee County,6,6,14014,7012,7002
50,12,81,Florida,Manatee County,6,7,16479,8189,8290
50,12,81,Florida,Manatee County,6,8,17765,8863,8902
50,12,81,Florida,Manatee County,6,9,20538,10128,10410
50,12,81,Florida,Manatee County,6,10,20341,9879,10462
50,12,81,Florida,Manatee County,6,11,19046,9104,9942
50,12,81,Florida,Manatee County,6,12,19439,8999,10440
50,12,81,Florida,Manatee County,6,13,18165,8389,9776
50,12,81,Florida,Manatee County,6,14,17208,8048,9160
50,12,81,Florida,Manatee County,6,15,16363,7729,8634
50,12,81,Florida,Manatee County,6,16,15520,7204,8316
50,12,81,Florida,Manatee County,6,17,11089,4841,6248
50,12,81,Florida,Manatee County,6,18,8059,3022,5037
50,12,81,Florida,Manatee County,6,99,296183,143476,152707
50,12,81,Florida,Manatee County,7,0,3603,1787,1816
50,12,81,Florida,Manatee County,7,1,14204,7108,7096
50,12,81,Florida,Manatee County,7,2,16842,8656,8186
50,12,81,Florida,Manatee County,7,3,18129,9207,8922
50,12,81,Florida,Manatee County,7,4,17272,9082,8190
50,12,81,Florida,Manatee County,7,5,15355,7848,7507
50,12,81,Florida,Manatee County,7,6,14839,7463,7376
50,12,81,Florida,Manatee County,7,7,16351,8191,8160
50,12,81,Florida,Manatee County,7,8,18336,9046,9290
50,12,81,Florida,Manatee County,7,9,21107,10390,10717
50,12,81,Florida,Manatee County,7,10,21234,10330,10904
50,12,81,Florida,Manatee County,7,11,20111,9553,10558
50,12,81,Florida,Manatee County,7,12,20819,9638,11181
50,12,81,Florida,Manatee County,7,13,19375,9008,10367
50,12,81,Florida,Manatee County,7,14,17652,8289,9363
50,12,81,Florida,Manatee County,7,15,16423,7810,8613
50,12,81,Florida,Manatee County,7,16,15533,7216,8317
50,12,81,Florida,Manatee County,7,17,11327,4983,6344
50,12,81,Florida,Manatee County,7,18,8333,3174,5159
50,12,81,Florida,Manatee County,7,99,306845,148779,158066
50,12,81,Florida,Manatee County,8,0,3992,1957,2035
50,12,81,Florida,Manatee County,8,1,14497,7273,7224
50,12,81,Florida,Manatee County,8,2,17475,8999,8476
50,12,81,Florida,Manatee County,8,3,18304,9280,9024
50,12,81,Florida,Manatee County,8,4,17939,9347,8592
50,12,81,Florida,Manatee County,8,5,15518,8036,7482
50,12,81,Florida,Manatee County,8,6,15926,7908,8018
50,12,81,Florida,Manatee County,8,7,16146,8108,8038
50,12,81,Florida,Manatee County,8,8,18940,9307,9633
50,12,81,Florida,Manatee County,8,9,20783,10279,10504
50,12,81,Florida,Manatee County,8,10,21942,10653,11289
50,12,81,Florida,Manatee County,8,11,20788,9901,10887
50,12,81,Florida,Manatee County,8,12,21788,10100,11688
50,12,81,Florida,Manatee County,8,13,20106,9362,10744
50,12,81,Florida,Manatee County,8,14,18164,8518,9646
50,12,81,Florida,Manatee County,8,15,16222,7719,8503
50,12,81,Florida,Manatee County,8,16,15342,7123,8219
50,12,81,Florida,Manatee County,8,17,11279,5032,6247
50,12,81,Florida,Manatee County,8,18,8620,3278,5342
50,12,81,Florida,Manatee County,8,99,313771,152180,161591
50,12,81,Florida,Manatee County,9,0,4055,2018,2037
50,12,81,Florida,Manatee County,9,1,14583,7322,7261
50,12,81,Florida,Manatee County,9,2,17683,9027,8656
50,12,81,Florida,Manatee County,9,3,18339,9333,9006
50,12,81,Florida,Manatee County,9,4,18287,9524,8763
50,12,81,Florida,Manatee County,9,5,15624,8032,7592
50,12,81,Florida,Manatee County,9,6,16315,8166,8149
50,12,81,Florida,Manatee County,9,7,15828,7894,7934
50,12,81,Florida,Manatee County,9,8,18967,9363,9604
50,12,81,Florida,Manatee County,9,9,20272,10098,10174
50,12,81,Florida,Manatee County,9,10,21897,10595,11302
50,12,81,Florida,Manatee County,9,11,21308,10200,11108
50,12,81,Florida,Manatee County,9,12,21419,9919,11500
50,12,81,Florida,Manatee County,9,13,21326,9944,11382
50,12,81,Florida,Manatee County,9,14,18799,8788,10011
50,12,81,Florida,Manatee County,9,15,16371,7779,8592
50,12,81,Florida,Manatee County,9,16,15098,7007,8091
50,12,81,Florida,Manatee County,9,17,11368,5176,6192
50,12,81,Florida,Manatee County,9,18,8871,3405,5466
50,12,81,Florida,Manatee County,9,99,316410,153590,162820
50,12,81,Florida,Manatee County,10,0,3983,1955,2028
50,12,81,Florida,Manatee County,10,1,14722,7470,7252
50,12,81,Florida,Manatee County,10,2,17885,9143,8742
50,12,81,Florida,Manatee County,10,3,18179,9249,8930
50,12,81,Florida,Manatee County,10,4,18397,9445,8952
50,12,81,Florida,Manatee County,10,5,15715,8047,7668
50,12,81,Florida,Manatee County,10,6,16546,8314,8232
50,12,81,Florida,Manatee County,10,7,15600,7824,7776
50,12,81,Florida,Manatee County,10,8,18686,9156,9530
50,12,81,Florida,Manatee County,10,9,19889,9807,10082
50,12,81,Florida,Manatee County,10,10,21730,10578,11152
50,12,81,Florida,Manatee County,10,11,21691,10376,11315
50,12,81,Florida,Manatee County,10,12,21173,9809,11364
50,12,81,Florida,Manatee County,10,13,21929,10221,11708
50,12,81,Florida,Manatee County,10,14,20127,9424,10703
50,12,81,Florida,Manatee County,10,15,16859,8057,8802
50,12,81,Florida,Manatee County,10,16,14818,6863,7955
50,12,81,Florida,Manatee County,10,17,11631,5269,6362
50,12,81,Florida,Manatee County,10,18,9206,3529,5677
50,12,81,Florida,Manatee County,10,99,318766,154536,164230
50,12,81,Florida,Manatee County,11,0,3667,1833,1834
50,12,81,Florida,Manatee County,11,1,14791,7454,7337
50,12,81,Florida,Manatee County,11,2,18125,9264,8861
50,12,81,Florida,Manatee County,11,3,18373,9269,9104
50,12,81,Florida,Manatee County,11,4,18217,9375,8842
50,12,81,Florida,Manatee County,11,5,15844,8050,7794
50,12,81,Florida,Manatee County,11,6,16519,8258,8261
50,12,81,Florida,Manatee County,11,7,15881,8017,7864
50,12,81,Florida,Manatee County,11,8,18087,8865,9222
50,12,81,Florida,Manatee County,11,9,19391,9468,9923
50,12,81,Florida,Manatee County,11,10,21834,10702,11132
50,12,81,Florida,Manatee County,11,11,21911,10445,11466
50,12,81,Florida,Manatee County,11,12,21379,9959,11420
50,12,81,Florida,Manatee County,11,13,22690,10488,12202
50,12,81,Florida,Manatee County,11,14,20812,9722,11090
50,12,81,Florida,Manatee County,11,15,17222,8199,9023
50,12,81,Florida,Manatee County,11,16,14715,6947,7768
50,12,81,Florida,Manatee County,11,17,11581,5221,6360
50,12,81,Florida,Manatee County,11,18,9672,3686,5986
50,12,81,Florida,Manatee County,11,99,320711,155222,165489
50,12,81,Florida,Manatee County,12,0,3519,1724,1795
50,12,81,Florida,Manatee County,12,1,14803,7499,7304
50,12,81,Florida,Manatee County,12,2,18136,9281,8855
50,12,81,Florida,Manatee County,12,3,18527,9414,9113
50,12,81,Florida,Manatee County,12,4,18100,9239,8861
50,12,81,Florida,Manatee County,12,5,16031,8160,7871
50,12,81,Florida,Manatee County,12,6,16627,8250,8377
50,12,81,Florida,Manatee County,12,7,16126,8143,7983
50,12,81,Florida,Manatee County,12,8,17484,8568,8916
50,12,81,Florida,Manatee County,12,9,19243,9362,9881
50,12,81,Florida,Manatee County,12,10,21723,10562,11161
50,12,81,Florida,Manatee County,12,11,22325,10713,11612
50,12,81,Florida,Manatee County,12,12,21713,9979,11734
50,12,81,Florida,Manatee County,12,13,23367,10811,12556
50,12,81,Florida,Manatee County,12,14,21602,10176,11426
50,12,81,Florida,Manatee County,12,15,17383,8277,9106
50,12,81,Florida,Manatee County,12,16,14633,6953,7680
50,12,81,Florida,Manatee County,12,17,11563,5171,6392
50,12,81,Florida,Manatee County,12,18,9928,3833,6095
50,12,81,Florida,Manatee County,12,99,322833,156115,166718
50,12,81,Florida,Manatee County,13,0,3523,1725,1798
50,12,81,Florida,Manatee County,13,1,14774,7488,7286
50,12,81,Florida,Manatee County,13,2,18147,9284,8863
50,12,81,Florida,Manatee County,13,3,18550,9421,9129
50,12,81,Florida,Manatee County,13,4,18023,9205,8818
50,12,81,Florida,Manatee County,13,5,16099,8195,7904
50,12,81,Florida,Manatee County,13,6,16657,8271,8386
50,12,81,Florida,Manatee County,13,7,16235,8200,8035
50,12,81,Florida,Manatee County,13,8,17384,8525,8859
50,12,81,Florida,Manatee County,13,9,19238,9359,9879
50,12,81,Florida,Manatee County,13,10,21634,10525,11109
50,12,81,Florida,Manatee County,13,11,22385,10741,11644
50,12,81,Florida,Manatee County,13,12,21834,10040,11794
50,12,81,Florida,Manatee County,13,13,23594,10920,12674
50,12,81,Florida,Manatee County,13,14,21736,10240,11496
50,12,81,Florida,Manatee County,13,15,17461,8319,9142
50,12,81,Florida,Manatee County,13,16,14604,6945,7659
50,12,81,Florida,Manatee County,13,17,11568,5187,6381
50,12,81,Florida,Manatee County,13,18,9989,3867,6122
50,12,81,Florida,Manatee County,13,99,323435,156457,166978
50,12,83,Florida,Marion County,1,0,2602,1305,1297
50,12,83,Florida,Marion County,1,1,10884,5660,5224
50,12,83,Florida,Marion County,1,2,15312,7898,7414
50,12,83,Florida,Marion County,1,3,16755,8601,8154
50,12,83,Florida,Marion County,1,4,15416,7915,7501
50,12,83,Florida,Marion County,1,5,10940,5501,5439
50,12,83,Florida,Marion County,1,6,12349,6029,6320
50,12,83,Florida,Marion County,1,7,14087,6889,7198
50,12,83,Florida,Marion County,1,8,17297,8512,8785
50,12,83,Florida,Marion County,1,9,17951,8700,9251
50,12,83,Florida,Marion County,1,10,15829,7577,8252
50,12,83,Florida,Marion County,1,11,15431,7230,8201
50,12,83,Florida,Marion County,1,12,14901,6674,8227
50,12,83,Florida,Marion County,1,13,15641,7162,8479
50,12,83,Florida,Marion County,1,14,17294,8249,9045
50,12,83,Florida,Marion County,1,15,17983,8640,9343
50,12,83,Florida,Marion County,1,16,14401,6671,7730
50,12,83,Florida,Marion County,1,17,8356,3753,4603
50,12,83,Florida,Marion County,1,18,5444,1957,3487
50,12,83,Florida,Marion County,1,99,258873,124923,133950
50,12,83,Florida,Marion County,2,0,2640,1322,1318
50,12,83,Florida,Marion County,2,1,10880,5653,5227
50,12,83,Florida,Marion County,2,2,15273,7877,7396
50,12,83,Florida,Marion County,2,3,16875,8663,8212
50,12,83,Florida,Marion County,2,4,15500,7959,7541
50,12,83,Florida,Marion County,2,5,11074,5562,5512
50,12,83,Florida,Marion County,2,6,12291,5995,6296
50,12,83,Florida,Marion County,2,7,14129,6907,7222
50,12,83,Florida,Marion County,2,8,17274,8503,8771
50,12,83,Florida,Marion County,2,9,18046,8742,9304
50,12,83,Florida,Marion County,2,10,15979,7641,8338
50,12,83,Florida,Marion County,2,11,15647,7329,8318
50,12,83,Florida,Marion County,2,12,15046,6736,8310
50,12,83,Florida,Marion County,2,13,15756,7223,8533
50,12,83,Florida,Marion County,2,14,17306,8253,9053
50,12,83,Florida,Marion County,2,15,18045,8686,9359
50,12,83,Florida,Marion County,2,16,14496,6720,7776
50,12,83,Florida,Marion County,2,17,8466,3808,4658
50,12,83,Florida,Marion County,2,18,5498,1980,3518
50,12,83,Florida,Marion County,2,99,260221,125559,134662
50,12,83,Florida,Marion County,3,0,2899,1509,1390
50,12,83,Florida,Marion County,3,1,10967,5663,5304
50,12,83,Florida,Marion County,3,2,15026,7770,7256
50,12,83,Florida,Marion County,3,3,17094,8774,8320
50,12,83,Florida,Marion County,3,4,15680,8069,7611
50,12,83,Florida,Marion County,3,5,11858,5913,5945
50,12,83,Florida,Marion County,3,6,11816,5748,6068
50,12,83,Florida,Marion County,3,7,14247,6981,7266
50,12,83,Florida,Marion County,3,8,16860,8233,8627
50,12,83,Florida,Marion County,3,9,18327,8856,9471
50,12,83,Florida,Marion County,3,10,16630,7953,8677
50,12,83,Florida,Marion County,3,11,16388,7674,8714
50,12,83,Florida,Marion County,3,12,15652,7005,8647
50,12,83,Florida,Marion County,3,13,15931,7302,8629
50,12,83,Florida,Marion County,3,14,17372,8283,9089
50,12,83,Florida,Marion County,3,15,18201,8708,9493
50,12,83,Florida,Marion County,3,16,14885,6976,7909
50,12,83,Florida,Marion County,3,17,9004,4045,4959
50,12,83,Florida,Marion County,3,18,5716,2082,3634
50,12,83,Florida,Marion County,3,99,264553,127544,137009
50,12,83,Florida,Marion County,4,0,3048,1586,1462
50,12,83,Florida,Marion County,4,1,11410,5918,5492
50,12,83,Florida,Marion County,4,2,15022,7752,7270
50,12,83,Florida,Marion County,4,3,17484,8969,8515
50,12,83,Florida,Marion County,4,4,16119,8330,7789
50,12,83,Florida,Marion County,4,5,12749,6315,6434
50,12,83,Florida,Marion County,4,6,11758,5714,6044
50,12,83,Florida,Marion County,4,7,14564,7089,7475
50,12,83,Florida,Marion County,4,8,16700,8143,8557
50,12,83,Florida,Marion County,4,9,18699,9099,9600
50,12,83,Florida,Marion County,4,10,17451,8282,9169
50,12,83,Florida,Marion County,4,11,16641,7787,8854
50,12,83,Florida,Marion County,4,12,16925,7547,9378
50,12,83,Florida,Marion County,4,13,16819,7712,9107
50,12,83,Florida,Marion County,4,14,17606,8350,9256
50,12,83,Florida,Marion County,4,15,18229,8813,9416
50,12,83,Florida,Marion County,4,16,15043,7058,7985
50,12,83,Florida,Marion County,4,17,9534,4325,5209
50,12,83,Florida,Marion County,4,18,5915,2189,3726
50,12,83,Florida,Marion County,4,99,271716,130978,140738
50,12,83,Florida,Marion County,5,0,2898,1464,1434
50,12,83,Florida,Marion County,5,1,11773,6123,5650
50,12,83,Florida,Marion County,5,2,15117,7748,7369
50,12,83,Florida,Marion County,5,3,17640,9059,8581
50,12,83,Florida,Marion County,5,4,16651,8636,8015
50,12,83,Florida,Marion County,5,5,13574,6760,6814
50,12,83,Florida,Marion County,5,6,11965,5822,6143
50,12,83,Florida,Marion County,5,7,14776,7212,7564
50,12,83,Florida,Marion County,5,8,16435,8005,8430
50,12,83,Florida,Marion County,5,9,19093,9279,9814
50,12,83,Florida,Marion County,5,10,18271,8699,9572
50,12,83,Florida,Marion County,5,11,17324,7983,9341
50,12,83,Florida,Marion County,5,12,17974,8153,9821
50,12,83,Florida,Marion County,5,13,18661,8515,10146
50,12,83,Florida,Marion County,5,14,18372,8706,9666
50,12,83,Florida,Marion County,5,15,18191,8889,9302
50,12,83,Florida,Marion County,5,16,15400,7237,8163
50,12,83,Florida,Marion County,5,17,9887,4525,5362
50,12,83,Florida,Marion County,5,18,6089,2283,3806
50,12,83,Florida,Marion County,5,99,280091,135098,144993
50,12,83,Florida,Marion County,6,0,3108,1581,1527
50,12,83,Florida,Marion County,6,1,12058,6162,5896
50,12,83,Florida,Marion County,6,2,15261,7864,7397
50,12,83,Florida,Marion County,6,3,17734,9088,8646
50,12,83,Florida,Marion County,6,4,17342,9021,8321
50,12,83,Florida,Marion County,6,5,14419,7226,7193
50,12,83,Florida,Marion County,6,6,12627,6121,6506
50,12,83,Florida,Marion County,6,7,14887,7243,7644
50,12,83,Florida,Marion County,6,8,16476,8084,8392
50,12,83,Florida,Marion County,6,9,19467,9493,9974
50,12,83,Florida,Marion County,6,10,19260,9129,10131
50,12,83,Florida,Marion County,6,11,18084,8317,9767
50,12,83,Florida,Marion County,6,12,19520,8817,10703
50,12,83,Florida,Marion County,6,13,20637,9384,11253
50,12,83,Florida,Marion County,6,14,19711,9483,10228
50,12,83,Florida,Marion County,6,15,18201,8906,9295
50,12,83,Florida,Marion County,6,16,15667,7485,8182
50,12,83,Florida,Marion County,6,17,10244,4670,5574
50,12,83,Florida,Marion County,6,18,6461,2443,4018
50,12,83,Florida,Marion County,6,99,291164,140517,150647
50,12,83,Florida,Marion County,7,0,3425,1750,1675
50,12,83,Florida,Marion County,7,1,12566,6403,6163
50,12,83,Florida,Marion County,7,2,15605,8027,7578
50,12,83,Florida,Marion County,7,3,17910,9176,8734
50,12,83,Florida,Marion County,7,4,18136,9376,8760
50,12,83,Florida,Marion County,7,5,15053,7545,7508
50,12,83,Florida,Marion County,7,6,13541,6519,7022
50,12,83,Florida,Marion County,7,7,14848,7239,7609
50,12,83,Florida,Marion County,7,8,16921,8237,8684
50,12,83,Florida,Marion County,7,9,19819,9750,10069
50,12,83,Florida,Marion County,7,10,20387,9589,10798
50,12,83,Florida,Marion County,7,11,19139,8848,10291
50,12,83,Florida,Marion County,7,12,20829,9470,11359
50,12,83,Florida,Marion County,7,13,22061,10000,12061
50,12,83,Florida,Marion County,7,14,20993,10102,10891
50,12,83,Florida,Marion County,7,15,18782,9129,9653
50,12,83,Florida,Marion County,7,16,16059,7718,8341
50,12,83,Florida,Marion County,7,17,10508,4869,5639
50,12,83,Florida,Marion County,7,18,6976,2615,4361
50,12,83,Florida,Marion County,7,99,303558,146362,157196
50,12,83,Florida,Marion County,8,0,3606,1857,1749
50,12,83,Florida,Marion County,8,1,13159,6669,6490
50,12,83,Florida,Marion County,8,2,16394,8451,7943
50,12,83,Florida,Marion County,8,3,18055,9274,8781
50,12,83,Florida,Marion County,8,4,18922,9809,9113
50,12,83,Florida,Marion County,8,5,15554,7762,7792
50,12,83,Florida,Marion County,8,6,14888,7158,7730
50,12,83,Florida,Marion County,8,7,14948,7241,7707
50,12,83,Florida,Marion County,8,8,17528,8540,8988
50,12,83,Florida,Marion County,8,9,20256,9988,10268
50,12,83,Florida,Marion County,8,10,21293,9999,11294
50,12,83,Florida,Marion County,8,11,20114,9347,10767
50,12,83,Florida,Marion County,8,12,22106,9988,12118
50,12,83,Florida,Marion County,8,13,23088,10523,12565
50,12,83,Florida,Marion County,8,14,22189,10581,11608
50,12,83,Florida,Marion County,8,15,19493,9528,9965
50,12,83,Florida,Marion County,8,16,16330,7865,8465
50,12,83,Florida,Marion County,8,17,11015,5092,5923
50,12,83,Florida,Marion County,8,18,7372,2806,4566
50,12,83,Florida,Marion County,8,99,316310,152478,163832
50,12,83,Florida,Marion County,9,0,3705,1885,1820
50,12,83,Florida,Marion County,9,1,13630,6922,6708
50,12,83,Florida,Marion County,9,2,17043,8813,8230
50,12,83,Florida,Marion County,9,3,18178,9294,8884
50,12,83,Florida,Marion County,9,4,19537,10168,9369
50,12,83,Florida,Marion County,9,5,16010,8056,7954
50,12,83,Florida,Marion County,9,6,15852,7612,8240
50,12,83,Florida,Marion County,9,7,15045,7288,7757
50,12,83,Florida,Marion County,9,8,18120,8779,9341
50,12,83,Florida,Marion County,9,9,20241,9865,10376
50,12,83,Florida,Marion County,9,10,21771,10308,11463
50,12,83,Florida,Marion County,9,11,21145,9842,11303
50,12,83,Florida,Marion County,9,12,22129,10031,12098
50,12,83,Florida,Marion County,9,13,24439,11087,13352
50,12,83,Florida,Marion County,9,14,23334,11100,12234
50,12,83,Florida,Marion County,9,15,19824,9696,10128
50,12,83,Florida,Marion County,9,16,16493,8014,8479
50,12,83,Florida,Marion County,9,17,11252,5175,6077
50,12,83,Florida,Marion County,9,18,7886,3030,4856
50,12,83,Florida,Marion County,9,99,325634,156965,168669
50,12,83,Florida,Marion County,10,0,3802,1934,1868
50,12,83,Florida,Marion County,10,1,13967,7143,6824
50,12,83,Florida,Marion County,10,2,17376,8907,8469
50,12,83,Florida,Marion County,10,3,18277,9429,8848
50,12,83,Florida,Marion County,10,4,19581,10133,9448
50,12,83,Florida,Marion County,10,5,16166,8096,8070
50,12,83,Florida,Marion County,10,6,16397,7869,8528
50,12,83,Florida,Marion County,10,7,15010,7271,7739
50,12,83,Florida,Marion County,10,8,17987,8700,9287
50,12,83,Florida,Marion County,10,9,19708,9538,10170
50,12,83,Florida,Marion County,10,10,22112,10468,11644
50,12,83,Florida,Marion County,10,11,21811,10137,11674
50,12,83,Florida,Marion County,10,12,21869,9793,12076
50,12,83,Florida,Marion County,10,13,24431,11143,13288
50,12,83,Florida,Marion County,10,14,24660,11660,13000
50,12,83,Florida,Marion County,10,15,20421,9811,10610
50,12,83,Florida,Marion County,10,16,16534,8081,8453
50,12,83,Florida,Marion County,10,17,11720,5411,6309
50,12,83,Florida,Marion County,10,18,8223,3215,5008
50,12,83,Florida,Marion County,10,99,330052,158739,171313
50,12,83,Florida,Marion County,11,0,3524,1819,1705
50,12,83,Florida,Marion County,11,1,14071,7191,6880
50,12,83,Florida,Marion County,11,2,17267,8867,8400
50,12,83,Florida,Marion County,11,3,18176,9366,8810
50,12,83,Florida,Marion County,11,4,19311,9990,9321
50,12,83,Florida,Marion County,11,5,16133,8082,8051
50,12,83,Florida,Marion County,11,6,16625,8003,8622
50,12,83,Florida,Marion County,11,7,15100,7291,7809
50,12,83,Florida,Marion County,11,8,17575,8407,9168
50,12,83,Florida,Marion County,11,9,19221,9276,9945
50,12,83,Florida,Marion County,11,10,22087,10517,11570
50,12,83,Florida,Marion County,11,11,22159,10272,11887
50,12,83,Florida,Marion County,11,12,21396,9667,11729
50,12,83,Florida,Marion County,11,13,24558,11138,13420
50,12,83,Florida,Marion County,11,14,25276,11830,13446
50,12,83,Florida,Marion County,11,15,21171,10152,11019
50,12,83,Florida,Marion County,11,16,16468,8030,8438
50,12,83,Florida,Marion County,11,17,11911,5597,6314
50,12,83,Florida,Marion County,11,18,8851,3438,5413
50,12,83,Florida,Marion County,11,99,330880,158933,171947
50,12,83,Florida,Marion County,12,0,3385,1728,1657
50,12,83,Florida,Marion County,12,1,13727,7024,6703
50,12,83,Florida,Marion County,12,2,17413,8942,8471
50,12,83,Florida,Marion County,12,3,18029,9260,8769
50,12,83,Florida,Marion County,12,4,19033,9819,9214
50,12,83,Florida,Marion County,12,5,16336,8164,8172
50,12,83,Florida,Marion County,12,6,16473,7965,8508
50,12,83,Florida,Marion County,12,7,15337,7444,7893
50,12,83,Florida,Marion County,12,8,16921,8083,8838
50,12,83,Florida,Marion County,12,9,18934,9095,9839
50,12,83,Florida,Marion County,12,10,21877,10509,11368
50,12,83,Florida,Marion County,12,11,22514,10402,12112
50,12,83,Florida,Marion County,12,12,21283,9608,11675
50,12,83,Florida,Marion County,12,13,24718,11256,13462
50,12,83,Florida,Marion County,12,14,25466,11804,13662
50,12,83,Florida,Marion County,12,15,21628,10345,11283
50,12,83,Florida,Marion County,12,16,16762,8151,8611
50,12,83,Florida,Marion County,12,17,12060,5679,6381
50,12,83,Florida,Marion County,12,18,9402,3715,5687
50,12,83,Florida,Marion County,12,99,331298,158993,172305
50,12,83,Florida,Marion County,13,0,3387,1729,1658
50,12,83,Florida,Marion County,13,1,13689,7005,6684
50,12,83,Florida,Marion County,13,2,17369,8926,8443
50,12,83,Florida,Marion County,13,3,18002,9241,8761
50,12,83,Florida,Marion County,13,4,18890,9749,9141
50,12,83,Florida,Marion County,13,5,16375,8180,8195
50,12,83,Florida,Marion County,13,6,16478,7978,8500
50,12,83,Florida,Marion County,13,7,15409,7477,7932
50,12,83,Florida,Marion County,13,8,16776,8019,8757
50,12,83,Florida,Marion County,13,9,18887,9070,9817
50,12,83,Florida,Marion County,13,10,21756,10454,11302
50,12,83,Florida,Marion County,13,11,22530,10405,12125
50,12,83,Florida,Marion County,13,12,21354,9644,11710
50,12,83,Florida,Marion County,13,13,24928,11352,13576
50,12,83,Florida,Marion County,13,14,25581,11861,13720
50,12,83,Florida,Marion County,13,15,21682,10375,11307
50,12,83,Florida,Marion County,13,16,16702,8128,8574
50,12,83,Florida,Marion County,13,17,12047,5684,6363
50,12,83,Florida,Marion County,13,18,9448,3743,5705
50,12,83,Florida,Marion County,13,99,331290,159020,172270
50,12,85,Florida,Martin County,1,0,1112,571,541
50,12,85,Florida,Martin County,1,1,4490,2298,2192
50,12,85,Florida,Martin County,1,2,6807,3476,3331
50,12,85,Florida,Martin County,1,3,7192,3758,3434
50,12,85,Florida,Martin County,1,4,6134,3203,2931
50,12,85,Florida,Martin County,1,5,4628,2628,2000
50,12,85,Florida,Martin County,1,6,4990,2679,2311
50,12,85,Florida,Martin County,1,7,6292,3262,3030
50,12,85,Florida,Martin County,1,8,8558,4296,4262
50,12,85,Florida,Martin County,1,9,9183,4611,4572
50,12,85,Florida,Martin County,1,10,8365,4174,4191
50,12,85,Florida,Martin County,1,11,8173,4024,4149
50,12,85,Florida,Martin County,1,12,7582,3496,4086
50,12,85,Florida,Martin County,1,13,7475,3452,4023
50,12,85,Florida,Martin County,1,14,8672,4106,4566
50,12,85,Florida,Martin County,1,15,9291,4379,4912
50,12,85,Florida,Martin County,1,16,8512,3929,4583
50,12,85,Florida,Martin County,1,17,5385,2424,2961
50,12,85,Florida,Martin County,1,18,3936,1446,2490
50,12,85,Florida,Martin County,1,99,126777,62212,64565
50,12,85,Florida,Martin County,2,0,1126,579,547
50,12,85,Florida,Martin County,2,1,4487,2294,2193
50,12,85,Florida,Martin County,2,2,6794,3471,3323
50,12,85,Florida,Martin County,2,3,7240,3784,3456
50,12,85,Florida,Martin County,2,4,6157,3221,2936
50,12,85,Florida,Martin County,2,5,4665,2651,2014
50,12,85,Florida,Martin County,2,6,4978,2677,2301
50,12,85,Florida,Martin County,2,7,6308,3270,3038
50,12,85,Florida,Martin County,2,8,8538,4285,4253
50,12,85,Florida,Martin County,2,9,9220,4627,4593
50,12,85,Florida,Martin County,2,10,8419,4202,4217
50,12,85,Florida,Martin County,2,11,8267,4072,4195
50,12,85,Florida,Martin County,2,12,7645,3525,4120
50,12,85,Florida,Martin County,2,13,7509,3467,4042
50,12,85,Florida,Martin County,2,14,8670,4107,4563
50,12,85,Florida,Martin County,2,15,9309,4396,4913
50,12,85,Florida,Martin County,2,16,8551,3949,4602
50,12,85,Florida,Martin County,2,17,5446,2452,2994
50,12,85,Florida,Martin County,2,18,3972,1462,2510
50,12,85,Florida,Martin County,2,99,127301,62491,64810
50,12,85,Florida,Martin County,3,0,1177,579,598
50,12,85,Florida,Martin County,3,1,4578,2322,2256
50,12,85,Florida,Martin County,3,2,6684,3391,3293
50,12,85,Florida,Martin County,3,3,7524,3873,3651
50,12,85,Florida,Martin County,3,4,6385,3366,3019
50,12,85,Florida,Martin County,3,5,4902,2765,2137
50,12,85,Florida,Martin County,3,6,4796,2574,2222
50,12,85,Florida,Martin County,3,7,6277,3249,3028
50,12,85,Florida,Martin County,3,8,8472,4309,4163
50,12,85,Florida,Martin County,3,9,9492,4727,4765
50,12,85,Florida,Martin County,3,10,8615,4283,4332
50,12,85,Florida,Martin County,3,11,8795,4334,4461
50,12,85,Florida,Martin County,3,12,7925,3717,4208
50,12,85,Florida,Martin County,3,13,7794,3566,4228
50,12,85,Florida,Martin County,3,14,8612,4053,4559
50,12,85,Florida,Martin County,3,15,9433,4505,4928
50,12,85,Florida,Martin County,3,16,8547,3940,4607
50,12,85,Florida,Martin County,3,17,5731,2622,3109
50,12,85,Florida,Martin County,3,18,4117,1520,2597
50,12,85,Florida,Martin County,3,99,129856,63695,66161
50,12,85,Florida,Martin County,4,0,1133,558,575
50,12,85,Florida,Martin County,4,1,4750,2396,2354
50,12,85,Florida,Martin County,4,2,6725,3443,3282
50,12,85,Florida,Martin County,4,3,7724,4016,3708
50,12,85,Florida,Martin County,4,4,6684,3514,3170
50,12,85,Florida,Martin County,4,5,5061,2799,2262
50,12,85,Florida,Martin County,4,6,4933,2664,2269
50,12,85,Florida,Martin County,4,7,6297,3333,2964
50,12,85,Florida,Martin County,4,8,8314,4209,4105
50,12,85,Florida,Martin County,4,9,9709,4863,4846
50,12,85,Florida,Martin County,4,10,9117,4504,4613
50,12,85,Florida,Martin County,4,11,8840,4352,4488
50,12,85,Florida,Martin County,4,12,8680,4087,4593
50,12,85,Florida,Martin County,4,13,8197,3755,4442
50,12,85,Florida,Martin County,4,14,8587,4056,4531
50,12,85,Florida,Martin County,4,15,9358,4525,4833
50,12,85,Florida,Martin County,4,16,8491,3928,4563
50,12,85,Florida,Martin County,4,17,6025,2734,3291
50,12,85,Florida,Martin County,4,18,4320,1627,2693
50,12,85,Florida,Martin County,4,99,132945,65363,67582
50,12,85,Florida,Martin County,5,0,1077,521,556
50,12,85,Florida,Martin County,5,1,4942,2472,2470
50,12,85,Florida,Martin County,5,2,6827,3466,3361
50,12,85,Florida,Martin County,5,3,7914,4086,3828
50,12,85,Florida,Martin County,5,4,7053,3780,3273
50,12,85,Florida,Martin County,5,5,5264,2966,2298
50,12,85,Florida,Martin County,5,6,5151,2805,2346
50,12,85,Florida,Martin County,5,7,6350,3392,2958
50,12,85,Florida,Martin County,5,8,8225,4138,4087
50,12,85,Florida,Martin County,5,9,10001,5036,4965
50,12,85,Florida,Martin County,5,10,9675,4801,4874
50,12,85,Florida,Martin County,5,11,9007,4483,4524
50,12,85,Florida,Martin County,5,12,9063,4293,4770
50,12,85,Florida,Martin County,5,13,8799,4004,4795
50,12,85,Florida,Martin County,5,14,8596,4094,4502
50,12,85,Florida,Martin County,5,15,9291,4505,4786
50,12,85,Florida,Martin County,5,16,8641,4017,4624
50,12,85,Florida,Martin County,5,17,6152,2786,3366
50,12,85,Florida,Martin County,5,18,4570,1736,2834
50,12,85,Florida,Martin County,5,99,136598,67381,69217
50,12,85,Florida,Martin County,6,0,1082,537,545
50,12,85,Florida,Martin County,6,1,5008,2495,2513
50,12,85,Florida,Martin County,6,2,6900,3553,3347
50,12,85,Florida,Martin County,6,3,8079,4140,3939
50,12,85,Florida,Martin County,6,4,7457,3993,3464
50,12,85,Florida,Martin County,6,5,5477,3033,2444
50,12,85,Florida,Martin County,6,6,5239,2903,2336
50,12,85,Florida,Martin County,6,7,6249,3351,2898
50,12,85,Florida,Martin County,6,8,7972,3991,3981
50,12,85,Florida,Martin County,6,9,10325,5242,5083
50,12,85,Florida,Martin County,6,10,10113,5032,5081
50,12,85,Florida,Martin County,6,11,9347,4614,4733
50,12,85,Florida,Martin County,6,12,9626,4579,5047
50,12,85,Florida,Martin County,6,13,9236,4205,5031
50,12,85,Florida,Martin County,6,14,8925,4209,4716
50,12,85,Florida,Martin County,6,15,9094,4491,4603
50,12,85,Florida,Martin County,6,16,8595,3954,4641
50,12,85,Florida,Martin County,6,17,6263,2819,3444
50,12,85,Florida,Martin County,6,18,4742,1827,2915
50,12,85,Florida,Martin County,6,99,139729,68968,70761
50,12,85,Florida,Martin County,7,0,1145,558,587
50,12,85,Florida,Martin County,7,1,5029,2568,2461
50,12,85,Florida,Martin County,7,2,6968,3598,3370
50,12,85,Florida,Martin County,7,3,8098,4128,3970
50,12,85,Florida,Martin County,7,4,7747,4165,3582
50,12,85,Florida,Martin County,7,5,5699,3117,2582
50,12,85,Florida,Martin County,7,6,5477,3054,2423
50,12,85,Florida,Martin County,7,7,6028,3239,2789
50,12,85,Florida,Martin County,7,8,7880,3975,3905
50,12,85,Florida,Martin County,7,9,10273,5236,5037
50,12,85,Florida,Martin County,7,10,10502,5225,5277
50,12,85,Florida,Martin County,7,11,9748,4815,4933
50,12,85,Florida,Martin County,7,12,10089,4837,5252
50,12,85,Florida,Martin County,7,13,9514,4401,5113
50,12,85,Florida,Martin County,7,14,9074,4271,4803
50,12,85,Florida,Martin County,7,15,8909,4323,4586
50,12,85,Florida,Martin County,7,16,8427,3916,4511
50,12,85,Florida,Martin County,7,17,6488,2953,3535
50,12,85,Florida,Martin County,7,18,4817,1888,2929
50,12,85,Florida,Martin County,7,99,141912,70267,71645
50,12,85,Florida,Martin County,8,0,1188,544,644
50,12,85,Florida,Martin County,8,1,4841,2533,2308
50,12,85,Florida,Martin County,8,2,6909,3521,3388
50,12,85,Florida,Martin County,8,3,7856,4020,3836
50,12,85,Florida,Martin County,8,4,8033,4327,3706
50,12,85,Florida,Martin County,8,5,5814,3224,2590
50,12,85,Florida,Martin County,8,6,5503,3015,2488
50,12,85,Florida,Martin County,8,7,5828,3170,2658
50,12,85,Florida,Martin County,8,8,7662,3888,3774
50,12,85,Florida,Martin County,8,9,10147,5173,4974
50,12,85,Florida,Martin County,8,10,10682,5287,5395
50,12,85,Florida,Martin County,8,11,9931,4907,5024
50,12,85,Florida,Martin County,8,12,10502,5060,5442
50,12,85,Florida,Martin County,8,13,9672,4498,5174
50,12,85,Florida,Martin County,8,14,8948,4187,4761
50,12,85,Florida,Martin County,8,15,8642,4167,4475
50,12,85,Florida,Martin County,8,16,8311,3907,4404
50,12,85,Florida,Martin County,8,17,6371,2870,3501
50,12,85,Florida,Martin County,8,18,4962,1949,3013
50,12,85,Florida,Martin County,8,99,141802,70247,71555
50,12,85,Florida,Martin County,9,0,1146,515,631
50,12,85,Florida,Martin County,9,1,4933,2573,2360
50,12,85,Florida,Martin County,9,2,6982,3540,3442
50,12,85,Florida,Martin County,9,3,7848,4019,3829
50,12,85,Florida,Martin County,9,4,8096,4344,3752
50,12,85,Florida,Martin County,9,5,6189,3460,2729
50,12,85,Florida,Martin County,9,6,5723,3169,2554
50,12,85,Florida,Martin County,9,7,5765,3112,2653
50,12,85,Florida,Martin County,9,8,7584,3911,3673
50,12,85,Florida,Martin County,9,9,9753,4865,4888
50,12,85,Florida,Martin County,9,10,10865,5420,5445
50,12,85,Florida,Martin County,9,11,10350,5100,5250
50,12,85,Florida,Martin County,9,12,10328,4964,5364
50,12,85,Florida,Martin County,9,13,10128,4701,5427
50,12,85,Florida,Martin County,9,14,9305,4327,4978
50,12,85,Florida,Martin County,9,15,8600,4153,4447
50,12,85,Florida,Martin County,9,16,8295,3916,4379
50,12,85,Florida,Martin County,9,17,6454,2934,3520
50,12,85,Florida,Martin County,9,18,5198,2052,3146
50,12,85,Florida,Martin County,9,99,143542,71075,72467
50,12,85,Florida,Martin County,10,0,1167,539,628
50,12,85,Florida,Martin County,10,1,5002,2556,2446
50,12,85,Florida,Martin County,10,2,6981,3541,3440
50,12,85,Florida,Martin County,10,3,7745,4011,3734
50,12,85,Florida,Martin County,10,4,8027,4283,3744
50,12,85,Florida,Martin County,10,5,6182,3441,2741
50,12,85,Florida,Martin County,10,6,5951,3300,2651
50,12,85,Florida,Martin County,10,7,5779,3091,2688
50,12,85,Florida,Martin County,10,8,7206,3736,3470
50,12,85,Florida,Martin County,10,9,9344,4716,4628
50,12,85,Florida,Martin County,10,10,10813,5357,5456
50,12,85,Florida,Martin County,10,11,10843,5395,5448
50,12,85,Florida,Martin County,10,12,10146,4875,5271
50,12,85,Florida,Martin County,10,13,10452,4901,5551
50,12,85,Florida,Martin County,10,14,9897,4527,5370
50,12,85,Florida,Martin County,10,15,8698,4243,4455
50,12,85,Florida,Martin County,10,16,8182,3872,4310
50,12,85,Florida,Martin County,10,17,6588,3019,3569
50,12,85,Florida,Martin County,10,18,5366,2150,3216
50,12,85,Florida,Martin County,10,99,144369,71553,72816
50,12,85,Florida,Martin County,11,0,1120,554,566
50,12,85,Florida,Martin County,11,1,5067,2578,2489
50,12,85,Florida,Martin County,11,2,6883,3459,3424
50,12,85,Florida,Martin County,11,3,7741,3999,3742
50,12,85,Florida,Martin County,11,4,7954,4213,3741
50,12,85,Florida,Martin County,11,5,6286,3464,2822
50,12,85,Florida,Martin County,11,6,6208,3514,2694
50,12,85,Florida,Martin County,11,7,5870,3162,2708
50,12,85,Florida,Martin County,11,8,7035,3667,3368
50,12,85,Florida,Martin County,11,9,8887,4444,4443
50,12,85,Florida,Martin County,11,10,10954,5441,5513
50,12,85,Florida,Martin County,11,11,11185,5571,5614
50,12,85,Florida,Martin County,11,12,10294,4878,5416
50,12,85,Florida,Martin County,11,13,10578,4990,5588
50,12,85,Florida,Martin County,11,14,10207,4721,5486
50,12,85,Florida,Martin County,11,15,8935,4294,4641
50,12,85,Florida,Martin County,11,16,7998,3806,4192
50,12,85,Florida,Martin County,11,17,6568,2975,3593
50,12,85,Florida,Martin County,11,18,5736,2316,3420
50,12,85,Florida,Martin County,11,99,145506,72046,73460
50,12,85,Florida,Martin County,12,0,1130,569,561
50,12,85,Florida,Martin County,12,1,5071,2559,2512
50,12,85,Florida,Martin County,12,2,6896,3497,3399
50,12,85,Florida,Martin County,12,3,7751,3976,3775
50,12,85,Florida,Martin County,12,4,7805,4096,3709
50,12,85,Florida,Martin County,12,5,6422,3529,2893
50,12,85,Florida,Martin County,12,6,6394,3629,2765
50,12,85,Florida,Martin County,12,7,6042,3280,2762
50,12,85,Florida,Martin County,12,8,6755,3490,3265
50,12,85,Florida,Martin County,12,9,8674,4388,4286
50,12,85,Florida,Martin County,12,10,10775,5360,5415
50,12,85,Florida,Martin County,12,11,11406,5647,5759
50,12,85,Florida,Martin County,12,12,10444,4951,5493
50,12,85,Florida,Martin County,12,13,10781,5106,5675
50,12,85,Florida,Martin County,12,14,10517,4892,5625
50,12,85,Florida,Martin County,12,15,8958,4302,4656
50,12,85,Florida,Martin County,12,16,7950,3734,4216
50,12,85,Florida,Martin County,12,17,6538,2978,3560
50,12,85,Florida,Martin County,12,18,6009,2440,3569
50,12,85,Florida,Martin County,12,99,146318,72423,73895
50,12,85,Florida,Martin County,13,0,1130,570,560
50,12,85,Florida,Martin County,13,1,5056,2556,2500
50,12,85,Florida,Martin County,13,2,6888,3494,3394
50,12,85,Florida,Martin County,13,3,7747,3967,3780
50,12,85,Florida,Martin County,13,4,7755,4073,3682
50,12,85,Florida,Martin County,13,5,6441,3536,2905
50,12,85,Florida,Martin County,13,6,6402,3630,2772
50,12,85,Florida,Martin County,13,7,6068,3290,2778
50,12,85,Florida,Martin County,13,8,6703,3465,3238
50,12,85,Florida,Martin County,13,9,8657,4379,4278
50,12,85,Florida,Martin County,13,10,10717,5338,5379
50,12,85,Florida,Martin County,13,11,11409,5644,5765
50,12,85,Florida,Martin County,13,12,10485,4969,5516
50,12,85,Florida,Martin County,13,13,10873,5146,5727
50,12,85,Florida,Martin County,13,14,10580,4920,5660
50,12,85,Florida,Martin County,13,15,8989,4319,4670
50,12,85,Florida,Martin County,13,16,7921,3728,4193
50,12,85,Florida,Martin County,13,17,6538,2986,3552
50,12,85,Florida,Martin County,13,18,6034,2457,3577
50,12,85,Florida,Martin County,13,99,146393,72467,73926
50,12,86,Florida,Miami-Dade County,1,0,28786,14744,14042
50,12,86,Florida,Miami-Dade County,1,1,116992,59975,57017
50,12,86,Florida,Miami-Dade County,1,2,157901,80652,77249
50,12,86,Florida,Miami-Dade County,1,3,160781,81901,78880
50,12,86,Florida,Miami-Dade County,1,4,155016,78797,76219
50,12,86,Florida,Miami-Dade County,1,5,144750,72191,72559
50,12,86,Florida,Miami-Dade County,1,6,163895,81834,82061
50,12,86,Florida,Miami-Dade County,1,7,173607,86785,86822
50,12,86,Florida,Miami-Dade County,1,8,191863,95226,96637
50,12,86,Florida,Miami-Dade County,1,9,170173,82690,87483
50,12,86,Florida,Miami-Dade County,1,10,150900,71906,78994
50,12,86,Florida,Miami-Dade County,1,11,131922,62761,69161
50,12,86,Florida,Miami-Dade County,1,12,109171,51597,57574
50,12,86,Florida,Miami-Dade County,1,13,97436,45010,52426
50,12,86,Florida,Miami-Dade County,1,14,84513,38250,46263
50,12,86,Florida,Miami-Dade County,1,15,77774,33914,43860
50,12,86,Florida,Miami-Dade County,1,16,59865,24434,35431
50,12,86,Florida,Miami-Dade County,1,17,39975,14716,25259
50,12,86,Florida,Miami-Dade County,1,18,38473,11752,26721
50,12,86,Florida,Miami-Dade County,1,99,2253793,1089135,1164658
50,12,86,Florida,Miami-Dade County,2,0,29186,14942,14244
50,12,86,Florida,Miami-Dade County,2,1,116045,59471,56574
50,12,86,Florida,Miami-Dade County,2,2,156617,79996,76621
50,12,86,Florida,Miami-Dade County,2,3,161695,82345,79350
50,12,86,Florida,Miami-Dade County,2,4,155086,78829,76257
50,12,86,Florida,Miami-Dade County,2,5,145288,72479,72809
50,12,86,Florida,Miami-Dade County,2,6,163282,81389,81893
50,12,86,Florida,Miami-Dade County,2,7,173645,86692,86953
50,12,86,Florida,Miami-Dade County,2,8,192109,95294,96815
50,12,86,Florida,Miami-Dade County,2,9,171398,83290,88108
50,12,86,Florida,Miami-Dade County,2,10,152088,72503,79585
50,12,86,Florida,Miami-Dade County,2,11,133606,63576,70030
50,12,86,Florida,Miami-Dade County,2,12,110142,52085,58057
50,12,86,Florida,Miami-Dade County,2,13,98075,45335,52740
50,12,86,Florida,Miami-Dade County,2,14,84419,38207,46212
50,12,86,Florida,Miami-Dade County,2,15,77894,34011,43883
50,12,86,Florida,Miami-Dade County,2,16,60134,24539,35595
50,12,86,Florida,Miami-Dade County,2,17,40287,14835,25452
50,12,86,Florida,Miami-Dade County,2,18,38512,11752,26760
50,12,86,Florida,Miami-Dade County,2,99,2259508,1091570,1167938
50,12,86,Florida,Miami-Dade County,3,0,32929,16967,15962
50,12,86,Florida,Miami-Dade County,3,1,115078,59023,56055
50,12,86,Florida,Miami-Dade County,3,2,152233,77864,74369
50,12,86,Florida,Miami-Dade County,3,3,164581,83736,80845
50,12,86,Florida,Miami-Dade County,3,4,158187,80685,77502
50,12,86,Florida,Miami-Dade County,3,5,149566,74549,75017
50,12,86,Florida,Miami-Dade County,3,6,160799,79865,80934
50,12,86,Florida,Miami-Dade County,3,7,172061,85450,86611
50,12,86,Florida,Miami-Dade County,3,8,193521,95950,97571
50,12,86,Florida,Miami-Dade County,3,9,176573,86021,90552
50,12,86,Florida,Miami-Dade County,3,10,156448,74902,81546
50,12,86,Florida,Miami-Dade County,3,11,138067,65457,72610
50,12,86,Florida,Miami-Dade County,3,12,112891,53255,59636
50,12,86,Florida,Miami-Dade County,3,13,99851,46303,53548
50,12,86,Florida,Miami-Dade County,3,14,85577,38450,47127
50,12,86,Florida,Miami-Dade County,3,15,78964,34669,44295
50,12,86,Florida,Miami-Dade County,3,16,60979,25146,35833
50,12,86,Florida,Miami-Dade County,3,17,41305,15324,25981
50,12,86,Florida,Miami-Dade County,3,18,37848,11432,26416
50,12,86,Florida,Miami-Dade County,3,99,2287458,1105048,1182410
50,12,86,Florida,Miami-Dade County,4,0,32284,16511,15773
50,12,86,Florida,Miami-Dade County,4,1,118232,60556,57676
50,12,86,Florida,Miami-Dade County,4,2,148902,76117,72785
50,12,86,Florida,Miami-Dade County,4,3,166356,84656,81700
50,12,86,Florida,Miami-Dade County,4,4,160544,82106,78438
50,12,86,Florida,Miami-Dade County,4,5,154132,76992,77140
50,12,86,Florida,Miami-Dade County,4,6,159199,78543,80656
50,12,86,Florida,Miami-Dade County,4,7,172379,85340,87039
50,12,86,Florida,Miami-Dade County,4,8,192489,94981,97508
50,12,86,Florida,Miami-Dade County,4,9,181816,88844,92972
50,12,86,Florida,Miami-Dade County,4,10,161325,77466,83859
50,12,86,Florida,Miami-Dade County,4,11,140754,66666,74088
50,12,86,Florida,Miami-Dade County,4,12,118617,56216,62401
50,12,86,Florida,Miami-Dade County,4,13,100851,46560,54291
50,12,86,Florida,Miami-Dade County,4,14,87353,39089,48264
50,12,86,Florida,Miami-Dade County,4,15,78289,34566,43723
50,12,86,Florida,Miami-Dade County,4,16,62492,25916,36576
50,12,86,Florida,Miami-Dade County,4,17,42458,15869,26589
50,12,86,Florida,Miami-Dade County,4,18,37275,11299,25976
50,12,86,Florida,Miami-Dade County,4,99,2315747,1118293,1197454
50,12,86,Florida,Miami-Dade County,5,0,32115,16492,15623
50,12,86,Florida,Miami-Dade County,5,1,119961,61521,58440
50,12,86,Florida,Miami-Dade County,5,2,144968,73923,71045
50,12,86,Florida,Miami-Dade County,5,3,165813,84610,81203
50,12,86,Florida,Miami-Dade County,5,4,162840,83308,79532
50,12,86,Florida,Miami-Dade County,5,5,159013,80084,78929
50,12,86,Florida,Miami-Dade County,5,6,158050,77773,80277
50,12,86,Florida,Miami-Dade County,5,7,172846,85647,87199
50,12,86,Florida,Miami-Dade County,5,8,188132,92901,95231
50,12,86,Florida,Miami-Dade County,5,9,187186,91352,95834
50,12,86,Florida,Miami-Dade County,5,10,164786,79445,85341
50,12,86,Florida,Miami-Dade County,5,11,143985,68091,75894
50,12,86,Florida,Miami-Dade County,5,12,121675,57492,64183
50,12,86,Florida,Miami-Dade County,5,13,103289,47753,55536
50,12,86,Florida,Miami-Dade County,5,14,89133,39994,49139
50,12,86,Florida,Miami-Dade County,5,15,78282,34613,43669
50,12,86,Florida,Miami-Dade County,5,16,63460,26185,37275
50,12,86,Florida,Miami-Dade County,5,17,43200,16444,26756
50,12,86,Florida,Miami-Dade County,5,18,37336,11341,25995
50,12,86,Florida,Miami-Dade County,5,99,2336070,1128969,1207101
50,12,86,Florida,Miami-Dade County,6,0,31383,15923,15460
50,12,86,Florida,Miami-Dade County,6,1,122743,63038,59705
50,12,86,Florida,Miami-Dade County,6,2,141069,72152,68917
50,12,86,Florida,Miami-Dade County,6,3,164598,83890,80708
50,12,86,Florida,Miami-Dade County,6,4,164962,84328,80634
50,12,86,Florida,Miami-Dade County,6,5,164050,82630,81420
50,12,86,Florida,Miami-Dade County,6,6,158578,78239,80339
50,12,86,Florida,Miami-Dade County,6,7,172523,85271,87252
50,12,86,Florida,Miami-Dade County,6,8,183649,90518,93131
50,12,86,Florida,Miami-Dade County,6,9,192881,94704,98177
50,12,86,Florida,Miami-Dade County,6,10,168737,81359,87378
50,12,86,Florida,Miami-Dade County,6,11,148074,70153,77921
50,12,86,Florida,Miami-Dade County,6,12,125481,59206,66275
50,12,86,Florida,Miami-Dade County,6,13,104979,48447,56532
50,12,86,Florida,Miami-Dade County,6,14,91320,41046,50274
50,12,86,Florida,Miami-Dade County,6,15,76988,33960,43028
50,12,86,Florida,Miami-Dade County,6,16,64869,26759,38110
50,12,86,Florida,Miami-Dade County,6,17,44298,16933,27365
50,12,86,Florida,Miami-Dade County,6,18,37502,11611,25891
50,12,86,Florida,Miami-Dade County,6,99,2358684,1140167,1218517
50,12,86,Florida,Miami-Dade County,7,0,31124,15961,15163
50,12,86,Florida,Miami-Dade County,7,1,124672,63570,61102
50,12,86,Florida,Miami-Dade County,7,2,138394,70988,67406
50,12,86,Florida,Miami-Dade County,7,3,160987,82096,78891
50,12,86,Florida,Miami-Dade County,7,4,168419,86054,82365
50,12,86,Florida,Miami-Dade County,7,5,166805,84195,82610
50,12,86,Florida,Miami-Dade County,7,6,161520,80094,81426
50,12,86,Florida,Miami-Dade County,7,7,171018,84374,86644
50,12,86,Florida,Miami-Dade County,7,8,180949,89270,91679
50,12,86,Florida,Miami-Dade County,7,9,195943,96521,99422
50,12,86,Florida,Miami-Dade County,7,10,173255,83751,89504
50,12,86,Florida,Miami-Dade County,7,11,151792,71957,79835
50,12,86,Florida,Miami-Dade County,7,12,130797,61639,69158
50,12,86,Florida,Miami-Dade County,7,13,106284,49110,57174
50,12,86,Florida,Miami-Dade County,7,14,94594,42511,52083
50,12,86,Florida,Miami-Dade County,7,15,77695,33978,43717
50,12,86,Florida,Miami-Dade County,7,16,66809,27815,38994
50,12,86,Florida,Miami-Dade County,7,17,45900,17689,28211
50,12,86,Florida,Miami-Dade County,7,18,38915,12112,26803
50,12,86,Florida,Miami-Dade County,7,99,2385872,1153685,1232187
50,12,86,Florida,Miami-Dade County,8,0,31522,16097,15425
50,12,86,Florida,Miami-Dade County,8,1,122710,62460,60250
50,12,86,Florida,Miami-Dade County,8,2,139075,71363,67712
50,12,86,Florida,Miami-Dade County,8,3,158103,80785,77318
50,12,86,Florida,Miami-Dade County,8,4,170666,87047,83619
50,12,86,Florida,Miami-Dade County,8,5,170190,86106,84084
50,12,86,Florida,Miami-Dade County,8,6,164917,81697,83220
50,12,86,Florida,Miami-Dade County,8,7,169019,83234,85785
50,12,86,Florida,Miami-Dade County,8,8,179170,88303,90867
50,12,86,Florida,Miami-Dade County,8,9,197708,97768,99940
50,12,86,Florida,Miami-Dade County,8,10,178071,86264,91807
50,12,86,Florida,Miami-Dade County,8,11,155111,73632,81479
50,12,86,Florida,Miami-Dade County,8,12,134996,63342,71654
50,12,86,Florida,Miami-Dade County,8,13,108686,50062,58624
50,12,86,Florida,Miami-Dade County,8,14,94864,42775,52089
50,12,86,Florida,Miami-Dade County,8,15,77755,33690,44065
50,12,86,Florida,Miami-Dade County,8,16,67335,28147,39188
50,12,86,Florida,Miami-Dade County,8,17,46267,17874,28393
50,12,86,Florida,Miami-Dade County,8,18,39746,12505,27241
50,12,86,Florida,Miami-Dade County,8,99,2405911,1163151,1242760
50,12,86,Florida,Miami-Dade County,9,0,31526,16006,15520
50,12,86,Florida,Miami-Dade County,9,1,121531,61973,59558
50,12,86,Florida,Miami-Dade County,9,2,138169,70829,67340
50,12,86,Florida,Miami-Dade County,9,3,154904,79091,75813
50,12,86,Florida,Miami-Dade County,9,4,170938,87216,83722
50,12,86,Florida,Miami-Dade County,9,5,171583,87216,84367
50,12,86,Florida,Miami-Dade County,9,6,166045,82264,83781
50,12,86,Florida,Miami-Dade County,9,7,165707,81553,84154
50,12,86,Florida,Miami-Dade County,9,8,178800,88297,90503
50,12,86,Florida,Miami-Dade County,9,9,195495,96855,98640
50,12,86,Florida,Miami-Dade County,9,10,182118,88651,93467
50,12,86,Florida,Miami-Dade County,9,11,158176,75280,82896
50,12,86,Florida,Miami-Dade County,9,12,137019,64109,72910
50,12,86,Florida,Miami-Dade County,9,13,112925,52276,60649
50,12,86,Florida,Miami-Dade County,9,14,94953,42633,52320
50,12,86,Florida,Miami-Dade County,9,15,79557,34386,45171
50,12,86,Florida,Miami-Dade County,9,16,67181,28327,38854
50,12,86,Florida,Miami-Dade County,9,17,47939,18712,29227
50,12,86,Florida,Miami-Dade County,9,18,41010,13033,27977
50,12,86,Florida,Miami-Dade County,9,99,2415576,1168707,1246869
50,12,86,Florida,Miami-Dade County,10,0,31241,15862,15379
50,12,86,Florida,Miami-Dade County,10,1,119397,60937,58460
50,12,86,Florida,Miami-Dade County,10,2,141045,72352,68693
50,12,86,Florida,Miami-Dade County,10,3,152876,77853,75023
50,12,86,Florida,Miami-Dade County,10,4,170190,86960,83230
50,12,86,Florida,Miami-Dade County,10,5,172813,87393,85420
50,12,86,Florida,Miami-Dade County,10,6,167489,83251,84238
50,12,86,Florida,Miami-Dade County,10,7,164647,80670,83977
50,12,86,Florida,Miami-Dade County,10,8,181296,89912,91384
50,12,86,Florida,Miami-Dade County,10,9,191802,95468,96334
50,12,86,Florida,Miami-Dade County,10,10,188338,91782,96556
50,12,86,Florida,Miami-Dade County,10,11,160909,76482,84427
50,12,86,Florida,Miami-Dade County,10,12,140336,65519,74817
50,12,86,Florida,Miami-Dade County,10,13,116155,53772,62383
50,12,86,Florida,Miami-Dade County,10,14,97062,43601,53461
50,12,86,Florida,Miami-Dade County,10,15,81376,35188,46188
50,12,86,Florida,Miami-Dade County,10,16,67335,28426,38909
50,12,86,Florida,Miami-Dade County,10,17,49359,19116,30243
50,12,86,Florida,Miami-Dade County,10,18,42396,13617,28779
50,12,86,Florida,Miami-Dade County,10,99,2436062,1178161,1257901
50,12,86,Florida,Miami-Dade County,11,0,30143,15254,14889
50,12,86,Florida,Miami-Dade County,11,1,119938,61298,58640
50,12,86,Florida,Miami-Dade County,11,2,142873,73136,69737
50,12,86,Florida,Miami-Dade County,11,3,151875,77536,74339
50,12,86,Florida,Miami-Dade County,11,4,168895,86194,82701
50,12,86,Florida,Miami-Dade County,11,5,173907,87744,86163
50,12,86,Florida,Miami-Dade County,11,6,170517,84356,86161
50,12,86,Florida,Miami-Dade County,11,7,164891,81090,83801
50,12,86,Florida,Miami-Dade County,11,8,183535,91227,92308
50,12,86,Florida,Miami-Dade County,11,9,188353,94029,94324
50,12,86,Florida,Miami-Dade County,11,10,194424,95291,99133
50,12,86,Florida,Miami-Dade County,11,11,164337,78097,86240
50,12,86,Florida,Miami-Dade County,11,12,144521,67432,77089
50,12,86,Florida,Miami-Dade County,11,13,119893,55366,64527
50,12,86,Florida,Miami-Dade County,11,14,99691,44918,54773
50,12,86,Florida,Miami-Dade County,11,15,84168,36391,47777
50,12,86,Florida,Miami-Dade County,11,16,66844,28187,38657
50,12,86,Florida,Miami-Dade County,11,17,50970,19839,31131
50,12,86,Florida,Miami-Dade County,11,18,44168,14339,29829
50,12,86,Florida,Miami-Dade County,11,99,2463943,1191724,1272219
50,12,86,Florida,Miami-Dade County,12,0,29937,15111,14826
50,12,86,Florida,Miami-Dade County,12,1,120000,61333,58667
50,12,86,Florida,Miami-Dade County,12,2,145253,74318,70935
50,12,86,Florida,Miami-Dade County,12,3,152541,77881,74660
50,12,86,Florida,Miami-Dade County,12,4,168514,86094,82420
50,12,86,Florida,Miami-Dade County,12,5,176823,89112,87711
50,12,86,Florida,Miami-Dade County,12,6,172129,85029,87100
50,12,86,Florida,Miami-Dade County,12,7,168338,82917,85421
50,12,86,Florida,Miami-Dade County,12,8,184733,91993,92740
50,12,86,Florida,Miami-Dade County,12,9,187664,94001,93663
50,12,86,Florida,Miami-Dade County,12,10,198253,97586,100667
50,12,86,Florida,Miami-Dade County,12,11,168364,80358,88006
50,12,86,Florida,Miami-Dade County,12,12,147653,68881,78772
50,12,86,Florida,Miami-Dade County,12,13,124220,57326,66894
50,12,86,Florida,Miami-Dade County,12,14,100980,45532,55448
50,12,86,Florida,Miami-Dade County,12,15,85996,37255,48741
50,12,86,Florida,Miami-Dade County,12,16,67140,28169,38971
50,12,86,Florida,Miami-Dade County,12,17,52031,20462,31569
50,12,86,Florida,Miami-Dade County,12,18,45866,15006,30860
50,12,86,Florida,Miami-Dade County,12,99,2496435,1208364,1288071
50,12,86,Florida,Miami-Dade County,13,0,29962,15132,14830
50,12,86,Florida,Miami-Dade County,13,1,119945,61301,58644
50,12,86,Florida,Miami-Dade County,13,2,145669,74522,71147
50,12,86,Florida,Miami-Dade County,13,3,152815,78015,74800
50,12,86,Florida,Miami-Dade County,13,4,168123,85914,82209
50,12,86,Florida,Miami-Dade County,13,5,177679,89566,88113
50,12,86,Florida,Miami-Dade County,13,6,172136,85117,87019
50,12,86,Florida,Miami-Dade County,13,7,168976,83301,85675
50,12,86,Florida,Miami-Dade County,13,8,184668,92002,92666
50,12,86,Florida,Miami-Dade County,13,9,188133,94288,93845
50,12,86,Florida,Miami-Dade County,13,10,198591,97794,100797
50,12,86,Florida,Miami-Dade County,13,11,169513,80932,88581
50,12,86,Florida,Miami-Dade County,13,12,148668,69398,79270
50,12,86,Florida,Miami-Dade County,13,13,125659,58005,67654
50,12,86,Florida,Miami-Dade County,13,14,101796,45954,55842
50,12,86,Florida,Miami-Dade County,13,15,86561,37553,49008
50,12,86,Florida,Miami-Dade County,13,16,67408,28299,39109
50,12,86,Florida,Miami-Dade County,13,17,52467,20683,31784
50,12,86,Florida,Miami-Dade County,13,18,46610,15273,31337
50,12,86,Florida,Miami-Dade County,13,99,2505379,1213049,1292330
50,12,87,Florida,Monroe County,1,0,725,375,350
50,12,87,Florida,Monroe County,1,1,2737,1438,1299
50,12,87,Florida,Monroe County,1,2,3802,1982,1820
50,12,87,Florida,Monroe County,1,3,4003,2067,1936
50,12,87,Florida,Monroe County,1,4,3699,1972,1727
50,12,87,Florida,Monroe County,1,5,3637,2017,1620
50,12,87,Florida,Monroe County,1,6,4655,2517,2138
50,12,87,Florida,Monroe County,1,7,5605,3023,2582
50,12,87,Florida,Monroe County,1,8,6937,3712,3225
50,12,87,Florida,Monroe County,1,9,7558,3947,3611
50,12,87,Florida,Monroe County,1,10,7498,4021,3477
50,12,87,Florida,Monroe County,1,11,7154,3938,3216
50,12,87,Florida,Monroe County,1,12,5597,3093,2504
50,12,87,Florida,Monroe County,1,13,4337,2413,1924
50,12,87,Florida,Monroe County,1,14,3577,1926,1651
50,12,87,Florida,Monroe County,1,15,3204,1714,1490
50,12,87,Florida,Monroe County,1,16,2421,1179,1242
50,12,87,Florida,Monroe County,1,17,1480,678,802
50,12,87,Florida,Monroe County,1,18,976,375,601
50,12,87,Florida,Monroe County,1,99,79602,42387,37215
50,12,87,Florida,Monroe County,2,0,728,376,352
50,12,87,Florida,Monroe County,2,1,2719,1430,1289
50,12,87,Florida,Monroe County,2,2,3770,1962,1808
50,12,87,Florida,Monroe County,2,3,3999,2065,1934
50,12,87,Florida,Monroe County,2,4,3691,1969,1722
50,12,87,Florida,Monroe County,2,5,3651,2026,1625
50,12,87,Florida,Monroe County,2,6,4618,2500,2118
50,12,87,Florida,Monroe County,2,7,5586,3016,2570
50,12,87,Florida,Monroe County,2,8,6898,3689,3209
50,12,87,Florida,Monroe County,2,9,7558,3948,3610
50,12,87,Florida,Monroe County,2,10,7507,4026,3481
50,12,87,Florida,Monroe County,2,11,7188,3959,3229
50,12,87,Florida,Monroe County,2,12,5610,3100,2510
50,12,87,Florida,Monroe County,2,13,4334,2413,1921
50,12,87,Florida,Monroe County,2,14,3552,1912,1640
50,12,87,Florida,Monroe County,2,15,3191,1709,1482
50,12,87,Florida,Monroe County,2,16,2409,1176,1233
50,12,87,Florida,Monroe County,2,17,1485,682,803
50,12,87,Florida,Monroe County,2,18,976,377,599
50,12,87,Florida,Monroe County,2,99,79470,42335,37135
50,12,87,Florida,Monroe County,3,0,744,354,390
50,12,87,Florida,Monroe County,3,1,2652,1432,1220
50,12,87,Florida,Monroe County,3,2,3671,1858,1813
50,12,87,Florida,Monroe County,3,3,3952,2065,1887
50,12,87,Florida,Monroe County,3,4,3642,1964,1678
50,12,87,Florida,Monroe County,3,5,3611,1980,1631
50,12,87,Florida,Monroe County,3,6,4491,2466,2025
50,12,87,Florida,Monroe County,3,7,5411,2909,2502
50,12,87,Florida,Monroe County,3,8,6703,3608,3095
50,12,87,Florida,Monroe County,3,9,7418,3871,3547
50,12,87,Florida,Monroe County,3,10,7513,3977,3536
50,12,87,Florida,Monroe County,3,11,7425,4068,3357
50,12,87,Florida,Monroe County,3,12,5768,3193,2575
50,12,87,Florida,Monroe County,3,13,4527,2511,2016
50,12,87,Florida,Monroe County,3,14,3503,1888,1615
50,12,87,Florida,Monroe County,3,15,3177,1721,1456
50,12,87,Florida,Monroe County,3,16,2330,1132,1198
50,12,87,Florida,Monroe County,3,17,1508,690,818
50,12,87,Florida,Monroe County,3,18,992,392,600
50,12,87,Florida,Monroe County,3,99,79038,42079,36959
50,12,87,Florida,Monroe County,4,0,691,345,346
50,12,87,Florida,Monroe County,4,1,2657,1386,1271
50,12,87,Florida,Monroe County,4,2,3564,1831,1733
50,12,87,Florida,Monroe County,4,3,3894,1977,1917
50,12,87,Florida,Monroe County,4,4,3711,2014,1697
50,12,87,Florida,Monroe County,4,5,3695,2019,1676
50,12,87,Florida,Monroe County,4,6,4357,2373,1984
50,12,87,Florida,Monroe County,4,7,5291,2829,2462
50,12,87,Florida,Monroe County,4,8,6339,3400,2939
50,12,87,Florida,Monroe County,4,9,7258,3775,3483
50,12,87,Florida,Monroe County,4,10,7551,3950,3601
50,12,87,Florida,Monroe County,4,11,7389,3979,3410
50,12,87,Florida,Monroe County,4,12,6213,3503,2710
50,12,87,Florida,Monroe County,4,13,4727,2590,2137
50,12,87,Florida,Monroe County,4,14,3493,1923,1570
50,12,87,Florida,Monroe County,4,15,3054,1651,1403
50,12,87,Florida,Monroe County,4,16,2288,1147,1141
50,12,87,Florida,Monroe County,4,17,1569,705,864
50,12,87,Florida,Monroe County,4,18,1014,411,603
50,12,87,Florida,Monroe County,4,99,78755,41808,36947
50,12,87,Florida,Monroe County,5,0,674,334,340
50,12,87,Florida,Monroe County,5,1,2657,1337,1320
50,12,87,Florida,Monroe County,5,2,3386,1748,1638
50,12,87,Florida,Monroe County,5,3,3910,2049,1861
50,12,87,Florida,Monroe County,5,4,3688,2001,1687
50,12,87,Florida,Monroe County,5,5,3811,2058,1753
50,12,87,Florida,Monroe County,5,6,4366,2398,1968
50,12,87,Florida,Monroe County,5,7,5168,2764,2404
50,12,87,Florida,Monroe County,5,8,6001,3201,2800
50,12,87,Florida,Monroe County,5,9,6986,3636,3350
50,12,87,Florida,Monroe County,5,10,7485,3919,3566
50,12,87,Florida,Monroe County,5,11,7472,4040,3432
50,12,87,Florida,Monroe County,5,12,6604,3701,2903
50,12,87,Florida,Monroe County,5,13,4849,2735,2114
50,12,87,Florida,Monroe County,5,14,3574,1924,1650
50,12,87,Florida,Monroe County,5,15,2954,1597,1357
50,12,87,Florida,Monroe County,5,16,2307,1199,1108
50,12,87,Florida,Monroe County,5,17,1551,682,869
50,12,87,Florida,Monroe County,5,18,1054,436,618
50,12,87,Florida,Monroe County,5,99,78497,41759,36738
50,12,87,Florida,Monroe County,6,0,695,373,322
50,12,87,Florida,Monroe County,6,1,2560,1275,1285
50,12,87,Florida,Monroe County,6,2,3192,1646,1546
50,12,87,Florida,Monroe County,6,3,3821,2016,1805
50,12,87,Florida,Monroe County,6,4,3661,1941,1720
50,12,87,Florida,Monroe County,6,5,3875,2124,1751
50,12,87,Florida,Monroe County,6,6,4381,2388,1993
50,12,87,Florida,Monroe County,6,7,4906,2650,2256
50,12,87,Florida,Monroe County,6,8,5718,3101,2617
50,12,87,Florida,Monroe County,6,9,6820,3533,3287
50,12,87,Florida,Monroe County,6,10,7378,3824,3554
50,12,87,Florida,Monroe County,6,11,7334,3933,3401
50,12,87,Florida,Monroe County,6,12,6793,3807,2986
50,12,87,Florida,Monroe County,6,13,5078,2869,2209
50,12,87,Florida,Monroe County,6,14,3664,2011,1653
50,12,87,Florida,Monroe County,6,15,2857,1526,1331
50,12,87,Florida,Monroe County,6,16,2282,1221,1061
50,12,87,Florida,Monroe County,6,17,1538,688,850
50,12,87,Florida,Monroe County,6,18,1063,418,645
50,12,87,Florida,Monroe County,6,99,77616,41344,36272
50,12,87,Florida,Monroe County,7,0,689,357,332
50,12,87,Florida,Monroe County,7,1,2426,1242,1184
50,12,87,Florida,Monroe County,7,2,2997,1513,1484
50,12,87,Florida,Monroe County,7,3,3529,1894,1635
50,12,87,Florida,Monroe County,7,4,3638,1931,1707
50,12,87,Florida,Monroe County,7,5,3906,2118,1788
50,12,87,Florida,Monroe County,7,6,4313,2329,1984
50,12,87,Florida,Monroe County,7,7,4506,2406,2100
50,12,87,Florida,Monroe County,7,8,5269,2855,2414
50,12,87,Florida,Monroe County,7,9,6493,3404,3089
50,12,87,Florida,Monroe County,7,10,7137,3647,3490
50,12,87,Florida,Monroe County,7,11,7393,3948,3445
50,12,87,Florida,Monroe County,7,12,6951,3851,3100
50,12,87,Florida,Monroe County,7,13,5273,2981,2292
50,12,87,Florida,Monroe County,7,14,3675,1990,1685
50,12,87,Florida,Monroe County,7,15,2806,1536,1270
50,12,87,Florida,Monroe County,7,16,2238,1202,1036
50,12,87,Florida,Monroe County,7,17,1514,680,834
50,12,87,Florida,Monroe County,7,18,1066,421,645
50,12,87,Florida,Monroe County,7,99,75819,40305,35514
50,12,87,Florida,Monroe County,8,0,652,347,305
50,12,87,Florida,Monroe County,8,1,2396,1223,1173
50,12,87,Florida,Monroe County,8,2,2912,1485,1427
50,12,87,Florida,Monroe County,8,3,3329,1730,1599
50,12,87,Florida,Monroe County,8,4,3521,1864,1657
50,12,87,Florida,Monroe County,8,5,3793,2088,1705
50,12,87,Florida,Monroe County,8,6,4396,2344,2052
50,12,87,Florida,Monroe County,8,7,4206,2281,1925
50,12,87,Florida,Monroe County,8,8,5150,2771,2379
50,12,87,Florida,Monroe County,8,9,6176,3263,2913
50,12,87,Florida,Monroe County,8,10,6771,3489,3282
50,12,87,Florida,Monroe County,8,11,7228,3842,3386
50,12,87,Florida,Monroe County,8,12,7056,3865,3191
50,12,87,Florida,Monroe County,8,13,5372,3051,2321
50,12,87,Florida,Monroe County,8,14,3611,1956,1655
50,12,87,Florida,Monroe County,8,15,2667,1488,1179
50,12,87,Florida,Monroe County,8,16,2031,1115,916
50,12,87,Florida,Monroe County,8,17,1473,658,815
50,12,87,Florida,Monroe County,8,18,1053,421,632
50,12,87,Florida,Monroe County,8,99,73793,39281,34512
50,12,87,Florida,Monroe County,9,0,665,346,319
50,12,87,Florida,Monroe County,9,1,2355,1221,1134
50,12,87,Florida,Monroe County,9,2,2814,1400,1414
50,12,87,Florida,Monroe County,9,3,3245,1683,1562
50,12,87,Florida,Monroe County,9,4,3470,1810,1660
50,12,87,Florida,Monroe County,9,5,3820,2107,1713
50,12,87,Florida,Monroe County,9,6,4431,2391,2040
50,12,87,Florida,Monroe County,9,7,4074,2253,1821
50,12,87,Florida,Monroe County,9,8,4971,2682,2289
50,12,87,Florida,Monroe County,9,9,5861,3109,2752
50,12,87,Florida,Monroe County,9,10,6523,3356,3167
50,12,87,Florida,Monroe County,9,11,7128,3776,3352
50,12,87,Florida,Monroe County,9,12,6841,3684,3157
50,12,87,Florida,Monroe County,9,13,5597,3203,2394
50,12,87,Florida,Monroe County,9,14,3853,2096,1757
50,12,87,Florida,Monroe County,9,15,2682,1487,1195
50,12,87,Florida,Monroe County,9,16,1972,1077,895
50,12,87,Florida,Monroe County,9,17,1483,693,790
50,12,87,Florida,Monroe County,9,18,1121,436,685
50,12,87,Florida,Monroe County,9,99,72906,38810,34096
50,12,87,Florida,Monroe County,10,0,654,347,307
50,12,87,Florida,Monroe County,10,1,2462,1286,1176
50,12,87,Florida,Monroe County,10,2,2795,1389,1406
50,12,87,Florida,Monroe County,10,3,3149,1641,1508
50,12,87,Florida,Monroe County,10,4,3400,1812,1588
50,12,87,Florida,Monroe County,10,5,3719,2056,1663
50,12,87,Florida,Monroe County,10,6,4539,2442,2097
50,12,87,Florida,Monroe County,10,7,4013,2225,1788
50,12,87,Florida,Monroe County,10,8,4893,2605,2288
50,12,87,Florida,Monroe County,10,9,5635,3053,2582
50,12,87,Florida,Monroe County,10,10,6305,3282,3023
50,12,87,Florida,Monroe County,10,11,6953,3663,3290
50,12,87,Florida,Monroe County,10,12,6745,3622,3123
50,12,87,Florida,Monroe County,10,13,5886,3315,2571
50,12,87,Florida,Monroe County,10,14,4159,2279,1880
50,12,87,Florida,Monroe County,10,15,2822,1556,1266
50,12,87,Florida,Monroe County,10,16,1994,1067,927
50,12,87,Florida,Monroe County,10,17,1530,766,764
50,12,87,Florida,Monroe County,10,18,1077,432,645
50,12,87,Florida,Monroe County,10,99,72730,38838,33892
50,12,87,Florida,Monroe County,11,0,629,326,303
50,12,87,Florida,Monroe County,11,1,2544,1311,1233
50,12,87,Florida,Monroe County,11,2,2792,1389,1403
50,12,87,Florida,Monroe County,11,3,2960,1553,1407
50,12,87,Florida,Monroe County,11,4,3385,1839,1546
50,12,87,Florida,Monroe County,11,5,3686,1987,1699
50,12,87,Florida,Monroe County,11,6,4643,2513,2130
50,12,87,Florida,Monroe County,11,7,4044,2218,1826
50,12,87,Florida,Monroe County,11,8,4624,2479,2145
50,12,87,Florida,Monroe County,11,9,5415,2947,2468
50,12,87,Florida,Monroe County,11,10,6335,3311,3024
50,12,87,Florida,Monroe County,11,11,6723,3524,3199
50,12,87,Florida,Monroe County,11,12,6685,3536,3149
50,12,87,Florida,Monroe County,11,13,6061,3414,2647
50,12,87,Florida,Monroe County,11,14,4408,2410,1998
50,12,87,Florida,Monroe County,11,15,3001,1675,1326
50,12,87,Florida,Monroe County,11,16,2023,1082,941
50,12,87,Florida,Monroe County,11,17,1543,777,766
50,12,87,Florida,Monroe County,11,18,1126,470,656
50,12,87,Florida,Monroe County,11,99,72627,38761,33866
50,12,87,Florida,Monroe County,12,0,634,330,304
50,12,87,Florida,Monroe County,12,1,2555,1309,1246
50,12,87,Florida,Monroe County,12,2,2858,1409,1449
50,12,87,Florida,Monroe County,12,3,2937,1539,1398
50,12,87,Florida,Monroe County,12,4,3260,1763,1497
50,12,87,Florida,Monroe County,12,5,3758,2043,1715
50,12,87,Florida,Monroe County,12,6,4687,2539,2148
50,12,87,Florida,Monroe County,12,7,4198,2262,1936
50,12,87,Florida,Monroe County,12,8,4578,2466,2112
50,12,87,Florida,Monroe County,12,9,5309,2861,2448
50,12,87,Florida,Monroe County,12,10,6211,3296,2915
50,12,87,Florida,Monroe County,12,11,6665,3471,3194
50,12,87,Florida,Monroe County,12,12,6744,3557,3187
50,12,87,Florida,Monroe County,12,13,6227,3463,2764
50,12,87,Florida,Monroe County,12,14,4617,2537,2080
50,12,87,Florida,Monroe County,12,15,3079,1737,1342
50,12,87,Florida,Monroe County,12,16,2024,1086,938
50,12,87,Florida,Monroe County,12,17,1585,790,795
50,12,87,Florida,Monroe County,12,18,1164,504,660
50,12,87,Florida,Monroe County,12,99,73090,38962,34128
50,12,87,Florida,Monroe County,13,0,638,332,306
50,12,87,Florida,Monroe County,13,1,2556,1311,1245
50,12,87,Florida,Monroe County,13,2,2866,1413,1453
50,12,87,Florida,Monroe County,13,3,2944,1537,1407
50,12,87,Florida,Monroe County,13,4,3260,1768,1492
50,12,87,Florida,Monroe County,13,5,3759,2041,1718
50,12,87,Florida,Monroe County,13,6,4697,2547,2150
50,12,87,Florida,Monroe County,13,7,4223,2274,1949
50,12,87,Florida,Monroe County,13,8,4557,2457,2100
50,12,87,Florida,Monroe County,13,9,5313,2861,2452
50,12,87,Florida,Monroe County,13,10,6188,3284,2904
50,12,87,Florida,Monroe County,13,11,6680,3476,3204
50,12,87,Florida,Monroe County,13,12,6779,3574,3205
50,12,87,Florida,Monroe County,13,13,6284,3495,2789
50,12,87,Florida,Monroe County,13,14,4643,2550,2093
50,12,87,Florida,Monroe County,13,15,3096,1748,1348
50,12,87,Florida,Monroe County,13,16,2026,1091,935
50,12,87,Florida,Monroe County,13,17,1586,793,793
50,12,87,Florida,Monroe County,13,18,1174,509,665
50,12,87,Florida,Monroe County,13,99,73269,39061,34208
50,12,89,Florida,Nassau County,1,0,686,347,339
50,12,89,Florida,Nassau County,1,1,2878,1449,1429
50,12,89,Florida,Nassau County,1,2,3906,2016,1890
50,12,89,Florida,Nassau County,1,3,4435,2273,2162
50,12,89,Florida,Nassau County,1,4,3817,2016,1801
50,12,89,Florida,Nassau County,1,5,2858,1445,1413
50,12,89,Florida,Nassau County,1,6,3271,1614,1657
50,12,89,Florida,Nassau County,1,7,3819,1861,1958
50,12,89,Florida,Nassau County,1,8,4737,2301,2436
50,12,89,Florida,Nassau County,1,9,4796,2371,2425
50,12,89,Florida,Nassau County,1,10,4467,2226,2241
50,12,89,Florida,Nassau County,1,11,4196,2039,2157
50,12,89,Florida,Nassau County,1,12,3579,1718,1861
50,12,89,Florida,Nassau County,1,13,2937,1474,1463
50,12,89,Florida,Nassau County,1,14,2497,1273,1224
50,12,89,Florida,Nassau County,1,15,2072,955,1117
50,12,89,Florida,Nassau County,1,16,1355,597,758
50,12,89,Florida,Nassau County,1,17,795,303,492
50,12,89,Florida,Nassau County,1,18,544,157,387
50,12,89,Florida,Nassau County,1,99,57645,28435,29210
50,12,89,Florida,Nassau County,2,0,693,350,343
50,12,89,Florida,Nassau County,2,1,2871,1446,1425
50,12,89,Florida,Nassau County,2,2,3899,2012,1887
50,12,89,Florida,Nassau County,2,3,4466,2287,2179
50,12,89,Florida,Nassau County,2,4,3842,2029,1813
50,12,89,Florida,Nassau County,2,5,2895,1467,1428
50,12,89,Florida,Nassau County,2,6,3245,1601,1644
50,12,89,Florida,Nassau County,2,7,3825,1865,1960
50,12,89,Florida,Nassau County,2,8,4731,2300,2431
50,12,89,Florida,Nassau County,2,9,4816,2378,2438
50,12,89,Florida,Nassau County,2,10,4506,2243,2263
50,12,89,Florida,Nassau County,2,11,4256,2070,2186
50,12,89,Florida,Nassau County,2,12,3612,1736,1876
50,12,89,Florida,Nassau County,2,13,2956,1484,1472
50,12,89,Florida,Nassau County,2,14,2520,1285,1235
50,12,89,Florida,Nassau County,2,15,2093,966,1127
50,12,89,Florida,Nassau County,2,16,1372,605,767
50,12,89,Florida,Nassau County,2,17,809,310,499
50,12,89,Florida,Nassau County,2,18,550,159,391
50,12,89,Florida,Nassau County,2,99,57957,28593,29364
50,12,89,Florida,Nassau County,3,0,725,384,341
50,12,89,Florida,Nassau County,3,1,2850,1456,1394
50,12,89,Florida,Nassau County,3,2,3967,2065,1902
50,12,89,Florida,Nassau County,3,3,4463,2273,2190
50,12,89,Florida,Nassau County,3,4,3985,2085,1900
50,12,89,Florida,Nassau County,3,5,3047,1545,1502
50,12,89,Florida,Nassau County,3,6,3150,1542,1608
50,12,89,Florida,Nassau County,3,7,3738,1851,1887
50,12,89,Florida,Nassau County,3,8,4697,2251,2446
50,12,89,Florida,Nassau County,3,9,4912,2468,2444
50,12,89,Florida,Nassau County,3,10,4620,2252,2368
50,12,89,Florida,Nassau County,3,11,4394,2137,2257
50,12,89,Florida,Nassau County,3,12,3830,1840,1990
50,12,89,Florida,Nassau County,3,13,3168,1596,1572
50,12,89,Florida,Nassau County,3,14,2584,1285,1299
50,12,89,Florida,Nassau County,3,15,2228,1063,1165
50,12,89,Florida,Nassau County,3,16,1462,626,836
50,12,89,Florida,Nassau County,3,17,887,352,535
50,12,89,Florida,Nassau County,3,18,593,190,403
50,12,89,Florida,Nassau County,3,99,59300,29261,30039
50,12,89,Florida,Nassau County,4,0,709,359,350
50,12,89,Florida,Nassau County,4,1,2917,1535,1382
50,12,89,Florida,Nassau County,4,2,3936,2011,1925
50,12,89,Florida,Nassau County,4,3,4595,2365,2230
50,12,89,Florida,Nassau County,4,4,4173,2158,2015
50,12,89,Florida,Nassau County,4,5,3078,1572,1506
50,12,89,Florida,Nassau County,4,6,3064,1502,1562
50,12,89,Florida,Nassau County,4,7,3847,1903,1944
50,12,89,Florida,Nassau County,4,8,4586,2204,2382
50,12,89,Florida,Nassau County,4,9,4995,2491,2504
50,12,89,Florida,Nassau County,4,10,4794,2341,2453
50,12,89,Florida,Nassau County,4,11,4457,2149,2308
50,12,89,Florida,Nassau County,4,12,4251,2099,2152
50,12,89,Florida,Nassau County,4,13,3360,1666,1694
50,12,89,Florida,Nassau County,4,14,2728,1353,1375
50,12,89,Florida,Nassau County,4,15,2234,1062,1172
50,12,89,Florida,Nassau County,4,16,1525,673,852
50,12,89,Florida,Nassau County,4,17,933,358,575
50,12,89,Florida,Nassau County,4,18,634,210,424
50,12,89,Florida,Nassau County,4,99,60816,30011,30805
50,12,89,Florida,Nassau County,5,0,689,341,348
50,12,89,Florida,Nassau County,5,1,2929,1544,1385
50,12,89,Florida,Nassau County,5,2,3902,1970,1932
50,12,89,Florida,Nassau County,5,3,4565,2328,2237
50,12,89,Florida,Nassau County,5,4,4329,2278,2051
50,12,89,Florida,Nassau County,5,5,3203,1645,1558
50,12,89,Florida,Nassau County,5,6,3126,1505,1621
50,12,89,Florida,Nassau County,5,7,3743,1851,1892
50,12,89,Florida,Nassau County,5,8,4500,2147,2353
50,12,89,Florida,Nassau County,5,9,5123,2555,2568
50,12,89,Florida,Nassau County,5,10,4935,2419,2516
50,12,89,Florida,Nassau County,5,11,4520,2177,2343
50,12,89,Florida,Nassau County,5,12,4453,2184,2269
50,12,89,Florida,Nassau County,5,13,3588,1767,1821
50,12,89,Florida,Nassau County,5,14,2913,1471,1442
50,12,89,Florida,Nassau County,5,15,2264,1088,1176
50,12,89,Florida,Nassau County,5,16,1611,713,898
50,12,89,Florida,Nassau County,5,17,1022,403,619
50,12,89,Florida,Nassau County,5,18,654,200,454
50,12,89,Florida,Nassau County,5,99,62069,30586,31483
50,12,89,Florida,Nassau County,6,0,741,385,356
50,12,89,Florida,Nassau County,6,1,2896,1523,1373
50,12,89,Florida,Nassau County,6,2,4051,2046,2005
50,12,89,Florida,Nassau County,6,3,4507,2280,2227
50,12,89,Florida,Nassau County,6,4,4436,2312,2124
50,12,89,Florida,Nassau County,6,5,3397,1790,1607
50,12,89,Florida,Nassau County,6,6,3123,1517,1606
50,12,89,Florida,Nassau County,6,7,3731,1819,1912
50,12,89,Florida,Nassau County,6,8,4405,2108,2297
50,12,89,Florida,Nassau County,6,9,5194,2566,2628
50,12,89,Florida,Nassau County,6,10,5084,2517,2567
50,12,89,Florida,Nassau County,6,11,4784,2330,2454
50,12,89,Florida,Nassau County,6,12,4701,2294,2407
50,12,89,Florida,Nassau County,6,13,3837,1875,1962
50,12,89,Florida,Nassau County,6,14,3087,1576,1511
50,12,89,Florida,Nassau County,6,15,2289,1119,1170
50,12,89,Florida,Nassau County,6,16,1704,754,950
50,12,89,Florida,Nassau County,6,17,1060,440,620
50,12,89,Florida,Nassau County,6,18,672,216,456
50,12,89,Florida,Nassau County,6,99,63699,31467,32232
50,12,89,Florida,Nassau County,7,0,773,389,384
50,12,89,Florida,Nassau County,7,1,2929,1531,1398
50,12,89,Florida,Nassau County,7,2,4125,2101,2024
50,12,89,Florida,Nassau County,7,3,4487,2279,2208
50,12,89,Florida,Nassau County,7,4,4551,2370,2181
50,12,89,Florida,Nassau County,7,5,3401,1814,1587
50,12,89,Florida,Nassau County,7,6,3378,1615,1763
50,12,89,Florida,Nassau County,7,7,3695,1849,1846
50,12,89,Florida,Nassau County,7,8,4316,2086,2230
50,12,89,Florida,Nassau County,7,9,5325,2582,2743
50,12,89,Florida,Nassau County,7,10,5228,2593,2635
50,12,89,Florida,Nassau County,7,11,5038,2487,2551
50,12,89,Florida,Nassau County,7,12,4901,2394,2507
50,12,89,Florida,Nassau County,7,13,4148,1983,2165
50,12,89,Florida,Nassau County,7,14,3203,1619,1584
50,12,89,Florida,Nassau County,7,15,2451,1231,1220
50,12,89,Florida,Nassau County,7,16,1763,783,980
50,12,89,Florida,Nassau County,7,17,1091,460,631
50,12,89,Florida,Nassau County,7,18,765,261,504
50,12,89,Florida,Nassau County,7,99,65568,32427,33141
50,12,89,Florida,Nassau County,8,0,813,426,387
50,12,89,Florida,Nassau County,8,1,2923,1524,1399
50,12,89,Florida,Nassau County,8,2,4254,2177,2077
50,12,89,Florida,Nassau County,8,3,4575,2365,2210
50,12,89,Florida,Nassau County,8,4,4579,2374,2205
50,12,89,Florida,Nassau County,8,5,3465,1842,1623
50,12,89,Florida,Nassau County,8,6,3564,1702,1862
50,12,89,Florida,Nassau County,8,7,3719,1855,1864
50,12,89,Florida,Nassau County,8,8,4371,2147,2224
50,12,89,Florida,Nassau County,8,9,5474,2613,2861
50,12,89,Florida,Nassau County,8,10,5385,2716,2669
50,12,89,Florida,Nassau County,8,11,5313,2612,2701
50,12,89,Florida,Nassau County,8,12,5170,2485,2685
50,12,89,Florida,Nassau County,8,13,4392,2122,2270
50,12,89,Florida,Nassau County,8,14,3472,1775,1697
50,12,89,Florida,Nassau County,8,15,2516,1228,1288
50,12,89,Florida,Nassau County,8,16,1855,847,1008
50,12,89,Florida,Nassau County,8,17,1160,489,671
50,12,89,Florida,Nassau County,8,18,823,291,532
50,12,89,Florida,Nassau County,8,99,67823,33590,34233
50,12,89,Florida,Nassau County,9,0,805,420,385
50,12,89,Florida,Nassau County,9,1,3059,1592,1467
50,12,89,Florida,Nassau County,9,2,4285,2172,2113
50,12,89,Florida,Nassau County,9,3,4648,2345,2303
50,12,89,Florida,Nassau County,9,4,4704,2428,2276
50,12,89,Florida,Nassau County,9,5,3584,1928,1656
50,12,89,Florida,Nassau County,9,6,3664,1785,1879
50,12,89,Florida,Nassau County,9,7,3689,1839,1850
50,12,89,Florida,Nassau County,9,8,4672,2307,2365
50,12,89,Florida,Nassau County,9,9,5392,2575,2817
50,12,89,Florida,Nassau County,9,10,5504,2758,2746
50,12,89,Florida,Nassau County,9,11,5553,2748,2805
50,12,89,Florida,Nassau County,9,12,5192,2427,2765
50,12,89,Florida,Nassau County,9,13,4850,2391,2459
50,12,89,Florida,Nassau County,9,14,3668,1855,1813
50,12,89,Florida,Nassau County,9,15,2681,1304,1377
50,12,89,Florida,Nassau County,9,16,1902,875,1027
50,12,89,Florida,Nassau County,9,17,1226,520,706
50,12,89,Florida,Nassau County,9,18,891,310,581
50,12,89,Florida,Nassau County,9,99,69969,34579,35390
50,12,89,Florida,Nassau County,10,0,825,422,403
50,12,89,Florida,Nassau County,10,1,3230,1694,1536
50,12,89,Florida,Nassau County,10,2,4255,2158,2097
50,12,89,Florida,Nassau County,10,3,4667,2343,2324
50,12,89,Florida,Nassau County,10,4,4757,2412,2345
50,12,89,Florida,Nassau County,10,5,3672,1969,1703
50,12,89,Florida,Nassau County,10,6,3743,1828,1915
50,12,89,Florida,Nassau County,10,7,3777,1862,1915
50,12,89,Florida,Nassau County,10,8,4747,2334,2413
50,12,89,Florida,Nassau County,10,9,5217,2516,2701
50,12,89,Florida,Nassau County,10,10,5609,2801,2808
50,12,89,Florida,Nassau County,10,11,5715,2817,2898
50,12,89,Florida,Nassau County,10,12,5341,2478,2863
50,12,89,Florida,Nassau County,10,13,5151,2545,2606
50,12,89,Florida,Nassau County,10,14,3853,1942,1911
50,12,89,Florida,Nassau County,10,15,2800,1389,1411
50,12,89,Florida,Nassau County,10,16,1977,913,1064
50,12,89,Florida,Nassau County,10,17,1267,565,702
50,12,89,Florida,Nassau County,10,18,954,326,628
50,12,89,Florida,Nassau County,10,99,71557,35314,36243
50,12,89,Florida,Nassau County,11,0,855,426,429
50,12,89,Florida,Nassau County,11,1,3219,1710,1509
50,12,89,Florida,Nassau County,11,2,4261,2149,2112
50,12,89,Florida,Nassau County,11,3,4747,2386,2361
50,12,89,Florida,Nassau County,11,4,4679,2392,2287
50,12,89,Florida,Nassau County,11,5,3743,1977,1766
50,12,89,Florida,Nassau County,11,6,3851,1908,1943
50,12,89,Florida,Nassau County,11,7,3699,1807,1892
50,12,89,Florida,Nassau County,11,8,4700,2288,2412
50,12,89,Florida,Nassau County,11,9,5072,2464,2608
50,12,89,Florida,Nassau County,11,10,5683,2799,2884
50,12,89,Florida,Nassau County,11,11,5787,2862,2925
50,12,89,Florida,Nassau County,11,12,5534,2620,2914
50,12,89,Florida,Nassau County,11,13,5372,2594,2778
50,12,89,Florida,Nassau County,11,14,4157,2077,2080
50,12,89,Florida,Nassau County,11,15,2933,1467,1466
50,12,89,Florida,Nassau County,11,16,2020,932,1088
50,12,89,Florida,Nassau County,11,17,1325,592,733
50,12,89,Florida,Nassau County,11,18,1034,364,670
50,12,89,Florida,Nassau County,11,99,72671,35814,36857
50,12,89,Florida,Nassau County,12,0,797,398,399
50,12,89,Florida,Nassau County,12,1,3186,1701,1485
50,12,89,Florida,Nassau County,12,2,4325,2201,2124
50,12,89,Florida,Nassau County,12,3,4816,2429,2387
50,12,89,Florida,Nassau County,12,4,4628,2360,2268
50,12,89,Florida,Nassau County,12,5,3895,2034,1861
50,12,89,Florida,Nassau County,12,6,3803,1907,1896
50,12,89,Florida,Nassau County,12,7,3810,1837,1973
50,12,89,Florida,Nassau County,12,8,4580,2253,2327
50,12,89,Florida,Nassau County,12,9,4910,2385,2525
50,12,89,Florida,Nassau County,12,10,5710,2771,2939
50,12,89,Florida,Nassau County,12,11,5853,2900,2953
50,12,89,Florida,Nassau County,12,12,5614,2690,2924
50,12,89,Florida,Nassau County,12,13,5479,2619,2860
50,12,89,Florida,Nassau County,12,14,4355,2156,2199
50,12,89,Florida,Nassau County,12,15,3041,1535,1506
50,12,89,Florida,Nassau County,12,16,2117,989,1128
50,12,89,Florida,Nassau County,12,17,1362,610,752
50,12,89,Florida,Nassau County,12,18,1033,371,662
50,12,89,Florida,Nassau County,12,99,73314,36146,37168
50,12,89,Florida,Nassau County,13,0,799,399,400
50,12,89,Florida,Nassau County,13,1,3180,1697,1483
50,12,89,Florida,Nassau County,13,2,4330,2204,2126
50,12,89,Florida,Nassau County,13,3,4818,2426,2392
50,12,89,Florida,Nassau County,13,4,4607,2350,2257
50,12,89,Florida,Nassau County,13,5,3907,2037,1870
50,12,89,Florida,Nassau County,13,6,3823,1917,1906
50,12,89,Florida,Nassau County,13,7,3844,1849,1995
50,12,89,Florida,Nassau County,13,8,4554,2241,2313
50,12,89,Florida,Nassau County,13,9,4907,2387,2520
50,12,89,Florida,Nassau County,13,10,5687,2763,2924
50,12,89,Florida,Nassau County,13,11,5868,2906,2962
50,12,89,Florida,Nassau County,13,12,5653,2709,2944
50,12,89,Florida,Nassau County,13,13,5541,2647,2894
50,12,89,Florida,Nassau County,13,14,4382,2171,2211
50,12,89,Florida,Nassau County,13,15,3058,1544,1514
50,12,89,Florida,Nassau County,13,16,2114,992,1122
50,12,89,Florida,Nassau County,13,17,1360,610,750
50,12,89,Florida,Nassau County,13,18,1041,375,666
50,12,89,Florida,Nassau County,13,99,73473,36224,37249
50,12,91,Florida,Okaloosa County,1,0,2175,1152,1023
50,12,91,Florida,Okaloosa County,1,1,8669,4380,4289
50,12,91,Florida,Okaloosa County,1,2,11601,5927,5674
50,12,91,Florida,Okaloosa County,1,3,12225,6182,6043
50,12,91,Florida,Okaloosa County,1,4,12064,6306,5758
50,12,91,Florida,Okaloosa County,1,5,11829,6569,5260
50,12,91,Florida,Okaloosa County,1,6,11718,6338,5380
50,12,91,Florida,Okaloosa County,1,7,11960,6137,5823
50,12,91,Florida,Okaloosa County,1,8,15034,7931,7103
50,12,91,Florida,Okaloosa County,1,9,14323,7288,7035
50,12,91,Florida,Okaloosa County,1,10,11684,5788,5896
50,12,91,Florida,Okaloosa County,1,11,10632,5313,5319
50,12,91,Florida,Okaloosa County,1,12,8356,4122,4234
50,12,91,Florida,Okaloosa County,1,13,7582,3537,4045
50,12,91,Florida,Okaloosa County,1,14,7269,3597,3672
50,12,91,Florida,Okaloosa County,1,15,5381,2456,2925
50,12,91,Florida,Okaloosa County,1,16,4190,1748,2442
50,12,91,Florida,Okaloosa County,1,17,2258,977,1281
50,12,91,Florida,Okaloosa County,1,18,1570,421,1149
50,12,91,Florida,Okaloosa County,1,99,170520,86169,84351
50,12,91,Florida,Okaloosa County,2,0,2210,1172,1038
50,12,91,Florida,Okaloosa County,2,1,8692,4397,4295
50,12,91,Florida,Okaloosa County,2,2,11559,5919,5640
50,12,91,Florida,Okaloosa County,2,3,12287,6208,6079
50,12,91,Florida,Okaloosa County,2,4,12100,6331,5769
50,12,91,Florida,Okaloosa County,2,5,11928,6618,5310
50,12,91,Florida,Okaloosa County,2,6,11648,6303,5345
50,12,91,Florida,Okaloosa County,2,7,11977,6139,5838
50,12,91,Florida,Okaloosa County,2,8,14991,7911,7080
50,12,91,Florida,Okaloosa County,2,9,14377,7312,7065
50,12,91,Florida,Okaloosa County,2,10,11786,5842,5944
50,12,91,Florida,Okaloosa County,2,11,10757,5377,5380
50,12,91,Florida,Okaloosa County,2,12,8433,4156,4277
50,12,91,Florida,Okaloosa County,2,13,7615,3551,4064
50,12,91,Florida,Okaloosa County,2,14,7306,3612,3694
50,12,91,Florida,Okaloosa County,2,15,5418,2473,2945
50,12,91,Florida,Okaloosa County,2,16,4235,1768,2467
50,12,91,Florida,Okaloosa County,2,17,2297,993,1304
50,12,91,Florida,Okaloosa County,2,18,1584,428,1156
50,12,91,Florida,Okaloosa County,2,99,171200,86510,84690
50,12,91,Florida,Okaloosa County,3,0,2335,1207,1128
50,12,91,Florida,Okaloosa County,3,1,8517,4363,4154
50,12,91,Florida,Okaloosa County,3,2,11367,5857,5510
50,12,91,Florida,Okaloosa County,3,3,12344,6240,6104
50,12,91,Florida,Okaloosa County,3,4,12091,6470,5621
50,12,91,Florida,Okaloosa County,3,5,12537,6937,5600
50,12,91,Florida,Okaloosa County,3,6,11270,5980,5290
50,12,91,Florida,Okaloosa County,3,7,11820,6177,5643
50,12,91,Florida,Okaloosa County,3,8,14283,7413,6870
50,12,91,Florida,Okaloosa County,3,9,14707,7461,7246
50,12,91,Florida,Okaloosa County,3,10,12287,6148,6139
50,12,91,Florida,Okaloosa County,3,11,11307,5605,5702
50,12,91,Florida,Okaloosa County,3,12,8761,4275,4486
50,12,91,Florida,Okaloosa County,3,13,7546,3575,3971
50,12,91,Florida,Okaloosa County,3,14,7366,3528,3838
50,12,91,Florida,Okaloosa County,3,15,5688,2734,2954
50,12,91,Florida,Okaloosa County,3,16,4203,1712,2491
50,12,91,Florida,Okaloosa County,3,17,2484,1071,1413
50,12,91,Florida,Okaloosa County,3,18,1651,472,1179
50,12,91,Florida,Okaloosa County,3,99,172564,87225,85339
50,12,91,Florida,Okaloosa County,4,0,2357,1198,1159
50,12,91,Florida,Okaloosa County,4,1,8937,4561,4376
50,12,91,Florida,Okaloosa County,4,2,11324,5820,5504
50,12,91,Florida,Okaloosa County,4,3,12451,6404,6047
50,12,91,Florida,Okaloosa County,4,4,12467,6690,5777
50,12,91,Florida,Okaloosa County,4,5,13480,7412,6068
50,12,91,Florida,Okaloosa County,4,6,11382,6036,5346
50,12,91,Florida,Okaloosa County,4,7,11789,6138,5651
50,12,91,Florida,Okaloosa County,4,8,13537,6939,6598
50,12,91,Florida,Okaloosa County,4,9,14957,7569,7388
50,12,91,Florida,Okaloosa County,4,10,12887,6450,6437
50,12,91,Florida,Okaloosa County,4,11,11296,5566,5730
50,12,91,Florida,Okaloosa County,4,12,9609,4748,4861
50,12,91,Florida,Okaloosa County,4,13,7642,3632,4010
50,12,91,Florida,Okaloosa County,4,14,7489,3610,3879
50,12,91,Florida,Okaloosa County,4,15,5921,2854,3067
50,12,91,Florida,Okaloosa County,4,16,4213,1736,2477
50,12,91,Florida,Okaloosa County,4,17,2726,1149,1577
50,12,91,Florida,Okaloosa County,4,18,1793,545,1248
50,12,91,Florida,Okaloosa County,4,99,176257,89057,87200
50,12,91,Florida,Okaloosa County,5,0,2399,1205,1194
50,12,91,Florida,Okaloosa County,5,1,9120,4668,4452
50,12,91,Florida,Okaloosa County,5,2,11137,5731,5406
50,12,91,Florida,Okaloosa County,5,3,12430,6460,5970
50,12,91,Florida,Okaloosa County,5,4,12587,6726,5861
50,12,91,Florida,Okaloosa County,5,5,13781,7417,6364
50,12,91,Florida,Okaloosa County,5,6,11381,5909,5472
50,12,91,Florida,Okaloosa County,5,7,11479,5880,5599
50,12,91,Florida,Okaloosa County,5,8,12801,6468,6333
50,12,91,Florida,Okaloosa County,5,9,14917,7558,7359
50,12,91,Florida,Okaloosa County,5,10,13506,6726,6780
50,12,91,Florida,Okaloosa County,5,11,11336,5541,5795
50,12,91,Florida,Okaloosa County,5,12,10142,5039,5103
50,12,91,Florida,Okaloosa County,5,13,7916,3762,4154
50,12,91,Florida,Okaloosa County,5,14,7476,3573,3903
50,12,91,Florida,Okaloosa County,5,15,6188,3008,3180
50,12,91,Florida,Okaloosa County,5,16,4305,1799,2506
50,12,91,Florida,Okaloosa County,5,17,2852,1185,1667
50,12,91,Florida,Okaloosa County,5,18,1896,599,1297
50,12,91,Florida,Okaloosa County,5,99,177649,89254,88395
50,12,91,Florida,Okaloosa County,6,0,2461,1265,1196
50,12,91,Florida,Okaloosa County,6,1,9564,4953,4611
50,12,91,Florida,Okaloosa County,6,2,11063,5645,5418
50,12,91,Florida,Okaloosa County,6,3,12396,6374,6022
50,12,91,Florida,Okaloosa County,6,4,12878,6934,5944
50,12,91,Florida,Okaloosa County,6,5,15079,8393,6686
50,12,91,Florida,Okaloosa County,6,6,12298,6465,5833
50,12,91,Florida,Okaloosa County,6,7,11577,5999,5578
50,12,91,Florida,Okaloosa County,6,8,12217,6163,6054
50,12,91,Florida,Okaloosa County,6,9,15189,7681,7508
50,12,91,Florida,Okaloosa County,6,10,14090,7048,7042
50,12,91,Florida,Okaloosa County,6,11,11677,5729,5948
50,12,91,Florida,Okaloosa County,6,12,10592,5236,5356
50,12,91,Florida,Okaloosa County,6,13,8190,3978,4212
50,12,91,Florida,Okaloosa County,6,14,7557,3540,4017
50,12,91,Florida,Okaloosa County,6,15,6374,3119,3255
50,12,91,Florida,Okaloosa County,6,16,4379,1862,2517
50,12,91,Florida,Okaloosa County,6,17,2947,1192,1755
50,12,91,Florida,Okaloosa County,6,18,1978,671,1307
50,12,91,Florida,Okaloosa County,6,99,182506,92247,90259
50,12,91,Florida,Okaloosa County,7,0,2617,1296,1321
50,12,91,Florida,Okaloosa County,7,1,9660,5009,4651
50,12,91,Florida,Okaloosa County,7,2,10924,5600,5324
50,12,91,Florida,Okaloosa County,7,3,12249,6347,5902
50,12,91,Florida,Okaloosa County,7,4,12782,6745,6037
50,12,91,Florida,Okaloosa County,7,5,15336,8546,6790
50,12,91,Florida,Okaloosa County,7,6,12962,6753,6209
50,12,91,Florida,Okaloosa County,7,7,11345,5907,5438
50,12,91,Florida,Okaloosa County,7,8,11719,5820,5899
50,12,91,Florida,Okaloosa County,7,9,14975,7542,7433
50,12,91,Florida,Okaloosa County,7,10,14605,7318,7287
50,12,91,Florida,Okaloosa County,7,11,12049,5962,6087
50,12,91,Florida,Okaloosa County,7,12,11062,5403,5659
50,12,91,Florida,Okaloosa County,7,13,8450,4089,4361
50,12,91,Florida,Okaloosa County,7,14,7280,3371,3909
50,12,91,Florida,Okaloosa County,7,15,6483,3125,3358
50,12,91,Florida,Okaloosa County,7,16,4487,1985,2502
50,12,91,Florida,Okaloosa County,7,17,3024,1183,1841
50,12,91,Florida,Okaloosa County,7,18,2036,740,1296
50,12,91,Florida,Okaloosa County,7,99,184045,92741,91304
50,12,91,Florida,Okaloosa County,8,0,2561,1278,1283
50,12,91,Florida,Okaloosa County,8,1,9517,4958,4559
50,12,91,Florida,Okaloosa County,8,2,10954,5519,5435
50,12,91,Florida,Okaloosa County,8,3,11868,6178,5690
50,12,91,Florida,Okaloosa County,8,4,12793,6766,6027
50,12,91,Florida,Okaloosa County,8,5,15016,8449,6567
50,12,91,Florida,Okaloosa County,8,6,13667,7190,6477
50,12,91,Florida,Okaloosa County,8,7,11206,5886,5320
50,12,91,Florida,Okaloosa County,8,8,11520,5811,5709
50,12,91,Florida,Okaloosa County,8,9,14350,7191,7159
50,12,91,Florida,Okaloosa County,8,10,14998,7574,7424
50,12,91,Florida,Okaloosa County,8,11,12439,6172,6267
50,12,91,Florida,Okaloosa County,8,12,11444,5560,5884
50,12,91,Florida,Okaloosa County,8,13,8527,4077,4450
50,12,91,Florida,Okaloosa County,8,14,7010,3256,3754
50,12,91,Florida,Okaloosa County,8,15,6390,2998,3392
50,12,91,Florida,Okaloosa County,8,16,4657,2160,2497
50,12,91,Florida,Okaloosa County,8,17,3013,1129,1884
50,12,91,Florida,Okaloosa County,8,18,2141,787,1354
50,12,91,Florida,Okaloosa County,8,99,184071,92939,91132
50,12,91,Florida,Okaloosa County,9,0,2528,1244,1284
50,12,91,Florida,Okaloosa County,9,1,9492,4916,4576
50,12,91,Florida,Okaloosa County,9,2,10916,5478,5438
50,12,91,Florida,Okaloosa County,9,3,11451,5951,5500
50,12,91,Florida,Okaloosa County,9,4,12674,6784,5890
50,12,91,Florida,Okaloosa County,9,5,14516,8159,6357
50,12,91,Florida,Okaloosa County,9,6,13895,7260,6635
50,12,91,Florida,Okaloosa County,9,7,10866,5711,5155
50,12,91,Florida,Okaloosa County,9,8,11307,5648,5659
50,12,91,Florida,Okaloosa County,9,9,13468,6733,6735
50,12,91,Florida,Okaloosa County,9,10,15018,7622,7396
50,12,91,Florida,Okaloosa County,9,11,12801,6304,6497
50,12,91,Florida,Okaloosa County,9,12,11151,5359,5792
50,12,91,Florida,Okaloosa County,9,13,9100,4456,4644
50,12,91,Florida,Okaloosa County,9,14,6960,3209,3751
50,12,91,Florida,Okaloosa County,9,15,6468,3005,3463
50,12,91,Florida,Okaloosa County,9,16,4851,2278,2573
50,12,91,Florida,Okaloosa County,9,17,2942,1096,1846
50,12,91,Florida,Okaloosa County,9,18,2273,822,1451
50,12,91,Florida,Okaloosa County,9,99,182677,92035,90642
50,12,91,Florida,Okaloosa County,10,0,2393,1158,1235
50,12,91,Florida,Okaloosa County,10,1,9299,4743,4556
50,12,91,Florida,Okaloosa County,10,2,10849,5490,5359
50,12,91,Florida,Okaloosa County,10,3,11090,5689,5401
50,12,91,Florida,Okaloosa County,10,4,12507,6765,5742
50,12,91,Florida,Okaloosa County,10,5,14316,7998,6318
50,12,91,Florida,Okaloosa County,10,6,13991,7335,6656
50,12,91,Florida,Okaloosa County,10,7,10750,5621,5129
50,12,91,Florida,Okaloosa County,10,8,11079,5540,5539
50,12,91,Florida,Okaloosa County,10,9,12595,6272,6323
50,12,91,Florida,Okaloosa County,10,10,14935,7641,7294
50,12,91,Florida,Okaloosa County,10,11,13299,6524,6775
50,12,91,Florida,Okaloosa County,10,12,10932,5206,5726
50,12,91,Florida,Okaloosa County,10,13,9597,4708,4889
50,12,91,Florida,Okaloosa County,10,14,7161,3328,3833
50,12,91,Florida,Okaloosa County,10,15,6481,2966,3515
50,12,91,Florida,Okaloosa County,10,16,5041,2379,2662
50,12,91,Florida,Okaloosa County,10,17,3090,1172,1918
50,12,91,Florida,Okaloosa County,10,18,2347,836,1511
50,12,91,Florida,Okaloosa County,10,99,181752,91371,90381
50,12,91,Florida,Okaloosa County,11,0,2376,1193,1183
50,12,91,Florida,Okaloosa County,11,1,9419,4817,4602
50,12,91,Florida,Okaloosa County,11,2,10839,5478,5361
50,12,91,Florida,Okaloosa County,11,3,10836,5556,5280
50,12,91,Florida,Okaloosa County,11,4,12112,6487,5625
50,12,91,Florida,Okaloosa County,11,5,13869,7706,6163
50,12,91,Florida,Okaloosa County,11,6,14113,7469,6644
50,12,91,Florida,Okaloosa County,11,7,10933,5758,5175
50,12,91,Florida,Okaloosa County,11,8,10664,5357,5307
50,12,91,Florida,Okaloosa County,11,9,11728,5785,5943
50,12,91,Florida,Okaloosa County,11,10,14924,7594,7330
50,12,91,Florida,Okaloosa County,11,11,13719,6742,6977
50,12,91,Florida,Okaloosa County,11,12,11072,5280,5792
50,12,91,Florida,Okaloosa County,11,13,9813,4818,4995
50,12,91,Florida,Okaloosa County,11,14,7397,3503,3894
50,12,91,Florida,Okaloosa County,11,15,6465,2888,3577
50,12,91,Florida,Okaloosa County,11,16,5227,2442,2785
50,12,91,Florida,Okaloosa County,11,17,3154,1240,1914
50,12,91,Florida,Okaloosa County,11,18,2493,885,1608
50,12,91,Florida,Okaloosa County,11,99,181153,90998,90155
50,12,91,Florida,Okaloosa County,12,0,2396,1201,1195
50,12,91,Florida,Okaloosa County,12,1,9212,4693,4519
50,12,91,Florida,Okaloosa County,12,2,10881,5488,5393
50,12,91,Florida,Okaloosa County,12,3,10674,5523,5151
50,12,91,Florida,Okaloosa County,12,4,11942,6402,5540
50,12,91,Florida,Okaloosa County,12,5,13678,7549,6129
50,12,91,Florida,Okaloosa County,12,6,13772,7331,6441
50,12,91,Florida,Okaloosa County,12,7,11223,5875,5348
50,12,91,Florida,Okaloosa County,12,8,10384,5240,5144
50,12,91,Florida,Okaloosa County,12,9,11291,5544,5747
50,12,91,Florida,Okaloosa County,12,10,14781,7544,7237
50,12,91,Florida,Okaloosa County,12,11,13967,6899,7068
50,12,91,Florida,Okaloosa County,12,12,11345,5428,5917
50,12,91,Florida,Okaloosa County,12,13,10058,4913,5145
50,12,91,Florida,Okaloosa County,12,14,7684,3662,4022
50,12,91,Florida,Okaloosa County,12,15,6410,2838,3572
50,12,91,Florida,Okaloosa County,12,16,5304,2467,2837
50,12,91,Florida,Okaloosa County,12,17,3273,1342,1931
50,12,91,Florida,Okaloosa County,12,18,2547,904,1643
50,12,91,Florida,Okaloosa County,12,99,180822,90843,89979
50,12,91,Florida,Okaloosa County,13,0,2390,1195,1195
50,12,91,Florida,Okaloosa County,13,1,9157,4666,4491
50,12,91,Florida,Okaloosa County,13,2,10846,5473,5373
50,12,91,Florida,Okaloosa County,13,3,10667,5514,5153
50,12,91,Florida,Okaloosa County,13,4,11846,6355,5491
50,12,91,Florida,Okaloosa County,13,5,13672,7545,6127
50,12,91,Florida,Okaloosa County,13,6,13755,7333,6422
50,12,91,Florida,Okaloosa County,13,7,11270,5897,5373
50,12,91,Florida,Okaloosa County,13,8,10274,5193,5081
50,12,91,Florida,Okaloosa County,13,9,11273,5534,5739
50,12,91,Florida,Okaloosa County,13,10,14697,7500,7197
50,12,91,Florida,Okaloosa County,13,11,13991,6910,7081
50,12,91,Florida,Okaloosa County,13,12,11399,5452,5947
50,12,91,Florida,Okaloosa County,13,13,10151,4962,5189
50,12,91,Florida,Okaloosa County,13,14,7732,3687,4045
50,12,91,Florida,Okaloosa County,13,15,6451,2862,3589
50,12,91,Florida,Okaloosa County,13,16,5306,2475,2831
50,12,91,Florida,Okaloosa County,13,17,3287,1350,1937
50,12,91,Florida,Okaloosa County,13,18,2564,912,1652
50,12,91,Florida,Okaloosa County,13,99,180728,90815,89913
50,12,93,Florida,Okeechobee County,1,0,478,239,239
50,12,93,Florida,Okeechobee County,1,1,1774,946,828
50,12,93,Florida,Okeechobee County,1,2,2461,1267,1194
50,12,93,Florida,Okeechobee County,1,3,2585,1362,1223
50,12,93,Florida,Okeechobee County,1,4,2820,1698,1122
50,12,93,Florida,Okeechobee County,1,5,2326,1368,958
50,12,93,Florida,Okeechobee County,1,6,2287,1372,915
50,12,93,Florida,Okeechobee County,1,7,2325,1366,959
50,12,93,Florida,Okeechobee County,1,8,2586,1404,1182
50,12,93,Florida,Okeechobee County,1,9,2521,1381,1140
50,12,93,Florida,Okeechobee County,1,10,2101,1115,986
50,12,93,Florida,Okeechobee County,1,11,2027,1022,1005
50,12,93,Florida,Okeechobee County,1,12,1855,920,935
50,12,93,Florida,Okeechobee County,1,13,1883,934,949
50,12,93,Florida,Okeechobee County,1,14,1735,879,856
50,12,93,Florida,Okeechobee County,1,15,1676,834,842
50,12,93,Florida,Okeechobee County,1,16,1240,613,627
50,12,93,Florida,Okeechobee County,1,17,704,315,389
50,12,93,Florida,Okeechobee County,1,18,485,186,299
50,12,93,Florida,Okeechobee County,1,99,35869,19221,16648
50,12,93,Florida,Okeechobee County,2,0,484,242,242
50,12,93,Florida,Okeechobee County,2,1,1774,946,828
50,12,93,Florida,Okeechobee County,2,2,2447,1260,1187
50,12,93,Florida,Okeechobee County,2,3,2590,1365,1225
50,12,93,Florida,Okeechobee County,2,4,2825,1702,1123
50,12,93,Florida,Okeechobee County,2,5,2342,1381,961
50,12,93,Florida,Okeechobee County,2,6,2279,1373,906
50,12,93,Florida,Okeechobee County,2,7,2330,1374,956
50,12,93,Florida,Okeechobee County,2,8,2575,1402,1173
50,12,93,Florida,Okeechobee County,2,9,2521,1386,1135
50,12,93,Florida,Okeechobee County,2,10,2105,1119,986
50,12,93,Florida,Okeechobee County,2,11,2048,1039,1009
50,12,93,Florida,Okeechobee County,2,12,1861,923,938
50,12,93,Florida,Okeechobee County,2,13,1887,937,950
50,12,93,Florida,Okeechobee County,2,14,1735,880,855
50,12,93,Florida,Okeechobee County,2,15,1676,835,841
50,12,93,Florida,Okeechobee County,2,16,1240,613,627
50,12,93,Florida,Okeechobee County,2,17,708,316,392
50,12,93,Florida,Okeechobee County,2,18,490,188,302
50,12,93,Florida,Okeechobee County,2,99,35917,19281,16636
50,12,93,Florida,Okeechobee County,3,0,567,276,291
50,12,93,Florida,Okeechobee County,3,1,1861,968,893
50,12,93,Florida,Okeechobee County,3,2,2442,1262,1180
50,12,93,Florida,Okeechobee County,3,3,2555,1358,1197
50,12,93,Florida,Okeechobee County,3,4,2807,1649,1158
50,12,93,Florida,Okeechobee County,3,5,2427,1423,1004
50,12,93,Florida,Okeechobee County,3,6,2238,1341,897
50,12,93,Florida,Okeechobee County,3,7,2357,1395,962
50,12,93,Florida,Okeechobee County,3,8,2492,1350,1142
50,12,93,Florida,Okeechobee County,3,9,2522,1348,1174
50,12,93,Florida,Okeechobee County,3,10,2200,1172,1028
50,12,93,Florida,Okeechobee County,3,11,2095,1085,1010
50,12,93,Florida,Okeechobee County,3,12,1837,925,912
50,12,93,Florida,Okeechobee County,3,13,1986,990,996
50,12,93,Florida,Okeechobee County,3,14,1742,860,882
50,12,93,Florida,Okeechobee County,3,15,1670,840,830
50,12,93,Florida,Okeechobee County,3,16,1301,659,642
50,12,93,Florida,Okeechobee County,3,17,715,314,401
50,12,93,Florida,Okeechobee County,3,18,484,190,294
50,12,93,Florida,Okeechobee County,3,99,36298,19405,16893
50,12,93,Florida,Okeechobee County,4,0,551,282,269
50,12,93,Florida,Okeechobee County,4,1,1954,993,961
50,12,93,Florida,Okeechobee County,4,2,2341,1226,1115
50,12,93,Florida,Okeechobee County,4,3,2632,1376,1256
50,12,93,Florida,Okeechobee County,4,4,2807,1640,1167
50,12,93,Florida,Okeechobee County,4,5,2427,1421,1006
50,12,93,Florida,Okeechobee County,4,6,2245,1353,892
50,12,93,Florida,Okeechobee County,4,7,2392,1394,998
50,12,93,Florida,Okeechobee County,4,8,2489,1396,1093
50,12,93,Florida,Okeechobee County,4,9,2565,1373,1192
50,12,93,Florida,Okeechobee County,4,10,2273,1217,1056
50,12,93,Florida,Okeechobee County,4,11,2132,1105,1027
50,12,93,Florida,Okeechobee County,4,12,1990,1008,982
50,12,93,Florida,Okeechobee County,4,13,1967,958,1009
50,12,93,Florida,Okeechobee County,4,14,1747,863,884
50,12,93,Florida,Okeechobee County,4,15,1668,856,812
50,12,93,Florida,Okeechobee County,4,16,1362,716,646
50,12,93,Florida,Okeechobee County,4,17,744,333,411
50,12,93,Florida,Okeechobee County,4,18,490,184,306
50,12,93,Florida,Okeechobee County,4,99,36776,19694,17082
50,12,93,Florida,Okeechobee County,5,0,532,269,263
50,12,93,Florida,Okeechobee County,5,1,2000,1036,964
50,12,93,Florida,Okeechobee County,5,2,2285,1214,1071
50,12,93,Florida,Okeechobee County,5,3,2632,1356,1276
50,12,93,Florida,Okeechobee County,5,4,2820,1642,1178
50,12,93,Florida,Okeechobee County,5,5,2440,1456,984
50,12,93,Florida,Okeechobee County,5,6,2339,1385,954
50,12,93,Florida,Okeechobee County,5,7,2393,1353,1040
50,12,93,Florida,Okeechobee County,5,8,2448,1407,1041
50,12,93,Florida,Okeechobee County,5,9,2599,1398,1201
50,12,93,Florida,Okeechobee County,5,10,2335,1244,1091
50,12,93,Florida,Okeechobee County,5,11,2158,1125,1033
50,12,93,Florida,Okeechobee County,5,12,2052,1068,984
50,12,93,Florida,Okeechobee County,5,13,2017,951,1066
50,12,93,Florida,Okeechobee County,5,14,1813,906,907
50,12,93,Florida,Okeechobee County,5,15,1642,844,798
50,12,93,Florida,Okeechobee County,5,16,1434,750,684
50,12,93,Florida,Okeechobee County,5,17,780,357,423
50,12,93,Florida,Okeechobee County,5,18,505,185,320
50,12,93,Florida,Okeechobee County,5,99,37224,19946,17278
50,12,93,Florida,Okeechobee County,6,0,564,289,275
50,12,93,Florida,Okeechobee County,6,1,2131,1064,1067
50,12,93,Florida,Okeechobee County,6,2,2292,1205,1087
50,12,93,Florida,Okeechobee County,6,3,2706,1425,1281
50,12,93,Florida,Okeechobee County,6,4,2899,1675,1224
50,12,93,Florida,Okeechobee County,6,5,2530,1487,1043
50,12,93,Florida,Okeechobee County,6,6,2401,1427,974
50,12,93,Florida,Okeechobee County,6,7,2471,1432,1039
50,12,93,Florida,Okeechobee County,6,8,2498,1444,1054
50,12,93,Florida,Okeechobee County,6,9,2732,1506,1226
50,12,93,Florida,Okeechobee County,6,10,2525,1367,1158
50,12,93,Florida,Okeechobee County,6,11,2249,1161,1088
50,12,93,Florida,Okeechobee County,6,12,2102,1098,1004
50,12,93,Florida,Okeechobee County,6,13,2065,1001,1064
50,12,93,Florida,Okeechobee County,6,14,1926,959,967
50,12,93,Florida,Okeechobee County,6,15,1658,884,774
50,12,93,Florida,Okeechobee County,6,16,1440,706,734
50,12,93,Florida,Okeechobee County,6,17,801,404,397
50,12,93,Florida,Okeechobee County,6,18,566,215,351
50,12,93,Florida,Okeechobee County,6,99,38556,20749,17807
50,12,93,Florida,Okeechobee County,7,0,587,316,271
50,12,93,Florida,Okeechobee County,7,1,2077,1062,1015
50,12,93,Florida,Okeechobee County,7,2,2349,1232,1117
50,12,93,Florida,Okeechobee County,7,3,2696,1421,1275
50,12,93,Florida,Okeechobee County,7,4,2978,1731,1247
50,12,93,Florida,Okeechobee County,7,5,2517,1462,1055
50,12,93,Florida,Okeechobee County,7,6,2545,1516,1029
50,12,93,Florida,Okeechobee County,7,7,2472,1426,1046
50,12,93,Florida,Okeechobee County,7,8,2536,1452,1084
50,12,93,Florida,Okeechobee County,7,9,2732,1517,1215
50,12,93,Florida,Okeechobee County,7,10,2608,1385,1223
50,12,93,Florida,Okeechobee County,7,11,2384,1268,1116
50,12,93,Florida,Okeechobee County,7,12,2166,1099,1067
50,12,93,Florida,Okeechobee County,7,13,2070,1043,1027
50,12,93,Florida,Okeechobee County,7,14,2057,1013,1044
50,12,93,Florida,Okeechobee County,7,15,1613,857,756
50,12,93,Florida,Okeechobee County,7,16,1432,681,751
50,12,93,Florida,Okeechobee County,7,17,863,458,405
50,12,93,Florida,Okeechobee County,7,18,565,196,369
50,12,93,Florida,Okeechobee County,7,99,39247,21135,18112
50,12,93,Florida,Okeechobee County,8,0,579,308,271
50,12,93,Florida,Okeechobee County,8,1,2111,1065,1046
50,12,93,Florida,Okeechobee County,8,2,2462,1290,1172
50,12,93,Florida,Okeechobee County,8,3,2669,1377,1292
50,12,93,Florida,Okeechobee County,8,4,2963,1709,1254
50,12,93,Florida,Okeechobee County,8,5,2532,1466,1066
50,12,93,Florida,Okeechobee County,8,6,2650,1570,1080
50,12,93,Florida,Okeechobee County,8,7,2452,1399,1053
50,12,93,Florida,Okeechobee County,8,8,2551,1488,1063
50,12,93,Florida,Okeechobee County,8,9,2747,1515,1232
50,12,93,Florida,Okeechobee County,8,10,2644,1407,1237
50,12,93,Florida,Okeechobee County,8,11,2467,1309,1158
50,12,93,Florida,Okeechobee County,8,12,2321,1206,1115
50,12,93,Florida,Okeechobee County,8,13,2066,1029,1037
50,12,93,Florida,Okeechobee County,8,14,2031,993,1038
50,12,93,Florida,Okeechobee County,8,15,1592,846,746
50,12,93,Florida,Okeechobee County,8,16,1336,674,662
50,12,93,Florida,Okeechobee County,8,17,915,492,423
50,12,93,Florida,Okeechobee County,8,18,580,190,390
50,12,93,Florida,Okeechobee County,8,99,39668,21333,18335
50,12,93,Florida,Okeechobee County,9,0,584,318,266
50,12,93,Florida,Okeechobee County,9,1,2103,1058,1045
50,12,93,Florida,Okeechobee County,9,2,2447,1277,1170
50,12,93,Florida,Okeechobee County,9,3,2646,1399,1247
50,12,93,Florida,Okeechobee County,9,4,2992,1676,1316
50,12,93,Florida,Okeechobee County,9,5,2550,1498,1052
50,12,93,Florida,Okeechobee County,9,6,2697,1595,1102
50,12,93,Florida,Okeechobee County,9,7,2410,1385,1025
50,12,93,Florida,Okeechobee County,9,8,2545,1435,1110
50,12,93,Florida,Okeechobee County,9,9,2708,1541,1167
50,12,93,Florida,Okeechobee County,9,10,2741,1455,1286
50,12,93,Florida,Okeechobee County,9,11,2472,1321,1151
50,12,93,Florida,Okeechobee County,9,12,2283,1172,1111
50,12,93,Florida,Okeechobee County,9,13,2111,1073,1038
50,12,93,Florida,Okeechobee County,9,14,2084,1003,1081
50,12,93,Florida,Okeechobee County,9,15,1633,853,780
50,12,93,Florida,Okeechobee County,9,16,1294,654,640
50,12,93,Florida,Okeechobee County,9,17,947,512,435
50,12,93,Florida,Okeechobee County,9,18,593,201,392
50,12,93,Florida,Okeechobee County,9,99,39840,21426,18414
50,12,93,Florida,Okeechobee County,10,0,555,306,249
50,12,93,Florida,Okeechobee County,10,1,2133,1090,1043
50,12,93,Florida,Okeechobee County,10,2,2485,1257,1228
50,12,93,Florida,Okeechobee County,10,3,2578,1369,1209
50,12,93,Florida,Okeechobee County,10,4,3042,1663,1379
50,12,93,Florida,Okeechobee County,10,5,2537,1505,1032
50,12,93,Florida,Okeechobee County,10,6,2658,1592,1066
50,12,93,Florida,Okeechobee County,10,7,2428,1384,1044
50,12,93,Florida,Okeechobee County,10,8,2552,1431,1121
50,12,93,Florida,Okeechobee County,10,9,2670,1510,1160
50,12,93,Florida,Okeechobee County,10,10,2685,1441,1244
50,12,93,Florida,Okeechobee County,10,11,2567,1381,1186
50,12,93,Florida,Okeechobee County,10,12,2258,1158,1100
50,12,93,Florida,Okeechobee County,10,13,2166,1108,1058
50,12,93,Florida,Okeechobee County,10,14,2094,997,1097
50,12,93,Florida,Okeechobee County,10,15,1709,891,818
50,12,93,Florida,Okeechobee County,10,16,1275,664,611
50,12,93,Florida,Okeechobee County,10,17,993,528,465
50,12,93,Florida,Okeechobee County,10,18,583,194,389
50,12,93,Florida,Okeechobee County,10,99,39968,21469,18499
50,12,93,Florida,Okeechobee County,11,0,508,268,240
50,12,93,Florida,Okeechobee County,11,1,2161,1115,1046
50,12,93,Florida,Okeechobee County,11,2,2511,1259,1252
50,12,93,Florida,Okeechobee County,11,3,2542,1337,1205
50,12,93,Florida,Okeechobee County,11,4,2977,1622,1355
50,12,93,Florida,Okeechobee County,11,5,2573,1487,1086
50,12,93,Florida,Okeechobee County,11,6,2627,1547,1080
50,12,93,Florida,Okeechobee County,11,7,2481,1425,1056
50,12,93,Florida,Okeechobee County,11,8,2480,1395,1085
50,12,93,Florida,Okeechobee County,11,9,2550,1467,1083
50,12,93,Florida,Okeechobee County,11,10,2716,1459,1257
50,12,93,Florida,Okeechobee County,11,11,2627,1405,1222
50,12,93,Florida,Okeechobee County,11,12,2242,1157,1085
50,12,93,Florida,Okeechobee County,11,13,2172,1090,1082
50,12,93,Florida,Okeechobee County,11,14,2107,1016,1091
50,12,93,Florida,Okeechobee County,11,15,1744,878,866
50,12,93,Florida,Okeechobee County,11,16,1279,703,576
50,12,93,Florida,Okeechobee County,11,17,982,485,497
50,12,93,Florida,Okeechobee County,11,18,620,242,378
50,12,93,Florida,Okeechobee County,11,99,39899,21357,18542
50,12,93,Florida,Okeechobee County,12,0,518,285,233
50,12,93,Florida,Okeechobee County,12,1,2141,1126,1015
50,12,93,Florida,Okeechobee County,12,2,2543,1271,1272
50,12,93,Florida,Okeechobee County,12,3,2591,1354,1237
50,12,93,Florida,Okeechobee County,12,4,2899,1596,1303
50,12,93,Florida,Okeechobee County,12,5,2537,1461,1076
50,12,93,Florida,Okeechobee County,12,6,2568,1512,1056
50,12,93,Florida,Okeechobee County,12,7,2490,1429,1061
50,12,93,Florida,Okeechobee County,12,8,2438,1367,1071
50,12,93,Florida,Okeechobee County,12,9,2530,1456,1074
50,12,93,Florida,Okeechobee County,12,10,2710,1473,1237
50,12,93,Florida,Okeechobee County,12,11,2691,1432,1259
50,12,93,Florida,Okeechobee County,12,12,2332,1216,1116
50,12,93,Florida,Okeechobee County,12,13,2217,1094,1123
50,12,93,Florida,Okeechobee County,12,14,2102,1037,1065
50,12,93,Florida,Okeechobee County,12,15,1800,895,905
50,12,93,Florida,Okeechobee County,12,16,1277,695,582
50,12,93,Florida,Okeechobee County,12,17,950,467,483
50,12,93,Florida,Okeechobee County,12,18,662,264,398
50,12,93,Florida,Okeechobee County,12,99,39996,21430,18566
50,12,93,Florida,Okeechobee County,13,0,517,287,230
50,12,93,Florida,Okeechobee County,13,1,2120,1116,1004
50,12,93,Florida,Okeechobee County,13,2,2529,1265,1264
50,12,93,Florida,Okeechobee County,13,3,2588,1348,1240
50,12,93,Florida,Okeechobee County,13,4,2889,1590,1299
50,12,93,Florida,Okeechobee County,13,5,2546,1460,1086
50,12,93,Florida,Okeechobee County,13,6,2577,1519,1058
50,12,93,Florida,Okeechobee County,13,7,2497,1429,1068
50,12,93,Florida,Okeechobee County,13,8,2433,1371,1062
50,12,93,Florida,Okeechobee County,13,9,2538,1460,1078
50,12,93,Florida,Okeechobee County,13,10,2713,1476,1237
50,12,93,Florida,Okeechobee County,13,11,2695,1431,1264
50,12,93,Florida,Okeechobee County,13,12,2344,1222,1122
50,12,93,Florida,Okeechobee County,13,13,2237,1103,1134
50,12,93,Florida,Okeechobee County,13,14,2115,1045,1070
50,12,93,Florida,Okeechobee County,13,15,1807,898,909
50,12,93,Florida,Okeechobee County,13,16,1281,702,579
50,12,93,Florida,Okeechobee County,13,17,949,465,484
50,12,93,Florida,Okeechobee County,13,18,666,267,399
50,12,93,Florida,Okeechobee County,13,99,40041,21454,18587
50,12,95,Florida,Orange County,1,0,12368,6308,6060
50,12,95,Florida,Orange County,1,1,49006,25134,23872
50,12,95,Florida,Orange County,1,2,65237,33476,31761
50,12,95,Florida,Orange County,1,3,63665,32686,30979
50,12,95,Florida,Orange County,1,4,63339,32105,31234
50,12,95,Florida,Orange County,1,5,70762,35808,34954
50,12,95,Florida,Orange County,1,6,73914,37541,36373
50,12,95,Florida,Orange County,1,7,75136,38796,36340
50,12,95,Florida,Orange County,1,8,80270,40866,39404
50,12,95,Florida,Orange County,1,9,73351,36871,36480
50,12,95,Florida,Orange County,1,10,61212,30165,31047
50,12,95,Florida,Orange County,1,11,51297,25010,26287
50,12,95,Florida,Orange County,1,12,37410,17981,19429
50,12,95,Florida,Orange County,1,13,29389,13757,15632
50,12,95,Florida,Orange County,1,14,26052,12016,14036
50,12,95,Florida,Orange County,1,15,23293,10059,13234
50,12,95,Florida,Orange County,1,16,18785,7608,11177
50,12,95,Florida,Orange County,1,17,12094,4653,7441
50,12,95,Florida,Orange County,1,18,9543,2814,6729
50,12,95,Florida,Orange County,1,99,896123,443654,452469
50,12,95,Florida,Orange County,2,0,12565,6404,6161
50,12,95,Florida,Orange County,2,1,49035,25144,23891
50,12,95,Florida,Orange County,2,2,65221,33459,31762
50,12,95,Florida,Orange County,2,3,64373,33046,31327
50,12,95,Florida,Orange County,2,4,64010,32445,31565
50,12,95,Florida,Orange County,2,5,72219,36543,35676
50,12,95,Florida,Orange County,2,6,73940,37528,36412
50,12,95,Florida,Orange County,2,7,75474,38947,36527
50,12,95,Florida,Orange County,2,8,80471,40952,39519
50,12,95,Florida,Orange County,2,9,74019,37194,36825
50,12,95,Florida,Orange County,2,10,61935,30526,31409
50,12,95,Florida,Orange County,2,11,52177,25432,26745
50,12,95,Florida,Orange County,2,12,37902,18219,19683
50,12,95,Florida,Orange County,2,13,29702,13912,15790
50,12,95,Florida,Orange County,2,14,26086,12034,14052
50,12,95,Florida,Orange County,2,15,23323,10090,13233
50,12,95,Florida,Orange County,2,16,18840,7630,11210
50,12,95,Florida,Orange County,2,17,12168,4696,7472
50,12,95,Florida,Orange County,2,18,9559,2824,6735
50,12,95,Florida,Orange County,2,99,903019,447025,455994
50,12,95,Florida,Orange County,3,0,14047,7119,6928
50,12,95,Florida,Orange County,3,1,49925,25559,24366
50,12,95,Florida,Orange County,3,2,65601,33731,31870
50,12,95,Florida,Orange County,3,3,66888,34348,32540
50,12,95,Florida,Orange County,3,4,64327,32890,31437
50,12,95,Florida,Orange County,3,5,79352,39795,39557
50,12,95,Florida,Orange County,3,6,74771,37891,36880
50,12,95,Florida,Orange County,3,7,77403,39748,37655
50,12,95,Florida,Orange County,3,8,80484,40830,39654
50,12,95,Florida,Orange County,3,9,77024,38609,38415
50,12,95,Florida,Orange County,3,10,64817,32008,32809
50,12,95,Florida,Orange County,3,11,55762,27025,28737
50,12,95,Florida,Orange County,3,12,39836,19239,20597
50,12,95,Florida,Orange County,3,13,30618,14316,16302
50,12,95,Florida,Orange County,3,14,26121,11990,14131
50,12,95,Florida,Orange County,3,15,23506,10315,13191
50,12,95,Florida,Orange County,3,16,18841,7616,11225
50,12,95,Florida,Orange County,3,17,12767,4908,7859
50,12,95,Florida,Orange County,3,18,9685,2902,6783
50,12,95,Florida,Orange County,3,99,931775,460839,470936
50,12,95,Florida,Orange County,4,0,13979,7171,6808
50,12,95,Florida,Orange County,4,1,51953,26508,25445
50,12,95,Florida,Orange County,4,2,65683,33748,31935
50,12,95,Florida,Orange County,4,3,68823,35406,33417
50,12,95,Florida,Orange County,4,4,65877,33854,32023
50,12,95,Florida,Orange County,4,5,82670,41110,41560
50,12,95,Florida,Orange County,4,6,76217,38545,37672
50,12,95,Florida,Orange County,4,7,78710,40222,38488
50,12,95,Florida,Orange County,4,8,79851,40492,39359
50,12,95,Florida,Orange County,4,9,78839,39546,39293
50,12,95,Florida,Orange County,4,10,68077,33685,34392
50,12,95,Florida,Orange County,4,11,56786,27571,29215
50,12,95,Florida,Orange County,4,12,43639,21021,22618
50,12,95,Florida,Orange County,4,13,31897,14875,17022
50,12,95,Florida,Orange County,4,14,26460,12088,14372
50,12,95,Florida,Orange County,4,15,23593,10592,13001
50,12,95,Florida,Orange County,4,16,19165,7690,11475
50,12,95,Florida,Orange County,4,17,13043,5057,7986
50,12,95,Florida,Orange County,4,18,9874,3042,6832
50,12,95,Florida,Orange County,4,99,955136,472223,482913
50,12,95,Florida,Orange County,5,0,13767,7025,6742
50,12,95,Florida,Orange County,5,1,53912,27384,26528
50,12,95,Florida,Orange County,5,2,65203,33452,31751
50,12,95,Florida,Orange County,5,3,70630,36379,34251
50,12,95,Florida,Orange County,5,4,68960,35267,33693
50,12,95,Florida,Orange County,5,5,85092,42430,42662
50,12,95,Florida,Orange County,5,6,79011,40262,38749
50,12,95,Florida,Orange County,5,7,79045,40135,38910
50,12,95,Florida,Orange County,5,8,79216,40060,39156
50,12,95,Florida,Orange County,5,9,80863,40616,40247
50,12,95,Florida,Orange County,5,10,71190,35219,35971
50,12,95,Florida,Orange County,5,11,58556,28386,30170
50,12,95,Florida,Orange County,5,12,46644,22486,24158
50,12,95,Florida,Orange County,5,13,33717,15784,17933
50,12,95,Florida,Orange County,5,14,27177,12471,14706
50,12,95,Florida,Orange County,5,15,23641,10681,12960
50,12,95,Florida,Orange County,5,16,19206,7643,11563
50,12,95,Florida,Orange County,5,17,13386,5203,8183
50,12,95,Florida,Orange County,5,18,10011,3161,6850
50,12,95,Florida,Orange County,5,99,979227,484044,495183
50,12,95,Florida,Orange County,6,0,14220,7279,6941
50,12,95,Florida,Orange County,6,1,56478,28712,27766
50,12,95,Florida,Orange County,6,2,65913,33814,32099
50,12,95,Florida,Orange County,6,3,72850,37351,35499
50,12,95,Florida,Orange County,6,4,72720,37273,35447
50,12,95,Florida,Orange County,6,5,87723,44007,43716
50,12,95,Florida,Orange County,6,6,83114,42251,40863
50,12,95,Florida,Orange County,6,7,80004,40484,39520
50,12,95,Florida,Orange County,6,8,79212,40024,39188
50,12,95,Florida,Orange County,6,9,83265,41597,41668
50,12,95,Florida,Orange County,6,10,74039,36680,37359
50,12,95,Florida,Orange County,6,11,61254,29758,31496
50,12,95,Florida,Orange County,6,12,49815,23915,25900
50,12,95,Florida,Orange County,6,13,35599,16701,18898
50,12,95,Florida,Orange County,6,14,28189,12846,15343
50,12,95,Florida,Orange County,6,15,23724,10703,13021
50,12,95,Florida,Orange County,6,16,19434,7845,11589
50,12,95,Florida,Orange County,6,17,13778,5304,8474
50,12,95,Florida,Orange County,6,18,10350,3289,7061
50,12,95,Florida,Orange County,6,99,1011681,499833,511848
50,12,95,Florida,Orange County,7,0,14884,7542,7342
50,12,95,Florida,Orange County,7,1,59746,30507,29239
50,12,95,Florida,Orange County,7,2,67586,34554,33032
50,12,95,Florida,Orange County,7,3,74771,38229,36542
50,12,95,Florida,Orange County,7,4,77494,39718,37776
50,12,95,Florida,Orange County,7,5,91058,45630,45428
50,12,95,Florida,Orange County,7,6,88834,44879,43955
50,12,95,Florida,Orange County,7,7,80578,40528,40050
50,12,95,Florida,Orange County,7,8,81415,41063,40352
50,12,95,Florida,Orange County,7,9,85560,42875,42685
50,12,95,Florida,Orange County,7,10,77491,38471,39020
50,12,95,Florida,Orange County,7,11,64888,31511,33377
50,12,95,Florida,Orange County,7,12,53456,25552,27904
50,12,95,Florida,Orange County,7,13,37662,17784,19878
50,12,95,Florida,Orange County,7,14,29123,13343,15780
50,12,95,Florida,Orange County,7,15,24144,10821,13323
50,12,95,Florida,Orange County,7,16,19759,8095,11664
50,12,95,Florida,Orange County,7,17,13998,5329,8669
50,12,95,Florida,Orange County,7,18,10894,3518,7376
50,12,95,Florida,Orange County,7,99,1053341,519949,533392
50,12,95,Florida,Orange County,8,0,15236,7806,7430
50,12,95,Florida,Orange County,8,1,60609,30907,29702
50,12,95,Florida,Orange County,8,2,69781,35456,34325
50,12,95,Florida,Orange County,8,3,75888,38766,37122
50,12,95,Florida,Orange County,8,4,81375,41528,39847
50,12,95,Florida,Orange County,8,5,95010,47925,47085
50,12,95,Florida,Orange County,8,6,93243,46976,46267
50,12,95,Florida,Orange County,8,7,80276,40273,40003
50,12,95,Florida,Orange County,8,8,83349,41935,41414
50,12,95,Florida,Orange County,8,9,85735,42862,42873
50,12,95,Florida,Orange County,8,10,80531,39960,40571
50,12,95,Florida,Orange County,8,11,67204,32733,34471
50,12,95,Florida,Orange County,8,12,56701,27001,29700
50,12,95,Florida,Orange County,8,13,39528,18738,20790
50,12,95,Florida,Orange County,8,14,29624,13522,16102
50,12,95,Florida,Orange County,8,15,24011,10714,13297
50,12,95,Florida,Orange County,8,16,19756,8267,11489
50,12,95,Florida,Orange County,8,17,14110,5332,8778
50,12,95,Florida,Orange County,8,18,11462,3720,7742
50,12,95,Florida,Orange County,8,99,1083429,534421,549008
50,12,95,Florida,Orange County,9,0,15077,7727,7350
50,12,95,Florida,Orange County,9,1,60005,30796,29209
50,12,95,Florida,Orange County,9,2,70923,35893,35030
50,12,95,Florida,Orange County,9,3,75518,38657,36861
50,12,95,Florida,Orange County,9,4,84009,42956,41053
50,12,95,Florida,Orange County,9,5,98241,49963,48278
50,12,95,Florida,Orange County,9,6,94649,47679,46970
50,12,95,Florida,Orange County,9,7,79919,40089,39830
50,12,95,Florida,Orange County,9,8,83964,42227,41737
50,12,95,Florida,Orange County,9,9,84397,42133,42264
50,12,95,Florida,Orange County,9,10,82010,40712,41298
50,12,95,Florida,Orange County,9,11,69988,34138,35850
50,12,95,Florida,Orange County,9,12,57661,27398,30263
50,12,95,Florida,Orange County,9,13,42880,20308,22572
50,12,95,Florida,Orange County,9,14,30756,14057,16699
50,12,95,Florida,Orange County,9,15,24380,10891,13489
50,12,95,Florida,Orange County,9,16,19940,8593,11347
50,12,95,Florida,Orange County,9,17,14389,5371,9018
50,12,95,Florida,Orange County,9,18,11957,3906,8051
50,12,95,Florida,Orange County,9,99,1100663,543494,557169
50,12,95,Florida,Orange County,10,0,14630,7460,7170
50,12,95,Florida,Orange County,10,1,59984,30732,29252
50,12,95,Florida,Orange County,10,2,71798,36239,35559
50,12,95,Florida,Orange County,10,3,74887,38278,36609
50,12,95,Florida,Orange County,10,4,85909,43850,42059
50,12,95,Florida,Orange County,10,5,101633,51345,50288
50,12,95,Florida,Orange County,10,6,94543,47667,46876
50,12,95,Florida,Orange County,10,7,80750,40460,40290
50,12,95,Florida,Orange County,10,8,83266,41688,41578
50,12,95,Florida,Orange County,10,9,82948,41372,41576
50,12,95,Florida,Orange County,10,10,82987,41319,41668
50,12,95,Florida,Orange County,10,11,72803,35421,37382
50,12,95,Florida,Orange County,10,12,58921,27860,31061
50,12,95,Florida,Orange County,10,13,45583,21670,23913
50,12,95,Florida,Orange County,10,14,32670,15006,17664
50,12,95,Florida,Orange County,10,15,25004,11166,13838
50,12,95,Florida,Orange County,10,16,20177,8806,11371
50,12,95,Florida,Orange County,10,17,14413,5364,9049
50,12,95,Florida,Orange County,10,18,12619,4200,8419
50,12,95,Florida,Orange County,10,99,1115525,549903,565622
50,12,95,Florida,Orange County,11,0,14396,7441,6955
50,12,95,Florida,Orange County,11,1,59700,30630,29070
50,12,95,Florida,Orange County,11,2,72739,36765,35974
50,12,95,Florida,Orange County,11,3,74528,38097,36431
50,12,95,Florida,Orange County,11,4,87523,44483,43040
50,12,95,Florida,Orange County,11,5,104048,52588,51460
50,12,95,Florida,Orange County,11,6,94405,47616,46789
50,12,95,Florida,Orange County,11,7,82004,41068,40936
50,12,95,Florida,Orange County,11,8,83171,41369,41802
50,12,95,Florida,Orange County,11,9,81738,40796,40942
50,12,95,Florida,Orange County,11,10,84301,41935,42366
50,12,95,Florida,Orange County,11,11,75024,36474,38550
50,12,95,Florida,Orange County,11,12,60981,28971,32010
50,12,95,Florida,Orange County,11,13,48544,23005,25539
50,12,95,Florida,Orange County,11,14,34411,15868,18543
50,12,95,Florida,Orange County,11,15,25665,11442,14223
50,12,95,Florida,Orange County,11,16,20213,8782,11431
50,12,95,Florida,Orange County,11,17,14803,5654,9149
50,12,95,Florida,Orange County,11,18,13157,4351,8806
50,12,95,Florida,Orange County,11,99,1131351,557335,574016
50,12,95,Florida,Orange County,12,0,14437,7417,7020
50,12,95,Florida,Orange County,12,1,59748,30713,29035
50,12,95,Florida,Orange County,12,2,73754,37440,36314
50,12,95,Florida,Orange County,12,3,74975,38221,36754
50,12,95,Florida,Orange County,12,4,88367,44855,43512
50,12,95,Florida,Orange County,12,5,105821,53541,52280
50,12,95,Florida,Orange County,12,6,93559,47142,46417
50,12,95,Florida,Orange County,12,7,83558,41733,41825
50,12,95,Florida,Orange County,12,8,82569,40853,41716
50,12,95,Florida,Orange County,12,9,81899,40995,40904
50,12,95,Florida,Orange County,12,10,85292,42407,42885
50,12,95,Florida,Orange County,12,11,76767,37430,39337
50,12,95,Florida,Orange County,12,12,63029,29938,33091
50,12,95,Florida,Orange County,12,13,51262,24203,27059
50,12,95,Florida,Orange County,12,14,35805,16561,19244
50,12,95,Florida,Orange County,12,15,26206,11777,14429
50,12,95,Florida,Orange County,12,16,20415,8798,11617
50,12,95,Florida,Orange County,12,17,14977,5834,9143
50,12,95,Florida,Orange County,12,18,13516,4468,9048
50,12,95,Florida,Orange County,12,99,1145956,564326,581630
50,12,95,Florida,Orange County,13,0,14495,7449,7046
50,12,95,Florida,Orange County,13,1,59839,30758,29081
50,12,95,Florida,Orange County,13,2,73991,37551,36440
50,12,95,Florida,Orange County,13,3,75132,38296,36836
50,12,95,Florida,Orange County,13,4,88161,44748,43413
50,12,95,Florida,Orange County,13,5,106304,53797,52507
50,12,95,Florida,Orange County,13,6,93795,47320,46475
50,12,95,Florida,Orange County,13,7,84127,42034,42093
50,12,95,Florida,Orange County,13,8,82337,40753,41584
50,12,95,Florida,Orange County,13,9,82037,41070,40967
50,12,95,Florida,Orange County,13,10,85235,42385,42850
50,12,95,Florida,Orange County,13,11,77150,37612,39538
50,12,95,Florida,Orange County,13,12,63466,30153,33313
50,12,95,Florida,Orange County,13,13,51863,24489,27374
50,12,95,Florida,Orange County,13,14,36077,16693,19384
50,12,95,Florida,Orange County,13,15,26371,11860,14511
50,12,95,Florida,Orange County,13,16,20454,8829,11625
50,12,95,Florida,Orange County,13,17,15025,5865,9160
50,12,95,Florida,Orange County,13,18,13641,4518,9123
50,12,95,Florida,Orange County,13,99,1149500,566180,583320
50,12,97,Florida,Osceola County,1,0,2313,1184,1129
50,12,97,Florida,Osceola County,1,1,9406,4804,4602
50,12,97,Florida,Osceola County,1,2,13214,6844,6370
50,12,97,Florida,Osceola County,1,3,13444,6902,6542
50,12,97,Florida,Osceola County,1,4,12490,6461,6029
50,12,97,Florida,Osceola County,1,5,11310,5790,5520
50,12,97,Florida,Osceola County,1,6,12196,6025,6171
50,12,97,Florida,Osceola County,1,7,13039,6493,6546
50,12,97,Florida,Osceola County,1,8,14515,7221,7294
50,12,97,Florida,Osceola County,1,9,13653,6747,6906
50,12,97,Florida,Osceola County,1,10,11685,5657,6028
50,12,97,Florida,Osceola County,1,11,10487,5044,5443
50,12,97,Florida,Osceola County,1,12,8354,3964,4390
50,12,97,Florida,Osceola County,1,13,6686,3267,3419
50,12,97,Florida,Osceola County,1,14,6007,2877,3130
50,12,97,Florida,Osceola County,1,15,5123,2369,2754
50,12,97,Florida,Osceola County,1,16,4030,1731,2299
50,12,97,Florida,Osceola County,1,17,2600,1019,1581
50,12,97,Florida,Osceola County,1,18,1968,634,1334
50,12,97,Florida,Osceola County,1,99,172520,85033,87487
50,12,97,Florida,Osceola County,2,0,2371,1213,1158
50,12,97,Florida,Osceola County,2,1,9456,4837,4619
50,12,97,Florida,Osceola County,2,2,13261,6863,6398
50,12,97,Florida,Osceola County,2,3,13632,6991,6641
50,12,97,Florida,Osceola County,2,4,12599,6504,6095
50,12,97,Florida,Osceola County,2,5,11467,5869,5598
50,12,97,Florida,Osceola County,2,6,12197,6019,6178
50,12,97,Florida,Osceola County,2,7,13126,6532,6594
50,12,97,Florida,Osceola County,2,8,14599,7267,7332
50,12,97,Florida,Osceola County,2,9,13816,6827,6989
50,12,97,Florida,Osceola County,2,10,11865,5745,6120
50,12,97,Florida,Osceola County,2,11,10695,5145,5550
50,12,97,Florida,Osceola County,2,12,8492,4030,4462
50,12,97,Florida,Osceola County,2,13,6783,3314,3469
50,12,97,Florida,Osceola County,2,14,6030,2889,3141
50,12,97,Florida,Osceola County,2,15,5122,2373,2749
50,12,97,Florida,Osceola County,2,16,4036,1735,2301
50,12,97,Florida,Osceola County,2,17,2620,1029,1591
50,12,97,Florida,Osceola County,2,18,1979,639,1340
50,12,97,Florida,Osceola County,2,99,174146,85821,88325
50,12,97,Florida,Osceola County,3,0,2702,1406,1296
50,12,97,Florida,Osceola County,3,1,9779,5031,4748
50,12,97,Florida,Osceola County,3,2,13501,6954,6547
50,12,97,Florida,Osceola County,3,3,14364,7312,7052
50,12,97,Florida,Osceola County,3,4,12989,6761,6228
50,12,97,Florida,Osceola County,3,5,12293,6322,5971
50,12,97,Florida,Osceola County,3,6,12313,6067,6246
50,12,97,Florida,Osceola County,3,7,13768,6846,6922
50,12,97,Florida,Osceola County,3,8,15057,7410,7647
50,12,97,Florida,Osceola County,3,9,14420,7093,7327
50,12,97,Florida,Osceola County,3,10,12538,6064,6474
50,12,97,Florida,Osceola County,3,11,11460,5455,6005
50,12,97,Florida,Osceola County,3,12,9012,4315,4697
50,12,97,Florida,Osceola County,3,13,7310,3529,3781
50,12,97,Florida,Osceola County,3,14,6158,2965,3193
50,12,97,Florida,Osceola County,3,15,5214,2416,2798
50,12,97,Florida,Osceola County,3,16,4062,1765,2297
50,12,97,Florida,Osceola County,3,17,2735,1081,1654
50,12,97,Florida,Osceola County,3,18,2019,643,1376
50,12,97,Florida,Osceola County,3,99,181694,89435,92259
50,12,97,Florida,Osceola County,4,0,2713,1406,1307
50,12,97,Florida,Osceola County,4,1,10533,5419,5114
50,12,97,Florida,Osceola County,4,2,13674,7106,6568
50,12,97,Florida,Osceola County,4,3,15276,7695,7581
50,12,97,Florida,Osceola County,4,4,13877,7227,6650
50,12,97,Florida,Osceola County,4,5,12763,6577,6186
50,12,97,Florida,Osceola County,4,6,12860,6428,6432
50,12,97,Florida,Osceola County,4,7,14355,6985,7370
50,12,97,Florida,Osceola County,4,8,15558,7660,7898
50,12,97,Florida,Osceola County,4,9,15202,7483,7719
50,12,97,Florida,Osceola County,4,10,13541,6600,6941
50,12,97,Florida,Osceola County,4,11,11827,5689,6138
50,12,97,Florida,Osceola County,4,12,9994,4764,5230
50,12,97,Florida,Osceola County,4,13,7821,3777,4044
50,12,97,Florida,Osceola County,4,14,6577,3174,3403
50,12,97,Florida,Osceola County,4,15,5342,2476,2866
50,12,97,Florida,Osceola County,4,16,4132,1770,2362
50,12,97,Florida,Osceola County,4,17,2796,1115,1681
50,12,97,Florida,Osceola County,4,18,2003,656,1347
50,12,97,Florida,Osceola County,4,99,190844,94007,96837
50,12,97,Florida,Osceola County,5,0,2852,1459,1393
50,12,97,Florida,Osceola County,5,1,11494,5883,5611
50,12,97,Florida,Osceola County,5,2,14296,7329,6967
50,12,97,Florida,Osceola County,5,3,16297,8289,8008
50,12,97,Florida,Osceola County,5,4,14808,7737,7071
50,12,97,Florida,Osceola County,5,5,13547,7096,6451
50,12,97,Florida,Osceola County,5,6,13777,6872,6905
50,12,97,Florida,Osceola County,5,7,15019,7265,7754
50,12,97,Florida,Osceola County,5,8,16218,8038,8180
50,12,97,Florida,Osceola County,5,9,16267,7923,8344
50,12,97,Florida,Osceola County,5,10,14558,7100,7458
50,12,97,Florida,Osceola County,5,11,12530,6009,6521
50,12,97,Florida,Osceola County,5,12,10840,5142,5698
50,12,97,Florida,Osceola County,5,13,8478,4099,4379
50,12,97,Florida,Osceola County,5,14,6982,3322,3660
50,12,97,Florida,Osceola County,5,15,5581,2579,3002
50,12,97,Florida,Osceola County,5,16,4293,1865,2428
50,12,97,Florida,Osceola County,5,17,2823,1146,1677
50,12,97,Florida,Osceola County,5,18,2027,647,1380
50,12,97,Florida,Osceola County,5,99,202687,99800,102887
50,12,97,Florida,Osceola County,6,0,3112,1619,1493
50,12,97,Florida,Osceola County,6,1,12348,6336,6012
50,12,97,Florida,Osceola County,6,2,14976,7671,7305
50,12,97,Florida,Osceola County,6,3,17455,8912,8543
50,12,97,Florida,Osceola County,6,4,16158,8420,7738
50,12,97,Florida,Osceola County,6,5,14352,7464,6888
50,12,97,Florida,Osceola County,6,6,14679,7379,7300
50,12,97,Florida,Osceola County,6,7,15893,7686,8207
50,12,97,Florida,Osceola County,6,8,16948,8209,8739
50,12,97,Florida,Osceola County,6,9,17472,8575,8897
50,12,97,Florida,Osceola County,6,10,15682,7669,8013
50,12,97,Florida,Osceola County,6,11,13511,6466,7045
50,12,97,Florida,Osceola County,6,12,11784,5556,6228
50,12,97,Florida,Osceola County,6,13,9231,4427,4804
50,12,97,Florida,Osceola County,6,14,7561,3596,3965
50,12,97,Florida,Osceola County,6,15,5831,2772,3059
50,12,97,Florida,Osceola County,6,16,4469,1931,2538
50,12,97,Florida,Osceola County,6,17,2960,1206,1754
50,12,97,Florida,Osceola County,6,18,2119,684,1435
50,12,97,Florida,Osceola County,6,99,216541,106578,109963
50,12,97,Florida,Osceola County,7,0,3200,1689,1511
50,12,97,Florida,Osceola County,7,1,13012,6776,6236
50,12,97,Florida,Osceola County,7,2,15567,7892,7675
50,12,97,Florida,Osceola County,7,3,18303,9383,8920
50,12,97,Florida,Osceola County,7,4,17605,9136,8469
50,12,97,Florida,Osceola County,7,5,14981,7764,7217
50,12,97,Florida,Osceola County,7,6,15272,7680,7592
50,12,97,Florida,Osceola County,7,7,16270,7868,8402
50,12,97,Florida,Osceola County,7,8,17620,8458,9162
50,12,97,Florida,Osceola County,7,9,18538,9053,9485
50,12,97,Florida,Osceola County,7,10,16830,8280,8550
50,12,97,Florida,Osceola County,7,11,14325,6883,7442
50,12,97,Florida,Osceola County,7,12,12666,6020,6646
50,12,97,Florida,Osceola County,7,13,9861,4690,5171
50,12,97,Florida,Osceola County,7,14,8062,3831,4231
50,12,97,Florida,Osceola County,7,15,6069,2942,3127
50,12,97,Florida,Osceola County,7,16,4587,1982,2605
50,12,97,Florida,Osceola County,7,17,3060,1221,1839
50,12,97,Florida,Osceola County,7,18,2198,717,1481
50,12,97,Florida,Osceola County,7,99,228026,112265,115761
50,12,97,Florida,Osceola County,8,0,3393,1763,1630
50,12,97,Florida,Osceola County,8,1,13738,7150,6588
50,12,97,Florida,Osceola County,8,2,16837,8588,8249
50,12,97,Florida,Osceola County,8,3,19294,9829,9465
50,12,97,Florida,Osceola County,8,4,19226,9951,9275
50,12,97,Florida,Osceola County,8,5,15889,8288,7601
50,12,97,Florida,Osceola County,8,6,16273,8114,8159
50,12,97,Florida,Osceola County,8,7,16657,8038,8619
50,12,97,Florida,Osceola County,8,8,18687,8968,9719
50,12,97,Florida,Osceola County,8,9,19458,9463,9995
50,12,97,Florida,Osceola County,8,10,17997,8837,9160
50,12,97,Florida,Osceola County,8,11,15366,7437,7929
50,12,97,Florida,Osceola County,8,12,13666,6470,7196
50,12,97,Florida,Osceola County,8,13,10343,4910,5433
50,12,97,Florida,Osceola County,8,14,8610,4081,4529
50,12,97,Florida,Osceola County,8,15,6303,3051,3252
50,12,97,Florida,Osceola County,8,16,4807,2080,2727
50,12,97,Florida,Osceola County,8,17,3167,1301,1866
50,12,97,Florida,Osceola County,8,18,2370,749,1621
50,12,97,Florida,Osceola County,8,99,242081,119068,123013
50,12,97,Florida,Osceola County,9,0,3562,1814,1748
50,12,97,Florida,Osceola County,9,1,14177,7328,6849
50,12,97,Florida,Osceola County,9,2,17734,9063,8671
50,12,97,Florida,Osceola County,9,3,20023,10257,9766
50,12,97,Florida,Osceola County,9,4,20514,10581,9933
50,12,97,Florida,Osceola County,9,5,16883,8779,8104
50,12,97,Florida,Osceola County,9,6,17289,8658,8631
50,12,97,Florida,Osceola County,9,7,17253,8360,8893
50,12,97,Florida,Osceola County,9,8,19469,9287,10182
50,12,97,Florida,Osceola County,9,9,20024,9855,10169
50,12,97,Florida,Osceola County,9,10,18872,9225,9647
50,12,97,Florida,Osceola County,9,11,16367,7921,8446
50,12,97,Florida,Osceola County,9,12,13886,6599,7287
50,12,97,Florida,Osceola County,9,13,11272,5267,6005
50,12,97,Florida,Osceola County,9,14,8946,4237,4709
50,12,97,Florida,Osceola County,9,15,6699,3191,3508
50,12,97,Florida,Osceola County,9,16,4844,2160,2684
50,12,97,Florida,Osceola County,9,17,3381,1360,2021
50,12,97,Florida,Osceola County,9,18,2527,820,1707
50,12,97,Florida,Osceola County,9,99,253722,124762,128960
50,12,97,Florida,Osceola County,10,0,3569,1844,1725
50,12,97,Florida,Osceola County,10,1,14657,7454,7203
50,12,97,Florida,Osceola County,10,2,18247,9363,8884
50,12,97,Florida,Osceola County,10,3,20413,10391,10022
50,12,97,Florida,Osceola County,10,4,21294,11032,10262
50,12,97,Florida,Osceola County,10,5,17524,9133,8391
50,12,97,Florida,Osceola County,10,6,17666,8878,8788
50,12,97,Florida,Osceola County,10,7,17648,8563,9085
50,12,97,Florida,Osceola County,10,8,19714,9411,10303
50,12,97,Florida,Osceola County,10,9,20340,10006,10334
50,12,97,Florida,Osceola County,10,10,19511,9514,9997
50,12,97,Florida,Osceola County,10,11,17219,8320,8899
50,12,97,Florida,Osceola County,10,12,14409,6853,7556
50,12,97,Florida,Osceola County,10,13,11945,5587,6358
50,12,97,Florida,Osceola County,10,14,9505,4469,5036
50,12,97,Florida,Osceola County,10,15,6858,3275,3583
50,12,97,Florida,Osceola County,10,16,5012,2205,2807
50,12,97,Florida,Osceola County,10,17,3560,1491,2069
50,12,97,Florida,Osceola County,10,18,2655,835,1820
50,12,97,Florida,Osceola County,10,99,261746,128624,133122
50,12,97,Florida,Osceola County,11,0,3416,1754,1662
50,12,97,Florida,Osceola County,11,1,14525,7377,7148
50,12,97,Florida,Osceola County,11,2,18508,9511,8997
50,12,97,Florida,Osceola County,11,3,20321,10332,9989
50,12,97,Florida,Osceola County,11,4,21443,11155,10288
50,12,97,Florida,Osceola County,11,5,17742,9102,8640
50,12,97,Florida,Osceola County,11,6,17671,8930,8741
50,12,97,Florida,Osceola County,11,7,17735,8676,9059
50,12,97,Florida,Osceola County,11,8,19488,9270,10218
50,12,97,Florida,Osceola County,11,9,20160,9795,10365
50,12,97,Florida,Osceola County,11,10,20179,9871,10308
50,12,97,Florida,Osceola County,11,11,17799,8605,9194
50,12,97,Florida,Osceola County,11,12,14884,7017,7867
50,12,97,Florida,Osceola County,11,13,12601,5868,6733
50,12,97,Florida,Osceola County,11,14,9950,4650,5300
50,12,97,Florida,Osceola County,11,15,7190,3424,3766
50,12,97,Florida,Osceola County,11,16,5165,2308,2857
50,12,97,Florida,Osceola County,11,17,3617,1538,2079
50,12,97,Florida,Osceola County,11,18,2873,917,1956
50,12,97,Florida,Osceola County,11,99,265267,130100,135167
50,12,97,Florida,Osceola County,12,0,3339,1738,1601
50,12,97,Florida,Osceola County,12,1,14457,7278,7179
50,12,97,Florida,Osceola County,12,2,18815,9658,9157
50,12,97,Florida,Osceola County,12,3,20572,10459,10113
50,12,97,Florida,Osceola County,12,4,21442,11142,10300
50,12,97,Florida,Osceola County,12,5,18007,9153,8854
50,12,97,Florida,Osceola County,12,6,17469,8845,8624
50,12,97,Florida,Osceola County,12,7,17832,8669,9163
50,12,97,Florida,Osceola County,12,8,19383,9319,10064
50,12,97,Florida,Osceola County,12,9,20101,9707,10394
50,12,97,Florida,Osceola County,12,10,20586,10082,10504
50,12,97,Florida,Osceola County,12,11,18290,8803,9487
50,12,97,Florida,Osceola County,12,12,15390,7294,8096
50,12,97,Florida,Osceola County,12,13,13346,6243,7103
50,12,97,Florida,Osceola County,12,14,10217,4785,5432
50,12,97,Florida,Osceola County,12,15,7396,3495,3901
50,12,97,Florida,Osceola County,12,16,5295,2387,2908
50,12,97,Florida,Osceola County,12,17,3695,1588,2107
50,12,97,Florida,Osceola County,12,18,3053,989,2064
50,12,97,Florida,Osceola County,12,99,268685,131634,137051
50,12,97,Florida,Osceola County,13,0,3357,1747,1610
50,12,97,Florida,Osceola County,13,1,14488,7290,7198
50,12,97,Florida,Osceola County,13,2,18925,9708,9217
50,12,97,Florida,Osceola County,13,3,20657,10491,10166
50,12,97,Florida,Osceola County,13,4,21440,11141,10299
50,12,97,Florida,Osceola County,13,5,18119,9213,8906
50,12,97,Florida,Osceola County,13,6,17508,8874,8634
50,12,97,Florida,Osceola County,13,7,17944,8728,9216
50,12,97,Florida,Osceola County,13,8,19362,9309,10053
50,12,97,Florida,Osceola County,13,9,20161,9744,10417
50,12,97,Florida,Osceola County,13,10,20602,10092,10510
50,12,97,Florida,Osceola County,13,11,18406,8858,9548
50,12,97,Florida,Osceola County,13,12,15511,7355,8156
50,12,97,Florida,Osceola County,13,13,13514,6315,7199
50,12,97,Florida,Osceola County,13,14,10305,4828,5477
50,12,97,Florida,Osceola County,13,15,7443,3519,3924
50,12,97,Florida,Osceola County,13,16,5314,2403,2911
50,12,97,Florida,Osceola County,13,17,3694,1591,2103
50,12,97,Florida,Osceola County,13,18,3087,1002,2085
50,12,97,Florida,Osceola County,13,99,269837,132208,137629
50,12,99,Florida,Palm Beach County,1,0,12287,6283,6004
50,12,99,Florida,Palm Beach County,1,1,50625,25962,24663
50,12,99,Florida,Palm Beach County,1,2,68649,35372,33277
50,12,99,Florida,Palm Beach County,1,3,70158,36047,34111
50,12,99,Florida,Palm Beach County,1,4,61739,31982,29757
50,12,99,Florida,Palm Beach County,1,5,51321,26452,24869
50,12,99,Florida,Palm Beach County,1,6,60565,30539,30026
50,12,99,Florida,Palm Beach County,1,7,72460,35888,36572
50,12,99,Florida,Palm Beach County,1,8,86509,43146,43363
50,12,99,Florida,Palm Beach County,1,9,85511,42661,42850
50,12,99,Florida,Palm Beach County,1,10,74355,36649,37706
50,12,99,Florida,Palm Beach County,1,11,66688,31948,34740
50,12,99,Florida,Palm Beach County,1,12,56858,26542,30316
50,12,99,Florida,Palm Beach County,1,13,51397,23064,28333
50,12,99,Florida,Palm Beach County,1,14,56833,25118,31715
50,12,99,Florida,Palm Beach County,1,15,65888,29410,36478
50,12,99,Florida,Palm Beach County,1,16,61036,27295,33741
50,12,99,Florida,Palm Beach County,1,17,43347,18970,24377
50,12,99,Florida,Palm Beach County,1,18,34963,13412,21551
50,12,99,Florida,Palm Beach County,1,99,1131189,546740,584449
50,12,99,Florida,Palm Beach County,2,0,12451,6365,6086
50,12,99,Florida,Palm Beach County,2,1,50533,25912,24621
50,12,99,Florida,Palm Beach County,2,2,68434,35253,33181
50,12,99,Florida,Palm Beach County,2,3,70726,36322,34404
50,12,99,Florida,Palm Beach County,2,4,62041,32143,29898
50,12,99,Florida,Palm Beach County,2,5,51885,26772,25113
50,12,99,Florida,Palm Beach County,2,6,60385,30445,29940
50,12,99,Florida,Palm Beach County,2,7,72682,35989,36693
50,12,99,Florida,Palm Beach County,2,8,86511,43137,43374
50,12,99,Florida,Palm Beach County,2,9,85998,42907,43091
50,12,99,Florida,Palm Beach County,2,10,74958,36956,38002
50,12,99,Florida,Palm Beach County,2,11,67524,32353,35171
50,12,99,Florida,Palm Beach County,2,12,57369,26788,30581
50,12,99,Florida,Palm Beach County,2,13,51758,23240,28518
50,12,99,Florida,Palm Beach County,2,14,56716,25068,31648
50,12,99,Florida,Palm Beach County,2,15,65880,29469,36411
50,12,99,Florida,Palm Beach County,2,16,61143,27380,33763
50,12,99,Florida,Palm Beach County,2,17,43650,19123,24527
50,12,99,Florida,Palm Beach County,2,18,35143,13496,21647
50,12,99,Florida,Palm Beach County,2,99,1135787,549118,586669
50,12,99,Florida,Palm Beach County,3,0,13326,6705,6621
50,12,99,Florida,Palm Beach County,3,1,50873,26113,24760
50,12,99,Florida,Palm Beach County,3,2,68150,34886,33264
50,12,99,Florida,Palm Beach County,3,3,73646,37917,35729
50,12,99,Florida,Palm Beach County,3,4,64492,33327,31165
50,12,99,Florida,Palm Beach County,3,5,54957,28400,26557
50,12,99,Florida,Palm Beach County,3,6,58993,29925,29068
50,12,99,Florida,Palm Beach County,3,7,73681,36310,37371
50,12,99,Florida,Palm Beach County,3,8,86098,42941,43157
50,12,99,Florida,Palm Beach County,3,9,88985,44301,44684
50,12,99,Florida,Palm Beach County,3,10,77737,38322,39415
50,12,99,Florida,Palm Beach County,3,11,71275,34149,37126
50,12,99,Florida,Palm Beach County,3,12,60041,27987,32054
50,12,99,Florida,Palm Beach County,3,13,53785,24206,29579
50,12,99,Florida,Palm Beach County,3,14,55737,24708,31029
50,12,99,Florida,Palm Beach County,3,15,65947,29394,36553
50,12,99,Florida,Palm Beach County,3,16,61431,27664,33767
50,12,99,Florida,Palm Beach County,3,17,45307,19823,25484
50,12,99,Florida,Palm Beach County,3,18,36013,13872,22141
50,12,99,Florida,Palm Beach County,3,99,1160474,560950,599524
50,12,99,Florida,Palm Beach County,4,0,13617,6933,6684
50,12,99,Florida,Palm Beach County,4,1,52128,26670,25458
50,12,99,Florida,Palm Beach County,4,2,68597,35151,33446
50,12,99,Florida,Palm Beach County,4,3,75788,38882,36906
50,12,99,Florida,Palm Beach County,4,4,67225,34684,32541
50,12,99,Florida,Palm Beach County,4,5,58112,29851,28261
50,12,99,Florida,Palm Beach County,4,6,59978,30608,29370
50,12,99,Florida,Palm Beach County,4,7,74771,36986,37785
50,12,99,Florida,Palm Beach County,4,8,86096,42627,43469
50,12,99,Florida,Palm Beach County,4,9,91126,45548,45578
50,12,99,Florida,Palm Beach County,4,10,81913,40245,41668
50,12,99,Florida,Palm Beach County,4,11,72425,34763,37662
50,12,99,Florida,Palm Beach County,4,12,65379,30430,34949
50,12,99,Florida,Palm Beach County,4,13,56565,25440,31125
50,12,99,Florida,Palm Beach County,4,14,56070,24904,31166
50,12,99,Florida,Palm Beach County,4,15,65411,29132,36279
50,12,99,Florida,Palm Beach County,4,16,61884,27902,33982
50,12,99,Florida,Palm Beach County,4,17,47161,20731,26430
50,12,99,Florida,Palm Beach County,4,18,37094,14274,22820
50,12,99,Florida,Palm Beach County,4,99,1191340,575761,615579
50,12,99,Florida,Palm Beach County,5,0,13720,6958,6762
50,12,99,Florida,Palm Beach County,5,1,53960,27741,26219
50,12,99,Florida,Palm Beach County,5,2,69052,35273,33779
50,12,99,Florida,Palm Beach County,5,3,77021,39571,37450
50,12,99,Florida,Palm Beach County,5,4,69856,35977,33879
50,12,99,Florida,Palm Beach County,5,5,61913,32037,29876
50,12,99,Florida,Palm Beach County,5,6,61343,31303,30040
50,12,99,Florida,Palm Beach County,5,7,75463,37366,38097
50,12,99,Florida,Palm Beach County,5,8,85429,42172,43257
50,12,99,Florida,Palm Beach County,5,9,92562,46252,46310
50,12,99,Florida,Palm Beach County,5,10,85844,42129,43715
50,12,99,Florida,Palm Beach County,5,11,74421,35889,38532
50,12,99,Florida,Palm Beach County,5,12,67963,31624,36339
50,12,99,Florida,Palm Beach County,5,13,60761,27422,33339
50,12,99,Florida,Palm Beach County,5,14,56787,25101,31686
50,12,99,Florida,Palm Beach County,5,15,63602,28191,35411
50,12,99,Florida,Palm Beach County,5,16,62191,28102,34089
50,12,99,Florida,Palm Beach County,5,17,47831,21053,26778
50,12,99,Florida,Palm Beach County,5,18,38381,14870,23511
50,12,99,Florida,Palm Beach County,5,99,1218100,589031,629069
50,12,99,Florida,Palm Beach County,6,0,14274,7376,6898
50,12,99,Florida,Palm Beach County,6,1,55939,28728,27211
50,12,99,Florida,Palm Beach County,6,2,69753,35582,34171
50,12,99,Florida,Palm Beach County,6,3,78852,40569,38283
50,12,99,Florida,Palm Beach County,6,4,73398,37912,35486
50,12,99,Florida,Palm Beach County,6,5,65338,33873,31465
50,12,99,Florida,Palm Beach County,6,6,64217,32780,31437
50,12,99,Florida,Palm Beach County,6,7,75708,37551,38157
50,12,99,Florida,Palm Beach County,6,8,85480,42143,43337
50,12,99,Florida,Palm Beach County,6,9,95103,47431,47672
50,12,99,Florida,Palm Beach County,6,10,89532,43859,45673
50,12,99,Florida,Palm Beach County,6,11,77547,37424,40123
50,12,99,Florida,Palm Beach County,6,12,71617,33389,38228
50,12,99,Florida,Palm Beach County,6,13,64101,29169,34932
50,12,99,Florida,Palm Beach County,6,14,58163,25690,32473
50,12,99,Florida,Palm Beach County,6,15,61878,27511,34367
50,12,99,Florida,Palm Beach County,6,16,62562,28189,34373
50,12,99,Florida,Palm Beach County,6,17,49057,21565,27492
50,12,99,Florida,Palm Beach County,6,18,39704,15465,24239
50,12,99,Florida,Palm Beach County,6,99,1252223,606206,646017
50,12,99,Florida,Palm Beach County,7,0,14353,7306,7047
50,12,99,Florida,Palm Beach County,7,1,57635,29644,27991
50,12,99,Florida,Palm Beach County,7,2,70275,36013,34262
50,12,99,Florida,Palm Beach County,7,3,79025,40524,38501
50,12,99,Florida,Palm Beach County,7,4,76748,39526,37222
50,12,99,Florida,Palm Beach County,7,5,67270,35008,32262
50,12,99,Florida,Palm Beach County,7,6,66805,34129,32676
50,12,99,Florida,Palm Beach County,7,7,74373,36939,37434
50,12,99,Florida,Palm Beach County,7,8,85898,42129,43769
50,12,99,Florida,Palm Beach County,7,9,96331,47998,48333
50,12,99,Florida,Palm Beach County,7,10,92595,45536,47059
50,12,99,Florida,Palm Beach County,7,11,80806,39028,41778
50,12,99,Florida,Palm Beach County,7,12,75543,35280,40263
50,12,99,Florida,Palm Beach County,7,13,66958,30488,36470
50,12,99,Florida,Palm Beach County,7,14,59518,26334,33184
50,12,99,Florida,Palm Beach County,7,15,60538,26945,33593
50,12,99,Florida,Palm Beach County,7,16,62699,28175,34524
50,12,99,Florida,Palm Beach County,7,17,50009,21939,28070
50,12,99,Florida,Palm Beach County,7,18,41001,16212,24789
50,12,99,Florida,Palm Beach County,7,99,1278380,619153,659227
50,12,99,Florida,Palm Beach County,8,0,14601,7490,7111
50,12,99,Florida,Palm Beach County,8,1,57276,29367,27909
50,12,99,Florida,Palm Beach County,8,2,70484,36130,34354
50,12,99,Florida,Palm Beach County,8,3,78200,39994,38206
50,12,99,Florida,Palm Beach County,8,4,78671,40620,38051
50,12,99,Florida,Palm Beach County,8,5,68496,35682,32814
50,12,99,Florida,Palm Beach County,8,6,69158,35135,34023
50,12,99,Florida,Palm Beach County,8,7,71730,35640,36090
50,12,99,Florida,Palm Beach County,8,8,85456,41907,43549
50,12,99,Florida,Palm Beach County,8,9,94644,46999,47645
50,12,99,Florida,Palm Beach County,8,10,94261,46519,47742
50,12,99,Florida,Palm Beach County,8,11,82753,40164,42589
50,12,99,Florida,Palm Beach County,8,12,78496,36644,41852
50,12,99,Florida,Palm Beach County,8,13,68762,31395,37367
50,12,99,Florida,Palm Beach County,8,14,59938,26549,33389
50,12,99,Florida,Palm Beach County,8,15,58326,26025,32301
50,12,99,Florida,Palm Beach County,8,16,61310,27364,33946
50,12,99,Florida,Palm Beach County,8,17,49511,21797,27714
50,12,99,Florida,Palm Beach County,8,18,42416,16806,25610
50,12,99,Florida,Palm Beach County,8,99,1284489,622227,662262
50,12,99,Florida,Palm Beach County,9,0,14664,7438,7226
50,12,99,Florida,Palm Beach County,9,1,56424,28905,27519
50,12,99,Florida,Palm Beach County,9,2,70552,35977,34575
50,12,99,Florida,Palm Beach County,9,3,76902,39373,37529
50,12,99,Florida,Palm Beach County,9,4,79216,40928,38288
50,12,99,Florida,Palm Beach County,9,5,69856,36657,33199
50,12,99,Florida,Palm Beach County,9,6,70363,35659,34704
50,12,99,Florida,Palm Beach County,9,7,69662,34840,34822
50,12,99,Florida,Palm Beach County,9,8,83703,41097,42606
50,12,99,Florida,Palm Beach County,9,9,91855,45436,46419
50,12,99,Florida,Palm Beach County,9,10,94491,46723,47768
50,12,99,Florida,Palm Beach County,9,11,84938,41276,43662
50,12,99,Florida,Palm Beach County,9,12,77873,36534,41339
50,12,99,Florida,Palm Beach County,9,13,72321,32976,39345
50,12,99,Florida,Palm Beach County,9,14,62156,27638,34518
50,12,99,Florida,Palm Beach County,9,15,57726,25836,31890
50,12,99,Florida,Palm Beach County,9,16,59927,26687,33240
50,12,99,Florida,Palm Beach County,9,17,49637,21767,27870
50,12,99,Florida,Palm Beach County,9,18,44320,17710,26610
50,12,99,Florida,Palm Beach County,9,99,1286586,623457,663129
50,12,99,Florida,Palm Beach County,10,0,14233,7271,6962
50,12,99,Florida,Palm Beach County,10,1,56513,28768,27745
50,12,99,Florida,Palm Beach County,10,2,71063,36407,34656
50,12,99,Florida,Palm Beach County,10,3,76469,39018,37451
50,12,99,Florida,Palm Beach County,10,4,79426,40979,38447
50,12,99,Florida,Palm Beach County,10,5,70813,36978,33835
50,12,99,Florida,Palm Beach County,10,6,71974,36678,35296
50,12,99,Florida,Palm Beach County,10,7,69379,34713,34666
50,12,99,Florida,Palm Beach County,10,8,82491,40560,41931
50,12,99,Florida,Palm Beach County,10,9,89477,44050,45427
50,12,99,Florida,Palm Beach County,10,10,94717,46720,47997
50,12,99,Florida,Palm Beach County,10,11,87824,42743,45081
50,12,99,Florida,Palm Beach County,10,12,78175,36902,41273
50,12,99,Florida,Palm Beach County,10,13,73640,33600,40040
50,12,99,Florida,Palm Beach County,10,14,65952,29302,36650
50,12,99,Florida,Palm Beach County,10,15,58295,26097,32198
50,12,99,Florida,Palm Beach County,10,16,57978,25654,32324
50,12,99,Florida,Palm Beach County,10,17,50271,22071,28200
50,12,99,Florida,Palm Beach County,10,18,46248,18591,27657
50,12,99,Florida,Palm Beach County,10,99,1294938,627102,667836
50,12,99,Florida,Palm Beach County,11,0,13673,7051,6622
50,12,99,Florida,Palm Beach County,11,1,56540,28610,27930
50,12,99,Florida,Palm Beach County,11,2,72378,37020,35358
50,12,99,Florida,Palm Beach County,11,3,76517,39154,37363
50,12,99,Florida,Palm Beach County,11,4,79727,41103,38624
50,12,99,Florida,Palm Beach County,11,5,72187,37827,34360
50,12,99,Florida,Palm Beach County,11,6,73634,37554,36080
50,12,99,Florida,Palm Beach County,11,7,70859,35210,35649
50,12,99,Florida,Palm Beach County,11,8,80678,39875,40803
50,12,99,Florida,Palm Beach County,11,9,87106,42884,44222
50,12,99,Florida,Palm Beach County,11,10,95604,46868,48736
50,12,99,Florida,Palm Beach County,11,11,90264,43947,46317
50,12,99,Florida,Palm Beach County,11,12,79857,37780,42077
50,12,99,Florida,Palm Beach County,11,13,76084,34730,41354
50,12,99,Florida,Palm Beach County,11,14,68613,30748,37865
50,12,99,Florida,Palm Beach County,11,15,58985,26329,32656
50,12,99,Florida,Palm Beach County,11,16,56004,24783,31221
50,12,99,Florida,Palm Beach County,11,17,50587,22119,28468
50,12,99,Florida,Palm Beach County,11,18,48074,19370,28704
50,12,99,Florida,Palm Beach County,11,99,1307371,632962,674409
50,12,99,Florida,Palm Beach County,12,0,13498,6968,6530
50,12,99,Florida,Palm Beach County,12,1,57354,29057,28297
50,12,99,Florida,Palm Beach County,12,2,72847,37131,35716
50,12,99,Florida,Palm Beach County,12,3,76917,39321,37596
50,12,99,Florida,Palm Beach County,12,4,79570,40975,38595
50,12,99,Florida,Palm Beach County,12,5,74105,38722,35383
50,12,99,Florida,Palm Beach County,12,6,74695,38232,36463
50,12,99,Florida,Palm Beach County,12,7,71999,35868,36131
50,12,99,Florida,Palm Beach County,12,8,78802,38852,39950
50,12,99,Florida,Palm Beach County,12,9,86774,42587,44187
50,12,99,Florida,Palm Beach County,12,10,95732,46791,48941
50,12,99,Florida,Palm Beach County,12,11,92394,45090,47304
50,12,99,Florida,Palm Beach County,12,12,81829,38714,43115
50,12,99,Florida,Palm Beach County,12,13,78463,35986,42477
50,12,99,Florida,Palm Beach County,12,14,70465,31626,38839
50,12,99,Florida,Palm Beach County,12,15,59962,26773,33189
50,12,99,Florida,Palm Beach County,12,16,54879,24318,30561
50,12,99,Florida,Palm Beach County,12,17,50644,22054,28590
50,12,99,Florida,Palm Beach County,12,18,49205,19823,29382
50,12,99,Florida,Palm Beach County,12,99,1320134,638888,681246
50,12,99,Florida,Palm Beach County,13,0,13544,6991,6553
50,12,99,Florida,Palm Beach County,13,1,57388,29072,28316
50,12,99,Florida,Palm Beach County,13,2,72983,37186,35797
50,12,99,Florida,Palm Beach County,13,3,76949,39327,37622
50,12,99,Florida,Palm Beach County,13,4,79273,40834,38439
50,12,99,Florida,Palm Beach County,13,5,74464,38912,35552
50,12,99,Florida,Palm Beach County,13,6,74866,38379,36487
50,12,99,Florida,Palm Beach County,13,7,72469,36106,36363
50,12,99,Florida,Palm Beach County,13,8,78478,38712,39766
50,12,99,Florida,Palm Beach County,13,9,86812,42610,44202
50,12,99,Florida,Palm Beach County,13,10,95537,46706,48831
50,12,99,Florida,Palm Beach County,13,11,92732,45255,47477
50,12,99,Florida,Palm Beach County,13,12,82319,38951,43368
50,12,99,Florida,Palm Beach County,13,13,79317,36381,42936
50,12,99,Florida,Palm Beach County,13,14,70953,31862,39091
50,12,99,Florida,Palm Beach County,13,15,60266,26926,33340
50,12,99,Florida,Palm Beach County,13,16,54806,24316,30490
50,12,99,Florida,Palm Beach County,13,17,50684,22118,28566
50,12,99,Florida,Palm Beach County,13,18,49554,20006,29548
50,12,99,Florida,Palm Beach County,13,99,1323394,640650,682744
50,12,101,Florida,Pasco County,1,0,3443,1812,1631
50,12,101,Florida,Pasco County,1,1,14696,7506,7190
50,12,101,Florida,Pasco County,1,2,19715,10122,9593
50,12,101,Florida,Pasco County,1,3,20371,10478,9893
50,12,101,Florida,Pasco County,1,4,17943,9270,8673
50,12,101,Florida,Pasco County,1,5,13508,6679,6829
50,12,101,Florida,Pasco County,1,6,16028,7892,8136
50,12,101,Florida,Pasco County,1,7,19779,9862,9917
50,12,101,Florida,Pasco County,1,8,24007,11977,12030
50,12,101,Florida,Pasco County,1,9,23314,11542,11772
50,12,101,Florida,Pasco County,1,10,21024,10177,10847
50,12,101,Florida,Pasco County,1,11,20713,9796,10917
50,12,101,Florida,Pasco County,1,12,18940,8822,10118
50,12,101,Florida,Pasco County,1,13,18897,8658,10239
50,12,101,Florida,Pasco County,1,14,21146,9731,11415
50,12,101,Florida,Pasco County,1,15,23477,10797,12680
50,12,101,Florida,Pasco County,1,16,21763,9612,12151
50,12,101,Florida,Pasco County,1,17,15162,6554,8608
50,12,101,Florida,Pasco County,1,18,10823,4122,6701
50,12,101,Florida,Pasco County,1,99,344749,165409,179340
50,12,101,Florida,Pasco County,2,0,3510,1847,1663
50,12,101,Florida,Pasco County,2,1,14783,7550,7233
50,12,101,Florida,Pasco County,2,2,19799,10170,9629
50,12,101,Florida,Pasco County,2,3,20618,10603,10015
50,12,101,Florida,Pasco County,2,4,18132,9374,8758
50,12,101,Florida,Pasco County,2,5,13745,6796,6949
50,12,101,Florida,Pasco County,2,6,16005,7882,8123
50,12,101,Florida,Pasco County,2,7,19919,9933,9986
50,12,101,Florida,Pasco County,2,8,24083,12020,12063
50,12,101,Florida,Pasco County,2,9,23537,11650,11887
50,12,101,Florida,Pasco County,2,10,21314,10320,10994
50,12,101,Florida,Pasco County,2,11,21107,9991,11116
50,12,101,Florida,Pasco County,2,12,19231,8960,10271
50,12,101,Florida,Pasco County,2,13,19138,8772,10366
50,12,101,Florida,Pasco County,2,14,21003,9673,11330
50,12,101,Florida,Pasco County,2,15,23378,10773,12605
50,12,101,Florida,Pasco County,2,16,21709,9598,12111
50,12,101,Florida,Pasco County,2,17,15201,6581,8620
50,12,101,Florida,Pasco County,2,18,10826,4128,6698
50,12,101,Florida,Pasco County,2,99,347038,166621,180417
50,12,101,Florida,Pasco County,3,0,3809,1931,1878
50,12,101,Florida,Pasco County,3,1,15147,7773,7374
50,12,101,Florida,Pasco County,3,2,20452,10384,10068
50,12,101,Florida,Pasco County,3,3,21633,11130,10503
50,12,101,Florida,Pasco County,3,4,18775,9742,9033
50,12,101,Florida,Pasco County,3,5,15087,7441,7646
50,12,101,Florida,Pasco County,3,6,15835,7761,8074
50,12,101,Florida,Pasco County,3,7,20782,10345,10437
50,12,101,Florida,Pasco County,3,8,24443,12259,12184
50,12,101,Florida,Pasco County,3,9,24873,12322,12551
50,12,101,Florida,Pasco County,3,10,22421,10882,11539
50,12,101,Florida,Pasco County,3,11,22579,10666,11913
50,12,101,Florida,Pasco County,3,12,20226,9438,10788
50,12,101,Florida,Pasco County,3,13,19740,9075,10665
50,12,101,Florida,Pasco County,3,14,21019,9792,11227
50,12,101,Florida,Pasco County,3,15,23364,10730,12634
50,12,101,Florida,Pasco County,3,16,21289,9466,11823
50,12,101,Florida,Pasco County,3,17,15405,6683,8722
50,12,101,Florida,Pasco County,3,18,10774,4073,6701
50,12,101,Florida,Pasco County,3,99,357653,171893,185760
50,12,101,Florida,Pasco County,4,0,3946,2006,1940
50,12,101,Florida,Pasco County,4,1,15890,8183,7707
50,12,101,Florida,Pasco County,4,2,21158,10780,10378
50,12,101,Florida,Pasco County,4,3,22825,11752,11073
50,12,101,Florida,Pasco County,4,4,19605,10161,9444
50,12,101,Florida,Pasco County,4,5,16160,8053,8107
50,12,101,Florida,Pasco County,4,6,16235,7942,8293
50,12,101,Florida,Pasco County,4,7,21515,10685,10830
50,12,101,Florida,Pasco County,4,8,24879,12509,12370
50,12,101,Florida,Pasco County,4,9,26298,12950,13348
50,12,101,Florida,Pasco County,4,10,23707,11536,12171
50,12,101,Florida,Pasco County,4,11,23016,10927,12089
50,12,101,Florida,Pasco County,4,12,22200,10333,11867
50,12,101,Florida,Pasco County,4,13,20557,9532,11025
50,12,101,Florida,Pasco County,4,14,21321,10042,11279
50,12,101,Florida,Pasco County,4,15,22904,10558,12346
50,12,101,Florida,Pasco County,4,16,20989,9411,11578
50,12,101,Florida,Pasco County,4,17,15497,6611,8886
50,12,101,Florida,Pasco County,4,18,10963,4190,6773
50,12,101,Florida,Pasco County,4,99,369665,178161,191504
50,12,101,Florida,Pasco County,5,0,3964,1979,1985
50,12,101,Florida,Pasco County,5,1,16786,8613,8173
50,12,101,Florida,Pasco County,5,2,21687,11112,10575
50,12,101,Florida,Pasco County,5,3,23777,12184,11593
50,12,101,Florida,Pasco County,5,4,21014,10779,10235
50,12,101,Florida,Pasco County,5,5,17416,8781,8635
50,12,101,Florida,Pasco County,5,6,17185,8476,8709
50,12,101,Florida,Pasco County,5,7,22431,11121,11310
50,12,101,Florida,Pasco County,5,8,25249,12630,12619
50,12,101,Florida,Pasco County,5,9,27600,13725,13875
50,12,101,Florida,Pasco County,5,10,25452,12383,13069
50,12,101,Florida,Pasco County,5,11,23854,11321,12533
50,12,101,Florida,Pasco County,5,12,23561,11011,12550
50,12,101,Florida,Pasco County,5,13,22244,10258,11986
50,12,101,Florida,Pasco County,5,14,21511,10154,11357
50,12,101,Florida,Pasco County,5,15,22429,10400,12029
50,12,101,Florida,Pasco County,5,16,20772,9434,11338
50,12,101,Florida,Pasco County,5,17,15209,6513,8696
50,12,101,Florida,Pasco County,5,18,11097,4216,6881
50,12,101,Florida,Pasco County,5,99,383238,185090,198148
50,12,101,Florida,Pasco County,6,0,4349,2215,2134
50,12,101,Florida,Pasco County,6,1,17652,8917,8735
50,12,101,Florida,Pasco County,6,2,22884,11725,11159
50,12,101,Florida,Pasco County,6,3,24829,12746,12083
50,12,101,Florida,Pasco County,6,4,22676,11745,10931
50,12,101,Florida,Pasco County,6,5,18585,9416,9169
50,12,101,Florida,Pasco County,6,6,18728,9226,9502
50,12,101,Florida,Pasco County,6,7,23765,11736,12029
50,12,101,Florida,Pasco County,6,8,26086,13015,13071
50,12,101,Florida,Pasco County,6,9,29333,14632,14701
50,12,101,Florida,Pasco County,6,10,27244,13316,13928
50,12,101,Florida,Pasco County,6,11,25103,11919,13184
50,12,101,Florida,Pasco County,6,12,25507,11912,13595
50,12,101,Florida,Pasco County,6,13,23852,11147,12705
50,12,101,Florida,Pasco County,6,14,22193,10490,11703
50,12,101,Florida,Pasco County,6,15,22086,10286,11800
50,12,101,Florida,Pasco County,6,16,20557,9400,11157
50,12,101,Florida,Pasco County,6,17,15185,6486,8699
50,12,101,Florida,Pasco County,6,18,11034,4188,6846
50,12,101,Florida,Pasco County,6,99,401648,194517,207131
50,12,101,Florida,Pasco County,7,0,4670,2300,2370
50,12,101,Florida,Pasco County,7,1,18549,9356,9193
50,12,101,Florida,Pasco County,7,2,24265,12546,11719
50,12,101,Florida,Pasco County,7,3,25943,13278,12665
50,12,101,Florida,Pasco County,7,4,24112,12505,11607
50,12,101,Florida,Pasco County,7,5,19561,9861,9700
50,12,101,Florida,Pasco County,7,6,20424,9952,10472
50,12,101,Florida,Pasco County,7,7,24790,12280,12510
50,12,101,Florida,Pasco County,7,8,27670,13847,13823
50,12,101,Florida,Pasco County,7,9,30813,15322,15491
50,12,101,Florida,Pasco County,7,10,29300,14373,14927
50,12,101,Florida,Pasco County,7,11,26818,12846,13972
50,12,101,Florida,Pasco County,7,12,27483,12791,14692
50,12,101,Florida,Pasco County,7,13,25309,11910,13399
50,12,101,Florida,Pasco County,7,14,23248,10967,12281
50,12,101,Florida,Pasco County,7,15,22015,10387,11628
50,12,101,Florida,Pasco County,7,16,20365,9352,11013
50,12,101,Florida,Pasco County,7,17,15221,6510,8711
50,12,101,Florida,Pasco County,7,18,11288,4356,6932
50,12,101,Florida,Pasco County,7,99,421844,204739,217105
50,12,101,Florida,Pasco County,8,0,4968,2501,2467
50,12,101,Florida,Pasco County,8,1,19452,9699,9753
50,12,101,Florida,Pasco County,8,2,25593,13171,12422
50,12,101,Florida,Pasco County,8,3,26923,13795,13128
50,12,101,Florida,Pasco County,8,4,25587,13257,12330
50,12,101,Florida,Pasco County,8,5,20474,10339,10135
50,12,101,Florida,Pasco County,8,6,22318,10886,11432
50,12,101,Florida,Pasco County,8,7,25242,12433,12809
50,12,101,Florida,Pasco County,8,8,29511,14797,14714
50,12,101,Florida,Pasco County,8,9,31766,15863,15903
50,12,101,Florida,Pasco County,8,10,31439,15509,15930
50,12,101,Florida,Pasco County,8,11,28058,13431,14627
50,12,101,Florida,Pasco County,8,12,29361,13597,15764
50,12,101,Florida,Pasco County,8,13,26409,12447,13962
50,12,101,Florida,Pasco County,8,14,24088,11328,12760
50,12,101,Florida,Pasco County,8,15,21854,10442,11412
50,12,101,Florida,Pasco County,8,16,19929,9184,10745
50,12,101,Florida,Pasco County,8,17,14999,6491,8508
50,12,101,Florida,Pasco County,8,18,11558,4411,7147
50,12,101,Florida,Pasco County,8,99,439529,213581,225948
50,12,101,Florida,Pasco County,9,0,5211,2655,2556
50,12,101,Florida,Pasco County,9,1,20338,10264,10074
50,12,101,Florida,Pasco County,9,2,26623,13702,12921
50,12,101,Florida,Pasco County,9,3,27680,14232,13448
50,12,101,Florida,Pasco County,9,4,26845,13885,12960
50,12,101,Florida,Pasco County,9,5,21630,10908,10722
50,12,101,Florida,Pasco County,9,6,24016,11696,12320
50,12,101,Florida,Pasco County,9,7,25830,12650,13180
50,12,101,Florida,Pasco County,9,8,30770,15465,15305
50,12,101,Florida,Pasco County,9,9,32029,15986,16043
50,12,101,Florida,Pasco County,9,10,32860,16281,16579
50,12,101,Florida,Pasco County,9,11,29322,14075,15247
50,12,101,Florida,Pasco County,9,12,29365,13680,15685
50,12,101,Florida,Pasco County,9,13,28300,13185,15115
50,12,101,Florida,Pasco County,9,14,25050,11776,13274
50,12,101,Florida,Pasco County,9,15,21867,10450,11417
50,12,101,Florida,Pasco County,9,16,19460,8980,10480
50,12,101,Florida,Pasco County,9,17,14579,6426,8153
50,12,101,Florida,Pasco County,9,18,11804,4499,7305
50,12,101,Florida,Pasco County,9,99,453579,220795,232784
50,12,101,Florida,Pasco County,10,0,5196,2660,2536
50,12,101,Florida,Pasco County,10,1,20939,10660,10279
50,12,101,Florida,Pasco County,10,2,27243,13985,13258
50,12,101,Florida,Pasco County,10,3,28200,14527,13673
50,12,101,Florida,Pasco County,10,4,27560,14164,13396
50,12,101,Florida,Pasco County,10,5,21947,10981,10966
50,12,101,Florida,Pasco County,10,6,24327,11835,12492
50,12,101,Florida,Pasco County,10,7,25639,12410,13229
50,12,101,Florida,Pasco County,10,8,31097,15484,15613
50,12,101,Florida,Pasco County,10,9,31829,15921,15908
50,12,101,Florida,Pasco County,10,10,33676,16651,17025
50,12,101,Florida,Pasco County,10,11,30580,14687,15893
50,12,101,Florida,Pasco County,10,12,29279,13701,15578
50,12,101,Florida,Pasco County,10,13,29252,13625,15627
50,12,101,Florida,Pasco County,10,14,26547,12443,14104
50,12,101,Florida,Pasco County,10,15,22259,10621,11638
50,12,101,Florida,Pasco County,10,16,19080,8807,10273
50,12,101,Florida,Pasco County,10,17,14578,6468,8110
50,12,101,Florida,Pasco County,10,18,12085,4600,7485
50,12,101,Florida,Pasco County,10,99,461313,224230,237083
50,12,101,Florida,Pasco County,11,0,4903,2491,2412
50,12,101,Florida,Pasco County,11,1,21195,10931,10264
50,12,101,Florida,Pasco County,11,2,26874,13791,13083
50,12,101,Florida,Pasco County,11,3,28292,14502,13790
50,12,101,Florida,Pasco County,11,4,27551,14188,13363
50,12,101,Florida,Pasco County,11,5,22078,11086,10992
50,12,101,Florida,Pasco County,11,6,23810,11624,12186
50,12,101,Florida,Pasco County,11,7,25591,12413,13178
50,12,101,Florida,Pasco County,11,8,30488,15109,15379
50,12,101,Florida,Pasco County,11,9,31189,15450,15739
50,12,101,Florida,Pasco County,11,10,34232,17094,17138
50,12,101,Florida,Pasco County,11,11,31462,15068,16394
50,12,101,Florida,Pasco County,11,12,29252,13682,15570
50,12,101,Florida,Pasco County,11,13,30167,14084,16083
50,12,101,Florida,Pasco County,11,14,27521,12873,14648
50,12,101,Florida,Pasco County,11,15,22694,10835,11859
50,12,101,Florida,Pasco County,11,16,18608,8634,9974
50,12,101,Florida,Pasco County,11,17,14339,6388,7951
50,12,101,Florida,Pasco County,11,18,12361,4686,7675
50,12,101,Florida,Pasco County,11,99,462607,224929,237678
50,12,101,Florida,Pasco County,12,0,4738,2398,2340
50,12,101,Florida,Pasco County,12,1,20926,10830,10096
50,12,101,Florida,Pasco County,12,2,27278,13942,13336
50,12,101,Florida,Pasco County,12,3,28407,14579,13828
50,12,101,Florida,Pasco County,12,4,27637,14236,13401
50,12,101,Florida,Pasco County,12,5,22191,11132,11059
50,12,101,Florida,Pasco County,12,6,23419,11393,12026
50,12,101,Florida,Pasco County,12,7,25788,12554,13234
50,12,101,Florida,Pasco County,12,8,29570,14545,15025
50,12,101,Florida,Pasco County,12,9,31141,15495,15646
50,12,101,Florida,Pasco County,12,10,34321,17082,17239
50,12,101,Florida,Pasco County,12,11,32273,15607,16666
50,12,101,Florida,Pasco County,12,12,29605,13847,15758
50,12,101,Florida,Pasco County,12,13,31158,14450,16708
50,12,101,Florida,Pasco County,12,14,27934,13124,14810
50,12,101,Florida,Pasco County,12,15,22936,10890,12046
50,12,101,Florida,Pasco County,12,16,18525,8622,9903
50,12,101,Florida,Pasco County,12,17,14297,6405,7892
50,12,101,Florida,Pasco County,12,18,12553,4755,7798
50,12,101,Florida,Pasco County,12,99,464697,225886,238811
50,12,101,Florida,Pasco County,13,0,4751,2404,2347
50,12,101,Florida,Pasco County,13,1,20897,10813,10084
50,12,101,Florida,Pasco County,13,2,27310,13952,13358
50,12,101,Florida,Pasco County,13,3,28408,14568,13840
50,12,101,Florida,Pasco County,13,4,27510,14175,13335
50,12,101,Florida,Pasco County,13,5,22270,11171,11099
50,12,101,Florida,Pasco County,13,6,23477,11444,12033
50,12,101,Florida,Pasco County,13,7,25961,12642,13319
50,12,101,Florida,Pasco County,13,8,29381,14455,14926
50,12,101,Florida,Pasco County,13,9,31135,15497,15638
50,12,101,Florida,Pasco County,13,10,34212,17032,17180
50,12,101,Florida,Pasco County,13,11,32356,15643,16713
50,12,101,Florida,Pasco County,13,12,29777,13928,15849
50,12,101,Florida,Pasco County,13,13,31486,14604,16882
50,12,101,Florida,Pasco County,13,14,28116,13217,14899
50,12,101,Florida,Pasco County,13,15,23051,10952,12099
50,12,101,Florida,Pasco County,13,16,18506,8628,9878
50,12,101,Florida,Pasco County,13,17,14301,6422,7879
50,12,101,Florida,Pasco County,13,18,12638,4798,7840
50,12,101,Florida,Pasco County,13,99,465543,226345,239198
50,12,103,Florida,Pinellas County,1,0,8901,4540,4361
50,12,103,Florida,Pinellas County,1,1,36450,18829,17621
50,12,103,Florida,Pinellas County,1,2,50785,26142,24643
50,12,103,Florida,Pinellas County,1,3,51669,26394,25275
50,12,103,Florida,Pinellas County,1,4,47388,24266,23122
50,12,103,Florida,Pinellas County,1,5,41431,20691,20740
50,12,103,Florida,Pinellas County,1,6,50600,25277,25323
50,12,103,Florida,Pinellas County,1,7,57874,29095,28779
50,12,103,Florida,Pinellas County,1,8,70837,35183,35654
50,12,103,Florida,Pinellas County,1,9,72641,35628,37013
50,12,103,Florida,Pinellas County,1,10,66795,32542,34253
50,12,103,Florida,Pinellas County,1,11,62427,30222,32205
50,12,103,Florida,Pinellas County,1,12,51091,23876,27215
50,12,103,Florida,Pinellas County,1,13,45035,20953,24082
50,12,103,Florida,Pinellas County,1,14,46769,21347,25422
50,12,103,Florida,Pinellas County,1,15,49779,21867,27912
50,12,103,Florida,Pinellas County,1,16,46315,19128,27187
50,12,103,Florida,Pinellas County,1,17,33758,13188,20570
50,12,103,Florida,Pinellas County,1,18,30955,9798,21157
50,12,103,Florida,Pinellas County,1,99,921500,438966,482534
50,12,103,Florida,Pinellas County,2,0,8976,4572,4404
50,12,103,Florida,Pinellas County,2,1,36305,18742,17563
50,12,103,Florida,Pinellas County,2,2,50516,25986,24530
50,12,103,Florida,Pinellas County,2,3,51882,26486,25396
50,12,103,Florida,Pinellas County,2,4,47476,24314,23162
50,12,103,Florida,Pinellas County,2,5,41756,20853,20903
50,12,103,Florida,Pinellas County,2,6,50198,25072,25126
50,12,103,Florida,Pinellas County,2,7,57841,29070,28771
50,12,103,Florida,Pinellas County,2,8,70565,35064,35501
50,12,103,Florida,Pinellas County,2,9,72826,35731,37095
50,12,103,Florida,Pinellas County,2,10,67190,32739,34451
50,12,103,Florida,Pinellas County,2,11,63095,30559,32536
50,12,103,Florida,Pinellas County,2,12,51431,24044,27387
50,12,103,Florida,Pinellas County,2,13,45263,21072,24191
50,12,103,Florida,Pinellas County,2,14,46399,21197,25202
50,12,103,Florida,Pinellas County,2,15,49505,21799,27706
50,12,103,Florida,Pinellas County,2,16,46159,19091,27068
50,12,103,Florida,Pinellas County,2,17,33818,13233,20585
50,12,103,Florida,Pinellas County,2,18,30949,9805,21144
50,12,103,Florida,Pinellas County,2,99,922150,439429,482721
50,12,103,Florida,Pinellas County,3,0,9622,4901,4721
50,12,103,Florida,Pinellas County,3,1,35609,18313,17296
50,12,103,Florida,Pinellas County,3,2,49295,25393,23902
50,12,103,Florida,Pinellas County,3,3,52904,26956,25948
50,12,103,Florida,Pinellas County,3,4,48088,24737,23351
50,12,103,Florida,Pinellas County,3,5,43641,21691,21950
50,12,103,Florida,Pinellas County,3,6,47881,24012,23869
50,12,103,Florida,Pinellas County,3,7,57652,28998,28654
50,12,103,Florida,Pinellas County,3,8,68524,34113,34411
50,12,103,Florida,Pinellas County,3,9,73902,36344,37558
50,12,103,Florida,Pinellas County,3,10,68740,33357,35383
50,12,103,Florida,Pinellas County,3,11,66243,32139,34104
50,12,103,Florida,Pinellas County,3,12,53076,24953,28123
50,12,103,Florida,Pinellas County,3,13,45896,21324,24572
50,12,103,Florida,Pinellas County,3,14,45493,20800,24693
50,12,103,Florida,Pinellas County,3,15,48432,21517,26915
50,12,103,Florida,Pinellas County,3,16,45090,18801,26289
50,12,103,Florida,Pinellas County,3,17,33552,13113,20439
50,12,103,Florida,Pinellas County,3,18,30210,9592,20618
50,12,103,Florida,Pinellas County,3,99,923850,441054,482796
50,12,103,Florida,Pinellas County,4,0,9079,4625,4454
50,12,103,Florida,Pinellas County,4,1,35883,18407,17476
50,12,103,Florida,Pinellas County,4,2,48097,24833,23264
50,12,103,Florida,Pinellas County,4,3,53815,27344,26471
50,12,103,Florida,Pinellas County,4,4,48547,25041,23506
50,12,103,Florida,Pinellas County,4,5,44637,22002,22635
50,12,103,Florida,Pinellas County,4,6,46969,23476,23493
50,12,103,Florida,Pinellas County,4,7,56923,28538,28385
50,12,103,Florida,Pinellas County,4,8,65909,32742,33167
50,12,103,Florida,Pinellas County,4,9,74101,36611,37490
50,12,103,Florida,Pinellas County,4,10,70727,34256,36471
50,12,103,Florida,Pinellas County,4,11,65882,31822,34060
50,12,103,Florida,Pinellas County,4,12,57604,27439,30165
50,12,103,Florida,Pinellas County,4,13,47485,21936,25549
50,12,103,Florida,Pinellas County,4,14,44679,20484,24195
50,12,103,Florida,Pinellas County,4,15,47152,21058,26094
50,12,103,Florida,Pinellas County,4,16,44198,18488,25710
50,12,103,Florida,Pinellas County,4,17,33717,13223,20494
50,12,103,Florida,Pinellas County,4,18,29698,9519,20179
50,12,103,Florida,Pinellas County,4,99,925102,441844,483258
50,12,103,Florida,Pinellas County,5,0,8996,4656,4340
50,12,103,Florida,Pinellas County,5,1,35756,18336,17420
50,12,103,Florida,Pinellas County,5,2,47183,24302,22881
50,12,103,Florida,Pinellas County,5,3,53939,27642,26297
50,12,103,Florida,Pinellas County,5,4,49329,25232,24097
50,12,103,Florida,Pinellas County,5,5,45750,22692,23058
50,12,103,Florida,Pinellas County,5,6,46843,23537,23306
50,12,103,Florida,Pinellas County,5,7,55569,27665,27904
50,12,103,Florida,Pinellas County,5,8,63163,31337,31826
50,12,103,Florida,Pinellas County,5,9,73882,36529,37353
50,12,103,Florida,Pinellas County,5,10,72449,35154,37295
50,12,103,Florida,Pinellas County,5,11,66363,32075,34288
50,12,103,Florida,Pinellas County,5,12,59807,28483,31324
50,12,103,Florida,Pinellas County,5,13,49833,23152,26681
50,12,103,Florida,Pinellas County,5,14,44481,20434,24047
50,12,103,Florida,Pinellas County,5,15,45888,20610,25278
50,12,103,Florida,Pinellas County,5,16,43543,18330,25213
50,12,103,Florida,Pinellas County,5,17,33744,13289,20455
50,12,103,Florida,Pinellas County,5,18,29748,9793,19955
50,12,103,Florida,Pinellas County,5,99,926266,443248,483018
50,12,103,Florida,Pinellas County,6,0,8839,4569,4270
50,12,103,Florida,Pinellas County,6,1,35642,18274,17368
50,12,103,Florida,Pinellas County,6,2,46245,23830,22415
50,12,103,Florida,Pinellas County,6,3,53608,27436,26172
50,12,103,Florida,Pinellas County,6,4,50656,25991,24665
50,12,103,Florida,Pinellas County,6,5,46910,23283,23627
50,12,103,Florida,Pinellas County,6,6,47461,23686,23775
50,12,103,Florida,Pinellas County,6,7,53484,26606,26878
50,12,103,Florida,Pinellas County,6,8,60867,30343,30524
50,12,103,Florida,Pinellas County,6,9,73738,36305,37433
50,12,103,Florida,Pinellas County,6,10,73595,35815,37780
50,12,103,Florida,Pinellas County,6,11,67783,32728,35055
50,12,103,Florida,Pinellas County,6,12,62418,29773,32645
50,12,103,Florida,Pinellas County,6,13,51818,24064,27754
50,12,103,Florida,Pinellas County,6,14,44945,20719,24226
50,12,103,Florida,Pinellas County,6,15,44347,20126,24221
50,12,103,Florida,Pinellas County,6,16,42487,18051,24436
50,12,103,Florida,Pinellas County,6,17,33878,13346,20532
50,12,103,Florida,Pinellas County,6,18,29584,9779,19805
50,12,103,Florida,Pinellas County,6,99,928305,444724,483581
50,12,103,Florida,Pinellas County,7,0,8921,4545,4376
50,12,103,Florida,Pinellas County,7,1,35520,18172,17348
50,12,103,Florida,Pinellas County,7,2,45234,23292,21942
50,12,103,Florida,Pinellas County,7,3,52492,26839,25653
50,12,103,Florida,Pinellas County,7,4,51924,26564,25360
50,12,103,Florida,Pinellas County,7,5,47222,23507,23715
50,12,103,Florida,Pinellas County,7,6,48621,24120,24501
50,12,103,Florida,Pinellas County,7,7,51060,25217,25843
50,12,103,Florida,Pinellas County,7,8,59285,29616,29669
50,12,103,Florida,Pinellas County,7,9,72436,35739,36697
50,12,103,Florida,Pinellas County,7,10,74418,36202,38216
50,12,103,Florida,Pinellas County,7,11,69530,33480,36050
50,12,103,Florida,Pinellas County,7,12,65338,31191,34147
50,12,103,Florida,Pinellas County,7,13,53413,24920,28493
50,12,103,Florida,Pinellas County,7,14,45626,21113,24513
50,12,103,Florida,Pinellas County,7,15,43100,19514,23586
50,12,103,Florida,Pinellas County,7,16,41710,17861,23849
50,12,103,Florida,Pinellas County,7,17,33781,13394,20387
50,12,103,Florida,Pinellas County,7,18,29795,9920,19875
50,12,103,Florida,Pinellas County,7,99,929426,445206,484220
50,12,103,Florida,Pinellas County,8,0,8866,4505,4361
50,12,103,Florida,Pinellas County,8,1,34609,17722,16887
50,12,103,Florida,Pinellas County,8,2,44855,22983,21872
50,12,103,Florida,Pinellas County,8,3,51123,26235,24888
50,12,103,Florida,Pinellas County,8,4,52306,26710,25596
50,12,103,Florida,Pinellas County,8,5,47172,23540,23632
50,12,103,Florida,Pinellas County,8,6,50090,24741,25349
50,12,103,Florida,Pinellas County,8,7,48283,23864,24419
50,12,103,Florida,Pinellas County,8,8,58307,29016,29291
50,12,103,Florida,Pinellas County,8,9,69823,34474,35349
50,12,103,Florida,Pinellas County,8,10,75026,36581,38445
50,12,103,Florida,Pinellas County,8,11,70811,33955,36856
50,12,103,Florida,Pinellas County,8,12,67883,32416,35467
50,12,103,Florida,Pinellas County,8,13,54593,25614,28979
50,12,103,Florida,Pinellas County,8,14,45548,21084,24464
50,12,103,Florida,Pinellas County,8,15,41787,18933,22854
50,12,103,Florida,Pinellas County,8,16,40425,17480,22945
50,12,103,Florida,Pinellas County,8,17,32732,12961,19771
50,12,103,Florida,Pinellas County,8,18,29943,10024,19919
50,12,103,Florida,Pinellas County,8,99,924182,442838,481344
50,12,103,Florida,Pinellas County,9,0,9001,4555,4446
50,12,103,Florida,Pinellas County,9,1,34056,17483,16573
50,12,103,Florida,Pinellas County,9,2,44075,22527,21548
50,12,103,Florida,Pinellas County,9,3,49452,25436,24016
50,12,103,Florida,Pinellas County,9,4,52376,26753,25623
50,12,103,Florida,Pinellas County,9,5,46865,23586,23279
50,12,103,Florida,Pinellas County,9,6,50733,25053,25680
50,12,103,Florida,Pinellas County,9,7,46699,23063,23636
50,12,103,Florida,Pinellas County,9,8,57297,28567,28730
50,12,103,Florida,Pinellas County,9,9,66300,32598,33702
50,12,103,Florida,Pinellas County,9,10,74548,36612,37936
50,12,103,Florida,Pinellas County,9,11,72049,34497,37552
50,12,103,Florida,Pinellas County,9,12,66994,31928,35066
50,12,103,Florida,Pinellas County,9,13,58351,27802,30549
50,12,103,Florida,Pinellas County,9,14,46813,21527,25286
50,12,103,Florida,Pinellas County,9,15,41250,18847,22403
50,12,103,Florida,Pinellas County,9,16,39271,17051,22220
50,12,103,Florida,Pinellas County,9,17,32188,12720,19468
50,12,103,Florida,Pinellas County,9,18,30306,10247,20059
50,12,103,Florida,Pinellas County,9,99,918624,440852,477772
50,12,103,Florida,Pinellas County,10,0,8844,4504,4340
50,12,103,Florida,Pinellas County,10,1,33784,17245,16539
50,12,103,Florida,Pinellas County,10,2,43476,22214,21262
50,12,103,Florida,Pinellas County,10,3,48195,24741,23454
50,12,103,Florida,Pinellas County,10,4,52181,26807,25374
50,12,103,Florida,Pinellas County,10,5,46666,23248,23418
50,12,103,Florida,Pinellas County,10,6,51283,25383,25900
50,12,103,Florida,Pinellas County,10,7,46571,23056,23515
50,12,103,Florida,Pinellas County,10,8,55515,27589,27926
50,12,103,Florida,Pinellas County,10,9,63052,31024,32028
50,12,103,Florida,Pinellas County,10,10,74008,36379,37629
50,12,103,Florida,Pinellas County,10,11,73332,35209,38123
50,12,103,Florida,Pinellas County,10,12,66561,31543,35018
50,12,103,Florida,Pinellas County,10,13,60958,29100,31858
50,12,103,Florida,Pinellas County,10,14,49639,22964,26675
50,12,103,Florida,Pinellas County,10,15,41400,18828,22572
50,12,103,Florida,Pinellas County,10,16,38275,16771,21504
50,12,103,Florida,Pinellas County,10,17,31812,12708,19104
50,12,103,Florida,Pinellas County,10,18,30906,10500,20406
50,12,103,Florida,Pinellas County,10,99,916458,439813,476645
50,12,103,Florida,Pinellas County,11,0,8359,4235,4124
50,12,103,Florida,Pinellas County,11,1,34175,17454,16721
50,12,103,Florida,Pinellas County,11,2,42953,21847,21106
50,12,103,Florida,Pinellas County,11,3,47219,24325,22894
50,12,103,Florida,Pinellas County,11,4,51353,26202,25151
50,12,103,Florida,Pinellas County,11,5,46899,23244,23655
50,12,103,Florida,Pinellas County,11,6,51504,25524,25980
50,12,103,Florida,Pinellas County,11,7,47249,23306,23943
50,12,103,Florida,Pinellas County,11,8,53512,26600,26912
50,12,103,Florida,Pinellas County,11,9,60471,29876,30595
50,12,103,Florida,Pinellas County,11,10,73562,35955,37607
50,12,103,Florida,Pinellas County,11,11,74160,35670,38490
50,12,103,Florida,Pinellas County,11,12,67507,32001,35506
50,12,103,Florida,Pinellas County,11,13,63180,30142,33038
50,12,103,Florida,Pinellas County,11,14,51622,23936,27686
50,12,103,Florida,Pinellas County,11,15,41865,19135,22730
50,12,103,Florida,Pinellas County,11,16,36856,16299,20557
50,12,103,Florida,Pinellas County,11,17,31383,12662,18721
50,12,103,Florida,Pinellas County,11,18,31501,10688,20813
50,12,103,Florida,Pinellas County,11,99,915330,439101,476229
50,12,103,Florida,Pinellas County,12,0,8293,4196,4097
50,12,103,Florida,Pinellas County,12,1,34056,17379,16677
50,12,103,Florida,Pinellas County,12,2,43079,22007,21072
50,12,103,Florida,Pinellas County,12,3,46769,24013,22756
50,12,103,Florida,Pinellas County,12,4,50416,25842,24574
50,12,103,Florida,Pinellas County,12,5,47098,23267,23831
50,12,103,Florida,Pinellas County,12,6,51142,25302,25840
50,12,103,Florida,Pinellas County,12,7,48237,23813,24424
50,12,103,Florida,Pinellas County,12,8,51997,25754,26243
50,12,103,Florida,Pinellas County,12,9,59366,29435,29931
50,12,103,Florida,Pinellas County,12,10,72618,35525,37093
50,12,103,Florida,Pinellas County,12,11,74973,36138,38835
50,12,103,Florida,Pinellas County,12,12,68714,32543,36171
50,12,103,Florida,Pinellas County,12,13,65685,31478,34207
50,12,103,Florida,Pinellas County,12,14,52994,24566,28428
50,12,103,Florida,Pinellas County,12,15,42300,19499,22801
50,12,103,Florida,Pinellas County,12,16,36090,15881,20209
50,12,103,Florida,Pinellas County,12,17,30880,12571,18309
50,12,103,Florida,Pinellas County,12,18,31835,10800,21035
50,12,103,Florida,Pinellas County,12,99,916542,440009,476533
50,12,103,Florida,Pinellas County,13,0,8298,4198,4100
50,12,103,Florida,Pinellas County,13,1,33928,17311,16617
50,12,103,Florida,Pinellas County,13,2,43014,21966,21048
50,12,103,Florida,Pinellas County,13,3,46652,23958,22694
50,12,103,Florida,Pinellas County,13,4,50069,25665,24404
50,12,103,Florida,Pinellas County,13,5,47200,23314,23886
50,12,103,Florida,Pinellas County,13,6,51192,25372,25820
50,12,103,Florida,Pinellas County,13,7,48512,23943,24569
50,12,103,Florida,Pinellas County,13,8,51557,25544,26013
50,12,103,Florida,Pinellas County,13,9,59231,29377,29854
50,12,103,Florida,Pinellas County,13,10,72232,35357,36875
50,12,103,Florida,Pinellas County,13,11,75032,36161,38871
50,12,103,Florida,Pinellas County,13,12,69006,32694,36312
50,12,103,Florida,Pinellas County,13,13,66250,31745,34505
50,12,103,Florida,Pinellas County,13,14,53254,24695,28559
50,12,103,Florida,Pinellas County,13,15,42450,19588,22862
50,12,103,Florida,Pinellas County,13,16,35998,15864,20134
50,12,103,Florida,Pinellas County,13,17,30854,12586,18268
50,12,103,Florida,Pinellas County,13,18,31990,10880,21110
50,12,103,Florida,Pinellas County,13,99,916719,440218,476501
50,12,105,Florida,Polk County,1,0,6211,3191,3020
50,12,105,Florida,Polk County,1,1,24974,12803,12171
50,12,105,Florida,Polk County,1,2,33185,17156,16029
50,12,105,Florida,Polk County,1,3,33854,17437,16417
50,12,105,Florida,Polk County,1,4,32603,16958,15645
50,12,105,Florida,Polk County,1,5,27310,13877,13433
50,12,105,Florida,Polk County,1,6,28811,14518,14293
50,12,105,Florida,Polk County,1,7,30519,15327,15192
50,12,105,Florida,Polk County,1,8,34557,17404,17153
50,12,105,Florida,Polk County,1,9,34033,16845,17188
50,12,105,Florida,Polk County,1,10,30591,15063,15528
50,12,105,Florida,Polk County,1,11,28879,13935,14944
50,12,105,Florida,Polk County,1,12,25477,12019,13458
50,12,105,Florida,Polk County,1,13,24167,11410,12757
50,12,105,Florida,Polk County,1,14,24246,11420,12826
50,12,105,Florida,Polk County,1,15,23870,11167,12703
50,12,105,Florida,Polk County,1,16,19633,8912,10721
50,12,105,Florida,Polk County,1,17,11916,4943,6973
50,12,105,Florida,Polk County,1,18,9052,2965,6087
50,12,105,Florida,Polk County,1,99,483888,237350,246538
50,12,105,Florida,Polk County,2,0,6299,3231,3068
50,12,105,Florida,Polk County,2,1,24924,12772,12152
50,12,105,Florida,Polk County,2,2,33053,17098,15955
50,12,105,Florida,Polk County,2,3,34069,17550,16519
50,12,105,Florida,Polk County,2,4,32760,17029,15731
50,12,105,Florida,Polk County,2,5,27613,14028,13585
50,12,105,Florida,Polk County,2,6,28636,14432,14204
50,12,105,Florida,Polk County,2,7,30565,15352,15213
50,12,105,Florida,Polk County,2,8,34499,17379,17120
50,12,105,Florida,Polk County,2,9,34181,16923,17258
50,12,105,Florida,Polk County,2,10,30846,15187,15659
50,12,105,Florida,Polk County,2,11,29255,14119,15136
50,12,105,Florida,Polk County,2,12,25694,12125,13569
50,12,105,Florida,Polk County,2,13,24328,11490,12838
50,12,105,Florida,Polk County,2,14,24203,11411,12792
50,12,105,Florida,Polk County,2,15,23861,11187,12674
50,12,105,Florida,Polk County,2,16,19672,8940,10732
50,12,105,Florida,Polk County,2,17,11986,4987,6999
50,12,105,Florida,Polk County,2,18,9071,2978,6093
50,12,105,Florida,Polk County,2,99,485515,238218,247297
50,12,105,Florida,Polk County,3,0,6870,3475,3395
50,12,105,Florida,Polk County,3,1,25247,12912,12335
50,12,105,Florida,Polk County,3,2,32669,16883,15786
50,12,105,Florida,Polk County,3,3,34874,17923,16951
50,12,105,Florida,Polk County,3,4,32994,17243,15751
50,12,105,Florida,Polk County,3,5,29252,14834,14418
50,12,105,Florida,Polk County,3,6,27844,14043,13801
50,12,105,Florida,Polk County,3,7,30938,15475,15463
50,12,105,Florida,Polk County,3,8,34024,17196,16828
50,12,105,Florida,Polk County,3,9,34909,17196,17713
50,12,105,Florida,Polk County,3,10,31902,15684,16218
50,12,105,Florida,Polk County,3,11,30731,14849,15882
50,12,105,Florida,Polk County,3,12,26299,12517,13782
50,12,105,Florida,Polk County,3,13,24842,11746,13096
50,12,105,Florida,Polk County,3,14,24404,11508,12896
50,12,105,Florida,Polk County,3,15,23813,11187,12626
50,12,105,Florida,Polk County,3,16,19883,9055,10828
50,12,105,Florida,Polk County,3,17,12354,5203,7151
50,12,105,Florida,Polk County,3,18,9068,2991,6077
50,12,105,Florida,Polk County,3,99,492917,241920,250997
50,12,105,Florida,Polk County,4,0,6835,3501,3334
50,12,105,Florida,Polk County,4,1,26215,13374,12841
50,12,105,Florida,Polk County,4,2,32513,16693,15820
50,12,105,Florida,Polk County,4,3,35516,18289,17227
50,12,105,Florida,Polk County,4,4,33381,17499,15882
50,12,105,Florida,Polk County,4,5,30256,15309,14947
50,12,105,Florida,Polk County,4,6,27822,14060,13762
50,12,105,Florida,Polk County,4,7,31231,15599,15632
50,12,105,Florida,Polk County,4,8,33752,16956,16796
50,12,105,Florida,Polk County,4,9,35371,17538,17833
50,12,105,Florida,Polk County,4,10,33202,16298,16904
50,12,105,Florida,Polk County,4,11,30742,14942,15800
50,12,105,Florida,Polk County,4,12,28343,13347,14996
50,12,105,Florida,Polk County,4,13,25895,12253,13642
50,12,105,Florida,Polk County,4,14,24762,11690,13072
50,12,105,Florida,Polk County,4,15,23648,11057,12591
50,12,105,Florida,Polk County,4,16,19944,9186,10758
50,12,105,Florida,Polk County,4,17,12825,5471,7354
50,12,105,Florida,Polk County,4,18,9216,3077,6139
50,12,105,Florida,Polk County,4,99,501469,246139,255330
50,12,105,Florida,Polk County,5,0,6883,3464,3419
50,12,105,Florida,Polk County,5,1,27079,13752,13327
50,12,105,Florida,Polk County,5,2,32629,16741,15888
50,12,105,Florida,Polk County,5,3,36372,18783,17589
50,12,105,Florida,Polk County,5,4,34126,17826,16300
50,12,105,Florida,Polk County,5,5,31575,15911,15664
50,12,105,Florida,Polk County,5,6,28371,14296,14075
50,12,105,Florida,Polk County,5,7,31692,15963,15729
50,12,105,Florida,Polk County,5,8,33563,16777,16786
50,12,105,Florida,Polk County,5,9,35959,17893,18066
50,12,105,Florida,Polk County,5,10,34416,16918,17498
50,12,105,Florida,Polk County,5,11,31400,15263,16137
50,12,105,Florida,Polk County,5,12,29853,14110,15743
50,12,105,Florida,Polk County,5,13,27036,12693,14343
50,12,105,Florida,Polk County,5,14,25600,12162,13438
50,12,105,Florida,Polk County,5,15,23499,11055,12444
50,12,105,Florida,Polk County,5,16,20305,9343,10962
50,12,105,Florida,Polk County,5,17,13260,5617,7643
50,12,105,Florida,Polk County,5,18,9440,3310,6130
50,12,105,Florida,Polk County,5,99,513058,251877,261181
50,12,105,Florida,Polk County,6,0,7130,3605,3525
50,12,105,Florida,Polk County,6,1,27965,14166,13799
50,12,105,Florida,Polk County,6,2,33033,16915,16118
50,12,105,Florida,Polk County,6,3,36907,19137,17770
50,12,105,Florida,Polk County,6,4,35442,18445,16997
50,12,105,Florida,Polk County,6,5,32719,16403,16316
50,12,105,Florida,Polk County,6,6,29596,14994,14602
50,12,105,Florida,Polk County,6,7,31977,15977,16000
50,12,105,Florida,Polk County,6,8,33209,16634,16575
50,12,105,Florida,Polk County,6,9,36923,18443,18480
50,12,105,Florida,Polk County,6,10,35610,17568,18042
50,12,105,Florida,Polk County,6,11,32712,15788,16924
50,12,105,Florida,Polk County,6,12,31454,14919,16535
50,12,105,Florida,Polk County,6,13,28719,13451,15268
50,12,105,Florida,Polk County,6,14,26826,12810,14016
50,12,105,Florida,Polk County,6,15,23739,11274,12465
50,12,105,Florida,Polk County,6,16,20427,9370,11057
50,12,105,Florida,Polk County,6,17,13780,5898,7882
50,12,105,Florida,Polk County,6,18,9517,3357,6160
50,12,105,Florida,Polk County,6,99,527685,259154,268531
50,12,105,Florida,Polk County,7,0,7393,3802,3591
50,12,105,Florida,Polk County,7,1,29526,14832,14694
50,12,105,Florida,Polk County,7,2,34142,17535,16607
50,12,105,Florida,Polk County,7,3,37221,19266,17955
50,12,105,Florida,Polk County,7,4,37419,19498,17921
50,12,105,Florida,Polk County,7,5,33768,17101,16667
50,12,105,Florida,Polk County,7,6,31762,15931,15831
50,12,105,Florida,Polk County,7,7,32436,16181,16255
50,12,105,Florida,Polk County,7,8,34275,17172,17103
50,12,105,Florida,Polk County,7,9,37726,18923,18803
50,12,105,Florida,Polk County,7,10,37126,18216,18910
50,12,105,Florida,Polk County,7,11,34135,16513,17622
50,12,105,Florida,Polk County,7,12,33665,16017,17648
50,12,105,Florida,Polk County,7,13,30221,14173,16048
50,12,105,Florida,Polk County,7,14,27906,13274,14632
50,12,105,Florida,Polk County,7,15,23974,11465,12509
50,12,105,Florida,Polk County,7,16,20605,9528,11077
50,12,105,Florida,Polk County,7,17,14118,6117,8001
50,12,105,Florida,Polk County,7,18,9955,3514,6441
50,12,105,Florida,Polk County,7,99,547373,269058,278315
50,12,105,Florida,Polk County,8,0,7982,4063,3919
50,12,105,Florida,Polk County,8,1,30270,15323,14947
50,12,105,Florida,Polk County,8,2,36273,18542,17731
50,12,105,Florida,Polk County,8,3,38090,19685,18405
50,12,105,Florida,Polk County,8,4,39121,20293,18828
50,12,105,Florida,Polk County,8,5,34741,17574,17167
50,12,105,Florida,Polk County,8,6,34417,17172,17245
50,12,105,Florida,Polk County,8,7,33093,16576,16517
50,12,105,Florida,Polk County,8,8,35965,17964,18001
50,12,105,Florida,Polk County,8,9,38125,19286,18839
50,12,105,Florida,Polk County,8,10,38825,19081,19744
50,12,105,Florida,Polk County,8,11,35544,17157,18387
50,12,105,Florida,Polk County,8,12,35725,16897,18828
50,12,105,Florida,Polk County,8,13,31473,14742,16731
50,12,105,Florida,Polk County,8,14,29081,13882,15199
50,12,105,Florida,Polk County,8,15,24518,11707,12811
50,12,105,Florida,Polk County,8,16,20700,9590,11110
50,12,105,Florida,Polk County,8,17,14123,6135,7988
50,12,105,Florida,Polk County,8,18,10258,3671,6587
50,12,105,Florida,Polk County,8,99,568324,279340,288984
50,12,105,Florida,Polk County,9,0,8229,4280,3949
50,12,105,Florida,Polk County,9,1,31420,15955,15465
50,12,105,Florida,Polk County,9,2,37934,19432,18502
50,12,105,Florida,Polk County,9,3,38758,19929,18829
50,12,105,Florida,Polk County,9,4,40590,21017,19573
50,12,105,Florida,Polk County,9,5,35667,18050,17617
50,12,105,Florida,Polk County,9,6,36210,18038,18172
50,12,105,Florida,Polk County,9,7,33879,16898,16981
50,12,105,Florida,Polk County,9,8,37215,18572,18643
50,12,105,Florida,Polk County,9,9,38316,19292,19024
50,12,105,Florida,Polk County,9,10,39677,19644,20033
50,12,105,Florida,Polk County,9,11,37170,18077,19093
50,12,105,Florida,Polk County,9,12,36165,17047,19118
50,12,105,Florida,Polk County,9,13,33887,15740,18147
50,12,105,Florida,Polk County,9,14,30343,14497,15846
50,12,105,Florida,Polk County,9,15,24971,11964,13007
50,12,105,Florida,Polk County,9,16,20438,9445,10993
50,12,105,Florida,Polk County,9,17,14365,6298,8067
50,12,105,Florida,Polk County,9,18,10748,3932,6816
50,12,105,Florida,Polk County,9,99,585982,288107,297875
50,12,105,Florida,Polk County,10,0,8150,4148,4002
50,12,105,Florida,Polk County,10,1,31661,16177,15484
50,12,105,Florida,Polk County,10,2,38743,19842,18901
50,12,105,Florida,Polk County,10,3,38981,19924,19057
50,12,105,Florida,Polk County,10,4,41346,21418,19928
50,12,105,Florida,Polk County,10,5,35949,18256,17693
50,12,105,Florida,Polk County,10,6,36693,18084,18609
50,12,105,Florida,Polk County,10,7,33987,16899,17088
50,12,105,Florida,Polk County,10,8,37526,18818,18708
50,12,105,Florida,Polk County,10,9,37965,19061,18904
50,12,105,Florida,Polk County,10,10,40089,19813,20276
50,12,105,Florida,Polk County,10,11,38176,18678,19498
50,12,105,Florida,Polk County,10,12,36286,17205,19081
50,12,105,Florida,Polk County,10,13,35265,16296,18969
50,12,105,Florida,Polk County,10,14,31611,14962,16649
50,12,105,Florida,Polk County,10,15,26111,12538,13573
50,12,105,Florida,Polk County,10,16,20557,9573,10984
50,12,105,Florida,Polk County,10,17,14599,6443,8156
50,12,105,Florida,Polk County,10,18,11106,4099,7007
50,12,105,Florida,Polk County,10,99,594801,292234,302567
50,12,105,Florida,Polk County,11,0,7600,3901,3699
50,12,105,Florida,Polk County,11,1,31683,16150,15533
50,12,105,Florida,Polk County,11,2,39050,19975,19075
50,12,105,Florida,Polk County,11,3,39041,19920,19121
50,12,105,Florida,Polk County,11,4,41209,21363,19846
50,12,105,Florida,Polk County,11,5,36096,18277,17819
50,12,105,Florida,Polk County,11,6,36617,18070,18547
50,12,105,Florida,Polk County,11,7,34275,16940,17335
50,12,105,Florida,Polk County,11,8,37413,18626,18787
50,12,105,Florida,Polk County,11,9,36828,18578,18250
50,12,105,Florida,Polk County,11,10,40448,20059,20389
50,12,105,Florida,Polk County,11,11,39012,19074,19938
50,12,105,Florida,Polk County,11,12,36765,17312,19453
50,12,105,Florida,Polk County,11,13,36186,16789,19397
50,12,105,Florida,Polk County,11,14,32802,15484,17318
50,12,105,Florida,Polk County,11,15,26806,12887,13919
50,12,105,Florida,Polk County,11,16,20407,9484,10923
50,12,105,Florida,Polk County,11,17,14791,6560,8231
50,12,105,Florida,Polk County,11,18,11654,4337,7317
50,12,105,Florida,Polk County,11,99,598683,293786,304897
50,12,105,Florida,Polk County,12,0,7632,3905,3727
50,12,105,Florida,Polk County,12,1,31207,15873,15334
50,12,105,Florida,Polk County,12,2,39316,20133,19183
50,12,105,Florida,Polk County,12,3,39282,20101,19181
50,12,105,Florida,Polk County,12,4,40847,21181,19666
50,12,105,Florida,Polk County,12,5,36499,18343,18156
50,12,105,Florida,Polk County,12,6,36235,17921,18314
50,12,105,Florida,Polk County,12,7,35013,17329,17684
50,12,105,Florida,Polk County,12,8,36600,18114,18486
50,12,105,Florida,Polk County,12,9,36847,18582,18265
50,12,105,Florida,Polk County,12,10,40418,20071,20347
50,12,105,Florida,Polk County,12,11,39659,19358,20301
50,12,105,Florida,Polk County,12,12,36929,17432,19497
50,12,105,Florida,Polk County,12,13,37315,17327,19988
50,12,105,Florida,Polk County,12,14,33508,15737,17771
50,12,105,Florida,Polk County,12,15,27250,13137,14113
50,12,105,Florida,Polk County,12,16,20537,9572,10965
50,12,105,Florida,Polk County,12,17,15007,6657,8350
50,12,105,Florida,Polk County,12,18,11994,4540,7454
50,12,105,Florida,Polk County,12,99,602095,295313,306782
50,12,105,Florida,Polk County,13,0,7635,3911,3724
50,12,105,Florida,Polk County,13,1,31118,15819,15299
50,12,105,Florida,Polk County,13,2,39293,20108,19185
50,12,105,Florida,Polk County,13,3,39235,20071,19164
50,12,105,Florida,Polk County,13,4,40622,21080,19542
50,12,105,Florida,Polk County,13,5,36636,18406,18230
50,12,105,Florida,Polk County,13,6,36299,17977,18322
50,12,105,Florida,Polk County,13,7,35241,17444,17797
50,12,105,Florida,Polk County,13,8,36360,18002,18358
50,12,105,Florida,Polk County,13,9,36836,18583,18253
50,12,105,Florida,Polk County,13,10,40299,20022,20277
50,12,105,Florida,Polk County,13,11,39732,19384,20348
50,12,105,Florida,Polk County,13,12,37106,17518,19588
50,12,105,Florida,Polk County,13,13,37675,17492,20183
50,12,105,Florida,Polk County,13,14,33687,15835,17852
50,12,105,Florida,Polk County,13,15,27352,13198,14154
50,12,105,Florida,Polk County,13,16,20528,9584,10944
50,12,105,Florida,Polk County,13,17,15058,6696,8362
50,12,105,Florida,Polk County,13,18,12076,4582,7494
50,12,105,Florida,Polk County,13,99,602788,295712,307076
50,12,107,Florida,Putnam County,1,0,846,422,424
50,12,107,Florida,Putnam County,1,1,3480,1862,1618
50,12,107,Florida,Putnam County,1,2,4892,2576,2316
50,12,107,Florida,Putnam County,1,3,5123,2669,2454
50,12,107,Florida,Putnam County,1,4,4806,2414,2392
50,12,107,Florida,Putnam County,1,5,3570,1821,1749
50,12,107,Florida,Putnam County,1,6,3508,1713,1795
50,12,107,Florida,Putnam County,1,7,3835,1987,1848
50,12,107,Florida,Putnam County,1,8,4611,2216,2395
50,12,107,Florida,Putnam County,1,9,5111,2543,2568
50,12,107,Florida,Putnam County,1,10,4699,2270,2429
50,12,107,Florida,Putnam County,1,11,4744,2306,2438
50,12,107,Florida,Putnam County,1,12,4200,2011,2189
50,12,107,Florida,Putnam County,1,13,3998,1939,2059
50,12,107,Florida,Putnam County,1,14,3954,1937,2017
50,12,107,Florida,Putnam County,1,15,3665,1781,1884
50,12,107,Florida,Putnam County,1,16,2783,1266,1517
50,12,107,Florida,Putnam County,1,17,1560,702,858
50,12,107,Florida,Putnam County,1,18,1033,353,680
50,12,107,Florida,Putnam County,1,99,70418,34788,35630
50,12,107,Florida,Putnam County,2,0,854,424,430
50,12,107,Florida,Putnam County,2,1,3466,1854,1612
50,12,107,Florida,Putnam County,2,2,4856,2558,2298
50,12,107,Florida,Putnam County,2,3,5134,2672,2462
50,12,107,Florida,Putnam County,2,4,4813,2416,2397
50,12,107,Florida,Putnam County,2,5,3599,1837,1762
50,12,107,Florida,Putnam County,2,6,3472,1695,1777
50,12,107,Florida,Putnam County,2,7,3827,1982,1845
50,12,107,Florida,Putnam County,2,8,4590,2208,2382
50,12,107,Florida,Putnam County,2,9,5118,2547,2571
50,12,107,Florida,Putnam County,2,10,4718,2281,2437
50,12,107,Florida,Putnam County,2,11,4790,2330,2460
50,12,107,Florida,Putnam County,2,12,4222,2024,2198
50,12,107,Florida,Putnam County,2,13,4005,1944,2061
50,12,107,Florida,Putnam County,2,14,3930,1927,2003
50,12,107,Florida,Putnam County,2,15,3655,1777,1878
50,12,107,Florida,Putnam County,2,16,2778,1265,1513
50,12,107,Florida,Putnam County,2,17,1569,707,862
50,12,107,Florida,Putnam County,2,18,1037,354,683
50,12,107,Florida,Putnam County,2,99,70433,34802,35631
50,12,107,Florida,Putnam County,3,0,881,455,426
50,12,107,Florida,Putnam County,3,1,3423,1811,1612
50,12,107,Florida,Putnam County,3,2,4671,2464,2207
50,12,107,Florida,Putnam County,3,3,5222,2743,2479
50,12,107,Florida,Putnam County,3,4,4737,2379,2358
50,12,107,Florida,Putnam County,3,5,3897,1973,1924
50,12,107,Florida,Putnam County,3,6,3374,1680,1694
50,12,107,Florida,Putnam County,3,7,3726,1910,1816
50,12,107,Florida,Putnam County,3,8,4546,2235,2311
50,12,107,Florida,Putnam County,3,9,4986,2423,2563
50,12,107,Florida,Putnam County,3,10,4839,2397,2442
50,12,107,Florida,Putnam County,3,11,5039,2427,2612
50,12,107,Florida,Putnam County,3,12,4286,2037,2249
50,12,107,Florida,Putnam County,3,13,4094,2004,2090
50,12,107,Florida,Putnam County,3,14,3849,1889,1960
50,12,107,Florida,Putnam County,3,15,3526,1733,1793
50,12,107,Florida,Putnam County,3,16,2787,1275,1512
50,12,107,Florida,Putnam County,3,17,1616,736,880
50,12,107,Florida,Putnam County,3,18,1086,372,714
50,12,107,Florida,Putnam County,3,99,70585,34943,35642
50,12,107,Florida,Putnam County,4,0,928,482,446
50,12,107,Florida,Putnam County,4,1,3490,1781,1709
50,12,107,Florida,Putnam County,4,2,4572,2436,2136
50,12,107,Florida,Putnam County,4,3,5287,2766,2521
50,12,107,Florida,Putnam County,4,4,4758,2458,2300
50,12,107,Florida,Putnam County,4,5,4029,2008,2021
50,12,107,Florida,Putnam County,4,6,3364,1639,1725
50,12,107,Florida,Putnam County,4,7,3850,1987,1863
50,12,107,Florida,Putnam County,4,8,4403,2169,2234
50,12,107,Florida,Putnam County,4,9,5012,2432,2580
50,12,107,Florida,Putnam County,4,10,4997,2463,2534
50,12,107,Florida,Putnam County,4,11,4943,2358,2585
50,12,107,Florida,Putnam County,4,12,4645,2239,2406
50,12,107,Florida,Putnam County,4,13,4162,2021,2141
50,12,107,Florida,Putnam County,4,14,3862,1890,1972
50,12,107,Florida,Putnam County,4,15,3512,1729,1783
50,12,107,Florida,Putnam County,4,16,2764,1290,1474
50,12,107,Florida,Putnam County,4,17,1698,730,968
50,12,107,Florida,Putnam County,4,18,1110,416,694
50,12,107,Florida,Putnam County,4,99,71386,35294,36092
50,12,107,Florida,Putnam County,5,0,896,463,433
50,12,107,Florida,Putnam County,5,1,3589,1841,1748
50,12,107,Florida,Putnam County,5,2,4436,2334,2102
50,12,107,Florida,Putnam County,5,3,5318,2795,2523
50,12,107,Florida,Putnam County,5,4,4824,2504,2320
50,12,107,Florida,Putnam County,5,5,4083,2025,2058
50,12,107,Florida,Putnam County,5,6,3403,1713,1690
50,12,107,Florida,Putnam County,5,7,3806,1894,1912
50,12,107,Florida,Putnam County,5,8,4299,2161,2138
50,12,107,Florida,Putnam County,5,9,5038,2459,2579
50,12,107,Florida,Putnam County,5,10,5085,2527,2558
50,12,107,Florida,Putnam County,5,11,5015,2384,2631
50,12,107,Florida,Putnam County,5,12,4786,2318,2468
50,12,107,Florida,Putnam County,5,13,4324,2091,2233
50,12,107,Florida,Putnam County,5,14,3874,1880,1994
50,12,107,Florida,Putnam County,5,15,3462,1727,1735
50,12,107,Florida,Putnam County,5,16,2784,1298,1486
50,12,107,Florida,Putnam County,5,17,1732,734,998
50,12,107,Florida,Putnam County,5,18,1099,418,681
50,12,107,Florida,Putnam County,5,99,71853,35566,36287
50,12,107,Florida,Putnam County,6,0,942,485,457
50,12,107,Florida,Putnam County,6,1,3629,1851,1778
50,12,107,Florida,Putnam County,6,2,4376,2305,2071
50,12,107,Florida,Putnam County,6,3,5266,2739,2527
50,12,107,Florida,Putnam County,6,4,4959,2593,2366
50,12,107,Florida,Putnam County,6,5,4154,2067,2087
50,12,107,Florida,Putnam County,6,6,3592,1815,1777
50,12,107,Florida,Putnam County,6,7,3803,1904,1899
50,12,107,Florida,Putnam County,6,8,4076,2106,1970
50,12,107,Florida,Putnam County,6,9,5056,2435,2621
50,12,107,Florida,Putnam County,6,10,5247,2593,2654
50,12,107,Florida,Putnam County,6,11,5094,2419,2675
50,12,107,Florida,Putnam County,6,12,5090,2481,2609
50,12,107,Florida,Putnam County,6,13,4450,2147,2303
50,12,107,Florida,Putnam County,6,14,3974,1966,2008
50,12,107,Florida,Putnam County,6,15,3407,1658,1749
50,12,107,Florida,Putnam County,6,16,2845,1323,1522
50,12,107,Florida,Putnam County,6,17,1733,744,989
50,12,107,Florida,Putnam County,6,18,1138,455,683
50,12,107,Florida,Putnam County,6,99,72831,36086,36745
50,12,107,Florida,Putnam County,7,0,966,483,483
50,12,107,Florida,Putnam County,7,1,3768,1963,1805
50,12,107,Florida,Putnam County,7,2,4430,2299,2131
50,12,107,Florida,Putnam County,7,3,5245,2752,2493
50,12,107,Florida,Putnam County,7,4,4983,2617,2366
50,12,107,Florida,Putnam County,7,5,4128,2059,2069
50,12,107,Florida,Putnam County,7,6,3845,1976,1869
50,12,107,Florida,Putnam County,7,7,3719,1843,1876
50,12,107,Florida,Putnam County,7,8,4104,2118,1986
50,12,107,Florida,Putnam County,7,9,4886,2320,2566
50,12,107,Florida,Putnam County,7,10,5528,2761,2767
50,12,107,Florida,Putnam County,7,11,5146,2446,2700
50,12,107,Florida,Putnam County,7,12,5331,2617,2714
50,12,107,Florida,Putnam County,7,13,4470,2151,2319
50,12,107,Florida,Putnam County,7,14,4012,1975,2037
50,12,107,Florida,Putnam County,7,15,3398,1668,1730
50,12,107,Florida,Putnam County,7,16,2811,1317,1494
50,12,107,Florida,Putnam County,7,17,1828,794,1034
50,12,107,Florida,Putnam County,7,18,1194,450,744
50,12,107,Florida,Putnam County,7,99,73792,36609,37183
50,12,107,Florida,Putnam County,8,0,990,508,482
50,12,107,Florida,Putnam County,8,1,3823,1976,1847
50,12,107,Florida,Putnam County,8,2,4488,2323,2165
50,12,107,Florida,Putnam County,8,3,5062,2640,2422
50,12,107,Florida,Putnam County,8,4,5166,2757,2409
50,12,107,Florida,Putnam County,8,5,4044,2050,1994
50,12,107,Florida,Putnam County,8,6,4039,2009,2030
50,12,107,Florida,Putnam County,8,7,3650,1833,1817
50,12,107,Florida,Putnam County,8,8,4156,2109,2047
50,12,107,Florida,Putnam County,8,9,4916,2370,2546
50,12,107,Florida,Putnam County,8,10,5454,2659,2795
50,12,107,Florida,Putnam County,8,11,5334,2622,2712
50,12,107,Florida,Putnam County,8,12,5643,2768,2875
50,12,107,Florida,Putnam County,8,13,4557,2186,2371
50,12,107,Florida,Putnam County,8,14,4068,2021,2047
50,12,107,Florida,Putnam County,8,15,3388,1639,1749
50,12,107,Florida,Putnam County,8,16,2797,1307,1490
50,12,107,Florida,Putnam County,8,17,1800,789,1011
50,12,107,Florida,Putnam County,8,18,1288,477,811
50,12,107,Florida,Putnam County,8,99,74663,37043,37620
50,12,107,Florida,Putnam County,9,0,1029,527,502
50,12,107,Florida,Putnam County,9,1,3842,1983,1859
50,12,107,Florida,Putnam County,9,2,4542,2331,2211
50,12,107,Florida,Putnam County,9,3,4958,2596,2362
50,12,107,Florida,Putnam County,9,4,5248,2810,2438
50,12,107,Florida,Putnam County,9,5,4084,2087,1997
50,12,107,Florida,Putnam County,9,6,4084,2027,2057
50,12,107,Florida,Putnam County,9,7,3644,1827,1817
50,12,107,Florida,Putnam County,9,8,4183,2115,2068
50,12,107,Florida,Putnam County,9,9,4744,2312,2432
50,12,107,Florida,Putnam County,9,10,5481,2697,2784
50,12,107,Florida,Putnam County,9,11,5431,2623,2808
50,12,107,Florida,Putnam County,9,12,5513,2676,2837
50,12,107,Florida,Putnam County,9,13,4833,2381,2452
50,12,107,Florida,Putnam County,9,14,4156,2028,2128
50,12,107,Florida,Putnam County,9,15,3480,1705,1775
50,12,107,Florida,Putnam County,9,16,2715,1308,1407
50,12,107,Florida,Putnam County,9,17,1832,808,1024
50,12,107,Florida,Putnam County,9,18,1308,480,828
50,12,107,Florida,Putnam County,9,99,75107,37321,37786
50,12,107,Florida,Putnam County,10,0,1035,549,486
50,12,107,Florida,Putnam County,10,1,3899,2000,1899
50,12,107,Florida,Putnam County,10,2,4546,2341,2205
50,12,107,Florida,Putnam County,10,3,4691,2445,2246
50,12,107,Florida,Putnam County,10,4,5189,2762,2427
50,12,107,Florida,Putnam County,10,5,4116,2117,1999
50,12,107,Florida,Putnam County,10,6,4164,2064,2100
50,12,107,Florida,Putnam County,10,7,3608,1864,1744
50,12,107,Florida,Putnam County,10,8,4074,2010,2064
50,12,107,Florida,Putnam County,10,9,4565,2263,2302
50,12,107,Florida,Putnam County,10,10,5447,2702,2745
50,12,107,Florida,Putnam County,10,11,5482,2651,2831
50,12,107,Florida,Putnam County,10,12,5531,2664,2867
50,12,107,Florida,Putnam County,10,13,4918,2420,2498
50,12,107,Florida,Putnam County,10,14,4305,2102,2203
50,12,107,Florida,Putnam County,10,15,3408,1650,1758
50,12,107,Florida,Putnam County,10,16,2782,1325,1457
50,12,107,Florida,Putnam County,10,17,1885,819,1066
50,12,107,Florida,Putnam County,10,18,1354,518,836
50,12,107,Florida,Putnam County,10,99,74999,37266,37733
50,12,107,Florida,Putnam County,11,0,901,468,433
50,12,107,Florida,Putnam County,11,1,3859,1982,1877
50,12,107,Florida,Putnam County,11,2,4508,2311,2197
50,12,107,Florida,Putnam County,11,3,4657,2416,2241
50,12,107,Florida,Putnam County,11,4,5032,2699,2333
50,12,107,Florida,Putnam County,11,5,4113,2128,1985
50,12,107,Florida,Putnam County,11,6,4081,2014,2067
50,12,107,Florida,Putnam County,11,7,3667,1896,1771
50,12,107,Florida,Putnam County,11,8,4076,2011,2065
50,12,107,Florida,Putnam County,11,9,4221,2148,2073
50,12,107,Florida,Putnam County,11,10,5394,2625,2769
50,12,107,Florida,Putnam County,11,11,5561,2708,2853
50,12,107,Florida,Putnam County,11,12,5448,2663,2785
50,12,107,Florida,Putnam County,11,13,5109,2486,2623
50,12,107,Florida,Putnam County,11,14,4447,2166,2281
50,12,107,Florida,Putnam County,11,15,3439,1696,1743
50,12,107,Florida,Putnam County,11,16,2709,1317,1392
50,12,107,Florida,Putnam County,11,17,1919,833,1086
50,12,107,Florida,Putnam County,11,18,1405,537,868
50,12,107,Florida,Putnam County,11,99,74546,37104,37442
50,12,107,Florida,Putnam County,12,0,868,440,428
50,12,107,Florida,Putnam County,12,1,3821,1949,1872
50,12,107,Florida,Putnam County,12,2,4506,2292,2214
50,12,107,Florida,Putnam County,12,3,4675,2406,2269
50,12,107,Florida,Putnam County,12,4,4930,2631,2299
50,12,107,Florida,Putnam County,12,5,4046,2077,1969
50,12,107,Florida,Putnam County,12,6,3985,1981,2004
50,12,107,Florida,Putnam County,12,7,3762,1942,1820
50,12,107,Florida,Putnam County,12,8,3861,1901,1960
50,12,107,Florida,Putnam County,12,9,4126,2084,2042
50,12,107,Florida,Putnam County,12,10,5300,2571,2729
50,12,107,Florida,Putnam County,12,11,5714,2800,2914
50,12,107,Florida,Putnam County,12,12,5444,2640,2804
50,12,107,Florida,Putnam County,12,13,5256,2577,2679
50,12,107,Florida,Putnam County,12,14,4468,2156,2312
50,12,107,Florida,Putnam County,12,15,3497,1733,1764
50,12,107,Florida,Putnam County,12,16,2705,1307,1398
50,12,107,Florida,Putnam County,12,17,1932,849,1083
50,12,107,Florida,Putnam County,12,18,1468,548,920
50,12,107,Florida,Putnam County,12,99,74364,36884,37480
50,12,107,Florida,Putnam County,13,0,873,444,429
50,12,107,Florida,Putnam County,13,1,3804,1944,1860
50,12,107,Florida,Putnam County,13,2,4500,2283,2217
50,12,107,Florida,Putnam County,13,3,4649,2387,2262
50,12,107,Florida,Putnam County,13,4,4891,2611,2280
50,12,107,Florida,Putnam County,13,5,4040,2068,1972
50,12,107,Florida,Putnam County,13,6,3984,1990,1994
50,12,107,Florida,Putnam County,13,7,3773,1945,1828
50,12,107,Florida,Putnam County,13,8,3831,1887,1944
50,12,107,Florida,Putnam County,13,9,4116,2083,2033
50,12,107,Florida,Putnam County,13,10,5265,2558,2707
50,12,107,Florida,Putnam County,13,11,5709,2800,2909
50,12,107,Florida,Putnam County,13,12,5459,2648,2811
50,12,107,Florida,Putnam County,13,13,5293,2595,2698
50,12,107,Florida,Putnam County,13,14,4475,2165,2310
50,12,107,Florida,Putnam County,13,15,3501,1734,1767
50,12,107,Florida,Putnam County,13,16,2698,1307,1391
50,12,107,Florida,Putnam County,13,17,1928,848,1080
50,12,107,Florida,Putnam County,13,18,1473,551,922
50,12,107,Florida,Putnam County,13,99,74262,36848,37414
50,12,109,Florida,St. Johns County,1,0,1263,645,618
50,12,109,Florida,St. Johns County,1,1,5351,2731,2620
50,12,109,Florida,St. Johns County,1,2,8060,4129,3931
50,12,109,Florida,St. Johns County,1,3,8817,4481,4336
50,12,109,Florida,St. Johns County,1,4,7926,4042,3884
50,12,109,Florida,St. Johns County,1,5,5651,2821,2830
50,12,109,Florida,St. Johns County,1,6,6002,3055,2947
50,12,109,Florida,St. Johns County,1,7,7258,3449,3809
50,12,109,Florida,St. Johns County,1,8,9970,4756,5214
50,12,109,Florida,St. Johns County,1,9,10799,5196,5603
50,12,109,Florida,St. Johns County,1,10,10169,4968,5201
50,12,109,Florida,St. Johns County,1,11,9248,4645,4603
50,12,109,Florida,St. Johns County,1,12,7322,3498,3824
50,12,109,Florida,St. Johns County,1,13,5804,2769,3035
50,12,109,Florida,St. Johns County,1,14,5489,2648,2841
50,12,109,Florida,St. Johns County,1,15,5337,2471,2866
50,12,109,Florida,St. Johns County,1,16,4295,1894,2401
50,12,109,Florida,St. Johns County,1,17,2543,1065,1478
50,12,109,Florida,St. Johns County,1,18,1933,610,1323
50,12,109,Florida,St. Johns County,1,99,123237,59873,63364
50,12,109,Florida,St. Johns County,2,0,1287,656,631
50,12,109,Florida,St. Johns County,2,1,5390,2752,2638
50,12,109,Florida,St. Johns County,2,2,8105,4153,3952
50,12,109,Florida,St. Johns County,2,3,8943,4546,4397
50,12,109,Florida,St. Johns County,2,4,8027,4097,3930
50,12,109,Florida,St. Johns County,2,5,5754,2874,2880
50,12,109,Florida,St. Johns County,2,6,6003,3052,2951
50,12,109,Florida,St. Johns County,2,7,7319,3478,3841
50,12,109,Florida,St. Johns County,2,8,10034,4788,5246
50,12,109,Florida,St. Johns County,2,9,10913,5250,5663
50,12,109,Florida,St. Johns County,2,10,10334,5045,5289
50,12,109,Florida,St. Johns County,2,11,9427,4735,4692
50,12,109,Florida,St. Johns County,2,12,7438,3551,3887
50,12,109,Florida,St. Johns County,2,13,5881,2802,3079
50,12,109,Florida,St. Johns County,2,14,5486,2650,2836
50,12,109,Florida,St. Johns County,2,15,5347,2478,2869
50,12,109,Florida,St. Johns County,2,16,4314,1903,2411
50,12,109,Florida,St. Johns County,2,17,2574,1080,1494
50,12,109,Florida,St. Johns County,2,18,1946,616,1330
50,12,109,Florida,St. Johns County,2,99,124522,60506,64016
50,12,109,Florida,St. Johns County,3,0,1300,658,642
50,12,109,Florida,St. Johns County,3,1,5554,2844,2710
50,12,109,Florida,St. Johns County,3,2,8347,4252,4095
50,12,109,Florida,St. Johns County,3,3,9352,4777,4575
50,12,109,Florida,St. Johns County,3,4,8538,4387,4151
50,12,109,Florida,St. Johns County,3,5,6294,3133,3161
50,12,109,Florida,St. Johns County,3,6,5828,2932,2896
50,12,109,Florida,St. Johns County,3,7,7535,3627,3908
50,12,109,Florida,St. Johns County,3,8,10007,4766,5241
50,12,109,Florida,St. Johns County,3,9,11535,5511,6024
50,12,109,Florida,St. Johns County,3,10,10882,5284,5598
50,12,109,Florida,St. Johns County,3,11,10265,5145,5120
50,12,109,Florida,St. Johns County,3,12,8014,3867,4147
50,12,109,Florida,St. Johns County,3,13,6310,3011,3299
50,12,109,Florida,St. Johns County,3,14,5483,2644,2839
50,12,109,Florida,St. Johns County,3,15,5350,2501,2849
50,12,109,Florida,St. Johns County,3,16,4458,1986,2472
50,12,109,Florida,St. Johns County,3,17,2736,1136,1600
50,12,109,Florida,St. Johns County,3,18,2017,652,1365
50,12,109,Florida,St. Johns County,3,99,129805,63113,66692
50,12,109,Florida,St. Johns County,4,0,1355,687,668
50,12,109,Florida,St. Johns County,4,1,5802,2955,2847
50,12,109,Florida,St. Johns County,4,2,8705,4450,4255
50,12,109,Florida,St. Johns County,4,3,9795,5048,4747
50,12,109,Florida,St. Johns County,4,4,9074,4675,4399
50,12,109,Florida,St. Johns County,4,5,6718,3319,3399
50,12,109,Florida,St. Johns County,4,6,5864,2898,2966
50,12,109,Florida,St. Johns County,4,7,7818,3768,4050
50,12,109,Florida,St. Johns County,4,8,10146,4857,5289
50,12,109,Florida,St. Johns County,4,9,12008,5738,6270
50,12,109,Florida,St. Johns County,4,10,11381,5453,5928
50,12,109,Florida,St. Johns County,4,11,10596,5315,5281
50,12,109,Florida,St. Johns County,4,12,9047,4435,4612
50,12,109,Florida,St. Johns County,4,13,6800,3263,3537
50,12,109,Florida,St. Johns County,4,14,5598,2684,2914
50,12,109,Florida,St. Johns County,4,15,5346,2503,2843
50,12,109,Florida,St. Johns County,4,16,4568,2051,2517
50,12,109,Florida,St. Johns County,4,17,2975,1238,1737
50,12,109,Florida,St. Johns County,4,18,2174,717,1457
50,12,109,Florida,St. Johns County,4,99,135770,66054,69716
50,12,109,Florida,St. Johns County,5,0,1488,800,688
50,12,109,Florida,St. Johns County,5,1,6268,3187,3081
50,12,109,Florida,St. Johns County,5,2,8938,4602,4336
50,12,109,Florida,St. Johns County,5,3,10278,5232,5046
50,12,109,Florida,St. Johns County,5,4,9545,4891,4654
50,12,109,Florida,St. Johns County,5,5,7100,3491,3609
50,12,109,Florida,St. Johns County,5,6,6212,3084,3128
50,12,109,Florida,St. Johns County,5,7,8077,3918,4159
50,12,109,Florida,St. Johns County,5,8,10158,4840,5318
50,12,109,Florida,St. Johns County,5,9,12380,5872,6508
50,12,109,Florida,St. Johns County,5,10,12094,5787,6307
50,12,109,Florida,St. Johns County,5,11,11056,5470,5586
50,12,109,Florida,St. Johns County,5,12,9688,4757,4931
50,12,109,Florida,St. Johns County,5,13,7584,3689,3895
50,12,109,Florida,St. Johns County,5,14,5825,2811,3014
50,12,109,Florida,St. Johns County,5,15,5424,2550,2874
50,12,109,Florida,St. Johns County,5,16,4553,2054,2499
50,12,109,Florida,St. Johns County,5,17,3185,1283,1902
50,12,109,Florida,St. Johns County,5,18,2312,776,1536
50,12,109,Florida,St. Johns County,5,99,142165,69094,73071
50,12,109,Florida,St. Johns County,6,0,1553,808,745
50,12,109,Florida,St. Johns County,6,1,6764,3479,3285
50,12,109,Florida,St. Johns County,6,2,9638,5020,4618
50,12,109,Florida,St. Johns County,6,3,10736,5476,5260
50,12,109,Florida,St. Johns County,6,4,10435,5357,5078
50,12,109,Florida,St. Johns County,6,5,7807,3895,3912
50,12,109,Florida,St. Johns County,6,6,6762,3300,3462
50,12,109,Florida,St. Johns County,6,7,8596,4192,4404
50,12,109,Florida,St. Johns County,6,8,10386,4966,5420
50,12,109,Florida,St. Johns County,6,9,13033,6238,6795
50,12,109,Florida,St. Johns County,6,10,12882,6168,6714
50,12,109,Florida,St. Johns County,6,11,11816,5767,6049
50,12,109,Florida,St. Johns County,6,12,10558,5251,5307
50,12,109,Florida,St. Johns County,6,13,8475,4072,4403
50,12,109,Florida,St. Johns County,6,14,6221,3023,3198
50,12,109,Florida,St. Johns County,6,15,5435,2546,2889
50,12,109,Florida,St. Johns County,6,16,4673,2106,2567
50,12,109,Florida,St. Johns County,6,17,3437,1437,2000
50,12,109,Florida,St. Johns County,6,18,2510,848,1662
50,12,109,Florida,St. Johns County,6,99,151717,73949,77768
50,12,109,Florida,St. Johns County,7,0,1680,842,838
50,12,109,Florida,St. Johns County,7,1,7178,3671,3507
50,12,109,Florida,St. Johns County,7,2,10235,5232,5003
50,12,109,Florida,St. Johns County,7,3,11324,5873,5451
50,12,109,Florida,St. Johns County,7,4,11012,5636,5376
50,12,109,Florida,St. Johns County,7,5,8315,4121,4194
50,12,109,Florida,St. Johns County,7,6,7439,3555,3884
50,12,109,Florida,St. Johns County,7,7,8843,4320,4523
50,12,109,Florida,St. Johns County,7,8,10959,5309,5650
50,12,109,Florida,St. Johns County,7,9,13446,6488,6958
50,12,109,Florida,St. Johns County,7,10,13581,6502,7079
50,12,109,Florida,St. Johns County,7,11,12496,6043,6453
50,12,109,Florida,St. Johns County,7,12,11530,5703,5827
50,12,109,Florida,St. Johns County,7,13,9068,4374,4694
50,12,109,Florida,St. Johns County,7,14,6681,3239,3442
50,12,109,Florida,St. Johns County,7,15,5473,2601,2872
50,12,109,Florida,St. Johns County,7,16,4732,2186,2546
50,12,109,Florida,St. Johns County,7,17,3610,1451,2159
50,12,109,Florida,St. Johns County,7,18,2664,930,1734
50,12,109,Florida,St. Johns County,7,99,160266,78076,82190
50,12,109,Florida,St. Johns County,8,0,1790,822,968
50,12,109,Florida,St. Johns County,8,1,7570,3965,3605
50,12,109,Florida,St. Johns County,8,2,10903,5517,5386
50,12,109,Florida,St. Johns County,8,3,11983,6137,5846
50,12,109,Florida,St. Johns County,8,4,11557,5970,5587
50,12,109,Florida,St. Johns County,8,5,8514,4205,4309
50,12,109,Florida,St. Johns County,8,6,7955,3808,4147
50,12,109,Florida,St. Johns County,8,7,8921,4325,4596
50,12,109,Florida,St. Johns County,8,8,11573,5645,5928
50,12,109,Florida,St. Johns County,8,9,13580,6557,7023
50,12,109,Florida,St. Johns County,8,10,14326,6807,7519
50,12,109,Florida,St. Johns County,8,11,13011,6321,6690
50,12,109,Florida,St. Johns County,8,12,12510,6186,6324
50,12,109,Florida,St. Johns County,8,13,9809,4722,5087
50,12,109,Florida,St. Johns County,8,14,7218,3488,3730
50,12,109,Florida,St. Johns County,8,15,5706,2723,2983
50,12,109,Florida,St. Johns County,8,16,4934,2311,2623
50,12,109,Florida,St. Johns County,8,17,3741,1554,2187
50,12,109,Florida,St. Johns County,8,18,2879,1030,1849
50,12,109,Florida,St. Johns County,8,99,168480,82093,86387
50,12,109,Florida,St. Johns County,9,0,1812,859,953
50,12,109,Florida,St. Johns County,9,1,7889,4047,3842
50,12,109,Florida,St. Johns County,9,2,11419,5830,5589
50,12,109,Florida,St. Johns County,9,3,12429,6310,6119
50,12,109,Florida,St. Johns County,9,4,12104,6259,5845
50,12,109,Florida,St. Johns County,9,5,8896,4404,4492
50,12,109,Florida,St. Johns County,9,6,8345,4001,4344
50,12,109,Florida,St. Johns County,9,7,8886,4222,4664
50,12,109,Florida,St. Johns County,9,8,12030,5926,6104
50,12,109,Florida,St. Johns County,9,9,13737,6644,7093
50,12,109,Florida,St. Johns County,9,10,14846,7093,7753
50,12,109,Florida,St. Johns County,9,11,13582,6508,7074
50,12,109,Florida,St. Johns County,9,12,12758,6272,6486
50,12,109,Florida,St. Johns County,9,13,10917,5295,5622
50,12,109,Florida,St. Johns County,9,14,7847,3788,4059
50,12,109,Florida,St. Johns County,9,15,5793,2766,3027
50,12,109,Florida,St. Johns County,9,16,5091,2362,2729
50,12,109,Florida,St. Johns County,9,17,3879,1628,2251
50,12,109,Florida,St. Johns County,9,18,3058,1115,1943
50,12,109,Florida,St. Johns County,9,99,175318,85329,89989
50,12,109,Florida,St. Johns County,10,0,1848,907,941
50,12,109,Florida,St. Johns County,10,1,8122,4113,4009
50,12,109,Florida,St. Johns County,10,2,11995,6129,5866
50,12,109,Florida,St. Johns County,10,3,12583,6451,6132
50,12,109,Florida,St. Johns County,10,4,12598,6519,6079
50,12,109,Florida,St. Johns County,10,5,9339,4652,4687
50,12,109,Florida,St. Johns County,10,6,8724,4137,4587
50,12,109,Florida,St. Johns County,10,7,9047,4348,4699
50,12,109,Florida,St. Johns County,10,8,12260,5969,6291
50,12,109,Florida,St. Johns County,10,9,13760,6678,7082
50,12,109,Florida,St. Johns County,10,10,15259,7251,8008
50,12,109,Florida,St. Johns County,10,11,14168,6798,7370
50,12,109,Florida,St. Johns County,10,12,12966,6323,6643
50,12,109,Florida,St. Johns County,10,13,11800,5720,6080
50,12,109,Florida,St. Johns County,10,14,8659,4251,4408
50,12,109,Florida,St. Johns County,10,15,6080,2875,3205
50,12,109,Florida,St. Johns County,10,16,5175,2383,2792
50,12,109,Florida,St. Johns County,10,17,3982,1727,2255
50,12,109,Florida,St. Johns County,10,18,3355,1194,2161
50,12,109,Florida,St. Johns County,10,99,181720,88425,93295
50,12,109,Florida,St. Johns County,11,0,1804,912,892
50,12,109,Florida,St. Johns County,11,1,8255,4152,4103
50,12,109,Florida,St. Johns County,11,2,12127,6178,5949
50,12,109,Florida,St. Johns County,11,3,13019,6674,6345
50,12,109,Florida,St. Johns County,11,4,12803,6624,6179
50,12,109,Florida,St. Johns County,11,5,9633,4776,4857
50,12,109,Florida,St. Johns County,11,6,8972,4306,4666
50,12,109,Florida,St. Johns County,11,7,9130,4401,4729
50,12,109,Florida,St. Johns County,11,8,12227,5902,6325
50,12,109,Florida,St. Johns County,11,9,13577,6607,6970
50,12,109,Florida,St. Johns County,11,10,15605,7426,8179
50,12,109,Florida,St. Johns County,11,11,14745,7141,7604
50,12,109,Florida,St. Johns County,11,12,13316,6389,6927
50,12,109,Florida,St. Johns County,11,13,12394,6066,6328
50,12,109,Florida,St. Johns County,11,14,9430,4556,4874
50,12,109,Florida,St. Johns County,11,15,6453,3063,3390
50,12,109,Florida,St. Johns County,11,16,5156,2390,2766
50,12,109,Florida,St. Johns County,11,17,4098,1757,2341
50,12,109,Florida,St. Johns County,11,18,3537,1285,2252
50,12,109,Florida,St. Johns County,11,99,186281,90605,95676
50,12,109,Florida,St. Johns County,12,0,1798,897,901
50,12,109,Florida,St. Johns County,12,1,8308,4187,4121
50,12,109,Florida,St. Johns County,12,2,12371,6346,6025
50,12,109,Florida,St. Johns County,12,3,13207,6724,6483
50,12,109,Florida,St. Johns County,12,4,12944,6730,6214
50,12,109,Florida,St. Johns County,12,5,9871,4873,4998
50,12,109,Florida,St. Johns County,12,6,9187,4443,4744
50,12,109,Florida,St. Johns County,12,7,9416,4524,4892
50,12,109,Florida,St. Johns County,12,8,11959,5760,6199
50,12,109,Florida,St. Johns County,12,9,13742,6682,7060
50,12,109,Florida,St. Johns County,12,10,15707,7476,8231
50,12,109,Florida,St. Johns County,12,11,15067,7275,7792
50,12,109,Florida,St. Johns County,12,12,13601,6507,7094
50,12,109,Florida,St. Johns County,12,13,13068,6362,6706
50,12,109,Florida,St. Johns County,12,14,9876,4792,5084
50,12,109,Florida,St. Johns County,12,15,6832,3246,3586
50,12,109,Florida,St. Johns County,12,16,5259,2471,2788
50,12,109,Florida,St. Johns County,12,17,4149,1780,2369
50,12,109,Florida,St. Johns County,12,18,3677,1350,2327
50,12,109,Florida,St. Johns County,12,99,190039,92425,97614
50,12,109,Florida,St. Johns County,13,0,1812,905,907
50,12,109,Florida,St. Johns County,13,1,8341,4205,4136
50,12,109,Florida,St. Johns County,13,2,12443,6380,6063
50,12,109,Florida,St. Johns County,13,3,13268,6748,6520
50,12,109,Florida,St. Johns County,13,4,12950,6733,6217
50,12,109,Florida,St. Johns County,13,5,9959,4913,5046
50,12,109,Florida,St. Johns County,13,6,9279,4497,4782
50,12,109,Florida,St. Johns County,13,7,9533,4576,4957
50,12,109,Florida,St. Johns County,13,8,11939,5754,6185
50,12,109,Florida,St. Johns County,13,9,13809,6715,7094
50,12,109,Florida,St. Johns County,13,10,15734,7492,8242
50,12,109,Florida,St. Johns County,13,11,15177,7329,7848
50,12,109,Florida,St. Johns County,13,12,13752,6578,7174
50,12,109,Florida,St. Johns County,13,13,13260,6453,6807
50,12,109,Florida,St. Johns County,13,14,9984,4848,5136
50,12,109,Florida,St. Johns County,13,15,6906,3282,3624
50,12,109,Florida,St. Johns County,13,16,5284,2491,2793
50,12,109,Florida,St. Johns County,13,17,4174,1794,2380
50,12,109,Florida,St. Johns County,13,18,3719,1368,2351
50,12,109,Florida,St. Johns County,13,99,191323,93061,98262
50,12,111,Florida,St. Lucie County,1,0,2071,1059,1012
50,12,111,Florida,St. Lucie County,1,1,8680,4441,4239
50,12,111,Florida,St. Lucie County,1,2,12418,6321,6097
50,12,111,Florida,St. Lucie County,1,3,13140,6779,6361
50,12,111,Florida,St. Lucie County,1,4,11483,5957,5526
50,12,111,Florida,St. Lucie County,1,5,8501,4436,4065
50,12,111,Florida,St. Lucie County,1,6,9298,4595,4703
50,12,111,Florida,St. Lucie County,1,7,11142,5494,5648
50,12,111,Florida,St. Lucie County,1,8,13861,6859,7002
50,12,111,Florida,St. Lucie County,1,9,14080,6951,7129
50,12,111,Florida,St. Lucie County,1,10,12343,6124,6219
50,12,111,Florida,St. Lucie County,1,11,11317,5456,5861
50,12,111,Florida,St. Lucie County,1,12,10173,4702,5471
50,12,111,Florida,St. Lucie County,1,13,10415,4826,5589
50,12,111,Florida,St. Lucie County,1,14,11634,5541,6093
50,12,111,Florida,St. Lucie County,1,15,12073,5742,6331
50,12,111,Florida,St. Lucie County,1,16,10087,4660,5427
50,12,111,Florida,St. Lucie County,1,17,6010,2712,3298
50,12,111,Florida,St. Lucie County,1,18,3953,1461,2492
50,12,111,Florida,St. Lucie County,1,99,192679,94116,98563
50,12,111,Florida,St. Lucie County,2,0,2103,1074,1029
50,12,111,Florida,St. Lucie County,2,1,8667,4433,4234
50,12,111,Florida,St. Lucie County,2,2,12369,6298,6071
50,12,111,Florida,St. Lucie County,2,3,13233,6827,6406
50,12,111,Florida,St. Lucie County,2,4,11552,5996,5556
50,12,111,Florida,St. Lucie County,2,5,8598,4494,4104
50,12,111,Florida,St. Lucie County,2,6,9249,4573,4676
50,12,111,Florida,St. Lucie County,2,7,11167,5508,5659
50,12,111,Florida,St. Lucie County,2,8,13846,6855,6991
50,12,111,Florida,St. Lucie County,2,9,14156,6991,7165
50,12,111,Florida,St. Lucie County,2,10,12458,6188,6270
50,12,111,Florida,St. Lucie County,2,11,11472,5532,5940
50,12,111,Florida,St. Lucie County,2,12,10271,4749,5522
50,12,111,Florida,St. Lucie County,2,13,10497,4871,5626
50,12,111,Florida,St. Lucie County,2,14,11629,5542,6087
50,12,111,Florida,St. Lucie County,2,15,12095,5762,6333
50,12,111,Florida,St. Lucie County,2,16,10123,4685,5438
50,12,111,Florida,St. Lucie County,2,17,6063,2742,3321
50,12,111,Florida,St. Lucie County,2,18,3970,1468,2502
50,12,111,Florida,St. Lucie County,2,99,193518,94588,98930
50,12,111,Florida,St. Lucie County,3,0,2191,1160,1031
50,12,111,Florida,St. Lucie County,3,1,8849,4493,4356
50,12,111,Florida,St. Lucie County,3,2,12082,6249,5833
50,12,111,Florida,St. Lucie County,3,3,13724,7000,6724
50,12,111,Florida,St. Lucie County,3,4,11993,6244,5749
50,12,111,Florida,St. Lucie County,3,5,9403,4912,4491
50,12,111,Florida,St. Lucie County,3,6,9243,4576,4667
50,12,111,Florida,St. Lucie County,3,7,11119,5488,5631
50,12,111,Florida,St. Lucie County,3,8,13798,6765,7033
50,12,111,Florida,St. Lucie County,3,9,14556,7182,7374
50,12,111,Florida,St. Lucie County,3,10,13291,6603,6688
50,12,111,Florida,St. Lucie County,3,11,12199,5833,6366
50,12,111,Florida,St. Lucie County,3,12,10744,5018,5726
50,12,111,Florida,St. Lucie County,3,13,10753,4989,5764
50,12,111,Florida,St. Lucie County,3,14,11662,5556,6106
50,12,111,Florida,St. Lucie County,3,15,12241,5850,6391
50,12,111,Florida,St. Lucie County,3,16,10255,4746,5509
50,12,111,Florida,St. Lucie County,3,17,6322,2885,3437
50,12,111,Florida,St. Lucie County,3,18,4034,1538,2496
50,12,111,Florida,St. Lucie County,3,99,198459,97087,101372
50,12,111,Florida,St. Lucie County,4,0,2311,1151,1160
50,12,111,Florida,St. Lucie County,4,1,9248,4748,4500
50,12,111,Florida,St. Lucie County,4,2,12255,6295,5960
50,12,111,Florida,St. Lucie County,4,3,13978,7107,6871
50,12,111,Florida,St. Lucie County,4,4,12541,6586,5955
50,12,111,Florida,St. Lucie County,4,5,10186,5346,4840
50,12,111,Florida,St. Lucie County,4,6,9562,4722,4840
50,12,111,Florida,St. Lucie County,4,7,11496,5708,5788
50,12,111,Florida,St. Lucie County,4,8,13690,6680,7010
50,12,111,Florida,St. Lucie County,4,9,15076,7480,7596
50,12,111,Florida,St. Lucie County,4,10,14147,6979,7168
50,12,111,Florida,St. Lucie County,4,11,12566,6051,6515
50,12,111,Florida,St. Lucie County,4,12,11919,5559,6360
50,12,111,Florida,St. Lucie County,4,13,11441,5296,6145
50,12,111,Florida,St. Lucie County,4,14,11952,5727,6225
50,12,111,Florida,St. Lucie County,4,15,12097,5781,6316
50,12,111,Florida,St. Lucie County,4,16,10460,4855,5605
50,12,111,Florida,St. Lucie County,4,17,6673,3005,3668
50,12,111,Florida,St. Lucie County,4,18,4198,1574,2624
50,12,111,Florida,St. Lucie County,4,99,205796,100650,105146
50,12,111,Florida,St. Lucie County,5,0,2379,1221,1158
50,12,111,Florida,St. Lucie County,5,1,9571,4908,4663
50,12,111,Florida,St. Lucie County,5,2,12662,6416,6246
50,12,111,Florida,St. Lucie County,5,3,14336,7298,7038
50,12,111,Florida,St. Lucie County,5,4,13257,6911,6346
50,12,111,Florida,St. Lucie County,5,5,11024,5752,5272
50,12,111,Florida,St. Lucie County,5,6,10007,5013,4994
50,12,111,Florida,St. Lucie County,5,7,11916,5875,6041
50,12,111,Florida,St. Lucie County,5,8,13842,6735,7107
50,12,111,Florida,St. Lucie County,5,9,15567,7736,7831
50,12,111,Florida,St. Lucie County,5,10,15080,7426,7654
50,12,111,Florida,St. Lucie County,5,11,13322,6391,6931
50,12,111,Florida,St. Lucie County,5,12,12857,5977,6880
50,12,111,Florida,St. Lucie County,5,13,12329,5732,6597
50,12,111,Florida,St. Lucie County,5,14,12356,5927,6429
50,12,111,Florida,St. Lucie County,5,15,12252,5871,6381
50,12,111,Florida,St. Lucie County,5,16,10744,5010,5734
50,12,111,Florida,St. Lucie County,5,17,6928,3138,3790
50,12,111,Florida,St. Lucie County,5,18,4495,1698,2797
50,12,111,Florida,St. Lucie County,5,99,214924,105035,109889
50,12,111,Florida,St. Lucie County,6,0,2651,1347,1304
50,12,111,Florida,St. Lucie County,6,1,10566,5363,5203
50,12,111,Florida,St. Lucie County,6,2,13109,6669,6440
50,12,111,Florida,St. Lucie County,6,3,15185,7700,7485
50,12,111,Florida,St. Lucie County,6,4,14170,7353,6817
50,12,111,Florida,St. Lucie County,6,5,11715,6136,5579
50,12,111,Florida,St. Lucie County,6,6,10966,5544,5422
50,12,111,Florida,St. Lucie County,6,7,12718,6250,6468
50,12,111,Florida,St. Lucie County,6,8,14329,7109,7220
50,12,111,Florida,St. Lucie County,6,9,16648,8151,8497
50,12,111,Florida,St. Lucie County,6,10,16354,8109,8245
50,12,111,Florida,St. Lucie County,6,11,14206,6830,7376
50,12,111,Florida,St. Lucie County,6,12,13984,6539,7445
50,12,111,Florida,St. Lucie County,6,13,13327,6194,7133
50,12,111,Florida,St. Lucie County,6,14,13116,6333,6783
50,12,111,Florida,St. Lucie County,6,15,12323,5866,6457
50,12,111,Florida,St. Lucie County,6,16,11064,5196,5868
50,12,111,Florida,St. Lucie County,6,17,7231,3293,3938
50,12,111,Florida,St. Lucie County,6,18,4886,1805,3081
50,12,111,Florida,St. Lucie County,6,99,228548,111787,116761
50,12,111,Florida,St. Lucie County,7,0,2978,1514,1464
50,12,111,Florida,St. Lucie County,7,1,11372,5886,5486
50,12,111,Florida,St. Lucie County,7,2,13981,7134,6847
50,12,111,Florida,St. Lucie County,7,3,15703,7970,7733
50,12,111,Florida,St. Lucie County,7,4,15201,7909,7292
50,12,111,Florida,St. Lucie County,7,5,12563,6529,6034
50,12,111,Florida,St. Lucie County,7,6,12198,6181,6017
50,12,111,Florida,St. Lucie County,7,7,13437,6568,6869
50,12,111,Florida,St. Lucie County,7,8,15255,7561,7694
50,12,111,Florida,St. Lucie County,7,9,17553,8640,8913
50,12,111,Florida,St. Lucie County,7,10,17517,8730,8787
50,12,111,Florida,St. Lucie County,7,11,15546,7487,8059
50,12,111,Florida,St. Lucie County,7,12,15016,7031,7985
50,12,111,Florida,St. Lucie County,7,13,14344,6677,7667
50,12,111,Florida,St. Lucie County,7,14,13371,6419,6952
50,12,111,Florida,St. Lucie County,7,15,12611,6075,6536
50,12,111,Florida,St. Lucie County,7,16,10778,5135,5643
50,12,111,Florida,St. Lucie County,7,17,7526,3399,4127
50,12,111,Florida,St. Lucie County,7,18,5015,1884,3131
50,12,111,Florida,St. Lucie County,7,99,241965,118729,123236
50,12,111,Florida,St. Lucie County,8,0,3214,1648,1566
50,12,111,Florida,St. Lucie County,8,1,12299,6336,5963
50,12,111,Florida,St. Lucie County,8,2,15352,7830,7522
50,12,111,Florida,St. Lucie County,8,3,16244,8340,7904
50,12,111,Florida,St. Lucie County,8,4,16369,8415,7954
50,12,111,Florida,St. Lucie County,8,5,13369,6911,6458
50,12,111,Florida,St. Lucie County,8,6,13608,6868,6740
50,12,111,Florida,St. Lucie County,8,7,14184,6933,7251
50,12,111,Florida,St. Lucie County,8,8,16309,8096,8213
50,12,111,Florida,St. Lucie County,8,9,18143,8965,9178
50,12,111,Florida,St. Lucie County,8,10,18623,9234,9389
50,12,111,Florida,St. Lucie County,8,11,16637,8087,8550
50,12,111,Florida,St. Lucie County,8,12,15969,7466,8503
50,12,111,Florida,St. Lucie County,8,13,14873,7028,7845
50,12,111,Florida,St. Lucie County,8,14,13769,6529,7240
50,12,111,Florida,St. Lucie County,8,15,12532,6060,6472
50,12,111,Florida,St. Lucie County,8,16,10888,5152,5736
50,12,111,Florida,St. Lucie County,8,17,7582,3445,4137
50,12,111,Florida,St. Lucie County,8,18,5287,1992,3295
50,12,111,Florida,St. Lucie County,8,99,255251,125335,129916
50,12,111,Florida,St. Lucie County,9,0,3521,1780,1741
50,12,111,Florida,St. Lucie County,9,1,13281,6850,6431
50,12,111,Florida,St. Lucie County,9,2,16363,8321,8042
50,12,111,Florida,St. Lucie County,9,3,17045,8738,8307
50,12,111,Florida,St. Lucie County,9,4,17286,8881,8405
50,12,111,Florida,St. Lucie County,9,5,13999,7277,6722
50,12,111,Florida,St. Lucie County,9,6,14660,7404,7256
50,12,111,Florida,St. Lucie County,9,7,15024,7354,7670
50,12,111,Florida,St. Lucie County,9,8,17202,8516,8686
50,12,111,Florida,St. Lucie County,9,9,18437,9128,9309
50,12,111,Florida,St. Lucie County,9,10,19397,9735,9662
50,12,111,Florida,St. Lucie County,9,11,17568,8540,9028
50,12,111,Florida,St. Lucie County,9,12,16185,7592,8593
50,12,111,Florida,St. Lucie County,9,13,15792,7502,8290
50,12,111,Florida,St. Lucie County,9,14,14306,6644,7662
50,12,111,Florida,St. Lucie County,9,15,12686,6160,6526
50,12,111,Florida,St. Lucie County,9,16,10824,5098,5726
50,12,111,Florida,St. Lucie County,9,17,7761,3529,4232
50,12,111,Florida,St. Lucie County,9,18,5523,2122,3401
50,12,111,Florida,St. Lucie County,9,99,266860,131171,135689
50,12,111,Florida,St. Lucie County,10,0,3572,1813,1759
50,12,111,Florida,St. Lucie County,10,1,13623,7027,6596
50,12,111,Florida,St. Lucie County,10,2,16680,8561,8119
50,12,111,Florida,St. Lucie County,10,3,17663,9022,8641
50,12,111,Florida,St. Lucie County,10,4,17662,9115,8547
50,12,111,Florida,St. Lucie County,10,5,14445,7474,6971
50,12,111,Florida,St. Lucie County,10,6,14982,7479,7503
50,12,111,Florida,St. Lucie County,10,7,15216,7419,7797
50,12,111,Florida,St. Lucie County,10,8,17481,8545,8936
50,12,111,Florida,St. Lucie County,10,9,18252,9049,9203
50,12,111,Florida,St. Lucie County,10,10,19754,9833,9921
50,12,111,Florida,St. Lucie County,10,11,18397,8919,9478
50,12,111,Florida,St. Lucie County,10,12,16291,7695,8596
50,12,111,Florida,St. Lucie County,10,13,16261,7666,8595
50,12,111,Florida,St. Lucie County,10,14,15114,7067,8047
50,12,111,Florida,St. Lucie County,10,15,12987,6254,6733
50,12,111,Florida,St. Lucie County,10,16,10922,5147,5775
50,12,111,Florida,St. Lucie County,10,17,8052,3643,4409
50,12,111,Florida,St. Lucie County,10,18,5797,2267,3530
50,12,111,Florida,St. Lucie County,10,99,273151,133995,139156
50,12,111,Florida,St. Lucie County,11,0,3107,1555,1552
50,12,111,Florida,St. Lucie County,11,1,13632,7037,6595
50,12,111,Florida,St. Lucie County,11,2,16558,8531,8027
50,12,111,Florida,St. Lucie County,11,3,17433,8845,8588
50,12,111,Florida,St. Lucie County,11,4,17724,9162,8562
50,12,111,Florida,St. Lucie County,11,5,14430,7400,7030
50,12,111,Florida,St. Lucie County,11,6,14788,7335,7453
50,12,111,Florida,St. Lucie County,11,7,15043,7371,7672
50,12,111,Florida,St. Lucie County,11,8,16975,8200,8775
50,12,111,Florida,St. Lucie County,11,9,17878,8915,8963
50,12,111,Florida,St. Lucie County,11,10,19899,9846,10053
50,12,111,Florida,St. Lucie County,11,11,18984,9216,9768
50,12,111,Florida,St. Lucie County,11,12,16665,7871,8794
50,12,111,Florida,St. Lucie County,11,13,16933,8052,8881
50,12,111,Florida,St. Lucie County,11,14,15567,7233,8334
50,12,111,Florida,St. Lucie County,11,15,13374,6461,6913
50,12,111,Florida,St. Lucie County,11,16,10927,5129,5798
50,12,111,Florida,St. Lucie County,11,17,8275,3746,4529
50,12,111,Florida,St. Lucie County,11,18,6152,2425,3727
50,12,111,Florida,St. Lucie County,11,99,274344,134330,140014
50,12,111,Florida,St. Lucie County,12,0,3011,1491,1520
50,12,111,Florida,St. Lucie County,12,1,13407,6912,6495
50,12,111,Florida,St. Lucie County,12,2,16964,8773,8191
50,12,111,Florida,St. Lucie County,12,3,17757,8998,8759
50,12,111,Florida,St. Lucie County,12,4,17656,9129,8527
50,12,111,Florida,St. Lucie County,12,5,14680,7437,7243
50,12,111,Florida,St. Lucie County,12,6,14812,7312,7500
50,12,111,Florida,St. Lucie County,12,7,15298,7512,7786
50,12,111,Florida,St. Lucie County,12,8,16749,8096,8653
50,12,111,Florida,St. Lucie County,12,9,17868,8894,8974
50,12,111,Florida,St. Lucie County,12,10,19885,9822,10063
50,12,111,Florida,St. Lucie County,12,11,19380,9436,9944
50,12,111,Florida,St. Lucie County,12,12,17371,8239,9132
50,12,111,Florida,St. Lucie County,12,13,17573,8308,9265
50,12,111,Florida,St. Lucie County,12,14,15865,7380,8485
50,12,111,Florida,St. Lucie County,12,15,13530,6493,7037
50,12,111,Florida,St. Lucie County,12,16,11135,5243,5892
50,12,111,Florida,St. Lucie County,12,17,8249,3797,4452
50,12,111,Florida,St. Lucie County,12,18,6599,2587,4012
50,12,111,Florida,St. Lucie County,12,99,277789,135859,141930
50,12,111,Florida,St. Lucie County,13,0,3028,1500,1528
50,12,111,Florida,St. Lucie County,13,1,13443,6932,6511
50,12,111,Florida,St. Lucie County,13,2,17033,8800,8233
50,12,111,Florida,St. Lucie County,13,3,17788,9008,8780
50,12,111,Florida,St. Lucie County,13,4,17599,9103,8496
50,12,111,Florida,St. Lucie County,13,5,14771,7480,7291
50,12,111,Florida,St. Lucie County,13,6,14863,7350,7513
50,12,111,Florida,St. Lucie County,13,7,15428,7575,7853
50,12,111,Florida,St. Lucie County,13,8,16677,8057,8620
50,12,111,Florida,St. Lucie County,13,9,17875,8903,8972
50,12,111,Florida,St. Lucie County,13,10,19850,9808,10042
50,12,111,Florida,St. Lucie County,13,11,19454,9473,9981
50,12,111,Florida,St. Lucie County,13,12,17482,8290,9192
50,12,111,Florida,St. Lucie County,13,13,17777,8406,9371
50,12,111,Florida,St. Lucie County,13,14,15973,7438,8535
50,12,111,Florida,St. Lucie County,13,15,13608,6531,7077
50,12,111,Florida,St. Lucie County,13,16,11134,5248,5886
50,12,111,Florida,St. Lucie County,13,17,8255,3808,4447
50,12,111,Florida,St. Lucie County,13,18,6651,2613,4038
50,12,111,Florida,St. Lucie County,13,99,278689,136323,142366
50,12,113,Florida,Santa Rosa County,1,0,1503,760,743
50,12,113,Florida,Santa Rosa County,1,1,6195,3176,3019
50,12,113,Florida,Santa Rosa County,1,2,8388,4371,4017
50,12,113,Florida,Santa Rosa County,1,3,9593,5040,4553
50,12,113,Florida,Santa Rosa County,1,4,8432,4422,4010
50,12,113,Florida,Santa Rosa County,1,5,5638,2880,2758
50,12,113,Florida,Santa Rosa County,1,6,6911,3548,3363
50,12,113,Florida,Santa Rosa County,1,7,8341,4172,4169
50,12,113,Florida,Santa Rosa County,1,8,10849,5449,5400
50,12,113,Florida,Santa Rosa County,1,9,10566,5306,5260
50,12,113,Florida,Santa Rosa County,1,10,8973,4443,4530
50,12,113,Florida,Santa Rosa County,1,11,7684,3856,3828
50,12,113,Florida,Santa Rosa County,1,12,6303,3008,3295
50,12,113,Florida,Santa Rosa County,1,13,5405,2689,2716
50,12,113,Florida,Santa Rosa County,1,14,4545,2241,2304
50,12,113,Florida,Santa Rosa County,1,15,3578,1731,1847
50,12,113,Florida,Santa Rosa County,1,16,2509,1142,1367
50,12,113,Florida,Santa Rosa County,1,17,1341,548,793
50,12,113,Florida,Santa Rosa County,1,18,998,283,715
50,12,113,Florida,Santa Rosa County,1,99,117752,59065,58687
50,12,113,Florida,Santa Rosa County,2,0,1526,768,758
50,12,113,Florida,Santa Rosa County,2,1,6210,3177,3033
50,12,113,Florida,Santa Rosa County,2,2,8372,4364,4008
50,12,113,Florida,Santa Rosa County,2,3,9657,5072,4585
50,12,113,Florida,Santa Rosa County,2,4,8480,4441,4039
50,12,113,Florida,Santa Rosa County,2,5,5706,2919,2787
50,12,113,Florida,Santa Rosa County,2,6,6857,3521,3336
50,12,113,Florida,Santa Rosa County,2,7,8350,4170,4180
50,12,113,Florida,Santa Rosa County,2,8,10841,5446,5395
50,12,113,Florida,Santa Rosa County,2,9,10612,5330,5282
50,12,113,Florida,Santa Rosa County,2,10,9047,4476,4571
50,12,113,Florida,Santa Rosa County,2,11,7789,3907,3882
50,12,113,Florida,Santa Rosa County,2,12,6350,3032,3318
50,12,113,Florida,Santa Rosa County,2,13,5437,2706,2731
50,12,113,Florida,Santa Rosa County,2,14,4583,2260,2323
50,12,113,Florida,Santa Rosa County,2,15,3618,1750,1868
50,12,113,Florida,Santa Rosa County,2,16,2544,1160,1384
50,12,113,Florida,Santa Rosa County,2,17,1370,562,808
50,12,113,Florida,Santa Rosa County,2,18,1011,287,724
50,12,113,Florida,Santa Rosa County,2,99,118360,59348,59012
50,12,113,Florida,Santa Rosa County,3,0,1505,769,736
50,12,113,Florida,Santa Rosa County,3,1,6278,3190,3088
50,12,113,Florida,Santa Rosa County,3,2,8353,4333,4020
50,12,113,Florida,Santa Rosa County,3,3,9816,5166,4650
50,12,113,Florida,Santa Rosa County,3,4,8772,4625,4147
50,12,113,Florida,Santa Rosa County,3,5,6045,3112,2933
50,12,113,Florida,Santa Rosa County,3,6,6692,3426,3266
50,12,113,Florida,Santa Rosa County,3,7,8357,4138,4219
50,12,113,Florida,Santa Rosa County,3,8,10642,5309,5333
50,12,113,Florida,Santa Rosa County,3,9,10978,5509,5469
50,12,113,Florida,Santa Rosa County,3,10,9457,4676,4781
50,12,113,Florida,Santa Rosa County,3,11,8277,4155,4122
50,12,113,Florida,Santa Rosa County,3,12,6614,3222,3392
50,12,113,Florida,Santa Rosa County,3,13,5670,2796,2874
50,12,113,Florida,Santa Rosa County,3,14,4708,2310,2398
50,12,113,Florida,Santa Rosa County,3,15,3869,1897,1972
50,12,113,Florida,Santa Rosa County,3,16,2619,1196,1423
50,12,113,Florida,Santa Rosa County,3,17,1533,642,891
50,12,113,Florida,Santa Rosa County,3,18,1076,292,784
50,12,113,Florida,Santa Rosa County,3,99,121261,60763,60498
50,12,113,Florida,Santa Rosa County,4,0,1598,811,787
50,12,113,Florida,Santa Rosa County,4,1,6635,3354,3281
50,12,113,Florida,Santa Rosa County,4,2,8666,4503,4163
50,12,113,Florida,Santa Rosa County,4,3,10165,5275,4890
50,12,113,Florida,Santa Rosa County,4,4,9289,4906,4383
50,12,113,Florida,Santa Rosa County,4,5,6623,3440,3183
50,12,113,Florida,Santa Rosa County,4,6,6957,3570,3387
50,12,113,Florida,Santa Rosa County,4,7,8775,4348,4427
50,12,113,Florida,Santa Rosa County,4,8,10427,5120,5307
50,12,113,Florida,Santa Rosa County,4,9,11623,5890,5733
50,12,113,Florida,Santa Rosa County,4,10,10038,4949,5089
50,12,113,Florida,Santa Rosa County,4,11,8672,4349,4323
50,12,113,Florida,Santa Rosa County,4,12,7405,3657,3748
50,12,113,Florida,Santa Rosa County,4,13,5993,2925,3068
50,12,113,Florida,Santa Rosa County,4,14,5032,2462,2570
50,12,113,Florida,Santa Rosa County,4,15,4003,2004,1999
50,12,113,Florida,Santa Rosa County,4,16,2770,1278,1492
50,12,113,Florida,Santa Rosa County,4,17,1665,692,973
50,12,113,Florida,Santa Rosa County,4,18,1102,313,789
50,12,113,Florida,Santa Rosa County,4,99,127438,63846,63592
50,12,113,Florida,Santa Rosa County,5,0,1616,860,756
50,12,113,Florida,Santa Rosa County,5,1,6751,3452,3299
50,12,113,Florida,Santa Rosa County,5,2,8973,4579,4394
50,12,113,Florida,Santa Rosa County,5,3,10333,5387,4946
50,12,113,Florida,Santa Rosa County,5,4,9617,5048,4569
50,12,113,Florida,Santa Rosa County,5,5,6833,3536,3297
50,12,113,Florida,Santa Rosa County,5,6,6934,3555,3379
50,12,113,Florida,Santa Rosa County,5,7,8860,4411,4449
50,12,113,Florida,Santa Rosa County,5,8,10126,4892,5234
50,12,113,Florida,Santa Rosa County,5,9,12139,6099,6040
50,12,113,Florida,Santa Rosa County,5,10,10491,5210,5281
50,12,113,Florida,Santa Rosa County,5,11,9117,4533,4584
50,12,113,Florida,Santa Rosa County,5,12,7912,3935,3977
50,12,113,Florida,Santa Rosa County,5,13,6473,3143,3330
50,12,113,Florida,Santa Rosa County,5,14,5304,2608,2696
50,12,113,Florida,Santa Rosa County,5,15,4118,2070,2048
50,12,113,Florida,Santa Rosa County,5,16,2959,1361,1598
50,12,113,Florida,Santa Rosa County,5,17,1792,769,1023
50,12,113,Florida,Santa Rosa County,5,18,1115,342,773
50,12,113,Florida,Santa Rosa County,5,99,131463,65790,65673
50,12,113,Florida,Santa Rosa County,6,0,1682,818,864
50,12,113,Florida,Santa Rosa County,6,1,6886,3472,3414
50,12,113,Florida,Santa Rosa County,6,2,9254,4757,4497
50,12,113,Florida,Santa Rosa County,6,3,10461,5444,5017
50,12,113,Florida,Santa Rosa County,6,4,10107,5247,4860
50,12,113,Florida,Santa Rosa County,6,5,7525,4072,3453
50,12,113,Florida,Santa Rosa County,6,6,7409,3815,3594
50,12,113,Florida,Santa Rosa County,6,7,8998,4495,4503
50,12,113,Florida,Santa Rosa County,6,8,10075,4893,5182
50,12,113,Florida,Santa Rosa County,6,9,12584,6385,6199
50,12,113,Florida,Santa Rosa County,6,10,11129,5506,5623
50,12,113,Florida,Santa Rosa County,6,11,9637,4775,4862
50,12,113,Florida,Santa Rosa County,6,12,8422,4177,4245
50,12,113,Florida,Santa Rosa County,6,13,6989,3379,3610
50,12,113,Florida,Santa Rosa County,6,14,5648,2812,2836
50,12,113,Florida,Santa Rosa County,6,15,4233,2114,2119
50,12,113,Florida,Santa Rosa County,6,16,3131,1462,1669
50,12,113,Florida,Santa Rosa County,6,17,1909,815,1094
50,12,113,Florida,Santa Rosa County,6,18,1162,352,810
50,12,113,Florida,Santa Rosa County,6,99,137241,68790,68451
50,12,113,Florida,Santa Rosa County,7,0,1744,863,881
50,12,113,Florida,Santa Rosa County,7,1,6947,3547,3400
50,12,113,Florida,Santa Rosa County,7,2,9595,4942,4653
50,12,113,Florida,Santa Rosa County,7,3,10548,5483,5065
50,12,113,Florida,Santa Rosa County,7,4,10469,5496,4973
50,12,113,Florida,Santa Rosa County,7,5,7793,4195,3598
50,12,113,Florida,Santa Rosa County,7,6,7812,4047,3765
50,12,113,Florida,Santa Rosa County,7,7,8917,4516,4401
50,12,113,Florida,Santa Rosa County,7,8,10082,4852,5230
50,12,113,Florida,Santa Rosa County,7,9,12763,6426,6337
50,12,113,Florida,Santa Rosa County,7,10,11758,5860,5898
50,12,113,Florida,Santa Rosa County,7,11,10025,4930,5095
50,12,113,Florida,Santa Rosa County,7,12,9005,4459,4546
50,12,113,Florida,Santa Rosa County,7,13,7265,3561,3704
50,12,113,Florida,Santa Rosa County,7,14,5789,2887,2902
50,12,113,Florida,Santa Rosa County,7,15,4412,2167,2245
50,12,113,Florida,Santa Rosa County,7,16,3123,1465,1658
50,12,113,Florida,Santa Rosa County,7,17,1872,789,1083
50,12,113,Florida,Santa Rosa County,7,18,1213,383,830
50,12,113,Florida,Santa Rosa County,7,99,141132,70868,70264
50,12,113,Florida,Santa Rosa County,8,0,1831,909,922
50,12,113,Florida,Santa Rosa County,8,1,6842,3501,3341
50,12,113,Florida,Santa Rosa County,8,2,9885,5050,4835
50,12,113,Florida,Santa Rosa County,8,3,10361,5384,4977
50,12,113,Florida,Santa Rosa County,8,4,10636,5519,5117
50,12,113,Florida,Santa Rosa County,8,5,7942,4320,3622
50,12,113,Florida,Santa Rosa County,8,6,8224,4267,3957
50,12,113,Florida,Santa Rosa County,8,7,8762,4475,4287
50,12,113,Florida,Santa Rosa County,8,8,10147,4900,5247
50,12,113,Florida,Santa Rosa County,8,9,12410,6267,6143
50,12,113,Florida,Santa Rosa County,8,10,12331,6129,6202
50,12,113,Florida,Santa Rosa County,8,11,10433,5195,5238
50,12,113,Florida,Santa Rosa County,8,12,9289,4630,4659
50,12,113,Florida,Santa Rosa County,8,13,7300,3619,3681
50,12,113,Florida,Santa Rosa County,8,14,5852,2881,2971
50,12,113,Florida,Santa Rosa County,8,15,4337,2127,2210
50,12,113,Florida,Santa Rosa County,8,16,3180,1481,1699
50,12,113,Florida,Santa Rosa County,8,17,1913,778,1135
50,12,113,Florida,Santa Rosa County,8,18,1308,401,907
50,12,113,Florida,Santa Rosa County,8,99,142983,71833,71150
50,12,113,Florida,Santa Rosa County,9,0,1868,931,937
50,12,113,Florida,Santa Rosa County,9,1,7055,3561,3494
50,12,113,Florida,Santa Rosa County,9,2,9922,5067,4855
50,12,113,Florida,Santa Rosa County,9,3,10379,5427,4952
50,12,113,Florida,Santa Rosa County,9,4,10805,5574,5231
50,12,113,Florida,Santa Rosa County,9,5,8457,4626,3831
50,12,113,Florida,Santa Rosa County,9,6,8711,4654,4057
50,12,113,Florida,Santa Rosa County,9,7,8774,4571,4203
50,12,113,Florida,Santa Rosa County,9,8,10372,5041,5331
50,12,113,Florida,Santa Rosa County,9,9,11979,6062,5917
50,12,113,Florida,Santa Rosa County,9,10,12704,6351,6353
50,12,113,Florida,Santa Rosa County,9,11,10790,5363,5427
50,12,113,Florida,Santa Rosa County,9,12,9335,4675,4660
50,12,113,Florida,Santa Rosa County,9,13,7737,3855,3882
50,12,113,Florida,Santa Rosa County,9,14,6028,2885,3143
50,12,113,Florida,Santa Rosa County,9,15,4542,2207,2335
50,12,113,Florida,Santa Rosa County,9,16,3239,1524,1715
50,12,113,Florida,Santa Rosa County,9,17,2025,854,1171
50,12,113,Florida,Santa Rosa County,9,18,1436,447,989
50,12,113,Florida,Santa Rosa County,9,99,146158,73675,72483
50,12,113,Florida,Santa Rosa County,10,0,1889,941,948
50,12,113,Florida,Santa Rosa County,10,1,7277,3723,3554
50,12,113,Florida,Santa Rosa County,10,2,9859,5051,4808
50,12,113,Florida,Santa Rosa County,10,3,10489,5422,5067
50,12,113,Florida,Santa Rosa County,10,4,10875,5635,5240
50,12,113,Florida,Santa Rosa County,10,5,8632,4738,3894
50,12,113,Florida,Santa Rosa County,10,6,9058,4910,4148
50,12,113,Florida,Santa Rosa County,10,7,8905,4647,4258
50,12,113,Florida,Santa Rosa County,10,8,10397,5158,5239
50,12,113,Florida,Santa Rosa County,10,9,11571,5773,5798
50,12,113,Florida,Santa Rosa County,10,10,12929,6501,6428
50,12,113,Florida,Santa Rosa County,10,11,11148,5570,5578
50,12,113,Florida,Santa Rosa County,10,12,9354,4673,4681
50,12,113,Florida,Santa Rosa County,10,13,8076,4003,4073
50,12,113,Florida,Santa Rosa County,10,14,6402,3060,3342
50,12,113,Florida,Santa Rosa County,10,15,4770,2321,2449
50,12,113,Florida,Santa Rosa County,10,16,3264,1549,1715
50,12,113,Florida,Santa Rosa County,10,17,2127,915,1212
50,12,113,Florida,Santa Rosa County,10,18,1516,506,1010
50,12,113,Florida,Santa Rosa County,10,99,148538,75096,73442
50,12,113,Florida,Santa Rosa County,11,0,1749,863,886
50,12,113,Florida,Santa Rosa County,11,1,7371,3787,3584
50,12,113,Florida,Santa Rosa County,11,2,9642,4874,4768
50,12,113,Florida,Santa Rosa County,11,3,10518,5437,5081
50,12,113,Florida,Santa Rosa County,11,4,10701,5583,5118
50,12,113,Florida,Santa Rosa County,11,5,8812,4849,3963
50,12,113,Florida,Santa Rosa County,11,6,9360,5087,4273
50,12,113,Florida,Santa Rosa County,11,7,8898,4556,4342
50,12,113,Florida,Santa Rosa County,11,8,10046,5021,5025
50,12,113,Florida,Santa Rosa County,11,9,11222,5618,5604
50,12,113,Florida,Santa Rosa County,11,10,13016,6551,6465
50,12,113,Florida,Santa Rosa County,11,11,11331,5636,5695
50,12,113,Florida,Santa Rosa County,11,12,9628,4739,4889
50,12,113,Florida,Santa Rosa County,11,13,8388,4155,4233
50,12,113,Florida,Santa Rosa County,11,14,6684,3188,3496
50,12,113,Florida,Santa Rosa County,11,15,4994,2423,2571
50,12,113,Florida,Santa Rosa County,11,16,3384,1595,1789
50,12,113,Florida,Santa Rosa County,11,17,2213,942,1271
50,12,113,Florida,Santa Rosa County,11,18,1587,555,1032
50,12,113,Florida,Santa Rosa County,11,99,149544,75459,74085
50,12,113,Florida,Santa Rosa County,12,0,1742,858,884
50,12,113,Florida,Santa Rosa County,12,1,7455,3815,3640
50,12,113,Florida,Santa Rosa County,12,2,9770,4985,4785
50,12,113,Florida,Santa Rosa County,12,3,10620,5453,5167
50,12,113,Florida,Santa Rosa County,12,4,10550,5525,5025
50,12,113,Florida,Santa Rosa County,12,5,8875,4866,4009
50,12,113,Florida,Santa Rosa County,12,6,9507,5157,4350
50,12,113,Florida,Santa Rosa County,12,7,9084,4696,4388
50,12,113,Florida,Santa Rosa County,12,8,9864,4950,4914
50,12,113,Florida,Santa Rosa County,12,9,11029,5548,5481
50,12,113,Florida,Santa Rosa County,12,10,13025,6527,6498
50,12,113,Florida,Santa Rosa County,12,11,11810,5905,5905
50,12,113,Florida,Santa Rosa County,12,12,9872,4830,5042
50,12,113,Florida,Santa Rosa County,12,13,8709,4312,4397
50,12,113,Florida,Santa Rosa County,12,14,6858,3266,3592
50,12,113,Florida,Santa Rosa County,12,15,5185,2528,2657
50,12,113,Florida,Santa Rosa County,12,16,3523,1667,1856
50,12,113,Florida,Santa Rosa County,12,17,2278,975,1303
50,12,113,Florida,Santa Rosa County,12,18,1616,559,1057
50,12,113,Florida,Santa Rosa County,12,99,151372,76422,74950
50,12,113,Florida,Santa Rosa County,13,0,1754,864,890
50,12,113,Florida,Santa Rosa County,13,1,7463,3815,3648
50,12,113,Florida,Santa Rosa County,13,2,9798,5000,4798
50,12,113,Florida,Santa Rosa County,13,3,10638,5455,5183
50,12,113,Florida,Santa Rosa County,13,4,10524,5508,5016
50,12,113,Florida,Santa Rosa County,13,5,8923,4888,4035
50,12,113,Florida,Santa Rosa County,13,6,9563,5195,4368
50,12,113,Florida,Santa Rosa County,13,7,9168,4734,4434
50,12,113,Florida,Santa Rosa County,13,8,9823,4931,4892
50,12,113,Florida,Santa Rosa County,13,9,11059,5566,5493
50,12,113,Florida,Santa Rosa County,13,10,13018,6524,6494
50,12,113,Florida,Santa Rosa County,13,11,11856,5928,5928
50,12,113,Florida,Santa Rosa County,13,12,9956,4871,5085
50,12,113,Florida,Santa Rosa County,13,13,8819,4367,4452
50,12,113,Florida,Santa Rosa County,13,14,6922,3300,3622
50,12,113,Florida,Santa Rosa County,13,15,5231,2550,2681
50,12,113,Florida,Santa Rosa County,13,16,3532,1676,1856
50,12,113,Florida,Santa Rosa County,13,17,2287,981,1306
50,12,113,Florida,Santa Rosa County,13,18,1632,566,1066
50,12,113,Florida,Santa Rosa County,13,99,151966,76719,75247
50,12,115,Florida,Sarasota County,1,0,2540,1283,1257
50,12,115,Florida,Sarasota County,1,1,10257,5209,5048
50,12,115,Florida,Sarasota County,1,2,14870,7661,7209
50,12,115,Florida,Sarasota County,1,3,16026,8256,7770
50,12,115,Florida,Sarasota County,1,4,14340,7446,6894
50,12,115,Florida,Sarasota County,1,5,11180,5849,5331
50,12,115,Florida,Sarasota County,1,6,13181,6672,6509
50,12,115,Florida,Sarasota County,1,7,15987,8015,7972
50,12,115,Florida,Sarasota County,1,8,19878,9821,10057
50,12,115,Florida,Sarasota County,1,9,21642,10553,11089
50,12,115,Florida,Sarasota County,1,10,21120,10010,11110
50,12,115,Florida,Sarasota County,1,11,20695,9605,11090
50,12,115,Florida,Sarasota County,1,12,20539,9147,11392
50,12,115,Florida,Sarasota County,1,13,21130,9475,11655
50,12,115,Florida,Sarasota County,1,14,23468,10950,12518
50,12,115,Florida,Sarasota County,1,15,26125,12041,14084
50,12,115,Florida,Sarasota County,1,16,23845,10774,13071
50,12,115,Florida,Sarasota County,1,17,15986,7006,8980
50,12,115,Florida,Sarasota County,1,18,13193,4659,8534
50,12,115,Florida,Sarasota County,1,99,326002,154432,171570
50,12,115,Florida,Sarasota County,2,0,2575,1297,1278
50,12,115,Florida,Sarasota County,2,1,10241,5206,5035
50,12,115,Florida,Sarasota County,2,2,14827,7639,7188
50,12,115,Florida,Sarasota County,2,3,16134,8311,7823
50,12,115,Florida,Sarasota County,2,4,14410,7484,6926
50,12,115,Florida,Sarasota County,2,5,11300,5910,5390
50,12,115,Florida,Sarasota County,2,6,13104,6633,6471
50,12,115,Florida,Sarasota County,2,7,16015,8033,7982
50,12,115,Florida,Sarasota County,2,8,19853,9813,10040
50,12,115,Florida,Sarasota County,2,9,21729,10593,11136
50,12,115,Florida,Sarasota County,2,10,21290,10094,11196
50,12,115,Florida,Sarasota County,2,11,20970,9737,11233
50,12,115,Florida,Sarasota County,2,12,20723,9234,11489
50,12,115,Florida,Sarasota County,2,13,21285,9548,11737
50,12,115,Florida,Sarasota County,2,14,23383,10921,12462
50,12,115,Florida,Sarasota County,2,15,26098,12052,14046
50,12,115,Florida,Sarasota County,2,16,23892,10811,13081
50,12,115,Florida,Sarasota County,2,17,16099,7067,9032
50,12,115,Florida,Sarasota County,2,18,13237,4684,8553
50,12,115,Florida,Sarasota County,2,99,327165,155067,172098
50,12,115,Florida,Sarasota County,3,0,2750,1401,1349
50,12,115,Florida,Sarasota County,3,1,10515,5302,5213
50,12,115,Florida,Sarasota County,3,2,14811,7625,7186
50,12,115,Florida,Sarasota County,3,3,16859,8611,8248
50,12,115,Florida,Sarasota County,3,4,15076,7913,7163
50,12,115,Florida,Sarasota County,3,5,12090,6251,5839
50,12,115,Florida,Sarasota County,3,6,12653,6442,6211
50,12,115,Florida,Sarasota County,3,7,16407,8193,8214
50,12,115,Florida,Sarasota County,3,8,19774,9817,9957
50,12,115,Florida,Sarasota County,3,9,22090,10752,11338
50,12,115,Florida,Sarasota County,3,10,21960,10421,11539
50,12,115,Florida,Sarasota County,3,11,22303,10396,11907
50,12,115,Florida,Sarasota County,3,12,21419,9572,11847
50,12,115,Florida,Sarasota County,3,13,21922,9821,12101
50,12,115,Florida,Sarasota County,3,14,23452,10912,12540
50,12,115,Florida,Sarasota County,3,15,25739,11976,13763
50,12,115,Florida,Sarasota County,3,16,23679,10818,12861
50,12,115,Florida,Sarasota County,3,17,16807,7371,9436
50,12,115,Florida,Sarasota County,3,18,13401,4862,8539
50,12,115,Florida,Sarasota County,3,99,333707,158456,175251
50,12,115,Florida,Sarasota County,4,0,2838,1449,1389
50,12,115,Florida,Sarasota County,4,1,10863,5475,5388
50,12,115,Florida,Sarasota County,4,2,14912,7655,7257
50,12,115,Florida,Sarasota County,4,3,17399,8877,8522
50,12,115,Florida,Sarasota County,4,4,15735,8169,7566
50,12,115,Florida,Sarasota County,4,5,12787,6625,6162
50,12,115,Florida,Sarasota County,4,6,12604,6435,6169
50,12,115,Florida,Sarasota County,4,7,16340,8226,8114
50,12,115,Florida,Sarasota County,4,8,19723,9755,9968
50,12,115,Florida,Sarasota County,4,9,22416,10974,11442
50,12,115,Florida,Sarasota County,4,10,22663,10739,11924
50,12,115,Florida,Sarasota County,4,11,22445,10447,11998
50,12,115,Florida,Sarasota County,4,12,23162,10436,12726
50,12,115,Florida,Sarasota County,4,13,22907,10282,12625
50,12,115,Florida,Sarasota County,4,14,23790,10995,12795
50,12,115,Florida,Sarasota County,4,15,25465,11993,13472
50,12,115,Florida,Sarasota County,4,16,23692,10865,12827
50,12,115,Florida,Sarasota County,4,17,17201,7555,9646
50,12,115,Florida,Sarasota County,4,18,13648,4972,8676
50,12,115,Florida,Sarasota County,4,99,340590,161924,178666
50,12,115,Florida,Sarasota County,5,0,2937,1523,1414
50,12,115,Florida,Sarasota County,5,1,11330,5774,5556
50,12,115,Florida,Sarasota County,5,2,14894,7634,7260
50,12,115,Florida,Sarasota County,5,3,17753,9020,8733
50,12,115,Florida,Sarasota County,5,4,16296,8417,7879
50,12,115,Florida,Sarasota County,5,5,13569,7034,6535
50,12,115,Florida,Sarasota County,5,6,12938,6750,6188
50,12,115,Florida,Sarasota County,5,7,16296,8182,8114
50,12,115,Florida,Sarasota County,5,8,19361,9574,9787
50,12,115,Florida,Sarasota County,5,9,22673,11098,11575
50,12,115,Florida,Sarasota County,5,10,23174,11071,12103
50,12,115,Florida,Sarasota County,5,11,23046,10715,12331
50,12,115,Florida,Sarasota County,5,12,24112,10905,13207
50,12,115,Florida,Sarasota County,5,13,24401,10966,13435
50,12,115,Florida,Sarasota County,5,14,24239,11172,13067
50,12,115,Florida,Sarasota County,5,15,25276,11890,13386
50,12,115,Florida,Sarasota County,5,16,23909,11075,12834
50,12,115,Florida,Sarasota County,5,17,17591,7728,9863
50,12,115,Florida,Sarasota County,5,18,14067,5207,8860
50,12,115,Florida,Sarasota County,5,99,347862,165735,182127
50,12,115,Florida,Sarasota County,6,0,3027,1534,1493
50,12,115,Florida,Sarasota County,6,1,11930,6148,5782
50,12,115,Florida,Sarasota County,6,2,15095,7734,7361
50,12,115,Florida,Sarasota County,6,3,18116,9218,8898
50,12,115,Florida,Sarasota County,6,4,17180,8828,8352
50,12,115,Florida,Sarasota County,6,5,14330,7436,6894
50,12,115,Florida,Sarasota County,6,6,13494,7004,6490
50,12,115,Florida,Sarasota County,6,7,16316,8252,8064
50,12,115,Florida,Sarasota County,6,8,19288,9608,9680
50,12,115,Florida,Sarasota County,6,9,23070,11253,11817
50,12,115,Florida,Sarasota County,6,10,23856,11444,12412
50,12,115,Florida,Sarasota County,6,11,23842,11088,12754
50,12,115,Florida,Sarasota County,6,12,25143,11408,13735
50,12,115,Florida,Sarasota County,6,13,25966,11718,14248
50,12,115,Florida,Sarasota County,6,14,25323,11646,13677
50,12,115,Florida,Sarasota County,6,15,24951,11838,13113
50,12,115,Florida,Sarasota County,6,16,24093,11173,12920
50,12,115,Florida,Sarasota County,6,17,18136,7905,10231
50,12,115,Florida,Sarasota County,6,18,14595,5474,9121
50,12,115,Florida,Sarasota County,6,99,357751,170709,187042
50,12,115,Florida,Sarasota County,7,0,2994,1505,1489
50,12,115,Florida,Sarasota County,7,1,12207,6215,5992
50,12,115,Florida,Sarasota County,7,2,15610,7887,7723
50,12,115,Florida,Sarasota County,7,3,18414,9430,8984
50,12,115,Florida,Sarasota County,7,4,18076,9205,8871
50,12,115,Florida,Sarasota County,7,5,14817,7680,7137
50,12,115,Florida,Sarasota County,7,6,14329,7411,6918
50,12,115,Florida,Sarasota County,7,7,16094,8045,8049
50,12,115,Florida,Sarasota County,7,8,19593,9805,9788
50,12,115,Florida,Sarasota County,7,9,23286,11297,11989
50,12,115,Florida,Sarasota County,7,10,24839,11967,12872
50,12,115,Florida,Sarasota County,7,11,24949,11618,13331
50,12,115,Florida,Sarasota County,7,12,26491,12021,14470
50,12,115,Florida,Sarasota County,7,13,27445,12312,15133
50,12,115,Florida,Sarasota County,7,14,26204,12169,14035
50,12,115,Florida,Sarasota County,7,15,24816,11819,12997
50,12,115,Florida,Sarasota County,7,16,24245,11240,13005
50,12,115,Florida,Sarasota County,7,17,18449,8080,10369
50,12,115,Florida,Sarasota County,7,18,15054,5722,9332
50,12,115,Florida,Sarasota County,7,99,367912,175428,192484
50,12,115,Florida,Sarasota County,8,0,3047,1581,1466
50,12,115,Florida,Sarasota County,8,1,12148,6154,5994
50,12,115,Florida,Sarasota County,8,2,15745,7950,7795
50,12,115,Florida,Sarasota County,8,3,18271,9450,8821
50,12,115,Florida,Sarasota County,8,4,18581,9469,9112
50,12,115,Florida,Sarasota County,8,5,15103,7924,7179
50,12,115,Florida,Sarasota County,8,6,15067,7733,7334
50,12,115,Florida,Sarasota County,8,7,15600,7892,7708
50,12,115,Florida,Sarasota County,8,8,19570,9663,9907
50,12,115,Florida,Sarasota County,8,9,23005,11224,11781
50,12,115,Florida,Sarasota County,8,10,25271,12200,13071
50,12,115,Florida,Sarasota County,8,11,25484,11948,13536
50,12,115,Florida,Sarasota County,8,12,27548,12465,15083
50,12,115,Florida,Sarasota County,8,13,27959,12580,15379
50,12,115,Florida,Sarasota County,8,14,26663,12453,14210
50,12,115,Florida,Sarasota County,8,15,24691,11702,12989
50,12,115,Florida,Sarasota County,8,16,23633,10977,12656
50,12,115,Florida,Sarasota County,8,17,18271,8061,10210
50,12,115,Florida,Sarasota County,8,18,15704,6043,9661
50,12,115,Florida,Sarasota County,8,99,371361,177469,193892
50,12,115,Florida,Sarasota County,9,0,3208,1652,1556
50,12,115,Florida,Sarasota County,9,1,12037,6137,5900
50,12,115,Florida,Sarasota County,9,2,15824,8061,7763
50,12,115,Florida,Sarasota County,9,3,18358,9489,8869
50,12,115,Florida,Sarasota County,9,4,18819,9601,9218
50,12,115,Florida,Sarasota County,9,5,15460,8064,7396
50,12,115,Florida,Sarasota County,9,6,15643,8040,7603
50,12,115,Florida,Sarasota County,9,7,15195,7695,7500
50,12,115,Florida,Sarasota County,9,8,19668,9726,9942
50,12,115,Florida,Sarasota County,9,9,22417,10933,11484
50,12,115,Florida,Sarasota County,9,10,25602,12428,13174
50,12,115,Florida,Sarasota County,9,11,25910,12135,13775
50,12,115,Florida,Sarasota County,9,12,27001,12258,14743
50,12,115,Florida,Sarasota County,9,13,29319,13249,16070
50,12,115,Florida,Sarasota County,9,14,27676,12897,14779
50,12,115,Florida,Sarasota County,9,15,25034,11846,13188
50,12,115,Florida,Sarasota County,9,16,23448,10948,12500
50,12,115,Florida,Sarasota County,9,17,18432,8208,10224
50,12,115,Florida,Sarasota County,9,18,16274,6287,9987
50,12,115,Florida,Sarasota County,9,99,375325,179654,195671
50,12,115,Florida,Sarasota County,10,0,3125,1584,1541
50,12,115,Florida,Sarasota County,10,1,12030,6135,5895
50,12,115,Florida,Sarasota County,10,2,15923,8046,7877
50,12,115,Florida,Sarasota County,10,3,18057,9317,8740
50,12,115,Florida,Sarasota County,10,4,18778,9642,9136
50,12,115,Florida,Sarasota County,10,5,15336,7892,7444
50,12,115,Florida,Sarasota County,10,6,15800,8114,7686
50,12,115,Florida,Sarasota County,10,7,15143,7732,7411
50,12,115,Florida,Sarasota County,10,8,18970,9301,9669
50,12,115,Florida,Sarasota County,10,9,21515,10485,11030
50,12,115,Florida,Sarasota County,10,10,25526,12319,13207
50,12,115,Florida,Sarasota County,10,11,26198,12286,13912
50,12,115,Florida,Sarasota County,10,12,26966,12220,14746
50,12,115,Florida,Sarasota County,10,13,29817,13537,16280
50,12,115,Florida,Sarasota County,10,14,29275,13500,15775
50,12,115,Florida,Sarasota County,10,15,25753,12234,13519
50,12,115,Florida,Sarasota County,10,16,23433,10952,12481
50,12,115,Florida,Sarasota County,10,17,18629,8354,10275
50,12,115,Florida,Sarasota County,10,18,16904,6489,10415
50,12,115,Florida,Sarasota County,10,99,377178,180139,197039
50,12,115,Florida,Sarasota County,11,0,2864,1472,1392
50,12,115,Florida,Sarasota County,11,1,12014,6159,5855
50,12,115,Florida,Sarasota County,11,2,15747,7994,7753
50,12,115,Florida,Sarasota County,11,3,17877,9170,8707
50,12,115,Florida,Sarasota County,11,4,18460,9471,8989
50,12,115,Florida,Sarasota County,11,5,15107,7806,7301
50,12,115,Florida,Sarasota County,11,6,15878,8124,7754
50,12,115,Florida,Sarasota County,11,7,15147,7650,7497
50,12,115,Florida,Sarasota County,11,8,18290,8939,9351
50,12,115,Florida,Sarasota County,11,9,20685,10063,10622
50,12,115,Florida,Sarasota County,11,10,25236,12122,13114
50,12,115,Florida,Sarasota County,11,11,26427,12439,13988
50,12,115,Florida,Sarasota County,11,12,26996,12260,14736
50,12,115,Florida,Sarasota County,11,13,30159,13690,16469
50,12,115,Florida,Sarasota County,11,14,30507,14099,16408
50,12,115,Florida,Sarasota County,11,15,26516,12504,14012
50,12,115,Florida,Sarasota County,11,16,22913,10789,12124
50,12,115,Florida,Sarasota County,11,17,18927,8493,10434
50,12,115,Florida,Sarasota County,11,18,17512,6738,10774
50,12,115,Florida,Sarasota County,11,99,377262,179982,197280
50,12,115,Florida,Sarasota County,12,0,2791,1420,1371
50,12,115,Florida,Sarasota County,12,1,11833,6068,5765
50,12,115,Florida,Sarasota County,12,2,15902,8101,7801
50,12,115,Florida,Sarasota County,12,3,17814,9093,8721
50,12,115,Florida,Sarasota County,12,4,18363,9523,8840
50,12,115,Florida,Sarasota County,12,5,15253,7758,7495
50,12,115,Florida,Sarasota County,12,6,15816,8090,7726
50,12,115,Florida,Sarasota County,12,7,15366,7788,7578
50,12,115,Florida,Sarasota County,12,8,17649,8585,9064
50,12,115,Florida,Sarasota County,12,9,20467,10003,10464
50,12,115,Florida,Sarasota County,12,10,24875,11952,12923
50,12,115,Florida,Sarasota County,12,11,26757,12626,14131
50,12,115,Florida,Sarasota County,12,12,27384,12480,14904
50,12,115,Florida,Sarasota County,12,13,30951,14045,16906
50,12,115,Florida,Sarasota County,12,14,31362,14437,16925
50,12,115,Florida,Sarasota County,12,15,26961,12756,14205
50,12,115,Florida,Sarasota County,12,16,22833,10793,12040
50,12,115,Florida,Sarasota County,12,17,19045,8521,10524
50,12,115,Florida,Sarasota County,12,18,18026,7002,11024
50,12,115,Florida,Sarasota County,12,99,379448,181041,198407
50,12,115,Florida,Sarasota County,13,0,2789,1422,1367
50,12,115,Florida,Sarasota County,13,1,11788,6049,5739
50,12,115,Florida,Sarasota County,13,2,15892,8090,7802
50,12,115,Florida,Sarasota County,13,3,17779,9074,8705
50,12,115,Florida,Sarasota County,13,4,18251,9460,8791
50,12,115,Florida,Sarasota County,13,5,15302,7781,7521
50,12,115,Florida,Sarasota County,13,6,15838,8108,7730
50,12,115,Florida,Sarasota County,13,7,15468,7838,7630
50,12,115,Florida,Sarasota County,13,8,17498,8510,8988
50,12,115,Florida,Sarasota County,13,9,20411,9983,10428
50,12,115,Florida,Sarasota County,13,10,24775,11903,12872
50,12,115,Florida,Sarasota County,13,11,26786,12631,14155
50,12,115,Florida,Sarasota County,13,12,27514,12540,14974
50,12,115,Florida,Sarasota County,13,13,31246,14184,17062
50,12,115,Florida,Sarasota County,13,14,31526,14525,17001
50,12,115,Florida,Sarasota County,13,15,27058,12810,14248
50,12,115,Florida,Sarasota County,13,16,22784,10780,12004
50,12,115,Florida,Sarasota County,13,17,19041,8537,10504
50,12,115,Florida,Sarasota County,13,18,18128,7061,11067
50,12,115,Florida,Sarasota County,13,99,379874,181286,198588
50,12,117,Florida,Seminole County,1,0,4370,2249,2121
50,12,117,Florida,Seminole County,1,1,18695,9746,8949
50,12,117,Florida,Seminole County,1,2,26211,13324,12887
50,12,117,Florida,Seminole County,1,3,27579,14128,13451
50,12,117,Florida,Seminole County,1,4,24806,12631,12175
50,12,117,Florida,Seminole County,1,5,21563,11060,10503
50,12,117,Florida,Seminole County,1,6,24261,12191,12070
50,12,117,Florida,Seminole County,1,7,27678,13787,13891
50,12,117,Florida,Seminole County,1,8,32452,15963,16489
50,12,117,Florida,Seminole County,1,9,32507,15815,16692
50,12,117,Florida,Seminole County,1,10,28891,13828,15063
50,12,117,Florida,Seminole County,1,11,25759,12609,13150
50,12,117,Florida,Seminole County,1,12,18393,8922,9471
50,12,117,Florida,Seminole County,1,13,13231,6312,6919
50,12,117,Florida,Seminole County,1,14,11434,5229,6205
50,12,117,Florida,Seminole County,1,15,9984,4373,5611
50,12,117,Florida,Seminole County,1,16,8323,3443,4880
50,12,117,Florida,Seminole County,1,17,5215,1994,3221
50,12,117,Florida,Seminole County,1,18,4096,1243,2853
50,12,117,Florida,Seminole County,1,99,365448,178847,186601
50,12,117,Florida,Seminole County,2,0,4424,2275,2149
50,12,117,Florida,Seminole County,2,1,18697,9738,8959
50,12,117,Florida,Seminole County,2,2,26172,13300,12872
50,12,117,Florida,Seminole County,2,3,27817,14256,13561
50,12,117,Florida,Seminole County,2,4,24996,12727,12269
50,12,117,Florida,Seminole County,2,5,21875,11229,10646
50,12,117,Florida,Seminole County,2,6,24121,12115,12006
50,12,117,Florida,Seminole County,2,7,27720,13808,13912
50,12,117,Florida,Seminole County,2,8,32429,15949,16480
50,12,117,Florida,Seminole County,2,9,32706,15911,16795
50,12,117,Florida,Seminole County,2,10,29170,13955,15215
50,12,117,Florida,Seminole County,2,11,26112,12786,13326
50,12,117,Florida,Seminole County,2,12,18568,9002,9566
50,12,117,Florida,Seminole County,2,13,13341,6365,6976
50,12,117,Florida,Seminole County,2,14,11442,5239,6203
50,12,117,Florida,Seminole County,2,15,10015,4398,5617
50,12,117,Florida,Seminole County,2,16,8373,3468,4905
50,12,117,Florida,Seminole County,2,17,5271,2021,3250
50,12,117,Florida,Seminole County,2,18,4129,1255,2874
50,12,117,Florida,Seminole County,2,99,367378,179797,187581
50,12,117,Florida,Seminole County,3,0,4552,2341,2211
50,12,117,Florida,Seminole County,3,1,18603,9576,9027
50,12,117,Florida,Seminole County,3,2,26218,13407,12811
50,12,117,Florida,Seminole County,3,3,28298,14522,13776
50,12,117,Florida,Seminole County,3,4,25557,12998,12559
50,12,117,Florida,Seminole County,3,5,23630,11970,11660
50,12,117,Florida,Seminole County,3,6,23467,11826,11641
50,12,117,Florida,Seminole County,3,7,28045,13972,14073
50,12,117,Florida,Seminole County,3,8,31810,15545,16265
50,12,117,Florida,Seminole County,3,9,33662,16505,17157
50,12,117,Florida,Seminole County,3,10,29967,14342,15625
50,12,117,Florida,Seminole County,3,11,27290,13213,14077
50,12,117,Florida,Seminole County,3,12,19417,9472,9945
50,12,117,Florida,Seminole County,3,13,13978,6677,7301
50,12,117,Florida,Seminole County,3,14,11486,5225,6261
50,12,117,Florida,Seminole County,3,15,10217,4526,5691
50,12,117,Florida,Seminole County,3,16,8422,3429,4993
50,12,117,Florida,Seminole County,3,17,5675,2225,3450
50,12,117,Florida,Seminole County,3,18,4299,1269,3030
50,12,117,Florida,Seminole County,3,99,374593,183040,191553
50,12,117,Florida,Seminole County,4,0,4340,2238,2102
50,12,117,Florida,Seminole County,4,1,18900,9671,9229
50,12,117,Florida,Seminole County,4,2,26331,13587,12744
50,12,117,Florida,Seminole County,4,3,29169,14987,14182
50,12,117,Florida,Seminole County,4,4,26210,13407,12803
50,12,117,Florida,Seminole County,4,5,25198,12656,12542
50,12,117,Florida,Seminole County,4,6,23847,12105,11742
50,12,117,Florida,Seminole County,4,7,27861,13850,14011
50,12,117,Florida,Seminole County,4,8,31352,15311,16041
50,12,117,Florida,Seminole County,4,9,34247,16724,17523
50,12,117,Florida,Seminole County,4,10,31095,15031,16064
50,12,117,Florida,Seminole County,4,11,27198,12991,14207
50,12,117,Florida,Seminole County,4,12,21524,10517,11007
50,12,117,Florida,Seminole County,4,13,14695,6977,7718
50,12,117,Florida,Seminole County,4,14,11630,5270,6360
50,12,117,Florida,Seminole County,4,15,10334,4624,5710
50,12,117,Florida,Seminole County,4,16,8417,3463,4954
50,12,117,Florida,Seminole County,4,17,5977,2278,3699
50,12,117,Florida,Seminole County,4,18,4521,1372,3149
50,12,117,Florida,Seminole County,4,99,382846,187059,195787
50,12,117,Florida,Seminole County,5,0,4475,2291,2184
50,12,117,Florida,Seminole County,5,1,18921,9729,9192
50,12,117,Florida,Seminole County,5,2,26227,13567,12660
50,12,117,Florida,Seminole County,5,3,29324,15027,14297
50,12,117,Florida,Seminole County,5,4,26936,13843,13093
50,12,117,Florida,Seminole County,5,5,26505,13374,13131
50,12,117,Florida,Seminole County,5,6,24477,12424,12053
50,12,117,Florida,Seminole County,5,7,27481,13609,13872
50,12,117,Florida,Seminole County,5,8,30463,14940,15523
50,12,117,Florida,Seminole County,5,9,34310,16704,17606
50,12,117,Florida,Seminole County,5,10,31854,15370,16484
50,12,117,Florida,Seminole County,5,11,27517,13103,14414
50,12,117,Florida,Seminole County,5,12,22513,10972,11541
50,12,117,Florida,Seminole County,5,13,15654,7440,8214
50,12,117,Florida,Seminole County,5,14,11611,5234,6377
50,12,117,Florida,Seminole County,5,15,10354,4629,5725
50,12,117,Florida,Seminole County,5,16,8581,3578,5003
50,12,117,Florida,Seminole County,5,17,6171,2378,3793
50,12,117,Florida,Seminole County,5,18,4767,1443,3324
50,12,117,Florida,Seminole County,5,99,388141,189655,198486
50,12,117,Florida,Seminole County,6,0,4353,2233,2120
50,12,117,Florida,Seminole County,6,1,19037,9874,9163
50,12,117,Florida,Seminole County,6,2,26418,13561,12857
50,12,117,Florida,Seminole County,6,3,29644,15175,14469
50,12,117,Florida,Seminole County,6,4,28060,14443,13617
50,12,117,Florida,Seminole County,6,5,27353,13722,13631
50,12,117,Florida,Seminole County,6,6,25425,12743,12682
50,12,117,Florida,Seminole County,6,7,26837,13145,13692
50,12,117,Florida,Seminole County,6,8,29771,14547,15224
50,12,117,Florida,Seminole County,6,9,34784,16899,17885
50,12,117,Florida,Seminole County,6,10,32676,15762,16914
50,12,117,Florida,Seminole County,6,11,27865,13305,14560
50,12,117,Florida,Seminole County,6,12,24001,11615,12386
50,12,117,Florida,Seminole County,6,13,16526,7864,8662
50,12,117,Florida,Seminole County,6,14,11992,5400,6592
50,12,117,Florida,Seminole County,6,15,10427,4663,5764
50,12,117,Florida,Seminole County,6,16,8560,3546,5014
50,12,117,Florida,Seminole County,6,17,6410,2465,3945
50,12,117,Florida,Seminole County,6,18,5091,1592,3499
50,12,117,Florida,Seminole County,6,99,395230,192554,202676
50,12,117,Florida,Seminole County,7,0,4441,2296,2145
50,12,117,Florida,Seminole County,7,1,19446,9976,9470
50,12,117,Florida,Seminole County,7,2,26730,13737,12993
50,12,117,Florida,Seminole County,7,3,30155,15412,14743
50,12,117,Florida,Seminole County,7,4,29353,15150,14203
50,12,117,Florida,Seminole County,7,5,28362,14311,14051
50,12,117,Florida,Seminole County,7,6,27236,13680,13556
50,12,117,Florida,Seminole County,7,7,26702,12925,13777
50,12,117,Florida,Seminole County,7,8,30073,14750,15323
50,12,117,Florida,Seminole County,7,9,35108,17032,18076
50,12,117,Florida,Seminole County,7,10,33819,16309,17510
50,12,117,Florida,Seminole County,7,11,28770,13678,15092
50,12,117,Florida,Seminole County,7,12,25460,12212,13248
50,12,117,Florida,Seminole County,7,13,17451,8324,9127
50,12,117,Florida,Seminole County,7,14,12441,5701,6740
50,12,117,Florida,Seminole County,7,15,10495,4606,5889
50,12,117,Florida,Seminole County,7,16,8733,3718,5015
50,12,117,Florida,Seminole County,7,17,6634,2546,4088
50,12,117,Florida,Seminole County,7,18,5431,1733,3698
50,12,117,Florida,Seminole County,7,99,406840,198096,208744
50,12,117,Florida,Seminole County,8,0,4528,2319,2209
50,12,117,Florida,Seminole County,8,1,19149,9764,9385
50,12,117,Florida,Seminole County,8,2,27048,13828,13220
50,12,117,Florida,Seminole County,8,3,30310,15484,14826
50,12,117,Florida,Seminole County,8,4,30347,15728,14619
50,12,117,Florida,Seminole County,8,5,29152,14879,14273
50,12,117,Florida,Seminole County,8,6,28527,14112,14415
50,12,117,Florida,Seminole County,8,7,26013,12673,13340
50,12,117,Florida,Seminole County,8,8,30283,14680,15603
50,12,117,Florida,Seminole County,8,9,34349,16676,17673
50,12,117,Florida,Seminole County,8,10,34658,16818,17840
50,12,117,Florida,Seminole County,8,11,29641,14077,15564
50,12,117,Florida,Seminole County,8,12,26503,12607,13896
50,12,117,Florida,Seminole County,8,13,18167,8678,9489
50,12,117,Florida,Seminole County,8,14,12970,6006,6964
50,12,117,Florida,Seminole County,8,15,10341,4565,5776
50,12,117,Florida,Seminole County,8,16,8858,3755,5103
50,12,117,Florida,Seminole County,8,17,6575,2515,4060
50,12,117,Florida,Seminole County,8,18,5799,1852,3947
50,12,117,Florida,Seminole County,8,99,413218,201016,212202
50,12,117,Florida,Seminole County,9,0,4348,2229,2119
50,12,117,Florida,Seminole County,9,1,18619,9508,9111
50,12,117,Florida,Seminole County,9,2,26398,13383,13015
50,12,117,Florida,Seminole County,9,3,29728,15238,14490
50,12,117,Florida,Seminole County,9,4,30763,15898,14865
50,12,117,Florida,Seminole County,9,5,29729,15270,14459
50,12,117,Florida,Seminole County,9,6,28515,14184,14331
50,12,117,Florida,Seminole County,9,7,25617,12529,13088
50,12,117,Florida,Seminole County,9,8,29645,14285,15360
50,12,117,Florida,Seminole County,9,9,33278,16084,17194
50,12,117,Florida,Seminole County,9,10,34777,16815,17962
50,12,117,Florida,Seminole County,9,11,30376,14586,15790
50,12,117,Florida,Seminole County,9,12,26300,12422,13878
50,12,117,Florida,Seminole County,9,13,19887,9495,10392
50,12,117,Florida,Seminole County,9,14,13526,6234,7292
50,12,117,Florida,Seminole County,9,15,10457,4587,5870
50,12,117,Florida,Seminole County,9,16,8847,3795,5052
50,12,117,Florida,Seminole County,9,17,6657,2591,4066
50,12,117,Florida,Seminole County,9,18,6104,1959,4145
50,12,117,Florida,Seminole County,9,99,413571,201092,212479
50,12,117,Florida,Seminole County,10,0,4224,2143,2081
50,12,117,Florida,Seminole County,10,1,18820,9574,9246
50,12,117,Florida,Seminole County,10,2,25954,13244,12710
50,12,117,Florida,Seminole County,10,3,29417,15125,14292
50,12,117,Florida,Seminole County,10,4,30946,15802,15144
50,12,117,Florida,Seminole County,10,5,30043,15483,14560
50,12,117,Florida,Seminole County,10,6,28772,14249,14523
50,12,117,Florida,Seminole County,10,7,25659,12623,13036
50,12,117,Florida,Seminole County,10,8,29097,13964,15133
50,12,117,Florida,Seminole County,10,9,32314,15641,16673
50,12,117,Florida,Seminole County,10,10,34892,16836,18056
50,12,117,Florida,Seminole County,10,11,31127,14860,16267
50,12,117,Florida,Seminole County,10,12,26603,12462,14141
50,12,117,Florida,Seminole County,10,13,21225,10184,11041
50,12,117,Florida,Seminole County,10,14,14642,6785,7857
50,12,117,Florida,Seminole County,10,15,10561,4623,5938
50,12,117,Florida,Seminole County,10,16,9017,3858,5159
50,12,117,Florida,Seminole County,10,17,6808,2675,4133
50,12,117,Florida,Seminole County,10,18,6443,2088,4355
50,12,117,Florida,Seminole County,10,99,416564,202219,214345
50,12,117,Florida,Seminole County,11,0,4265,2188,2077
50,12,117,Florida,Seminole County,11,1,18971,9577,9394
50,12,117,Florida,Seminole County,11,2,25649,13054,12595
50,12,117,Florida,Seminole County,11,3,29078,14977,14101
50,12,117,Florida,Seminole County,11,4,31094,15892,15202
50,12,117,Florida,Seminole County,11,5,30534,15780,14754
50,12,117,Florida,Seminole County,11,6,28630,14282,14348
50,12,117,Florida,Seminole County,11,7,25931,12731,13200
50,12,117,Florida,Seminole County,11,8,28378,13601,14777
50,12,117,Florida,Seminole County,11,9,31397,15174,16223
50,12,117,Florida,Seminole County,11,10,34962,16843,18119
50,12,117,Florida,Seminole County,11,11,31909,15261,16648
50,12,117,Florida,Seminole County,11,12,27076,12654,14422
50,12,117,Florida,Seminole County,11,13,22652,10760,11892
50,12,117,Florida,Seminole County,11,14,15643,7301,8342
50,12,117,Florida,Seminole County,11,15,10891,4785,6106
50,12,117,Florida,Seminole County,11,16,9127,3907,5220
50,12,117,Florida,Seminole County,11,17,6811,2675,4136
50,12,117,Florida,Seminole County,11,18,6790,2223,4567
50,12,117,Florida,Seminole County,11,99,419788,203665,216123
50,12,117,Florida,Seminole County,12,0,4427,2272,2155
50,12,117,Florida,Seminole County,12,1,18936,9568,9368
50,12,117,Florida,Seminole County,12,2,25722,12982,12740
50,12,117,Florida,Seminole County,12,3,28998,14922,14076
50,12,117,Florida,Seminole County,12,4,30877,15796,15081
50,12,117,Florida,Seminole County,12,5,30888,15862,15026
50,12,117,Florida,Seminole County,12,6,28331,14129,14202
50,12,117,Florida,Seminole County,12,7,26477,12997,13480
50,12,117,Florida,Seminole County,12,8,27657,13237,14420
50,12,117,Florida,Seminole County,12,9,31202,15011,16191
50,12,117,Florida,Seminole County,12,10,34747,16785,17962
50,12,117,Florida,Seminole County,12,11,32563,15527,17036
50,12,117,Florida,Seminole County,12,12,27577,12871,14706
50,12,117,Florida,Seminole County,12,13,23639,11227,12412
50,12,117,Florida,Seminole County,12,14,16390,7674,8716
50,12,117,Florida,Seminole County,12,15,11243,5028,6215
50,12,117,Florida,Seminole County,12,16,9267,3890,5377
50,12,117,Florida,Seminole County,12,17,6879,2763,4116
50,12,117,Florida,Seminole County,12,18,6898,2258,4640
50,12,117,Florida,Seminole County,12,99,422718,204799,217919
50,12,117,Florida,Seminole County,13,0,4438,2277,2161
50,12,117,Florida,Seminole County,13,1,18918,9560,9358
50,12,117,Florida,Seminole County,13,2,25762,12998,12764
50,12,117,Florida,Seminole County,13,3,28999,14921,14078
50,12,117,Florida,Seminole County,13,4,30741,15727,15014
50,12,117,Florida,Seminole County,13,5,31018,15922,15096
50,12,117,Florida,Seminole County,13,6,28393,14183,14210
50,12,117,Florida,Seminole County,13,7,26669,13089,13580
50,12,117,Florida,Seminole County,13,8,27516,13165,14351
50,12,117,Florida,Seminole County,13,9,31196,15013,16183
50,12,117,Florida,Seminole County,13,10,34661,16741,17920
50,12,117,Florida,Seminole County,13,11,32668,15570,17098
50,12,117,Florida,Seminole County,13,12,27738,12948,14790
50,12,117,Florida,Seminole County,13,13,23881,11346,12535
50,12,117,Florida,Seminole County,13,14,16482,7725,8757
50,12,117,Florida,Seminole County,13,15,11305,5060,6245
50,12,117,Florida,Seminole County,13,16,9275,3898,5377
50,12,117,Florida,Seminole County,13,17,6894,2780,4114
50,12,117,Florida,Seminole County,13,18,6954,2281,4673
50,12,117,Florida,Seminole County,13,99,423508,205204,218304
50,12,119,Florida,Sumter County,1,0,412,224,188
50,12,119,Florida,Sumter County,1,1,1696,891,805
50,12,119,Florida,Sumter County,1,2,2423,1221,1202
50,12,119,Florida,Sumter County,1,3,2463,1293,1170
50,12,119,Florida,Sumter County,1,4,2467,1316,1151
50,12,119,Florida,Sumter County,1,5,2280,1391,889
50,12,119,Florida,Sumter County,1,6,2792,1803,989
50,12,119,Florida,Sumter County,1,7,2929,1893,1036
50,12,119,Florida,Sumter County,1,8,3446,2112,1334
50,12,119,Florida,Sumter County,1,9,3245,1806,1439
50,12,119,Florida,Sumter County,1,10,2942,1654,1288
50,12,119,Florida,Sumter County,1,11,3065,1547,1518
50,12,119,Florida,Sumter County,1,12,3687,1669,2018
50,12,119,Florida,Sumter County,1,13,4879,2346,2533
50,12,119,Florida,Sumter County,1,14,5315,2663,2652
50,12,119,Florida,Sumter County,1,15,4160,2126,2034
50,12,119,Florida,Sumter County,1,16,2783,1358,1425
50,12,119,Florida,Sumter County,1,17,1482,709,773
50,12,119,Florida,Sumter County,1,18,871,286,585
50,12,119,Florida,Sumter County,1,99,53337,28308,25029
50,12,119,Florida,Sumter County,2,0,415,224,191
50,12,119,Florida,Sumter County,2,1,1689,887,802
50,12,119,Florida,Sumter County,2,2,2400,1207,1193
50,12,119,Florida,Sumter County,2,3,2459,1292,1167
50,12,119,Florida,Sumter County,2,4,2458,1310,1148
50,12,119,Florida,Sumter County,2,5,2275,1386,889
50,12,119,Florida,Sumter County,2,6,2755,1780,975
50,12,119,Florida,Sumter County,2,7,2918,1887,1031
50,12,119,Florida,Sumter County,2,8,3423,2101,1322
50,12,119,Florida,Sumter County,2,9,3242,1806,1436
50,12,119,Florida,Sumter County,2,10,2946,1659,1287
50,12,119,Florida,Sumter County,2,11,3086,1557,1529
50,12,119,Florida,Sumter County,2,12,3704,1676,2028
50,12,119,Florida,Sumter County,2,13,4881,2348,2533
50,12,119,Florida,Sumter County,2,14,5425,2714,2711
50,12,119,Florida,Sumter County,2,15,4333,2214,2119
50,12,119,Florida,Sumter County,2,16,2886,1414,1472
50,12,119,Florida,Sumter County,2,17,1537,740,797
50,12,119,Florida,Sumter County,2,18,906,306,600
50,12,119,Florida,Sumter County,2,99,53738,28508,25230
50,12,119,Florida,Sumter County,3,0,451,216,235
50,12,119,Florida,Sumter County,3,1,1640,886,754
50,12,119,Florida,Sumter County,3,2,2285,1143,1142
50,12,119,Florida,Sumter County,3,3,2431,1260,1171
50,12,119,Florida,Sumter County,3,4,2421,1331,1090
50,12,119,Florida,Sumter County,3,5,2333,1410,923
50,12,119,Florida,Sumter County,3,6,2702,1766,936
50,12,119,Florida,Sumter County,3,7,2953,1951,1002
50,12,119,Florida,Sumter County,3,8,3435,2176,1259
50,12,119,Florida,Sumter County,3,9,3303,1893,1410
50,12,119,Florida,Sumter County,3,10,3025,1731,1294
50,12,119,Florida,Sumter County,3,11,3166,1616,1550
50,12,119,Florida,Sumter County,3,12,3616,1668,1948
50,12,119,Florida,Sumter County,3,13,4928,2313,2615
50,12,119,Florida,Sumter County,3,14,5883,2950,2933
50,12,119,Florida,Sumter County,3,15,5071,2589,2482
50,12,119,Florida,Sumter County,3,16,3319,1652,1667
50,12,119,Florida,Sumter County,3,17,1776,874,902
50,12,119,Florida,Sumter County,3,18,1055,383,672
50,12,119,Florida,Sumter County,3,99,55793,29808,25985
50,12,119,Florida,Sumter County,4,0,419,208,211
50,12,119,Florida,Sumter County,4,1,1731,902,829
50,12,119,Florida,Sumter County,4,2,2141,1084,1057
50,12,119,Florida,Sumter County,4,3,2476,1293,1183
50,12,119,Florida,Sumter County,4,4,2392,1316,1076
50,12,119,Florida,Sumter County,4,5,2407,1490,917
50,12,119,Florida,Sumter County,4,6,2734,1808,926
50,12,119,Florida,Sumter County,4,7,3135,2111,1024
50,12,119,Florida,Sumter County,4,8,3534,2320,1214
50,12,119,Florida,Sumter County,4,9,3465,2077,1388
50,12,119,Florida,Sumter County,4,10,3229,1848,1381
50,12,119,Florida,Sumter County,4,11,3236,1637,1599
50,12,119,Florida,Sumter County,4,12,4108,1933,2175
50,12,119,Florida,Sumter County,4,13,5447,2540,2907
50,12,119,Florida,Sumter County,4,14,6355,3172,3183
50,12,119,Florida,Sumter County,4,15,5780,2954,2826
50,12,119,Florida,Sumter County,4,16,3735,1878,1857
50,12,119,Florida,Sumter County,4,17,2008,1005,1003
50,12,119,Florida,Sumter County,4,18,1207,465,742
50,12,119,Florida,Sumter County,4,99,59539,32041,27498
50,12,119,Florida,Sumter County,5,0,467,242,225
50,12,119,Florida,Sumter County,5,1,1717,875,842
50,12,119,Florida,Sumter County,5,2,2119,1090,1029
50,12,119,Florida,Sumter County,5,3,2376,1239,1137
50,12,119,Florida,Sumter County,5,4,2313,1271,1042
50,12,119,Florida,Sumter County,5,5,2465,1574,891
50,12,119,Florida,Sumter County,5,6,2817,1881,936
50,12,119,Florida,Sumter County,5,7,3274,2217,1057
50,12,119,Florida,Sumter County,5,8,3533,2383,1150
50,12,119,Florida,Sumter County,5,9,3498,2129,1369
50,12,119,Florida,Sumter County,5,10,3353,1943,1410
50,12,119,Florida,Sumter County,5,11,3169,1661,1508
50,12,119,Florida,Sumter County,5,12,4158,1960,2198
50,12,119,Florida,Sumter County,5,13,5536,2558,2978
50,12,119,Florida,Sumter County,5,14,6887,3420,3467
50,12,119,Florida,Sumter County,5,15,6484,3310,3174
50,12,119,Florida,Sumter County,5,16,4163,2111,2052
50,12,119,Florida,Sumter County,5,17,2244,1137,1107
50,12,119,Florida,Sumter County,5,18,1361,544,817
50,12,119,Florida,Sumter County,5,99,61934,33545,28389
50,12,119,Florida,Sumter County,6,0,450,219,231
50,12,119,Florida,Sumter County,6,1,1740,894,846
50,12,119,Florida,Sumter County,6,2,2044,1071,973
50,12,119,Florida,Sumter County,6,3,2372,1233,1139
50,12,119,Florida,Sumter County,6,4,2324,1281,1043
50,12,119,Florida,Sumter County,6,5,2450,1541,909
50,12,119,Florida,Sumter County,6,6,2729,1833,896
50,12,119,Florida,Sumter County,6,7,3245,2200,1045
50,12,119,Florida,Sumter County,6,8,3447,2344,1103
50,12,119,Florida,Sumter County,6,9,3518,2151,1367
50,12,119,Florida,Sumter County,6,10,3370,1964,1406
50,12,119,Florida,Sumter County,6,11,3249,1675,1574
50,12,119,Florida,Sumter County,6,12,4290,2076,2214
50,12,119,Florida,Sumter County,6,13,5829,2648,3181
50,12,119,Florida,Sumter County,6,14,7649,3760,3889
50,12,119,Florida,Sumter County,6,15,7212,3689,3523
50,12,119,Florida,Sumter County,6,16,4578,2340,2238
50,12,119,Florida,Sumter County,6,17,2471,1265,1206
50,12,119,Florida,Sumter County,6,18,1489,615,874
50,12,119,Florida,Sumter County,6,99,64456,34799,29657
50,12,119,Florida,Sumter County,7,0,486,241,245
50,12,119,Florida,Sumter County,7,1,1761,897,864
50,12,119,Florida,Sumter County,7,2,2050,1064,986
50,12,119,Florida,Sumter County,7,3,2380,1247,1133
50,12,119,Florida,Sumter County,7,4,2350,1257,1093
50,12,119,Florida,Sumter County,7,5,2510,1565,945
50,12,119,Florida,Sumter County,7,6,2792,1883,909
50,12,119,Florida,Sumter County,7,7,3288,2237,1051
50,12,119,Florida,Sumter County,7,8,3472,2372,1100
50,12,119,Florida,Sumter County,7,9,3623,2211,1412
50,12,119,Florida,Sumter County,7,10,3524,2024,1500
50,12,119,Florida,Sumter County,7,11,3454,1768,1686
50,12,119,Florida,Sumter County,7,12,4935,2321,2614
50,12,119,Florida,Sumter County,7,13,6795,3073,3722
50,12,119,Florida,Sumter County,7,14,8477,4138,4339
50,12,119,Florida,Sumter County,7,15,7972,4076,3896
50,12,119,Florida,Sumter County,7,16,5040,2593,2447
50,12,119,Florida,Sumter County,7,17,2711,1403,1308
50,12,119,Florida,Sumter County,7,18,1641,695,946
50,12,119,Florida,Sumter County,7,99,69261,37065,32196
50,12,119,Florida,Sumter County,8,0,483,267,216
50,12,119,Florida,Sumter County,8,1,1837,952,885
50,12,119,Florida,Sumter County,8,2,2127,1122,1005
50,12,119,Florida,Sumter County,8,3,2399,1242,1157
50,12,119,Florida,Sumter County,8,4,2424,1314,1110
50,12,119,Florida,Sumter County,8,5,2567,1614,953
50,12,119,Florida,Sumter County,8,6,2921,1916,1005
50,12,119,Florida,Sumter County,8,7,3397,2352,1045
50,12,119,Florida,Sumter County,8,8,3618,2498,1120
50,12,119,Florida,Sumter County,8,9,3724,2315,1409
50,12,119,Florida,Sumter County,8,10,3735,2158,1577
50,12,119,Florida,Sumter County,8,11,3829,1919,1910
50,12,119,Florida,Sumter County,8,12,5949,2754,3195
50,12,119,Florida,Sumter County,8,13,8348,3729,4619
50,12,119,Florida,Sumter County,8,14,9652,4693,4959
50,12,119,Florida,Sumter County,8,15,8841,4523,4318
50,12,119,Florida,Sumter County,8,16,5539,2871,2668
50,12,119,Florida,Sumter County,8,17,2996,1560,1436
50,12,119,Florida,Sumter County,8,18,1816,787,1029
50,12,119,Florida,Sumter County,8,99,76202,40586,35616
50,12,119,Florida,Sumter County,9,0,505,262,243
50,12,119,Florida,Sumter County,9,1,1907,970,937
50,12,119,Florida,Sumter County,9,2,2171,1130,1041
50,12,119,Florida,Sumter County,9,3,2318,1206,1112
50,12,119,Florida,Sumter County,9,4,2553,1363,1190
50,12,119,Florida,Sumter County,9,5,2631,1632,999
50,12,119,Florida,Sumter County,9,6,2996,1979,1017
50,12,119,Florida,Sumter County,9,7,3448,2422,1026
50,12,119,Florida,Sumter County,9,8,3823,2681,1142
50,12,119,Florida,Sumter County,9,9,3778,2396,1382
50,12,119,Florida,Sumter County,9,10,3987,2301,1686
50,12,119,Florida,Sumter County,9,11,4090,2039,2051
50,12,119,Florida,Sumter County,9,12,6324,2844,3480
50,12,119,Florida,Sumter County,9,13,9807,4381,5426
50,12,119,Florida,Sumter County,9,14,10812,5197,5615
50,12,119,Florida,Sumter County,9,15,9670,4942,4728
50,12,119,Florida,Sumter County,9,16,6029,3132,2897
50,12,119,Florida,Sumter County,9,17,3265,1707,1558
50,12,119,Florida,Sumter County,9,18,1987,875,1112
50,12,119,Florida,Sumter County,9,99,82101,43459,38642
50,12,119,Florida,Sumter County,10,0,481,243,238
50,12,119,Florida,Sumter County,10,1,1948,983,965
50,12,119,Florida,Sumter County,10,2,2192,1120,1072
50,12,119,Florida,Sumter County,10,3,2339,1231,1108
50,12,119,Florida,Sumter County,10,4,2525,1347,1178
50,12,119,Florida,Sumter County,10,5,2589,1600,989
50,12,119,Florida,Sumter County,10,6,3082,2018,1064
50,12,119,Florida,Sumter County,10,7,3537,2486,1051
50,12,119,Florida,Sumter County,10,8,3834,2686,1148
50,12,119,Florida,Sumter County,10,9,3723,2360,1363
50,12,119,Florida,Sumter County,10,10,4034,2364,1670
50,12,119,Florida,Sumter County,10,11,4301,2127,2174
50,12,119,Florida,Sumter County,10,12,6355,2818,3537
50,12,119,Florida,Sumter County,10,13,10569,4665,5904
50,12,119,Florida,Sumter County,10,14,12267,5916,6351
50,12,119,Florida,Sumter County,10,15,10473,5363,5110
50,12,119,Florida,Sumter County,10,16,6505,3397,3108
50,12,119,Florida,Sumter County,10,17,3529,1856,1673
50,12,119,Florida,Sumter County,10,18,2150,962,1188
50,12,119,Florida,Sumter County,10,99,86433,45542,40891
50,12,119,Florida,Sumter County,11,0,461,228,233
50,12,119,Florida,Sumter County,11,1,1849,942,907
50,12,119,Florida,Sumter County,11,2,2269,1151,1118
50,12,119,Florida,Sumter County,11,3,2364,1259,1105
50,12,119,Florida,Sumter County,11,4,2541,1325,1216
50,12,119,Florida,Sumter County,11,5,2540,1559,981
50,12,119,Florida,Sumter County,11,6,3031,1964,1067
50,12,119,Florida,Sumter County,11,7,3595,2515,1080
50,12,119,Florida,Sumter County,11,8,3915,2741,1174
50,12,119,Florida,Sumter County,11,9,3686,2379,1307
50,12,119,Florida,Sumter County,11,10,4138,2434,1704
50,12,119,Florida,Sumter County,11,11,4394,2156,2238
50,12,119,Florida,Sumter County,11,12,6391,2787,3604
50,12,119,Florida,Sumter County,11,13,11289,5006,6283
50,12,119,Florida,Sumter County,11,14,13791,6576,7215
50,12,119,Florida,Sumter County,11,15,11302,5786,5516
50,12,119,Florida,Sumter County,11,16,6984,3650,3334
50,12,119,Florida,Sumter County,11,17,3800,2010,1790
50,12,119,Florida,Sumter County,11,18,2303,1042,1261
50,12,119,Florida,Sumter County,11,99,90643,47510,43133
50,12,119,Florida,Sumter County,12,0,438,220,218
50,12,119,Florida,Sumter County,12,1,1805,905,900
50,12,119,Florida,Sumter County,12,2,2348,1193,1155
50,12,119,Florida,Sumter County,12,3,2360,1252,1108
50,12,119,Florida,Sumter County,12,4,2542,1323,1219
50,12,119,Florida,Sumter County,12,5,2453,1479,974
50,12,119,Florida,Sumter County,12,6,2932,1891,1041
50,12,119,Florida,Sumter County,12,7,3520,2443,1077
50,12,119,Florida,Sumter County,12,8,3824,2641,1183
50,12,119,Florida,Sumter County,12,9,3649,2334,1315
50,12,119,Florida,Sumter County,12,10,4138,2466,1672
50,12,119,Florida,Sumter County,12,11,4436,2167,2269
50,12,119,Florida,Sumter County,12,12,6481,2793,3688
50,12,119,Florida,Sumter County,12,13,11964,5271,6693
50,12,119,Florida,Sumter County,12,14,14788,7029,7759
50,12,119,Florida,Sumter County,12,15,11945,6109,5836
50,12,119,Florida,Sumter County,12,16,7378,3868,3510
50,12,119,Florida,Sumter County,12,17,3997,2117,1880
50,12,119,Florida,Sumter County,12,18,2422,1110,1312
50,12,119,Florida,Sumter County,12,99,93420,48611,44809
50,12,119,Florida,Sumter County,13,0,441,222,219
50,12,119,Florida,Sumter County,13,1,1818,909,909
50,12,119,Florida,Sumter County,13,2,2370,1203,1167
50,12,119,Florida,Sumter County,13,3,2370,1253,1117
50,12,119,Florida,Sumter County,13,4,2538,1319,1219
50,12,119,Florida,Sumter County,13,5,2472,1487,985
50,12,119,Florida,Sumter County,13,6,2956,1903,1053
50,12,119,Florida,Sumter County,13,7,3541,2451,1090
50,12,119,Florida,Sumter County,13,8,3812,2632,1180
50,12,119,Florida,Sumter County,13,9,3662,2342,1320
50,12,119,Florida,Sumter County,13,10,4142,2466,1676
50,12,119,Florida,Sumter County,13,11,4455,2175,2280
50,12,119,Florida,Sumter County,13,12,6539,2816,3723
50,12,119,Florida,Sumter County,13,13,12141,5349,6792
50,12,119,Florida,Sumter County,13,14,14928,7102,7826
50,12,119,Florida,Sumter County,13,15,12041,6160,5881
50,12,119,Florida,Sumter County,13,16,7393,3881,3512
50,12,119,Florida,Sumter County,13,17,4009,2127,1882
50,12,119,Florida,Sumter County,13,18,2446,1123,1323
50,12,119,Florida,Sumter County,13,99,94074,48920,45154
50,12,121,Florida,Suwannee County,1,0,458,228,230
50,12,121,Florida,Suwannee County,1,1,1642,808,834
50,12,121,Florida,Suwannee County,1,2,2319,1193,1126
50,12,121,Florida,Suwannee County,1,3,2363,1221,1142
50,12,121,Florida,Suwannee County,1,4,2625,1358,1267
50,12,121,Florida,Suwannee County,1,5,1939,1023,916
50,12,121,Florida,Suwannee County,1,6,1904,1007,897
50,12,121,Florida,Suwannee County,1,7,1980,983,997
50,12,121,Florida,Suwannee County,1,8,2355,1173,1182
50,12,121,Florida,Suwannee County,1,9,2514,1189,1325
50,12,121,Florida,Suwannee County,1,10,2363,1151,1212
50,12,121,Florida,Suwannee County,1,11,2391,1137,1254
50,12,121,Florida,Suwannee County,1,12,2087,1021,1066
50,12,121,Florida,Suwannee County,1,13,2025,1004,1021
50,12,121,Florida,Suwannee County,1,14,1701,813,888
50,12,121,Florida,Suwannee County,1,15,1568,699,869
50,12,121,Florida,Suwannee County,1,16,1183,534,649
50,12,121,Florida,Suwannee County,1,17,754,302,452
50,12,121,Florida,Suwannee County,1,18,710,187,523
50,12,121,Florida,Suwannee County,1,99,34881,17031,17850
50,12,121,Florida,Suwannee County,2,0,469,234,235
50,12,121,Florida,Suwannee County,2,1,1644,810,834
50,12,121,Florida,Suwannee County,2,2,2318,1193,1125
50,12,121,Florida,Suwannee County,2,3,2384,1231,1153
50,12,121,Florida,Suwannee County,2,4,2643,1368,1275
50,12,121,Florida,Suwannee County,2,5,1974,1046,928
50,12,121,Florida,Suwannee County,2,6,1899,1007,892
50,12,121,Florida,Suwannee County,2,7,1981,984,997
50,12,121,Florida,Suwannee County,2,8,2357,1173,1184
50,12,121,Florida,Suwannee County,2,9,2524,1195,1329
50,12,121,Florida,Suwannee County,2,10,2380,1159,1221
50,12,121,Florida,Suwannee County,2,11,2424,1153,1271
50,12,121,Florida,Suwannee County,2,12,2102,1027,1075
50,12,121,Florida,Suwannee County,2,13,2039,1012,1027
50,12,121,Florida,Suwannee County,2,14,1705,816,889
50,12,121,Florida,Suwannee County,2,15,1570,701,869
50,12,121,Florida,Suwannee County,2,16,1190,538,652
50,12,121,Florida,Suwannee County,2,17,759,305,454
50,12,121,Florida,Suwannee County,2,18,709,187,522
50,12,121,Florida,Suwannee County,2,99,35071,17139,17932
50,12,121,Florida,Suwannee County,3,0,469,238,231
50,12,121,Florida,Suwannee County,3,1,1794,907,887
50,12,121,Florida,Suwannee County,3,2,2208,1130,1078
50,12,121,Florida,Suwannee County,3,3,2462,1253,1209
50,12,121,Florida,Suwannee County,3,4,2541,1340,1201
50,12,121,Florida,Suwannee County,3,5,2156,1149,1007
50,12,121,Florida,Suwannee County,3,6,1964,1047,917
50,12,121,Florida,Suwannee County,3,7,1952,948,1004
50,12,121,Florida,Suwannee County,3,8,2378,1199,1179
50,12,121,Florida,Suwannee County,3,9,2576,1265,1311
50,12,121,Florida,Suwannee County,3,10,2415,1123,1292
50,12,121,Florida,Suwannee County,3,11,2496,1213,1283
50,12,121,Florida,Suwannee County,3,12,2142,1034,1108
50,12,121,Florida,Suwannee County,3,13,2069,1013,1056
50,12,121,Florida,Suwannee County,3,14,1809,860,949
50,12,121,Florida,Suwannee County,3,15,1535,679,856
50,12,121,Florida,Suwannee County,3,16,1241,583,658
50,12,121,Florida,Suwannee County,3,17,786,316,470
50,12,121,Florida,Suwannee County,3,18,686,187,499
50,12,121,Florida,Suwannee County,3,99,35679,17484,18195
50,12,121,Florida,Suwannee County,4,0,495,279,216
50,12,121,Florida,Suwannee County,4,1,1927,960,967
50,12,121,Florida,Suwannee County,4,2,2167,1111,1056
50,12,121,Florida,Suwannee County,4,3,2494,1252,1242
50,12,121,Florida,Suwannee County,4,4,2444,1295,1149
50,12,121,Florida,Suwannee County,4,5,2289,1222,1067
50,12,121,Florida,Suwannee County,4,6,1885,987,898
50,12,121,Florida,Suwannee County,4,7,1959,980,979
50,12,121,Florida,Suwannee County,4,8,2364,1140,1224
50,12,121,Florida,Suwannee County,4,9,2582,1293,1289
50,12,121,Florida,Suwannee County,4,10,2499,1178,1321
50,12,121,Florida,Suwannee County,4,11,2489,1208,1281
50,12,121,Florida,Suwannee County,4,12,2358,1110,1248
50,12,121,Florida,Suwannee County,4,13,2096,1021,1075
50,12,121,Florida,Suwannee County,4,14,1849,886,963
50,12,121,Florida,Suwannee County,4,15,1516,686,830
50,12,121,Florida,Suwannee County,4,16,1260,575,685
50,12,121,Florida,Suwannee County,4,17,850,338,512
50,12,121,Florida,Suwannee County,4,18,663,206,457
50,12,121,Florida,Suwannee County,4,99,36186,17727,18459
50,12,121,Florida,Suwannee County,5,0,473,220,253
50,12,121,Florida,Suwannee County,5,1,1918,973,945
50,12,121,Florida,Suwannee County,5,2,2218,1123,1095
50,12,121,Florida,Suwannee County,5,3,2548,1280,1268
50,12,121,Florida,Suwannee County,5,4,2379,1260,1119
50,12,121,Florida,Suwannee County,5,5,2410,1312,1098
50,12,121,Florida,Suwannee County,5,6,1951,1031,920
50,12,121,Florida,Suwannee County,5,7,2025,1062,963
50,12,121,Florida,Suwannee County,5,8,2307,1125,1182
50,12,121,Florida,Suwannee County,5,9,2577,1292,1285
50,12,121,Florida,Suwannee County,5,10,2502,1174,1328
50,12,121,Florida,Suwannee County,5,11,2560,1226,1334
50,12,121,Florida,Suwannee County,5,12,2399,1154,1245
50,12,121,Florida,Suwannee County,5,13,2177,1044,1133
50,12,121,Florida,Suwannee County,5,14,1994,984,1010
50,12,121,Florida,Suwannee County,5,15,1527,690,837
50,12,121,Florida,Suwannee County,5,16,1313,603,710
50,12,121,Florida,Suwannee County,5,17,850,355,495
50,12,121,Florida,Suwannee County,5,18,684,216,468
50,12,121,Florida,Suwannee County,5,99,36812,18124,18688
50,12,121,Florida,Suwannee County,6,0,514,264,250
50,12,121,Florida,Suwannee County,6,1,1940,1000,940
50,12,121,Florida,Suwannee County,6,2,2259,1129,1130
50,12,121,Florida,Suwannee County,6,3,2618,1332,1286
50,12,121,Florida,Suwannee County,6,4,2390,1268,1122
50,12,121,Florida,Suwannee County,6,5,2462,1325,1137
50,12,121,Florida,Suwannee County,6,6,1992,1044,948
50,12,121,Florida,Suwannee County,6,7,2058,1089,969
50,12,121,Florida,Suwannee County,6,8,2220,1101,1119
50,12,121,Florida,Suwannee County,6,9,2624,1354,1270
50,12,121,Florida,Suwannee County,6,10,2642,1230,1412
50,12,121,Florida,Suwannee County,6,11,2590,1245,1345
50,12,121,Florida,Suwannee County,6,12,2496,1199,1297
50,12,121,Florida,Suwannee County,6,13,2257,1105,1152
50,12,121,Florida,Suwannee County,6,14,2040,1000,1040
50,12,121,Florida,Suwannee County,6,15,1559,701,858
50,12,121,Florida,Suwannee County,6,16,1346,625,721
50,12,121,Florida,Suwannee County,6,17,850,362,488
50,12,121,Florida,Suwannee County,6,18,740,232,508
50,12,121,Florida,Suwannee County,6,99,37597,18605,18992
50,12,121,Florida,Suwannee County,7,0,533,258,275
50,12,121,Florida,Suwannee County,7,1,1986,990,996
50,12,121,Florida,Suwannee County,7,2,2338,1161,1177
50,12,121,Florida,Suwannee County,7,3,2617,1331,1286
50,12,121,Florida,Suwannee County,7,4,2534,1349,1185
50,12,121,Florida,Suwannee County,7,5,2388,1266,1122
50,12,121,Florida,Suwannee County,7,6,2166,1140,1026
50,12,121,Florida,Suwannee County,7,7,2044,1093,951
50,12,121,Florida,Suwannee County,7,8,2253,1128,1125
50,12,121,Florida,Suwannee County,7,9,2645,1372,1273
50,12,121,Florida,Suwannee County,7,10,2753,1268,1485
50,12,121,Florida,Suwannee County,7,11,2691,1311,1380
50,12,121,Florida,Suwannee County,7,12,2663,1264,1399
50,12,121,Florida,Suwannee County,7,13,2339,1146,1193
50,12,121,Florida,Suwannee County,7,14,2126,1062,1064
50,12,121,Florida,Suwannee County,7,15,1585,730,855
50,12,121,Florida,Suwannee County,7,16,1343,612,731
50,12,121,Florida,Suwannee County,7,17,915,390,525
50,12,121,Florida,Suwannee County,7,18,768,250,518
50,12,121,Florida,Suwannee County,7,99,38687,19121,19566
50,12,121,Florida,Suwannee County,8,0,478,234,244
50,12,121,Florida,Suwannee County,8,1,2031,1032,999
50,12,121,Florida,Suwannee County,8,2,2479,1267,1212
50,12,121,Florida,Suwannee County,8,3,2556,1296,1260
50,12,121,Florida,Suwannee County,8,4,2673,1409,1264
50,12,121,Florida,Suwannee County,8,5,2313,1267,1046
50,12,121,Florida,Suwannee County,8,6,2243,1142,1101
50,12,121,Florida,Suwannee County,8,7,2044,1078,966
50,12,121,Florida,Suwannee County,8,8,2230,1106,1124
50,12,121,Florida,Suwannee County,8,9,2659,1364,1295
50,12,121,Florida,Suwannee County,8,10,2829,1380,1449
50,12,121,Florida,Suwannee County,8,11,2730,1296,1434
50,12,121,Florida,Suwannee County,8,12,2793,1320,1473
50,12,121,Florida,Suwannee County,8,13,2477,1202,1275
50,12,121,Florida,Suwannee County,8,14,2220,1097,1123
50,12,121,Florida,Suwannee County,8,15,1696,796,900
50,12,121,Florida,Suwannee County,8,16,1324,602,722
50,12,121,Florida,Suwannee County,8,17,988,430,558
50,12,121,Florida,Suwannee County,8,18,770,253,517
50,12,121,Florida,Suwannee County,8,99,39533,19571,19962
50,12,121,Florida,Suwannee County,9,0,522,263,259
50,12,121,Florida,Suwannee County,9,1,2045,1017,1028
50,12,121,Florida,Suwannee County,9,2,2577,1325,1252
50,12,121,Florida,Suwannee County,9,3,2547,1297,1250
50,12,121,Florida,Suwannee County,9,4,2672,1410,1262
50,12,121,Florida,Suwannee County,9,5,2262,1246,1016
50,12,121,Florida,Suwannee County,9,6,2335,1186,1149
50,12,121,Florida,Suwannee County,9,7,2018,1074,944
50,12,121,Florida,Suwannee County,9,8,2274,1146,1128
50,12,121,Florida,Suwannee County,9,9,2658,1331,1327
50,12,121,Florida,Suwannee County,9,10,2917,1429,1488
50,12,121,Florida,Suwannee County,9,11,2855,1392,1463
50,12,121,Florida,Suwannee County,9,12,2781,1313,1468
50,12,121,Florida,Suwannee County,9,13,2644,1287,1357
50,12,121,Florida,Suwannee County,9,14,2294,1122,1172
50,12,121,Florida,Suwannee County,9,15,1760,852,908
50,12,121,Florida,Suwannee County,9,16,1349,596,753
50,12,121,Florida,Suwannee County,9,17,1008,420,588
50,12,121,Florida,Suwannee County,9,18,791,264,527
50,12,121,Florida,Suwannee County,9,99,40309,19970,20339
50,12,121,Florida,Suwannee County,10,0,597,283,314
50,12,121,Florida,Suwannee County,10,1,2061,1074,987
50,12,121,Florida,Suwannee County,10,2,2618,1328,1290
50,12,121,Florida,Suwannee County,10,3,2548,1274,1274
50,12,121,Florida,Suwannee County,10,4,2722,1426,1296
50,12,121,Florida,Suwannee County,10,5,2201,1204,997
50,12,121,Florida,Suwannee County,10,6,2393,1212,1181
50,12,121,Florida,Suwannee County,10,7,2058,1080,978
50,12,121,Florida,Suwannee County,10,8,2319,1202,1117
50,12,121,Florida,Suwannee County,10,9,2545,1258,1287
50,12,121,Florida,Suwannee County,10,10,2881,1438,1443
50,12,121,Florida,Suwannee County,10,11,2888,1411,1477
50,12,121,Florida,Suwannee County,10,12,2801,1327,1474
50,12,121,Florida,Suwannee County,10,13,2725,1339,1386
50,12,121,Florida,Suwannee County,10,14,2341,1129,1212
50,12,121,Florida,Suwannee County,10,15,1803,875,928
50,12,121,Florida,Suwannee County,10,16,1423,649,774
50,12,121,Florida,Suwannee County,10,17,1037,412,625
50,12,121,Florida,Suwannee County,10,18,813,282,531
50,12,121,Florida,Suwannee County,10,99,40774,20203,20571
50,12,121,Florida,Suwannee County,11,0,528,258,270
50,12,121,Florida,Suwannee County,11,1,2151,1124,1027
50,12,121,Florida,Suwannee County,11,2,2612,1392,1220
50,12,121,Florida,Suwannee County,11,3,2572,1295,1277
50,12,121,Florida,Suwannee County,11,4,2725,1464,1261
50,12,121,Florida,Suwannee County,11,5,2252,1260,992
50,12,121,Florida,Suwannee County,11,6,2410,1258,1152
50,12,121,Florida,Suwannee County,11,7,2128,1120,1008
50,12,121,Florida,Suwannee County,11,8,2342,1234,1108
50,12,121,Florida,Suwannee County,11,9,2505,1248,1257
50,12,121,Florida,Suwannee County,11,10,2895,1457,1438
50,12,121,Florida,Suwannee County,11,11,2949,1447,1502
50,12,121,Florida,Suwannee County,11,12,2769,1323,1446
50,12,121,Florida,Suwannee County,11,13,2797,1352,1445
50,12,121,Florida,Suwannee County,11,14,2457,1182,1275
50,12,121,Florida,Suwannee County,11,15,1890,917,973
50,12,121,Florida,Suwannee County,11,16,1400,646,754
50,12,121,Florida,Suwannee County,11,17,1030,412,618
50,12,121,Florida,Suwannee County,11,18,851,299,552
50,12,121,Florida,Suwannee County,11,99,41263,20688,20575
50,12,121,Florida,Suwannee County,12,0,500,237,263
50,12,121,Florida,Suwannee County,12,1,2074,1101,973
50,12,121,Florida,Suwannee County,12,2,2595,1343,1252
50,12,121,Florida,Suwannee County,12,3,2612,1315,1297
50,12,121,Florida,Suwannee County,12,4,2654,1438,1216
50,12,121,Florida,Suwannee County,12,5,2267,1283,984
50,12,121,Florida,Suwannee County,12,6,2429,1301,1128
50,12,121,Florida,Suwannee County,12,7,2251,1225,1026
50,12,121,Florida,Suwannee County,12,8,2339,1251,1088
50,12,121,Florida,Suwannee County,12,9,2491,1250,1241
50,12,121,Florida,Suwannee County,12,10,2873,1467,1406
50,12,121,Florida,Suwannee County,12,11,3002,1467,1535
50,12,121,Florida,Suwannee County,12,12,2761,1318,1443
50,12,121,Florida,Suwannee County,12,13,2853,1395,1458
50,12,121,Florida,Suwannee County,12,14,2496,1198,1298
50,12,121,Florida,Suwannee County,12,15,1952,948,1004
50,12,121,Florida,Suwannee County,12,16,1418,665,753
50,12,121,Florida,Suwannee County,12,17,1054,417,637
50,12,121,Florida,Suwannee County,12,18,930,326,604
50,12,121,Florida,Suwannee County,12,99,41551,20945,20606
50,12,121,Florida,Suwannee County,13,0,502,239,263
50,12,121,Florida,Suwannee County,13,1,2057,1094,963
50,12,121,Florida,Suwannee County,13,2,2587,1339,1248
50,12,121,Florida,Suwannee County,13,3,2595,1301,1294
50,12,121,Florida,Suwannee County,13,4,2627,1420,1207
50,12,121,Florida,Suwannee County,13,5,2276,1286,990
50,12,121,Florida,Suwannee County,13,6,2426,1299,1127
50,12,121,Florida,Suwannee County,13,7,2261,1227,1034
50,12,121,Florida,Suwannee County,13,8,2316,1235,1081
50,12,121,Florida,Suwannee County,13,9,2492,1250,1242
50,12,121,Florida,Suwannee County,13,10,2858,1462,1396
50,12,121,Florida,Suwannee County,13,11,2994,1463,1531
50,12,121,Florida,Suwannee County,13,12,2767,1321,1446
50,12,121,Florida,Suwannee County,13,13,2876,1404,1472
50,12,121,Florida,Suwannee County,13,14,2503,1204,1299
50,12,121,Florida,Suwannee County,13,15,1957,950,1007
50,12,121,Florida,Suwannee County,13,16,1417,666,751
50,12,121,Florida,Suwannee County,13,17,1052,416,636
50,12,121,Florida,Suwannee County,13,18,932,327,605
50,12,121,Florida,Suwannee County,13,99,41495,20903,20592
50,12,123,Florida,Taylor County,1,0,248,132,116
50,12,123,Florida,Taylor County,1,1,892,465,427
50,12,123,Florida,Taylor County,1,2,1289,633,656
50,12,123,Florida,Taylor County,1,3,1437,739,698
50,12,123,Florida,Taylor County,1,4,1378,710,668
50,12,123,Florida,Taylor County,1,5,1076,570,506
50,12,123,Florida,Taylor County,1,6,1283,721,562
50,12,123,Florida,Taylor County,1,7,1213,682,531
50,12,123,Florida,Taylor County,1,8,1484,814,670
50,12,123,Florida,Taylor County,1,9,1473,786,687
50,12,123,Florida,Taylor County,1,10,1419,735,684
50,12,123,Florida,Taylor County,1,11,1330,667,663
50,12,123,Florida,Taylor County,1,12,1124,568,556
50,12,123,Florida,Taylor County,1,13,899,429,470
50,12,123,Florida,Taylor County,1,14,858,386,472
50,12,123,Florida,Taylor County,1,15,742,360,382
50,12,123,Florida,Taylor County,1,16,513,225,288
50,12,123,Florida,Taylor County,1,17,309,122,187
50,12,123,Florida,Taylor County,1,18,286,87,199
50,12,123,Florida,Taylor County,1,99,19253,9831,9422
50,12,123,Florida,Taylor County,2,0,250,133,117
50,12,123,Florida,Taylor County,2,1,887,462,425
50,12,123,Florida,Taylor County,2,2,1280,629,651
50,12,123,Florida,Taylor County,2,3,1435,738,697
50,12,123,Florida,Taylor County,2,4,1375,711,664
50,12,123,Florida,Taylor County,2,5,1081,572,509
50,12,123,Florida,Taylor County,2,6,1273,717,556
50,12,123,Florida,Taylor County,2,7,1205,678,527
50,12,123,Florida,Taylor County,2,8,1470,805,665
50,12,123,Florida,Taylor County,2,9,1470,785,685
50,12,123,Florida,Taylor County,2,10,1421,736,685
50,12,123,Florida,Taylor County,2,11,1344,674,670
50,12,123,Florida,Taylor County,2,12,1128,572,556
50,12,123,Florida,Taylor County,2,13,898,428,470
50,12,123,Florida,Taylor County,2,14,860,386,474
50,12,123,Florida,Taylor County,2,15,744,362,382
50,12,123,Florida,Taylor County,2,16,515,226,289
50,12,123,Florida,Taylor County,2,17,312,123,189
50,12,123,Florida,Taylor County,2,18,285,88,197
50,12,123,Florida,Taylor County,2,99,19233,9825,9408
50,12,123,Florida,Taylor County,3,0,271,131,140
50,12,123,Florida,Taylor County,3,1,949,489,460
50,12,123,Florida,Taylor County,3,2,1230,603,627
50,12,123,Florida,Taylor County,3,3,1401,719,682
50,12,123,Florida,Taylor County,3,4,1312,681,631
50,12,123,Florida,Taylor County,3,5,1174,638,536
50,12,123,Florida,Taylor County,3,6,1228,724,504
50,12,123,Florida,Taylor County,3,7,1246,697,549
50,12,123,Florida,Taylor County,3,8,1380,767,613
50,12,123,Florida,Taylor County,3,9,1488,808,680
50,12,123,Florida,Taylor County,3,10,1492,804,688
50,12,123,Florida,Taylor County,3,11,1407,702,705
50,12,123,Florida,Taylor County,3,12,1172,601,571
50,12,123,Florida,Taylor County,3,13,905,433,472
50,12,123,Florida,Taylor County,3,14,880,391,489
50,12,123,Florida,Taylor County,3,15,730,356,374
50,12,123,Florida,Taylor County,3,16,542,242,300
50,12,123,Florida,Taylor County,3,17,307,112,195
50,12,123,Florida,Taylor County,3,18,265,86,179
50,12,123,Florida,Taylor County,3,99,19379,9984,9395
50,12,123,Florida,Taylor County,4,0,256,132,124
50,12,123,Florida,Taylor County,4,1,938,462,476
50,12,123,Florida,Taylor County,4,2,1213,616,597
50,12,123,Florida,Taylor County,4,3,1372,708,664
50,12,123,Florida,Taylor County,4,4,1301,682,619
50,12,123,Florida,Taylor County,4,5,1167,660,507
50,12,123,Florida,Taylor County,4,6,1191,686,505
50,12,123,Florida,Taylor County,4,7,1182,669,513
50,12,123,Florida,Taylor County,4,8,1379,772,607
50,12,123,Florida,Taylor County,4,9,1491,833,658
50,12,123,Florida,Taylor County,4,10,1560,826,734
50,12,123,Florida,Taylor County,4,11,1402,701,701
50,12,123,Florida,Taylor County,4,12,1282,654,628
50,12,123,Florida,Taylor County,4,13,987,491,496
50,12,123,Florida,Taylor County,4,14,888,404,484
50,12,123,Florida,Taylor County,4,15,739,355,384
50,12,123,Florida,Taylor County,4,16,547,251,296
50,12,123,Florida,Taylor County,4,17,307,120,187
50,12,123,Florida,Taylor County,4,18,263,88,175
50,12,123,Florida,Taylor County,4,99,19465,10110,9355
50,12,123,Florida,Taylor County,5,0,236,125,111
50,12,123,Florida,Taylor County,5,1,957,495,462
50,12,123,Florida,Taylor County,5,2,1189,597,592
50,12,123,Florida,Taylor County,5,3,1356,689,667
50,12,123,Florida,Taylor County,5,4,1290,682,608
50,12,123,Florida,Taylor County,5,5,1199,706,493
50,12,123,Florida,Taylor County,5,6,1309,805,504
50,12,123,Florida,Taylor County,5,7,1291,780,511
50,12,123,Florida,Taylor County,5,8,1404,819,585
50,12,123,Florida,Taylor County,5,9,1519,878,641
50,12,123,Florida,Taylor County,5,10,1632,875,757
50,12,123,Florida,Taylor County,5,11,1450,756,694
50,12,123,Florida,Taylor County,5,12,1352,700,652
50,12,123,Florida,Taylor County,5,13,1035,524,511
50,12,123,Florida,Taylor County,5,14,907,427,480
50,12,123,Florida,Taylor County,5,15,761,354,407
50,12,123,Florida,Taylor County,5,16,551,238,313
50,12,123,Florida,Taylor County,5,17,314,119,195
50,12,123,Florida,Taylor County,5,18,259,87,172
50,12,123,Florida,Taylor County,5,99,20011,10656,9355
50,12,123,Florida,Taylor County,6,0,256,126,130
50,12,123,Florida,Taylor County,6,1,940,484,456
50,12,123,Florida,Taylor County,6,2,1197,619,578
50,12,123,Florida,Taylor County,6,3,1313,652,661
50,12,123,Florida,Taylor County,6,4,1321,707,614
50,12,123,Florida,Taylor County,6,5,1227,700,527
50,12,123,Florida,Taylor County,6,6,1280,777,503
50,12,123,Florida,Taylor County,6,7,1266,741,525
50,12,123,Florida,Taylor County,6,8,1333,791,542
50,12,123,Florida,Taylor County,6,9,1509,850,659
50,12,123,Florida,Taylor County,6,10,1605,876,729
50,12,123,Florida,Taylor County,6,11,1457,757,700
50,12,123,Florida,Taylor County,6,12,1439,751,688
50,12,123,Florida,Taylor County,6,13,1076,545,531
50,12,123,Florida,Taylor County,6,14,938,449,489
50,12,123,Florida,Taylor County,6,15,759,329,430
50,12,123,Florida,Taylor County,6,16,571,266,305
50,12,123,Florida,Taylor County,6,17,347,132,215
50,12,123,Florida,Taylor County,6,18,259,88,171
50,12,123,Florida,Taylor County,6,99,20093,10640,9453
50,12,123,Florida,Taylor County,7,0,264,121,143
50,12,123,Florida,Taylor County,7,1,941,500,441
50,12,123,Florida,Taylor County,7,2,1183,598,585
50,12,123,Florida,Taylor County,7,3,1315,645,670
50,12,123,Florida,Taylor County,7,4,1331,694,637
50,12,123,Florida,Taylor County,7,5,1283,740,543
50,12,123,Florida,Taylor County,7,6,1293,794,499
50,12,123,Florida,Taylor County,7,7,1274,727,547
50,12,123,Florida,Taylor County,7,8,1325,804,521
50,12,123,Florida,Taylor County,7,9,1515,852,663
50,12,123,Florida,Taylor County,7,10,1625,879,746
50,12,123,Florida,Taylor County,7,11,1520,799,721
50,12,123,Florida,Taylor County,7,12,1490,782,708
50,12,123,Florida,Taylor County,7,13,1159,591,568
50,12,123,Florida,Taylor County,7,14,963,463,500
50,12,123,Florida,Taylor County,7,15,827,352,475
50,12,123,Florida,Taylor County,7,16,575,276,299
50,12,123,Florida,Taylor County,7,17,401,154,247
50,12,123,Florida,Taylor County,7,18,231,79,152
50,12,123,Florida,Taylor County,7,99,20515,10850,9665
50,12,123,Florida,Taylor County,8,0,299,170,129
50,12,123,Florida,Taylor County,8,1,905,465,440
50,12,123,Florida,Taylor County,8,2,1210,599,611
50,12,123,Florida,Taylor County,8,3,1292,647,645
50,12,123,Florida,Taylor County,8,4,1319,703,616
50,12,123,Florida,Taylor County,8,5,1274,724,550
50,12,123,Florida,Taylor County,8,6,1359,850,509
50,12,123,Florida,Taylor County,8,7,1206,709,497
50,12,123,Florida,Taylor County,8,8,1358,799,559
50,12,123,Florida,Taylor County,8,9,1522,860,662
50,12,123,Florida,Taylor County,8,10,1620,876,744
50,12,123,Florida,Taylor County,8,11,1569,843,726
50,12,123,Florida,Taylor County,8,12,1567,804,763
50,12,123,Florida,Taylor County,8,13,1213,613,600
50,12,123,Florida,Taylor County,8,14,975,470,505
50,12,123,Florida,Taylor County,8,15,882,377,505
50,12,123,Florida,Taylor County,8,16,568,284,284
50,12,123,Florida,Taylor County,8,17,437,175,262
50,12,123,Florida,Taylor County,8,18,218,66,152
50,12,123,Florida,Taylor County,8,99,20793,11034,9759
50,12,123,Florida,Taylor County,9,0,311,153,158
50,12,123,Florida,Taylor County,9,1,935,490,445
50,12,123,Florida,Taylor County,9,2,1268,649,619
50,12,123,Florida,Taylor County,9,3,1261,629,632
50,12,123,Florida,Taylor County,9,4,1317,689,628
50,12,123,Florida,Taylor County,9,5,1348,817,531
50,12,123,Florida,Taylor County,9,6,1541,1007,534
50,12,123,Florida,Taylor County,9,7,1298,812,486
50,12,123,Florida,Taylor County,9,8,1452,885,567
50,12,123,Florida,Taylor County,9,9,1595,942,653
50,12,123,Florida,Taylor County,9,10,1734,998,736
50,12,123,Florida,Taylor County,9,11,1674,902,772
50,12,123,Florida,Taylor County,9,12,1563,813,750
50,12,123,Florida,Taylor County,9,13,1340,690,650
50,12,123,Florida,Taylor County,9,14,1018,498,520
50,12,123,Florida,Taylor County,9,15,893,394,499
50,12,123,Florida,Taylor County,9,16,580,273,307
50,12,123,Florida,Taylor County,9,17,426,179,247
50,12,123,Florida,Taylor County,9,18,251,82,169
50,12,123,Florida,Taylor County,9,99,21805,11902,9903
50,12,123,Florida,Taylor County,10,0,336,144,192
50,12,123,Florida,Taylor County,10,1,949,490,459
50,12,123,Florida,Taylor County,10,2,1258,681,577
50,12,123,Florida,Taylor County,10,3,1263,625,638
50,12,123,Florida,Taylor County,10,4,1317,686,631
50,12,123,Florida,Taylor County,10,5,1404,875,529
50,12,123,Florida,Taylor County,10,6,1594,1078,516
50,12,123,Florida,Taylor County,10,7,1347,863,484
50,12,123,Florida,Taylor County,10,8,1545,967,578
50,12,123,Florida,Taylor County,10,9,1589,981,608
50,12,123,Florida,Taylor County,10,10,1737,1037,700
50,12,123,Florida,Taylor County,10,11,1714,931,783
50,12,123,Florida,Taylor County,10,12,1597,864,733
50,12,123,Florida,Taylor County,10,13,1432,724,708
50,12,123,Florida,Taylor County,10,14,1065,524,541
50,12,123,Florida,Taylor County,10,15,909,413,496
50,12,123,Florida,Taylor County,10,16,615,281,334
50,12,123,Florida,Taylor County,10,17,424,174,250
50,12,123,Florida,Taylor County,10,18,261,92,169
50,12,123,Florida,Taylor County,10,99,22356,12430,9926
50,12,123,Florida,Taylor County,11,0,319,145,174
50,12,123,Florida,Taylor County,11,1,993,505,488
50,12,123,Florida,Taylor County,11,2,1224,631,593
50,12,123,Florida,Taylor County,11,3,1229,632,597
50,12,123,Florida,Taylor County,11,4,1270,644,626
50,12,123,Florida,Taylor County,11,5,1409,888,521
50,12,123,Florida,Taylor County,11,6,1657,1120,537
50,12,123,Florida,Taylor County,11,7,1361,891,470
50,12,123,Florida,Taylor County,11,8,1510,937,573
50,12,123,Florida,Taylor County,11,9,1538,966,572
50,12,123,Florida,Taylor County,11,10,1754,1029,725
50,12,123,Florida,Taylor County,11,11,1725,946,779
50,12,123,Florida,Taylor County,11,12,1608,873,735
50,12,123,Florida,Taylor County,11,13,1481,750,731
50,12,123,Florida,Taylor County,11,14,1137,562,575
50,12,123,Florida,Taylor County,11,15,951,440,511
50,12,123,Florida,Taylor County,11,16,595,257,338
50,12,123,Florida,Taylor County,11,17,462,206,256
50,12,123,Florida,Taylor County,11,18,259,98,161
50,12,123,Florida,Taylor County,11,99,22482,12520,9962
50,12,123,Florida,Taylor County,12,0,278,126,152
50,12,123,Florida,Taylor County,12,1,1011,526,485
50,12,123,Florida,Taylor County,12,2,1193,616,577
50,12,123,Florida,Taylor County,12,3,1198,609,589
50,12,123,Florida,Taylor County,12,4,1256,633,623
50,12,123,Florida,Taylor County,12,5,1458,898,560
50,12,123,Florida,Taylor County,12,6,1678,1132,546
50,12,123,Florida,Taylor County,12,7,1335,880,455
50,12,123,Florida,Taylor County,12,8,1524,936,588
50,12,123,Florida,Taylor County,12,9,1521,956,565
50,12,123,Florida,Taylor County,12,10,1756,1033,723
50,12,123,Florida,Taylor County,12,11,1716,945,771
50,12,123,Florida,Taylor County,12,12,1630,883,747
50,12,123,Florida,Taylor County,12,13,1488,753,735
50,12,123,Florida,Taylor County,12,14,1203,602,601
50,12,123,Florida,Taylor County,12,15,949,444,505
50,12,123,Florida,Taylor County,12,16,646,280,366
50,12,123,Florida,Taylor County,12,17,449,195,254
50,12,123,Florida,Taylor County,12,18,281,107,174
50,12,123,Florida,Taylor County,12,99,22570,12554,10016
50,12,123,Florida,Taylor County,13,0,277,126,151
50,12,123,Florida,Taylor County,13,1,1009,524,485
50,12,123,Florida,Taylor County,13,2,1194,618,576
50,12,123,Florida,Taylor County,13,3,1193,603,590
50,12,123,Florida,Taylor County,13,4,1239,623,616
50,12,123,Florida,Taylor County,13,5,1464,901,563
50,12,123,Florida,Taylor County,13,6,1684,1138,546
50,12,123,Florida,Taylor County,13,7,1341,881,460
50,12,123,Florida,Taylor County,13,8,1512,930,582
50,12,123,Florida,Taylor County,13,9,1522,959,563
50,12,123,Florida,Taylor County,13,10,1752,1032,720
50,12,123,Florida,Taylor County,13,11,1715,944,771
50,12,123,Florida,Taylor County,13,12,1627,881,746
50,12,123,Florida,Taylor County,13,13,1501,759,742
50,12,123,Florida,Taylor County,13,14,1207,606,601
50,12,123,Florida,Taylor County,13,15,951,446,505
50,12,123,Florida,Taylor County,13,16,650,284,366
50,12,123,Florida,Taylor County,13,17,446,195,251
50,12,123,Florida,Taylor County,13,18,282,107,175
50,12,123,Florida,Taylor County,13,99,22566,12557,10009
50,12,125,Florida,Union County,1,0,141,78,63
50,12,125,Florida,Union County,1,1,596,286,310
50,12,125,Florida,Union County,1,2,755,396,359
50,12,125,Florida,Union County,1,3,871,467,404
50,12,125,Florida,Union County,1,4,913,485,428
50,12,125,Florida,Union County,1,5,823,540,283
50,12,125,Florida,Union County,1,6,1105,803,302
50,12,125,Florida,Union County,1,7,1289,975,314
50,12,125,Florida,Union County,1,8,1583,1178,405
50,12,125,Florida,Union County,1,9,1366,991,375
50,12,125,Florida,Union County,1,10,1118,797,321
50,12,125,Florida,Union County,1,11,852,574,278
50,12,125,Florida,Union County,1,12,590,369,221
50,12,125,Florida,Union County,1,13,423,244,179
50,12,125,Florida,Union County,1,14,365,205,160
50,12,125,Florida,Union County,1,15,273,143,130
50,12,125,Florida,Union County,1,16,177,82,95
50,12,125,Florida,Union County,1,17,110,47,63
50,12,125,Florida,Union County,1,18,78,25,53
50,12,125,Florida,Union County,1,99,13428,8685,4743
50,12,125,Florida,Union County,2,0,141,78,63
50,12,125,Florida,Union County,2,1,595,286,309
50,12,125,Florida,Union County,2,2,754,395,359
50,12,125,Florida,Union County,2,3,877,472,405
50,12,125,Florida,Union County,2,4,923,492,431
50,12,125,Florida,Union County,2,5,829,543,286
50,12,125,Florida,Union County,2,6,1098,798,300
50,12,125,Florida,Union County,2,7,1282,968,314
50,12,125,Florida,Union County,2,8,1566,1161,405
50,12,125,Florida,Union County,2,9,1357,981,376
50,12,125,Florida,Union County,2,10,1121,798,323
50,12,125,Florida,Union County,2,11,860,579,281
50,12,125,Florida,Union County,2,12,604,382,222
50,12,125,Florida,Union County,2,13,432,252,180
50,12,125,Florida,Union County,2,14,368,207,161
50,12,125,Florida,Union County,2,15,273,143,130
50,12,125,Florida,Union County,2,16,178,83,95
50,12,125,Florida,Union County,2,17,112,48,64
50,12,125,Florida,Union County,2,18,80,25,55
50,12,125,Florida,Union County,2,99,13450,8691,4759
50,12,125,Florida,Union County,3,0,138,73,65
50,12,125,Florida,Union County,3,1,590,281,309
50,12,125,Florida,Union County,3,2,743,381,362
50,12,125,Florida,Union County,3,3,893,480,413
50,12,125,Florida,Union County,3,4,883,460,423
50,12,125,Florida,Union County,3,5,907,593,314
50,12,125,Florida,Union County,3,6,1077,772,305
50,12,125,Florida,Union County,3,7,1266,963,303
50,12,125,Florida,Union County,3,8,1516,1111,405
50,12,125,Florida,Union County,3,9,1342,959,383
50,12,125,Florida,Union County,3,10,1120,789,331
50,12,125,Florida,Union County,3,11,912,618,294
50,12,125,Florida,Union County,3,12,680,436,244
50,12,125,Florida,Union County,3,13,474,293,181
50,12,125,Florida,Union County,3,14,396,222,174
50,12,125,Florida,Union County,3,15,272,146,126
50,12,125,Florida,Union County,3,16,192,90,102
50,12,125,Florida,Union County,3,17,115,48,67
50,12,125,Florida,Union County,3,18,82,24,58
50,12,125,Florida,Union County,3,99,13598,8739,4859
50,12,125,Florida,Union County,4,0,136,73,63
50,12,125,Florida,Union County,4,1,600,289,311
50,12,125,Florida,Union County,4,2,750,370,380
50,12,125,Florida,Union County,4,3,818,449,369
50,12,125,Florida,Union County,4,4,905,490,415
50,12,125,Florida,Union County,4,5,916,591,325
50,12,125,Florida,Union County,4,6,1095,785,310
50,12,125,Florida,Union County,4,7,1244,935,309
50,12,125,Florida,Union County,4,8,1438,1044,394
50,12,125,Florida,Union County,4,9,1305,938,367
50,12,125,Florida,Union County,4,10,1134,785,349
50,12,125,Florida,Union County,4,11,930,637,293
50,12,125,Florida,Union County,4,12,752,487,265
50,12,125,Florida,Union County,4,13,539,341,198
50,12,125,Florida,Union County,4,14,424,244,180
50,12,125,Florida,Union County,4,15,275,149,126
50,12,125,Florida,Union County,4,16,216,107,109
50,12,125,Florida,Union County,4,17,109,44,65
50,12,125,Florida,Union County,4,18,76,29,47
50,12,125,Florida,Union County,4,99,13662,8787,4875
50,12,125,Florida,Union County,5,0,154,90,64
50,12,125,Florida,Union County,5,1,592,292,300
50,12,125,Florida,Union County,5,2,766,382,384
50,12,125,Florida,Union County,5,3,874,480,394
50,12,125,Florida,Union County,5,4,892,493,399
50,12,125,Florida,Union County,5,5,921,609,312
50,12,125,Florida,Union County,5,6,1115,791,324
50,12,125,Florida,Union County,5,7,1202,896,306
50,12,125,Florida,Union County,5,8,1351,972,379
50,12,125,Florida,Union County,5,9,1258,869,389
50,12,125,Florida,Union County,5,10,1172,799,373
50,12,125,Florida,Union County,5,11,944,637,307
50,12,125,Florida,Union County,5,12,825,541,284
50,12,125,Florida,Union County,5,13,586,383,203
50,12,125,Florida,Union County,5,14,441,253,188
50,12,125,Florida,Union County,5,15,300,166,134
50,12,125,Florida,Union County,5,16,201,95,106
50,12,125,Florida,Union County,5,17,120,52,68
50,12,125,Florida,Union County,5,18,73,29,44
50,12,125,Florida,Union County,5,99,13787,8829,4958
50,12,125,Florida,Union County,6,0,163,77,86
50,12,125,Florida,Union County,6,1,595,310,285
50,12,125,Florida,Union County,6,2,783,376,407
50,12,125,Florida,Union County,6,3,855,454,401
50,12,125,Florida,Union County,6,4,896,531,365
50,12,125,Florida,Union County,6,5,996,670,326
50,12,125,Florida,Union County,6,6,1205,864,341
50,12,125,Florida,Union County,6,7,1250,967,283
50,12,125,Florida,Union County,6,8,1341,988,353
50,12,125,Florida,Union County,6,9,1321,915,406
50,12,125,Florida,Union County,6,10,1201,822,379
50,12,125,Florida,Union County,6,11,1035,715,320
50,12,125,Florida,Union County,6,12,930,633,297
50,12,125,Florida,Union County,6,13,692,465,227
50,12,125,Florida,Union County,6,14,497,300,197
50,12,125,Florida,Union County,6,15,307,180,127
50,12,125,Florida,Union County,6,16,208,100,108
50,12,125,Florida,Union County,6,17,120,49,71
50,12,125,Florida,Union County,6,18,75,29,46
50,12,125,Florida,Union County,6,99,14470,9445,5025
50,12,125,Florida,Union County,7,0,163,89,74
50,12,125,Florida,Union County,7,1,582,308,274
50,12,125,Florida,Union County,7,2,796,385,411
50,12,125,Florida,Union County,7,3,818,425,393
50,12,125,Florida,Union County,7,4,935,560,375
50,12,125,Florida,Union County,7,5,1021,702,319
50,12,125,Florida,Union County,7,6,1224,892,332
50,12,125,Florida,Union County,7,7,1265,964,301
50,12,125,Florida,Union County,7,8,1287,956,331
50,12,125,Florida,Union County,7,9,1353,950,403
50,12,125,Florida,Union County,7,10,1198,802,396
50,12,125,Florida,Union County,7,11,1128,778,350
50,12,125,Florida,Union County,7,12,1051,744,307
50,12,125,Florida,Union County,7,13,770,520,250
50,12,125,Florida,Union County,7,14,497,319,178
50,12,125,Florida,Union County,7,15,335,196,139
50,12,125,Florida,Union County,7,16,234,117,117
50,12,125,Florida,Union County,7,17,118,48,70
50,12,125,Florida,Union County,7,18,81,31,50
50,12,125,Florida,Union County,7,99,14856,9786,5070
50,12,125,Florida,Union County,8,0,169,89,80
50,12,125,Florida,Union County,8,1,562,279,283
50,12,125,Florida,Union County,8,2,810,384,426
50,12,125,Florida,Union County,8,3,846,441,405
50,12,125,Florida,Union County,8,4,898,527,371
50,12,125,Florida,Union County,8,5,996,674,322
50,12,125,Florida,Union County,8,6,1263,905,358
50,12,125,Florida,Union County,8,7,1182,880,302
50,12,125,Florida,Union County,8,8,1253,919,334
50,12,125,Florida,Union County,8,9,1280,903,377
50,12,125,Florida,Union County,8,10,1209,798,411
50,12,125,Florida,Union County,8,11,1138,790,348
50,12,125,Florida,Union County,8,12,1114,794,320
50,12,125,Florida,Union County,8,13,821,554,267
50,12,125,Florida,Union County,8,14,527,333,194
50,12,125,Florida,Union County,8,15,348,204,144
50,12,125,Florida,Union County,8,16,240,115,125
50,12,125,Florida,Union County,8,17,129,59,70
50,12,125,Florida,Union County,8,18,88,29,59
50,12,125,Florida,Union County,8,99,14873,9677,5196
50,12,125,Florida,Union County,9,0,181,93,88
50,12,125,Florida,Union County,9,1,595,303,292
50,12,125,Florida,Union County,9,2,787,389,398
50,12,125,Florida,Union County,9,3,863,448,415
50,12,125,Florida,Union County,9,4,885,510,375
50,12,125,Florida,Union County,9,5,1070,732,338
50,12,125,Florida,Union County,9,6,1296,930,366
50,12,125,Florida,Union County,9,7,1212,896,316
50,12,125,Florida,Union County,9,8,1277,924,353
50,12,125,Florida,Union County,9,9,1274,890,384
50,12,125,Florida,Union County,9,10,1217,831,386
50,12,125,Florida,Union County,9,11,1233,870,363
50,12,125,Florida,Union County,9,12,1200,870,330
50,12,125,Florida,Union County,9,13,906,620,286
50,12,125,Florida,Union County,9,14,577,356,221
50,12,125,Florida,Union County,9,15,372,218,154
50,12,125,Florida,Union County,9,16,226,118,108
50,12,125,Florida,Union County,9,17,162,71,91
50,12,125,Florida,Union County,9,18,86,27,59
50,12,125,Florida,Union County,9,99,15419,10096,5323
50,12,125,Florida,Union County,10,0,182,92,90
50,12,125,Florida,Union County,10,1,657,323,334
50,12,125,Florida,Union County,10,2,771,382,389
50,12,125,Florida,Union County,10,3,855,435,420
50,12,125,Florida,Union County,10,4,923,524,399
50,12,125,Florida,Union County,10,5,1091,755,336
50,12,125,Florida,Union County,10,6,1300,946,354
50,12,125,Florida,Union County,10,7,1209,884,325
50,12,125,Florida,Union County,10,8,1262,891,371
50,12,125,Florida,Union County,10,9,1205,845,360
50,12,125,Florida,Union County,10,10,1232,817,415
50,12,125,Florida,Union County,10,11,1313,934,379
50,12,125,Florida,Union County,10,12,1222,899,323
50,12,125,Florida,Union County,10,13,964,680,284
50,12,125,Florida,Union County,10,14,598,390,208
50,12,125,Florida,Union County,10,15,386,224,162
50,12,125,Florida,Union County,10,16,286,145,141
50,12,125,Florida,Union County,10,17,154,65,89
50,12,125,Florida,Union County,10,18,108,38,70
50,12,125,Florida,Union County,10,99,15718,10269,5449
50,12,125,Florida,Union County,11,0,162,85,77
50,12,125,Florida,Union County,11,1,681,343,338
50,12,125,Florida,Union County,11,2,781,395,386
50,12,125,Florida,Union County,11,3,877,434,443
50,12,125,Florida,Union County,11,4,894,509,385
50,12,125,Florida,Union County,11,5,1058,748,310
50,12,125,Florida,Union County,11,6,1255,869,386
50,12,125,Florida,Union County,11,7,1139,807,332
50,12,125,Florida,Union County,11,8,1157,801,356
50,12,125,Florida,Union County,11,9,1080,730,350
50,12,125,Florida,Union County,11,10,1221,791,430
50,12,125,Florida,Union County,11,11,1264,873,391
50,12,125,Florida,Union County,11,12,1272,927,345
50,12,125,Florida,Union County,11,13,972,677,295
50,12,125,Florida,Union County,11,14,604,391,213
50,12,125,Florida,Union County,11,15,380,223,157
50,12,125,Florida,Union County,11,16,292,160,132
50,12,125,Florida,Union County,11,17,152,65,87
50,12,125,Florida,Union County,11,18,99,30,69
50,12,125,Florida,Union County,11,99,15340,9858,5482
50,12,125,Florida,Union County,12,0,152,83,69
50,12,125,Florida,Union County,12,1,675,347,328
50,12,125,Florida,Union County,12,2,769,390,379
50,12,125,Florida,Union County,12,3,880,443,437
50,12,125,Florida,Union County,12,4,896,506,390
50,12,125,Florida,Union County,12,5,1075,754,321
50,12,125,Florida,Union County,12,6,1276,897,379
50,12,125,Florida,Union County,12,7,1139,798,341
50,12,125,Florida,Union County,12,8,1123,761,362
50,12,125,Florida,Union County,12,9,1047,718,329
50,12,125,Florida,Union County,12,10,1266,830,436
50,12,125,Florida,Union County,12,11,1319,902,417
50,12,125,Florida,Union County,12,12,1325,976,349
50,12,125,Florida,Union County,12,13,1039,745,294
50,12,125,Florida,Union County,12,14,638,414,224
50,12,125,Florida,Union County,12,15,394,238,156
50,12,125,Florida,Union County,12,16,274,145,129
50,12,125,Florida,Union County,12,17,148,66,82
50,12,125,Florida,Union County,12,18,100,32,68
50,12,125,Florida,Union County,12,99,15535,10045,5490
50,12,125,Florida,Union County,13,0,150,83,67
50,12,125,Florida,Union County,13,1,672,347,325
50,12,125,Florida,Union County,13,2,765,388,377
50,12,125,Florida,Union County,13,3,877,442,435
50,12,125,Florida,Union County,13,4,890,504,386
50,12,125,Florida,Union County,13,5,1083,759,324
50,12,125,Florida,Union County,13,6,1278,900,378
50,12,125,Florida,Union County,13,7,1143,798,345
50,12,125,Florida,Union County,13,8,1117,757,360
50,12,125,Florida,Union County,13,9,1048,719,329
50,12,125,Florida,Union County,13,10,1262,826,436
50,12,125,Florida,Union County,13,11,1323,906,417
50,12,125,Florida,Union County,13,12,1326,978,348
50,12,125,Florida,Union County,13,13,1043,746,297
50,12,125,Florida,Union County,13,14,634,414,220
50,12,125,Florida,Union County,13,15,391,238,153
50,12,125,Florida,Union County,13,16,274,145,129
50,12,125,Florida,Union County,13,17,147,66,81
50,12,125,Florida,Union County,13,18,101,32,69
50,12,125,Florida,Union County,13,99,15524,10048,5476
50,12,127,Florida,Volusia County,1,0,4157,2116,2041
50,12,127,Florida,Volusia County,1,1,17498,8913,8585
50,12,127,Florida,Volusia County,1,2,25069,12802,12267
50,12,127,Florida,Volusia County,1,3,27081,14027,13054
50,12,127,Florida,Volusia County,1,4,27605,14497,13108
50,12,127,Florida,Volusia County,1,5,24727,13267,11460
50,12,127,Florida,Volusia County,1,6,22753,11729,11024
50,12,127,Florida,Volusia County,1,7,25489,12898,12591
50,12,127,Florida,Volusia County,1,8,31195,15403,15792
50,12,127,Florida,Volusia County,1,9,32660,16111,16549
50,12,127,Florida,Volusia County,1,10,30386,14774,15612
50,12,127,Florida,Volusia County,1,11,28741,13914,14827
50,12,127,Florida,Volusia County,1,12,24578,11532,13046
50,12,127,Florida,Volusia County,1,13,23624,10875,12749
50,12,127,Florida,Volusia County,1,14,24729,11559,13170
50,12,127,Florida,Volusia County,1,15,25297,11494,13803
50,12,127,Florida,Volusia County,1,16,22076,9785,12291
50,12,127,Florida,Volusia County,1,17,14402,5960,8442
50,12,127,Florida,Volusia County,1,18,11318,3729,7589
50,12,127,Florida,Volusia County,1,99,443385,215385,228000
50,12,127,Florida,Volusia County,2,0,4203,2136,2067
50,12,127,Florida,Volusia County,2,1,17474,8900,8574
50,12,127,Florida,Volusia County,2,2,24988,12760,12228
50,12,127,Florida,Volusia County,2,3,27245,14107,13138
50,12,127,Florida,Volusia County,2,4,27700,14553,13147
50,12,127,Florida,Volusia County,2,5,25003,13424,11579
50,12,127,Florida,Volusia County,2,6,22593,11641,10952
50,12,127,Florida,Volusia County,2,7,25502,12896,12606
50,12,127,Florida,Volusia County,2,8,31129,15381,15748
50,12,127,Florida,Volusia County,2,9,32823,16194,16629
50,12,127,Florida,Volusia County,2,10,30635,14897,15738
50,12,127,Florida,Volusia County,2,11,29117,14102,15015
50,12,127,Florida,Volusia County,2,12,24805,11642,13163
50,12,127,Florida,Volusia County,2,13,23782,10948,12834
50,12,127,Florida,Volusia County,2,14,24670,11543,13127
50,12,127,Florida,Volusia County,2,15,25277,11506,13771
50,12,127,Florida,Volusia County,2,16,22109,9808,12301
50,12,127,Florida,Volusia County,2,17,14511,6013,8498
50,12,127,Florida,Volusia County,2,18,11369,3750,7619
50,12,127,Florida,Volusia County,2,99,444935,216201,228734
50,12,127,Florida,Volusia County,3,0,4613,2391,2222
50,12,127,Florida,Volusia County,3,1,17524,8938,8586
50,12,127,Florida,Volusia County,3,2,24686,12621,12065
50,12,127,Florida,Volusia County,3,3,27797,14277,13520
50,12,127,Florida,Volusia County,3,4,27887,14767,13120
50,12,127,Florida,Volusia County,3,5,26448,14090,12358
50,12,127,Florida,Volusia County,3,6,22047,11333,10714
50,12,127,Florida,Volusia County,3,7,25280,12750,12530
50,12,127,Florida,Volusia County,3,8,30464,15076,15388
50,12,127,Florida,Volusia County,3,9,33708,16657,17051
50,12,127,Florida,Volusia County,3,10,31420,15284,16136
50,12,127,Florida,Volusia County,3,11,31068,15047,16021
50,12,127,Florida,Volusia County,3,12,25790,12193,13597
50,12,127,Florida,Volusia County,3,13,24375,11284,13091
50,12,127,Florida,Volusia County,3,14,24522,11422,13100
50,12,127,Florida,Volusia County,3,15,24975,11361,13614
50,12,127,Florida,Volusia County,3,16,21917,9830,12087
50,12,127,Florida,Volusia County,3,17,15093,6319,8774
50,12,127,Florida,Volusia County,3,18,11489,3848,7641
50,12,127,Florida,Volusia County,3,99,451103,219488,231615
50,12,127,Florida,Volusia County,4,0,4568,2313,2255
50,12,127,Florida,Volusia County,4,1,18112,9301,8811
50,12,127,Florida,Volusia County,4,2,24240,12378,11862
50,12,127,Florida,Volusia County,4,3,28338,14534,13804
50,12,127,Florida,Volusia County,4,4,28487,15143,13344
50,12,127,Florida,Volusia County,4,5,27241,14385,12856
50,12,127,Florida,Volusia County,4,6,22096,11364,10732
50,12,127,Florida,Volusia County,4,7,25366,12716,12650
50,12,127,Florida,Volusia County,4,8,29631,14795,14836
50,12,127,Florida,Volusia County,4,9,34341,16938,17403
50,12,127,Florida,Volusia County,4,10,32692,15915,16777
50,12,127,Florida,Volusia County,4,11,31145,15032,16113
50,12,127,Florida,Volusia County,4,12,28375,13540,14835
50,12,127,Florida,Volusia County,4,13,25293,11743,13550
50,12,127,Florida,Volusia County,4,14,24737,11593,13144
50,12,127,Florida,Volusia County,4,15,24539,11224,13315
50,12,127,Florida,Volusia County,4,16,21981,9721,12260
50,12,127,Florida,Volusia County,4,17,15509,6539,8970
50,12,127,Florida,Volusia County,4,18,11557,3987,7570
50,12,127,Florida,Volusia County,4,99,458248,223161,235087
50,12,127,Florida,Volusia County,5,0,4664,2390,2274
50,12,127,Florida,Volusia County,5,1,18567,9537,9030
50,12,127,Florida,Volusia County,5,2,24247,12333,11914
50,12,127,Florida,Volusia County,5,3,28563,14603,13960
50,12,127,Florida,Volusia County,5,4,29406,15651,13755
50,12,127,Florida,Volusia County,5,5,27987,14858,13129
50,12,127,Florida,Volusia County,5,6,22925,11792,11133
50,12,127,Florida,Volusia County,5,7,25121,12636,12485
50,12,127,Florida,Volusia County,5,8,29093,14504,14589
50,12,127,Florida,Volusia County,5,9,34505,17057,17448
50,12,127,Florida,Volusia County,5,10,33917,16564,17353
50,12,127,Florida,Volusia County,5,11,31907,15285,16622
50,12,127,Florida,Volusia County,5,12,29837,14380,15457
50,12,127,Florida,Volusia County,5,13,26552,12328,14224
50,12,127,Florida,Volusia County,5,14,25195,11786,13409
50,12,127,Florida,Volusia County,5,15,24196,11193,13003
50,12,127,Florida,Volusia County,5,16,22011,9742,12269
50,12,127,Florida,Volusia County,5,17,15532,6570,8962
50,12,127,Florida,Volusia County,5,18,11849,4110,7739
50,12,127,Florida,Volusia County,5,99,466074,227319,238755
50,12,127,Florida,Volusia County,6,0,4857,2434,2423
50,12,127,Florida,Volusia County,6,1,19075,9772,9303
50,12,127,Florida,Volusia County,6,2,24443,12486,11957
50,12,127,Florida,Volusia County,6,3,28678,14687,13991
50,12,127,Florida,Volusia County,6,4,30469,16255,14214
50,12,127,Florida,Volusia County,6,5,28731,15167,13564
50,12,127,Florida,Volusia County,6,6,24295,12531,11764
50,12,127,Florida,Volusia County,6,7,25150,12629,12521
50,12,127,Florida,Volusia County,6,8,28582,14117,14465
50,12,127,Florida,Volusia County,6,9,34793,17289,17504
50,12,127,Florida,Volusia County,6,10,35188,17237,17951
50,12,127,Florida,Volusia County,6,11,33023,15752,17271
50,12,127,Florida,Volusia County,6,12,31770,15359,16411
50,12,127,Florida,Volusia County,6,13,27997,13039,14958
50,12,127,Florida,Volusia County,6,14,26028,12228,13800
50,12,127,Florida,Volusia County,6,15,23896,11100,12796
50,12,127,Florida,Volusia County,6,16,21758,9703,12055
50,12,127,Florida,Volusia County,6,17,15969,6708,9261
50,12,127,Florida,Volusia County,6,18,12143,4278,7865
50,12,127,Florida,Volusia County,6,99,476845,232771,244074
50,12,127,Florida,Volusia County,7,0,4890,2488,2402
50,12,127,Florida,Volusia County,7,1,19650,10047,9603
50,12,127,Florida,Volusia County,7,2,24566,12528,12038
50,12,127,Florida,Volusia County,7,3,28866,14675,14191
50,12,127,Florida,Volusia County,7,4,31494,16851,14643
50,12,127,Florida,Volusia County,7,5,29329,15385,13944
50,12,127,Florida,Volusia County,7,6,25598,13310,12288
50,12,127,Florida,Volusia County,7,7,24982,12455,12527
50,12,127,Florida,Volusia County,7,8,28700,14397,14303
50,12,127,Florida,Volusia County,7,9,34843,17226,17617
50,12,127,Florida,Volusia County,7,10,36278,17740,18538
50,12,127,Florida,Volusia County,7,11,34284,16450,17834
50,12,127,Florida,Volusia County,7,12,33508,16115,17393
50,12,127,Florida,Volusia County,7,13,29207,13617,15590
50,12,127,Florida,Volusia County,7,14,26430,12519,13911
50,12,127,Florida,Volusia County,7,15,23728,11021,12707
50,12,127,Florida,Volusia County,7,16,21473,9599,11874
50,12,127,Florida,Volusia County,7,17,16062,6768,9294
50,12,127,Florida,Volusia County,7,18,12409,4375,8034
50,12,127,Florida,Volusia County,7,99,486297,237566,248731
50,12,127,Florida,Volusia County,8,0,5081,2550,2531
50,12,127,Florida,Volusia County,8,1,19944,10143,9801
50,12,127,Florida,Volusia County,8,2,25400,13134,12266
50,12,127,Florida,Volusia County,8,3,28723,14665,14058
50,12,127,Florida,Volusia County,8,4,32172,17046,15126
50,12,127,Florida,Volusia County,8,5,30009,15897,14112
50,12,127,Florida,Volusia County,8,6,27312,13995,13317
50,12,127,Florida,Volusia County,8,7,24957,12417,12540
50,12,127,Florida,Volusia County,8,8,29066,14651,14415
50,12,127,Florida,Volusia County,8,9,34312,17038,17274
50,12,127,Florida,Volusia County,8,10,37522,18388,19134
50,12,127,Florida,Volusia County,8,11,35240,16882,18358
50,12,127,Florida,Volusia County,8,12,35336,16972,18364
50,12,127,Florida,Volusia County,8,13,29993,14174,15819
50,12,127,Florida,Volusia County,8,14,26459,12443,14016
50,12,127,Florida,Volusia County,8,15,23309,10820,12489
50,12,127,Florida,Volusia County,8,16,21064,9450,11614
50,12,127,Florida,Volusia County,8,17,16062,6800,9262
50,12,127,Florida,Volusia County,8,18,12787,4559,8228
50,12,127,Florida,Volusia County,8,99,494748,242024,252724
50,12,127,Florida,Volusia County,9,0,5199,2622,2577
50,12,127,Florida,Volusia County,9,1,19986,10166,9820
50,12,127,Florida,Volusia County,9,2,25778,13226,12552
50,12,127,Florida,Volusia County,9,3,28409,14585,13824
50,12,127,Florida,Volusia County,9,4,32751,17350,15401
50,12,127,Florida,Volusia County,9,5,30538,16291,14247
50,12,127,Florida,Volusia County,9,6,27468,14023,13445
50,12,127,Florida,Volusia County,9,7,24834,12351,12483
50,12,127,Florida,Volusia County,9,8,29323,14728,14595
50,12,127,Florida,Volusia County,9,9,33175,16593,16582
50,12,127,Florida,Volusia County,9,10,37984,18569,19415
50,12,127,Florida,Volusia County,9,11,36323,17490,18833
50,12,127,Florida,Volusia County,9,12,35110,16765,18345
50,12,127,Florida,Volusia County,9,13,31864,15130,16734
50,12,127,Florida,Volusia County,9,14,27185,12824,14361
50,12,127,Florida,Volusia County,9,15,23164,10816,12348
50,12,127,Florida,Volusia County,9,16,20513,9223,11290
50,12,127,Florida,Volusia County,9,17,16114,6776,9338
50,12,127,Florida,Volusia County,9,18,13217,4755,8462
50,12,127,Florida,Volusia County,9,99,498935,244283,254652
50,12,127,Florida,Volusia County,10,0,5150,2601,2549
50,12,127,Florida,Volusia County,10,1,19808,10077,9731
50,12,127,Florida,Volusia County,10,2,25302,12961,12341
50,12,127,Florida,Volusia County,10,3,27844,14296,13548
50,12,127,Florida,Volusia County,10,4,32435,17129,15306
50,12,127,Florida,Volusia County,10,5,30446,16206,14240
50,12,127,Florida,Volusia County,10,6,27019,13818,13201
50,12,127,Florida,Volusia County,10,7,24706,12235,12471
50,12,127,Florida,Volusia County,10,8,28426,14380,14046
50,12,127,Florida,Volusia County,10,9,31775,15819,15956
50,12,127,Florida,Volusia County,10,10,37502,18412,19090
50,12,127,Florida,Volusia County,10,11,37008,17885,19123
50,12,127,Florida,Volusia County,10,12,34915,16556,18359
50,12,127,Florida,Volusia County,10,13,32878,15676,17202
50,12,127,Florida,Volusia County,10,14,28290,13353,14937
50,12,127,Florida,Volusia County,10,15,23528,10941,12587
50,12,127,Florida,Volusia County,10,16,20284,9202,11082
50,12,127,Florida,Volusia County,10,17,16353,6876,9477
50,12,127,Florida,Volusia County,10,18,13697,4929,8768
50,12,127,Florida,Volusia County,10,99,497366,243352,254014
50,12,127,Florida,Volusia County,11,0,4846,2432,2414
50,12,127,Florida,Volusia County,11,1,19834,10074,9760
50,12,127,Florida,Volusia County,11,2,24857,12694,12163
50,12,127,Florida,Volusia County,11,3,27472,14049,13423
50,12,127,Florida,Volusia County,11,4,31591,16633,14958
50,12,127,Florida,Volusia County,11,5,30454,16128,14326
50,12,127,Florida,Volusia County,11,6,26352,13420,12932
50,12,127,Florida,Volusia County,11,7,24583,12286,12297
50,12,127,Florida,Volusia County,11,8,27637,13916,13721
50,12,127,Florida,Volusia County,11,9,30441,15078,15363
50,12,127,Florida,Volusia County,11,10,36853,18121,18732
50,12,127,Florida,Volusia County,11,11,37368,18041,19327
50,12,127,Florida,Volusia County,11,12,35030,16589,18441
50,12,127,Florida,Volusia County,11,13,34015,16289,17726
50,12,127,Florida,Volusia County,11,14,29224,13801,15423
50,12,127,Florida,Volusia County,11,15,23814,11128,12686
50,12,127,Florida,Volusia County,11,16,19863,9029,10834
50,12,127,Florida,Volusia County,11,17,16170,6856,9314
50,12,127,Florida,Volusia County,11,18,14284,5138,9146
50,12,127,Florida,Volusia County,11,99,494688,241702,252986
50,12,127,Florida,Volusia County,12,0,4648,2342,2306
50,12,127,Florida,Volusia County,12,1,19689,10056,9633
50,12,127,Florida,Volusia County,12,2,24819,12725,12094
50,12,127,Florida,Volusia County,12,3,26923,13689,13234
50,12,127,Florida,Volusia County,12,4,31095,16313,14782
50,12,127,Florida,Volusia County,12,5,30798,16323,14475
50,12,127,Florida,Volusia County,12,6,25952,13128,12824
50,12,127,Florida,Volusia County,12,7,24890,12515,12375
50,12,127,Florida,Volusia County,12,8,26838,13478,13360
50,12,127,Florida,Volusia County,12,9,29773,14881,14892
50,12,127,Florida,Volusia County,12,10,36408,17836,18572
50,12,127,Florida,Volusia County,12,11,37785,18263,19522
50,12,127,Florida,Volusia County,12,12,35429,16849,18580
50,12,127,Florida,Volusia County,12,13,35257,16794,18463
50,12,127,Florida,Volusia County,12,14,29761,14078,15683
50,12,127,Florida,Volusia County,12,15,24006,11281,12725
50,12,127,Florida,Volusia County,12,16,19810,9045,10765
50,12,127,Florida,Volusia County,12,17,16062,6818,9244
50,12,127,Florida,Volusia County,12,18,14650,5301,9349
50,12,127,Florida,Volusia County,12,99,494593,241715,252878
50,12,127,Florida,Volusia County,13,0,4636,2339,2297
50,12,127,Florida,Volusia County,13,1,19602,10014,9588
50,12,127,Florida,Volusia County,13,2,24773,12701,12072
50,12,127,Florida,Volusia County,13,3,26840,13650,13190
50,12,127,Florida,Volusia County,13,4,30821,16173,14648
50,12,127,Florida,Volusia County,13,5,30813,16327,14486
50,12,127,Florida,Volusia County,13,6,25951,13154,12797
50,12,127,Florida,Volusia County,13,7,24986,12553,12433
50,12,127,Florida,Volusia County,13,8,26587,13347,13240
50,12,127,Florida,Volusia County,13,9,29665,14834,14831
50,12,127,Florida,Volusia County,13,10,36212,17745,18467
50,12,127,Florida,Volusia County,13,11,37890,18325,19565
50,12,127,Florida,Volusia County,13,12,35682,16970,18712
50,12,127,Florida,Volusia County,13,13,35613,16970,18643
50,12,127,Florida,Volusia County,13,14,29874,14136,15738
50,12,127,Florida,Volusia County,13,15,24062,11316,12746
50,12,127,Florida,Volusia County,13,16,19758,9031,10727
50,12,127,Florida,Volusia County,13,17,16048,6829,9219
50,12,127,Florida,Volusia County,13,18,14714,5336,9378
50,12,127,Florida,Volusia County,13,99,494527,241750,252777
50,12,129,Florida,Wakulla County,1,0,254,127,127
50,12,129,Florida,Wakulla County,1,1,1094,571,523
50,12,129,Florida,Wakulla County,1,2,1560,811,749
50,12,129,Florida,Wakulla County,1,3,1850,961,889
50,12,129,Florida,Wakulla County,1,4,1710,905,805
50,12,129,Florida,Wakulla County,1,5,1137,597,540
50,12,129,Florida,Wakulla County,1,6,1380,734,646
50,12,129,Florida,Wakulla County,1,7,1690,902,788
50,12,129,Florida,Wakulla County,1,8,2040,1014,1026
50,12,129,Florida,Wakulla County,1,9,2142,1145,997
50,12,129,Florida,Wakulla County,1,10,1810,952,858
50,12,129,Florida,Wakulla County,1,11,1599,863,736
50,12,129,Florida,Wakulla County,1,12,1235,631,604
50,12,129,Florida,Wakulla County,1,13,1007,491,516
50,12,129,Florida,Wakulla County,1,14,786,413,373
50,12,129,Florida,Wakulla County,1,15,679,345,334
50,12,129,Florida,Wakulla County,1,16,434,196,238
50,12,129,Florida,Wakulla County,1,17,242,90,152
50,12,129,Florida,Wakulla County,1,18,208,85,123
50,12,129,Florida,Wakulla County,1,99,22857,11833,11024
50,12,129,Florida,Wakulla County,2,0,253,125,128
50,12,129,Florida,Wakulla County,2,1,1094,571,523
50,12,129,Florida,Wakulla County,2,2,1557,810,747
50,12,129,Florida,Wakulla County,2,3,1861,967,894
50,12,129,Florida,Wakulla County,2,4,1719,909,810
50,12,129,Florida,Wakulla County,2,5,1145,598,547
50,12,129,Florida,Wakulla County,2,6,1371,730,641
50,12,129,Florida,Wakulla County,2,7,1690,902,788
50,12,129,Florida,Wakulla County,2,8,2035,1010,1025
50,12,129,Florida,Wakulla County,2,9,2148,1147,1001
50,12,129,Florida,Wakulla County,2,10,1831,966,865
50,12,129,Florida,Wakulla County,2,11,1620,874,746
50,12,129,Florida,Wakulla County,2,12,1245,637,608
50,12,129,Florida,Wakulla County,2,13,1018,498,520
50,12,129,Florida,Wakulla County,2,14,786,414,372
50,12,129,Florida,Wakulla County,2,15,673,342,331
50,12,129,Florida,Wakulla County,2,16,431,193,238
50,12,129,Florida,Wakulla County,2,17,246,93,153
50,12,129,Florida,Wakulla County,2,18,201,83,118
50,12,129,Florida,Wakulla County,2,99,22924,11869,11055
50,12,129,Florida,Wakulla County,3,0,291,144,147
50,12,129,Florida,Wakulla County,3,1,1112,576,536
50,12,129,Florida,Wakulla County,3,2,1578,829,749
50,12,129,Florida,Wakulla County,3,3,1873,963,910
50,12,129,Florida,Wakulla County,3,4,1732,923,809
50,12,129,Florida,Wakulla County,3,5,1269,677,592
50,12,129,Florida,Wakulla County,3,6,1414,743,671
50,12,129,Florida,Wakulla County,3,7,1763,967,796
50,12,129,Florida,Wakulla County,3,8,2075,1077,998
50,12,129,Florida,Wakulla County,3,9,2241,1194,1047
50,12,129,Florida,Wakulla County,3,10,1985,1058,927
50,12,129,Florida,Wakulla County,3,11,1713,916,797
50,12,129,Florida,Wakulla County,3,12,1305,690,615
50,12,129,Florida,Wakulla County,3,13,1065,527,538
50,12,129,Florida,Wakulla County,3,14,798,427,371
50,12,129,Florida,Wakulla County,3,15,652,329,323
50,12,129,Florida,Wakulla County,3,16,459,212,247
50,12,129,Florida,Wakulla County,3,17,268,100,168
50,12,129,Florida,Wakulla County,3,18,186,72,114
50,12,129,Florida,Wakulla County,3,99,23779,12424,11355
50,12,129,Florida,Wakulla County,4,0,277,141,136
50,12,129,Florida,Wakulla County,4,1,1193,608,585
50,12,129,Florida,Wakulla County,4,2,1553,823,730
50,12,129,Florida,Wakulla County,4,3,1884,993,891
50,12,129,Florida,Wakulla County,4,4,1790,916,874
50,12,129,Florida,Wakulla County,4,5,1377,731,646
50,12,129,Florida,Wakulla County,4,6,1397,753,644
50,12,129,Florida,Wakulla County,4,7,1765,953,812
50,12,129,Florida,Wakulla County,4,8,2058,1087,971
50,12,129,Florida,Wakulla County,4,9,2253,1199,1054
50,12,129,Florida,Wakulla County,4,10,2067,1111,956
50,12,129,Florida,Wakulla County,4,11,1763,938,825
50,12,129,Florida,Wakulla County,4,12,1438,754,684
50,12,129,Florida,Wakulla County,4,13,1111,549,562
50,12,129,Florida,Wakulla County,4,14,892,474,418
50,12,129,Florida,Wakulla County,4,15,701,376,325
50,12,129,Florida,Wakulla County,4,16,457,198,259
50,12,129,Florida,Wakulla County,4,17,298,107,191
50,12,129,Florida,Wakulla County,4,18,184,72,112
50,12,129,Florida,Wakulla County,4,99,24458,12783,11675
50,12,129,Florida,Wakulla County,5,0,288,162,126
50,12,129,Florida,Wakulla County,5,1,1230,628,602
50,12,129,Florida,Wakulla County,5,2,1535,806,729
50,12,129,Florida,Wakulla County,5,3,1859,976,883
50,12,129,Florida,Wakulla County,5,4,1810,929,881
50,12,129,Florida,Wakulla County,5,5,1422,787,635
50,12,129,Florida,Wakulla County,5,6,1441,798,643
50,12,129,Florida,Wakulla County,5,7,1787,994,793
50,12,129,Florida,Wakulla County,5,8,2120,1130,990
50,12,129,Florida,Wakulla County,5,9,2224,1149,1075
50,12,129,Florida,Wakulla County,5,10,2140,1166,974
50,12,129,Florida,Wakulla County,5,11,1819,980,839
50,12,129,Florida,Wakulla County,5,12,1519,816,703
50,12,129,Florida,Wakulla County,5,13,1192,590,602
50,12,129,Florida,Wakulla County,5,14,948,504,444
50,12,129,Florida,Wakulla County,5,15,754,387,367
50,12,129,Florida,Wakulla County,5,16,476,208,268
50,12,129,Florida,Wakulla County,5,17,310,105,205
50,12,129,Florida,Wakulla County,5,18,188,82,106
50,12,129,Florida,Wakulla County,5,99,25062,13197,11865
50,12,129,Florida,Wakulla County,6,0,308,157,151
50,12,129,Florida,Wakulla County,6,1,1249,674,575
50,12,129,Florida,Wakulla County,6,2,1583,834,749
50,12,129,Florida,Wakulla County,6,3,1877,979,898
50,12,129,Florida,Wakulla County,6,4,1874,951,923
50,12,129,Florida,Wakulla County,6,5,1456,831,625
50,12,129,Florida,Wakulla County,6,6,1508,828,680
50,12,129,Florida,Wakulla County,6,7,1811,1018,793
50,12,129,Florida,Wakulla County,6,8,2089,1135,954
50,12,129,Florida,Wakulla County,6,9,2318,1211,1107
50,12,129,Florida,Wakulla County,6,10,2245,1266,979
50,12,129,Florida,Wakulla County,6,11,1874,1003,871
50,12,129,Florida,Wakulla County,6,12,1655,883,772
50,12,129,Florida,Wakulla County,6,13,1214,622,592
50,12,129,Florida,Wakulla County,6,14,1017,529,488
50,12,129,Florida,Wakulla County,6,15,749,380,369
50,12,129,Florida,Wakulla County,6,16,498,225,273
50,12,129,Florida,Wakulla County,6,17,327,120,207
50,12,129,Florida,Wakulla County,6,18,180,76,104
50,12,129,Florida,Wakulla County,6,99,25832,13722,12110
50,12,129,Florida,Wakulla County,7,0,326,167,159
50,12,129,Florida,Wakulla County,7,1,1315,714,601
50,12,129,Florida,Wakulla County,7,2,1684,886,798
50,12,129,Florida,Wakulla County,7,3,1873,987,886
50,12,129,Florida,Wakulla County,7,4,1855,971,884
50,12,129,Florida,Wakulla County,7,5,1511,846,665
50,12,129,Florida,Wakulla County,7,6,1571,881,690
50,12,129,Florida,Wakulla County,7,7,1776,994,782
50,12,129,Florida,Wakulla County,7,8,2122,1159,963
50,12,129,Florida,Wakulla County,7,9,2296,1189,1107
50,12,129,Florida,Wakulla County,7,10,2425,1361,1064
50,12,129,Florida,Wakulla County,7,11,1986,1036,950
50,12,129,Florida,Wakulla County,7,12,1793,985,808
50,12,129,Florida,Wakulla County,7,13,1289,637,652
50,12,129,Florida,Wakulla County,7,14,1079,557,522
50,12,129,Florida,Wakulla County,7,15,733,380,353
50,12,129,Florida,Wakulla County,7,16,552,261,291
50,12,129,Florida,Wakulla County,7,17,322,121,201
50,12,129,Florida,Wakulla County,7,18,198,78,120
50,12,129,Florida,Wakulla County,7,99,26706,14210,12496
50,12,129,Florida,Wakulla County,8,0,281,161,120
50,12,129,Florida,Wakulla County,8,1,1321,724,597
50,12,129,Florida,Wakulla County,8,2,1818,957,861
50,12,129,Florida,Wakulla County,8,3,1930,1021,909
50,12,129,Florida,Wakulla County,8,4,1867,959,908
50,12,129,Florida,Wakulla County,8,5,1514,846,668
50,12,129,Florida,Wakulla County,8,6,1724,996,728
50,12,129,Florida,Wakulla County,8,7,1857,1043,814
50,12,129,Florida,Wakulla County,8,8,2169,1228,941
50,12,129,Florida,Wakulla County,8,9,2298,1216,1082
50,12,129,Florida,Wakulla County,8,10,2517,1404,1113
50,12,129,Florida,Wakulla County,8,11,2159,1144,1015
50,12,129,Florida,Wakulla County,8,12,1863,997,866
50,12,129,Florida,Wakulla County,8,13,1382,715,667
50,12,129,Florida,Wakulla County,8,14,1174,597,577
50,12,129,Florida,Wakulla County,8,15,778,396,382
50,12,129,Florida,Wakulla County,8,16,560,282,278
50,12,129,Florida,Wakulla County,8,17,355,143,212
50,12,129,Florida,Wakulla County,8,18,218,77,141
50,12,129,Florida,Wakulla County,8,99,27785,14906,12879
50,12,129,Florida,Wakulla County,9,0,307,165,142
50,12,129,Florida,Wakulla County,9,1,1412,780,632
50,12,129,Florida,Wakulla County,9,2,1917,1021,896
50,12,129,Florida,Wakulla County,9,3,1910,1027,883
50,12,129,Florida,Wakulla County,9,4,1894,967,927
50,12,129,Florida,Wakulla County,9,5,1543,820,723
50,12,129,Florida,Wakulla County,9,6,1769,1016,753
50,12,129,Florida,Wakulla County,9,7,1892,1060,832
50,12,129,Florida,Wakulla County,9,8,2188,1195,993
50,12,129,Florida,Wakulla County,9,9,2340,1273,1067
50,12,129,Florida,Wakulla County,9,10,2498,1388,1110
50,12,129,Florida,Wakulla County,9,11,2212,1157,1055
50,12,129,Florida,Wakulla County,9,12,1925,1016,909
50,12,129,Florida,Wakulla County,9,13,1489,763,726
50,12,129,Florida,Wakulla County,9,14,1218,625,593
50,12,129,Florida,Wakulla County,9,15,852,421,431
50,12,129,Florida,Wakulla County,9,16,600,320,280
50,12,129,Florida,Wakulla County,9,17,363,136,227
50,12,129,Florida,Wakulla County,9,18,259,90,169
50,12,129,Florida,Wakulla County,9,99,28588,15240,13348
50,12,129,Florida,Wakulla County,10,0,324,157,167
50,12,129,Florida,Wakulla County,10,1,1469,775,694
50,12,129,Florida,Wakulla County,10,2,1933,1039,894
50,12,129,Florida,Wakulla County,10,3,1905,1015,890
50,12,129,Florida,Wakulla County,10,4,1943,991,952
50,12,129,Florida,Wakulla County,10,5,1625,887,738
50,12,129,Florida,Wakulla County,10,6,1859,1050,809
50,12,129,Florida,Wakulla County,10,7,1888,1049,839
50,12,129,Florida,Wakulla County,10,8,2213,1208,1005
50,12,129,Florida,Wakulla County,10,9,2297,1272,1025
50,12,129,Florida,Wakulla County,10,10,2516,1374,1142
50,12,129,Florida,Wakulla County,10,11,2312,1186,1126
50,12,129,Florida,Wakulla County,10,12,1955,1040,915
50,12,129,Florida,Wakulla County,10,13,1582,812,770
50,12,129,Florida,Wakulla County,10,14,1266,647,619
50,12,129,Florida,Wakulla County,10,15,854,411,443
50,12,129,Florida,Wakulla County,10,16,637,327,310
50,12,129,Florida,Wakulla County,10,17,346,142,204
50,12,129,Florida,Wakulla County,10,18,259,93,166
50,12,129,Florida,Wakulla County,10,99,29183,15475,13708
50,12,129,Florida,Wakulla County,11,0,339,175,164
50,12,129,Florida,Wakulla County,11,1,1466,766,700
50,12,129,Florida,Wakulla County,11,2,1987,1062,925
50,12,129,Florida,Wakulla County,11,3,1954,1055,899
50,12,129,Florida,Wakulla County,11,4,1927,967,960
50,12,129,Florida,Wakulla County,11,5,1711,951,760
50,12,129,Florida,Wakulla County,11,6,2033,1211,822
50,12,129,Florida,Wakulla County,11,7,2103,1253,850
50,12,129,Florida,Wakulla County,11,8,2371,1358,1013
50,12,129,Florida,Wakulla County,11,9,2365,1388,977
50,12,129,Florida,Wakulla County,11,10,2671,1529,1142
50,12,129,Florida,Wakulla County,11,11,2451,1338,1113
50,12,129,Florida,Wakulla County,11,12,2023,1084,939
50,12,129,Florida,Wakulla County,11,13,1703,893,810
50,12,129,Florida,Wakulla County,11,14,1255,643,612
50,12,129,Florida,Wakulla County,11,15,866,429,437
50,12,129,Florida,Wakulla County,11,16,605,304,301
50,12,129,Florida,Wakulla County,11,17,366,156,210
50,12,129,Florida,Wakulla County,11,18,263,104,159
50,12,129,Florida,Wakulla County,11,99,30459,16666,13793
50,12,129,Florida,Wakulla County,12,0,320,163,157
50,12,129,Florida,Wakulla County,12,1,1420,741,679
50,12,129,Florida,Wakulla County,12,2,2000,1074,926
50,12,129,Florida,Wakulla County,12,3,1951,1050,901
50,12,129,Florida,Wakulla County,12,4,1905,965,940
50,12,129,Florida,Wakulla County,12,5,1770,999,771
50,12,129,Florida,Wakulla County,12,6,2099,1282,817
50,12,129,Florida,Wakulla County,12,7,2177,1326,851
50,12,129,Florida,Wakulla County,12,8,2384,1388,996
50,12,129,Florida,Wakulla County,12,9,2394,1439,955
50,12,129,Florida,Wakulla County,12,10,2681,1535,1146
50,12,129,Florida,Wakulla County,12,11,2486,1367,1119
50,12,129,Florida,Wakulla County,12,12,2072,1097,975
50,12,129,Florida,Wakulla County,12,13,1778,948,830
50,12,129,Florida,Wakulla County,12,14,1256,646,610
50,12,129,Florida,Wakulla County,12,15,867,421,446
50,12,129,Florida,Wakulla County,12,16,580,283,297
50,12,129,Florida,Wakulla County,12,17,378,163,215
50,12,129,Florida,Wakulla County,12,18,258,105,153
50,12,129,Florida,Wakulla County,12,99,30776,16992,13784
50,12,129,Florida,Wakulla County,13,0,324,165,159
50,12,129,Florida,Wakulla County,13,1,1422,741,681
50,12,129,Florida,Wakulla County,13,2,2004,1075,929
50,12,129,Florida,Wakulla County,13,3,1959,1055,904
50,12,129,Florida,Wakulla County,13,4,1889,959,930
50,12,129,Florida,Wakulla County,13,5,1775,1001,774
50,12,129,Florida,Wakulla County,13,6,2115,1290,825
50,12,129,Florida,Wakulla County,13,7,2192,1330,862
50,12,129,Florida,Wakulla County,13,8,2367,1377,990
50,12,129,Florida,Wakulla County,13,9,2393,1441,952
50,12,129,Florida,Wakulla County,13,10,2674,1531,1143
50,12,129,Florida,Wakulla County,13,11,2491,1369,1122
50,12,129,Florida,Wakulla County,13,12,2088,1107,981
50,12,129,Florida,Wakulla County,13,13,1791,954,837
50,12,129,Florida,Wakulla County,13,14,1259,648,611
50,12,129,Florida,Wakulla County,13,15,868,421,447
50,12,129,Florida,Wakulla County,13,16,579,284,295
50,12,129,Florida,Wakulla County,13,17,377,164,213
50,12,129,Florida,Wakulla County,13,18,259,105,154
50,12,129,Florida,Wakulla County,13,99,30826,17017,13809
50,12,131,Florida,Walton County,1,0,444,227,217
50,12,131,Florida,Walton County,1,1,1715,929,786
50,12,131,Florida,Walton County,1,2,2520,1303,1217
50,12,131,Florida,Walton County,1,3,2556,1271,1285
50,12,131,Florida,Walton County,1,4,2462,1267,1195
50,12,131,Florida,Walton County,1,5,1990,1073,917
50,12,131,Florida,Walton County,1,6,2424,1350,1074
50,12,131,Florida,Walton County,1,7,2542,1384,1158
50,12,131,Florida,Walton County,1,8,3281,1721,1560
50,12,131,Florida,Walton County,1,9,3311,1778,1533
50,12,131,Florida,Walton County,1,10,3042,1597,1445
50,12,131,Florida,Walton County,1,11,2865,1457,1408
50,12,131,Florida,Walton County,1,12,2596,1236,1360
50,12,131,Florida,Walton County,1,13,2391,1190,1201
50,12,131,Florida,Walton County,1,14,2082,1060,1022
50,12,131,Florida,Walton County,1,15,1798,862,936
50,12,131,Florida,Walton County,1,16,1283,615,668
50,12,131,Florida,Walton County,1,17,696,286,410
50,12,131,Florida,Walton County,1,18,563,187,376
50,12,131,Florida,Walton County,1,99,40561,20793,19768
50,12,131,Florida,Walton County,2,0,456,234,222
50,12,131,Florida,Walton County,2,1,1710,923,787
50,12,131,Florida,Walton County,2,2,2527,1301,1226
50,12,131,Florida,Walton County,2,3,2570,1279,1291
50,12,131,Florida,Walton County,2,4,2478,1276,1202
50,12,131,Florida,Walton County,2,5,2019,1088,931
50,12,131,Florida,Walton County,2,6,2414,1347,1067
50,12,131,Florida,Walton County,2,7,2545,1387,1158
50,12,131,Florida,Walton County,2,8,3283,1722,1561
50,12,131,Florida,Walton County,2,9,3331,1789,1542
50,12,131,Florida,Walton County,2,10,3062,1608,1454
50,12,131,Florida,Walton County,2,11,2897,1475,1422
50,12,131,Florida,Walton County,2,12,2613,1241,1372
50,12,131,Florida,Walton County,2,13,2402,1193,1209
50,12,131,Florida,Walton County,2,14,2086,1064,1022
50,12,131,Florida,Walton County,2,15,1802,865,937
50,12,131,Florida,Walton County,2,16,1295,621,674
50,12,131,Florida,Walton County,2,17,704,290,414
50,12,131,Florida,Walton County,2,18,561,187,374
50,12,131,Florida,Walton County,2,99,40755,20890,19865
50,12,131,Florida,Walton County,3,0,498,259,239
50,12,131,Florida,Walton County,3,1,1792,934,858
50,12,131,Florida,Walton County,3,2,2482,1327,1155
50,12,131,Florida,Walton County,3,3,2714,1358,1356
50,12,131,Florida,Walton County,3,4,2522,1296,1226
50,12,131,Florida,Walton County,3,5,2170,1168,1002
50,12,131,Florida,Walton County,3,6,2490,1379,1111
50,12,131,Florida,Walton County,3,7,2614,1442,1172
50,12,131,Florida,Walton County,3,8,3283,1723,1560
50,12,131,Florida,Walton County,3,9,3576,1921,1655
50,12,131,Florida,Walton County,3,10,3223,1665,1558
50,12,131,Florida,Walton County,3,11,3162,1613,1549
50,12,131,Florida,Walton County,3,12,2776,1352,1424
50,12,131,Florida,Walton County,3,13,2508,1254,1254
50,12,131,Florida,Walton County,3,14,2115,1059,1056
50,12,131,Florida,Walton County,3,15,1868,914,954
50,12,131,Florida,Walton County,3,16,1272,585,687
50,12,131,Florida,Walton County,3,17,743,316,427
50,12,131,Florida,Walton County,3,18,583,189,394
50,12,131,Florida,Walton County,3,99,42391,21754,20637
50,12,131,Florida,Walton County,4,0,533,289,244
50,12,131,Florida,Walton County,4,1,1925,984,941
50,12,131,Florida,Walton County,4,2,2521,1354,1167
50,12,131,Florida,Walton County,4,3,2766,1375,1391
50,12,131,Florida,Walton County,4,4,2560,1328,1232
50,12,131,Florida,Walton County,4,5,2317,1218,1099
50,12,131,Florida,Walton County,4,6,2497,1437,1060
50,12,131,Florida,Walton County,4,7,2766,1495,1271
50,12,131,Florida,Walton County,4,8,3253,1687,1566
50,12,131,Florida,Walton County,4,9,3674,2011,1663
50,12,131,Florida,Walton County,4,10,3413,1700,1713
50,12,131,Florida,Walton County,4,11,3235,1650,1585
50,12,131,Florida,Walton County,4,12,3032,1478,1554
50,12,131,Florida,Walton County,4,13,2677,1353,1324
50,12,131,Florida,Walton County,4,14,2216,1095,1121
50,12,131,Florida,Walton County,4,15,1846,925,921
50,12,131,Florida,Walton County,4,16,1337,587,750
50,12,131,Florida,Walton County,4,17,792,351,441
50,12,131,Florida,Walton County,4,18,575,183,392
50,12,131,Florida,Walton County,4,99,43935,22500,21435
50,12,131,Florida,Walton County,5,0,528,278,250
50,12,131,Florida,Walton County,5,1,2047,1055,992
50,12,131,Florida,Walton County,5,2,2491,1308,1183
50,12,131,Florida,Walton County,5,3,2920,1465,1455
50,12,131,Florida,Walton County,5,4,2639,1399,1240
50,12,131,Florida,Walton County,5,5,2414,1312,1102
50,12,131,Florida,Walton County,5,6,2549,1433,1116
50,12,131,Florida,Walton County,5,7,2925,1588,1337
50,12,131,Florida,Walton County,5,8,3277,1676,1601
50,12,131,Florida,Walton County,5,9,3819,2023,1796
50,12,131,Florida,Walton County,5,10,3558,1838,1720
50,12,131,Florida,Walton County,5,11,3318,1721,1597
50,12,131,Florida,Walton County,5,12,3331,1598,1733
50,12,131,Florida,Walton County,5,13,2843,1445,1398
50,12,131,Florida,Walton County,5,14,2277,1131,1146
50,12,131,Florida,Walton County,5,15,1851,937,914
50,12,131,Florida,Walton County,5,16,1367,593,774
50,12,131,Florida,Walton County,5,17,837,373,464
50,12,131,Florida,Walton County,5,18,587,187,400
50,12,131,Florida,Walton County,5,99,45578,23360,22218
50,12,131,Florida,Walton County,6,0,566,285,281
50,12,131,Florida,Walton County,6,1,2118,1100,1018
50,12,131,Florida,Walton County,6,2,2555,1333,1222
50,12,131,Florida,Walton County,6,3,3010,1524,1486
50,12,131,Florida,Walton County,6,4,2741,1441,1300
50,12,131,Florida,Walton County,6,5,2632,1440,1192
50,12,131,Florida,Walton County,6,6,2692,1479,1213
50,12,131,Florida,Walton County,6,7,3000,1650,1350
50,12,131,Florida,Walton County,6,8,3204,1684,1520
50,12,131,Florida,Walton County,6,9,4029,2118,1911
50,12,131,Florida,Walton County,6,10,3732,1941,1791
50,12,131,Florida,Walton County,6,11,3586,1829,1757
50,12,131,Florida,Walton County,6,12,3589,1727,1862
50,12,131,Florida,Walton County,6,13,3024,1502,1522
50,12,131,Florida,Walton County,6,14,2379,1189,1190
50,12,131,Florida,Walton County,6,15,1840,940,900
50,12,131,Florida,Walton County,6,16,1368,614,754
50,12,131,Florida,Walton County,6,17,850,361,489
50,12,131,Florida,Walton County,6,18,603,193,410
50,12,131,Florida,Walton County,6,99,47518,24350,23168
50,12,131,Florida,Walton County,7,0,616,332,284
50,12,131,Florida,Walton County,7,1,2175,1124,1051
50,12,131,Florida,Walton County,7,2,2683,1380,1303
50,12,131,Florida,Walton County,7,3,3038,1547,1491
50,12,131,Florida,Walton County,7,4,2884,1525,1359
50,12,131,Florida,Walton County,7,5,2690,1427,1263
50,12,131,Florida,Walton County,7,6,2943,1635,1308
50,12,131,Florida,Walton County,7,7,3085,1641,1444
50,12,131,Florida,Walton County,7,8,3262,1751,1511
50,12,131,Florida,Walton County,7,9,4009,2089,1920
50,12,131,Florida,Walton County,7,10,3979,2070,1909
50,12,131,Florida,Walton County,7,11,3784,1900,1884
50,12,131,Florida,Walton County,7,12,3711,1824,1887
50,12,131,Florida,Walton County,7,13,3235,1605,1630
50,12,131,Florida,Walton County,7,14,2474,1231,1243
50,12,131,Florida,Walton County,7,15,1836,948,888
50,12,131,Florida,Walton County,7,16,1480,660,820
50,12,131,Florida,Walton County,7,17,877,372,505
50,12,131,Florida,Walton County,7,18,631,212,419
50,12,131,Florida,Walton County,7,99,49392,25273,24119
50,12,131,Florida,Walton County,8,0,702,394,308
50,12,131,Florida,Walton County,8,1,2297,1174,1123
50,12,131,Florida,Walton County,8,2,2870,1477,1393
50,12,131,Florida,Walton County,8,3,2940,1498,1442
50,12,131,Florida,Walton County,8,4,3029,1584,1445
50,12,131,Florida,Walton County,8,5,2728,1440,1288
50,12,131,Florida,Walton County,8,6,3184,1759,1425
50,12,131,Florida,Walton County,8,7,3039,1643,1396
50,12,131,Florida,Walton County,8,8,3395,1836,1559
50,12,131,Florida,Walton County,8,9,3925,2025,1900
50,12,131,Florida,Walton County,8,10,4204,2190,2014
50,12,131,Florida,Walton County,8,11,3987,1963,2024
50,12,131,Florida,Walton County,8,12,3842,1921,1921
50,12,131,Florida,Walton County,8,13,3386,1659,1727
50,12,131,Florida,Walton County,8,14,2541,1271,1270
50,12,131,Florida,Walton County,8,15,1959,990,969
50,12,131,Florida,Walton County,8,16,1505,709,796
50,12,131,Florida,Walton County,8,17,907,354,553
50,12,131,Florida,Walton County,8,18,705,239,466
50,12,131,Florida,Walton County,8,99,51145,26126,25019
50,12,131,Florida,Walton County,9,0,722,405,317
50,12,131,Florida,Walton County,9,1,2411,1221,1190
50,12,131,Florida,Walton County,9,2,3042,1523,1519
50,12,131,Florida,Walton County,9,3,2963,1586,1377
50,12,131,Florida,Walton County,9,4,3023,1593,1430
50,12,131,Florida,Walton County,9,5,2753,1452,1301
50,12,131,Florida,Walton County,9,6,3448,1906,1542
50,12,131,Florida,Walton County,9,7,2977,1646,1331
50,12,131,Florida,Walton County,9,8,3475,1889,1586
50,12,131,Florida,Walton County,9,9,3864,1987,1877
50,12,131,Florida,Walton County,9,10,4234,2239,1995
50,12,131,Florida,Walton County,9,11,4145,2019,2126
50,12,131,Florida,Walton County,9,12,3853,1905,1948
50,12,131,Florida,Walton County,9,13,3534,1717,1817
50,12,131,Florida,Walton County,9,14,2694,1339,1355
50,12,131,Florida,Walton County,9,15,2061,1036,1025
50,12,131,Florida,Walton County,9,16,1475,700,775
50,12,131,Florida,Walton County,9,17,924,356,568
50,12,131,Florida,Walton County,9,18,757,261,496
50,12,131,Florida,Walton County,9,99,52355,26780,25575
50,12,131,Florida,Walton County,10,0,772,413,359
50,12,131,Florida,Walton County,10,1,2530,1320,1210
50,12,131,Florida,Walton County,10,2,3092,1534,1558
50,12,131,Florida,Walton County,10,3,2877,1514,1363
50,12,131,Florida,Walton County,10,4,3069,1614,1455
50,12,131,Florida,Walton County,10,5,2778,1458,1320
50,12,131,Florida,Walton County,10,6,3537,1963,1574
50,12,131,Florida,Walton County,10,7,3071,1673,1398
50,12,131,Florida,Walton County,10,8,3529,1938,1591
50,12,131,Florida,Walton County,10,9,3785,1930,1855
50,12,131,Florida,Walton County,10,10,4359,2249,2110
50,12,131,Florida,Walton County,10,11,4202,2083,2119
50,12,131,Florida,Walton County,10,12,3839,1908,1931
50,12,131,Florida,Walton County,10,13,3754,1829,1925
50,12,131,Florida,Walton County,10,14,2892,1430,1462
50,12,131,Florida,Walton County,10,15,2193,1072,1121
50,12,131,Florida,Walton County,10,16,1496,724,772
50,12,131,Florida,Walton County,10,17,981,389,592
50,12,131,Florida,Walton County,10,18,807,291,516
50,12,131,Florida,Walton County,10,99,53563,27332,26231
50,12,131,Florida,Walton County,11,0,714,386,328
50,12,131,Florida,Walton County,11,1,2726,1417,1309
50,12,131,Florida,Walton County,11,2,3116,1553,1563
50,12,131,Florida,Walton County,11,3,2923,1551,1372
50,12,131,Florida,Walton County,11,4,3151,1677,1474
50,12,131,Florida,Walton County,11,5,2843,1503,1340
50,12,131,Florida,Walton County,11,6,3571,2000,1571
50,12,131,Florida,Walton County,11,7,3203,1750,1453
50,12,131,Florida,Walton County,11,8,3533,1936,1597
50,12,131,Florida,Walton County,11,9,3561,1876,1685
50,12,131,Florida,Walton County,11,10,4365,2211,2154
50,12,131,Florida,Walton County,11,11,4331,2166,2165
50,12,131,Florida,Walton County,11,12,3935,1971,1964
50,12,131,Florida,Walton County,11,13,3862,1887,1975
50,12,131,Florida,Walton County,11,14,3028,1502,1526
50,12,131,Florida,Walton County,11,15,2248,1079,1169
50,12,131,Florida,Walton County,11,16,1545,746,799
50,12,131,Florida,Walton County,11,17,1037,413,624
50,12,131,Florida,Walton County,11,18,842,302,540
50,12,131,Florida,Walton County,11,99,54534,27926,26608
50,12,131,Florida,Walton County,12,0,652,361,291
50,12,131,Florida,Walton County,12,1,2703,1410,1293
50,12,131,Florida,Walton County,12,2,3159,1556,1603
50,12,131,Florida,Walton County,12,3,2916,1521,1395
50,12,131,Florida,Walton County,12,4,3124,1686,1438
50,12,131,Florida,Walton County,12,5,2945,1567,1378
50,12,131,Florida,Walton County,12,6,3556,1977,1579
50,12,131,Florida,Walton County,12,7,3382,1851,1531
50,12,131,Florida,Walton County,12,8,3574,1935,1639
50,12,131,Florida,Walton County,12,9,3542,1885,1657
50,12,131,Florida,Walton County,12,10,4294,2187,2107
50,12,131,Florida,Walton County,12,11,4420,2207,2213
50,12,131,Florida,Walton County,12,12,3967,1956,2011
50,12,131,Florida,Walton County,12,13,3866,1894,1972
50,12,131,Florida,Walton County,12,14,3154,1579,1575
50,12,131,Florida,Walton County,12,15,2304,1102,1202
50,12,131,Florida,Walton County,12,16,1567,749,818
50,12,131,Florida,Walton County,12,17,1063,449,614
50,12,131,Florida,Walton County,12,18,855,305,550
50,12,131,Florida,Walton County,12,99,55043,28177,26866
50,12,131,Florida,Walton County,13,0,656,363,293
50,12,131,Florida,Walton County,13,1,2704,1409,1295
50,12,131,Florida,Walton County,13,2,3172,1562,1610
50,12,131,Florida,Walton County,13,3,2925,1526,1399
50,12,131,Florida,Walton County,13,4,3108,1682,1426
50,12,131,Florida,Walton County,13,5,2964,1576,1388
50,12,131,Florida,Walton County,13,6,3575,1992,1583
50,12,131,Florida,Walton County,13,7,3411,1863,1548
50,12,131,Florida,Walton County,13,8,3553,1922,1631
50,12,131,Florida,Walton County,13,9,3549,1891,1658
50,12,131,Florida,Walton County,13,10,4282,2178,2104
50,12,131,Florida,Walton County,13,11,4438,2217,2221
50,12,131,Florida,Walton County,13,12,4003,1974,2029
50,12,131,Florida,Walton County,13,13,3906,1913,1993
50,12,131,Florida,Walton County,13,14,3174,1589,1585
50,12,131,Florida,Walton County,13,15,2322,1112,1210
50,12,131,Florida,Walton County,13,16,1566,750,816
50,12,131,Florida,Walton County,13,17,1063,451,612
50,12,131,Florida,Walton County,13,18,862,308,554
50,12,131,Florida,Walton County,13,99,55233,28278,26955
50,12,133,Florida,Washington County,1,0,230,133,97
50,12,133,Florida,Washington County,1,1,1036,525,511
50,12,133,Florida,Washington County,1,2,1339,664,675
50,12,133,Florida,Washington County,1,3,1380,737,643
50,12,133,Florida,Washington County,1,4,1400,727,673
50,12,133,Florida,Washington County,1,5,1137,623,514
50,12,133,Florida,Washington County,1,6,1262,710,552
50,12,133,Florida,Washington County,1,7,1489,857,632
50,12,133,Florida,Washington County,1,8,1604,869,735
50,12,133,Florida,Washington County,1,9,1636,875,761
50,12,133,Florida,Washington County,1,10,1387,742,645
50,12,133,Florida,Washington County,1,11,1428,743,685
50,12,133,Florida,Washington County,1,12,1283,595,688
50,12,133,Florida,Washington County,1,13,1072,539,533
50,12,133,Florida,Washington County,1,14,968,474,494
50,12,133,Florida,Washington County,1,15,790,362,428
50,12,133,Florida,Washington County,1,16,644,284,360
50,12,133,Florida,Washington County,1,17,467,187,280
50,12,133,Florida,Washington County,1,18,423,141,282
50,12,133,Florida,Washington County,1,99,20975,10787,10188
50,12,133,Florida,Washington County,2,0,235,136,99
50,12,133,Florida,Washington County,2,1,1037,523,514
50,12,133,Florida,Washington County,2,2,1336,665,671
50,12,133,Florida,Washington County,2,3,1383,737,646
50,12,133,Florida,Washington County,2,4,1405,707,698
50,12,133,Florida,Washington County,2,5,1153,631,522
50,12,133,Florida,Washington County,2,6,1257,707,550
50,12,133,Florida,Washington County,2,7,1490,858,632
50,12,133,Florida,Washington County,2,8,1601,866,735
50,12,133,Florida,Washington County,2,9,1640,877,763
50,12,133,Florida,Washington County,2,10,1395,746,649
50,12,133,Florida,Washington County,2,11,1449,755,694
50,12,133,Florida,Washington County,2,12,1293,599,694
50,12,133,Florida,Washington County,2,13,1077,542,535
50,12,133,Florida,Washington County,2,14,959,470,489
50,12,133,Florida,Washington County,2,15,786,360,426
50,12,133,Florida,Washington County,2,16,641,283,358
50,12,133,Florida,Washington County,2,17,469,187,282
50,12,133,Florida,Washington County,2,18,417,139,278
50,12,133,Florida,Washington County,2,99,21023,10788,10235
50,12,133,Florida,Washington County,3,0,227,117,110
50,12,133,Florida,Washington County,3,1,1029,544,485
50,12,133,Florida,Washington County,3,2,1346,672,674
50,12,133,Florida,Washington County,3,3,1411,742,669
50,12,133,Florida,Washington County,3,4,1428,719,709
50,12,133,Florida,Washington County,3,5,1170,660,510
50,12,133,Florida,Washington County,3,6,1229,702,527
50,12,133,Florida,Washington County,3,7,1468,819,649
50,12,133,Florida,Washington County,3,8,1671,931,740
50,12,133,Florida,Washington County,3,9,1650,874,776
50,12,133,Florida,Washington County,3,10,1497,811,686
50,12,133,Florida,Washington County,3,11,1521,796,725
50,12,133,Florida,Washington County,3,12,1343,622,721
50,12,133,Florida,Washington County,3,13,1079,542,537
50,12,133,Florida,Washington County,3,14,980,472,508
50,12,133,Florida,Washington County,3,15,770,371,399
50,12,133,Florida,Washington County,3,16,639,284,355
50,12,133,Florida,Washington County,3,17,437,182,255
50,12,133,Florida,Washington County,3,18,421,143,278
50,12,133,Florida,Washington County,3,99,21316,11003,10313
50,12,133,Florida,Washington County,4,0,216,116,100
50,12,133,Florida,Washington County,4,1,973,509,464
50,12,133,Florida,Washington County,4,2,1337,689,648
50,12,133,Florida,Washington County,4,3,1429,740,689
50,12,133,Florida,Washington County,4,4,1417,718,699
50,12,133,Florida,Washington County,4,5,1156,657,499
50,12,133,Florida,Washington County,4,6,1216,692,524
50,12,133,Florida,Washington County,4,7,1434,804,630
50,12,133,Florida,Washington County,4,8,1628,894,734
50,12,133,Florida,Washington County,4,9,1683,903,780
50,12,133,Florida,Washington County,4,10,1532,832,700
50,12,133,Florida,Washington County,4,11,1462,749,713
50,12,133,Florida,Washington County,4,12,1458,726,732
50,12,133,Florida,Washington County,4,13,1111,536,575
50,12,133,Florida,Washington County,4,14,963,465,498
50,12,133,Florida,Washington County,4,15,779,395,384
50,12,133,Florida,Washington County,4,16,630,274,356
50,12,133,Florida,Washington County,4,17,460,185,275
50,12,133,Florida,Washington County,4,18,403,138,265
50,12,133,Florida,Washington County,4,99,21287,11022,10265
50,12,133,Florida,Washington County,5,0,242,136,106
50,12,133,Florida,Washington County,5,1,945,486,459
50,12,133,Florida,Washington County,5,2,1315,695,620
50,12,133,Florida,Washington County,5,3,1446,736,710
50,12,133,Florida,Washington County,5,4,1397,729,668
50,12,133,Florida,Washington County,5,5,1191,686,505
50,12,133,Florida,Washington County,5,6,1235,707,528
50,12,133,Florida,Washington County,5,7,1416,797,619
50,12,133,Florida,Washington County,5,8,1582,859,723
50,12,133,Florida,Washington County,5,9,1717,951,766
50,12,133,Florida,Washington County,5,10,1622,844,778
50,12,133,Florida,Washington County,5,11,1485,762,723
50,12,133,Florida,Washington County,5,12,1499,746,753
50,12,133,Florida,Washington County,5,13,1205,577,628
50,12,133,Florida,Washington County,5,14,970,479,491
50,12,133,Florida,Washington County,5,15,810,412,398
50,12,133,Florida,Washington County,5,16,626,267,359
50,12,133,Florida,Washington County,5,17,454,185,269
50,12,133,Florida,Washington County,5,18,380,118,262
50,12,133,Florida,Washington County,5,99,21537,11172,10365
50,12,133,Florida,Washington County,6,0,267,157,110
50,12,133,Florida,Washington County,6,1,982,528,454
50,12,133,Florida,Washington County,6,2,1351,692,659
50,12,133,Florida,Washington County,6,3,1463,763,700
50,12,133,Florida,Washington County,6,4,1398,751,647
50,12,133,Florida,Washington County,6,5,1264,736,528
50,12,133,Florida,Washington County,6,6,1263,737,526
50,12,133,Florida,Washington County,6,7,1426,817,609
50,12,133,Florida,Washington County,6,8,1613,869,744
50,12,133,Florida,Washington County,6,9,1747,972,775
50,12,133,Florida,Washington County,6,10,1631,859,772
50,12,133,Florida,Washington County,6,11,1451,759,692
50,12,133,Florida,Washington County,6,12,1582,778,804
50,12,133,Florida,Washington County,6,13,1266,617,649
50,12,133,Florida,Washington County,6,14,1012,492,520
50,12,133,Florida,Washington County,6,15,831,403,428
50,12,133,Florida,Washington County,6,16,610,274,336
50,12,133,Florida,Washington County,6,17,435,183,252
50,12,133,Florida,Washington County,6,18,375,114,261
50,12,133,Florida,Washington County,6,99,21967,11501,10466
50,12,133,Florida,Washington County,7,0,254,125,129
50,12,133,Florida,Washington County,7,1,1013,546,467
50,12,133,Florida,Washington County,7,2,1365,713,652
50,12,133,Florida,Washington County,7,3,1454,752,702
50,12,133,Florida,Washington County,7,4,1440,762,678
50,12,133,Florida,Washington County,7,5,1246,715,531
50,12,133,Florida,Washington County,7,6,1327,792,535
50,12,133,Florida,Washington County,7,7,1377,786,591
50,12,133,Florida,Washington County,7,8,1616,891,725
50,12,133,Florida,Washington County,7,9,1692,913,779
50,12,133,Florida,Washington County,7,10,1719,937,782
50,12,133,Florida,Washington County,7,11,1512,783,729
50,12,133,Florida,Washington County,7,12,1587,808,779
50,12,133,Florida,Washington County,7,13,1347,640,707
50,12,133,Florida,Washington County,7,14,1058,523,535
50,12,133,Florida,Washington County,7,15,799,395,404
50,12,133,Florida,Washington County,7,16,601,277,324
50,12,133,Florida,Washington County,7,17,441,186,255
50,12,133,Florida,Washington County,7,18,368,112,256
50,12,133,Florida,Washington County,7,99,22216,11656,10560
50,12,133,Florida,Washington County,8,0,267,142,125
50,12,133,Florida,Washington County,8,1,1028,523,505
50,12,133,Florida,Washington County,8,2,1364,718,646
50,12,133,Florida,Washington County,8,3,1490,756,734
50,12,133,Florida,Washington County,8,4,1492,812,680
50,12,133,Florida,Washington County,8,5,1283,739,544
50,12,133,Florida,Washington County,8,6,1358,799,559
50,12,133,Florida,Washington County,8,7,1374,802,572
50,12,133,Florida,Washington County,8,8,1609,867,742
50,12,133,Florida,Washington County,8,9,1713,940,773
50,12,133,Florida,Washington County,8,10,1790,929,861
50,12,133,Florida,Washington County,8,11,1620,857,763
50,12,133,Florida,Washington County,8,12,1644,837,807
50,12,133,Florida,Washington County,8,13,1395,655,740
50,12,133,Florida,Washington County,8,14,1114,575,539
50,12,133,Florida,Washington County,8,15,851,410,441
50,12,133,Florida,Washington County,8,16,631,301,330
50,12,133,Florida,Washington County,8,17,479,195,284
50,12,133,Florida,Washington County,8,18,358,111,247
50,12,133,Florida,Washington County,8,99,22860,11968,10892
50,12,133,Florida,Washington County,9,0,277,151,126
50,12,133,Florida,Washington County,9,1,1066,539,527
50,12,133,Florida,Washington County,9,2,1400,741,659
50,12,133,Florida,Washington County,9,3,1502,770,732
50,12,133,Florida,Washington County,9,4,1521,822,699
50,12,133,Florida,Washington County,9,5,1380,806,574
50,12,133,Florida,Washington County,9,6,1385,834,551
50,12,133,Florida,Washington County,9,7,1454,839,615
50,12,133,Florida,Washington County,9,8,1610,883,727
50,12,133,Florida,Washington County,9,9,1721,955,766
50,12,133,Florida,Washington County,9,10,1824,977,847
50,12,133,Florida,Washington County,9,11,1708,901,807
50,12,133,Florida,Washington County,9,12,1594,791,803
50,12,133,Florida,Washington County,9,13,1476,748,728
50,12,133,Florida,Washington County,9,14,1186,586,600
50,12,133,Florida,Washington County,9,15,865,416,449
50,12,133,Florida,Washington County,9,16,639,332,307
50,12,133,Florida,Washington County,9,17,494,203,291
50,12,133,Florida,Washington County,9,18,367,119,248
50,12,133,Florida,Washington County,9,99,23469,12413,11056
50,12,133,Florida,Washington County,10,0,302,161,141
50,12,133,Florida,Washington County,10,1,1157,581,576
50,12,133,Florida,Washington County,10,2,1439,792,647
50,12,133,Florida,Washington County,10,3,1495,792,703
50,12,133,Florida,Washington County,10,4,1585,847,738
50,12,133,Florida,Washington County,10,5,1487,913,574
50,12,133,Florida,Washington County,10,6,1580,1008,572
50,12,133,Florida,Washington County,10,7,1615,996,619
50,12,133,Florida,Washington County,10,8,1753,1013,740
50,12,133,Florida,Washington County,10,9,1750,1011,739
50,12,133,Florida,Washington County,10,10,1939,1115,824
50,12,133,Florida,Washington County,10,11,1802,937,865
50,12,133,Florida,Washington County,10,12,1619,815,804
50,12,133,Florida,Washington County,10,13,1514,756,758
50,12,133,Florida,Washington County,10,14,1281,621,660
50,12,133,Florida,Washington County,10,15,873,449,424
50,12,133,Florida,Washington County,10,16,656,322,334
50,12,133,Florida,Washington County,10,17,483,192,291
50,12,133,Florida,Washington County,10,18,376,122,254
50,12,133,Florida,Washington County,10,99,24706,13443,11263
50,12,133,Florida,Washington County,11,0,287,159,128
50,12,133,Florida,Washington County,11,1,1188,566,622
50,12,133,Florida,Washington County,11,2,1401,777,624
50,12,133,Florida,Washington County,11,3,1504,786,718
50,12,133,Florida,Washington County,11,4,1583,866,717
50,12,133,Florida,Washington County,11,5,1490,913,577
50,12,133,Florida,Washington County,11,6,1529,970,559
50,12,133,Florida,Washington County,11,7,1610,1003,607
50,12,133,Florida,Washington County,11,8,1716,1004,712
50,12,133,Florida,Washington County,11,9,1732,1005,727
50,12,133,Florida,Washington County,11,10,1951,1094,857
50,12,133,Florida,Washington County,11,11,1819,968,851
50,12,133,Florida,Washington County,11,12,1612,827,785
50,12,133,Florida,Washington County,11,13,1525,734,791
50,12,133,Florida,Washington County,11,14,1323,653,670
50,12,133,Florida,Washington County,11,15,937,489,448
50,12,133,Florida,Washington County,11,16,652,317,335
50,12,133,Florida,Washington County,11,17,462,201,261
50,12,133,Florida,Washington County,11,18,372,117,255
50,12,133,Florida,Washington County,11,99,24693,13449,11244
50,12,133,Florida,Washington County,12,0,263,147,116
50,12,133,Florida,Washington County,12,1,1181,559,622
50,12,133,Florida,Washington County,12,2,1404,764,640
50,12,133,Florida,Washington County,12,3,1465,771,694
50,12,133,Florida,Washington County,12,4,1596,862,734
50,12,133,Florida,Washington County,12,5,1528,936,592
50,12,133,Florida,Washington County,12,6,1544,989,555
50,12,133,Florida,Washington County,12,7,1665,1038,627
50,12,133,Florida,Washington County,12,8,1693,993,700
50,12,133,Florida,Washington County,12,9,1781,1067,714
50,12,133,Florida,Washington County,12,10,1927,1079,848
50,12,133,Florida,Washington County,12,11,1893,1014,879
50,12,133,Florida,Washington County,12,12,1603,823,780
50,12,133,Florida,Washington County,12,13,1526,750,776
50,12,133,Florida,Washington County,12,14,1369,651,718
50,12,133,Florida,Washington County,12,15,959,495,464
50,12,133,Florida,Washington County,12,16,682,325,357
50,12,133,Florida,Washington County,12,17,442,190,252
50,12,133,Florida,Washington County,12,18,375,122,253
50,12,133,Florida,Washington County,12,99,24896,13575,11321
50,12,133,Florida,Washington County,13,0,261,144,117
50,12,133,Florida,Washington County,13,1,1177,555,622
50,12,133,Florida,Washington County,13,2,1400,758,642
50,12,133,Florida,Washington County,13,3,1467,772,695
50,12,133,Florida,Washington County,13,4,1568,850,718
50,12,133,Florida,Washington County,13,5,1532,939,593
50,12,133,Florida,Washington County,13,6,1558,1002,556
50,12,133,Florida,Washington County,13,7,1684,1047,637
50,12,133,Florida,Washington County,13,8,1681,989,692
50,12,133,Florida,Washington County,13,9,1776,1066,710
50,12,133,Florida,Washington County,13,10,1918,1074,844
50,12,133,Florida,Washington County,13,11,1895,1014,881
50,12,133,Florida,Washington County,13,12,1611,827,784
50,12,133,Florida,Washington County,13,13,1537,754,783
50,12,133,Florida,Washington County,13,14,1372,652,720
50,12,133,Florida,Washington County,13,15,962,498,464
50,12,133,Florida,Washington County,13,16,681,326,355
50,12,133,Florida,Washington County,13,17,442,191,251
50,12,133,Florida,Washington County,13,18,377,122,255
50,12,133,Florida,Washington County,13,99,24899,13580,11319
