STNAME,CTYNAME,YEAR,AGEGRP,TOT_POP,TOT_MALE,TOT_FEMALE
California,Alameda County,1,0,1510271,740573,769698
California,Alameda County,1,1,97652,50259,47393
California,Alameda County,1,2,94546,48145,46401
California,Alameda County,1,3,91070,46403,44667
California,Alameda County,1,4,100394,51445,48949
California,Alameda County,1,5,107049,54515,52534
California,Alameda County,1,6,113597,56185,57412
California,Alameda County,1,7,114607,56256,58351
California,Alameda County,1,8,115275,57062,58213
California,Alameda County,1,9,112216,55959,56257
California,Alameda County,1,10,114111,56168,57943
California,Alameda County,1,11,108506,53431,55075
California,Alameda County,1,12,94648,45580,49068
California,Alameda County,1,13,78854,37509,41345
California,Alameda County,1,14,52663,24568,28095
California,Alameda County,1,15,37774,17060,20714
California,Alameda County,1,16,29185,12617,16568
California,Alameda County,1,17,23391,9144,14247
California,Alameda County,1,18,24733,8267,16466
California,Alameda County,2,0,1510258,740568,769690
California,Alameda County,2,1,97650,50257,47393
California,Alameda County,2,2,94546,48145,46401
California,Alameda County,2,3,91070,46403,44667
California,Alameda County,2,4,100394,51445,48949
California,Alameda County,2,5,107047,54515,52532
California,Alameda County,2,6,113597,56185,57412
California,Alameda County,2,7,114607,56257,58350
California,Alameda County,2,8,115273,57061,58212
California,Alameda County,2,9,112216,55959,56257
California,Alameda County,2,10,114109,56167,57942
California,Alameda County,2,11,108502,53429,55073
California,Alameda County,2,12,94648,45580,49068
California,Alameda County,2,13,78852,37508,41344
California,Alameda County,2,14,52663,24568,28095
California,Alameda County,2,15,37775,17061,20714
California,Alameda County,2,16,29185,12617,16568
California,Alameda County,2,17,23391,9144,14247
California,Alameda County,2,18,24733,8267,16466
California,Alameda County,3,0,1513043,741781,771262
California,Alameda County,3,1,97655,50199,47456
California,Alameda County,3,2,94489,48153,46336
California,Alameda County,3,3,90982,46397,44585
California,Alameda County,3,4,99688,51061,48627
California,Alameda County,3,5,107533,54588,52945
California,Alameda County,3,6,113583,56249,57334
California,Alameda County,3,7,114823,56343,58480
California,Alameda County,3,8,114915,56858,58057
California,Alameda County,3,9,112615,56145,56470
California,Alameda County,3,10,113883,56110,57773
California,Alameda County,3,11,108877,53600,55277
California,Alameda County,3,12,95306,45956,49350
California,Alameda County,3,13,79700,37861,41839
California,Alameda County,3,14,53354,24902,28452
California,Alameda County,3,15,38074,17205,20869
California,Alameda County,3,16,29245,12650,16595
California,Alameda County,3,17,23343,9172,14171
California,Alameda County,3,18,24978,8332,16646
California,Alameda County,4,0,1530998,750148,780850
California,Alameda County,4,1,97781,50118,47663
California,Alameda County,4,2,95086,48564,46522
California,Alameda County,4,3,91096,46531,44565
California,Alameda County,4,4,97330,49765,47565
California,Alameda County,4,5,109976,55349,54627
California,Alameda County,4,6,114834,57104,57730
California,Alameda County,4,7,117143,57521,59622
California,Alameda County,4,8,113929,56335,57594
California,Alameda County,4,9,114489,57023,57466
California,Alameda County,4,10,112975,55784,57191
California,Alameda County,4,11,110396,54269,56127
California,Alameda County,4,12,97843,47351,50492
California,Alameda County,4,13,83640,39562,44078
California,Alameda County,4,14,56104,26291,29813
California,Alameda County,4,15,39327,17700,21627
California,Alameda County,4,16,29806,12915,16891
California,Alameda County,4,17,23207,9240,13967
California,Alameda County,4,18,26036,8726,17310
California,Alameda County,5,0,1554138,760910,793228
California,Alameda County,5,1,97503,49849,47654
California,Alameda County,5,2,96701,49447,47254
California,Alameda County,5,3,91314,46638,44676
California,Alameda County,5,4,96365,49065,47300
California,Alameda County,5,5,110721,55706,55015
California,Alameda County,5,6,117114,58207,58907
California,Alameda County,5,7,121049,59388,61661
California,Alameda County,5,8,114918,56633,58285
California,Alameda County,5,9,116501,57946,58555
California,Alameda County,5,10,111786,55338,56448
California,Alameda County,5,11,111603,54811,56792
California,Alameda County,5,12,100490,48701,51789
California,Alameda County,5,13,84845,40129,44716
California,Alameda County,5,14,61763,28947,32816
California,Alameda County,5,15,40995,18469,22526
California,Alameda County,5,16,30371,13148,17223
California,Alameda County,5,17,23262,9363,13899
California,Alameda County,5,18,26837,9125,17712
California,Alameda County,6,0,1580247,774012,806235
California,Alameda County,6,1,97356,49802,47554
California,Alameda County,6,2,98218,50386,47832
California,Alameda County,6,3,92259,47093,45166
California,Alameda County,6,4,95483,48355,47128
California,Alameda County,6,5,110230,55293,54937
California,Alameda County,6,6,121521,60665,60856
California,Alameda County,6,7,125876,61893,63983
California,Alameda County,6,8,116705,57675,59030
California,Alameda County,6,9,117566,58263,59303
California,Alameda County,6,10,110885,55188,55697
California,Alameda County,6,11,112808,55280,57528
California,Alameda County,6,12,103126,50193,52933
California,Alameda County,6,13,86669,40865,45804
California,Alameda County,6,14,65874,30788,35086
California,Alameda County,6,15,43412,19743,23669
California,Alameda County,6,16,31292,13584,17708
California,Alameda County,6,17,23425,9525,13900
California,Alameda County,6,18,27542,9421,18121
California,Alameda County,7,0,1608674,788148,820526
California,Alameda County,7,1,97822,49996,47826
California,Alameda County,7,2,98701,50605,48096
California,Alameda County,7,3,93605,47576,46029
California,Alameda County,7,4,94534,47750,46784
California,Alameda County,7,5,108802,54637,54165
California,Alameda County,7,6,128016,63979,64037
California,Alameda County,7,7,130381,64118,66263
California,Alameda County,7,8,119678,59466,60212
California,Alameda County,7,9,118209,58467,59742
California,Alameda County,7,10,110697,55264,55433
California,Alameda County,7,11,114043,55864,58179
California,Alameda County,7,12,105108,51221,53887
California,Alameda County,7,13,88840,42065,46775
California,Alameda County,7,14,69879,32591,37288
California,Alameda County,7,15,45799,20901,24898
California,Alameda County,7,16,32497,14231,18266
California,Alameda County,7,17,23825,9717,14108
California,Alameda County,7,18,28238,9700,18538
California,Alameda County,8,0,1634634,801667,832967
California,Alameda County,8,1,98179,50205,47974
California,Alameda County,8,2,99065,50598,48467
California,Alameda County,8,3,94235,48033,46202
California,Alameda County,8,4,94102,47406,46696
California,Alameda County,8,5,105887,53270,52617
California,Alameda County,8,6,134291,67180,67111
California,Alameda County,8,7,134294,66418,67876
California,Alameda County,8,8,124120,61878,62242
California,Alameda County,8,9,117688,58262,59426
California,Alameda County,8,10,112720,56214,56506
California,Alameda County,8,11,113200,55622,57578
California,Alameda County,8,12,106884,52118,54766
California,Alameda County,8,13,91166,43413,47753
California,Alameda County,8,14,73754,34294,39460
California,Alameda County,8,15,48318,22000,26318
California,Alameda County,8,16,33639,14815,18824
California,Alameda County,8,17,24218,9990,14228
California,Alameda County,8,18,28874,9951,18923
California,Alameda County,9,0,1650306,810551,839755
California,Alameda County,9,1,97649,50089,47560
California,Alameda County,9,2,98305,50169,48136
California,Alameda County,9,3,94398,48225,46173
California,Alameda County,9,4,93828,47298,46530
California,Alameda County,9,5,103175,51885,51290
California,Alameda County,9,6,138220,69241,68979
California,Alameda County,9,7,137426,68387,69039
California,Alameda County,9,8,127608,63648,63960
California,Alameda County,9,9,116785,57963,58822
California,Alameda County,9,10,114270,57062,57208
California,Alameda County,9,11,111483,54960,56523
California,Alameda County,9,12,107526,52399,55127
California,Alameda County,9,13,93119,44619,48500
California,Alameda County,9,14,76786,35525,41261
California,Alameda County,9,15,50814,23231,27583
California,Alameda County,9,16,34638,15253,19385
California,Alameda County,9,17,24798,10318,14480
California,Alameda County,9,18,29478,10279,19199
California,Alameda County,10,0,1658131,815264,842867
California,Alameda County,10,1,97201,49917,47284
California,Alameda County,10,2,96760,49369,47391
California,Alameda County,10,3,95217,48738,46479
California,Alameda County,10,4,93350,47128,46222
California,Alameda County,10,5,101161,50761,50400
California,Alameda County,10,6,138584,69712,68872
California,Alameda County,10,7,138906,69492,69414
California,Alameda County,10,8,130826,65275,65551
California,Alameda County,10,9,116692,57956,58736
California,Alameda County,10,10,114926,57317,57609
California,Alameda County,10,11,109044,53976,55068
California,Alameda County,10,12,107495,52437,55058
California,Alameda County,10,13,94451,45396,49055
California,Alameda County,10,14,77189,35715,41474
California,Alameda County,10,15,55150,25195,29955
California,Alameda County,10,16,36014,15826,20188
California,Alameda County,10,17,25168,10539,14629
California,Alameda County,10,18,29997,10515,19482
California,Alameda County,11,0,1666753,820045,846708
California,Alameda County,11,1,96716,49506,47210
California,Alameda County,11,2,95425,48711,46714
California,Alameda County,11,3,95370,48947,46423
California,Alameda County,11,4,93570,47278,46292
California,Alameda County,11,5,99446,49656,49790
California,Alameda County,11,6,137553,69291,68262
California,Alameda County,11,7,141644,71053,70591
California,Alameda County,11,8,134126,67278,66848
California,Alameda County,11,9,117048,58217,58831
California,Alameda County,11,10,115151,57304,57847
California,Alameda County,11,11,107012,53257,53755
California,Alameda County,11,12,107380,52314,55066
California,Alameda County,11,13,95802,46151,49651
California,Alameda County,11,14,78175,36178,41997
California,Alameda County,11,15,58232,26577,31655
California,Alameda County,11,16,37876,16738,21138
California,Alameda County,11,17,25807,10825,14982
California,Alameda County,11,18,30420,10764,19656
California,Alpine County,1,0,1175,606,569
California,Alpine County,1,1,71,40,31
California,Alpine County,1,2,80,36,44
California,Alpine County,1,3,69,26,43
California,Alpine County,1,4,55,29,26
California,Alpine County,1,5,51,31,20
California,Alpine County,1,6,50,22,28
California,Alpine County,1,7,47,20,27
California,Alpine County,1,8,54,34,20
California,Alpine County,1,9,82,40,42
California,Alpine County,1,10,102,52,50
California,Alpine County,1,11,113,59,54
California,Alpine County,1,12,125,70,55
California,Alpine County,1,13,110,57,53
California,Alpine County,1,14,65,37,28
California,Alpine County,1,15,44,20,24
California,Alpine County,1,16,31,21,10
California,Alpine County,1,17,20,8,12
California,Alpine County,1,18,6,4,2
California,Alpine County,2,0,1175,606,569
California,Alpine County,2,1,71,40,31
California,Alpine County,2,2,80,36,44
California,Alpine County,2,3,69,26,43
California,Alpine County,2,4,55,29,26
California,Alpine County,2,5,51,31,20
California,Alpine County,2,6,50,22,28
California,Alpine County,2,7,47,20,27
California,Alpine County,2,8,54,34,20
California,Alpine County,2,9,82,40,42
California,Alpine County,2,10,102,52,50
California,Alpine County,2,11,113,59,54
California,Alpine County,2,12,125,70,55
California,Alpine County,2,13,110,57,53
California,Alpine County,2,14,65,37,28
California,Alpine County,2,15,44,20,24
California,Alpine County,2,16,31,21,10
California,Alpine County,2,17,20,8,12
California,Alpine County,2,18,6,4,2
California,Alpine County,3,0,1161,599,562
California,Alpine County,3,1,69,39,30
California,Alpine County,3,2,82,38,44
California,Alpine County,3,3,67,25,42
California,Alpine County,3,4,55,28,27
California,Alpine County,3,5,51,31,20
California,Alpine County,3,6,48,21,27
California,Alpine County,3,7,48,22,26
California,Alpine County,3,8,51,31,20
California,Alpine County,3,9,80,40,40
California,Alpine County,3,10,98,50,48
California,Alpine County,3,11,111,57,54
California,Alpine County,3,12,127,73,54
California,Alpine County,3,13,108,54,54
California,Alpine County,3,14,64,36,28
California,Alpine County,3,15,43,21,22
California,Alpine County,3,16,31,20,11
California,Alpine County,3,17,22,9,13
California,Alpine County,3,18,6,4,2
California,Alpine County,4,0,1093,565,528
California,Alpine County,4,1,49,22,27
California,Alpine County,4,2,70,38,32
California,Alpine County,4,3,59,26,33
California,Alpine County,4,4,52,23,29
California,Alpine County,4,5,43,26,17
California,Alpine County,4,6,51,26,25
California,Alpine County,4,7,42,20,22
California,Alpine County,4,8,47,28,19
California,Alpine County,4,9,75,39,36
California,Alpine County,4,10,91,48,43
California,Alpine County,4,11,106,55,51
California,Alpine County,4,12,121,68,53
California,Alpine County,4,13,120,58,62
California,Alpine County,4,14,65,35,30
California,Alpine County,4,15,35,18,17
California,Alpine County,4,16,37,20,17
California,Alpine County,4,17,26,14,12
California,Alpine County,4,18,4,1,3
California,Alpine County,5,0,1110,582,528
California,Alpine County,5,1,47,26,21
California,Alpine County,5,2,86,44,42
California,Alpine County,5,3,72,34,38
California,Alpine County,5,4,54,27,27
California,Alpine County,5,5,45,24,21
California,Alpine County,5,6,52,28,24
California,Alpine County,5,7,41,22,19
California,Alpine County,5,8,55,34,21
California,Alpine County,5,9,69,31,38
California,Alpine County,5,10,85,47,38
California,Alpine County,5,11,97,52,45
California,Alpine County,5,12,116,69,47
California,Alpine County,5,13,106,50,56
California,Alpine County,5,14,77,41,36
California,Alpine County,5,15,34,16,18
California,Alpine County,5,16,44,23,21
California,Alpine County,5,17,21,11,10
California,Alpine County,5,18,9,3,6
California,Alpine County,6,0,1127,588,539
California,Alpine County,6,1,39,22,17
California,Alpine County,6,2,80,36,44
California,Alpine County,6,3,80,45,35
California,Alpine County,6,4,66,33,33
California,Alpine County,6,5,51,30,21
California,Alpine County,6,6,55,28,27
California,Alpine County,6,7,38,21,17
California,Alpine County,6,8,46,25,21
California,Alpine County,6,9,68,36,32
California,Alpine County,6,10,75,33,42
California,Alpine County,6,11,102,61,41
California,Alpine County,6,12,111,63,48
California,Alpine County,6,13,108,52,56
California,Alpine County,6,14,90,44,46
California,Alpine County,6,15,37,20,17
California,Alpine County,6,16,46,23,23
California,Alpine County,6,17,25,14,11
California,Alpine County,6,18,10,2,8
California,Alpine County,7,0,1082,553,529
California,Alpine County,7,1,34,16,18
California,Alpine County,7,2,72,30,42
California,Alpine County,7,3,72,41,31
California,Alpine County,7,4,68,33,35
California,Alpine County,7,5,47,29,18
California,Alpine County,7,6,48,29,19
California,Alpine County,7,7,42,22,20
California,Alpine County,7,8,47,19,28
California,Alpine County,7,9,67,38,29
California,Alpine County,7,10,69,30,39
California,Alpine County,7,11,96,56,40
California,Alpine County,7,12,97,49,48
California,Alpine County,7,13,106,54,52
California,Alpine County,7,14,99,50,49
California,Alpine County,7,15,45,22,23
California,Alpine County,7,16,38,18,20
California,Alpine County,7,17,23,15,8
California,Alpine County,7,18,12,2,10
California,Alpine County,8,0,1087,568,519
California,Alpine County,8,1,39,17,22
California,Alpine County,8,2,62,30,32
California,Alpine County,8,3,68,40,28
California,Alpine County,8,4,64,32,32
California,Alpine County,8,5,55,35,20
California,Alpine County,8,6,60,37,23
California,Alpine County,8,7,36,16,20
California,Alpine County,8,8,42,20,22
California,Alpine County,8,9,58,30,28
California,Alpine County,8,10,77,40,37
California,Alpine County,8,11,99,53,46
California,Alpine County,8,12,93,47,46
California,Alpine County,8,13,106,60,46
California,Alpine County,8,14,98,46,52
California,Alpine County,8,15,55,28,27
California,Alpine County,8,16,33,14,19
California,Alpine County,8,17,25,18,7
California,Alpine County,8,18,17,5,12
California,Alpine County,9,0,1057,557,500
California,Alpine County,9,1,34,21,13
California,Alpine County,9,2,56,22,34
California,Alpine County,9,3,63,37,26
California,Alpine County,9,4,61,29,32
California,Alpine County,9,5,54,31,23
California,Alpine County,9,6,56,33,23
California,Alpine County,9,7,42,20,22
California,Alpine County,9,8,31,14,17
California,Alpine County,9,9,43,25,18
California,Alpine County,9,10,88,47,41
California,Alpine County,9,11,84,47,37
California,Alpine County,9,12,102,51,51
California,Alpine County,9,13,101,59,42
California,Alpine County,9,14,110,54,56
California,Alpine County,9,15,56,27,29
California,Alpine County,9,16,26,14,12
California,Alpine County,9,17,29,18,11
California,Alpine County,9,18,21,8,13
California,Alpine County,10,0,1121,608,513
California,Alpine County,10,1,40,27,13
California,Alpine County,10,2,52,25,27
California,Alpine County,10,3,76,44,32
California,Alpine County,10,4,69,35,34
California,Alpine County,10,5,61,39,22
California,Alpine County,10,6,64,36,28
California,Alpine County,10,7,50,27,23
California,Alpine County,10,8,40,22,18
California,Alpine County,10,9,50,25,25
California,Alpine County,10,10,72,39,33
California,Alpine County,10,11,79,42,37
California,Alpine County,10,12,112,61,51
California,Alpine County,10,13,97,55,42
California,Alpine County,10,14,109,56,53
California,Alpine County,10,15,71,36,35
California,Alpine County,10,16,29,14,15
California,Alpine County,10,17,29,17,12
California,Alpine County,10,18,21,8,13
California,Alpine County,11,0,1101,588,513
California,Alpine County,11,1,44,27,17
California,Alpine County,11,2,36,18,18
California,Alpine County,11,3,69,35,34
California,Alpine County,11,4,70,39,31
California,Alpine County,11,5,60,34,26
California,Alpine County,11,6,55,35,20
California,Alpine County,11,7,54,30,24
California,Alpine County,11,8,36,22,14
California,Alpine County,11,9,47,19,28
California,Alpine County,11,10,63,36,27
California,Alpine County,11,11,70,29,41
California,Alpine County,11,12,114,67,47
California,Alpine County,11,13,103,58,45
California,Alpine County,11,14,115,58,57
California,Alpine County,11,15,78,36,42
California,Alpine County,11,16,36,19,17
California,Alpine County,11,17,28,16,12
California,Alpine County,11,18,23,10,13
California,Amador County,1,0,38091,20749,17342
California,Amador County,1,1,1431,697,734
California,Amador County,1,2,1655,819,836
California,Amador County,1,3,1881,934,947
California,Amador County,1,4,2288,1341,947
California,Amador County,1,5,1648,996,652
California,Amador County,1,6,1778,1065,713
California,Amador County,1,7,1862,1186,676
California,Amador County,1,8,2048,1267,781
California,Amador County,1,9,2470,1572,898
California,Amador County,1,10,3114,1848,1266
California,Amador County,1,11,3255,1795,1460
California,Amador County,1,12,3405,1731,1674
California,Amador County,1,13,3391,1708,1683
California,Amador County,1,14,2533,1297,1236
California,Amador County,1,15,1922,955,967
California,Amador County,1,16,1312,643,669
California,Amador County,1,17,1096,501,595
California,Amador County,1,18,1002,394,608
California,Amador County,2,0,38091,20749,17342
California,Amador County,2,1,1431,697,734
California,Amador County,2,2,1655,819,836
California,Amador County,2,3,1881,934,947
California,Amador County,2,4,2288,1341,947
California,Amador County,2,5,1648,996,652
California,Amador County,2,6,1778,1065,713
California,Amador County,2,7,1862,1186,676
California,Amador County,2,8,2048,1267,781
California,Amador County,2,9,2470,1572,898
California,Amador County,2,10,3114,1848,1266
California,Amador County,2,11,3255,1795,1460
California,Amador County,2,12,3405,1731,1674
California,Amador County,2,13,3391,1708,1683
California,Amador County,2,14,2533,1297,1236
California,Amador County,2,15,1922,955,967
California,Amador County,2,16,1312,643,669
California,Amador County,2,17,1096,501,595
California,Amador County,2,18,1002,394,608
California,Amador County,3,0,37884,20559,17325
California,Amador County,3,1,1433,696,737
California,Amador County,3,2,1635,812,823
California,Amador County,3,3,1849,918,931
California,Amador County,3,4,2224,1282,942
California,Amador County,3,5,1653,990,663
California,Amador County,3,6,1763,1047,716
California,Amador County,3,7,1859,1181,678
California,Amador County,3,8,2012,1241,771
California,Amador County,3,9,2436,1538,898
California,Amador County,3,10,3064,1818,1246
California,Amador County,3,11,3226,1776,1450
California,Amador County,3,12,3396,1728,1668
California,Amador County,3,13,3400,1710,1690
California,Amador County,3,14,2564,1306,1258
California,Amador County,3,15,1934,962,972
California,Amador County,3,16,1329,649,680
California,Amador County,3,17,1087,499,588
California,Amador County,3,18,1020,406,614
California,Amador County,4,0,37538,20298,17240
California,Amador County,4,1,1376,682,694
California,Amador County,4,2,1611,800,811
California,Amador County,4,3,1778,873,905
California,Amador County,4,4,2135,1216,919
California,Amador County,4,5,1657,982,675
California,Amador County,4,6,1767,1040,727
California,Amador County,4,7,1892,1179,713
California,Amador County,4,8,1936,1199,737
California,Amador County,4,9,2399,1497,902
California,Amador County,4,10,2895,1732,1163
California,Amador County,4,11,3167,1740,1427
California,Amador County,4,12,3362,1720,1642
California,Amador County,4,13,3461,1732,1729
California,Amador County,4,14,2694,1343,1351
California,Amador County,4,15,1959,983,976
California,Amador County,4,16,1358,660,698
California,Amador County,4,17,1063,490,573
California,Amador County,4,18,1028,430,598
California,Amador County,5,0,37101,19949,17152
California,Amador County,5,1,1368,677,691
California,Amador County,5,2,1559,761,798
California,Amador County,5,3,1711,852,859
California,Amador County,5,4,1876,1003,873
California,Amador County,5,5,1670,943,727
California,Amador County,5,6,1749,1066,683
California,Amador County,5,7,1919,1183,736
California,Amador County,5,8,1905,1173,732
California,Amador County,5,9,2292,1433,859
California,Amador County,5,10,2716,1659,1057
California,Amador County,5,11,3149,1728,1421
California,Amador County,5,12,3301,1698,1603
California,Amador County,5,13,3329,1654,1675
California,Amador County,5,14,2987,1479,1508
California,Amador County,5,15,2053,1012,1041
California,Amador County,5,16,1423,705,718
California,Amador County,5,17,1015,463,552
California,Amador County,5,18,1079,460,619
California,Amador County,6,0,36625,19474,17151
California,Amador County,6,1,1356,731,625
California,Amador County,6,2,1521,743,778
California,Amador County,6,3,1689,844,845
California,Amador County,6,4,1773,930,843
California,Amador County,6,5,1706,931,775
California,Amador County,6,6,1705,1017,688
California,Amador County,6,7,1871,1113,758
California,Amador County,6,8,1822,1129,693
California,Amador County,6,9,2180,1320,860
California,Amador County,6,10,2489,1497,992
California,Amador County,6,11,3059,1639,1420
California,Amador County,6,12,3196,1625,1571
California,Amador County,6,13,3383,1645,1738
California,Amador County,6,14,3123,1565,1558
California,Amador County,6,15,2130,1056,1074
California,Amador County,6,16,1510,765,745
California,Amador County,6,17,992,454,538
California,Amador County,6,18,1120,470,650
California,Amador County,7,0,36738,19512,17226
California,Amador County,7,1,1412,756,656
California,Amador County,7,2,1504,728,776
California,Amador County,7,3,1656,831,825
California,Amador County,7,4,1708,893,815
California,Amador County,7,5,1747,950,797
California,Amador County,7,6,1723,1038,685
California,Amador County,7,7,1919,1119,800
California,Amador County,7,8,1852,1157,695
California,Amador County,7,9,2107,1283,824
California,Amador County,7,10,2376,1423,953
California,Amador County,7,11,3004,1634,1370
California,Amador County,7,12,3094,1576,1518
California,Amador County,7,13,3421,1669,1752
California,Amador County,7,14,3241,1588,1653
California,Amador County,7,15,2244,1119,1125
California,Amador County,7,16,1581,783,798
California,Amador County,7,17,1003,483,520
California,Amador County,7,18,1146,482,664
California,Amador County,8,0,37037,19658,17379
California,Amador County,8,1,1477,811,666
California,Amador County,8,2,1487,728,759
California,Amador County,8,3,1665,844,821
California,Amador County,8,4,1715,881,834
California,Amador County,8,5,1663,914,749
California,Amador County,8,6,1863,1101,762
California,Amador County,8,7,1914,1112,802
California,Amador County,8,8,1897,1181,716
California,Amador County,8,9,2063,1268,795
California,Amador County,8,10,2368,1440,928
California,Amador County,8,11,2898,1599,1299
California,Amador County,8,12,3091,1543,1548
California,Amador County,8,13,3379,1655,1724
California,Amador County,8,14,3400,1641,1759
California,Amador County,8,15,2389,1189,1200
California,Amador County,8,16,1646,808,838
California,Amador County,8,17,992,471,521
California,Amador County,8,18,1130,472,658
California,Amador County,9,0,37438,19826,17612
California,Amador County,9,1,1567,828,739
California,Amador County,9,2,1549,775,774
California,Amador County,9,3,1672,858,814
California,Amador County,9,4,1673,863,810
California,Amador County,9,5,1622,899,723
California,Amador County,9,6,1925,1120,805
California,Amador County,9,7,1965,1138,827
California,Amador County,9,8,2031,1239,792
California,Amador County,9,9,2025,1261,764
California,Amador County,9,10,2336,1397,939
California,Amador County,9,11,2788,1546,1242
California,Amador County,9,12,3117,1566,1551
California,Amador County,9,13,3310,1618,1692
California,Amador County,9,14,3544,1701,1843
California,Amador County,9,15,2500,1241,1259
California,Amador County,9,16,1670,832,838
California,Amador County,9,17,1034,480,554
California,Amador County,9,18,1110,464,646
California,Amador County,10,0,38551,20750,17801
California,Amador County,10,1,1601,831,770
California,Amador County,10,2,1550,812,738
California,Amador County,10,3,1646,822,824
California,Amador County,10,4,1688,882,806
California,Amador County,10,5,1646,939,707
California,Amador County,10,6,2044,1217,827
California,Amador County,10,7,2074,1251,823
California,Amador County,10,8,2197,1364,833
California,Amador County,10,9,2162,1380,782
California,Amador County,10,10,2448,1506,942
California,Amador County,10,11,2776,1594,1182
California,Amador County,10,12,3150,1601,1549
California,Amador County,10,13,3321,1643,1678
California,Amador County,10,14,3473,1664,1809
California,Amador County,10,15,2834,1386,1448
California,Amador County,10,16,1741,848,893
California,Amador County,10,17,1111,540,571
California,Amador County,10,18,1089,470,619
California,Amador County,11,0,39383,21425,17958
California,Amador County,11,1,1615,824,791
California,Amador County,11,2,1587,870,717
California,Amador County,11,3,1688,825,863
California,Amador County,11,4,1672,886,786
California,Amador County,11,5,1595,914,681
California,Amador County,11,6,2165,1289,876
California,Amador County,11,7,2131,1316,815
California,Amador County,11,8,2365,1472,893
California,Amador County,11,9,2266,1510,756
California,Amador County,11,10,2488,1554,934
California,Amador County,11,11,2697,1556,1141
California,Amador County,11,12,3140,1653,1487
California,Amador County,11,13,3341,1647,1694
California,Amador County,11,14,3492,1675,1817
California,Amador County,11,15,2997,1467,1530
California,Amador County,11,16,1871,903,968
California,Amador County,11,17,1187,591,596
California,Amador County,11,18,1086,473,613
California,Butte County,1,0,220000,108931,111069
California,Butte County,1,1,12409,6243,6166
California,Butte County,1,2,12439,6320,6119
California,Butte County,1,3,12911,6616,6295
California,Butte County,1,4,17841,9158,8683
California,Butte County,1,5,22818,11905,10913
California,Butte County,1,6,14721,7824,6897
California,Butte County,1,7,11960,6213,5747
California,Butte County,1,8,11482,5864,5618
California,Butte County,1,9,11847,5969,5878
California,Butte County,1,10,13849,6683,7166
California,Butte County,1,11,15028,7405,7623
California,Butte County,1,12,15265,7340,7925
California,Butte County,1,13,13613,6640,6973
California,Butte County,1,14,9805,4647,5158
California,Butte County,1,15,7380,3414,3966
California,Butte County,1,16,5925,2680,3245
California,Butte County,1,17,5037,2052,2985
California,Butte County,1,18,5670,1958,3712
California,Butte County,2,0,220002,108932,111070
California,Butte County,2,1,12409,6243,6166
California,Butte County,2,2,12439,6320,6119
California,Butte County,2,3,12911,6616,6295
California,Butte County,2,4,17841,9158,8683
California,Butte County,2,5,22818,11905,10913
California,Butte County,2,6,14721,7824,6897
California,Butte County,2,7,11960,6213,5747
California,Butte County,2,8,11482,5864,5618
California,Butte County,2,9,11847,5969,5878
California,Butte County,2,10,13849,6683,7166
California,Butte County,2,11,15030,7406,7624
California,Butte County,2,12,15265,7340,7925
California,Butte County,2,13,13613,6640,6973
California,Butte County,2,14,9805,4647,5158
California,Butte County,2,15,7380,3414,3966
California,Butte County,2,16,5925,2680,3245
California,Butte County,2,17,5037,2052,2985
California,Butte County,2,18,5670,1958,3712
California,Butte County,3,0,219945,108854,111091
California,Butte County,3,1,12397,6259,6138
California,Butte County,3,2,12399,6291,6108
California,Butte County,3,3,12866,6586,6280
California,Butte County,3,4,17443,8929,8514
California,Butte County,3,5,23239,12127,11112
California,Butte County,3,6,14688,7754,6934
California,Butte County,3,7,12053,6266,5787
California,Butte County,3,8,11393,5814,5579
California,Butte County,3,9,11826,5959,5867
California,Butte County,3,10,13735,6646,7089
California,Butte County,3,11,14969,7364,7605
California,Butte County,3,12,15258,7350,7908
California,Butte County,3,13,13763,6710,7053
California,Butte County,3,14,9872,4674,5198
California,Butte County,3,15,7437,3443,3994
California,Butte County,3,16,5913,2676,3237
California,Butte County,3,17,5004,2041,2963
California,Butte County,3,18,5690,1965,3725
California,Butte County,4,0,219952,108968,110984
California,Butte County,4,1,12280,6320,5960
California,Butte County,4,2,12443,6247,6196
California,Butte County,4,3,12715,6533,6182
California,Butte County,4,4,16377,8361,8016
California,Butte County,4,5,24806,13006,11800
California,Butte County,4,6,14216,7387,6829
California,Butte County,4,7,12405,6444,5961
California,Butte County,4,8,11083,5635,5448
California,Butte County,4,9,11864,6001,5863
California,Butte County,4,10,13107,6389,6718
California,Butte County,4,11,14729,7209,7520
California,Butte County,4,12,15214,7346,7868
California,Butte County,4,13,14364,6968,7396
California,Butte County,4,14,10145,4838,5307
California,Butte County,4,15,7594,3526,4068
California,Butte County,4,16,5943,2703,3240
California,Butte County,4,17,4902,2034,2868
California,Butte County,4,18,5765,2021,3744
California,Butte County,5,0,220873,109429,111444
California,Butte County,5,1,12120,6221,5899
California,Butte County,5,2,12584,6324,6260
California,Butte County,5,3,12600,6543,6057
California,Butte County,5,4,16156,8180,7976
California,Butte County,5,5,26092,13603,12489
California,Butte County,5,6,13604,7090,6514
California,Butte County,5,7,12684,6615,6069
California,Butte County,5,8,11079,5644,5435
California,Butte County,5,9,11777,5962,5815
California,Butte County,5,10,12626,6179,6447
California,Butte County,5,11,14408,7049,7359
California,Butte County,5,12,15188,7341,7847
California,Butte County,5,13,14268,6874,7394
California,Butte County,5,14,11212,5374,5838
California,Butte County,5,15,7836,3654,4182
California,Butte County,5,16,6006,2682,3324
California,Butte County,5,17,4811,2050,2761
California,Butte County,5,18,5822,2044,3778
California,Butte County,6,0,221664,109724,111940
California,Butte County,6,1,12070,6162,5908
California,Butte County,6,2,12600,6368,6232
California,Butte County,6,3,12616,6529,6087
California,Butte County,6,4,15945,8098,7847
California,Butte County,6,5,26491,13662,12829
California,Butte County,6,6,13544,7151,6393
California,Butte County,6,7,13010,6751,6259
California,Butte County,6,8,11269,5750,5519
California,Butte County,6,9,11675,5907,5768
California,Butte County,6,10,12155,5955,6200
California,Butte County,6,11,14110,6846,7264
California,Butte County,6,12,14986,7281,7705
California,Butte County,6,13,14574,6976,7598
California,Butte County,6,14,11793,5652,6141
California,Butte County,6,15,8231,3840,4391
California,Butte County,6,16,6156,2766,3390
California,Butte County,6,17,4662,2022,2640
California,Butte County,6,18,5777,2008,3769
California,Butte County,7,0,223570,110595,112975
California,Butte County,7,1,12306,6342,5964
California,Butte County,7,2,12531,6376,6155
California,Butte County,7,3,12763,6477,6286
California,Butte County,7,4,15775,8005,7770
California,Butte County,7,5,26430,13554,12876
California,Butte County,7,6,13867,7361,6506
California,Butte County,7,7,13457,6992,6465
California,Butte County,7,8,11599,5895,5704
California,Butte County,7,9,11564,5866,5698
California,Butte County,7,10,11875,5875,6000
California,Butte County,7,11,13843,6668,7175
California,Butte County,7,12,14950,7247,7703
California,Butte County,7,13,14793,7074,7719
California,Butte County,7,14,12469,5991,6478
California,Butte County,7,15,8638,4018,4620
California,Butte County,7,16,6306,2857,3449
California,Butte County,7,17,4660,2019,2641
California,Butte County,7,18,5744,1978,3766
California,Butte County,8,0,224812,111175,113637
California,Butte County,8,1,12412,6461,5951
California,Butte County,8,2,12555,6369,6186
California,Butte County,8,3,12706,6473,6233
California,Butte County,8,4,15719,7933,7786
California,Butte County,8,5,25825,13219,12606
California,Butte County,8,6,14627,7758,6869
California,Butte County,8,7,13468,6931,6537
California,Butte County,8,8,12072,6191,5881
California,Butte County,8,9,11393,5807,5586
California,Butte County,8,10,11781,5837,5944
California,Butte County,8,11,13519,6461,7058
California,Butte County,8,12,14833,7192,7641
California,Butte County,8,13,14884,7072,7812
California,Butte County,8,14,13124,6343,6781
California,Butte County,8,15,9023,4214,4809
California,Butte County,8,16,6423,2906,3517
California,Butte County,8,17,4724,2039,2685
California,Butte County,8,18,5724,1969,3755
California,Butte County,9,0,226529,112008,114521
California,Butte County,9,1,12447,6463,5984
California,Butte County,9,2,12605,6473,6132
California,Butte County,9,3,12682,6415,6267
California,Butte County,9,4,15623,7901,7722
California,Butte County,9,5,25222,12858,12364
California,Butte County,9,6,15691,8361,7330
California,Butte County,9,7,13567,6936,6631
California,Butte County,9,8,12568,6469,6099
California,Butte County,9,9,11280,5726,5554
California,Butte County,9,10,11887,5902,5985
California,Butte County,9,11,13027,6266,6761
California,Butte County,9,12,14603,7041,7562
California,Butte County,9,13,15006,7147,7859
California,Butte County,9,14,13908,6661,7247
California,Butte County,9,15,9326,4344,4982
California,Butte County,9,16,6647,3013,3634
California,Butte County,9,17,4741,2057,2684
California,Butte County,9,18,5699,1975,3724
California,Butte County,10,0,229207,113284,115923
California,Butte County,10,1,12610,6526,6084
California,Butte County,10,2,12713,6531,6182
California,Butte County,10,3,12808,6460,6348
California,Butte County,10,4,15609,7930,7679
California,Butte County,10,5,25135,12710,12425
California,Butte County,10,6,16511,8786,7725
California,Butte County,10,7,13406,6822,6584
California,Butte County,10,8,13152,6782,6370
California,Butte County,10,9,11391,5763,5628
California,Butte County,10,10,12027,6002,6025
California,Butte County,10,11,12675,6158,6517
California,Butte County,10,12,14427,6914,7513
California,Butte County,10,13,15161,7221,7940
California,Butte County,10,14,13957,6622,7335
California,Butte County,10,15,10369,4861,5508
California,Butte County,10,16,6841,3166,3675
California,Butte County,10,17,4784,2038,2746
California,Butte County,10,18,5631,1992,3639
California,Butte County,11,0,231256,114342,116914
California,Butte County,11,1,12803,6603,6200
California,Butte County,11,2,12732,6561,6171
California,Butte County,11,3,12963,6597,6366
California,Butte County,11,4,15667,7923,7744
California,Butte County,11,5,25027,12680,12347
California,Butte County,11,6,16833,8818,8015
California,Butte County,11,7,13394,6889,6505
California,Butte County,11,8,13601,6996,6605
California,Butte County,11,9,11685,5942,5743
California,Butte County,11,10,11971,5967,6004
California,Butte County,11,11,12243,5955,6288
California,Butte County,11,12,14305,6849,7456
California,Butte County,11,13,15040,7154,7886
California,Butte County,11,14,14348,6797,7551
California,Butte County,11,15,10990,5192,5798
California,Butte County,11,16,7162,3296,3866
California,Butte County,11,17,4914,2140,2774
California,Butte County,11,18,5578,1983,3595
California,Calaveras County,1,0,45578,22822,22756
California,Calaveras County,1,1,1992,1000,992
California,Calaveras County,1,2,2239,1149,1090
California,Calaveras County,1,3,2770,1429,1341
California,Calaveras County,1,4,2893,1589,1304
California,Calaveras County,1,5,1883,994,889
California,Calaveras County,1,6,1829,972,857
California,Calaveras County,1,7,1779,892,887
California,Calaveras County,1,8,2017,1008,1009
California,Calaveras County,1,9,2588,1258,1330
California,Calaveras County,1,10,3421,1689,1732
California,Calaveras County,1,11,4144,2027,2117
California,Calaveras County,1,12,4233,2031,2202
California,Calaveras County,1,13,4225,2102,2123
California,Calaveras County,1,14,3307,1671,1636
California,Calaveras County,1,15,2502,1268,1234
California,Calaveras County,1,16,1686,849,837
California,Calaveras County,1,17,1098,529,569
California,Calaveras County,1,18,972,365,607
California,Calaveras County,2,0,45578,22822,22756
California,Calaveras County,2,1,1992,1000,992
California,Calaveras County,2,2,2239,1149,1090
California,Calaveras County,2,3,2770,1429,1341
California,Calaveras County,2,4,2893,1589,1304
California,Calaveras County,2,5,1883,994,889
California,Calaveras County,2,6,1829,972,857
California,Calaveras County,2,7,1779,892,887
California,Calaveras County,2,8,2017,1008,1009
California,Calaveras County,2,9,2588,1258,1330
California,Calaveras County,2,10,3421,1689,1732
California,Calaveras County,2,11,4144,2027,2117
California,Calaveras County,2,12,4233,2031,2202
California,Calaveras County,2,13,4225,2102,2123
California,Calaveras County,2,14,3307,1671,1636
California,Calaveras County,2,15,2502,1268,1234
California,Calaveras County,2,16,1686,849,837
California,Calaveras County,2,17,1098,529,569
California,Calaveras County,2,18,972,365,607
California,Calaveras County,3,0,45468,22751,22717
California,Calaveras County,3,1,1966,992,974
California,Calaveras County,3,2,2210,1133,1077
California,Calaveras County,3,3,2747,1416,1331
California,Calaveras County,3,4,2875,1578,1297
California,Calaveras County,3,5,1899,1002,897
California,Calaveras County,3,6,1848,983,865
California,Calaveras County,3,7,1775,889,886
California,Calaveras County,3,8,1991,998,993
California,Calaveras County,3,9,2557,1231,1326
California,Calaveras County,3,10,3375,1677,1698
California,Calaveras County,3,11,4128,2011,2117
California,Calaveras County,3,12,4243,2021,2222
California,Calaveras County,3,13,4225,2109,2116
California,Calaveras County,3,14,3338,1688,1650
California,Calaveras County,3,15,2518,1276,1242
California,Calaveras County,3,16,1691,852,839
California,Calaveras County,3,17,1105,528,577
California,Calaveras County,3,18,977,367,610
California,Calaveras County,4,0,45160,22606,22554
California,Calaveras County,4,1,1898,976,922
California,Calaveras County,4,2,2118,1076,1042
California,Calaveras County,4,3,2653,1377,1276
California,Calaveras County,4,4,2834,1524,1310
California,Calaveras County,4,5,1942,1018,924
California,Calaveras County,4,6,1933,1044,889
California,Calaveras County,4,7,1818,925,893
California,Calaveras County,4,8,1874,939,935
California,Calaveras County,4,9,2449,1158,1291
California,Calaveras County,4,10,3118,1567,1551
California,Calaveras County,4,11,4005,1949,2056
California,Calaveras County,4,12,4236,1981,2255
California,Calaveras County,4,13,4310,2187,2123
California,Calaveras County,4,14,3455,1752,1703
California,Calaveras County,4,15,2625,1315,1310
California,Calaveras County,4,16,1768,902,866
California,Calaveras County,4,17,1129,531,598
California,Calaveras County,4,18,995,385,610
California,Calaveras County,5,0,44821,22456,22365
California,Calaveras County,5,1,1790,935,855
California,Calaveras County,5,2,2138,1077,1061
California,Calaveras County,5,3,2518,1317,1201
California,Calaveras County,5,4,2786,1458,1328
California,Calaveras County,5,5,1954,1025,929
California,Calaveras County,5,6,1850,1008,842
California,Calaveras County,5,7,1841,939,902
California,Calaveras County,5,8,1841,946,895
California,Calaveras County,5,9,2352,1123,1229
California,Calaveras County,5,10,2990,1477,1513
California,Calaveras County,5,11,3809,1861,1948
California,Calaveras County,5,12,4269,2026,2243
California,Calaveras County,5,13,4177,2095,2082
California,Calaveras County,5,14,3758,1909,1849
California,Calaveras County,5,15,2688,1359,1329
California,Calaveras County,5,16,1889,952,937
California,Calaveras County,5,17,1126,534,592
California,Calaveras County,5,18,1045,415,630
California,Calaveras County,6,0,44660,22341,22319
California,Calaveras County,6,1,1744,910,834
California,Calaveras County,6,2,2089,1047,1042
California,Calaveras County,6,3,2420,1252,1168
California,Calaveras County,6,4,2717,1443,1274
California,Calaveras County,6,5,2026,1056,970
California,Calaveras County,6,6,1847,992,855
California,Calaveras County,6,7,1896,957,939
California,Calaveras County,6,8,1844,969,875
California,Calaveras County,6,9,2241,1067,1174
California,Calaveras County,6,10,2782,1373,1409
California,Calaveras County,6,11,3708,1803,1905
California,Calaveras County,6,12,4241,2049,2192
California,Calaveras County,6,13,4205,2053,2152
California,Calaveras County,6,14,3867,1987,1880
California,Calaveras County,6,15,2804,1401,1403
California,Calaveras County,6,16,2022,1007,1015
California,Calaveras County,6,17,1166,555,611
California,Calaveras County,6,18,1041,420,621
California,Calaveras County,7,0,44673,22352,22321
California,Calaveras County,7,1,1768,925,843
California,Calaveras County,7,2,2085,1024,1061
California,Calaveras County,7,3,2331,1223,1108
California,Calaveras County,7,4,2616,1421,1195
California,Calaveras County,7,5,2020,1077,943
California,Calaveras County,7,6,1921,987,934
California,Calaveras County,7,7,1920,994,926
California,Calaveras County,7,8,1909,1001,908
California,Calaveras County,7,9,2151,1048,1103
California,Calaveras County,7,10,2617,1282,1335
California,Calaveras County,7,11,3598,1743,1855
California,Calaveras County,7,12,4168,2015,2153
California,Calaveras County,7,13,4296,2053,2243
California,Calaveras County,7,14,4002,2049,1953
California,Calaveras County,7,15,2963,1486,1477
California,Calaveras County,7,16,2039,1028,1011
California,Calaveras County,7,17,1210,579,631
California,Calaveras County,7,18,1059,417,642
California,Calaveras County,8,0,44957,22444,22513
California,Calaveras County,8,1,1823,949,874
California,Calaveras County,8,2,2063,1017,1046
California,Calaveras County,8,3,2256,1169,1087
California,Calaveras County,8,4,2520,1362,1158
California,Calaveras County,8,5,2069,1134,935
California,Calaveras County,8,6,1943,978,965
California,Calaveras County,8,7,2029,1051,978
California,Calaveras County,8,8,1971,1000,971
California,Calaveras County,8,9,2048,1041,1007
California,Calaveras County,8,10,2582,1248,1334
California,Calaveras County,8,11,3388,1689,1699
California,Calaveras County,8,12,4220,1994,2226
California,Calaveras County,8,13,4338,2044,2294
California,Calaveras County,8,14,4185,2113,2072
California,Calaveras County,8,15,3062,1557,1505
California,Calaveras County,8,16,2094,1046,1048
California,Calaveras County,8,17,1273,624,649
California,Calaveras County,8,18,1093,428,665
California,Calaveras County,9,0,45303,22586,22717
California,Calaveras County,9,1,1872,968,904
California,Calaveras County,9,2,2037,1027,1010
California,Calaveras County,9,3,2241,1143,1098
California,Calaveras County,9,4,2441,1335,1106
California,Calaveras County,9,5,2072,1106,966
California,Calaveras County,9,6,2002,1024,978
California,Calaveras County,9,7,2142,1115,1027
California,Calaveras County,9,8,2097,1067,1030
California,Calaveras County,9,9,1933,982,951
California,Calaveras County,9,10,2625,1255,1370
California,Calaveras County,9,11,3229,1615,1614
California,Calaveras County,9,12,4159,1980,2179
California,Calaveras County,9,13,4410,2032,2378
California,Calaveras County,9,14,4296,2162,2134
California,Calaveras County,9,15,3179,1629,1550
California,Calaveras County,9,16,2153,1075,1078
California,Calaveras County,9,17,1279,623,656
California,Calaveras County,9,18,1136,448,688
California,Calaveras County,10,0,45642,22735,22907
California,Calaveras County,10,1,1931,1003,928
California,Calaveras County,10,2,2018,1047,971
California,Calaveras County,10,3,2248,1139,1109
California,Calaveras County,10,4,2365,1278,1087
California,Calaveras County,10,5,2067,1109,958
California,Calaveras County,10,6,2102,1064,1038
California,Calaveras County,10,7,2265,1164,1101
California,Calaveras County,10,8,2170,1102,1068
California,Calaveras County,10,9,1976,1002,974
California,Calaveras County,10,10,2571,1243,1328
California,Calaveras County,10,11,3101,1532,1569
California,Calaveras County,10,12,4073,1948,2125
California,Calaveras County,10,13,4457,2063,2394
California,Calaveras County,10,14,4151,2053,2098
California,Calaveras County,10,15,3428,1742,1686
California,Calaveras County,10,16,2224,1119,1105
California,Calaveras County,10,17,1371,663,708
California,Calaveras County,10,18,1124,464,660
California,Calaveras County,11,0,45602,22697,22905
California,Calaveras County,11,1,1955,1016,939
California,Calaveras County,11,2,2023,1060,963
California,Calaveras County,11,3,2220,1089,1131
California,Calaveras County,11,4,2313,1263,1050
California,Calaveras County,11,5,2021,1058,963
California,Calaveras County,11,6,2125,1105,1020
California,Calaveras County,11,7,2252,1146,1106
California,Calaveras County,11,8,2282,1178,1104
California,Calaveras County,11,9,1997,1013,984
California,Calaveras County,11,10,2497,1197,1300
California,Calaveras County,11,11,2969,1465,1504
California,Calaveras County,11,12,3887,1847,2040
California,Calaveras County,11,13,4508,2151,2357
California,Calaveras County,11,14,4122,1993,2129
California,Calaveras County,11,15,3497,1762,1735
California,Calaveras County,11,16,2333,1172,1161
California,Calaveras County,11,17,1468,710,758
California,Calaveras County,11,18,1133,472,661
California,Colusa County,1,0,21419,11012,10407
California,Colusa County,1,1,1841,987,854
California,Colusa County,1,2,1733,914,819
California,Colusa County,1,3,1692,881,811
California,Colusa County,1,4,1773,965,808
California,Colusa County,1,5,1287,691,596
California,Colusa County,1,6,1440,736,704
California,Colusa County,1,7,1340,673,667
California,Colusa County,1,8,1325,660,665
California,Colusa County,1,9,1353,711,642
California,Colusa County,1,10,1356,700,656
California,Colusa County,1,11,1411,713,698
California,Colusa County,1,12,1296,646,650
California,Colusa County,1,13,1077,565,512
California,Colusa County,1,14,812,403,409
California,Colusa County,1,15,555,282,273
California,Colusa County,1,16,422,200,222
California,Colusa County,1,17,357,160,197
California,Colusa County,1,18,349,125,224
California,Colusa County,2,0,21407,11004,10403
California,Colusa County,2,1,1841,987,854
California,Colusa County,2,2,1733,914,819
California,Colusa County,2,3,1692,881,811
California,Colusa County,2,4,1773,965,808
California,Colusa County,2,5,1287,691,596
California,Colusa County,2,6,1440,736,704
California,Colusa County,2,7,1340,673,667
California,Colusa County,2,8,1324,659,665
California,Colusa County,2,9,1352,711,641
California,Colusa County,2,10,1355,699,656
California,Colusa County,2,11,1411,713,698
California,Colusa County,2,12,1294,644,650
California,Colusa County,2,13,1074,563,511
California,Colusa County,2,14,809,402,407
California,Colusa County,2,15,554,281,273
California,Colusa County,2,16,422,200,222
California,Colusa County,2,17,357,160,197
California,Colusa County,2,18,349,125,224
California,Colusa County,3,0,21437,11035,10402
California,Colusa County,3,1,1820,972,848
California,Colusa County,3,2,1731,916,815
California,Colusa County,3,3,1685,875,810
California,Colusa County,3,4,1770,968,802
California,Colusa County,3,5,1302,697,605
California,Colusa County,3,6,1441,744,697
California,Colusa County,3,7,1345,670,675
California,Colusa County,3,8,1321,665,656
California,Colusa County,3,9,1350,710,640
California,Colusa County,3,10,1346,695,651
California,Colusa County,3,11,1422,719,703
California,Colusa County,3,12,1294,648,646
California,Colusa County,3,13,1099,574,525
California,Colusa County,3,14,813,405,408
California,Colusa County,3,15,560,286,274
California,Colusa County,3,16,422,200,222
California,Colusa County,3,17,365,166,199
California,Colusa County,3,18,351,125,226
California,Colusa County,4,0,21327,10980,10347
California,Colusa County,4,1,1765,916,849
California,Colusa County,4,2,1740,931,809
California,Colusa County,4,3,1679,857,822
California,Colusa County,4,4,1748,970,778
California,Colusa County,4,5,1323,721,602
California,Colusa County,4,6,1414,734,680
California,Colusa County,4,7,1320,646,674
California,Colusa County,4,8,1279,648,631
California,Colusa County,4,9,1356,700,656
California,Colusa County,4,10,1305,675,630
California,Colusa County,4,11,1424,719,705
California,Colusa County,4,12,1282,665,617
California,Colusa County,4,13,1156,593,563
California,Colusa County,4,14,823,419,404
California,Colusa County,4,15,597,307,290
California,Colusa County,4,16,405,189,216
California,Colusa County,4,17,363,166,197
California,Colusa County,4,18,348,124,224
California,Colusa County,5,0,21294,10952,10342
California,Colusa County,5,1,1684,881,803
California,Colusa County,5,2,1748,928,820
California,Colusa County,5,3,1652,839,813
California,Colusa County,5,4,1646,903,743
California,Colusa County,5,5,1425,771,654
California,Colusa County,5,6,1392,722,670
California,Colusa County,5,7,1329,694,635
California,Colusa County,5,8,1265,616,649
California,Colusa County,5,9,1318,687,631
California,Colusa County,5,10,1314,672,642
California,Colusa County,5,11,1376,697,679
California,Colusa County,5,12,1370,712,658
California,Colusa County,5,13,1131,579,552
California,Colusa County,5,14,885,445,440
California,Colusa County,5,15,639,323,316
California,Colusa County,5,16,405,192,213
California,Colusa County,5,17,357,165,192
California,Colusa County,5,18,358,126,232
California,Colusa County,6,0,21265,10935,10330
California,Colusa County,6,1,1602,822,780
California,Colusa County,6,2,1789,955,834
California,Colusa County,6,3,1607,828,779
California,Colusa County,6,4,1627,888,739
California,Colusa County,6,5,1473,784,689
California,Colusa County,6,6,1392,724,668
California,Colusa County,6,7,1342,715,627
California,Colusa County,6,8,1256,619,637
California,Colusa County,6,9,1287,665,622
California,Colusa County,6,10,1297,671,626
California,Colusa County,6,11,1358,691,667
California,Colusa County,6,12,1360,705,655
California,Colusa County,6,13,1137,567,570
California,Colusa County,6,14,889,456,433
California,Colusa County,6,15,695,349,346
California,Colusa County,6,16,441,215,226
California,Colusa County,6,17,335,146,189
California,Colusa County,6,18,378,135,243
California,Colusa County,7,0,21198,10860,10338
California,Colusa County,7,1,1568,780,788
California,Colusa County,7,2,1768,933,835
California,Colusa County,7,3,1621,859,762
California,Colusa County,7,4,1594,865,729
California,Colusa County,7,5,1463,774,689
California,Colusa County,7,6,1350,713,637
California,Colusa County,7,7,1410,733,677
California,Colusa County,7,8,1254,628,626
California,Colusa County,7,9,1216,620,596
California,Colusa County,7,10,1283,669,614
California,Colusa County,7,11,1342,679,663
California,Colusa County,7,12,1335,693,642
California,Colusa County,7,13,1170,574,596
California,Colusa County,7,14,926,470,456
California,Colusa County,7,15,720,363,357
California,Colusa County,7,16,465,227,238
California,Colusa County,7,17,317,139,178
California,Colusa County,7,18,396,141,255
California,Colusa County,8,0,21269,10883,10386
California,Colusa County,8,1,1549,770,779
California,Colusa County,8,2,1716,904,812
California,Colusa County,8,3,1605,860,745
California,Colusa County,8,4,1579,838,741
California,Colusa County,8,5,1500,783,717
California,Colusa County,8,6,1316,717,599
California,Colusa County,8,7,1453,739,714
California,Colusa County,8,8,1260,630,630
California,Colusa County,8,9,1204,613,591
California,Colusa County,8,10,1280,664,616
California,Colusa County,8,11,1313,675,638
California,Colusa County,8,12,1367,701,666
California,Colusa County,8,13,1203,599,604
California,Colusa County,8,14,971,497,474
California,Colusa County,8,15,734,364,370
California,Colusa County,8,16,491,241,250
California,Colusa County,8,17,319,142,177
California,Colusa County,8,18,409,146,263
California,Colusa County,9,0,21553,11024,10529
California,Colusa County,9,1,1543,771,772
California,Colusa County,9,2,1721,899,822
California,Colusa County,9,3,1657,884,773
California,Colusa County,9,4,1581,843,738
California,Colusa County,9,5,1481,764,717
California,Colusa County,9,6,1374,756,618
California,Colusa County,9,7,1449,734,715
California,Colusa County,9,8,1347,679,668
California,Colusa County,9,9,1184,589,595
California,Colusa County,9,10,1313,670,643
California,Colusa County,9,11,1269,658,611
California,Colusa County,9,12,1401,720,681
California,Colusa County,9,13,1226,635,591
California,Colusa County,9,14,1019,510,509
California,Colusa County,9,15,727,356,371
California,Colusa County,9,16,519,258,261
California,Colusa County,9,17,322,139,183
California,Colusa County,9,18,420,159,261
California,Colusa County,10,0,21675,11078,10597
California,Colusa County,10,1,1599,810,789
California,Colusa County,10,2,1672,862,810
California,Colusa County,10,3,1710,897,813
California,Colusa County,10,4,1606,865,741
California,Colusa County,10,5,1424,715,709
California,Colusa County,10,6,1426,767,659
California,Colusa County,10,7,1433,732,701
California,Colusa County,10,8,1378,719,659
California,Colusa County,10,9,1216,596,620
California,Colusa County,10,10,1289,659,630
California,Colusa County,10,11,1261,655,606
California,Colusa County,10,12,1319,666,653
California,Colusa County,10,13,1275,674,601
California,Colusa County,10,14,1006,504,502
California,Colusa County,10,15,772,378,394
California,Colusa County,10,16,556,275,281
California,Colusa County,10,17,324,147,177
California,Colusa County,10,18,409,157,252
California,Colusa County,11,0,21627,11046,10581
California,Colusa County,11,1,1543,779,764
California,Colusa County,11,2,1618,832,786
California,Colusa County,11,3,1732,910,822
California,Colusa County,11,4,1598,855,743
California,Colusa County,11,5,1409,728,681
California,Colusa County,11,6,1463,761,702
California,Colusa County,11,7,1418,733,685
California,Colusa County,11,8,1390,712,678
California,Colusa County,11,9,1222,608,614
California,Colusa County,11,10,1255,633,622
California,Colusa County,11,11,1285,665,620
California,Colusa County,11,12,1286,665,621
California,Colusa County,11,13,1245,645,600
California,Colusa County,11,14,1026,509,517
California,Colusa County,11,15,780,393,387
California,Colusa County,11,16,607,297,310
California,Colusa County,11,17,354,172,182
California,Colusa County,11,18,396,149,247
California,Contra Costa County,1,0,1049025,511526,537499
California,Contra Costa County,1,1,67018,34004,33014
California,Contra Costa County,1,2,72285,36983,35302
California,Contra Costa County,1,3,74444,38052,36392
California,Contra Costa County,1,4,73766,38187,35579
California,Contra Costa County,1,5,59943,30793,29150
California,Contra Costa County,1,6,64747,32303,32444
California,Contra Costa County,1,7,64896,31637,33259
California,Contra Costa County,1,8,70520,34253,36267
California,Contra Costa County,1,9,78130,38033,40097
California,Contra Costa County,1,10,84006,40737,43269
California,Contra Costa County,1,11,80074,38882,41192
California,Contra Costa County,1,12,69400,33301,36099
California,Contra Costa County,1,13,59358,28062,31296
California,Contra Costa County,1,14,41276,19189,22087
California,Contra Costa County,1,15,29443,13534,15909
California,Contra Costa County,1,16,22383,9761,12622
California,Contra Costa County,1,17,17964,7197,10767
California,Contra Costa County,1,18,19372,6618,12754
California,Contra Costa County,2,0,1049204,511613,537591
California,Contra Costa County,2,1,67020,34005,33015
California,Contra Costa County,2,2,72285,36983,35302
California,Contra Costa County,2,3,74442,38050,36392
California,Contra Costa County,2,4,73766,38187,35579
California,Contra Costa County,2,5,59945,30793,29152
California,Contra Costa County,2,6,64747,32303,32444
California,Contra Costa County,2,7,64897,31637,33260
California,Contra Costa County,2,8,70522,34254,36268
California,Contra Costa County,2,9,78135,38037,40098
California,Contra Costa County,2,10,84011,40741,43270
California,Contra Costa County,2,11,80082,38887,41195
California,Contra Costa County,2,12,69411,33307,36104
California,Contra Costa County,2,13,59370,28070,31300
California,Contra Costa County,2,14,41297,19198,22099
California,Contra Costa County,2,15,29462,13547,15915
California,Contra Costa County,2,16,22412,9774,12638
California,Contra Costa County,2,17,17983,7209,10774
California,Contra Costa County,2,18,19417,6631,12786
California,Contra Costa County,3,0,1052559,513210,539349
California,Contra Costa County,3,1,66913,33959,32954
California,Contra Costa County,3,2,72277,36961,35316
California,Contra Costa County,3,3,74442,38027,36415
California,Contra Costa County,3,4,73785,38162,35623
California,Contra Costa County,3,5,60452,31046,29406
California,Contra Costa County,3,6,64909,32421,32488
California,Contra Costa County,3,7,65330,31841,33489
California,Contra Costa County,3,8,70294,34117,36177
California,Contra Costa County,3,9,78213,38067,40146
California,Contra Costa County,3,10,83886,40699,43187
California,Contra Costa County,3,11,80470,39071,41399
California,Contra Costa County,3,12,69937,33614,36323
California,Contra Costa County,3,13,59954,28341,31613
California,Contra Costa County,3,14,41834,19422,22412
California,Contra Costa County,3,15,29771,13704,16067
California,Contra Costa County,3,16,22454,9810,12644
California,Contra Costa County,3,17,18050,7260,10790
California,Contra Costa County,3,18,19588,6688,12900
California,Contra Costa County,4,0,1065452,519386,546066
California,Contra Costa County,4,1,66365,33690,32675
California,Contra Costa County,4,2,72620,37099,35521
California,Contra Costa County,4,3,74603,38057,36546
California,Contra Costa County,4,4,73575,37927,35648
California,Contra Costa County,4,5,62715,32148,30567
California,Contra Costa County,4,6,65069,32537,32532
California,Contra Costa County,4,7,66735,32525,34210
California,Contra Costa County,4,8,69164,33389,35775
California,Contra Costa County,4,9,78862,38446,40416
California,Contra Costa County,4,10,82802,40288,42514
California,Contra Costa County,4,11,81809,39759,42050
California,Contra Costa County,4,12,72171,34846,37325
California,Contra Costa County,4,13,62563,29534,33029
California,Contra Costa County,4,14,44066,20407,23659
California,Contra Costa County,4,15,31195,14347,16848
California,Contra Costa County,4,16,22831,10070,12761
California,Contra Costa County,4,17,18218,7443,10775
California,Contra Costa County,4,18,20089,6874,13215
California,Contra Costa County,5,0,1077731,525493,552238
California,Contra Costa County,5,1,65178,33183,31995
California,Contra Costa County,5,2,73187,37442,35745
California,Contra Costa County,5,3,74839,38056,36783
California,Contra Costa County,5,4,73057,37650,35407
California,Contra Costa County,5,5,65078,33294,31784
California,Contra Costa County,5,6,64914,32455,32459
California,Contra Costa County,5,7,68217,33551,34666
California,Contra Costa County,5,8,69201,33360,35841
California,Contra Costa County,5,9,78593,38375,40218
California,Contra Costa County,5,10,81600,39730,41870
California,Contra Costa County,5,11,82537,40141,42396
California,Contra Costa County,5,12,74447,36000,38447
California,Contra Costa County,5,13,62798,29521,33277
California,Contra Costa County,5,14,48523,22540,25983
California,Contra Costa County,5,15,32992,15111,17881
California,Contra Costa County,5,16,23509,10398,13111
California,Contra Costa County,5,17,18395,7613,10782
California,Contra Costa County,5,18,20666,7073,13593
California,Contra Costa County,6,0,1093758,533435,560323
California,Contra Costa County,6,1,65064,33041,32023
California,Contra Costa County,6,2,73536,37540,35996
California,Contra Costa County,6,3,75563,38461,37102
California,Contra Costa County,6,4,72744,37484,35260
California,Contra Costa County,6,5,67566,34536,33030
California,Contra Costa County,6,6,65456,32897,32559
California,Contra Costa County,6,7,70082,34471,35611
California,Contra Costa County,6,8,70052,33882,36170
California,Contra Costa County,6,9,78150,38161,39989
California,Contra Costa County,6,10,80866,39403,41463
California,Contra Costa County,6,11,83603,40640,42963
California,Contra Costa County,6,12,76083,36874,39209
California,Contra Costa County,6,13,63996,30074,33922
California,Contra Costa County,6,14,51301,23804,27497
California,Contra Costa County,6,15,35291,16144,19147
California,Contra Costa County,6,16,24547,10901,13646
California,Contra Costa County,6,17,18648,7802,10846
California,Contra Costa County,6,18,21210,7320,13890
California,Contra Costa County,7,0,1109358,541335,568023
California,Contra Costa County,7,1,65367,33278,32089
California,Contra Costa County,7,2,73258,37430,35828
California,Contra Costa County,7,3,76395,38868,37527
California,Contra Costa County,7,4,72443,37210,35233
California,Contra Costa County,7,5,68945,35075,33870
California,Contra Costa County,7,6,66857,33712,33145
California,Contra Costa County,7,7,71953,35505,36448
California,Contra Costa County,7,8,71326,34555,36771
California,Contra Costa County,7,9,77227,37680,39547
California,Contra Costa County,7,10,80512,39349,41163
California,Contra Costa County,7,11,84599,41257,43342
California,Contra Costa County,7,12,77191,37375,39816
California,Contra Costa County,7,13,65669,30994,34675
California,Contra Costa County,7,14,54059,25062,28997
California,Contra Costa County,7,15,37382,17007,20375
California,Contra Costa County,7,16,25656,11477,14179
California,Contra Costa County,7,17,18745,7850,10895
California,Contra Costa County,7,18,21774,7651,14123
California,Contra Costa County,8,0,1124606,548978,575628
California,Contra Costa County,8,1,65744,33471,32273
California,Contra Costa County,8,2,73293,37421,35872
California,Contra Costa County,8,3,76761,39096,37665
California,Contra Costa County,8,4,72668,37302,35366
California,Contra Costa County,8,5,69178,35248,33930
California,Contra Costa County,8,6,68642,34770,33872
California,Contra Costa County,8,7,72950,36003,36947
California,Contra Costa County,8,8,73534,35698,37836
California,Contra Costa County,8,9,75960,37068,38892
California,Contra Costa County,8,10,81209,39726,41483
California,Contra Costa County,8,11,84532,41217,43315
California,Contra Costa County,8,12,78669,38144,40525
California,Contra Costa County,8,13,67383,31871,35512
California,Contra Costa County,8,14,56674,26197,30477
California,Contra Costa County,8,15,39281,17767,21514
California,Contra Costa County,8,16,26823,12059,14764
California,Contra Costa County,8,17,18908,7967,10941
California,Contra Costa County,8,18,22397,7953,14444
California,Contra Costa County,9,0,1137194,555564,581630
California,Contra Costa County,9,1,65863,33594,32269
California,Contra Costa County,9,2,72934,37287,35647
California,Contra Costa County,9,3,76838,39005,37833
California,Contra Costa County,9,4,72774,37296,35478
California,Contra Costa County,9,5,68189,34856,33333
California,Contra Costa County,9,6,71369,36151,35218
California,Contra Costa County,9,7,73913,36703,37210
California,Contra Costa County,9,8,75805,36928,38877
California,Contra Costa County,9,9,75533,36749,38784
California,Contra Costa County,9,10,81612,39915,41697
California,Contra Costa County,9,11,83553,40880,42673
California,Contra Costa County,9,12,79535,38669,40866
California,Contra Costa County,9,13,69210,32888,36322
California,Contra Costa County,9,14,58839,27196,31643
California,Contra Costa County,9,15,41177,18588,22589
California,Contra Costa County,9,16,28116,12617,15499
California,Contra Costa County,9,17,19146,8118,11028
California,Contra Costa County,9,18,22788,8124,14664
California,Contra Costa County,10,0,1144863,559511,585352
California,Contra Costa County,10,1,65578,33252,32326
California,Contra Costa County,10,2,71841,36733,35108
California,Contra Costa County,10,3,77313,39487,37826
California,Contra Costa County,10,4,72795,37124,35671
California,Contra Costa County,10,5,67690,34505,33185
California,Contra Costa County,10,6,72776,37030,35746
California,Contra Costa County,10,7,73465,36379,37086
California,Contra Costa County,10,8,77660,38205,39455
California,Contra Costa County,10,9,75877,36851,39026
California,Contra Costa County,10,10,81578,39999,41579
California,Contra Costa County,10,11,81988,40107,41881
California,Contra Costa County,10,12,79834,38855,40979
California,Contra Costa County,10,13,70767,33732,37035
California,Contra Costa County,10,14,58522,26994,31528
California,Contra Costa County,10,15,44956,20415,24541
California,Contra Costa County,10,16,29543,13212,16331
California,Contra Costa County,10,17,19633,8346,11287
California,Contra Costa County,10,18,23047,8285,14762
California,Contra Costa County,11,0,1150215,562483,587732
California,Contra Costa County,11,1,64973,33130,31843
California,Contra Costa County,11,2,70774,36107,34667
California,Contra Costa County,11,3,77366,39512,37854
California,Contra Costa County,11,4,73055,37404,35651
California,Contra Costa County,11,5,66640,33961,32679
California,Contra Costa County,11,6,73055,37178,35877
California,Contra Costa County,11,7,73953,36808,37145
California,Contra Costa County,11,8,78936,38822,40114
California,Contra Costa County,11,9,76498,37235,39263
California,Contra Costa County,11,10,80738,39602,41136
California,Contra Costa County,11,11,80749,39416,41333
California,Contra Costa County,11,12,80276,39126,41150
California,Contra Costa County,11,13,71759,34324,37435
California,Contra Costa County,11,14,59161,27241,31920
California,Contra Costa County,11,15,47276,21524,25752
California,Contra Costa County,11,16,31351,13938,17413
California,Contra Costa County,11,17,20413,8726,11687
California,Contra Costa County,11,18,23242,8429,14813
California,Del Norte County,1,0,28610,15907,12703
California,Del Norte County,1,1,1703,850,853
California,Del Norte County,1,2,1567,827,740
California,Del Norte County,1,3,1718,872,846
California,Del Norte County,1,4,1870,986,884
California,Del Norte County,1,5,1799,1110,689
California,Del Norte County,1,6,2081,1354,727
California,Del Norte County,1,7,2000,1351,649
California,Del Norte County,1,8,1937,1284,653
California,Del Norte County,1,9,1895,1184,711
California,Del Norte County,1,10,2204,1254,950
California,Del Norte County,1,11,2246,1172,1074
California,Del Norte County,1,12,1975,1003,972
California,Del Norte County,1,13,1742,905,837
California,Del Norte County,1,14,1245,613,632
California,Del Norte County,1,15,908,411,497
California,Del Norte County,1,16,739,332,407
California,Del Norte County,1,17,524,229,295
California,Del Norte County,1,18,457,170,287
California,Del Norte County,2,0,28610,15907,12703
California,Del Norte County,2,1,1703,850,853
California,Del Norte County,2,2,1567,827,740
California,Del Norte County,2,3,1718,872,846
California,Del Norte County,2,4,1870,986,884
California,Del Norte County,2,5,1799,1110,689
California,Del Norte County,2,6,2081,1354,727
California,Del Norte County,2,7,2000,1351,649
California,Del Norte County,2,8,1937,1284,653
California,Del Norte County,2,9,1895,1184,711
California,Del Norte County,2,10,2204,1254,950
California,Del Norte County,2,11,2246,1172,1074
California,Del Norte County,2,12,1975,1003,972
California,Del Norte County,2,13,1742,905,837
California,Del Norte County,2,14,1245,613,632
California,Del Norte County,2,15,908,411,497
California,Del Norte County,2,16,739,332,407
California,Del Norte County,2,17,524,229,295
California,Del Norte County,2,18,457,170,287
California,Del Norte County,3,0,28568,15878,12690
California,Del Norte County,3,1,1714,858,856
California,Del Norte County,3,2,1569,830,739
California,Del Norte County,3,3,1723,869,854
California,Del Norte County,3,4,1841,974,867
California,Del Norte County,3,5,1796,1105,691
California,Del Norte County,3,6,2084,1349,735
California,Del Norte County,3,7,2008,1349,659
California,Del Norte County,3,8,1915,1268,647
California,Del Norte County,3,9,1884,1179,705
California,Del Norte County,3,10,2190,1248,942
California,Del Norte County,3,11,2233,1172,1061
California,Del Norte County,3,12,1973,998,975
California,Del Norte County,3,13,1753,910,843
California,Del Norte County,3,14,1259,617,642
California,Del Norte County,3,15,915,421,494
California,Del Norte County,3,16,727,328,399
California,Del Norte County,3,17,529,231,298
California,Del Norte County,3,18,455,172,283
California,Del Norte County,4,0,28442,15819,12623
California,Del Norte County,4,1,1696,848,848
California,Del Norte County,4,2,1603,844,759
California,Del Norte County,4,3,1686,845,841
California,Del Norte County,4,4,1750,936,814
California,Del Norte County,4,5,1813,1115,698
California,Del Norte County,4,6,2087,1346,741
California,Del Norte County,4,7,2051,1380,671
California,Del Norte County,4,8,1876,1243,633
California,Del Norte County,4,9,1839,1145,694
California,Del Norte County,4,10,2081,1204,877
California,Del Norte County,4,11,2211,1173,1038
California,Del Norte County,4,12,2021,1007,1014
California,Del Norte County,4,13,1806,935,871
California,Del Norte County,4,14,1266,619,647
California,Del Norte County,4,15,953,451,502
California,Del Norte County,4,16,686,313,373
California,Del Norte County,4,17,546,239,307
California,Del Norte County,4,18,471,176,295
California,Del Norte County,5,0,28189,15661,12528
California,Del Norte County,5,1,1646,828,818
California,Del Norte County,5,2,1648,841,807
California,Del Norte County,5,3,1624,814,810
California,Del Norte County,5,4,1707,931,776
California,Del Norte County,5,5,1817,1104,713
California,Del Norte County,5,6,2039,1317,722
California,Del Norte County,5,7,2103,1424,679
California,Del Norte County,5,8,1838,1218,620
California,Del Norte County,5,9,1787,1115,672
California,Del Norte County,5,10,1966,1154,812
California,Del Norte County,5,11,2130,1120,1010
California,Del Norte County,5,12,2012,975,1037
California,Del Norte County,5,13,1809,936,873
California,Del Norte County,5,14,1368,678,690
California,Del Norte County,5,15,1008,486,522
California,Del Norte County,5,16,658,294,364
California,Del Norte County,5,17,574,245,329
California,Del Norte County,5,18,455,181,274
California,Del Norte County,6,0,27817,15406,12411
California,Del Norte County,6,1,1626,834,792
California,Del Norte County,6,2,1683,848,835
California,Del Norte County,6,3,1559,807,752
California,Del Norte County,6,4,1642,896,746
California,Del Norte County,6,5,1750,1063,687
California,Del Norte County,6,6,1962,1238,724
California,Del Norte County,6,7,2097,1399,698
California,Del Norte County,6,8,1824,1208,616
California,Del Norte County,6,9,1709,1046,663
California,Del Norte County,6,10,1855,1090,765
California,Del Norte County,6,11,2055,1103,952
California,Del Norte County,6,12,2061,981,1080
California,Del Norte County,6,13,1827,945,882
California,Del Norte County,6,14,1397,717,680
California,Del Norte County,6,15,1066,504,562
California,Del Norte County,6,16,677,290,387
California,Del Norte County,6,17,557,242,315
California,Del Norte County,6,18,470,195,275
California,Del Norte County,7,0,27198,14868,12330
California,Del Norte County,7,1,1591,773,818
California,Del Norte County,7,2,1662,841,821
California,Del Norte County,7,3,1582,824,758
California,Del Norte County,7,4,1547,841,706
California,Del Norte County,7,5,1620,972,648
California,Del Norte County,7,6,1870,1172,698
California,Del Norte County,7,7,2054,1328,726
California,Del Norte County,7,8,1806,1180,626
California,Del Norte County,7,9,1635,988,647
California,Del Norte County,7,10,1688,986,702
California,Del Norte County,7,11,1993,1062,931
California,Del Norte County,7,12,2037,979,1058
California,Del Norte County,7,13,1827,911,916
California,Del Norte County,7,14,1485,774,711
California,Del Norte County,7,15,1078,503,575
California,Del Norte County,7,16,713,301,412
California,Del Norte County,7,17,539,248,291
California,Del Norte County,7,18,471,185,286
California,Del Norte County,8,0,27246,14913,12333
California,Del Norte County,8,1,1572,808,764
California,Del Norte County,8,2,1643,835,808
California,Del Norte County,8,3,1533,781,752
California,Del Norte County,8,4,1554,853,701
California,Del Norte County,8,5,1596,944,652
California,Del Norte County,8,6,1890,1207,683
California,Del Norte County,8,7,2038,1324,714
California,Del Norte County,8,8,1834,1172,662
California,Del Norte County,8,9,1613,991,622
California,Del Norte County,8,10,1645,952,693
California,Del Norte County,8,11,1896,1006,890
California,Del Norte County,8,12,2067,1020,1047
California,Del Norte County,8,13,1871,909,962
California,Del Norte County,8,14,1631,836,795
California,Del Norte County,8,15,1062,507,555
California,Del Norte County,8,16,763,333,430
California,Del Norte County,8,17,545,246,299
California,Del Norte County,8,18,493,189,304
California,Del Norte County,9,0,27422,14896,12526
California,Del Norte County,9,1,1630,851,779
California,Del Norte County,9,2,1630,812,818
California,Del Norte County,9,3,1564,809,755
California,Del Norte County,9,4,1545,826,719
California,Del Norte County,9,5,1565,940,625
California,Del Norte County,9,6,1883,1198,685
California,Del Norte County,9,7,2004,1249,755
California,Del Norte County,9,8,1896,1215,681
California,Del Norte County,9,9,1586,946,640
California,Del Norte County,9,10,1625,938,687
California,Del Norte County,9,11,1834,996,838
California,Del Norte County,9,12,2044,1004,1040
California,Del Norte County,9,13,1939,927,1012
California,Del Norte County,9,14,1733,873,860
California,Del Norte County,9,15,1109,524,585
California,Del Norte County,9,16,802,364,438
California,Del Norte County,9,17,506,232,274
California,Del Norte County,9,18,527,192,335
California,Del Norte County,10,0,27428,14766,12662
California,Del Norte County,10,1,1606,851,755
California,Del Norte County,10,2,1646,816,830
California,Del Norte County,10,3,1679,869,810
California,Del Norte County,10,4,1523,798,725
California,Del Norte County,10,5,1528,928,600
California,Del Norte County,10,6,1854,1125,729
California,Del Norte County,10,7,1955,1212,743
California,Del Norte County,10,8,1955,1212,743
California,Del Norte County,10,9,1538,904,634
California,Del Norte County,10,10,1569,891,678
California,Del Norte County,10,11,1734,941,793
California,Del Norte County,10,12,2000,990,1010
California,Del Norte County,10,13,1976,922,1054
California,Del Norte County,10,14,1740,885,855
California,Del Norte County,10,15,1212,594,618
California,Del Norte County,10,16,850,391,459
California,Del Norte County,10,17,498,221,277
California,Del Norte County,10,18,565,216,349
California,Del Norte County,11,0,27828,15188,12640
California,Del Norte County,11,1,1560,812,748
California,Del Norte County,11,2,1659,853,806
California,Del Norte County,11,3,1688,856,832
California,Del Norte County,11,4,1479,773,706
California,Del Norte County,11,5,1584,965,619
California,Del Norte County,11,6,1925,1202,723
California,Del Norte County,11,7,2008,1301,707
California,Del Norte County,11,8,2056,1269,787
California,Del Norte County,11,9,1634,998,636
California,Del Norte County,11,10,1603,935,668
California,Del Norte County,11,11,1641,895,746
California,Del Norte County,11,12,1940,993,947
California,Del Norte County,11,13,2033,939,1094
California,Del Norte County,11,14,1754,871,883
California,Del Norte County,11,15,1276,657,619
California,Del Norte County,11,16,893,412,481
California,Del Norte County,11,17,546,244,302
California,Del Norte County,11,18,549,213,336
California,El Dorado County,1,0,181058,90571,90487
California,El Dorado County,1,1,9513,4870,4643
California,El Dorado County,1,2,11126,5664,5462
California,El Dorado County,1,3,12506,6410,6096
California,El Dorado County,1,4,12522,6543,5979
California,El Dorado County,1,5,8958,4889,4069
California,El Dorado County,1,6,8682,4544,4138
California,El Dorado County,1,7,8562,4302,4260
California,El Dorado County,1,8,9993,4954,5039
California,El Dorado County,1,9,12210,5974,6236
California,El Dorado County,1,10,15516,7521,7995
California,El Dorado County,1,11,16830,8310,8520
California,El Dorado County,1,12,15146,7501,7645
California,El Dorado County,1,13,12970,6533,6437
California,El Dorado County,1,14,9141,4519,4622
California,El Dorado County,1,15,6296,3148,3148
California,El Dorado County,1,16,4656,2294,2362
California,El Dorado County,1,17,3313,1432,1881
California,El Dorado County,1,18,3118,1163,1955
California,El Dorado County,2,0,181058,90572,90486
California,El Dorado County,2,1,9513,4870,4643
California,El Dorado County,2,2,11126,5664,5462
California,El Dorado County,2,3,12506,6410,6096
California,El Dorado County,2,4,12522,6543,5979
California,El Dorado County,2,5,8958,4889,4069
California,El Dorado County,2,6,8682,4544,4138
California,El Dorado County,2,7,8562,4302,4260
California,El Dorado County,2,8,9993,4954,5039
California,El Dorado County,2,9,12210,5974,6236
California,El Dorado County,2,10,15516,7521,7995
California,El Dorado County,2,11,16831,8311,8520
California,El Dorado County,2,12,15145,7501,7644
California,El Dorado County,2,13,12970,6533,6437
California,El Dorado County,2,14,9141,4519,4622
California,El Dorado County,2,15,6296,3148,3148
California,El Dorado County,2,16,4656,2294,2362
California,El Dorado County,2,17,3313,1432,1881
California,El Dorado County,2,18,3118,1163,1955
California,El Dorado County,3,0,181133,90589,90544
California,El Dorado County,3,1,9407,4812,4595
California,El Dorado County,3,2,11095,5643,5452
California,El Dorado County,3,3,12431,6374,6057
California,El Dorado County,3,4,12463,6515,5948
California,El Dorado County,3,5,9067,4929,4138
California,El Dorado County,3,6,8704,4557,4147
California,El Dorado County,3,7,8598,4322,4276
California,El Dorado County,3,8,9878,4899,4979
California,El Dorado County,3,9,12156,5958,6198
California,El Dorado County,3,10,15359,7446,7913
California,El Dorado County,3,11,16828,8297,8531
California,El Dorado County,3,12,15208,7524,7684
California,El Dorado County,3,13,13162,6627,6535
California,El Dorado County,3,14,9232,4565,4667
California,El Dorado County,3,15,6382,3191,3191
California,El Dorado County,3,16,4661,2303,2358
California,El Dorado County,3,17,3341,1452,1889
California,El Dorado County,3,18,3161,1175,1986
California,El Dorado County,4,0,180918,90437,90481
California,El Dorado County,4,1,8915,4580,4335
California,El Dorado County,4,2,10997,5607,5390
California,El Dorado County,4,3,12193,6208,5985
California,El Dorado County,4,4,12203,6391,5812
California,El Dorado County,4,5,9564,5099,4465
California,El Dorado County,4,6,8671,4561,4110
California,El Dorado County,4,7,8635,4398,4237
California,El Dorado County,4,8,9260,4616,4644
California,El Dorado County,4,9,11868,5816,6052
California,El Dorado County,4,10,14584,7089,7495
California,El Dorado County,4,11,16832,8243,8589
California,El Dorado County,4,12,15443,7614,7829
California,El Dorado County,4,13,13909,6987,6922
California,El Dorado County,4,14,9648,4766,4882
California,El Dorado County,4,15,6730,3343,3387
California,El Dorado County,4,16,4694,2334,2360
California,El Dorado County,4,17,3439,1548,1891
California,El Dorado County,4,18,3333,1237,2096
California,El Dorado County,5,0,180578,90232,90346
California,El Dorado County,5,1,8578,4391,4187
California,El Dorado County,5,2,10911,5594,5317
California,El Dorado County,5,3,11906,6076,5830
California,El Dorado County,5,4,11938,6234,5704
California,El Dorado County,5,5,9849,5216,4633
California,El Dorado County,5,6,8523,4508,4015
California,El Dorado County,5,7,8833,4483,4350
California,El Dorado County,5,8,8992,4451,4541
California,El Dorado County,5,9,11568,5715,5853
California,El Dorado County,5,10,13618,6612,7006
California,El Dorado County,5,11,16557,8114,8443
California,El Dorado County,5,12,15741,7664,8077
California,El Dorado County,5,13,13863,7020,6843
California,El Dorado County,5,14,10767,5316,5451
California,El Dorado County,5,15,7155,3527,3628
California,El Dorado County,5,16,4847,2416,2431
California,El Dorado County,5,17,3501,1611,1890
California,El Dorado County,5,18,3431,1284,2147
California,El Dorado County,6,0,181497,90701,90796
California,El Dorado County,6,1,8340,4274,4066
California,El Dorado County,6,2,10714,5497,5217
California,El Dorado County,6,3,11887,6103,5784
California,El Dorado County,6,4,11742,6078,5664
California,El Dorado County,6,5,9973,5311,4662
California,El Dorado County,6,6,8540,4527,4013
California,El Dorado County,6,7,9103,4574,4529
California,El Dorado County,6,8,9018,4464,4554
California,El Dorado County,6,9,11368,5648,5720
California,El Dorado County,6,10,12881,6306,6575
California,El Dorado County,6,11,16100,7878,8222
California,El Dorado County,6,12,16151,7895,8256
California,El Dorado County,6,13,14269,7133,7136
California,El Dorado County,6,14,11302,5611,5691
California,El Dorado County,6,15,7782,3817,3965
California,El Dorado County,6,16,5094,2522,2572
California,El Dorado County,6,17,3630,1709,1921
California,El Dorado County,6,18,3603,1354,2249
California,El Dorado County,7,0,183161,91564,91597
California,El Dorado County,7,1,8462,4364,4098
California,El Dorado County,7,2,10592,5430,5162
California,El Dorado County,7,3,11695,6015,5680
California,El Dorado County,7,4,11651,6080,5571
California,El Dorado County,7,5,10168,5397,4771
California,El Dorado County,7,6,8811,4649,4162
California,El Dorado County,7,7,9245,4701,4544
California,El Dorado County,7,8,9259,4576,4683
California,El Dorado County,7,9,10950,5438,5512
California,El Dorado County,7,10,12515,6145,6370
California,El Dorado County,7,11,15645,7647,7998
California,El Dorado County,7,12,16376,8008,8368
California,El Dorado County,7,13,14566,7210,7356
California,El Dorado County,7,14,12105,6049,6056
California,El Dorado County,7,15,8197,3998,4199
California,El Dorado County,7,16,5405,2655,2750
California,El Dorado County,7,17,3748,1776,1972
California,El Dorado County,7,18,3771,1426,2345
California,El Dorado County,8,0,184660,92194,92466
California,El Dorado County,8,1,8676,4472,4204
California,El Dorado County,8,2,10312,5286,5026
California,El Dorado County,8,3,11603,5968,5635
California,El Dorado County,8,4,11462,5963,5499
California,El Dorado County,8,5,10170,5350,4820
California,El Dorado County,8,6,9004,4709,4295
California,El Dorado County,8,7,9418,4832,4586
California,El Dorado County,8,8,9630,4786,4844
California,El Dorado County,8,9,10594,5279,5315
California,El Dorado County,8,10,12429,6088,6341
California,El Dorado County,8,11,15118,7354,7764
California,El Dorado County,8,12,16567,8124,8443
California,El Dorado County,8,13,14746,7257,7489
California,El Dorado County,8,14,12865,6408,6457
California,El Dorado County,8,15,8647,4221,4426
California,El Dorado County,8,16,5694,2797,2897
California,El Dorado County,8,17,3820,1824,1996
California,El Dorado County,8,18,3905,1476,2429
California,El Dorado County,9,0,186082,92747,93335
California,El Dorado County,9,1,8663,4468,4195
California,El Dorado County,9,2,10126,5172,4954
California,El Dorado County,9,3,11683,5979,5704
California,El Dorado County,9,4,11236,5851,5385
California,El Dorado County,9,5,9930,5154,4776
California,El Dorado County,9,6,9117,4766,4351
California,El Dorado County,9,7,9515,4863,4652
California,El Dorado County,9,8,9981,4960,5021
California,El Dorado County,9,9,10232,5133,5099
California,El Dorado County,9,10,12465,6116,6349
California,El Dorado County,9,11,14573,7133,7440
California,El Dorado County,9,12,16698,8162,8536
California,El Dorado County,9,13,15119,7402,7717
California,El Dorado County,9,14,13623,6785,6838
California,El Dorado County,9,15,9135,4435,4700
California,El Dorado County,9,16,6040,2946,3094
California,El Dorado County,9,17,3843,1871,1972
California,El Dorado County,9,18,4103,1551,2552
California,El Dorado County,10,0,188722,94081,94641
California,El Dorado County,10,1,8712,4463,4249
California,El Dorado County,10,2,10120,5159,4961
California,El Dorado County,10,3,11840,6072,5768
California,El Dorado County,10,4,11140,5822,5318
California,El Dorado County,10,5,9693,5025,4668
California,El Dorado County,10,6,9641,5064,4577
California,El Dorado County,10,7,9624,4937,4687
California,El Dorado County,10,8,10529,5224,5305
California,El Dorado County,10,9,10218,5082,5136
California,El Dorado County,10,10,12307,6062,6245
California,El Dorado County,10,11,13955,6865,7090
California,El Dorado County,10,12,16621,8102,8519
California,El Dorado County,10,13,15770,7628,8142
California,El Dorado County,10,14,13685,6886,6799
California,El Dorado County,10,15,10245,5010,5235
California,El Dorado County,10,16,6403,3116,3287
California,El Dorado County,10,17,3967,1914,2053
California,El Dorado County,10,18,4252,1650,2602
California,El Dorado County,11,0,190678,95091,95587
California,El Dorado County,11,1,8704,4427,4277
California,El Dorado County,11,2,10164,5243,4921
California,El Dorado County,11,3,11802,6004,5798
California,El Dorado County,11,4,11103,5803,5300
California,El Dorado County,11,5,9554,4934,4620
California,El Dorado County,11,6,9649,5125,4524
California,El Dorado County,11,7,9799,5011,4788
California,El Dorado County,11,8,10898,5379,5519
California,El Dorado County,11,9,10515,5210,5305
California,El Dorado County,11,10,12189,6104,6085
California,El Dorado County,11,11,13360,6586,6774
California,El Dorado County,11,12,16346,7921,8425
California,El Dorado County,11,13,16206,7854,8352
California,El Dorado County,11,14,14190,7089,7101
California,El Dorado County,11,15,10754,5292,5462
California,El Dorado County,11,16,6926,3397,3529
California,El Dorado County,11,17,4191,1988,2203
California,El Dorado County,11,18,4328,1724,2604
California,Fresno County,1,0,930450,464811,465639
California,Fresno County,1,1,78980,40476,38504
California,Fresno County,1,2,75040,38161,36879
California,Fresno County,1,3,75409,38453,36956
California,Fresno County,1,4,81306,41878,39428
California,Fresno County,1,5,75290,38646,36644
California,Fresno County,1,6,70495,36186,34309
California,Fresno County,1,7,62234,31790,30444
California,Fresno County,1,8,57710,29033,28677
California,Fresno County,1,9,56659,28663,27996
California,Fresno County,1,10,59046,29446,29600
California,Fresno County,1,11,56006,27908,28098
California,Fresno County,1,12,48907,23911,24996
California,Fresno County,1,13,39947,19497,20450
California,Fresno County,1,14,28529,13580,14949
California,Fresno County,1,15,20970,9670,11300
California,Fresno County,1,16,16700,7145,9555
California,Fresno County,1,17,13604,5512,8092
California,Fresno County,1,18,13618,4856,8762
California,Fresno County,2,0,930496,464837,465659
California,Fresno County,2,1,78984,40478,38506
California,Fresno County,2,2,75043,38162,36881
California,Fresno County,2,3,75412,38454,36958
California,Fresno County,2,4,81313,41884,39429
California,Fresno County,2,5,75297,38650,36647
California,Fresno County,2,6,70498,36188,34310
California,Fresno County,2,7,62238,31791,30447
California,Fresno County,2,8,57714,29035,28679
California,Fresno County,2,9,56658,28662,27996
California,Fresno County,2,10,59046,29447,29599
California,Fresno County,2,11,56008,27909,28099
California,Fresno County,2,12,48909,23913,24996
California,Fresno County,2,13,39950,19499,20451
California,Fresno County,2,14,28528,13579,14949
California,Fresno County,2,15,20972,9671,11301
California,Fresno County,2,16,16704,7147,9557
California,Fresno County,2,17,13604,5512,8092
California,Fresno County,2,18,13618,4856,8762
California,Fresno County,3,0,932063,465317,466746
California,Fresno County,3,1,79104,40474,38630
California,Fresno County,3,2,75182,38269,36913
California,Fresno County,3,3,75249,38343,36906
California,Fresno County,3,4,80414,41391,39023
California,Fresno County,3,5,75935,38932,37003
California,Fresno County,3,6,70702,36268,34434
California,Fresno County,3,7,62652,31961,30691
California,Fresno County,3,8,57657,29026,28631
California,Fresno County,3,9,56728,28640,28088
California,Fresno County,3,10,58802,29335,29467
California,Fresno County,3,11,56230,27985,28245
California,Fresno County,3,12,49157,24031,25126
California,Fresno County,3,13,40379,19667,20712
California,Fresno County,3,14,28774,13711,15063
California,Fresno County,3,15,21104,9720,11384
California,Fresno County,3,16,16652,7145,9507
California,Fresno County,3,17,13640,5517,8123
California,Fresno County,3,18,13702,4902,8800
California,Fresno County,4,0,939479,468484,470995
California,Fresno County,4,1,79734,40637,39097
California,Fresno County,4,2,75979,38807,37172
California,Fresno County,4,3,74837,38186,36651
California,Fresno County,4,4,77212,39672,37540
California,Fresno County,4,5,78225,39947,38278
California,Fresno County,4,6,71373,36736,34637
California,Fresno County,4,7,64166,32564,31602
California,Fresno County,4,8,57443,29092,28351
California,Fresno County,4,9,57038,28551,28487
California,Fresno County,4,10,57706,28823,28883
California,Fresno County,4,11,57139,28290,28849
California,Fresno County,4,12,50013,24409,25604
California,Fresno County,4,13,42462,20614,21848
California,Fresno County,4,14,29882,14311,15571
California,Fresno County,4,15,21694,9954,11740
California,Fresno County,4,16,16810,7294,9516
California,Fresno County,4,17,13637,5522,8115
California,Fresno County,4,18,14129,5075,9054
California,Fresno County,5,0,945349,471208,474141
California,Fresno County,5,1,79580,40571,39009
California,Fresno County,5,2,77389,39728,37661
California,Fresno County,5,3,74162,37879,36283
California,Fresno County,5,4,75006,38370,36636
California,Fresno County,5,5,79312,40385,38927
California,Fresno County,5,6,71669,36975,34694
California,Fresno County,5,7,65732,33274,32458
California,Fresno County,5,8,57735,29326,28409
California,Fresno County,5,9,57032,28409,28623
California,Fresno County,5,10,56822,28433,28389
California,Fresno County,5,11,57211,28263,28948
California,Fresno County,5,12,50958,24890,26068
California,Fresno County,5,13,42994,20813,22181
California,Fresno County,5,14,32169,15406,16763
California,Fresno County,5,15,22549,10315,12234
California,Fresno County,5,16,17014,7459,9555
California,Fresno County,5,17,13567,5563,8004
California,Fresno County,5,18,14448,5149,9299
California,Fresno County,6,0,952029,474681,477348
California,Fresno County,6,1,78903,40189,38714
California,Fresno County,6,2,78665,40410,38255
California,Fresno County,6,3,74203,37711,36492
California,Fresno County,6,4,73639,37680,35959
California,Fresno County,6,5,79097,40322,38775
California,Fresno County,6,6,72504,37384,35120
California,Fresno County,6,7,67211,34118,33093
California,Fresno County,6,8,58707,29841,28866
California,Fresno County,6,9,56796,28353,28443
California,Fresno County,6,10,56050,28118,27932
California,Fresno County,6,11,57381,28422,28959
California,Fresno County,6,12,51986,25424,26562
California,Fresno County,6,13,43920,21244,22676
California,Fresno County,6,14,33807,16119,17688
California,Fresno County,6,15,23805,10967,12838
California,Fresno County,6,16,17336,7650,9686
California,Fresno County,6,17,13444,5513,7931
California,Fresno County,6,18,14575,5216,9359
California,Fresno County,7,0,961311,479704,481607
California,Fresno County,7,1,79486,40548,38938
California,Fresno County,7,2,79033,40526,38507
California,Fresno County,7,3,74694,37974,36720
California,Fresno County,7,4,72507,37020,35487
California,Fresno County,7,5,78519,40161,38358
California,Fresno County,7,6,74561,38406,36155
California,Fresno County,7,7,68287,34798,33489
California,Fresno County,7,8,59946,30407,29539
California,Fresno County,7,9,56584,28367,28217
California,Fresno County,7,10,55482,27838,27644
California,Fresno County,7,11,57606,28593,29013
California,Fresno County,7,12,52855,25941,26914
California,Fresno County,7,13,45030,21768,23262
California,Fresno County,7,14,35547,17027,18520
California,Fresno County,7,15,25026,11518,13508
California,Fresno County,7,16,17898,7965,9933
California,Fresno County,7,17,13322,5473,7849
California,Fresno County,7,18,14928,5374,9554
California,Fresno County,8,0,970442,484099,486343
California,Fresno County,8,1,79576,40570,39006
California,Fresno County,8,2,79490,40694,38796
California,Fresno County,8,3,75161,38249,36912
California,Fresno County,8,4,72327,36716,35611
California,Fresno County,8,5,76534,39114,37420
California,Fresno County,8,6,76985,39524,37461
California,Fresno County,8,7,68979,35327,33652
California,Fresno County,8,8,61794,31291,30503
California,Fresno County,8,9,56603,28414,28189
California,Fresno County,8,10,55584,28001,27583
California,Fresno County,8,11,56898,28262,28636
California,Fresno County,8,12,53708,26482,27226
California,Fresno County,8,13,46202,22141,24061
California,Fresno County,8,14,37491,18025,19466
California,Fresno County,8,15,26103,12095,14008
California,Fresno County,8,16,18511,8292,10219
California,Fresno County,8,17,13207,5376,7831
California,Fresno County,8,18,15289,5526,9763
California,Fresno County,9,0,977956,487685,490271
California,Fresno County,9,1,78850,40257,38593
California,Fresno County,9,2,80279,40989,39290
California,Fresno County,9,3,76343,38933,37410
California,Fresno County,9,4,71911,36529,35382
California,Fresno County,9,5,73552,37525,36027
California,Fresno County,9,6,79143,40508,38635
California,Fresno County,9,7,70230,36001,34229
California,Fresno County,9,8,63386,32127,31259
California,Fresno County,9,9,56556,28549,28007
California,Fresno County,9,10,55975,28113,27862
California,Fresno County,9,11,55814,27780,28034
California,Fresno County,9,12,54568,26816,27752
California,Fresno County,9,13,46914,22501,24413
California,Fresno County,9,14,39285,18801,20484
California,Fresno County,9,15,27078,12611,14467
California,Fresno County,9,16,19014,8421,10593
California,Fresno County,9,17,13374,5572,7802
California,Fresno County,9,18,15684,5652,10032
California,Fresno County,10,0,986542,492022,494520
California,Fresno County,10,1,77974,39755,38219
California,Fresno County,10,2,80696,41181,39515
California,Fresno County,10,3,78070,39978,38092
California,Fresno County,10,4,71427,36298,35129
California,Fresno County,10,5,71710,36462,35248
California,Fresno County,10,6,80635,41236,39399
California,Fresno County,10,7,71073,36518,34555
California,Fresno County,10,8,65338,33111,32227
California,Fresno County,10,9,57420,29038,28382
California,Fresno County,10,10,56050,28062,27988
California,Fresno County,10,11,55134,27532,27602
California,Fresno County,10,12,54828,26888,27940
California,Fresno County,10,13,47951,23114,24837
California,Fresno County,10,14,39831,19012,20819
California,Fresno County,10,15,29180,13576,15604
California,Fresno County,10,16,19741,8749,10992
California,Fresno County,10,17,13686,5806,7880
California,Fresno County,10,18,15798,5706,10092
California,Fresno County,11,0,994400,496016,498384
California,Fresno County,11,1,77299,39515,37784
California,Fresno County,11,2,80577,41032,39545
California,Fresno County,11,3,79551,40870,38681
California,Fresno County,11,4,71727,36379,35348
California,Fresno County,11,5,70764,35947,34817
California,Fresno County,11,6,80417,41056,39361
California,Fresno County,11,7,72036,37065,34971
California,Fresno County,11,8,67102,34041,33061
California,Fresno County,11,9,58541,29657,28884
California,Fresno County,11,10,55843,27918,27925
California,Fresno County,11,11,54618,27355,27263
California,Fresno County,11,12,54997,26910,28087
California,Fresno County,11,13,48815,23537,25278
California,Fresno County,11,14,40669,19398,21271
California,Fresno County,11,15,30698,14304,16394
California,Fresno County,11,16,20902,9301,11601
California,Fresno County,11,17,14028,5985,8043
California,Fresno County,11,18,15816,5746,10070
California,Glenn County,1,0,28122,14191,13931
California,Glenn County,1,1,2178,1116,1062
California,Glenn County,1,2,2115,1050,1065
California,Glenn County,1,3,2227,1163,1064
California,Glenn County,1,4,2156,1123,1033
California,Glenn County,1,5,1770,915,855
California,Glenn County,1,6,1818,966,852
California,Glenn County,1,7,1692,860,832
California,Glenn County,1,8,1635,817,818
California,Glenn County,1,9,1708,869,839
California,Glenn County,1,10,1909,946,963
California,Glenn County,1,11,1926,960,966
California,Glenn County,1,12,1817,943,874
California,Glenn County,1,13,1434,738,696
California,Glenn County,1,14,1165,596,569
California,Glenn County,1,15,881,422,459
California,Glenn County,1,16,673,302,371
California,Glenn County,1,17,512,223,289
California,Glenn County,1,18,506,182,324
California,Glenn County,2,0,28122,14191,13931
California,Glenn County,2,1,2178,1116,1062
California,Glenn County,2,2,2115,1050,1065
California,Glenn County,2,3,2227,1163,1064
California,Glenn County,2,4,2156,1123,1033
California,Glenn County,2,5,1770,915,855
California,Glenn County,2,6,1818,966,852
California,Glenn County,2,7,1692,860,832
California,Glenn County,2,8,1635,817,818
California,Glenn County,2,9,1708,869,839
California,Glenn County,2,10,1909,946,963
California,Glenn County,2,11,1926,960,966
California,Glenn County,2,12,1817,943,874
California,Glenn County,2,13,1434,738,696
California,Glenn County,2,14,1165,596,569
California,Glenn County,2,15,881,422,459
California,Glenn County,2,16,673,302,371
California,Glenn County,2,17,512,223,289
California,Glenn County,2,18,506,182,324
California,Glenn County,3,0,28126,14194,13932
California,Glenn County,3,1,2165,1108,1057
California,Glenn County,3,2,2117,1060,1057
California,Glenn County,3,3,2210,1147,1063
California,Glenn County,3,4,2150,1122,1028
California,Glenn County,3,5,1788,931,857
California,Glenn County,3,6,1798,951,847
California,Glenn County,3,7,1695,865,830
California,Glenn County,3,8,1628,811,817
California,Glenn County,3,9,1708,867,841
California,Glenn County,3,10,1897,943,954
California,Glenn County,3,11,1927,960,967
California,Glenn County,3,12,1826,943,883
California,Glenn County,3,13,1459,749,710
California,Glenn County,3,14,1162,592,570
California,Glenn County,3,15,893,433,460
California,Glenn County,3,16,673,303,370
California,Glenn County,3,17,515,223,292
California,Glenn County,3,18,515,186,329
California,Glenn County,4,0,28144,14214,13930
California,Glenn County,4,1,2163,1126,1037
California,Glenn County,4,2,2103,1071,1032
California,Glenn County,4,3,2161,1119,1042
California,Glenn County,4,4,2135,1113,1022
California,Glenn County,4,5,1829,955,874
California,Glenn County,4,6,1789,924,865
California,Glenn County,4,7,1719,887,832
California,Glenn County,4,8,1602,801,801
California,Glenn County,4,9,1660,828,832
California,Glenn County,4,10,1837,918,919
California,Glenn County,4,11,1920,966,954
California,Glenn County,4,12,1881,960,921
California,Glenn County,4,13,1546,791,755
California,Glenn County,4,14,1138,576,562
California,Glenn County,4,15,932,460,472
California,Glenn County,4,16,685,318,367
California,Glenn County,4,17,525,210,315
California,Glenn County,4,18,519,191,328
California,Glenn County,5,0,27860,14051,13809
California,Glenn County,5,1,2078,1073,1005
California,Glenn County,5,2,2083,1087,996
California,Glenn County,5,3,2110,1081,1029
California,Glenn County,5,4,2122,1108,1014
California,Glenn County,5,5,1812,935,877
California,Glenn County,5,6,1704,905,799
California,Glenn County,5,7,1743,877,866
California,Glenn County,5,8,1604,787,817
California,Glenn County,5,9,1588,797,791
California,Glenn County,5,10,1751,860,891
California,Glenn County,5,11,1911,973,938
California,Glenn County,5,12,1872,949,923
California,Glenn County,5,13,1589,801,788
California,Glenn County,5,14,1184,597,587
California,Glenn County,5,15,965,479,486
California,Glenn County,5,16,695,326,369
California,Glenn County,5,17,530,223,307
California,Glenn County,5,18,519,193,326
California,Glenn County,6,0,27826,14057,13769
California,Glenn County,6,1,2027,1047,980
California,Glenn County,6,2,2105,1097,1008
California,Glenn County,6,3,2062,1071,991
California,Glenn County,6,4,2086,1083,1003
California,Glenn County,6,5,1801,942,859
California,Glenn County,6,6,1737,912,825
California,Glenn County,6,7,1727,879,848
California,Glenn County,6,8,1610,790,820
California,Glenn County,6,9,1577,791,786
California,Glenn County,6,10,1665,819,846
California,Glenn County,6,11,1917,962,955
California,Glenn County,6,12,1898,961,937
California,Glenn County,6,13,1584,804,780
California,Glenn County,6,14,1216,629,587
California,Glenn County,6,15,1014,497,517
California,Glenn County,6,16,711,334,377
California,Glenn County,6,17,546,236,310
California,Glenn County,6,18,543,203,340
California,Glenn County,7,0,27857,14061,13796
California,Glenn County,7,1,2006,1067,939
California,Glenn County,7,2,2172,1118,1054
California,Glenn County,7,3,2014,1021,993
California,Glenn County,7,4,2102,1085,1017
California,Glenn County,7,5,1771,918,853
California,Glenn County,7,6,1790,923,867
California,Glenn County,7,7,1734,889,845
California,Glenn County,7,8,1623,813,810
California,Glenn County,7,9,1560,764,796
California,Glenn County,7,10,1570,804,766
California,Glenn County,7,11,1918,938,980
California,Glenn County,7,12,1866,943,923
California,Glenn County,7,13,1631,841,790
California,Glenn County,7,14,1258,632,626
California,Glenn County,7,15,1032,521,511
California,Glenn County,7,16,742,346,396
California,Glenn County,7,17,537,234,303
California,Glenn County,7,18,531,204,327
California,Glenn County,8,0,27776,14008,13768
California,Glenn County,8,1,1968,1041,927
California,Glenn County,8,2,2146,1100,1046
California,Glenn County,8,3,2048,1015,1033
California,Glenn County,8,4,2038,1053,985
California,Glenn County,8,5,1835,965,870
California,Glenn County,8,6,1743,897,846
California,Glenn County,8,7,1744,913,831
California,Glenn County,8,8,1649,811,838
California,Glenn County,8,9,1536,754,782
California,Glenn County,8,10,1543,791,752
California,Glenn County,8,11,1828,903,925
California,Glenn County,8,12,1867,936,931
California,Glenn County,8,13,1675,852,823
California,Glenn County,8,14,1314,669,645
California,Glenn County,8,15,1033,520,513
California,Glenn County,8,16,753,353,400
California,Glenn County,8,17,527,234,293
California,Glenn County,8,18,529,201,328
California,Glenn County,9,0,27851,14115,13736
California,Glenn County,9,1,1974,1026,948
California,Glenn County,9,2,2122,1127,995
California,Glenn County,9,3,2034,1018,1016
California,Glenn County,9,4,2036,1059,977
California,Glenn County,9,5,1844,954,890
California,Glenn County,9,6,1792,933,859
California,Glenn County,9,7,1704,890,814
California,Glenn County,9,8,1684,838,846
California,Glenn County,9,9,1510,750,760
California,Glenn County,9,10,1536,783,753
California,Glenn County,9,11,1767,877,890
California,Glenn County,9,12,1838,934,904
California,Glenn County,9,13,1735,886,849
California,Glenn County,9,14,1404,705,699
California,Glenn County,9,15,1028,516,512
California,Glenn County,9,16,786,388,398
California,Glenn County,9,17,523,232,291
California,Glenn County,9,18,534,199,335
California,Glenn County,10,0,27956,14172,13784
California,Glenn County,10,1,2009,1051,958
California,Glenn County,10,2,2095,1097,998
California,Glenn County,10,3,2086,1065,1021
California,Glenn County,10,4,1969,1018,951
California,Glenn County,10,5,1804,936,868
California,Glenn County,10,6,1873,982,891
California,Glenn County,10,7,1669,876,793
California,Glenn County,10,8,1742,879,863
California,Glenn County,10,9,1534,752,782
California,Glenn County,10,10,1509,770,739
California,Glenn County,10,11,1705,835,870
California,Glenn County,10,12,1858,963,895
California,Glenn County,10,13,1742,869,873
California,Glenn County,10,14,1409,705,704
California,Glenn County,10,15,1076,541,535
California,Glenn County,10,16,809,398,411
California,Glenn County,10,17,546,240,306
California,Glenn County,10,18,521,195,326
California,Glenn County,11,0,28047,14235,13812
California,Glenn County,11,1,1995,1043,952
California,Glenn County,11,2,2099,1104,995
California,Glenn County,11,3,2156,1103,1053
California,Glenn County,11,4,1922,1003,919
California,Glenn County,11,5,1806,933,873
California,Glenn County,11,6,1874,990,884
California,Glenn County,11,7,1747,906,841
California,Glenn County,11,8,1729,878,851
California,Glenn County,11,9,1521,752,769
California,Glenn County,11,10,1531,778,753
California,Glenn County,11,11,1617,792,825
California,Glenn County,11,12,1852,942,910
California,Glenn County,11,13,1745,876,869
California,Glenn County,11,14,1424,719,705
California,Glenn County,11,15,1108,563,545
California,Glenn County,11,16,836,407,429
California,Glenn County,11,17,540,241,299
California,Glenn County,11,18,545,205,340
California,Humboldt County,1,0,134623,67595,67028
California,Humboldt County,1,1,7738,3977,3761
California,Humboldt County,1,2,7324,3699,3625
California,Humboldt County,1,3,7242,3721,3521
California,Humboldt County,1,4,9531,4807,4724
California,Humboldt County,1,5,11878,6064,5814
California,Humboldt County,1,6,10743,5686,5057
California,Humboldt County,1,7,9252,4899,4353
California,Humboldt County,1,8,7989,4323,3666
California,Humboldt County,1,9,7079,3701,3378
California,Humboldt County,1,10,8771,4401,4370
California,Humboldt County,1,11,9978,4846,5132
California,Humboldt County,1,12,10339,5060,5279
California,Humboldt County,1,13,9034,4538,4496
California,Humboldt County,1,14,5691,2773,2918
California,Humboldt County,1,15,3980,1888,2092
California,Humboldt County,1,16,3040,1337,1703
California,Humboldt County,1,17,2449,1021,1428
California,Humboldt County,1,18,2565,854,1711
California,Humboldt County,2,0,134611,67589,67022
California,Humboldt County,2,1,7738,3977,3761
California,Humboldt County,2,2,7324,3699,3625
California,Humboldt County,2,3,7242,3721,3521
California,Humboldt County,2,4,9531,4807,4724
California,Humboldt County,2,5,11878,6064,5814
California,Humboldt County,2,6,10743,5686,5057
California,Humboldt County,2,7,9252,4899,4353
California,Humboldt County,2,8,7989,4323,3666
California,Humboldt County,2,9,7079,3701,3378
California,Humboldt County,2,10,8771,4401,4370
California,Humboldt County,2,11,9978,4846,5132
California,Humboldt County,2,12,10338,5060,5278
California,Humboldt County,2,13,9032,4536,4496
California,Humboldt County,2,14,5691,2773,2918
California,Humboldt County,2,15,3979,1888,2091
California,Humboldt County,2,16,3038,1335,1703
California,Humboldt County,2,17,2446,1020,1426
California,Humboldt County,2,18,2562,853,1709
California,Humboldt County,3,0,135000,67789,67211
California,Humboldt County,3,1,7736,3974,3762
California,Humboldt County,3,2,7330,3711,3619
California,Humboldt County,3,3,7234,3723,3511
California,Humboldt County,3,4,9629,4848,4781
California,Humboldt County,3,5,12141,6174,5967
California,Humboldt County,3,6,10606,5620,4986
California,Humboldt County,3,7,9376,4961,4415
California,Humboldt County,3,8,7988,4322,3666
California,Humboldt County,3,9,7130,3738,3392
California,Humboldt County,3,10,8640,4337,4303
California,Humboldt County,3,11,9900,4808,5092
California,Humboldt County,3,12,10346,5053,5293
California,Humboldt County,3,13,9148,4597,4551
California,Humboldt County,3,14,5755,2811,2944
California,Humboldt County,3,15,4018,1914,2104
California,Humboldt County,3,16,3013,1324,1689
California,Humboldt County,3,17,2444,1017,1427
California,Humboldt County,3,18,2566,857,1709
California,Humboldt County,4,0,135215,67836,67379
California,Humboldt County,4,1,7639,3931,3708
California,Humboldt County,4,2,7315,3753,3562
California,Humboldt County,4,3,7220,3705,3515
California,Humboldt County,4,4,9490,4804,4686
California,Humboldt County,4,5,12648,6303,6345
California,Humboldt County,4,6,9908,5265,4643
California,Humboldt County,4,7,9698,5079,4619
California,Humboldt County,4,8,7999,4315,3684
California,Humboldt County,4,9,7314,3871,3443
California,Humboldt County,4,10,8082,4066,4016
California,Humboldt County,4,11,9655,4713,4942
California,Humboldt County,4,12,10304,4988,5316
California,Humboldt County,4,13,9703,4877,4826
California,Humboldt County,4,14,5997,2936,3061
California,Humboldt County,4,15,4204,2037,2167
California,Humboldt County,4,16,2974,1305,1669
California,Humboldt County,4,17,2417,990,1427
California,Humboldt County,4,18,2648,898,1750
California,Humboldt County,5,0,134560,67343,67217
California,Humboldt County,5,1,7331,3735,3596
California,Humboldt County,5,2,7397,3775,3622
California,Humboldt County,5,3,7191,3666,3525
California,Humboldt County,5,4,9252,4669,4583
California,Humboldt County,5,5,13048,6458,6590
California,Humboldt County,5,6,9142,4839,4303
California,Humboldt County,5,7,9795,5133,4662
California,Humboldt County,5,8,8223,4399,3824
California,Humboldt County,5,9,7371,3947,3424
California,Humboldt County,5,10,7623,3828,3795
California,Humboldt County,5,11,9287,4550,4737
California,Humboldt County,5,12,10117,4860,5257
California,Humboldt County,5,13,9664,4786,4878
California,Humboldt County,5,14,6688,3318,3370
California,Humboldt County,5,15,4343,2118,2225
California,Humboldt County,5,16,3042,1375,1667
California,Humboldt County,5,17,2378,968,1410
California,Humboldt County,5,18,2668,919,1749
California,Humboldt County,6,0,134407,67165,67242
California,Humboldt County,6,1,7383,3751,3632
California,Humboldt County,6,2,7492,3826,3666
California,Humboldt County,6,3,7059,3579,3480
California,Humboldt County,6,4,9107,4586,4521
California,Humboldt County,6,5,13241,6494,6747
California,Humboldt County,6,6,8716,4599,4117
California,Humboldt County,6,7,9764,5109,4655
California,Humboldt County,6,8,8344,4467,3877
California,Humboldt County,6,9,7492,3988,3504
California,Humboldt County,6,10,7222,3643,3579
California,Humboldt County,6,11,9040,4464,4576
California,Humboldt County,6,12,9865,4761,5104
California,Humboldt County,6,13,9845,4782,5063
California,Humboldt County,6,14,7141,3575,3566
California,Humboldt County,6,15,4573,2222,2351
California,Humboldt County,6,16,3083,1418,1665
California,Humboldt County,6,17,2342,941,1401
California,Humboldt County,6,18,2698,960,1738
California,Humboldt County,7,0,134514,67217,67297
California,Humboldt County,7,1,7402,3771,3631
California,Humboldt County,7,2,7442,3845,3597
California,Humboldt County,7,3,7050,3537,3513
California,Humboldt County,7,4,8939,4497,4442
California,Humboldt County,7,5,13401,6614,6787
California,Humboldt County,7,6,8727,4616,4111
California,Humboldt County,7,7,9542,4948,4594
California,Humboldt County,7,8,8471,4478,3993
California,Humboldt County,7,9,7643,4031,3612
California,Humboldt County,7,10,6999,3580,3419
California,Humboldt County,7,11,8710,4331,4379
California,Humboldt County,7,12,9591,4623,4968
California,Humboldt County,7,13,9828,4753,5075
California,Humboldt County,7,14,7806,3859,3947
California,Humboldt County,7,15,4770,2301,2469
California,Humboldt County,7,16,3184,1490,1694
California,Humboldt County,7,17,2272,924,1348
California,Humboldt County,7,18,2737,1019,1718
California,Humboldt County,8,0,135114,67447,67667
California,Humboldt County,8,1,7479,3861,3618
California,Humboldt County,8,2,7395,3799,3596
California,Humboldt County,8,3,7159,3647,3512
California,Humboldt County,8,4,8844,4415,4429
California,Humboldt County,8,5,13276,6584,6692
California,Humboldt County,8,6,8884,4597,4287
California,Humboldt County,8,7,9273,4790,4483
California,Humboldt County,8,8,8778,4604,4174
California,Humboldt County,8,9,7731,4113,3618
California,Humboldt County,8,10,6968,3621,3347
California,Humboldt County,8,11,8277,4119,4158
California,Humboldt County,8,12,9478,4536,4942
California,Humboldt County,8,13,9749,4641,5108
California,Humboldt County,8,14,8459,4189,4270
California,Humboldt County,8,15,5047,2411,2636
California,Humboldt County,8,16,3347,1572,1775
California,Humboldt County,8,17,2247,952,1295
California,Humboldt County,8,18,2723,996,1727
California,Humboldt County,9,0,136314,68024,68290
California,Humboldt County,9,1,7464,3879,3585
California,Humboldt County,9,2,7421,3784,3637
California,Humboldt County,9,3,7249,3701,3548
California,Humboldt County,9,4,9015,4488,4527
California,Humboldt County,9,5,13040,6449,6591
California,Humboldt County,9,6,9295,4798,4497
California,Humboldt County,9,7,9032,4692,4340
California,Humboldt County,9,8,9253,4804,4449
California,Humboldt County,9,9,7796,4151,3645
California,Humboldt County,9,10,7215,3794,3421
California,Humboldt County,9,11,7777,3859,3918
California,Humboldt County,9,12,9312,4486,4826
California,Humboldt County,9,13,9655,4581,5074
California,Humboldt County,9,14,8981,4401,4580
California,Humboldt County,9,15,5286,2530,2756
California,Humboldt County,9,16,3534,1688,1846
California,Humboldt County,9,17,2232,949,1283
California,Humboldt County,9,18,2757,990,1767
California,Humboldt County,10,0,136527,68039,68488
California,Humboldt County,10,1,7454,3872,3582
California,Humboldt County,10,2,7194,3662,3532
California,Humboldt County,10,3,7304,3736,3568
California,Humboldt County,10,4,8972,4466,4506
California,Humboldt County,10,5,12902,6387,6515
California,Humboldt County,10,6,9655,4946,4709
California,Humboldt County,10,7,8635,4497,4138
California,Humboldt County,10,8,9437,4869,4568
California,Humboldt County,10,9,8105,4315,3790
California,Humboldt County,10,10,7308,3849,3459
California,Humboldt County,10,11,7457,3714,3743
California,Humboldt County,10,12,8991,4350,4641
California,Humboldt County,10,13,9524,4482,5042
California,Humboldt County,10,14,8907,4305,4602
California,Humboldt County,10,15,5980,2896,3084
California,Humboldt County,10,16,3670,1725,1945
California,Humboldt County,10,17,2295,995,1300
California,Humboldt County,10,18,2737,973,1764
California,Humboldt County,11,0,136373,67913,68460
California,Humboldt County,11,1,7251,3764,3487
California,Humboldt County,11,2,7209,3686,3523
California,Humboldt County,11,3,7394,3781,3613
California,Humboldt County,11,4,8904,4441,4463
California,Humboldt County,11,5,12667,6251,6416
California,Humboldt County,11,6,9823,5058,4765
California,Humboldt County,11,7,8311,4294,4017
California,Humboldt County,11,8,9464,4877,4587
California,Humboldt County,11,9,8373,4422,3951
California,Humboldt County,11,10,7417,3915,3502
California,Humboldt County,11,11,7069,3545,3524
California,Humboldt County,11,12,8788,4262,4526
California,Humboldt County,11,13,9323,4418,4905
California,Humboldt County,11,14,9062,4300,4762
California,Humboldt County,11,15,6364,3079,3285
California,Humboldt County,11,16,3844,1799,2045
California,Humboldt County,11,17,2377,1047,1330
California,Humboldt County,11,18,2733,974,1759
California,Imperial County,1,0,174528,89646,84882
California,Imperial County,1,1,13526,6874,6652
California,Imperial County,1,2,13841,7028,6813
California,Imperial County,1,3,14536,7593,6943
California,Imperial County,1,4,15047,7721,7326
California,Imperial County,1,5,13188,7235,5953
California,Imperial County,1,6,12511,7042,5469
California,Imperial County,1,7,11686,6558,5128
California,Imperial County,1,8,11374,6069,5305
California,Imperial County,1,9,11567,6057,5510
California,Imperial County,1,10,11413,5750,5663
California,Imperial County,1,11,11084,5518,5566
California,Imperial County,1,12,9236,4440,4796
California,Imperial County,1,13,7367,3526,3841
California,Imperial County,1,14,5371,2452,2919
California,Imperial County,1,15,4420,2099,2321
California,Imperial County,1,16,3618,1631,1987
California,Imperial County,1,17,2738,1247,1491
California,Imperial County,1,18,2005,806,1199
California,Imperial County,2,0,174524,89645,84879
California,Imperial County,2,1,13525,6874,6651
California,Imperial County,2,2,13841,7028,6813
California,Imperial County,2,3,14536,7593,6943
California,Imperial County,2,4,15047,7721,7326
California,Imperial County,2,5,13188,7235,5953
California,Imperial County,2,6,12510,7042,5468
California,Imperial County,2,7,11686,6558,5128
California,Imperial County,2,8,11374,6069,5305
California,Imperial County,2,9,11567,6057,5510
California,Imperial County,2,10,11413,5750,5663
California,Imperial County,2,11,11083,5517,5566
California,Imperial County,2,12,9236,4440,4796
California,Imperial County,2,13,7366,3526,3840
California,Imperial County,2,14,5371,2452,2919
California,Imperial County,2,15,4420,2099,2321
California,Imperial County,2,16,3618,1631,1987
California,Imperial County,2,17,2738,1247,1491
California,Imperial County,2,18,2005,806,1199
California,Imperial County,3,0,174730,89660,85070
California,Imperial County,3,1,13585,6898,6687
California,Imperial County,3,2,13844,7014,6830
California,Imperial County,3,3,14494,7567,6927
California,Imperial County,3,4,14982,7686,7296
California,Imperial County,3,5,13347,7321,6026
California,Imperial County,3,6,12575,7063,5512
California,Imperial County,3,7,11704,6560,5144
California,Imperial County,3,8,11299,6009,5290
California,Imperial County,3,9,11526,6023,5503
California,Imperial County,3,10,11362,5725,5637
California,Imperial County,3,11,11024,5483,5541
California,Imperial County,3,12,9301,4459,4842
California,Imperial County,3,13,7422,3554,3868
California,Imperial County,3,14,5394,2469,2925
California,Imperial County,3,15,4425,2094,2331
California,Imperial County,3,16,3631,1647,1984
California,Imperial County,3,17,2759,1257,1502
California,Imperial County,3,18,2056,831,1225
California,Imperial County,4,0,175813,90223,85590
California,Imperial County,4,1,14024,7160,6864
California,Imperial County,4,2,13740,6914,6826
California,Imperial County,4,3,14305,7445,6860
California,Imperial County,4,4,14704,7584,7120
California,Imperial County,4,5,13919,7650,6269
California,Imperial County,4,6,12720,7188,5532
California,Imperial County,4,7,11852,6640,5212
California,Imperial County,4,8,11066,5856,5210
California,Imperial County,4,9,11392,5949,5443
California,Imperial County,4,10,11196,5645,5551
California,Imperial County,4,11,10815,5374,5441
California,Imperial County,4,12,9683,4649,5034
California,Imperial County,4,13,7715,3704,4011
California,Imperial County,4,14,5508,2540,2968
California,Imperial County,4,15,4470,2054,2416
California,Imperial County,4,16,3684,1694,1990
California,Imperial County,4,17,2812,1279,1533
California,Imperial County,4,18,2208,898,1310
California,Imperial County,5,0,176678,90665,86013
California,Imperial County,5,1,14368,7389,6979
California,Imperial County,5,2,13807,6880,6927
California,Imperial County,5,3,13972,7232,6740
California,Imperial County,5,4,14367,7455,6912
California,Imperial County,5,5,14302,7898,6404
California,Imperial County,5,6,12767,7216,5551
California,Imperial County,5,7,12078,6751,5327
California,Imperial County,5,8,11061,5911,5150
California,Imperial County,5,9,11118,5765,5353
California,Imperial County,5,10,11001,5567,5434
California,Imperial County,5,11,10812,5385,5427
California,Imperial County,5,12,9841,4699,5142
California,Imperial County,5,13,7816,3767,4049
California,Imperial County,5,14,5877,2723,3154
California,Imperial County,5,15,4573,2064,2509
California,Imperial County,5,16,3704,1708,1996
California,Imperial County,5,17,2787,1263,1524
California,Imperial County,5,18,2427,992,1435
California,Imperial County,6,0,176605,90061,86544
California,Imperial County,6,1,14630,7531,7099
California,Imperial County,6,2,13801,6874,6927
California,Imperial County,6,3,13934,7157,6777
California,Imperial County,6,4,14104,7309,6795
California,Imperial County,6,5,14373,7840,6533
California,Imperial County,6,6,12652,7131,5521
California,Imperial County,6,7,12137,6672,5465
California,Imperial County,6,8,10819,5820,4999
California,Imperial County,6,9,10752,5506,5246
California,Imperial County,6,10,10755,5385,5370
California,Imperial County,6,11,10661,5289,5372
California,Imperial County,6,12,9977,4736,5241
California,Imperial County,6,13,7942,3787,4155
California,Imperial County,6,14,6200,2895,3305
California,Imperial County,6,15,4715,2133,2582
California,Imperial County,6,16,3766,1708,2058
California,Imperial County,6,17,2792,1231,1561
California,Imperial County,6,18,2595,1057,1538
California,Imperial County,7,0,178233,90997,87236
California,Imperial County,7,1,14979,7696,7283
California,Imperial County,7,2,13952,7036,6916
California,Imperial County,7,3,13905,7089,6816
California,Imperial County,7,4,13912,7277,6635
California,Imperial County,7,5,14441,7862,6579
California,Imperial County,7,6,13007,7344,5663
California,Imperial County,7,7,12317,6804,5513
California,Imperial County,7,8,10905,5901,5004
California,Imperial County,7,9,10597,5421,5176
California,Imperial County,7,10,10673,5379,5294
California,Imperial County,7,11,10600,5233,5367
California,Imperial County,7,12,10012,4774,5238
California,Imperial County,7,13,8151,3848,4303
California,Imperial County,7,14,6535,3107,3428
California,Imperial County,7,15,4824,2134,2690
California,Imperial County,7,16,3842,1735,2107
California,Imperial County,7,17,2830,1232,1598
California,Imperial County,7,18,2751,1125,1626
California,Imperial County,8,0,179179,91518,87661
California,Imperial County,8,1,15370,7842,7528
California,Imperial County,8,2,13836,7019,6817
California,Imperial County,8,3,13821,6997,6824
California,Imperial County,8,4,13848,7253,6595
California,Imperial County,8,5,14056,7635,6421
California,Imperial County,8,6,13439,7608,5831
California,Imperial County,8,7,12355,6867,5488
California,Imperial County,8,8,11112,6090,5022
California,Imperial County,8,9,10408,5302,5106
California,Imperial County,8,10,10632,5423,5209
California,Imperial County,8,11,10409,5097,5312
California,Imperial County,8,12,9961,4795,5166
California,Imperial County,8,13,8442,3952,4490
California,Imperial County,8,14,6828,3246,3582
California,Imperial County,8,15,4986,2217,2769
California,Imperial County,8,16,3851,1712,2139
California,Imperial County,8,17,2878,1255,1623
California,Imperial County,8,18,2947,1208,1739
California,Imperial County,9,0,180268,92104,88164
California,Imperial County,9,1,15292,7732,7560
California,Imperial County,9,2,14188,7233,6955
California,Imperial County,9,3,13843,6959,6884
California,Imperial County,9,4,13770,7197,6573
California,Imperial County,9,5,13735,7467,6268
California,Imperial County,9,6,13754,7784,5970
California,Imperial County,9,7,12540,7052,5488
California,Imperial County,9,8,11369,6221,5148
California,Imperial County,9,9,10299,5299,5000
California,Imperial County,9,10,10494,5305,5189
California,Imperial County,9,11,10269,5079,5190
California,Imperial County,9,12,9889,4774,5115
California,Imperial County,9,13,8701,4072,4629
California,Imperial County,9,14,7114,3373,3741
California,Imperial County,9,15,5123,2307,2816
California,Imperial County,9,16,3899,1689,2210
California,Imperial County,9,17,2971,1318,1653
California,Imperial County,9,18,3018,1243,1775
California,Imperial County,10,0,181574,93201,88373
California,Imperial County,10,1,15071,7648,7423
California,Imperial County,10,2,14469,7427,7042
California,Imperial County,10,3,13915,6955,6960
California,Imperial County,10,4,13514,7052,6462
California,Imperial County,10,5,13529,7475,6054
California,Imperial County,10,6,14200,8080,6120
California,Imperial County,10,7,12680,7170,5510
California,Imperial County,10,8,11691,6425,5266
California,Imperial County,10,9,10353,5446,4907
California,Imperial County,10,10,10377,5258,5119
California,Imperial County,10,11,10129,5033,5096
California,Imperial County,10,12,9869,4776,5093
California,Imperial County,10,13,8911,4159,4752
California,Imperial County,10,14,7242,3463,3779
California,Imperial County,10,15,5464,2456,3008
California,Imperial County,10,16,4038,1755,2283
California,Imperial County,10,17,2997,1331,1666
California,Imperial County,10,18,3125,1292,1833
California,Imperial County,11,0,181827,93235,88592
California,Imperial County,11,1,14889,7575,7314
California,Imperial County,11,2,14623,7585,7038
California,Imperial County,11,3,13986,6959,7027
California,Imperial County,11,4,13563,7032,6531
California,Imperial County,11,5,13089,7197,5892
California,Imperial County,11,6,14215,8034,6181
California,Imperial County,11,7,12697,7236,5461
California,Imperial County,11,8,12001,6551,5450
California,Imperial County,11,9,10202,5425,4777
California,Imperial County,11,10,10128,5100,5028
California,Imperial County,11,11,9995,4966,5029
California,Imperial County,11,12,9798,4749,5049
California,Imperial County,11,13,9061,4254,4807
California,Imperial County,11,14,7332,3435,3897
California,Imperial County,11,15,5780,2643,3137
California,Imperial County,11,16,4222,1859,2363
California,Imperial County,11,17,2996,1308,1688
California,Imperial County,11,18,3250,1327,1923
California,Inyo County,1,0,18546,9354,9192
California,Inyo County,1,1,1070,560,510
California,Inyo County,1,2,985,529,456
California,Inyo County,1,3,1134,580,554
California,Inyo County,1,4,1087,549,538
California,Inyo County,1,5,865,465,400
California,Inyo County,1,6,1041,519,522
California,Inyo County,1,7,979,522,457
California,Inyo County,1,8,977,506,471
California,Inyo County,1,9,992,494,498
California,Inyo County,1,10,1367,673,694
California,Inyo County,1,11,1594,821,773
California,Inyo County,1,12,1581,810,771
California,Inyo County,1,13,1339,678,661
California,Inyo County,1,14,1035,527,508
California,Inyo County,1,15,783,396,387
California,Inyo County,1,16,676,315,361
California,Inyo County,1,17,520,216,304
California,Inyo County,1,18,521,194,327
California,Inyo County,2,0,18542,9351,9191
California,Inyo County,2,1,1070,560,510
California,Inyo County,2,2,985,529,456
California,Inyo County,2,3,1134,580,554
California,Inyo County,2,4,1087,549,538
California,Inyo County,2,5,864,465,399
California,Inyo County,2,6,1040,518,522
California,Inyo County,2,7,979,522,457
California,Inyo County,2,8,977,506,471
California,Inyo County,2,9,992,494,498
California,Inyo County,2,10,1367,673,694
California,Inyo County,2,11,1594,821,773
California,Inyo County,2,12,1580,809,771
California,Inyo County,2,13,1339,678,661
California,Inyo County,2,14,1035,527,508
California,Inyo County,2,15,782,395,387
California,Inyo County,2,16,676,315,361
California,Inyo County,2,17,520,216,304
California,Inyo County,2,18,521,194,327
California,Inyo County,3,0,18512,9340,9172
California,Inyo County,3,1,1060,555,505
California,Inyo County,3,2,991,531,460
California,Inyo County,3,3,1116,573,543
California,Inyo County,3,4,1096,558,538
California,Inyo County,3,5,863,464,399
California,Inyo County,3,6,1029,512,517
California,Inyo County,3,7,987,526,461
California,Inyo County,3,8,960,496,464
California,Inyo County,3,9,996,502,494
California,Inyo County,3,10,1341,657,684
California,Inyo County,3,11,1586,814,772
California,Inyo County,3,12,1576,803,773
California,Inyo County,3,13,1361,692,669
California,Inyo County,3,14,1038,527,511
California,Inyo County,3,15,788,400,388
California,Inyo County,3,16,675,317,358
California,Inyo County,3,17,519,216,303
California,Inyo County,3,18,530,197,333
California,Inyo County,4,0,18393,9267,9126
California,Inyo County,4,1,1043,533,510
California,Inyo County,4,2,1015,534,481
California,Inyo County,4,3,1061,547,514
California,Inyo County,4,4,1134,586,548
California,Inyo County,4,5,871,466,405
California,Inyo County,4,6,1000,504,496
California,Inyo County,4,7,1015,536,479
California,Inyo County,4,8,911,475,436
California,Inyo County,4,9,1022,511,511
California,Inyo County,4,10,1236,621,615
California,Inyo County,4,11,1533,776,757
California,Inyo County,4,12,1582,781,801
California,Inyo County,4,13,1408,723,685
California,Inyo County,4,14,1054,533,521
California,Inyo County,4,15,788,405,383
California,Inyo County,4,16,665,317,348
California,Inyo County,4,17,502,218,284
California,Inyo County,4,18,553,201,352
California,Inyo County,5,0,18353,9227,9126
California,Inyo County,5,1,1067,544,523
California,Inyo County,5,2,1017,528,489
California,Inyo County,5,3,1034,542,492
California,Inyo County,5,4,1122,584,538
California,Inyo County,5,5,888,460,428
California,Inyo County,5,6,974,495,479
California,Inyo County,5,7,1051,545,506
California,Inyo County,5,8,938,496,442
California,Inyo County,5,9,1022,511,511
California,Inyo County,5,10,1108,550,558
California,Inyo County,5,11,1513,744,769
California,Inyo County,5,12,1589,786,803
California,Inyo County,5,13,1389,712,677
California,Inyo County,5,14,1112,572,540
California,Inyo County,5,15,804,407,397
California,Inyo County,5,16,656,318,338
California,Inyo County,5,17,498,224,274
California,Inyo County,5,18,571,209,362
California,Inyo County,6,0,18360,9207,9153
California,Inyo County,6,1,1089,559,530
California,Inyo County,6,2,1046,540,506
California,Inyo County,6,3,1031,548,483
California,Inyo County,6,4,1095,551,544
California,Inyo County,6,5,900,447,453
California,Inyo County,6,6,924,481,443
California,Inyo County,6,7,1084,563,521
California,Inyo County,6,8,957,507,450
California,Inyo County,6,9,971,491,480
California,Inyo County,6,10,1028,490,538
California,Inyo County,6,11,1474,742,732
California,Inyo County,6,12,1616,801,815
California,Inyo County,6,13,1409,712,697
California,Inyo County,6,14,1139,593,546
California,Inyo County,6,15,847,422,425
California,Inyo County,6,16,652,314,338
California,Inyo County,6,17,524,240,284
California,Inyo County,6,18,574,206,368
California,Inyo County,7,0,18320,9191,9129
California,Inyo County,7,1,1095,559,536
California,Inyo County,7,2,1056,537,519
California,Inyo County,7,3,991,526,465
California,Inyo County,7,4,1068,540,528
California,Inyo County,7,5,879,438,441
California,Inyo County,7,6,923,485,438
California,Inyo County,7,7,1080,558,522
California,Inyo County,7,8,997,526,471
California,Inyo County,7,9,950,481,469
California,Inyo County,7,10,1003,492,511
California,Inyo County,7,11,1398,700,698
California,Inyo County,7,12,1594,796,798
California,Inyo County,7,13,1436,723,713
California,Inyo County,7,14,1180,607,573
California,Inyo County,7,15,895,445,450
California,Inyo County,7,16,671,319,352
California,Inyo County,7,17,525,250,275
California,Inyo County,7,18,579,209,370
California,Inyo County,8,0,18174,9107,9067
California,Inyo County,8,1,1077,543,534
California,Inyo County,8,2,1068,548,520
California,Inyo County,8,3,957,512,445
California,Inyo County,8,4,1053,548,505
California,Inyo County,8,5,849,412,437
California,Inyo County,8,6,882,460,422
California,Inyo County,8,7,1084,550,534
California,Inyo County,8,8,988,534,454
California,Inyo County,8,9,927,464,463
California,Inyo County,8,10,978,486,492
California,Inyo County,8,11,1289,634,655
California,Inyo County,8,12,1561,790,771
California,Inyo County,8,13,1477,724,753
California,Inyo County,8,14,1242,626,616
California,Inyo County,8,15,924,468,456
California,Inyo County,8,16,682,334,348
California,Inyo County,8,17,555,253,302
California,Inyo County,8,18,581,221,360
California,Inyo County,9,0,17996,9046,8950
California,Inyo County,9,1,1054,538,516
California,Inyo County,9,2,1037,541,496
California,Inyo County,9,3,968,506,462
California,Inyo County,9,4,990,526,464
California,Inyo County,9,5,847,438,409
California,Inyo County,9,6,881,457,424
California,Inyo County,9,7,1080,550,530
California,Inyo County,9,8,1007,533,474
California,Inyo County,9,9,911,470,441
California,Inyo County,9,10,951,467,484
California,Inyo County,9,11,1174,579,595
California,Inyo County,9,12,1513,754,759
California,Inyo County,9,13,1519,739,780
California,Inyo County,9,14,1281,655,626
California,Inyo County,9,15,919,456,463
California,Inyo County,9,16,706,345,361
California,Inyo County,9,17,539,252,287
California,Inyo County,9,18,619,240,379
California,Inyo County,10,0,17948,9059,8889
California,Inyo County,10,1,1027,536,491
California,Inyo County,10,2,1047,558,489
California,Inyo County,10,3,995,503,492
California,Inyo County,10,4,940,506,434
California,Inyo County,10,5,852,448,404
California,Inyo County,10,6,889,449,440
California,Inyo County,10,7,1060,546,514
California,Inyo County,10,8,1043,553,490
California,Inyo County,10,9,919,486,433
California,Inyo County,10,10,996,496,500
California,Inyo County,10,11,1053,519,534
California,Inyo County,10,12,1516,734,782
California,Inyo County,10,13,1481,722,759
California,Inyo County,10,14,1284,661,623
California,Inyo County,10,15,989,500,489
California,Inyo County,10,16,706,340,366
California,Inyo County,10,17,523,253,270
California,Inyo County,10,18,628,249,379
California,Inyo County,11,0,17987,9044,8943
California,Inyo County,11,1,1011,501,510
California,Inyo County,11,2,1083,574,509
California,Inyo County,11,3,1019,522,497
California,Inyo County,11,4,928,500,428
California,Inyo County,11,5,828,428,400
California,Inyo County,11,6,893,439,454
California,Inyo County,11,7,1063,549,514
California,Inyo County,11,8,1110,584,526
California,Inyo County,11,9,915,476,439
California,Inyo County,11,10,965,490,475
California,Inyo County,11,11,994,475,519
California,Inyo County,11,12,1461,727,734
California,Inyo County,11,13,1507,731,776
California,Inyo County,11,14,1316,667,649
California,Inyo County,11,15,1002,525,477
California,Inyo County,11,16,731,337,394
California,Inyo County,11,17,536,262,274
California,Inyo County,11,18,625,257,368
California,Kern County,1,0,839631,433108,406523
California,Kern County,1,1,72885,36952,35933
California,Kern County,1,2,68694,35022,33672
California,Kern County,1,3,68473,34899,33574
California,Kern County,1,4,72493,37862,34631
California,Kern County,1,5,65339,35895,29444
California,Kern County,1,6,63630,34949,28681
California,Kern County,1,7,58416,31585,26831
California,Kern County,1,8,54558,28846,25712
California,Kern County,1,9,53942,28542,25400
California,Kern County,1,10,55879,28993,26886
California,Kern County,1,11,52600,26980,25620
California,Kern County,1,12,43233,21756,21477
California,Kern County,1,13,34052,16807,17245
California,Kern County,1,14,25040,12058,12982
California,Kern County,1,15,18462,8752,9710
California,Kern County,1,16,13555,6076,7479
California,Kern County,1,17,9918,4109,5809
California,Kern County,1,18,8462,3025,5437
California,Kern County,2,0,839619,433102,406517
California,Kern County,2,1,72885,36952,35933
California,Kern County,2,2,68694,35022,33672
California,Kern County,2,3,68471,34898,33573
California,Kern County,2,4,72489,37860,34629
California,Kern County,2,5,65339,35895,29444
California,Kern County,2,6,63630,34949,28681
California,Kern County,2,7,58416,31585,26831
California,Kern County,2,8,54558,28846,25712
California,Kern County,2,9,53940,28541,25399
California,Kern County,2,10,55876,28992,26884
California,Kern County,2,11,52599,26979,25620
California,Kern County,2,12,43233,21756,21477
California,Kern County,2,13,34052,16807,17245
California,Kern County,2,14,25040,12058,12982
California,Kern County,2,15,18462,8752,9710
California,Kern County,2,16,13555,6076,7479
California,Kern County,2,17,9918,4109,5809
California,Kern County,2,18,8462,3025,5437
California,Kern County,3,0,841072,433493,407579
California,Kern County,3,1,72903,36967,35936
California,Kern County,3,2,68844,35060,33784
California,Kern County,3,3,68467,34898,33569
California,Kern County,3,4,71925,37580,34345
California,Kern County,3,5,65859,36064,29795
California,Kern County,3,6,63773,35012,28761
California,Kern County,3,7,58599,31648,26951
California,Kern County,3,8,54527,28778,25749
California,Kern County,3,9,53875,28431,25444
California,Kern County,3,10,55652,28872,26780
California,Kern County,3,11,52782,27029,25753
California,Kern County,3,12,43658,21996,21662
California,Kern County,3,13,34392,16943,17449
California,Kern County,3,14,25149,12106,13043
California,Kern County,3,15,18596,8825,9771
California,Kern County,3,16,13618,6120,7498
California,Kern County,3,17,9907,4110,5797
California,Kern County,3,18,8546,3054,5492
California,Kern County,4,0,848140,436445,411695
California,Kern County,4,1,72986,36955,36031
California,Kern County,4,2,69639,35366,34273
California,Kern County,4,3,68382,34829,33553
California,Kern County,4,4,69878,36518,33360
California,Kern County,4,5,68290,37174,31116
California,Kern County,4,6,64739,35528,29211
California,Kern County,4,7,59596,32125,27471
California,Kern County,4,8,54447,28703,25744
California,Kern County,4,9,53740,28188,25552
California,Kern County,4,10,54423,28275,26148
California,Kern County,4,11,53336,27212,26124
California,Kern County,4,12,45171,22831,22340
California,Kern County,4,13,35934,17589,18345
California,Kern County,4,14,25756,12402,13354
California,Kern County,4,15,19252,9180,10072
California,Kern County,4,16,13882,6288,7594
California,Kern County,4,17,9806,4067,5739
California,Kern County,4,18,8883,3215,5668
California,Kern County,5,0,853963,437448,416515
California,Kern County,5,1,72863,36875,35988
California,Kern County,5,2,71393,36177,35216
California,Kern County,5,3,68376,34800,33576
California,Kern County,5,4,68362,35540,32822
California,Kern County,5,5,69734,37621,32113
California,Kern County,5,6,64991,35414,29577
California,Kern County,5,7,60266,32316,27950
California,Kern County,5,8,54278,28434,25844
California,Kern County,5,9,53164,27606,25558
California,Kern County,5,10,53204,27474,25730
California,Kern County,5,11,53502,27162,26340
California,Kern County,5,12,46616,23515,23101
California,Kern County,5,13,36379,17841,18538
California,Kern County,5,14,27679,13229,14450
California,Kern County,5,15,19961,9526,10435
California,Kern County,5,16,14157,6467,7690
California,Kern County,5,17,9904,4128,5776
California,Kern County,5,18,9134,3323,5811
California,Kern County,6,0,862557,441454,421103
California,Kern County,6,1,72899,36887,36012
California,Kern County,6,2,73126,37045,36081
California,Kern County,6,3,68740,34986,33754
California,Kern County,6,4,67247,34853,32394
California,Kern County,6,5,70760,38026,32734
California,Kern County,6,6,66080,35955,30125
California,Kern County,6,7,61735,33059,28676
California,Kern County,6,8,54689,28705,25984
California,Kern County,6,9,53067,27485,25582
California,Kern County,6,10,52102,26853,25249
California,Kern County,6,11,53611,27050,26561
California,Kern County,6,12,47625,24117,23508
California,Kern County,6,13,37350,18490,18860
California,Kern County,6,14,28665,13648,15017
California,Kern County,6,15,21005,9969,11036
California,Kern County,6,16,14540,6691,7849
California,Kern County,6,17,10026,4256,5770
California,Kern County,6,18,9290,3379,5911
California,Kern County,7,0,869957,445804,424153
California,Kern County,7,1,72460,36823,35637
California,Kern County,7,2,73821,37472,36349
California,Kern County,7,3,69157,35140,34017
California,Kern County,7,4,66396,34372,32024
California,Kern County,7,5,71165,38339,32826
California,Kern County,7,6,67510,36571,30939
California,Kern County,7,7,63008,34021,28987
California,Kern County,7,8,55545,29293,26252
California,Kern County,7,9,52791,27377,25414
California,Kern County,7,10,51337,26531,24806
California,Kern County,7,11,53224,26781,26443
California,Kern County,7,12,48641,24631,24010
California,Kern County,7,13,38760,19170,19590
California,Kern County,7,14,29761,14248,15513
California,Kern County,7,15,21806,10325,11481
California,Kern County,7,16,15031,6942,8089
California,Kern County,7,17,10039,4262,5777
California,Kern County,7,18,9505,3506,5999
California,Kern County,8,0,877197,449827,427370
California,Kern County,8,1,72053,36729,35324
California,Kern County,8,2,74348,37634,36714
California,Kern County,8,3,69576,35341,34235
California,Kern County,8,4,65910,34096,31814
California,Kern County,8,5,70649,38014,32635
California,Kern County,8,6,69365,37654,31711
California,Kern County,8,7,63995,34563,29432
California,Kern County,8,8,56632,30020,26612
California,Kern County,8,9,52583,27285,25298
California,Kern County,8,10,51327,26538,24789
California,Kern County,8,11,52168,26285,25883
California,Kern County,8,12,49575,25049,24526
California,Kern County,8,13,40175,19815,20360
California,Kern County,8,14,31034,14969,16065
California,Kern County,8,15,22314,10544,11770
California,Kern County,8,16,15602,7283,8319
California,Kern County,8,17,10196,4386,5810
California,Kern County,8,18,9695,3622,6073
California,Kern County,9,0,882361,452336,430025
California,Kern County,9,1,71119,36209,34910
California,Kern County,9,2,74327,37629,36698
California,Kern County,9,3,70465,35663,34802
California,Kern County,9,4,65879,34147,31732
California,Kern County,9,5,68491,36852,31639
California,Kern County,9,6,71396,38589,32807
California,Kern County,9,7,64680,34981,29699
California,Kern County,9,8,57739,30675,27064
California,Kern County,9,9,52463,27327,25136
California,Kern County,9,10,51281,26431,24850
California,Kern County,9,11,51033,25748,25285
California,Kern County,9,12,50226,25263,24963
California,Kern County,9,13,41357,20571,20786
California,Kern County,9,14,32438,15542,16896
California,Kern County,9,15,23022,10873,12149
California,Kern County,9,16,16189,7589,8600
California,Kern County,9,17,10433,4560,5873
California,Kern County,9,18,9823,3687,6136
California,Kern County,10,0,888988,455785,433203
California,Kern County,10,1,70597,35991,34606
California,Kern County,10,2,74254,37634,36620
California,Kern County,10,3,72001,36409,35592
California,Kern County,10,4,65727,34011,31716
California,Kern County,10,5,66937,35982,30955
California,Kern County,10,6,72772,39268,33504
California,Kern County,10,7,65339,35374,29965
California,Kern County,10,8,59185,31504,27681
California,Kern County,10,9,52922,27786,25136
California,Kern County,10,10,51148,26261,24887
California,Kern County,10,11,50051,25288,24763
California,Kern County,10,12,50374,25265,25109
California,Kern County,10,13,42727,21307,21420
California,Kern County,10,14,32768,15793,16975
California,Kern County,10,15,24682,11597,13085
California,Kern County,10,16,16811,7821,8990
California,Kern County,10,17,10559,4657,5902
California,Kern County,10,18,10134,3837,6297
California,Kern County,11,0,896764,459690,437074
California,Kern County,11,1,69785,35578,34207
California,Kern County,11,2,74172,37604,36568
California,Kern County,11,3,73637,37336,36301
California,Kern County,11,4,66394,34327,32067
California,Kern County,11,5,65720,35265,30455
California,Kern County,11,6,73491,39711,33780
California,Kern County,11,7,66219,35776,30443
California,Kern County,11,8,60946,32421,28525
California,Kern County,11,9,53421,28149,25272
California,Kern County,11,10,51266,26272,24994
California,Kern County,11,11,49175,24873,24302
California,Kern County,11,12,50348,25079,25269
California,Kern County,11,13,43843,21937,21906
California,Kern County,11,14,33832,16408,17424
California,Kern County,11,15,25532,11964,13568
California,Kern County,11,16,17762,8248,9514
California,Kern County,11,17,10840,4837,6003
California,Kern County,11,18,10381,3905,6476
California,Kings County,1,0,152982,86344,66638
California,Kings County,1,1,12877,6543,6334
California,Kings County,1,2,11564,5904,5660
California,Kings County,1,3,11324,5749,5575
California,Kings County,1,4,11356,5947,5409
California,Kings County,1,5,13158,7927,5231
California,Kings County,1,6,13424,8282,5142
California,Kings County,1,7,12165,7435,4730
California,Kings County,1,8,11183,6962,4221
California,Kings County,1,9,10695,6699,3996
California,Kings County,1,10,10909,6683,4226
California,Kings County,1,11,9373,5547,3826
California,Kings County,1,12,7321,4194,3127
California,Kings County,1,13,5603,2940,2663
California,Kings County,1,14,3857,1997,1860
California,Kings County,1,15,2987,1412,1575
California,Kings County,1,16,2255,995,1260
California,Kings County,1,17,1554,643,911
California,Kings County,1,18,1377,485,892
California,Kings County,2,0,152982,86344,66638
California,Kings County,2,1,12877,6543,6334
California,Kings County,2,2,11564,5904,5660
California,Kings County,2,3,11324,5749,5575
California,Kings County,2,4,11356,5947,5409
California,Kings County,2,5,13158,7927,5231
California,Kings County,2,6,13424,8282,5142
California,Kings County,2,7,12165,7435,4730
California,Kings County,2,8,11183,6962,4221
California,Kings County,2,9,10695,6699,3996
California,Kings County,2,10,10909,6683,4226
California,Kings County,2,11,9373,5547,3826
California,Kings County,2,12,7321,4194,3127
California,Kings County,2,13,5603,2940,2663
California,Kings County,2,14,3857,1997,1860
California,Kings County,2,15,2987,1412,1575
California,Kings County,2,16,2255,995,1260
California,Kings County,2,17,1554,643,911
California,Kings County,2,18,1377,485,892
California,Kings County,3,0,152381,85712,66669
California,Kings County,3,1,12801,6515,6286
California,Kings County,3,2,11564,5889,5675
California,Kings County,3,3,11299,5731,5568
California,Kings County,3,4,11301,5915,5386
California,Kings County,3,5,13118,7863,5255
California,Kings County,3,6,13373,8213,5160
California,Kings County,3,7,12081,7357,4724
California,Kings County,3,8,11087,6873,4214
California,Kings County,3,9,10598,6616,3982
California,Kings County,3,10,10775,6574,4201
California,Kings County,3,11,9352,5498,3854
California,Kings County,3,12,7324,4176,3148
California,Kings County,3,13,5616,2947,2669
California,Kings County,3,14,3866,1985,1881
California,Kings County,3,15,2988,1415,1573
California,Kings County,3,16,2272,998,1274
California,Kings County,3,17,1573,652,921
California,Kings County,3,18,1393,495,898
California,Kings County,4,0,151886,85094,66792
California,Kings County,4,1,12712,6509,6203
California,Kings County,4,2,11643,5882,5761
California,Kings County,4,3,11188,5714,5474
California,Kings County,4,4,11007,5716,5291
California,Kings County,4,5,13140,7807,5333
California,Kings County,4,6,13329,8154,5175
California,Kings County,4,7,12019,7269,4750
California,Kings County,4,8,10910,6732,4178
California,Kings County,4,9,10424,6506,3918
California,Kings County,4,10,10507,6389,4118
California,Kings County,4,11,9356,5452,3904
California,Kings County,4,12,7448,4241,3207
California,Kings County,4,13,5776,3040,2736
California,Kings County,4,14,4004,2020,1984
California,Kings County,4,15,3035,1436,1599
California,Kings County,4,16,2321,1026,1295
California,Kings County,4,17,1621,673,948
California,Kings County,4,18,1446,528,918
California,Kings County,5,0,151026,84425,66601
California,Kings County,5,1,12185,6240,5945
California,Kings County,5,2,11738,5946,5792
California,Kings County,5,3,11029,5599,5430
California,Kings County,5,4,10737,5570,5167
California,Kings County,5,5,13189,7780,5409
California,Kings County,5,6,13212,8094,5118
California,Kings County,5,7,11990,7273,4717
California,Kings County,5,8,10891,6661,4230
California,Kings County,5,9,10263,6392,3871
California,Kings County,5,10,10180,6184,3996
California,Kings County,5,11,9293,5408,3885
California,Kings County,5,12,7613,4272,3341
California,Kings County,5,13,5780,3056,2724
California,Kings County,5,14,4268,2167,2101
California,Kings County,5,15,3161,1481,1680
California,Kings County,5,16,2356,1065,1291
California,Kings County,5,17,1643,676,967
California,Kings County,5,18,1498,561,937
California,Kings County,6,0,150416,83645,66771
California,Kings County,6,1,12067,6139,5928
California,Kings County,6,2,11988,6146,5842
California,Kings County,6,3,10806,5412,5394
California,Kings County,6,4,10687,5597,5090
California,Kings County,6,5,13214,7804,5410
California,Kings County,6,6,13089,7929,5160
California,Kings County,6,7,11912,7147,4765
California,Kings County,6,8,10685,6513,4172
California,Kings County,6,9,10019,6170,3849
California,Kings County,6,10,9793,5942,3851
California,Kings County,6,11,9243,5348,3895
California,Kings County,6,12,7657,4237,3420
California,Kings County,6,13,5910,3113,2797
California,Kings County,6,14,4448,2235,2213
California,Kings County,6,15,3246,1525,1721
California,Kings County,6,16,2398,1095,1303
California,Kings County,6,17,1665,695,970
California,Kings County,6,18,1589,598,991
California,Kings County,7,0,149603,82650,66953
California,Kings County,7,1,11828,6041,5787
California,Kings County,7,2,12026,6105,5921
California,Kings County,7,3,10814,5465,5349
California,Kings County,7,4,10596,5535,5061
California,Kings County,7,5,13205,7827,5378
California,Kings County,7,6,12960,7795,5165
California,Kings County,7,7,11959,7059,4900
California,Kings County,7,8,10525,6311,4214
California,Kings County,7,9,9762,5933,3829
California,Kings County,7,10,9366,5646,3720
California,Kings County,7,11,9081,5161,3920
California,Kings County,7,12,7698,4244,3454
California,Kings County,7,13,6007,3194,2813
California,Kings County,7,14,4618,2287,2331
California,Kings County,7,15,3295,1574,1721
California,Kings County,7,16,2481,1120,1361
California,Kings County,7,17,1749,747,1002
California,Kings County,7,18,1633,606,1027
California,Kings County,8,0,150199,82934,67265
California,Kings County,8,1,11860,6015,5845
California,Kings County,8,2,11993,6031,5962
California,Kings County,8,3,10825,5506,5319
California,Kings County,8,4,10528,5504,5024
California,Kings County,8,5,13157,7812,5345
California,Kings County,8,6,13021,7866,5155
California,Kings County,8,7,11921,7065,4856
California,Kings County,8,8,10793,6460,4333
California,Kings County,8,9,9679,5825,3854
California,Kings County,8,10,9289,5645,3644
California,Kings County,8,11,9009,5125,3884
California,Kings County,8,12,7772,4248,3524
California,Kings County,8,13,6133,3283,2850
California,Kings County,8,14,4813,2382,2431
California,Kings County,8,15,3347,1610,1737
California,Kings County,8,16,2566,1153,1413
California,Kings County,8,17,1787,756,1031
California,Kings County,8,18,1706,648,1058
California,Kings County,9,0,149509,82387,67122
California,Kings County,9,1,11593,5873,5720
California,Kings County,9,2,11890,5996,5894
California,Kings County,9,3,10836,5510,5326
California,Kings County,9,4,10433,5421,5012
California,Kings County,9,5,12776,7620,5156
California,Kings County,9,6,13122,7923,5199
California,Kings County,9,7,12026,7090,4936
California,Kings County,9,8,10757,6436,4321
California,Kings County,9,9,9503,5742,3761
California,Kings County,9,10,9166,5529,3637
California,Kings County,9,11,8770,4972,3798
California,Kings County,9,12,7791,4211,3580
California,Kings County,9,13,6245,3349,2896
California,Kings County,9,14,4956,2453,2503
California,Kings County,9,15,3484,1672,1812
California,Kings County,9,16,2544,1130,1414
California,Kings County,9,17,1847,803,1044
California,Kings County,9,18,1770,657,1113
California,Kings County,10,0,149696,82089,67607
California,Kings County,10,1,11481,5874,5607
California,Kings County,10,2,11837,5948,5889
California,Kings County,10,3,11113,5669,5444
California,Kings County,10,4,10347,5370,4977
California,Kings County,10,5,12677,7485,5192
California,Kings County,10,6,13270,7931,5339
California,Kings County,10,7,12073,7094,4979
California,Kings County,10,8,10756,6334,4422
California,Kings County,10,9,9496,5707,3789
California,Kings County,10,10,8917,5376,3541
California,Kings County,10,11,8469,4788,3681
California,Kings County,10,12,7813,4216,3597
California,Kings County,10,13,6414,3400,3014
California,Kings County,10,14,4973,2453,2520
California,Kings County,10,15,3701,1767,1934
California,Kings County,10,16,2668,1170,1498
California,Kings County,10,17,1864,821,1043
California,Kings County,10,18,1827,686,1141
California,Kings County,11,0,151366,83196,68170
California,Kings County,11,1,11371,5814,5557
California,Kings County,11,2,11885,5946,5939
California,Kings County,11,3,11490,5861,5629
California,Kings County,11,4,10164,5280,4884
California,Kings County,11,5,12660,7506,5154
California,Kings County,11,6,13439,8008,5431
California,Kings County,11,7,12303,7268,5035
California,Kings County,11,8,11130,6585,4545
California,Kings County,11,9,9685,5890,3795
California,Kings County,11,10,8975,5416,3559
California,Kings County,11,11,8391,4787,3604
California,Kings County,11,12,7841,4250,3591
California,Kings County,11,13,6516,3458,3058
California,Kings County,11,14,5086,2508,2578
California,Kings County,11,15,3893,1846,2047
California,Kings County,11,16,2741,1209,1532
California,Kings County,11,17,1928,844,1084
California,Kings County,11,18,1868,720,1148
California,Lake County,1,0,64665,32469,32196
California,Lake County,1,1,3633,1873,1760
California,Lake County,1,2,3574,1841,1733
California,Lake County,1,3,3888,2044,1844
California,Lake County,1,4,4190,2190,2000
California,Lake County,1,5,3362,1745,1617
California,Lake County,1,6,3346,1763,1583
California,Lake County,1,7,3257,1717,1540
California,Lake County,1,8,3255,1601,1654
California,Lake County,1,9,3840,1925,1915
California,Lake County,1,10,4725,2301,2424
California,Lake County,1,11,5530,2744,2786
California,Lake County,1,12,5468,2658,2810
California,Lake County,1,13,5157,2638,2519
California,Lake County,1,14,3791,1858,1933
California,Lake County,1,15,2762,1376,1386
California,Lake County,1,16,2007,989,1018
California,Lake County,1,17,1495,662,833
California,Lake County,1,18,1385,544,841
California,Lake County,2,0,64664,32468,32196
California,Lake County,2,1,3633,1873,1760
California,Lake County,2,2,3574,1841,1733
California,Lake County,2,3,3888,2044,1844
California,Lake County,2,4,4190,2190,2000
California,Lake County,2,5,3362,1745,1617
California,Lake County,2,6,3346,1763,1583
California,Lake County,2,7,3257,1717,1540
California,Lake County,2,8,3255,1601,1654
California,Lake County,2,9,3840,1925,1915
California,Lake County,2,10,4725,2301,2424
California,Lake County,2,11,5530,2744,2786
California,Lake County,2,12,5468,2658,2810
California,Lake County,2,13,5156,2637,2519
California,Lake County,2,14,3791,1858,1933
California,Lake County,2,15,2762,1376,1386
California,Lake County,2,16,2007,989,1018
California,Lake County,2,17,1495,662,833
California,Lake County,2,18,1385,544,841
California,Lake County,3,0,64735,32469,32266
California,Lake County,3,1,3632,1871,1761
California,Lake County,3,2,3575,1843,1732
California,Lake County,3,3,3853,2018,1835
California,Lake County,3,4,4141,2165,1976
California,Lake County,3,5,3421,1777,1644
California,Lake County,3,6,3380,1783,1597
California,Lake County,3,7,3261,1717,1544
California,Lake County,3,8,3225,1590,1635
California,Lake County,3,9,3830,1907,1923
California,Lake County,3,10,4693,2281,2412
California,Lake County,3,11,5529,2749,2780
California,Lake County,3,12,5489,2659,2830
California,Lake County,3,13,5203,2651,2552
California,Lake County,3,14,3833,1887,1946
California,Lake County,3,15,2776,1379,1397
California,Lake County,3,16,2016,990,1026
California,Lake County,3,17,1483,661,822
California,Lake County,3,18,1395,541,854
California,Lake County,4,0,64247,32160,32087
California,Lake County,4,1,3604,1886,1718
California,Lake County,4,2,3559,1839,1720
California,Lake County,4,3,3635,1882,1753
California,Lake County,4,4,3936,2053,1883
California,Lake County,4,5,3503,1839,1664
California,Lake County,4,6,3365,1767,1598
California,Lake County,4,7,3272,1727,1545
California,Lake County,4,8,3033,1498,1535
California,Lake County,4,9,3736,1818,1918
California,Lake County,4,10,4462,2151,2311
California,Lake County,4,11,5412,2685,2727
California,Lake County,4,12,5506,2639,2867
California,Lake County,4,13,5438,2748,2690
California,Lake County,4,14,3964,1980,1984
California,Lake County,4,15,2842,1409,1433
California,Lake County,4,16,2094,1022,1072
California,Lake County,4,17,1461,669,792
California,Lake County,4,18,1425,548,877
California,Lake County,5,0,63963,32031,31932
California,Lake County,5,1,3615,1882,1733
California,Lake County,5,2,3563,1838,1725
California,Lake County,5,3,3607,1841,1766
California,Lake County,5,4,3748,1995,1753
California,Lake County,5,5,3579,1872,1707
California,Lake County,5,6,3317,1727,1590
California,Lake County,5,7,3337,1771,1566
California,Lake County,5,8,3070,1557,1513
California,Lake County,5,9,3523,1680,1843
California,Lake County,5,10,4295,2107,2188
California,Lake County,5,11,5125,2503,2622
California,Lake County,5,12,5552,2660,2892
California,Lake County,5,13,5327,2655,2672
California,Lake County,5,14,4341,2187,2154
California,Lake County,5,15,2948,1479,1469
California,Lake County,5,16,2101,1033,1068
California,Lake County,5,17,1469,671,798
California,Lake County,5,18,1446,573,873
California,Lake County,6,0,63809,31875,31934
California,Lake County,6,1,3583,1828,1755
California,Lake County,6,2,3551,1868,1683
California,Lake County,6,3,3601,1821,1780
California,Lake County,6,4,3630,1975,1655
California,Lake County,6,5,3520,1828,1692
California,Lake County,6,6,3337,1712,1625
California,Lake County,6,7,3320,1761,1559
California,Lake County,6,8,3098,1574,1524
California,Lake County,6,9,3531,1684,1847
California,Lake County,6,10,4011,1939,2072
California,Lake County,6,11,4908,2382,2526
California,Lake County,6,12,5567,2693,2874
California,Lake County,6,13,5384,2652,2732
California,Lake County,6,14,4495,2265,2230
California,Lake County,6,15,3162,1583,1579
California,Lake County,6,16,2173,1063,1110
California,Lake County,6,17,1451,665,786
California,Lake County,6,18,1487,582,905
California,Lake County,7,0,64058,31957,32101
California,Lake County,7,1,3662,1827,1835
California,Lake County,7,2,3616,1903,1713
California,Lake County,7,3,3578,1814,1764
California,Lake County,7,4,3559,1902,1657
California,Lake County,7,5,3455,1785,1670
California,Lake County,7,6,3491,1831,1660
California,Lake County,7,7,3391,1751,1640
California,Lake County,7,8,3186,1649,1537
California,Lake County,7,9,3371,1624,1747
California,Lake County,7,10,3896,1893,2003
California,Lake County,7,11,4728,2302,2426
California,Lake County,7,12,5494,2637,2857
California,Lake County,7,13,5343,2609,2734
California,Lake County,7,14,4774,2418,2356
California,Lake County,7,15,3307,1631,1676
California,Lake County,7,16,2255,1107,1148
California,Lake County,7,17,1461,686,775
California,Lake County,7,18,1491,588,903
California,Lake County,8,0,64254,31998,32256
California,Lake County,8,1,3708,1860,1848
California,Lake County,8,2,3667,1879,1788
California,Lake County,8,3,3599,1839,1760
California,Lake County,8,4,3463,1812,1651
California,Lake County,8,5,3322,1754,1568
California,Lake County,8,6,3596,1871,1725
California,Lake County,8,7,3447,1780,1667
California,Lake County,8,8,3269,1667,1602
California,Lake County,8,9,3184,1552,1632
California,Lake County,8,10,3773,1863,1910
California,Lake County,8,11,4559,2188,2371
California,Lake County,8,12,5506,2661,2845
California,Lake County,8,13,5384,2569,2815
California,Lake County,8,14,5010,2561,2449
California,Lake County,8,15,3448,1688,1760
California,Lake County,8,16,2306,1136,1170
California,Lake County,8,17,1548,735,813
California,Lake County,8,18,1465,583,882
California,Lake County,9,0,63884,31833,32051
California,Lake County,9,1,3662,1833,1829
California,Lake County,9,2,3714,1930,1784
California,Lake County,9,3,3647,1883,1764
California,Lake County,9,4,3449,1781,1668
California,Lake County,9,5,3110,1677,1433
California,Lake County,9,6,3672,1908,1764
California,Lake County,9,7,3491,1805,1686
California,Lake County,9,8,3325,1697,1628
California,Lake County,9,9,3061,1505,1556
California,Lake County,9,10,3680,1782,1898
California,Lake County,9,11,4425,2135,2290
California,Lake County,9,12,5283,2568,2715
California,Lake County,9,13,5334,2500,2834
California,Lake County,9,14,5129,2617,2512
California,Lake County,9,15,3517,1730,1787
California,Lake County,9,16,2354,1153,1201
California,Lake County,9,17,1569,738,831
California,Lake County,9,18,1462,591,871
California,Lake County,10,0,64162,31945,32217
California,Lake County,10,1,3744,1863,1881
California,Lake County,10,2,3748,1912,1836
California,Lake County,10,3,3692,1912,1780
California,Lake County,10,4,3400,1747,1653
California,Lake County,10,5,3041,1636,1405
California,Lake County,10,6,3741,1944,1797
California,Lake County,10,7,3544,1808,1736
California,Lake County,10,8,3442,1786,1656
California,Lake County,10,9,3163,1588,1575
California,Lake County,10,10,3592,1681,1911
California,Lake County,10,11,4286,2125,2161
California,Lake County,10,12,5065,2421,2644
California,Lake County,10,13,5382,2535,2847
California,Lake County,10,14,4953,2521,2432
California,Lake County,10,15,3889,1917,1972
California,Lake County,10,16,2455,1221,1234
California,Lake County,10,17,1579,740,839
California,Lake County,10,18,1446,588,858
California,Lake County,11,0,64382,32140,32242
California,Lake County,11,1,3779,1891,1888
California,Lake County,11,2,3771,1926,1845
California,Lake County,11,3,3734,1949,1785
California,Lake County,11,4,3423,1762,1661
California,Lake County,11,5,3017,1630,1387
California,Lake County,11,6,3676,1915,1761
California,Lake County,11,7,3690,1864,1826
California,Lake County,11,8,3507,1806,1701
California,Lake County,11,9,3222,1640,1582
California,Lake County,11,10,3607,1707,1900
California,Lake County,11,11,4076,1994,2082
California,Lake County,11,12,4852,2353,2499
California,Lake County,11,13,5393,2562,2831
California,Lake County,11,14,4943,2454,2489
California,Lake County,11,15,4023,2018,2005
California,Lake County,11,16,2645,1315,1330
California,Lake County,11,17,1583,763,820
California,Lake County,11,18,1441,591,850
California,Lassen County,1,0,34895,22416,12479
California,Lassen County,1,1,1625,866,759
California,Lassen County,1,2,1595,850,745
California,Lassen County,1,3,1853,933,920
California,Lassen County,1,4,2107,1203,904
California,Lassen County,1,5,2831,2199,632
California,Lassen County,1,6,3343,2635,708
California,Lassen County,1,7,2994,2335,659
California,Lassen County,1,8,2807,2031,776
California,Lassen County,1,9,2706,1933,773
California,Lassen County,1,10,2853,1895,958
California,Lassen County,1,11,2594,1558,1036
California,Lassen County,1,12,2281,1258,1023
California,Lassen County,1,13,1832,1000,832
California,Lassen County,1,14,1190,634,556
California,Lassen County,1,15,794,410,384
California,Lassen County,1,16,584,304,280
California,Lassen County,1,17,457,209,248
California,Lassen County,1,18,449,163,286
California,Lassen County,2,0,34895,22416,12479
California,Lassen County,2,1,1625,866,759
California,Lassen County,2,2,1595,850,745
California,Lassen County,2,3,1853,933,920
California,Lassen County,2,4,2107,1203,904
California,Lassen County,2,5,2831,2199,632
California,Lassen County,2,6,3343,2635,708
California,Lassen County,2,7,2994,2335,659
California,Lassen County,2,8,2807,2031,776
California,Lassen County,2,9,2706,1933,773
California,Lassen County,2,10,2853,1895,958
California,Lassen County,2,11,2594,1558,1036
California,Lassen County,2,12,2281,1258,1023
California,Lassen County,2,13,1832,1000,832
California,Lassen County,2,14,1190,634,556
California,Lassen County,2,15,794,410,384
California,Lassen County,2,16,584,304,280
California,Lassen County,2,17,457,209,248
California,Lassen County,2,18,449,163,286
California,Lassen County,3,0,34832,22407,12425
California,Lassen County,3,1,1618,854,764
California,Lassen County,3,2,1587,848,739
California,Lassen County,3,3,1839,933,906
California,Lassen County,3,4,2070,1179,891
California,Lassen County,3,5,2861,2220,641
California,Lassen County,3,6,3359,2652,707
California,Lassen County,3,7,2994,2328,666
California,Lassen County,3,8,2797,2045,752
California,Lassen County,3,9,2705,1934,771
California,Lassen County,3,10,2824,1875,949
California,Lassen County,3,11,2580,1555,1025
California,Lassen County,3,12,2269,1246,1023
California,Lassen County,3,13,1861,1018,843
California,Lassen County,3,14,1187,631,556
California,Lassen County,3,15,797,411,386
California,Lassen County,3,16,583,304,279
California,Lassen County,3,17,452,210,242
California,Lassen County,3,18,449,164,285
California,Lassen County,4,0,34238,22079,12159
California,Lassen County,4,1,1545,776,769
California,Lassen County,4,2,1527,821,706
California,Lassen County,4,3,1731,889,842
California,Lassen County,4,4,1952,1121,831
California,Lassen County,4,5,2865,2211,654
California,Lassen County,4,6,3368,2663,705
California,Lassen County,4,7,2934,2276,658
California,Lassen County,4,8,2742,2051,691
California,Lassen County,4,9,2638,1893,745
California,Lassen County,4,10,2719,1814,905
California,Lassen County,4,11,2534,1553,981
California,Lassen County,4,12,2212,1200,1012
California,Lassen County,4,13,1935,1067,868
California,Lassen County,4,14,1208,632,576
California,Lassen County,4,15,809,411,398
California,Lassen County,4,16,584,303,281
California,Lassen County,4,17,474,223,251
California,Lassen County,4,18,461,175,286
California,Lassen County,5,0,33624,21664,11960
California,Lassen County,5,1,1549,771,778
California,Lassen County,5,2,1526,809,717
California,Lassen County,5,3,1625,858,767
California,Lassen County,5,4,1919,1077,842
California,Lassen County,5,5,2792,2153,639
California,Lassen County,5,6,3291,2606,685
California,Lassen County,5,7,2912,2252,660
California,Lassen County,5,8,2633,1998,635
California,Lassen County,5,9,2592,1826,766
California,Lassen County,5,10,2630,1766,864
California,Lassen County,5,11,2447,1528,919
California,Lassen County,5,12,2177,1159,1018
California,Lassen County,5,13,1877,1053,824
California,Lassen County,5,14,1318,694,624
California,Lassen County,5,15,853,433,420
California,Lassen County,5,16,562,286,276
California,Lassen County,5,17,466,216,250
California,Lassen County,5,18,455,179,276
California,Lassen County,6,0,32126,20371,11755
California,Lassen County,6,1,1497,736,761
California,Lassen County,6,2,1490,781,709
California,Lassen County,6,3,1581,831,750
California,Lassen County,6,4,1879,1057,822
California,Lassen County,6,5,2590,1959,631
California,Lassen County,6,6,3012,2370,642
California,Lassen County,6,7,2758,2087,671
California,Lassen County,6,8,2441,1827,614
California,Lassen County,6,9,2396,1665,731
California,Lassen County,6,10,2383,1598,785
California,Lassen County,6,11,2318,1422,896
California,Lassen County,6,12,2106,1129,977
California,Lassen County,6,13,1836,1016,820
California,Lassen County,6,14,1417,729,688
California,Lassen County,6,15,904,452,452
California,Lassen County,6,16,576,298,278
California,Lassen County,6,17,467,223,244
California,Lassen County,6,18,475,191,284
California,Lassen County,7,0,31710,20214,11496
California,Lassen County,7,1,1419,695,724
California,Lassen County,7,2,1437,739,698
California,Lassen County,7,3,1476,782,694
California,Lassen County,7,4,1788,993,795
California,Lassen County,7,5,2588,1969,619
California,Lassen County,7,6,3000,2381,619
California,Lassen County,7,7,2784,2119,665
California,Lassen County,7,8,2377,1794,583
California,Lassen County,7,9,2351,1646,705
California,Lassen County,7,10,2297,1577,720
California,Lassen County,7,11,2280,1398,882
California,Lassen County,7,12,2037,1131,906
California,Lassen County,7,13,1887,1025,862
California,Lassen County,7,14,1485,758,727
California,Lassen County,7,15,947,491,456
California,Lassen County,7,16,614,295,319
California,Lassen County,7,17,451,223,228
California,Lassen County,7,18,492,198,294
California,Lassen County,8,0,31383,19811,11572
California,Lassen County,8,1,1437,699,738
California,Lassen County,8,2,1425,755,670
California,Lassen County,8,3,1439,744,695
California,Lassen County,8,4,1730,950,780
California,Lassen County,8,5,2574,1928,646
California,Lassen County,8,6,3014,2341,673
California,Lassen County,8,7,2714,2054,660
California,Lassen County,8,8,2338,1732,606
California,Lassen County,8,9,2255,1581,674
California,Lassen County,8,10,2200,1512,688
California,Lassen County,8,11,2161,1323,838
California,Lassen County,8,12,2013,1106,907
California,Lassen County,8,13,1929,1021,908
California,Lassen County,8,14,1541,802,739
California,Lassen County,8,15,1013,520,493
California,Lassen County,8,16,638,308,330
California,Lassen County,8,17,450,227,223
California,Lassen County,8,18,512,208,304
California,Lassen County,9,0,30906,19243,11663
California,Lassen County,9,1,1480,738,742
California,Lassen County,9,2,1434,716,718
California,Lassen County,9,3,1430,758,672
California,Lassen County,9,4,1682,946,736
California,Lassen County,9,5,2474,1819,655
California,Lassen County,9,6,2962,2249,713
California,Lassen County,9,7,2640,1966,674
California,Lassen County,9,8,2273,1641,632
California,Lassen County,9,9,2152,1517,635
California,Lassen County,9,10,2129,1432,697
California,Lassen County,9,11,2103,1274,829
California,Lassen County,9,12,1980,1099,881
California,Lassen County,9,13,1875,953,922
California,Lassen County,9,14,1595,842,753
California,Lassen County,9,15,1048,530,518
California,Lassen County,9,16,666,322,344
California,Lassen County,9,17,452,225,227
California,Lassen County,9,18,531,216,315
California,Lassen County,10,0,31123,19479,11644
California,Lassen County,10,1,1531,806,725
California,Lassen County,10,2,1443,698,745
California,Lassen County,10,3,1472,784,688
California,Lassen County,10,4,1542,881,661
California,Lassen County,10,5,2457,1828,629
California,Lassen County,10,6,3054,2329,725
California,Lassen County,10,7,2682,1989,693
California,Lassen County,10,8,2358,1708,650
California,Lassen County,10,9,2149,1543,606
California,Lassen County,10,10,2115,1412,703
California,Lassen County,10,11,2022,1224,798
California,Lassen County,10,12,1970,1119,851
California,Lassen County,10,13,1856,930,926
California,Lassen County,10,14,1583,849,734
California,Lassen County,10,15,1173,584,589
California,Lassen County,10,16,707,343,364
California,Lassen County,10,17,469,233,236
California,Lassen County,10,18,540,219,321
California,Lassen County,11,0,30802,19155,11647
California,Lassen County,11,1,1533,793,740
California,Lassen County,11,2,1454,701,753
California,Lassen County,11,3,1439,758,681
California,Lassen County,11,4,1515,871,644
California,Lassen County,11,5,2364,1763,601
California,Lassen County,11,6,2999,2269,730
California,Lassen County,11,7,2706,2010,696
California,Lassen County,11,8,2361,1676,685
California,Lassen County,11,9,2134,1524,610
California,Lassen County,11,10,2062,1365,697
California,Lassen County,11,11,1882,1152,730
California,Lassen County,11,12,1850,1036,814
California,Lassen County,11,13,1836,918,918
California,Lassen County,11,14,1633,875,758
California,Lassen County,11,15,1257,618,639
California,Lassen County,11,16,740,353,387
California,Lassen County,11,17,467,239,228
California,Lassen County,11,18,570,234,336
California,Los Angeles County,1,0,9818605,4839654,4978951
California,Los Angeles County,1,1,645793,330265,315528
California,Los Angeles County,1,2,633690,323676,310014
California,Los Angeles County,1,3,678845,347102,331743
California,Los Angeles County,1,4,753630,385012,368618
California,Los Angeles County,1,5,752788,385393,367395
California,Los Angeles County,1,6,759602,386393,373209
California,Los Angeles County,1,7,716129,360263,355866
California,Los Angeles County,1,8,715635,356358,359277
California,Los Angeles County,1,9,714691,357282,357409
California,Los Angeles County,1,10,706742,349671,357071
California,Los Angeles County,1,11,662205,323330,338875
California,Los Angeles County,1,12,560920,269289,291631
California,Los Angeles County,1,13,452236,212254,239982
California,Los Angeles County,1,14,323287,148148,175139
California,Los Angeles County,1,15,245183,109338,135845
California,Los Angeles County,1,16,192881,82327,110554
California,Los Angeles County,1,17,152722,60853,91869
California,Los Angeles County,1,18,151626,52700,98926
California,Los Angeles County,2,0,9818672,4839698,4978974
California,Los Angeles County,2,1,645794,330266,315528
California,Los Angeles County,2,2,633690,323676,310014
California,Los Angeles County,2,3,678848,347104,331744
California,Los Angeles County,2,4,753654,385032,368622
California,Los Angeles County,2,5,752787,385393,367394
California,Los Angeles County,2,6,759599,386391,373208
California,Los Angeles County,2,7,716128,360263,355865
California,Los Angeles County,2,8,715634,356357,359277
California,Los Angeles County,2,9,714700,357285,357415
California,Los Angeles County,2,10,706748,349675,357073
California,Los Angeles County,2,11,662210,323336,338874
California,Los Angeles County,2,12,560933,269296,291637
California,Los Angeles County,2,13,452242,212259,239983
California,Los Angeles County,2,14,323293,148150,175143
California,Los Angeles County,2,15,245185,109339,135846
California,Los Angeles County,2,16,192878,82324,110554
California,Los Angeles County,2,17,152723,60853,91870
California,Los Angeles County,2,18,151626,52699,98927
California,Los Angeles County,3,0,9822433,4840523,4981910
California,Los Angeles County,3,1,644688,329736,314952
California,Los Angeles County,3,2,631426,322444,308982
California,Los Angeles County,3,3,674516,344683,329833
California,Los Angeles County,3,4,748522,382389,366133
California,Los Angeles County,3,5,755987,386519,369468
California,Los Angeles County,3,6,759854,386503,373351
California,Los Angeles County,3,7,717408,361082,356326
California,Los Angeles County,3,8,711823,354278,357545
California,Los Angeles County,3,9,715106,357328,357778
California,Los Angeles County,3,10,705456,349121,356335
California,Los Angeles County,3,11,664082,324480,339602
California,Los Angeles County,3,12,564912,271278,293634
California,Los Angeles County,3,13,456661,214329,242332
California,Los Angeles County,3,14,326069,149461,176608
California,Los Angeles County,3,15,246522,110006,136516
California,Los Angeles County,3,16,192926,82374,110552
California,Los Angeles County,3,17,153125,61173,91952
California,Los Angeles County,3,18,153350,53339,100011
California,Los Angeles County,4,0,9876727,4864955,5011772
California,Los Angeles County,4,1,646079,330573,315506
California,Los Angeles County,4,2,627645,320654,306991
California,Los Angeles County,4,3,660534,337226,323308
California,Los Angeles County,4,4,729397,372408,356989
California,Los Angeles County,4,5,772705,393249,379456
California,Los Angeles County,4,6,767849,391138,376711
California,Los Angeles County,4,7,725787,366062,359725
California,Los Angeles County,4,8,697082,346381,350701
California,Los Angeles County,4,9,720914,359519,361395
California,Los Angeles County,4,10,700621,346985,353636
California,Los Angeles County,4,11,670868,328578,342290
California,Los Angeles County,4,12,581576,279394,302182
California,Los Angeles County,4,13,477318,224209,253109
California,Los Angeles County,4,14,337346,154731,182615
California,Los Angeles County,4,15,252370,112630,139740
California,Los Angeles County,4,16,195381,83641,111740
California,Los Angeles County,4,17,153785,61932,91853
California,Los Angeles County,4,18,159470,55645,103825
California,Los Angeles County,5,0,9938436,4895014,5043422
California,Los Angeles County,5,1,641648,328106,313542
California,Los Angeles County,5,2,630185,322181,308004
California,Los Angeles County,5,3,646971,330273,316698
California,Los Angeles County,5,4,711856,362898,348958
California,Los Angeles County,5,5,783103,397398,385705
California,Los Angeles County,5,6,776617,396445,380172
California,Los Angeles County,5,7,736413,372018,364395
California,Los Angeles County,5,8,692474,344368,348106
California,Los Angeles County,5,9,722627,359803,362824
California,Los Angeles County,5,10,696467,345118,351349
California,Los Angeles County,5,11,676012,331800,344212
California,Los Angeles County,5,12,599034,288203,310831
California,Los Angeles County,5,13,484275,227455,256820
California,Los Angeles County,5,14,361919,166615,195304
California,Los Angeles County,5,15,260705,116479,144226
California,Los Angeles County,5,16,198875,85222,113653
California,Los Angeles County,5,17,153920,62490,91430
California,Los Angeles County,5,18,165335,58142,107193
California,Los Angeles County,6,0,9998105,4925307,5072798
California,Los Angeles County,6,1,638410,326430,311980
California,Los Angeles County,6,2,631836,322977,308859
California,Los Angeles County,6,3,635788,324367,311421
California,Los Angeles County,6,4,696813,354798,342015
California,Los Angeles County,6,5,782074,396666,385408
California,Los Angeles County,6,6,791802,404446,387356
California,Los Angeles County,6,7,748058,378881,369177
California,Los Angeles County,6,8,691846,345040,346806
California,Los Angeles County,6,9,717047,356218,360829
California,Los Angeles County,6,10,692794,344252,348542
California,Los Angeles County,6,11,681933,335177,346756
California,Los Angeles County,6,12,614157,295885,318272
California,Los Angeles County,6,13,496232,233422,262810
California,Los Angeles County,6,14,379081,174878,204203
California,Los Angeles County,6,15,272041,121440,150601
California,Los Angeles County,6,16,203762,87573,116189
California,Los Angeles County,6,17,154400,62849,91551
California,Los Angeles County,6,18,170031,60008,110023
California,Los Angeles County,7,0,10048408,4950666,5097742
California,Los Angeles County,7,1,638865,327066,311799
California,Los Angeles County,7,2,627843,321339,306504
California,Los Angeles County,7,3,628001,320279,307722
California,Los Angeles County,7,4,680380,346026,334354
California,Los Angeles County,7,5,775757,392679,383078
California,Los Angeles County,7,6,811039,414313,396726
California,Los Angeles County,7,7,755030,383148,371882
California,Los Angeles County,7,8,692580,346336,346244
California,Los Angeles County,7,9,706450,350367,356083
California,Los Angeles County,7,10,689986,343199,346787
California,Los Angeles County,7,11,686786,337948,348838
California,Los Angeles County,7,12,624798,301753,323045
California,Los Angeles County,7,13,511349,241541,269808
California,Los Angeles County,7,14,397077,182951,214126
California,Los Angeles County,7,15,282207,125766,156441
California,Los Angeles County,7,16,209420,90253,119167
California,Los Angeles County,7,17,155350,63429,91921
California,Los Angeles County,7,18,175490,62273,113217
California,Los Angeles County,8,0,10097037,4975652,5121385
California,Los Angeles County,8,1,637517,326692,310825
California,Los Angeles County,8,2,623279,319033,304246
California,Los Angeles County,8,3,619622,316084,303538
California,Los Angeles County,8,4,669002,340218,328784
California,Los Angeles County,8,5,759170,383993,375177
California,Los Angeles County,8,6,832033,424831,407202
California,Los Angeles County,8,7,759734,385708,374026
California,Los Angeles County,8,8,698836,350829,348007
California,Los Angeles County,8,9,692620,343237,349383
California,Los Angeles County,8,10,695520,346122,349398
California,Los Angeles County,8,11,683820,336669,347151
California,Los Angeles County,8,12,635514,307826,327688
California,Los Angeles County,8,13,528277,250540,277737
California,Los Angeles County,8,14,415797,191389,224408
California,Los Angeles County,8,15,293472,130964,162508
California,Los Angeles County,8,16,214870,92791,122079
California,Los Angeles County,8,17,156650,64054,92596
California,Los Angeles County,8,18,181304,64672,116632
California,Los Angeles County,9,0,10120540,4987687,5132853
California,Los Angeles County,9,1,627368,321642,305726
California,Los Angeles County,9,2,621089,317885,303204
California,Los Angeles County,9,3,613222,312867,300355
California,Los Angeles County,9,4,655441,333361,322080
California,Los Angeles County,9,5,737960,372800,365160
California,Los Angeles County,9,6,851322,433830,417492
California,Los Angeles County,9,7,767623,391469,376154
California,Los Angeles County,9,8,706459,355461,350998
California,Los Angeles County,9,9,677599,335583,342016
California,Los Angeles County,9,10,699686,347721,351965
California,Los Angeles County,9,11,678041,334469,343572
California,Los Angeles County,9,12,641175,311380,329795
California,Los Angeles County,9,13,542828,257819,285009
California,Los Angeles County,9,14,433913,199776,234137
California,Los Angeles County,9,15,302998,135340,167658
California,Los Angeles County,9,16,219717,95009,124708
California,Los Angeles County,9,17,158766,65007,93759
California,Los Angeles County,9,18,185333,66268,119065
California,Los Angeles County,10,0,10118759,4987994,5130765
California,Los Angeles County,10,1,616410,316186,300224
California,Los Angeles County,10,2,612551,313284,299267
California,Los Angeles County,10,3,612010,312851,299159
California,Los Angeles County,10,4,640766,325917,314849
California,Los Angeles County,10,5,718244,362195,356049
California,Los Angeles County,10,6,859298,437536,421762
California,Los Angeles County,10,7,773531,396062,377469
California,Los Angeles County,10,8,712331,359427,352904
California,Los Angeles County,10,9,669291,331515,337776
California,Los Angeles County,10,10,696756,345807,350949
California,Los Angeles County,10,11,670026,330777,339249
California,Los Angeles County,10,12,642762,312936,329826
California,Los Angeles County,10,13,556736,264866,291870
California,Los Angeles County,10,14,438327,201898,236429
California,Los Angeles County,10,15,323542,145056,178486
California,Los Angeles County,10,16,226031,97761,128270
California,Los Angeles County,10,17,161526,66239,95287
California,Los Angeles County,10,18,188621,67681,120940
California,Los Angeles County,11,0,10105518,4981895,5123623
California,Los Angeles County,11,1,603555,309680,293875
California,Los Angeles County,11,2,604698,309372,295326
California,Los Angeles County,11,3,610207,312086,298121
California,Los Angeles County,11,4,628932,319722,309210
California,Los Angeles County,11,5,700953,352925,348028
California,Los Angeles County,11,6,856120,435805,420315
California,Los Angeles County,11,7,783916,401667,382249
California,Los Angeles County,11,8,717928,363020,354908
California,Los Angeles County,11,9,663194,329493,333701
California,Los Angeles County,11,10,686882,340062,346820
California,Los Angeles County,11,11,661685,327276,334409
California,Los Angeles County,11,12,644318,314317,330001
California,Los Angeles County,11,13,567173,270049,297124
California,Los Angeles County,11,14,447152,206523,240629
California,Los Angeles County,11,15,337469,151633,185836
California,Los Angeles County,11,16,235061,101591,133470
California,Los Angeles County,11,17,164813,67774,97039
California,Los Angeles County,11,18,191462,68900,122562
California,Madera County,1,0,150865,72682,78183
California,Madera County,1,1,11983,6052,5931
California,Madera County,1,2,11756,5899,5857
California,Madera County,1,3,11755,6093,5662
California,Madera County,1,4,12224,6515,5709
California,Madera County,1,5,11032,5547,5485
California,Madera County,1,6,10541,4846,5695
California,Madera County,1,7,10021,4524,5497
California,Madera County,1,8,9661,4368,5293
California,Madera County,1,9,9506,4325,5181
California,Madera County,1,10,9893,4473,5420
California,Madera County,1,11,9398,4378,5020
California,Madera County,1,12,8467,3996,4471
California,Madera County,1,13,7366,3598,3768
California,Madera County,1,14,5642,2714,2928
California,Madera County,1,15,4226,2049,2177
California,Madera County,1,16,3240,1557,1683
California,Madera County,1,17,2228,988,1240
California,Madera County,1,18,1926,760,1166
California,Madera County,2,0,150841,72669,78172
California,Madera County,2,1,11979,6051,5928
California,Madera County,2,2,11755,5898,5857
California,Madera County,2,3,11754,6093,5661
California,Madera County,2,4,12220,6512,5708
California,Madera County,2,5,11026,5543,5483
California,Madera County,2,6,10540,4846,5694
California,Madera County,2,7,10019,4523,5496
California,Madera County,2,8,9661,4368,5293
California,Madera County,2,9,9505,4325,5180
California,Madera County,2,10,9893,4473,5420
California,Madera County,2,11,9397,4377,5020
California,Madera County,2,12,8466,3995,4471
California,Madera County,2,13,7366,3598,3768
California,Madera County,2,14,5642,2714,2928
California,Madera County,2,15,4226,2049,2177
California,Madera County,2,16,3238,1556,1682
California,Madera County,2,17,2228,988,1240
California,Madera County,2,18,1926,760,1166
California,Madera County,3,0,151006,72779,78227
California,Madera County,3,1,11978,6041,5937
California,Madera County,3,2,11800,5920,5880
California,Madera County,3,3,11748,6094,5654
California,Madera County,3,4,12136,6440,5696
California,Madera County,3,5,11100,5575,5525
California,Madera County,3,6,10554,4875,5679
California,Madera County,3,7,10046,4546,5500
California,Madera County,3,8,9632,4376,5256
California,Madera County,3,9,9493,4316,5177
California,Madera County,3,10,9853,4464,5389
California,Madera County,3,11,9410,4378,5032
California,Madera County,3,12,8492,4016,4476
California,Madera County,3,13,7456,3649,3807
California,Madera County,3,14,5641,2715,2926
California,Madera County,3,15,4269,2067,2202
California,Madera County,3,16,3224,1548,1676
California,Madera County,3,17,2234,994,1240
California,Madera County,3,18,1940,765,1175
California,Madera County,4,0,151702,73134,78568
California,Madera County,4,1,11940,6037,5903
California,Madera County,4,2,11860,5961,5899
California,Madera County,4,3,11753,6082,5671
California,Madera County,4,4,11819,6183,5636
California,Madera County,4,5,11349,5730,5619
California,Madera County,4,6,10668,4969,5699
California,Madera County,4,7,10169,4608,5561
California,Madera County,4,8,9455,4295,5160
California,Madera County,4,9,9513,4328,5185
California,Madera County,4,10,9668,4383,5285
California,Madera County,4,11,9436,4403,5033
California,Madera County,4,12,8576,4064,4512
California,Madera County,4,13,7829,3820,4009
California,Madera County,4,14,5759,2774,2985
California,Madera County,4,15,4435,2142,2293
California,Madera County,4,16,3222,1550,1672
California,Madera County,4,17,2289,1029,1260
California,Madera County,4,18,1962,776,1186
California,Madera County,5,0,151594,73517,78077
California,Madera County,5,1,11972,6047,5925
California,Madera County,5,2,11976,6023,5953
California,Madera County,5,3,11680,6022,5658
California,Madera County,5,4,11578,6055,5523
California,Madera County,5,5,11343,5727,5616
California,Madera County,5,6,10586,4995,5591
California,Madera County,5,7,10213,4720,5493
California,Madera County,5,8,9299,4267,5032
California,Madera County,5,9,9386,4338,5048
California,Madera County,5,10,9383,4318,5065
California,Madera County,5,11,9317,4381,4936
California,Madera County,5,12,8652,4133,4519
California,Madera County,5,13,7788,3791,3997
California,Madera County,5,14,6211,3031,3180
California,Madera County,5,15,4596,2239,2357
California,Madera County,5,16,3233,1544,1689
California,Madera County,5,17,2367,1081,1286
California,Madera County,5,18,2014,805,1209
California,Madera County,6,0,151470,73592,77878
California,Madera County,6,1,11778,5963,5815
California,Madera County,6,2,12158,6088,6070
California,Madera County,6,3,11571,5935,5636
California,Madera County,6,4,11399,5896,5503
California,Madera County,6,5,11337,5694,5643
California,Madera County,6,6,10380,4988,5392
California,Madera County,6,7,10270,4765,5505
California,Madera County,6,8,9333,4304,5029
California,Madera County,6,9,9349,4388,4961
California,Madera County,6,10,9140,4270,4870
California,Madera County,6,11,9261,4334,4927
California,Madera County,6,12,8644,4158,4486
California,Madera County,6,13,7962,3850,4112
California,Madera County,6,14,6395,3104,3291
California,Madera County,6,15,4746,2324,2422
California,Madera County,6,16,3299,1578,1721
California,Madera County,6,17,2339,1114,1225
California,Madera County,6,18,2109,839,1270
California,Madera County,7,0,153590,73910,79680
California,Madera County,7,1,11794,6022,5772
California,Madera County,7,2,12242,6148,6094
California,Madera County,7,3,11585,5875,5710
California,Madera County,7,4,11242,5799,5443
California,Madera County,7,5,11505,5685,5820
California,Madera County,7,6,10692,4988,5704
California,Madera County,7,7,10486,4798,5688
California,Madera County,7,8,9665,4402,5263
California,Madera County,7,9,9530,4334,5196
California,Madera County,7,10,9161,4240,4921
California,Madera County,7,11,9336,4294,5042
California,Madera County,7,12,8742,4193,4549
California,Madera County,7,13,8104,3912,4192
California,Madera County,7,14,6718,3257,3461
California,Madera County,7,15,4874,2336,2538
California,Madera County,7,16,3393,1636,1757
California,Madera County,7,17,2345,1107,1238
California,Madera County,7,18,2176,884,1292
California,Madera County,8,0,153739,74125,79614
California,Madera County,8,1,11821,6012,5809
California,Madera County,8,2,12128,6108,6020
California,Madera County,8,3,11631,5860,5771
California,Madera County,8,4,11088,5768,5320
California,Madera County,8,5,11246,5502,5744
California,Madera County,8,6,10866,5131,5735
California,Madera County,8,7,10384,4825,5559
California,Madera County,8,8,9811,4476,5335
California,Madera County,8,9,9364,4260,5104
California,Madera County,8,10,9089,4192,4897
California,Madera County,8,11,9145,4264,4881
California,Madera County,8,12,8896,4257,4639
California,Madera County,8,13,8156,3940,4216
California,Madera County,8,14,7062,3439,3623
California,Madera County,8,15,5029,2438,2591
California,Madera County,8,16,3499,1679,1820
California,Madera County,8,17,2323,1082,1241
California,Madera County,8,18,2201,892,1309
California,Madera County,9,0,154160,74506,79654
California,Madera County,9,1,11690,5914,5776
California,Madera County,9,2,12156,6148,6008
California,Madera County,9,3,11723,5901,5822
California,Madera County,9,4,11122,5786,5336
California,Madera County,9,5,10917,5313,5604
California,Madera County,9,6,11028,5294,5734
California,Madera County,9,7,10350,4865,5485
California,Madera County,9,8,9908,4524,5384
California,Madera County,9,9,9201,4197,5004
California,Madera County,9,10,9171,4257,4914
California,Madera County,9,11,9020,4271,4749
California,Madera County,9,12,8945,4248,4697
California,Madera County,9,13,8192,3966,4226
California,Madera County,9,14,7364,3574,3790
California,Madera County,9,15,5143,2510,2633
California,Madera County,9,16,3666,1743,1923
California,Madera County,9,17,2315,1061,1254
California,Madera County,9,18,2249,934,1315
California,Madera County,10,0,155904,75165,80739
California,Madera County,10,1,11836,5999,5837
California,Madera County,10,2,12160,6135,6025
California,Madera County,10,3,11959,6032,5927
California,Madera County,10,4,11092,5753,5339
California,Madera County,10,5,10795,5195,5600
California,Madera County,10,6,11377,5428,5949
California,Madera County,10,7,10447,4869,5578
California,Madera County,10,8,10166,4647,5519
California,Madera County,10,9,9241,4224,5017
California,Madera County,10,10,9212,4215,4997
California,Madera County,10,11,8888,4223,4665
California,Madera County,10,12,8965,4273,4692
California,Madera County,10,13,8424,4063,4361
California,Madera County,10,14,7333,3576,3757
California,Madera County,10,15,5557,2699,2858
California,Madera County,10,16,3788,1805,1983
California,Madera County,10,17,2311,1043,1268
California,Madera County,10,18,2353,986,1367
California,Madera County,11,0,157672,76008,81664
California,Madera County,11,1,11922,6075,5847
California,Madera County,11,2,12162,6203,5959
California,Madera County,11,3,12264,6162,6102
California,Madera County,11,4,11120,5734,5386
California,Madera County,11,5,10743,5162,5581
California,Madera County,11,6,11563,5477,6086
California,Madera County,11,7,10462,4910,5552
California,Madera County,11,8,10456,4804,5652
California,Madera County,11,9,9403,4211,5192
California,Madera County,11,10,9288,4280,5008
California,Madera County,11,11,8830,4193,4637
California,Madera County,11,12,8944,4294,4650
California,Madera County,11,13,8464,4062,4402
California,Madera County,11,14,7524,3700,3824
California,Madera County,11,15,5776,2763,3013
California,Madera County,11,16,3966,1883,2083
California,Madera County,11,17,2407,1074,1333
California,Madera County,11,18,2378,1021,1357
California,Marin County,1,0,252409,124072,128337
California,Marin County,1,1,13932,7118,6814
California,Marin County,1,2,15481,7919,7562
California,Marin County,1,3,14241,7153,7088
California,Marin County,1,4,12798,6758,6040
California,Marin County,1,5,10308,5707,4601
California,Marin County,1,6,11960,6449,5511
California,Marin County,1,7,12876,6598,6278
California,Marin County,1,8,16376,8226,8150
California,Marin County,1,9,20102,9988,10114
California,Marin County,1,10,20971,10411,10560
California,Marin County,1,11,21084,10185,10899
California,Marin County,1,12,20826,9873,10953
California,Marin County,1,13,19262,9031,10231
California,Marin County,1,14,14037,6784,7253
California,Marin County,1,15,9174,4278,4896
California,Marin County,1,16,6837,3124,3713
California,Marin County,1,17,5588,2275,3313
California,Marin County,1,18,6556,2195,4361
California,Marin County,2,0,252423,124080,128343
California,Marin County,2,1,13932,7118,6814
California,Marin County,2,2,15481,7919,7562
California,Marin County,2,3,14241,7153,7088
California,Marin County,2,4,12798,6758,6040
California,Marin County,2,5,10311,5709,4602
California,Marin County,2,6,11960,6449,5511
California,Marin County,2,7,12877,6599,6278
California,Marin County,2,8,16376,8226,8150
California,Marin County,2,9,20102,9988,10114
California,Marin County,2,10,20973,10411,10562
California,Marin County,2,11,21088,10188,10900
California,Marin County,2,12,20826,9873,10953
California,Marin County,2,13,19263,9032,10231
California,Marin County,2,14,14037,6784,7253
California,Marin County,2,15,9175,4278,4897
California,Marin County,2,16,6839,3125,3714
California,Marin County,2,17,5588,2275,3313
California,Marin County,2,18,6556,2195,4361
California,Marin County,3,0,252905,124354,128551
California,Marin County,3,1,13847,7072,6775
California,Marin County,3,2,15510,7944,7566
California,Marin County,3,3,14315,7191,7124
California,Marin County,3,4,12982,6837,6145
California,Marin County,3,5,10243,5678,4565
California,Marin County,3,6,11927,6434,5493
California,Marin County,3,7,12883,6618,6265
California,Marin County,3,8,16196,8131,8065
California,Marin County,3,9,20101,10007,10094
California,Marin County,3,10,20953,10407,10546
California,Marin County,3,11,21113,10197,10916
California,Marin County,3,12,20854,9885,10969
California,Marin County,3,13,19378,9099,10279
California,Marin County,3,14,14300,6897,7403
California,Marin County,3,15,9268,4316,4952
California,Marin County,3,16,6830,3138,3692
California,Marin County,3,17,5608,2299,3309
California,Marin County,3,18,6597,2204,4393
California,Marin County,4,0,255363,125512,129851
California,Marin County,4,1,13662,6994,6668
California,Marin County,4,2,15706,8027,7679
California,Marin County,4,3,14720,7384,7336
California,Marin County,4,4,13529,7047,6482
California,Marin County,4,5,10209,5670,4539
California,Marin County,4,6,11600,6265,5335
California,Marin County,4,7,12988,6681,6307
California,Marin County,4,8,15506,7774,7732
California,Marin County,4,9,20144,10078,10066
California,Marin County,4,10,20906,10396,10510
California,Marin County,4,11,21276,10284,10992
California,Marin County,4,12,20861,9906,10955
California,Marin County,4,13,19986,9414,10572
California,Marin County,4,14,15124,7201,7923
California,Marin County,4,15,9731,4525,5206
California,Marin County,4,16,6895,3180,3715
California,Marin County,4,17,5724,2408,3316
California,Marin County,4,18,6796,2278,4518
California,Marin County,5,0,256072,125315,130757
California,Marin County,5,1,13255,6808,6447
California,Marin County,5,2,15844,8065,7779
California,Marin County,5,3,15088,7588,7500
California,Marin County,5,4,13680,7039,6641
California,Marin County,5,5,10379,5713,4666
California,Marin County,5,6,11143,6002,5141
California,Marin County,5,7,12757,6540,6217
California,Marin County,5,8,15089,7486,7603
California,Marin County,5,9,19811,9897,9914
California,Marin County,5,10,20664,10153,10511
California,Marin County,5,11,21120,10237,10883
California,Marin County,5,12,20664,9740,10924
California,Marin County,5,13,19710,9247,10463
California,Marin County,5,14,16446,7781,8665
California,Marin County,5,15,10528,4899,5629
California,Marin County,5,16,7158,3296,3862
California,Marin County,5,17,5780,2472,3308
California,Marin County,5,18,6956,2352,4604
California,Marin County,6,0,258453,126161,132292
California,Marin County,6,1,12803,6487,6316
California,Marin County,6,2,15988,8175,7813
California,Marin County,6,3,15711,7918,7793
California,Marin County,6,4,13713,6951,6762
California,Marin County,6,5,10955,5907,5048
California,Marin County,6,6,10938,5941,4997
California,Marin County,6,7,12716,6508,6208
California,Marin County,6,8,14893,7372,7521
California,Marin County,6,9,19512,9654,9858
California,Marin County,6,10,20696,10234,10462
California,Marin County,6,11,21066,10280,10786
California,Marin County,6,12,20529,9651,10878
California,Marin County,6,13,19892,9305,10587
California,Marin County,6,14,16967,7938,9029
California,Marin County,6,15,11625,5410,6215
California,Marin County,6,16,7504,3476,4028
California,Marin County,6,17,5786,2485,3301
California,Marin County,6,18,7159,2469,4690
California,Marin County,7,0,260435,127132,133303
California,Marin County,7,1,12686,6445,6241
California,Marin County,7,2,15828,8056,7772
California,Marin County,7,3,16177,8175,8002
California,Marin County,7,4,13788,6906,6882
California,Marin County,7,5,11530,6170,5360
California,Marin County,7,6,10667,5820,4847
California,Marin County,7,7,12750,6561,6189
California,Marin County,7,8,14738,7278,7460
California,Marin County,7,9,18918,9386,9532
California,Marin County,7,10,20816,10349,10467
California,Marin County,7,11,21063,10317,10746
California,Marin County,7,12,20394,9646,10748
California,Marin County,7,13,20004,9357,10647
California,Marin County,7,14,17562,8121,9441
California,Marin County,7,15,12324,5746,6578
California,Marin County,7,16,8037,3738,4299
California,Marin County,7,17,5770,2495,3275
California,Marin County,7,18,7383,2566,4817
California,Marin County,8,0,261016,127473,133543
California,Marin County,8,1,12534,6346,6188
California,Marin County,8,2,15438,7885,7553
California,Marin County,8,3,16427,8358,8069
California,Marin County,8,4,14008,6974,7034
California,Marin County,8,5,11881,6364,5517
California,Marin County,8,6,10547,5746,4801
California,Marin County,8,7,12434,6448,5986
California,Marin County,8,8,14708,7248,7460
California,Marin County,8,9,17944,8982,8962
California,Marin County,8,10,20985,10358,10627
California,Marin County,8,11,20783,10234,10549
California,Marin County,8,12,20536,9785,10751
California,Marin County,8,13,19823,9203,10620
California,Marin County,8,14,18075,8297,9778
California,Marin County,8,15,13164,6189,6975
California,Marin County,8,16,8401,3813,4588
California,Marin County,8,17,5795,2590,3205
California,Marin County,8,18,7533,2653,4880
California,Marin County,9,0,260633,127144,133489
California,Marin County,9,1,12420,6286,6134
California,Marin County,9,2,14847,7576,7271
California,Marin County,9,3,16621,8476,8145
California,Marin County,9,4,14265,7095,7170
California,Marin County,9,5,11897,6307,5590
California,Marin County,9,6,10393,5662,4731
California,Marin County,9,7,12122,6293,5829
California,Marin County,9,8,14727,7222,7505
California,Marin County,9,9,17072,8536,8536
California,Marin County,9,10,20920,10389,10531
California,Marin County,9,11,20595,10104,10491
California,Marin County,9,12,20491,9779,10712
California,Marin County,9,13,19731,9175,10556
California,Marin County,9,14,18376,8452,9924
California,Marin County,9,15,13781,6406,7375
California,Marin County,9,16,8798,3981,4817
California,Marin County,9,17,5842,2630,3212
California,Marin County,9,18,7735,2775,4960
California,Marin County,10,0,259725,126883,132842
California,Marin County,10,1,12107,6108,5999
California,Marin County,10,2,14328,7353,6975
California,Marin County,10,3,16544,8422,8122
California,Marin County,10,4,14551,7277,7274
California,Marin County,10,5,11788,6148,5640
California,Marin County,10,6,10506,5796,4710
California,Marin County,10,7,11867,6197,5670
California,Marin County,10,8,14405,7179,7226
California,Marin County,10,9,16616,8288,8328
California,Marin County,10,10,20596,10261,10335
California,Marin County,10,11,20452,10040,10412
California,Marin County,10,12,20261,9714,10547
California,Marin County,10,13,19452,9128,10324
California,Marin County,10,14,18045,8226,9819
California,Marin County,10,15,14977,6940,8037
California,Marin County,10,16,9402,4298,5104
California,Marin County,10,17,6059,2682,3377
California,Marin County,10,18,7769,2826,4943
California,Marin County,11,0,259666,126989,132677
California,Marin County,11,1,11842,5966,5876
California,Marin County,11,2,13794,7034,6760
California,Marin County,11,3,16388,8340,8048
California,Marin County,11,4,15088,7616,7472
California,Marin County,11,5,11793,6077,5716
California,Marin County,11,6,10773,5898,4875
California,Marin County,11,7,11748,6227,5521
California,Marin County,11,8,14325,7185,7140
California,Marin County,11,9,16171,8123,8048
California,Marin County,11,10,20014,9915,10099
California,Marin County,11,11,20298,10058,10240
California,Marin County,11,12,20123,9730,10393
California,Marin County,11,13,19366,9075,10291
California,Marin County,11,14,18061,8225,9836
California,Marin County,11,15,15409,7125,8284
California,Marin County,11,16,10305,4709,5596
California,Marin County,11,17,6343,2821,3522
California,Marin County,11,18,7825,2865,4960
California,Mariposa County,1,0,18251,9269,8982
California,Mariposa County,1,1,775,381,394
California,Mariposa County,1,2,821,426,395
California,Mariposa County,1,3,987,495,492
California,Mariposa County,1,4,1026,517,509
California,Mariposa County,1,5,827,450,377
California,Mariposa County,1,6,828,427,401
California,Mariposa County,1,7,823,423,400
California,Mariposa County,1,8,840,447,393
California,Mariposa County,1,9,988,494,494
California,Mariposa County,1,10,1456,739,717
California,Mariposa County,1,11,1776,890,886
California,Mariposa County,1,12,1693,822,871
California,Mariposa County,1,13,1590,872,718
California,Mariposa County,1,14,1304,654,650
California,Mariposa County,1,15,949,499,450
California,Mariposa County,1,16,707,339,368
California,Mariposa County,1,17,479,250,229
California,Mariposa County,1,18,382,144,238
California,Mariposa County,2,0,18247,9267,8980
California,Mariposa County,2,1,775,381,394
California,Mariposa County,2,2,820,425,395
California,Mariposa County,2,3,987,495,492
California,Mariposa County,2,4,1026,517,509
California,Mariposa County,2,5,827,450,377
California,Mariposa County,2,6,828,427,401
California,Mariposa County,2,7,822,422,400
California,Mariposa County,2,8,840,447,393
California,Mariposa County,2,9,987,494,493
California,Mariposa County,2,10,1456,739,717
California,Mariposa County,2,11,1775,890,885
California,Mariposa County,2,12,1693,822,871
California,Mariposa County,2,13,1590,872,718
California,Mariposa County,2,14,1304,654,650
California,Mariposa County,2,15,949,499,450
California,Mariposa County,2,16,707,339,368
California,Mariposa County,2,17,479,250,229
California,Mariposa County,2,18,382,144,238
California,Mariposa County,3,0,18277,9294,8983
California,Mariposa County,3,1,771,381,390
California,Mariposa County,3,2,818,421,397
California,Mariposa County,3,3,974,493,481
California,Mariposa County,3,4,1013,507,506
California,Mariposa County,3,5,844,460,384
California,Mariposa County,3,6,846,437,409
California,Mariposa County,3,7,820,420,400
California,Mariposa County,3,8,840,447,393
California,Mariposa County,3,9,976,493,483
California,Mariposa County,3,10,1443,732,711
California,Mariposa County,3,11,1766,881,885
California,Mariposa County,3,12,1698,829,869
California,Mariposa County,3,13,1616,884,732
California,Mariposa County,3,14,1304,657,647
California,Mariposa County,3,15,956,505,451
California,Mariposa County,3,16,715,347,368
California,Mariposa County,3,17,487,252,235
California,Mariposa County,3,18,390,148,242
California,Mariposa County,4,0,18168,9238,8930
California,Mariposa County,4,1,777,398,379
California,Mariposa County,4,2,835,419,416
California,Mariposa County,4,3,937,486,451
California,Mariposa County,4,4,976,478,498
California,Mariposa County,4,5,875,457,418
California,Mariposa County,4,6,890,471,419
California,Mariposa County,4,7,846,437,409
California,Mariposa County,4,8,807,419,388
California,Mariposa County,4,9,939,480,459
California,Mariposa County,4,10,1325,691,634
California,Mariposa County,4,11,1701,823,878
California,Mariposa County,4,12,1689,845,844
California,Mariposa County,4,13,1665,875,790
California,Mariposa County,4,14,1293,663,630
California,Mariposa County,4,15,987,519,468
California,Mariposa County,4,16,710,358,352
California,Mariposa County,4,17,498,257,241
California,Mariposa County,4,18,418,162,256
California,Mariposa County,5,0,17880,9113,8767
California,Mariposa County,5,1,747,376,371
California,Mariposa County,5,2,798,402,396
California,Mariposa County,5,3,899,480,419
California,Mariposa County,5,4,969,479,490
California,Mariposa County,5,5,832,440,392
California,Mariposa County,5,6,862,454,408
California,Mariposa County,5,7,812,428,384
California,Mariposa County,5,8,786,413,373
California,Mariposa County,5,9,904,463,441
California,Mariposa County,5,10,1193,626,567
California,Mariposa County,5,11,1639,793,846
California,Mariposa County,5,12,1689,858,831
California,Mariposa County,5,13,1597,804,793
California,Mariposa County,5,14,1416,743,673
California,Mariposa County,5,15,1059,548,511
California,Mariposa County,5,16,715,368,347
California,Mariposa County,5,17,518,259,259
California,Mariposa County,5,18,445,179,266
California,Mariposa County,6,0,17808,9064,8744
California,Mariposa County,6,1,755,381,374
California,Mariposa County,6,2,788,401,387
California,Mariposa County,6,3,849,457,392
California,Mariposa County,6,4,957,486,471
California,Mariposa County,6,5,863,436,427
California,Mariposa County,6,6,860,454,406
California,Mariposa County,6,7,837,451,386
California,Mariposa County,6,8,781,398,383
California,Mariposa County,6,9,870,458,412
California,Mariposa County,6,10,1108,554,554
California,Mariposa County,6,11,1547,772,775
California,Mariposa County,6,12,1707,855,852
California,Mariposa County,6,13,1592,794,798
California,Mariposa County,6,14,1478,792,686
California,Mariposa County,6,15,1096,558,538
California,Mariposa County,6,16,740,384,356
California,Mariposa County,6,17,507,242,265
California,Mariposa County,6,18,473,191,282
California,Mariposa County,7,0,17713,9039,8674
California,Mariposa County,7,1,760,404,356
California,Mariposa County,7,2,787,391,396
California,Mariposa County,7,3,817,445,372
California,Mariposa County,7,4,892,450,442
California,Mariposa County,7,5,882,468,414
California,Mariposa County,7,6,886,468,418
California,Mariposa County,7,7,853,454,399
California,Mariposa County,7,8,735,374,361
California,Mariposa County,7,9,825,429,396
California,Mariposa County,7,10,1007,503,504
California,Mariposa County,7,11,1492,757,735
California,Mariposa County,7,12,1720,856,864
California,Mariposa County,7,13,1640,809,831
California,Mariposa County,7,14,1492,807,685
California,Mariposa County,7,15,1130,564,566
California,Mariposa County,7,16,800,422,378
California,Mariposa County,7,17,505,241,264
California,Mariposa County,7,18,490,197,293
California,Mariposa County,8,0,17622,8941,8681
California,Mariposa County,8,1,742,391,351
California,Mariposa County,8,2,763,356,407
California,Mariposa County,8,3,821,442,379
California,Mariposa County,8,4,873,466,407
California,Mariposa County,8,5,879,471,408
California,Mariposa County,8,6,902,478,424
California,Mariposa County,8,7,840,416,424
California,Mariposa County,8,8,814,415,399
California,Mariposa County,8,9,801,404,397
California,Mariposa County,8,10,961,495,466
California,Mariposa County,8,11,1378,699,679
California,Mariposa County,8,12,1682,815,867
California,Mariposa County,8,13,1637,804,833
California,Mariposa County,8,14,1539,820,719
California,Mariposa County,8,15,1166,592,574
California,Mariposa County,8,16,817,426,391
California,Mariposa County,8,17,521,252,269
California,Mariposa County,8,18,486,199,287
California,Mariposa County,9,0,17455,8886,8569
California,Mariposa County,9,1,773,390,383
California,Mariposa County,9,2,739,372,367
California,Mariposa County,9,3,831,422,409
California,Mariposa County,9,4,811,452,359
California,Mariposa County,9,5,837,449,388
California,Mariposa County,9,6,930,499,431
California,Mariposa County,9,7,887,462,425
California,Mariposa County,9,8,834,429,405
California,Mariposa County,9,9,781,391,390
California,Mariposa County,9,10,896,464,432
California,Mariposa County,9,11,1241,645,596
California,Mariposa County,9,12,1645,784,861
California,Mariposa County,9,13,1660,833,827
California,Mariposa County,9,14,1569,802,767
California,Mariposa County,9,15,1168,579,589
California,Mariposa County,9,16,833,444,389
California,Mariposa County,9,17,529,262,267
California,Mariposa County,9,18,491,207,284
California,Mariposa County,10,0,17437,8902,8535
California,Mariposa County,10,1,757,392,365
California,Mariposa County,10,2,770,389,381
California,Mariposa County,10,3,787,403,384
California,Mariposa County,10,4,782,421,361
California,Mariposa County,10,5,838,459,379
California,Mariposa County,10,6,964,508,456
California,Mariposa County,10,7,905,486,419
California,Mariposa County,10,8,849,432,417
California,Mariposa County,10,9,768,396,372
California,Mariposa County,10,10,893,448,445
California,Mariposa County,10,11,1121,593,528
California,Mariposa County,10,12,1607,777,830
California,Mariposa County,10,13,1675,839,836
California,Mariposa County,10,14,1542,769,773
California,Mariposa County,10,15,1255,653,602
California,Mariposa County,10,16,867,443,424
California,Mariposa County,10,17,540,282,258
California,Mariposa County,10,18,517,212,305
California,Mariposa County,11,0,17471,8904,8567
California,Mariposa County,11,1,750,403,347
California,Mariposa County,11,2,786,392,394
California,Mariposa County,11,3,787,386,401
California,Mariposa County,11,4,763,409,354
California,Mariposa County,11,5,824,452,372
California,Mariposa County,11,6,993,513,480
California,Mariposa County,11,7,876,467,409
California,Mariposa County,11,8,891,441,450
California,Mariposa County,11,9,777,403,374
California,Mariposa County,11,10,876,462,414
California,Mariposa County,11,11,1095,542,553
California,Mariposa County,11,12,1499,746,753
California,Mariposa County,11,13,1672,834,838
California,Mariposa County,11,14,1550,769,781
California,Mariposa County,11,15,1289,701,588
California,Mariposa County,11,16,922,458,464
California,Mariposa County,11,17,577,303,274
California,Mariposa County,11,18,544,223,321
California,Mendocino County,1,0,87841,43983,43858
California,Mendocino County,1,1,5347,2786,2561
California,Mendocino County,1,2,5259,2656,2603
California,Mendocino County,1,3,5390,2735,2655
California,Mendocino County,1,4,5613,2991,2622
California,Mendocino County,1,5,4874,2635,2239
California,Mendocino County,1,6,5485,2833,2652
California,Mendocino County,1,7,5219,2724,2495
California,Mendocino County,1,8,5097,2647,2450
California,Mendocino County,1,9,5171,2688,2483
California,Mendocino County,1,10,5759,2838,2921
California,Mendocino County,1,11,6717,3289,3428
California,Mendocino County,1,12,7283,3487,3796
California,Mendocino County,1,13,7134,3540,3594
California,Mendocino County,1,14,4632,2287,2345
California,Mendocino County,1,15,2924,1427,1497
California,Mendocino County,1,16,2178,1010,1168
California,Mendocino County,1,17,1805,759,1046
California,Mendocino County,1,18,1954,651,1303
California,Mendocino County,2,0,87850,43987,43863
California,Mendocino County,2,1,5347,2786,2561
California,Mendocino County,2,2,5259,2656,2603
California,Mendocino County,2,3,5390,2735,2655
California,Mendocino County,2,4,5613,2991,2622
California,Mendocino County,2,5,4874,2635,2239
California,Mendocino County,2,6,5485,2833,2652
California,Mendocino County,2,7,5219,2724,2495
California,Mendocino County,2,8,5097,2647,2450
California,Mendocino County,2,9,5171,2688,2483
California,Mendocino County,2,10,5758,2837,2921
California,Mendocino County,2,11,6717,3289,3428
California,Mendocino County,2,12,7284,3487,3797
California,Mendocino County,2,13,7135,3542,3593
California,Mendocino County,2,14,4631,2286,2345
California,Mendocino County,2,15,2925,1427,1498
California,Mendocino County,2,16,2180,1012,1168
California,Mendocino County,2,17,1808,760,1048
California,Mendocino County,2,18,1957,652,1305
California,Mendocino County,3,0,87800,43935,43865
California,Mendocino County,3,1,5360,2797,2563
California,Mendocino County,3,2,5262,2645,2617
California,Mendocino County,3,3,5384,2739,2645
California,Mendocino County,3,4,5560,2970,2590
California,Mendocino County,3,5,4859,2617,2242
California,Mendocino County,3,6,5452,2808,2644
California,Mendocino County,3,7,5233,2726,2507
California,Mendocino County,3,8,5070,2630,2440
California,Mendocino County,3,9,5188,2699,2489
California,Mendocino County,3,10,5702,2820,2882
California,Mendocino County,3,11,6677,3267,3410
California,Mendocino County,3,12,7250,3468,3782
California,Mendocino County,3,13,7218,3573,3645
California,Mendocino County,3,14,4682,2312,2370
California,Mendocino County,3,15,2944,1436,1508
California,Mendocino County,3,16,2189,1021,1168
California,Mendocino County,3,17,1796,755,1041
California,Mendocino County,3,18,1974,652,1322
California,Mendocino County,4,0,87334,43586,43748
California,Mendocino County,4,1,5279,2724,2555
California,Mendocino County,4,2,5286,2660,2626
California,Mendocino County,4,3,5353,2735,2618
California,Mendocino County,4,4,5400,2892,2508
California,Mendocino County,4,5,4823,2540,2283
California,Mendocino County,4,6,5228,2699,2529
California,Mendocino County,4,7,5284,2737,2547
California,Mendocino County,4,8,4932,2551,2381
California,Mendocino County,4,9,5230,2704,2526
California,Mendocino County,4,10,5381,2682,2699
California,Mendocino County,4,11,6488,3175,3313
California,Mendocino County,4,12,7079,3398,3681
California,Mendocino County,4,13,7498,3663,3835
California,Mendocino County,4,14,4949,2456,2493
California,Mendocino County,4,15,3075,1518,1557
California,Mendocino County,4,16,2270,1066,1204
California,Mendocino County,4,17,1742,733,1009
California,Mendocino County,4,18,2037,653,1384
California,Mendocino County,5,0,87304,43532,43772
California,Mendocino County,5,1,5324,2772,2552
California,Mendocino County,5,2,5292,2679,2613
California,Mendocino County,5,3,5313,2712,2601
California,Mendocino County,5,4,5283,2754,2529
California,Mendocino County,5,5,4787,2513,2274
California,Mendocino County,5,6,4999,2601,2398
California,Mendocino County,5,7,5331,2788,2543
California,Mendocino County,5,8,4991,2590,2401
California,Mendocino County,5,9,5221,2673,2548
California,Mendocino County,5,10,5132,2577,2555
California,Mendocino County,5,11,6275,3070,3205
California,Mendocino County,5,12,7018,3365,3653
California,Mendocino County,5,13,7303,3518,3785
California,Mendocino County,5,14,5637,2809,2828
California,Mendocino County,5,15,3316,1608,1708
California,Mendocino County,5,16,2317,1105,1212
California,Mendocino County,5,17,1685,712,973
California,Mendocino County,5,18,2080,686,1394
California,Mendocino County,6,0,87077,43350,43727
California,Mendocino County,6,1,5302,2733,2569
California,Mendocino County,6,2,5271,2719,2552
California,Mendocino County,6,3,5244,2675,2569
California,Mendocino County,6,4,5203,2663,2540
California,Mendocino County,6,5,4777,2528,2249
California,Mendocino County,6,6,4982,2601,2381
California,Mendocino County,6,7,5300,2729,2571
California,Mendocino County,6,8,4994,2586,2408
California,Mendocino County,6,9,5138,2591,2547
California,Mendocino County,6,10,5035,2553,2482
California,Mendocino County,6,11,5994,2889,3105
California,Mendocino County,6,12,6824,3307,3517
California,Mendocino County,6,13,7215,3438,3777
California,Mendocino County,6,14,6029,3016,3013
California,Mendocino County,6,15,3650,1800,1850
California,Mendocino County,6,16,2349,1122,1227
California,Mendocino County,6,17,1707,730,977
California,Mendocino County,6,18,2063,670,1393
California,Mendocino County,7,0,87257,43405,43852
California,Mendocino County,7,1,5316,2711,2605
California,Mendocino County,7,2,5347,2761,2586
California,Mendocino County,7,3,5207,2621,2586
California,Mendocino County,7,4,5167,2672,2495
California,Mendocino County,7,5,4843,2558,2285
California,Mendocino County,7,6,4874,2537,2337
California,Mendocino County,7,7,5293,2731,2562
California,Mendocino County,7,8,5088,2595,2493
California,Mendocino County,7,9,5044,2563,2481
California,Mendocino County,7,10,4967,2543,2424
California,Mendocino County,7,11,5854,2822,3032
California,Mendocino County,7,12,6574,3200,3374
California,Mendocino County,7,13,7130,3364,3766
California,Mendocino County,7,14,6424,3211,3213
California,Mendocino County,7,15,3963,1953,2010
California,Mendocino County,7,16,2405,1144,1261
California,Mendocino County,7,17,1683,741,942
California,Mendocino County,7,18,2078,678,1400
California,Mendocino County,8,0,87168,43339,43829
California,Mendocino County,8,1,5239,2688,2551
California,Mendocino County,8,2,5346,2745,2601
California,Mendocino County,8,3,5135,2582,2553
California,Mendocino County,8,4,5058,2608,2450
California,Mendocino County,8,5,4848,2592,2256
California,Mendocino County,8,6,4751,2495,2256
California,Mendocino County,8,7,5255,2660,2595
California,Mendocino County,8,8,5146,2643,2503
California,Mendocino County,8,9,5002,2566,2436
California,Mendocino County,8,10,5018,2552,2466
California,Mendocino County,8,11,5583,2693,2890
California,Mendocino County,8,12,6447,3160,3287
California,Mendocino County,8,13,6982,3294,3688
California,Mendocino County,8,14,6838,3347,3491
California,Mendocino County,8,15,4218,2084,2134
California,Mendocino County,8,16,2524,1217,1307
California,Mendocino County,8,17,1704,744,960
California,Mendocino County,8,18,2074,669,1405
California,Mendocino County,9,0,87382,43362,44020
California,Mendocino County,9,1,5282,2688,2594
California,Mendocino County,9,2,5205,2707,2498
California,Mendocino County,9,3,5203,2595,2608
California,Mendocino County,9,4,5108,2689,2419
California,Mendocino County,9,5,4648,2458,2190
California,Mendocino County,9,6,4831,2488,2343
California,Mendocino County,9,7,5129,2611,2518
California,Mendocino County,9,8,5265,2715,2550
California,Mendocino County,9,9,4966,2512,2454
California,Mendocino County,9,10,5118,2608,2510
California,Mendocino County,9,11,5390,2617,2773
California,Mendocino County,9,12,6319,3098,3221
California,Mendocino County,9,13,6933,3258,3675
California,Mendocino County,9,14,7113,3440,3673
California,Mendocino County,9,15,4450,2187,2263
California,Mendocino County,9,16,2570,1246,1324
California,Mendocino County,9,17,1754,780,974
California,Mendocino County,9,18,2098,665,1433
California,Mendocino County,10,0,87697,43462,44235
California,Mendocino County,10,1,5182,2587,2595
California,Mendocino County,10,2,5281,2773,2508
California,Mendocino County,10,3,5215,2651,2564
California,Mendocino County,10,4,5080,2667,2413
California,Mendocino County,10,5,4537,2348,2189
California,Mendocino County,10,6,4921,2488,2433
California,Mendocino County,10,7,5053,2600,2453
California,Mendocino County,10,8,5405,2740,2665
California,Mendocino County,10,9,5036,2593,2443
California,Mendocino County,10,10,5107,2548,2559
California,Mendocino County,10,11,5188,2572,2616
California,Mendocino County,10,12,6194,3033,3161
California,Mendocino County,10,13,6833,3236,3597
California,Mendocino County,10,14,6908,3295,3613
California,Mendocino County,10,15,5096,2501,2595
California,Mendocino County,10,16,2809,1346,1463
California,Mendocino County,10,17,1752,793,959
California,Mendocino County,10,18,2100,691,1409
California,Mendocino County,11,0,87606,43403,44203
California,Mendocino County,11,1,5160,2576,2584
California,Mendocino County,11,2,5205,2683,2522
California,Mendocino County,11,3,5234,2707,2527
California,Mendocino County,11,4,4994,2594,2400
California,Mendocino County,11,5,4503,2300,2203
California,Mendocino County,11,6,4920,2555,2365
California,Mendocino County,11,7,4963,2543,2420
California,Mendocino County,11,8,5396,2733,2663
California,Mendocino County,11,9,5080,2598,2482
California,Mendocino County,11,10,5127,2546,2581
California,Mendocino County,11,11,5059,2523,2536
California,Mendocino County,11,12,5922,2870,3052
California,Mendocino County,11,13,6677,3196,3481
California,Mendocino County,11,14,6857,3228,3629
California,Mendocino County,11,15,5505,2730,2775
California,Mendocino County,11,16,3097,1482,1615
California,Mendocino County,11,17,1792,829,963
California,Mendocino County,11,18,2115,710,1405
California,Merced County,1,0,255793,128737,127056
California,Merced County,1,1,22226,11407,10819
California,Merced County,1,2,22167,11312,10855
California,Merced County,1,3,22115,11387,10728
California,Merced County,1,4,24451,12722,11729
California,Merced County,1,5,20195,10513,9682
California,Merced County,1,6,18190,9413,8777
California,Merced County,1,7,16870,8580,8290
California,Merced County,1,8,16243,8130,8113
California,Merced County,1,9,15724,7975,7749
California,Merced County,1,10,16146,8018,8128
California,Merced County,1,11,14861,7452,7409
California,Merced County,1,12,12363,6132,6231
California,Merced County,1,13,10282,5093,5189
California,Merced County,1,14,7606,3606,4000
California,Merced County,1,15,5599,2589,3010
California,Merced County,1,16,4470,1993,2477
California,Merced County,1,17,3247,1334,1913
California,Merced County,1,18,3038,1081,1957
California,Merced County,2,0,255796,128738,127058
California,Merced County,2,1,22226,11407,10819
California,Merced County,2,2,22167,11312,10855
California,Merced County,2,3,22116,11388,10728
California,Merced County,2,4,24451,12722,11729
California,Merced County,2,5,20194,10512,9682
California,Merced County,2,6,18189,9412,8777
California,Merced County,2,7,16870,8580,8290
California,Merced County,2,8,16243,8130,8113
California,Merced County,2,9,15724,7975,7749
California,Merced County,2,10,16149,8020,8129
California,Merced County,2,11,14862,7452,7410
California,Merced County,2,12,12363,6132,6231
California,Merced County,2,13,10282,5093,5189
California,Merced County,2,14,7606,3606,4000
California,Merced County,2,15,5599,2589,3010
California,Merced County,2,16,4470,1993,2477
California,Merced County,2,17,3247,1334,1913
California,Merced County,2,18,3038,1081,1957
California,Merced County,3,0,256732,129172,127560
California,Merced County,3,1,22228,11395,10833
California,Merced County,3,2,22223,11336,10887
California,Merced County,3,3,22080,11357,10723
California,Merced County,3,4,24398,12676,11722
California,Merced County,3,5,20522,10672,9850
California,Merced County,3,6,18308,9485,8823
California,Merced County,3,7,17003,8649,8354
California,Merced County,3,8,16246,8137,8109
California,Merced County,3,9,15731,7979,7752
California,Merced County,3,10,16140,8036,8104
California,Merced County,3,11,14929,7469,7460
California,Merced County,3,12,12446,6169,6277
California,Merced County,3,13,10371,5126,5245
California,Merced County,3,14,7647,3635,4012
California,Merced County,3,15,5647,2612,3035
California,Merced County,3,16,4505,2012,2493
California,Merced County,3,17,3256,1341,1915
California,Merced County,3,18,3052,1086,1966
California,Merced County,4,0,259333,130584,128749
California,Merced County,4,1,21938,11275,10663
California,Merced County,4,2,22235,11354,10881
California,Merced County,4,3,22102,11356,10746
California,Merced County,4,4,23883,12401,11482
California,Merced County,4,5,21594,11246,10348
California,Merced County,4,6,18469,9574,8895
California,Merced County,4,7,17291,8788,8503
California,Merced County,4,8,16127,8093,8034
California,Merced County,4,9,15857,8011,7846
California,Merced County,4,10,16064,8098,7966
California,Merced County,4,11,15201,7568,7633
California,Merced County,4,12,12851,6386,6465
California,Merced County,4,13,10849,5367,5482
California,Merced County,4,14,7921,3801,4120
California,Merced County,4,15,5840,2707,3133
California,Merced County,4,16,4625,2058,2567
California,Merced County,4,17,3299,1368,1931
California,Merced County,4,18,3187,1133,2054
California,Merced County,5,0,260971,131607,129364
California,Merced County,5,1,21626,11144,10482
California,Merced County,5,2,22542,11479,11063
California,Merced County,5,3,22063,11273,10790
California,Merced County,5,4,23113,12062,11051
California,Merced County,5,5,22000,11436,10564
California,Merced County,5,6,18661,9728,8933
California,Merced County,5,7,17647,9086,8561
California,Merced County,5,8,16002,8039,7963
California,Merced County,5,9,15974,8071,7903
California,Merced County,5,10,15761,8012,7749
California,Merced County,5,11,15405,7646,7759
California,Merced County,5,12,13301,6626,6675
California,Merced County,5,13,10979,5415,5564
California,Merced County,5,14,8509,4098,4411
California,Merced County,5,15,6100,2855,3245
California,Merced County,5,16,4620,2059,2561
California,Merced County,5,17,3372,1419,1953
California,Merced County,5,18,3296,1159,2137
California,Merced County,6,0,262198,132283,129915
California,Merced County,6,1,21490,10992,10498
California,Merced County,6,2,22546,11584,10962
California,Merced County,6,3,22144,11310,10834
California,Merced County,6,4,22668,11827,10841
California,Merced County,6,5,21930,11362,10568
California,Merced County,6,6,18905,9968,8937
California,Merced County,6,7,17854,9234,8620
California,Merced County,6,8,16058,8046,8012
California,Merced County,6,9,15973,7989,7984
California,Merced County,6,10,15607,7948,7659
California,Merced County,6,11,15434,7690,7744
California,Merced County,6,12,13727,6844,6883
California,Merced County,6,13,11128,5482,5646
California,Merced County,6,14,8874,4259,4615
California,Merced County,6,15,6357,3004,3353
California,Merced County,6,16,4742,2128,2614
California,Merced County,6,17,3371,1411,1960
California,Merced County,6,18,3390,1205,2185
California,Merced County,7,0,264649,133608,131041
California,Merced County,7,1,21548,11049,10499
California,Merced County,7,2,22543,11558,10985
California,Merced County,7,3,22287,11322,10965
California,Merced County,7,4,22762,11788,10974
California,Merced County,7,5,21954,11499,10455
California,Merced County,7,6,19272,10084,9188
California,Merced County,7,7,18029,9418,8611
California,Merced County,7,8,16411,8287,8124
California,Merced County,7,9,15887,7942,7945
California,Merced County,7,10,15493,7876,7617
California,Merced County,7,11,15522,7726,7796
California,Merced County,7,12,13976,7019,6957
California,Merced County,7,13,11318,5543,5775
California,Merced County,7,14,9274,4503,4771
California,Merced County,7,15,6684,3142,3542
California,Merced County,7,16,4789,2149,2640
California,Merced County,7,17,3429,1450,1979
California,Merced County,7,18,3471,1253,2218
California,Merced County,8,0,266651,134589,132062
California,Merced County,8,1,21472,11048,10424
California,Merced County,8,2,22609,11644,10965
California,Merced County,8,3,22347,11295,11052
California,Merced County,8,4,22884,11813,11071
California,Merced County,8,5,21330,11163,10167
California,Merced County,8,6,20018,10467,9551
California,Merced County,8,7,18138,9471,8667
California,Merced County,8,8,16762,8489,8273
California,Merced County,8,9,15814,7857,7957
California,Merced County,8,10,15374,7859,7515
California,Merced County,8,11,15494,7723,7771
California,Merced County,8,12,14268,7098,7170
California,Merced County,8,13,11697,5750,5947
California,Merced County,8,14,9577,4669,4908
California,Merced County,8,15,6936,3284,3652
California,Merced County,8,16,4891,2206,2685
California,Merced County,8,17,3491,1472,2019
California,Merced County,8,18,3549,1281,2268
California,Merced County,9,0,267971,134978,132993
California,Merced County,9,1,21231,10839,10392
California,Merced County,9,2,22667,11716,10951
California,Merced County,9,3,22544,11453,11091
California,Merced County,9,4,22882,11740,11142
California,Merced County,9,5,20687,10758,9929
California,Merced County,9,6,20635,10779,9856
California,Merced County,9,7,18195,9524,8671
California,Merced County,9,8,16858,8488,8370
California,Merced County,9,9,15752,7828,7924
California,Merced County,9,10,15462,7809,7653
California,Merced County,9,11,15259,7659,7600
California,Merced County,9,12,14500,7193,7307
California,Merced County,9,13,11999,5886,6113
California,Merced County,9,14,9865,4811,5054
California,Merced County,9,15,7185,3366,3819
California,Merced County,9,16,5077,2299,2778
California,Merced County,9,17,3553,1504,2049
California,Merced County,9,18,3620,1326,2294
California,Merced County,10,0,271340,136917,134423
California,Merced County,10,1,21220,10846,10374
California,Merced County,10,2,22594,11615,10979
California,Merced County,10,3,22991,11768,11223
California,Merced County,10,4,23469,12012,11457
California,Merced County,10,5,20631,10823,9808
California,Merced County,10,6,20929,10962,9967
California,Merced County,10,7,18591,9783,8808
California,Merced County,10,8,17201,8695,8506
California,Merced County,10,9,15801,7900,7901
California,Merced County,10,10,15644,7818,7826
California,Merced County,10,11,15017,7621,7396
California,Merced County,10,12,14680,7276,7404
California,Merced County,10,13,12554,6145,6409
California,Merced County,10,14,9961,4849,5112
California,Merced County,10,15,7603,3560,4043
California,Merced County,10,16,5238,2387,2851
California,Merced County,10,17,3537,1509,2028
California,Merced County,10,18,3679,1348,2331
California,Merced County,11,0,274765,138632,136133
California,Merced County,11,1,21174,10835,10339
California,Merced County,11,2,22566,11568,10998
California,Merced County,11,3,23193,11906,11287
California,Merced County,11,4,23859,12153,11706
California,Merced County,11,5,20649,10842,9807
California,Merced County,11,6,21277,11076,10201
California,Merced County,11,7,19012,10073,8939
California,Merced County,11,8,17798,9024,8774
California,Merced County,11,9,15933,7973,7960
California,Merced County,11,10,15740,7778,7962
California,Merced County,11,11,15025,7631,7394
California,Merced County,11,12,14770,7392,7378
California,Merced County,11,13,12924,6356,6568
California,Merced County,11,14,10122,4889,5233
California,Merced County,11,15,7987,3724,4263
California,Merced County,11,16,5387,2472,2915
California,Merced County,11,17,3625,1549,2076
California,Merced County,11,18,3724,1391,2333
California,Modoc County,1,0,9686,4878,4808
California,Modoc County,1,1,545,271,274
California,Modoc County,1,2,564,297,267
California,Modoc County,1,3,602,298,304
California,Modoc County,1,4,604,311,293
California,Modoc County,1,5,422,215,207
California,Modoc County,1,6,446,242,204
California,Modoc County,1,7,458,219,239
California,Modoc County,1,8,506,295,211
California,Modoc County,1,9,556,275,281
California,Modoc County,1,10,708,344,364
California,Modoc County,1,11,736,351,385
California,Modoc County,1,12,807,396,411
California,Modoc County,1,13,827,418,409
California,Modoc County,1,14,634,329,305
California,Modoc County,1,15,474,243,231
California,Modoc County,1,16,351,175,176
California,Modoc County,1,17,219,98,121
California,Modoc County,1,18,227,101,126
California,Modoc County,2,0,9686,4878,4808
California,Modoc County,2,1,545,271,274
California,Modoc County,2,2,564,297,267
California,Modoc County,2,3,602,298,304
California,Modoc County,2,4,604,311,293
California,Modoc County,2,5,422,215,207
California,Modoc County,2,6,446,242,204
California,Modoc County,2,7,458,219,239
California,Modoc County,2,8,506,295,211
California,Modoc County,2,9,556,275,281
California,Modoc County,2,10,708,344,364
California,Modoc County,2,11,736,351,385
California,Modoc County,2,12,807,396,411
California,Modoc County,2,13,827,418,409
California,Modoc County,2,14,634,329,305
California,Modoc County,2,15,474,243,231
California,Modoc County,2,16,351,175,176
California,Modoc County,2,17,219,98,121
California,Modoc County,2,18,227,101,126
California,Modoc County,3,0,9699,4885,4814
California,Modoc County,3,1,550,275,275
California,Modoc County,3,2,561,296,265
California,Modoc County,3,3,596,296,300
California,Modoc County,3,4,609,316,293
California,Modoc County,3,5,421,212,209
California,Modoc County,3,6,453,243,210
California,Modoc County,3,7,461,221,240
California,Modoc County,3,8,501,291,210
California,Modoc County,3,9,556,278,278
California,Modoc County,3,10,697,338,359
California,Modoc County,3,11,739,351,388
California,Modoc County,3,12,804,396,408
California,Modoc County,3,13,834,419,415
California,Modoc County,3,14,632,325,307
California,Modoc County,3,15,484,251,233
California,Modoc County,3,16,348,168,180
California,Modoc County,3,17,229,108,121
California,Modoc County,3,18,224,101,123
California,Modoc County,4,0,9512,4804,4708
California,Modoc County,4,1,494,252,242
California,Modoc County,4,2,541,287,254
California,Modoc County,4,3,568,281,287
California,Modoc County,4,4,624,337,287
California,Modoc County,4,5,390,202,188
California,Modoc County,4,6,442,237,205
California,Modoc County,4,7,465,219,246
California,Modoc County,4,8,475,272,203
California,Modoc County,4,9,550,285,265
California,Modoc County,4,10,632,292,340
California,Modoc County,4,11,741,351,390
California,Modoc County,4,12,781,392,389
California,Modoc County,4,13,858,432,426
California,Modoc County,4,14,619,307,312
California,Modoc County,4,15,513,278,235
California,Modoc County,4,16,332,156,176
California,Modoc County,4,17,260,126,134
California,Modoc County,4,18,227,98,129
California,Modoc County,5,0,9355,4735,4620
California,Modoc County,5,1,467,240,227
California,Modoc County,5,2,525,276,249
California,Modoc County,5,3,566,296,270
California,Modoc County,5,4,611,318,293
California,Modoc County,5,5,404,215,189
California,Modoc County,5,6,417,215,202
California,Modoc County,5,7,449,221,228
California,Modoc County,5,8,469,248,221
California,Modoc County,5,9,545,291,254
California,Modoc County,5,10,562,258,304
California,Modoc County,5,11,725,352,373
California,Modoc County,5,12,773,388,385
California,Modoc County,5,13,816,415,401
California,Modoc County,5,14,680,336,344
California,Modoc County,5,15,529,283,246
California,Modoc County,5,16,326,157,169
California,Modoc County,5,17,256,122,134
California,Modoc County,5,18,235,104,131
California,Modoc County,6,0,9149,4636,4513
California,Modoc County,6,1,458,236,222
California,Modoc County,6,2,501,266,235
California,Modoc County,6,3,529,289,240
California,Modoc County,6,4,559,294,265
California,Modoc County,6,5,400,212,188
California,Modoc County,6,6,400,205,195
California,Modoc County,6,7,463,236,227
California,Modoc County,6,8,457,234,223
California,Modoc County,6,9,508,278,230
California,Modoc County,6,10,520,241,279
California,Modoc County,6,11,683,331,352
California,Modoc County,6,12,755,370,385
California,Modoc County,6,13,802,396,406
California,Modoc County,6,14,721,362,359
California,Modoc County,6,15,564,296,268
California,Modoc County,6,16,330,164,166
California,Modoc County,6,17,254,120,134
California,Modoc County,6,18,245,106,139
California,Modoc County,7,0,9080,4579,4501
California,Modoc County,7,1,456,227,229
California,Modoc County,7,2,492,253,239
California,Modoc County,7,3,533,293,240
California,Modoc County,7,4,505,256,249
California,Modoc County,7,5,415,227,188
California,Modoc County,7,6,409,202,207
California,Modoc County,7,7,458,245,213
California,Modoc County,7,8,453,222,231
California,Modoc County,7,9,491,269,222
California,Modoc County,7,10,505,242,263
California,Modoc County,7,11,677,335,342
California,Modoc County,7,12,720,336,384
California,Modoc County,7,13,786,388,398
California,Modoc County,7,14,736,370,366
California,Modoc County,7,15,592,315,277
California,Modoc County,7,16,345,172,173
California,Modoc County,7,17,264,124,140
California,Modoc County,7,18,243,103,140
California,Modoc County,8,0,9048,4581,4467
California,Modoc County,8,1,420,211,209
California,Modoc County,8,2,492,254,238
California,Modoc County,8,3,527,295,232
California,Modoc County,8,4,495,254,241
California,Modoc County,8,5,431,230,201
California,Modoc County,8,6,404,208,196
California,Modoc County,8,7,458,237,221
California,Modoc County,8,8,478,236,242
California,Modoc County,8,9,465,254,211
California,Modoc County,8,10,504,251,253
California,Modoc County,8,11,667,313,354
California,Modoc County,8,12,678,319,359
California,Modoc County,8,13,773,393,380
California,Modoc County,8,14,771,391,380
California,Modoc County,8,15,591,313,278
California,Modoc County,8,16,377,187,190
California,Modoc County,8,17,271,120,151
California,Modoc County,8,18,246,115,131
California,Modoc County,9,0,8935,4516,4419
California,Modoc County,9,1,413,193,220
California,Modoc County,9,2,514,272,242
California,Modoc County,9,3,506,274,232
California,Modoc County,9,4,452,231,221
California,Modoc County,9,5,416,226,190
California,Modoc County,9,6,437,220,217
California,Modoc County,9,7,456,229,227
California,Modoc County,9,8,478,245,233
California,Modoc County,9,9,445,231,214
California,Modoc County,9,10,493,251,242
California,Modoc County,9,11,596,274,322
California,Modoc County,9,12,680,322,358
California,Modoc County,9,13,753,391,362
California,Modoc County,9,14,790,402,388
California,Modoc County,9,15,578,295,283
California,Modoc County,9,16,420,223,197
California,Modoc County,9,17,251,113,138
California,Modoc County,9,18,257,124,133
California,Modoc County,10,0,8848,4429,4419
California,Modoc County,10,1,419,205,214
California,Modoc County,10,2,500,252,248
California,Modoc County,10,3,494,258,236
California,Modoc County,10,4,428,222,206
California,Modoc County,10,5,402,211,191
California,Modoc County,10,6,463,240,223
California,Modoc County,10,7,440,205,235
California,Modoc County,10,8,441,218,223
California,Modoc County,10,9,443,214,229
California,Modoc County,10,10,492,265,227
California,Modoc County,10,11,550,253,297
California,Modoc County,10,12,700,330,370
California,Modoc County,10,13,755,377,378
California,Modoc County,10,14,749,388,361
California,Modoc County,10,15,625,327,298
California,Modoc County,10,16,432,230,202
California,Modoc County,10,17,257,117,140
California,Modoc County,10,18,258,117,141
California,Modoc County,11,0,8777,4386,4391
California,Modoc County,11,1,435,204,231
California,Modoc County,11,2,497,252,245
California,Modoc County,11,3,475,244,231
California,Modoc County,11,4,435,235,200
California,Modoc County,11,5,397,208,189
California,Modoc County,11,6,446,232,214
California,Modoc County,11,7,437,200,237
California,Modoc County,11,8,461,233,228
California,Modoc County,11,9,436,201,235
California,Modoc County,11,10,472,259,213
California,Modoc County,11,11,503,227,276
California,Modoc County,11,12,659,323,336
California,Modoc County,11,13,766,375,391
California,Modoc County,11,14,754,379,375
California,Modoc County,11,15,640,338,302
California,Modoc County,11,16,455,245,210
California,Modoc County,11,17,258,121,137
California,Modoc County,11,18,251,110,141
California,Mono County,1,0,14202,7548,6654
California,Mono County,1,1,893,439,454
California,Mono County,1,2,828,427,401
California,Mono County,1,3,770,380,390
California,Mono County,1,4,820,425,395
California,Mono County,1,5,1118,628,490
California,Mono County,1,6,1277,706,571
California,Mono County,1,7,976,546,430
California,Mono County,1,8,967,538,429
California,Mono County,1,9,942,510,432
California,Mono County,1,10,1130,560,570
California,Mono County,1,11,1212,652,560
California,Mono County,1,12,1079,570,509
California,Mono County,1,13,813,441,372
California,Mono County,1,14,534,293,241
California,Mono County,1,15,388,178,210
California,Mono County,1,16,236,143,93
California,Mono County,1,17,140,82,58
California,Mono County,1,18,79,30,49
California,Mono County,2,0,14206,7551,6655
California,Mono County,2,1,893,439,454
California,Mono County,2,2,828,427,401
California,Mono County,2,3,770,380,390
California,Mono County,2,4,820,425,395
California,Mono County,2,5,1119,628,491
California,Mono County,2,6,1278,707,571
California,Mono County,2,7,976,546,430
California,Mono County,2,8,967,538,429
California,Mono County,2,9,942,510,432
California,Mono County,2,10,1130,560,570
California,Mono County,2,11,1212,652,560
California,Mono County,2,12,1080,571,509
California,Mono County,2,13,813,441,372
California,Mono County,2,14,534,293,241
California,Mono County,2,15,389,179,210
California,Mono County,2,16,236,143,93
California,Mono County,2,17,140,82,58
California,Mono County,2,18,79,30,49
California,Mono County,3,0,14257,7593,6664
California,Mono County,3,1,868,424,444
California,Mono County,3,2,830,427,403
California,Mono County,3,3,770,381,389
California,Mono County,3,4,827,435,392
California,Mono County,3,5,1132,638,494
California,Mono County,3,6,1293,718,575
California,Mono County,3,7,983,551,432
California,Mono County,3,8,959,533,426
California,Mono County,3,9,945,515,430
California,Mono County,3,10,1124,559,565
California,Mono County,3,11,1223,658,565
California,Mono County,3,12,1081,567,514
California,Mono County,3,13,826,451,375
California,Mono County,3,14,545,300,245
California,Mono County,3,15,393,184,209
California,Mono County,3,16,232,137,95
California,Mono County,3,17,144,85,59
California,Mono County,3,18,82,30,52
California,Mono County,4,0,14423,7678,6745
California,Mono County,4,1,847,411,436
California,Mono County,4,2,843,417,426
California,Mono County,4,3,792,401,391
California,Mono County,4,4,841,447,394
California,Mono County,4,5,1074,608,466
California,Mono County,4,6,1315,744,571
California,Mono County,4,7,1033,542,491
California,Mono County,4,8,940,524,416
California,Mono County,4,9,954,530,424
California,Mono County,4,10,1088,561,527
California,Mono County,4,11,1229,654,575
California,Mono County,4,12,1106,573,533
California,Mono County,4,13,898,491,407
California,Mono County,4,14,591,328,263
California,Mono County,4,15,389,188,201
California,Mono County,4,16,229,125,104
California,Mono County,4,17,161,98,63
California,Mono County,4,18,93,36,57
California,Mono County,5,0,14334,7674,6660
California,Mono County,5,1,803,377,426
California,Mono County,5,2,837,428,409
California,Mono County,5,3,767,395,372
California,Mono County,5,4,833,444,389
California,Mono County,5,5,1015,582,433
California,Mono County,5,6,1298,744,554
California,Mono County,5,7,1078,567,511
California,Mono County,5,8,911,514,397
California,Mono County,5,9,939,506,433
California,Mono County,5,10,1025,545,480
California,Mono County,5,11,1229,653,576
California,Mono County,5,12,1099,593,506
California,Mono County,5,13,942,497,445
California,Mono County,5,14,635,359,276
California,Mono County,5,15,390,185,205
California,Mono County,5,16,252,133,119
California,Mono County,5,17,181,112,69
California,Mono County,5,18,100,40,60
California,Mono County,6,0,14074,7494,6580
California,Mono County,6,1,752,358,394
California,Mono County,6,2,828,404,424
California,Mono County,6,3,736,376,360
California,Mono County,6,4,793,428,365
California,Mono County,6,5,996,571,425
California,Mono County,6,6,1180,651,529
California,Mono County,6,7,1117,572,545
California,Mono County,6,8,855,491,364
California,Mono County,6,9,942,516,426
California,Mono County,6,10,940,511,429
California,Mono County,6,11,1196,621,575
California,Mono County,6,12,1102,604,498
California,Mono County,6,13,1001,527,474
California,Mono County,6,14,635,343,292
California,Mono County,6,15,432,225,207
California,Mono County,6,16,260,126,134
California,Mono County,6,17,192,119,73
California,Mono County,6,18,117,51,66
California,Mono County,7,0,14142,7521,6621
California,Mono County,7,1,745,353,392
California,Mono County,7,2,821,391,430
California,Mono County,7,3,752,372,380
California,Mono County,7,4,766,405,361
California,Mono County,7,5,1053,602,451
California,Mono County,7,6,1150,651,499
California,Mono County,7,7,1156,602,554
California,Mono County,7,8,845,460,385
California,Mono County,7,9,919,509,410
California,Mono County,7,10,904,496,408
California,Mono County,7,11,1148,584,564
California,Mono County,7,12,1123,635,488
California,Mono County,7,13,1005,534,471
California,Mono County,7,14,678,357,321
California,Mono County,7,15,467,251,216
California,Mono County,7,16,290,140,150
California,Mono County,7,17,189,111,78
California,Mono County,7,18,131,68,63
California,Mono County,8,0,14043,7471,6572
California,Mono County,8,1,713,355,358
California,Mono County,8,2,792,382,410
California,Mono County,8,3,756,376,380
California,Mono County,8,4,727,369,358
California,Mono County,8,5,990,552,438
California,Mono County,8,6,1110,618,492
California,Mono County,8,7,1118,586,532
California,Mono County,8,8,878,476,402
California,Mono County,8,9,855,466,389
California,Mono County,8,10,884,490,394
California,Mono County,8,11,1108,580,528
California,Mono County,8,12,1160,642,518
California,Mono County,8,13,1034,547,487
California,Mono County,8,14,774,423,351
California,Mono County,8,15,505,280,225
California,Mono County,8,16,304,144,160
California,Mono County,8,17,181,103,78
California,Mono County,8,18,154,82,72
California,Mono County,9,0,14202,7534,6668
California,Mono County,9,1,694,359,335
California,Mono County,9,2,759,361,398
California,Mono County,9,3,787,381,406
California,Mono County,9,4,751,398,353
California,Mono County,9,5,958,512,446
California,Mono County,9,6,1072,610,462
California,Mono County,9,7,1095,564,531
California,Mono County,9,8,914,484,430
California,Mono County,9,9,876,470,406
California,Mono County,9,10,922,517,405
California,Mono County,9,11,1073,571,502
California,Mono County,9,12,1171,639,532
California,Mono County,9,13,1072,568,504
California,Mono County,9,14,842,452,390
California,Mono County,9,15,554,309,245
California,Mono County,9,16,312,152,160
California,Mono County,9,17,175,98,77
California,Mono County,9,18,175,89,86
California,Mono County,10,0,14235,7571,6664
California,Mono County,10,1,694,368,326
California,Mono County,10,2,720,337,383
California,Mono County,10,3,774,394,380
California,Mono County,10,4,749,384,365
California,Mono County,10,5,1005,543,462
California,Mono County,10,6,1022,583,439
California,Mono County,10,7,1105,575,530
California,Mono County,10,8,960,506,454
California,Mono County,10,9,867,474,393
California,Mono County,10,10,916,488,428
California,Mono County,10,11,999,545,454
California,Mono County,10,12,1171,635,536
California,Mono County,10,13,1092,581,511
California,Mono County,10,14,866,456,410
California,Mono County,10,15,583,336,247
California,Mono County,10,16,329,165,164
California,Mono County,10,17,187,97,90
California,Mono County,10,18,196,104,92
California,Mono County,11,0,14250,7571,6679
California,Mono County,11,1,691,360,331
California,Mono County,11,2,702,330,372
California,Mono County,11,3,778,393,385
California,Mono County,11,4,750,388,362
California,Mono County,11,5,982,548,434
California,Mono County,11,6,1027,577,450
California,Mono County,11,7,1059,532,527
California,Mono County,11,8,976,507,469
California,Mono County,11,9,871,485,386
California,Mono County,11,10,947,517,430
California,Mono County,11,11,941,529,412
California,Mono County,11,12,1158,593,565
California,Mono County,11,13,1115,608,507
California,Mono County,11,14,899,478,421
California,Mono County,11,15,571,317,254
California,Mono County,11,16,380,204,176
California,Mono County,11,17,198,97,101
California,Mono County,11,18,205,108,97
California,Monterey County,1,0,415057,213431,201626
California,Monterey County,1,1,32547,16723,15824
California,Monterey County,1,2,30577,15797,14780
California,Monterey County,1,3,29037,14861,14176
California,Monterey County,1,4,32624,16940,15684
California,Monterey County,1,5,32481,17714,14767
California,Monterey County,1,6,32063,17292,14771
California,Monterey County,1,7,30014,16248,13766
California,Monterey County,1,8,27767,14862,12905
California,Monterey County,1,9,27053,14550,12503
California,Monterey County,1,10,26678,13946,12732
California,Monterey County,1,11,26576,13483,13093
California,Monterey County,1,12,23558,11799,11759
California,Monterey County,1,13,19660,9784,9876
California,Monterey County,1,14,13390,6413,6977
California,Monterey County,1,15,9531,4447,5084
California,Monterey County,1,16,8090,3499,4591
California,Monterey County,1,17,6654,2725,3929
California,Monterey County,1,18,6757,2348,4409
California,Monterey County,2,0,415061,213432,201629
California,Monterey County,2,1,32548,16723,15825
California,Monterey County,2,2,30579,15797,14782
California,Monterey County,2,3,29038,14862,14176
California,Monterey County,2,4,32625,16940,15685
California,Monterey County,2,5,32482,17715,14767
California,Monterey County,2,6,32062,17292,14770
California,Monterey County,2,7,30014,16248,13766
California,Monterey County,2,8,27769,14862,12907
California,Monterey County,2,9,27054,14551,12503
California,Monterey County,2,10,26678,13946,12732
California,Monterey County,2,11,26576,13483,13093
California,Monterey County,2,12,23556,11798,11758
California,Monterey County,2,13,19660,9784,9876
California,Monterey County,2,14,13390,6413,6977
California,Monterey County,2,15,9530,4447,5083
California,Monterey County,2,16,8090,3499,4591
California,Monterey County,2,17,6654,2725,3929
California,Monterey County,2,18,6756,2347,4409
California,Monterey County,3,0,416396,214206,202190
California,Monterey County,3,1,32694,16801,15893
California,Monterey County,3,2,30683,15833,14850
California,Monterey County,3,3,28995,14848,14147
California,Monterey County,3,4,32472,16846,15626
California,Monterey County,3,5,32595,17784,14811
California,Monterey County,3,6,32149,17351,14798
California,Monterey County,3,7,30274,16394,13880
California,Monterey County,3,8,27783,14882,12901
California,Monterey County,3,9,27141,14628,12513
California,Monterey County,3,10,26705,13985,12720
California,Monterey County,3,11,26620,13486,13134
California,Monterey County,3,12,23663,11886,11777
California,Monterey County,3,13,19928,9896,10032
California,Monterey County,3,14,13540,6497,7043
California,Monterey County,3,15,9611,4485,5126
California,Monterey County,3,16,8034,3485,4549
California,Monterey County,3,17,6691,2751,3940
California,Monterey County,3,18,6818,2368,4450
California,Monterey County,4,0,420542,216062,204480
California,Monterey County,4,1,33418,17156,16262
California,Monterey County,4,2,31373,16100,15273
California,Monterey County,4,3,28993,14849,14144
California,Monterey County,4,4,31696,16397,15299
California,Monterey County,4,5,32972,17883,15089
California,Monterey County,4,6,32330,17352,14978
California,Monterey County,4,7,30990,16710,14280
California,Monterey County,4,8,27649,14819,12830
California,Monterey County,4,9,27414,14761,12653
California,Monterey County,4,10,26428,13906,12522
California,Monterey County,4,11,26675,13471,13204
California,Monterey County,4,12,23980,12088,11892
California,Monterey County,4,13,20807,10296,10511
California,Monterey County,4,14,14160,6845,7315
California,Monterey County,4,15,9921,4655,5266
California,Monterey County,4,16,7908,3471,4437
California,Monterey County,4,17,6804,2851,3953
California,Monterey County,4,18,7024,2452,4572
California,Monterey County,5,0,425000,218110,206890
California,Monterey County,5,1,33494,17201,16293
California,Monterey County,5,2,32172,16557,15615
California,Monterey County,5,3,29310,14938,14372
California,Monterey County,5,4,31081,15978,15103
California,Monterey County,5,5,33447,18170,15277
California,Monterey County,5,6,32363,17283,15080
California,Monterey County,5,7,31568,16947,14621
California,Monterey County,5,8,27899,14949,12950
California,Monterey County,5,9,27571,14796,12775
California,Monterey County,5,10,26162,13875,12287
California,Monterey County,5,11,26637,13479,13158
California,Monterey County,5,12,24529,12284,12245
California,Monterey County,5,13,20936,10368,10568
California,Monterey County,5,14,15570,7534,8036
California,Monterey County,5,15,10344,4858,5486
California,Monterey County,5,16,7917,3483,4434
California,Monterey County,5,17,6743,2861,3882
California,Monterey County,5,18,7257,2549,4708
California,Monterey County,6,0,427054,218616,208438
California,Monterey County,6,1,33351,17045,16306
California,Monterey County,6,2,32857,16879,15978
California,Monterey County,6,3,29599,15108,14491
California,Monterey County,6,4,30482,15623,14859
California,Monterey County,6,5,33254,17868,15386
California,Monterey County,6,6,32098,17118,14980
California,Monterey County,6,7,31814,17065,14749
California,Monterey County,6,8,28094,15040,13054
California,Monterey County,6,9,27388,14634,12754
California,Monterey County,6,10,26064,13885,12179
California,Monterey County,6,11,26319,13314,13005
California,Monterey County,6,12,24848,12279,12569
California,Monterey County,6,13,21332,10612,10720
California,Monterey County,6,14,16419,7892,8527
California,Monterey County,6,15,10972,5174,5798
California,Monterey County,6,16,7974,3548,4426
California,Monterey County,6,17,6680,2839,3841
California,Monterey County,6,18,7509,2693,4816
California,Monterey County,7,0,428980,218906,210074
California,Monterey County,7,1,33291,17004,16287
California,Monterey County,7,2,33091,16904,16187
California,Monterey County,7,3,29982,15292,14690
California,Monterey County,7,4,30007,15361,14646
California,Monterey County,7,5,33168,17587,15581
California,Monterey County,7,6,31774,16868,14906
California,Monterey County,7,7,31929,17062,14867
California,Monterey County,7,8,28111,15000,13111
California,Monterey County,7,9,27245,14544,12701
California,Monterey County,7,10,25860,13754,12106
California,Monterey County,7,11,26059,13196,12863
California,Monterey County,7,12,25093,12359,12734
California,Monterey County,7,13,21847,10785,11062
California,Monterey County,7,14,17380,8399,8981
California,Monterey County,7,15,11631,5481,6150
California,Monterey County,7,16,8115,3679,4436
California,Monterey County,7,17,6611,2798,3813
California,Monterey County,7,18,7786,2833,4953
California,Monterey County,8,0,431241,219890,211351
California,Monterey County,8,1,33072,16824,16248
California,Monterey County,8,2,33115,16954,16161
California,Monterey County,8,3,30423,15642,14781
California,Monterey County,8,4,30123,15314,14809
California,Monterey County,8,5,32683,17262,15421
California,Monterey County,8,6,31572,16746,14826
California,Monterey County,8,7,31729,16914,14815
California,Monterey County,8,8,28777,15327,13450
California,Monterey County,8,9,26736,14287,12449
California,Monterey County,8,10,26155,13858,12297
California,Monterey County,8,11,25594,13023,12571
California,Monterey County,8,12,25359,12466,12893
California,Monterey County,8,13,22332,11039,11293
California,Monterey County,8,14,18273,8850,9423
California,Monterey County,8,15,12315,5801,6514
California,Monterey County,8,16,8396,3852,4544
California,Monterey County,8,17,6611,2817,3794
California,Monterey County,8,18,7976,2914,5062
California,Monterey County,9,0,434767,222002,212765
California,Monterey County,9,1,32401,16581,15820
California,Monterey County,9,2,33363,17067,16296
California,Monterey County,9,3,30988,15898,15090
California,Monterey County,9,4,30422,15409,15013
California,Monterey County,9,5,32109,16962,15147
California,Monterey County,9,6,31747,16841,14906
California,Monterey County,9,7,31911,17129,14782
California,Monterey County,9,8,29255,15559,13696
California,Monterey County,9,9,26657,14308,12349
California,Monterey County,9,10,26486,14079,12407
California,Monterey County,9,11,25433,13050,12383
California,Monterey County,9,12,25580,12519,13061
California,Monterey County,9,13,22737,11303,11434
California,Monterey County,9,14,19251,9296,9955
California,Monterey County,9,15,12974,6148,6826
California,Monterey County,9,16,8745,4026,4719
California,Monterey County,9,17,6496,2774,3722
California,Monterey County,9,18,8212,3053,5159
California,Monterey County,10,0,435477,222120,213357
California,Monterey County,10,1,31569,16111,15458
California,Monterey County,10,2,33200,17050,16150
California,Monterey County,10,3,31680,16254,15426
California,Monterey County,10,4,30461,15289,15172
California,Monterey County,10,5,31152,16344,14808
California,Monterey County,10,6,31759,16807,14952
California,Monterey County,10,7,31397,16794,14603
California,Monterey County,10,8,29615,15785,13830
California,Monterey County,10,9,26795,14390,12405
California,Monterey County,10,10,26517,14093,12424
California,Monterey County,10,11,25184,13042,12142
California,Monterey County,10,12,25474,12504,12970
California,Monterey County,10,13,23281,11502,11779
California,Monterey County,10,14,19381,9360,10021
California,Monterey County,10,15,14127,6695,7432
California,Monterey County,10,16,9084,4233,4851
California,Monterey County,10,17,6433,2738,3695
California,Monterey County,10,18,8368,3129,5239
California,Monterey County,11,0,435594,221787,213807
California,Monterey County,11,1,30950,15799,15151
California,Monterey County,11,2,32700,16798,15902
California,Monterey County,11,3,32143,16481,15662
California,Monterey County,11,4,30786,15445,15341
California,Monterey County,11,5,30484,15836,14648
California,Monterey County,11,6,31403,16520,14883
California,Monterey County,11,7,31037,16644,14393
California,Monterey County,11,8,29768,15836,13932
California,Monterey County,11,9,27046,14491,12555
California,Monterey County,11,10,26268,13932,12336
California,Monterey County,11,11,25048,13066,11982
California,Monterey County,11,12,25217,12413,12804
California,Monterey County,11,13,23543,11457,12086
California,Monterey County,11,14,19759,9569,10190
California,Monterey County,11,15,14899,7026,7873
California,Monterey County,11,16,9585,4505,5080
California,Monterey County,11,17,6532,2823,3709
California,Monterey County,11,18,8426,3146,5280
California,Napa County,1,0,136484,68159,68325
California,Napa County,1,1,8131,4196,3935
California,Napa County,1,2,8576,4411,4165
California,Napa County,1,3,9040,4639,4401
California,Napa County,1,4,9473,4836,4637
California,Napa County,1,5,8289,4461,3828
California,Napa County,1,6,8519,4511,4008
California,Napa County,1,7,8236,4255,3981
California,Napa County,1,8,8526,4363,4163
California,Napa County,1,9,9325,4614,4711
California,Napa County,1,10,9937,4960,4977
California,Napa County,1,11,9995,4995,5000
California,Napa County,1,12,9423,4544,4879
California,Napa County,1,13,8420,4144,4276
California,Napa County,1,14,6161,2976,3185
California,Napa County,1,15,4361,2065,2296
California,Napa County,1,16,3628,1671,1957
California,Napa County,1,17,2948,1252,1696
California,Napa County,1,18,3496,1266,2230
California,Napa County,2,0,136578,68224,68354
California,Napa County,2,1,8137,4201,3936
California,Napa County,2,2,8577,4411,4166
California,Napa County,2,3,9042,4640,4402
California,Napa County,2,4,9476,4838,4638
California,Napa County,2,5,8300,4468,3832
California,Napa County,2,6,8529,4518,4011
California,Napa County,2,7,8241,4258,3983
California,Napa County,2,8,8535,4371,4164
California,Napa County,2,9,9338,4624,4714
California,Napa County,2,10,9951,4969,4982
California,Napa County,2,11,10004,5001,5003
California,Napa County,2,12,9430,4549,4881
California,Napa County,2,13,8419,4143,4276
California,Napa County,2,14,6162,2976,3186
California,Napa County,2,15,4363,2066,2297
California,Napa County,2,16,3628,1671,1957
California,Napa County,2,17,2948,1252,1696
California,Napa County,2,18,3498,1268,2230
California,Napa County,3,0,136808,68316,68492
California,Napa County,3,1,8140,4205,3935
California,Napa County,3,2,8595,4425,4170
California,Napa County,3,3,9053,4641,4412
California,Napa County,3,4,9448,4818,4630
California,Napa County,3,5,8357,4494,3863
California,Napa County,3,6,8549,4527,4022
California,Napa County,3,7,8256,4263,3993
California,Napa County,3,8,8522,4359,4163
California,Napa County,3,9,9309,4618,4691
California,Napa County,3,10,9928,4957,4971
California,Napa County,3,11,10029,5001,5028
California,Napa County,3,12,9446,4552,4894
California,Napa County,3,13,8489,4186,4303
California,Napa County,3,14,6213,2996,3217
California,Napa County,3,15,4406,2086,2320
California,Napa County,3,16,3633,1679,1954
California,Napa County,3,17,2936,1252,1684
California,Napa County,3,18,3499,1257,2242
California,Napa County,4,0,137750,68709,69041
California,Napa County,4,1,8055,4142,3913
California,Napa County,4,2,8644,4472,4172
California,Napa County,4,3,9055,4621,4434
California,Napa County,4,4,9355,4771,4584
California,Napa County,4,5,8476,4555,3921
California,Napa County,4,6,8536,4466,4070
California,Napa County,4,7,8476,4357,4119
California,Napa County,4,8,8460,4293,4167
California,Napa County,4,9,9258,4616,4642
California,Napa County,4,10,9778,4915,4863
California,Napa County,4,11,10104,5021,5083
California,Napa County,4,12,9495,4567,4928
California,Napa County,4,13,8834,4368,4466
California,Napa County,4,14,6435,3101,3334
California,Napa County,4,15,4601,2187,2414
California,Napa County,4,16,3687,1709,1978
California,Napa County,4,17,2925,1264,1661
California,Napa County,4,18,3576,1284,2292
California,Napa County,5,0,138625,69149,69476
California,Napa County,5,1,7938,4107,3831
California,Napa County,5,2,8668,4483,4185
California,Napa County,5,3,8922,4517,4405
California,Napa County,5,4,9248,4731,4517
California,Napa County,5,5,8715,4649,4066
California,Napa County,5,6,8495,4441,4054
California,Napa County,5,7,8583,4410,4173
California,Napa County,5,8,8504,4326,4178
California,Napa County,5,9,9221,4585,4636
California,Napa County,5,10,9618,4832,4786
California,Napa County,5,11,10019,4994,5025
California,Napa County,5,12,9690,4666,5024
California,Napa County,5,13,8804,4338,4466
California,Napa County,5,14,7074,3403,3671
California,Napa County,5,15,4840,2325,2515
California,Napa County,5,16,3723,1710,2013
California,Napa County,5,17,2972,1335,1637
California,Napa County,5,18,3591,1297,2294
California,Napa County,6,0,139706,69605,70101
California,Napa County,6,1,7814,4042,3772
California,Napa County,6,2,8642,4474,4168
California,Napa County,6,3,8903,4446,4457
California,Napa County,6,4,9268,4744,4524
California,Napa County,6,5,8962,4697,4265
California,Napa County,6,6,8360,4389,3971
California,Napa County,6,7,8780,4497,4283
California,Napa County,6,8,8543,4364,4179
California,Napa County,6,9,9258,4597,4661
California,Napa County,6,10,9458,4733,4725
California,Napa County,6,11,9964,5028,4936
California,Napa County,6,12,9762,4713,5049
California,Napa County,6,13,8977,4360,4617
California,Napa County,6,14,7417,3601,3816
California,Napa County,6,15,5176,2442,2734
California,Napa County,6,16,3866,1811,2055
California,Napa County,6,17,2952,1358,1594
California,Napa County,6,18,3604,1309,2295
California,Napa County,7,0,140567,70101,70466
California,Napa County,7,1,7633,3979,3654
California,Napa County,7,2,8592,4429,4163
California,Napa County,7,3,8935,4476,4459
California,Napa County,7,4,9197,4710,4487
California,Napa County,7,5,9065,4712,4353
California,Napa County,7,6,8446,4407,4039
California,Napa County,7,7,8884,4562,4322
California,Napa County,7,8,8644,4410,4234
California,Napa County,7,9,9191,4614,4577
California,Napa County,7,10,9386,4687,4699
California,Napa County,7,11,10044,5069,4975
California,Napa County,7,12,9694,4780,4914
California,Napa County,7,13,9118,4332,4786
California,Napa County,7,14,7673,3761,3912
California,Napa County,7,15,5504,2599,2905
California,Napa County,7,16,3973,1859,2114
California,Napa County,7,17,2974,1397,1577
California,Napa County,7,18,3614,1318,2296
California,Napa County,8,0,141096,70377,70719
California,Napa County,8,1,7519,3942,3577
California,Napa County,8,2,8473,4342,4131
California,Napa County,8,3,8929,4537,4392
California,Napa County,8,4,9116,4658,4458
California,Napa County,8,5,9026,4557,4469
California,Napa County,8,6,8535,4483,4052
California,Napa County,8,7,8759,4499,4260
California,Napa County,8,8,8860,4504,4356
California,Napa County,8,9,8952,4591,4361
California,Napa County,8,10,9447,4642,4805
California,Napa County,8,11,9893,5025,4868
California,Napa County,8,12,9765,4812,4953
California,Napa County,8,13,9214,4391,4823
California,Napa County,8,14,8023,3937,4086
California,Napa County,8,15,5799,2738,3061
California,Napa County,8,16,4106,1951,2155
California,Napa County,8,17,2997,1406,1591
California,Napa County,8,18,3683,1362,2321
California,Napa County,9,0,141185,70321,70864
California,Napa County,9,1,7355,3828,3527
California,Napa County,9,2,8268,4256,4012
California,Napa County,9,3,8878,4561,4317
California,Napa County,9,4,9032,4570,4462
California,Napa County,9,5,8790,4418,4372
California,Napa County,9,6,8618,4451,4167
California,Napa County,9,7,8766,4527,4239
California,Napa County,9,8,8977,4554,4423
California,Napa County,9,9,8815,4479,4336
California,Napa County,9,10,9436,4688,4748
California,Napa County,9,11,9701,4924,4777
California,Napa County,9,12,9793,4788,5005
California,Napa County,9,13,9321,4444,4877
California,Napa County,9,14,8411,4133,4278
California,Napa County,9,15,5939,2806,3133
California,Napa County,9,16,4323,2058,2265
California,Napa County,9,17,3115,1471,1644
California,Napa County,9,18,3647,1365,2282
California,Napa County,10,0,140386,69968,70418
California,Napa County,10,1,7121,3679,3442
California,Napa County,10,2,8048,4157,3891
California,Napa County,10,3,8792,4561,4231
California,Napa County,10,4,8901,4518,4383
California,Napa County,10,5,8640,4375,4265
California,Napa County,10,6,8597,4402,4195
California,Napa County,10,7,8667,4447,4220
California,Napa County,10,8,8943,4552,4391
California,Napa County,10,9,8713,4445,4268
California,Napa County,10,10,9377,4663,4714
California,Napa County,10,11,9523,4808,4715
California,Napa County,10,12,9693,4792,4901
California,Napa County,10,13,9308,4455,4853
California,Napa County,10,14,8304,4043,4261
California,Napa County,10,15,6480,3051,3429
California,Napa County,10,16,4471,2158,2313
California,Napa County,10,17,3138,1473,1665
California,Napa County,10,18,3670,1389,2281
California,Napa County,11,0,139417,69392,70025
California,Napa County,11,1,7049,3605,3444
California,Napa County,11,2,7801,4036,3765
California,Napa County,11,3,8569,4451,4118
California,Napa County,11,4,8764,4402,4362
California,Napa County,11,5,8444,4275,4169
California,Napa County,11,6,8651,4441,4210
California,Napa County,11,7,8468,4314,4154
California,Napa County,11,8,8958,4612,4346
California,Napa County,11,9,8675,4426,4249
California,Napa County,11,10,9159,4555,4604
California,Napa County,11,11,9274,4630,4644
California,Napa County,11,12,9707,4840,4867
California,Napa County,11,13,9233,4473,4760
California,Napa County,11,14,8379,4014,4365
California,Napa County,11,15,6716,3177,3539
California,Napa County,11,16,4711,2263,2448
California,Napa County,11,17,3197,1499,1698
California,Napa County,11,18,3662,1379,2283
California,Nevada County,1,0,98764,48835,49929
California,Nevada County,1,1,4365,2260,2105
California,Nevada County,1,2,4950,2510,2440
California,Nevada County,1,3,5798,3016,2782
California,Nevada County,1,4,6091,3134,2957
California,Nevada County,1,5,4439,2375,2064
California,Nevada County,1,6,4839,2589,2250
California,Nevada County,1,7,4815,2474,2341
California,Nevada County,1,8,4830,2517,2313
California,Nevada County,1,9,5655,2820,2835
California,Nevada County,1,10,7257,3455,3802
California,Nevada County,1,11,8569,4033,4536
California,Nevada County,1,12,9156,4329,4827
California,Nevada County,1,13,8826,4472,4354
California,Nevada County,1,14,6243,3043,3200
California,Nevada County,1,15,4355,2171,2184
California,Nevada County,1,16,3170,1508,1662
California,Nevada County,1,17,2647,1147,1500
California,Nevada County,1,18,2759,982,1777
California,Nevada County,2,0,98745,48824,49921
California,Nevada County,2,1,4362,2259,2103
California,Nevada County,2,2,4948,2508,2440
California,Nevada County,2,3,5798,3016,2782
California,Nevada County,2,4,6091,3134,2957
California,Nevada County,2,5,4435,2373,2062
California,Nevada County,2,6,4839,2589,2250
California,Nevada County,2,7,4815,2474,2341
California,Nevada County,2,8,4826,2515,2311
California,Nevada County,2,9,5653,2819,2834
California,Nevada County,2,10,7257,3455,3802
California,Nevada County,2,11,8569,4033,4536
California,Nevada County,2,12,9154,4328,4826
California,Nevada County,2,13,8824,4470,4354
California,Nevada County,2,14,6243,3043,3200
California,Nevada County,2,15,4355,2171,2184
California,Nevada County,2,16,3170,1508,1662
California,Nevada County,2,17,2647,1147,1500
California,Nevada County,2,18,2759,982,1777
California,Nevada County,3,0,98785,48841,49944
California,Nevada County,3,1,4355,2247,2108
California,Nevada County,3,2,4917,2494,2423
California,Nevada County,3,3,5764,2999,2765
California,Nevada County,3,4,6069,3121,2948
California,Nevada County,3,5,4480,2387,2093
California,Nevada County,3,6,4841,2586,2255
California,Nevada County,3,7,4836,2497,2339
California,Nevada County,3,8,4790,2499,2291
California,Nevada County,3,9,5653,2820,2833
California,Nevada County,3,10,7144,3407,3737
California,Nevada County,3,11,8530,4009,4521
California,Nevada County,3,12,9144,4321,4823
California,Nevada County,3,13,8930,4513,4417
California,Nevada County,3,14,6312,3078,3234
California,Nevada County,3,15,4416,2197,2219
California,Nevada County,3,16,3173,1523,1650
California,Nevada County,3,17,2632,1143,1489
California,Nevada County,3,18,2799,1000,1799
California,Nevada County,4,0,98697,48759,49938
California,Nevada County,4,1,4295,2193,2102
California,Nevada County,4,2,4835,2475,2360
California,Nevada County,4,3,5609,2895,2714
California,Nevada County,4,4,5932,3089,2843
California,Nevada County,4,5,4617,2439,2178
California,Nevada County,4,6,4780,2542,2238
California,Nevada County,4,7,4913,2566,2347
California,Nevada County,4,8,4658,2425,2233
California,Nevada County,4,9,5634,2801,2833
California,Nevada County,4,10,6680,3219,3461
California,Nevada County,4,11,8336,3885,4451
California,Nevada County,4,12,9066,4281,4785
California,Nevada County,4,13,9384,4692,4692
California,Nevada County,4,14,6595,3240,3355
California,Nevada County,4,15,4695,2300,2395
California,Nevada County,4,16,3190,1558,1632
California,Nevada County,4,17,2590,1139,1451
California,Nevada County,4,18,2888,1020,1868
California,Nevada County,5,0,98140,48440,49700
California,Nevada County,5,1,4199,2143,2056
California,Nevada County,5,2,4778,2423,2355
California,Nevada County,5,3,5385,2769,2616
California,Nevada County,5,4,5702,2999,2703
California,Nevada County,5,5,4623,2440,2183
California,Nevada County,5,6,4688,2474,2214
California,Nevada County,5,7,5009,2630,2379
California,Nevada County,5,8,4736,2436,2300
California,Nevada County,5,9,5408,2722,2686
California,Nevada County,5,10,6332,3097,3235
California,Nevada County,5,11,7911,3632,4279
California,Nevada County,5,12,9109,4309,4800
California,Nevada County,5,13,9212,4545,4667
California,Nevada County,5,14,7331,3628,3703
California,Nevada County,5,15,4975,2420,2555
California,Nevada County,5,16,3208,1577,1631
California,Nevada County,5,17,2572,1162,1410
California,Nevada County,5,18,2962,1034,1928
California,Nevada County,6,0,97952,48349,49603
California,Nevada County,6,1,4211,2175,2036
California,Nevada County,6,2,4771,2420,2351
California,Nevada County,6,3,5228,2670,2558
California,Nevada County,6,4,5425,2862,2563
California,Nevada County,6,5,4707,2453,2254
California,Nevada County,6,6,4585,2426,2159
California,Nevada County,6,7,5107,2662,2445
California,Nevada County,6,8,4881,2507,2374
California,Nevada County,6,9,5260,2680,2580
California,Nevada County,6,10,5910,2892,3018
California,Nevada County,6,11,7644,3568,4076
California,Nevada County,6,12,8969,4213,4756
California,Nevada County,6,13,9288,4501,4787
California,Nevada County,6,14,7820,3892,3928
California,Nevada County,6,15,5265,2534,2731
California,Nevada County,6,16,3440,1708,1732
California,Nevada County,6,17,2499,1140,1359
California,Nevada County,6,18,2942,1046,1896
California,Nevada County,7,0,98589,48545,50044
California,Nevada County,7,1,4233,2194,2039
California,Nevada County,7,2,4785,2392,2393
California,Nevada County,7,3,5178,2639,2539
California,Nevada County,7,4,5328,2825,2503
California,Nevada County,7,5,4775,2458,2317
California,Nevada County,7,6,4615,2431,2184
California,Nevada County,7,7,5165,2628,2537
California,Nevada County,7,8,5095,2622,2473
California,Nevada County,7,9,5128,2653,2475
California,Nevada County,7,10,5627,2785,2842
California,Nevada County,7,11,7415,3477,3938
California,Nevada County,7,12,8787,4062,4725
California,Nevada County,7,13,9375,4477,4898
California,Nevada County,7,14,8364,4164,4200
California,Nevada County,7,15,5579,2708,2871
California,Nevada County,7,16,3671,1819,1852
California,Nevada County,7,17,2468,1135,1333
California,Nevada County,7,18,3001,1076,1925
California,Nevada County,8,0,98709,48606,50103
California,Nevada County,8,1,4215,2184,2031
California,Nevada County,8,2,4740,2408,2332
California,Nevada County,8,3,5081,2594,2487
California,Nevada County,8,4,5220,2759,2461
California,Nevada County,8,5,4599,2377,2222
California,Nevada County,8,6,4591,2403,2188
California,Nevada County,8,7,5162,2624,2538
California,Nevada County,8,8,5421,2774,2647
California,Nevada County,8,9,4931,2539,2392
California,Nevada County,8,10,5583,2824,2759
California,Nevada County,8,11,7058,3314,3744
California,Nevada County,8,12,8529,3946,4583
California,Nevada County,8,13,9382,4373,5009
California,Nevada County,8,14,8941,4433,4508
California,Nevada County,8,15,5880,2868,3012
California,Nevada County,8,16,3833,1893,1940
California,Nevada County,8,17,2537,1193,1344
California,Nevada County,8,18,3006,1100,1906
California,Nevada County,9,0,98964,48652,50312
California,Nevada County,9,1,4217,2141,2076
California,Nevada County,9,2,4711,2428,2283
California,Nevada County,9,3,5065,2578,2487
California,Nevada County,9,4,5063,2674,2389
California,Nevada County,9,5,4444,2355,2089
California,Nevada County,9,6,4573,2340,2233
California,Nevada County,9,7,5167,2589,2578
California,Nevada County,9,8,5515,2854,2661
California,Nevada County,9,9,4894,2529,2365
California,Nevada County,9,10,5611,2833,2778
California,Nevada County,9,11,6655,3179,3476
California,Nevada County,9,12,8456,3832,4624
California,Nevada County,9,13,9336,4353,4983
California,Nevada County,9,14,9420,4626,4794
California,Nevada County,9,15,6217,3028,3189
California,Nevada County,9,16,4067,1980,2087
California,Nevada County,9,17,2532,1212,1320
California,Nevada County,9,18,3021,1121,1900
California,Nevada County,10,0,99503,48882,50621
California,Nevada County,10,1,4276,2145,2131
California,Nevada County,10,2,4636,2408,2228
California,Nevada County,10,3,5032,2537,2495
California,Nevada County,10,4,4992,2624,2368
California,Nevada County,10,5,4369,2320,2049
California,Nevada County,10,6,4618,2346,2272
California,Nevada County,10,7,5083,2579,2504
California,Nevada County,10,8,5708,2920,2788
California,Nevada County,10,9,5068,2626,2442
California,Nevada County,10,10,5524,2764,2760
California,Nevada County,10,11,6398,3110,3288
California,Nevada County,10,12,8104,3651,4453
California,Nevada County,10,13,9405,4389,5016
California,Nevada County,10,14,9311,4507,4804
California,Nevada County,10,15,7019,3474,3545
California,Nevada County,10,16,4306,2091,2215
California,Nevada County,10,17,2588,1248,1340
California,Nevada County,10,18,3066,1143,1923
California,Nevada County,11,0,99696,48920,50776
California,Nevada County,11,1,4282,2186,2096
California,Nevada County,11,2,4637,2390,2247
California,Nevada County,11,3,5006,2550,2456
California,Nevada County,11,4,4869,2543,2326
California,Nevada County,11,5,4218,2202,2016
California,Nevada County,11,6,4578,2334,2244
California,Nevada County,11,7,5038,2541,2497
California,Nevada County,11,8,5766,2927,2839
California,Nevada County,11,9,5257,2691,2566
California,Nevada County,11,10,5491,2787,2704
California,Nevada County,11,11,5960,2882,3078
California,Nevada County,11,12,7957,3634,4323
California,Nevada County,11,13,9257,4306,4951
California,Nevada County,11,14,9395,4507,4888
California,Nevada County,11,15,7531,3720,3811
California,Nevada County,11,16,4609,2228,2381
California,Nevada County,11,17,2796,1364,1432
California,Nevada County,11,18,3049,1128,1921
California,Orange County,1,0,3010232,1488780,1521452
California,Orange County,1,1,191691,98332,93359
California,Orange County,1,2,198769,101577,97192
California,Orange County,1,3,210195,107446,102749
California,Orange County,1,4,227689,117278,110411
California,Orange County,1,5,213601,110168,103433
California,Orange County,1,6,215362,110805,104557
California,Orange County,1,7,198166,100050,98116
California,Orange County,1,8,213605,105316,108289
California,Orange County,1,9,225438,111325,114113
California,Orange County,1,10,230596,114473,116123
California,Orange County,1,11,213589,105810,107779
California,Orange County,1,12,175127,84699,90428
California,Orange County,1,13,146727,70010,76717
California,Orange County,1,14,107421,50153,57268
California,Orange County,1,15,80033,36704,43329
California,Orange County,1,16,63133,27713,35420
California,Orange County,1,17,49570,19952,29618
California,Orange County,1,18,49520,16969,32551
California,Orange County,2,0,3010274,1488794,1521480
California,Orange County,2,1,191690,98331,93359
California,Orange County,2,2,198769,101577,97192
California,Orange County,2,3,210195,107446,102749
California,Orange County,2,4,227688,117278,110410
California,Orange County,2,5,213601,110168,103433
California,Orange County,2,6,215362,110805,104557
California,Orange County,2,7,198170,100050,98120
California,Orange County,2,8,213606,105316,108290
California,Orange County,2,9,225437,111324,114113
California,Orange County,2,10,230601,114475,116126
California,Orange County,2,11,213595,105813,107782
California,Orange County,2,12,175126,84698,90428
California,Orange County,2,13,146735,70013,76722
California,Orange County,2,14,107430,50154,57276
California,Orange County,2,15,80036,36707,43329
California,Orange County,2,16,63141,27716,35425
California,Orange County,2,17,49571,19953,29618
California,Orange County,2,18,49521,16970,32551
California,Orange County,3,0,3016559,1491620,1524939
California,Orange County,3,1,191501,98212,93289
California,Orange County,3,2,198404,101381,97023
California,Orange County,3,3,209753,107139,102614
California,Orange County,3,4,226088,116358,109730
California,Orange County,3,5,215763,111195,104568
California,Orange County,3,6,215553,110953,104600
California,Orange County,3,7,198958,100469,98489
California,Orange County,3,8,212123,104527,107596
California,Orange County,3,9,226045,111627,114418
California,Orange County,3,10,230295,114310,115985
California,Orange County,3,11,215021,106561,108460
California,Orange County,3,12,176968,85669,91299
California,Orange County,3,13,148019,70592,77427
California,Orange County,3,14,108387,50631,57756
California,Orange County,3,15,80654,37005,43649
California,Orange County,3,16,63173,27715,35458
California,Orange County,3,17,49801,20125,29676
California,Orange County,3,18,50053,17151,32902
California,Orange County,4,0,3050867,1507651,1543216
California,Orange County,4,1,191958,98351,93607
California,Orange County,4,2,198574,101516,97058
California,Orange County,4,3,209012,106617,102395
California,Orange County,4,4,220732,113398,107334
California,Orange County,4,5,223608,114660,108948
California,Orange County,4,6,217071,112007,105064
California,Orange County,4,7,203608,102797,100811
California,Orange County,4,8,206526,101760,104766
California,Orange County,4,9,228976,112768,116208
California,Orange County,4,10,229196,113761,115435
California,Orange County,4,11,220092,109117,110975
California,Orange County,4,12,184270,89508,94762
California,Orange County,4,13,154314,73462,80852
California,Orange County,4,14,112629,52681,59948
California,Orange County,4,15,83601,38344,45257
California,Orange County,4,16,64171,28203,35968
California,Orange County,4,17,50551,20697,29854
California,Orange County,4,18,51978,18004,33974
California,Orange County,5,0,3080419,1521636,1558783
California,Orange County,5,1,190947,97632,93315
California,Orange County,5,2,199817,102271,97546
California,Orange County,5,3,206782,105557,101225
California,Orange County,5,4,218120,111707,106413
California,Orange County,5,5,228737,116949,111788
California,Orange County,5,6,217684,112558,105126
California,Orange County,5,7,207935,105117,102818
California,Orange County,5,8,203155,100101,103054
California,Orange County,5,9,229077,112751,116326
California,Orange County,5,10,228119,113003,115116
California,Orange County,5,11,223050,110498,112552
California,Orange County,5,12,191632,93413,98219
California,Orange County,5,13,154874,73805,81069
California,Orange County,5,14,122242,57126,65116
California,Orange County,5,15,87256,40022,47234
California,Orange County,5,16,65933,29066,36867
California,Orange County,5,17,51124,21187,29937
California,Orange County,5,18,53935,18873,35062
California,Orange County,6,0,3108009,1535242,1572767
California,Orange County,6,1,189337,96786,92551
California,Orange County,6,2,200518,102719,97799
California,Orange County,6,3,206073,105207,100866
California,Orange County,6,4,215216,109974,105242
California,Orange County,6,5,229802,117288,112514
California,Orange County,6,6,220669,114178,106491
California,Orange County,6,7,212313,107540,104773
California,Orange County,6,8,202478,100125,102353
California,Orange County,6,9,226283,111099,115184
California,Orange County,6,10,227125,112356,114769
California,Orange County,6,11,226138,112042,114096
California,Orange County,6,12,198148,96953,101195
California,Orange County,6,13,158922,75819,83103
California,Orange County,6,14,127451,59467,67984
California,Orange County,6,15,92417,42389,50028
California,Orange County,6,16,68140,30237,37903
California,Orange County,6,17,51497,21450,30047
California,Orange County,6,18,55482,19613,35869
California,Orange County,7,0,3130322,1545898,1584424
California,Orange County,7,1,189328,96991,92337
California,Orange County,7,2,198481,101645,96836
California,Orange County,7,3,205060,104561,100499
California,Orange County,7,4,211965,107986,103979
California,Orange County,7,5,228802,116943,111859
California,Orange County,7,6,225401,116491,108910
California,Orange County,7,7,215061,109168,105893
California,Orange County,7,8,201353,99809,101544
California,Orange County,7,9,221968,108622,113346
California,Orange County,7,10,226162,111729,114433
California,Orange County,7,11,228677,113216,115461
California,Orange County,7,12,203596,99981,103615
California,Orange County,7,13,164274,78394,85880
California,Orange County,7,14,133279,62255,71024
California,Orange County,7,15,97216,44424,52792
California,Orange County,7,16,70351,31386,38965
California,Orange County,7,17,52283,21857,30426
California,Orange County,7,18,57065,20440,36625
California,Orange County,8,0,3153962,1557813,1596149
California,Orange County,8,1,190033,97507,92526
California,Orange County,8,2,196347,100657,95690
California,Orange County,8,3,203307,103515,99792
California,Orange County,8,4,211056,107512,103544
California,Orange County,8,5,223810,114397,109413
California,Orange County,8,6,232474,120028,112446
California,Orange County,8,7,215932,109804,106128
California,Orange County,8,8,202520,100686,101834
California,Orange County,8,9,216087,105611,110476
California,Orange County,8,10,227771,112200,115571
California,Orange County,8,11,228690,113197,115493
California,Orange County,8,12,209738,103452,106286
California,Orange County,8,13,170026,81301,88725
California,Orange County,8,14,139388,65099,74289
California,Orange County,8,15,101556,46364,55192
California,Orange County,8,16,72827,32618,40209
California,Orange County,8,17,53187,22355,30832
California,Orange County,8,18,59213,21510,37703
California,Orange County,9,0,3170707,1565572,1605135
California,Orange County,9,1,189467,97047,92420
California,Orange County,9,2,194364,99796,94568
California,Orange County,9,3,201653,102682,98971
California,Orange County,9,4,209370,106462,102908
California,Orange County,9,5,217970,111178,106792
California,Orange County,9,6,239270,123548,115722
California,Orange County,9,7,217191,110823,106368
California,Orange County,9,8,204622,102028,102594
California,Orange County,9,9,209032,101871,107161
California,Orange County,9,10,229818,112876,116942
California,Orange County,9,11,226913,112376,114537
California,Orange County,9,12,214035,105604,108431
California,Orange County,9,13,176397,84681,91716
California,Orange County,9,14,144878,67602,77276
California,Orange County,9,15,105253,48028,57225
California,Orange County,9,16,75587,33835,41752
California,Orange County,9,17,54122,22884,31238
California,Orange County,9,18,60765,22251,38514
California,Orange County,10,0,3179950,1570063,1609887
California,Orange County,10,1,188483,96683,91800
California,Orange County,10,2,190976,97823,93153
California,Orange County,10,3,201121,102732,98389
California,Orange County,10,4,206768,105063,101705
California,Orange County,10,5,214189,108899,105290
California,Orange County,10,6,243519,125675,117844
California,Orange County,10,7,216189,110689,105500
California,Orange County,10,8,207120,103321,103799
California,Orange County,10,9,204490,99738,104752
California,Orange County,10,10,228758,112196,116562
California,Orange County,10,11,224636,111021,113615
California,Orange County,10,12,216101,106779,109322
California,Orange County,10,13,182490,87919,94571
California,Orange County,10,14,145147,67837,77310
California,Orange County,10,15,113318,51678,61640
California,Orange County,10,16,79078,35388,43690
California,Orange County,10,17,55599,23719,31880
California,Orange County,10,18,61968,22903,39065
California,Orange County,11,0,3185968,1572801,1613167
California,Orange County,11,1,187486,96162,91324
California,Orange County,11,2,188161,96378,91783
California,Orange County,11,3,200154,102332,97822
California,Orange County,11,4,204892,104049,100843
California,Orange County,11,5,210107,106528,103579
California,Orange County,11,6,243613,125620,117993
California,Orange County,11,7,216966,111107,105859
California,Orange County,11,8,210516,105483,105033
California,Orange County,11,9,201901,98624,103277
California,Orange County,11,10,224329,109645,114684
California,Orange County,11,11,222233,109741,112492
California,Orange County,11,12,217563,107363,110200
California,Orange County,11,13,187660,90897,96763
California,Orange County,11,14,148314,69512,78802
California,Orange County,11,15,117735,53676,64059
California,Orange County,11,16,83665,37454,46211
California,Orange County,11,17,57494,24750,32744
California,Orange County,11,18,63179,23480,39699
California,Placer County,1,0,348432,170151,178281
California,Placer County,1,1,20851,10613,10238
California,Placer County,1,2,23604,12077,11527
California,Placer County,1,3,24986,12686,12300
California,Placer County,1,4,24298,12512,11786
California,Placer County,1,5,17936,9326,8610
California,Placer County,1,6,19560,9849,9711
California,Placer County,1,7,19613,9737,9876
California,Placer County,1,8,21871,10623,11248
California,Placer County,1,9,24694,11977,12717
California,Placer County,1,10,27232,13344,13888
California,Placer County,1,11,26107,12712,13395
California,Placer County,1,12,22972,11047,11925
California,Placer County,1,13,21146,9985,11161
California,Placer County,1,14,16459,7605,8854
California,Placer County,1,15,12531,5837,6694
California,Placer County,1,16,10019,4551,5468
California,Placer County,1,17,7299,3116,4183
California,Placer County,1,18,7254,2554,4700
California,Placer County,2,0,348503,170191,178312
California,Placer County,2,1,20855,10615,10240
California,Placer County,2,2,23610,12082,11528
California,Placer County,2,3,24995,12689,12306
California,Placer County,2,4,24305,12518,11787
California,Placer County,2,5,17942,9330,8612
California,Placer County,2,6,19561,9850,9711
California,Placer County,2,7,19614,9737,9877
California,Placer County,2,8,21879,10627,11252
California,Placer County,2,9,24701,11979,12722
California,Placer County,2,10,27238,13349,13889
California,Placer County,2,11,26111,12715,13396
California,Placer County,2,12,22974,11048,11926
California,Placer County,2,13,21151,9988,11163
California,Placer County,2,14,16461,7606,8855
California,Placer County,2,15,12531,5837,6694
California,Placer County,2,16,10019,4551,5468
California,Placer County,2,17,7300,3116,4184
California,Placer County,2,18,7256,2554,4702
California,Placer County,3,0,350026,170926,179100
California,Placer County,3,1,20860,10616,10244
California,Placer County,3,2,23632,12081,11551
California,Placer County,3,3,25036,12726,12310
California,Placer County,3,4,24267,12489,11778
California,Placer County,3,5,18233,9479,8754
California,Placer County,3,6,19625,9873,9752
California,Placer County,3,7,19821,9843,9978
California,Placer County,3,8,21788,10601,11187
California,Placer County,3,9,24760,11991,12769
California,Placer County,3,10,27163,13307,13856
California,Placer County,3,11,26334,12822,13512
California,Placer County,3,12,23143,11131,12012
California,Placer County,3,13,21394,10110,11284
California,Placer County,3,14,16620,7688,8932
California,Placer County,3,15,12660,5880,6780
California,Placer County,3,16,10017,4553,5464
California,Placer County,3,17,7365,3161,4204
California,Placer County,3,18,7308,2575,4733
California,Placer County,4,0,356312,174054,182258
California,Placer County,4,1,20858,10567,10291
California,Placer County,4,2,23863,12203,11660
California,Placer County,4,3,25316,12976,12340
California,Placer County,4,4,24363,12486,11877
California,Placer County,4,5,19208,9977,9231
California,Placer County,4,6,19549,9799,9750
California,Placer County,4,7,20677,10323,10354
California,Placer County,4,8,21388,10453,10935
California,Placer County,4,9,25130,12137,12993
California,Placer County,4,10,26601,13010,13591
California,Placer County,4,11,27037,13188,13849
California,Placer County,4,12,23717,11405,12312
California,Placer County,4,13,22572,10689,11883
California,Placer County,4,14,17377,8069,9308
California,Placer County,4,15,13284,6136,7148
California,Placer County,4,16,10256,4686,5570
California,Placer County,4,17,7581,3310,4271
California,Placer County,4,18,7535,2640,4895
California,Placer County,5,0,360277,176258,184019
California,Placer County,5,1,20465,10368,10097
California,Placer County,5,2,23862,12254,11608
California,Placer County,5,3,25340,12954,12386
California,Placer County,5,4,24340,12472,11868
California,Placer County,5,5,19806,10334,9472
California,Placer County,5,6,19149,9692,9457
California,Placer County,5,7,21097,10529,10568
California,Placer County,5,8,21420,10522,10898
California,Placer County,5,9,25198,12177,13021
California,Placer County,5,10,26215,12890,13325
California,Placer County,5,11,27143,13281,13862
California,Placer County,5,12,24510,11703,12807
California,Placer County,5,13,22370,10552,11818
California,Placer County,5,14,19156,8944,10212
California,Placer County,5,15,13924,6463,7461
California,Placer County,5,16,10588,4863,5725
California,Placer County,5,17,7815,3436,4379
California,Placer County,5,18,7879,2824,5055
California,Placer County,6,0,365445,178577,186868
California,Placer County,6,1,20336,10286,10050
California,Placer County,6,2,23843,12213,11630
California,Placer County,6,3,25381,12986,12395
California,Placer County,6,4,24219,12437,11782
California,Placer County,6,5,20307,10539,9768
California,Placer County,6,6,19125,9737,9388
California,Placer County,6,7,21782,10825,10957
California,Placer County,6,8,21891,10792,11099
California,Placer County,6,9,25217,12212,13005
California,Placer County,6,10,25637,12523,13114
California,Placer County,6,11,27462,13440,14022
California,Placer County,6,12,25269,12070,13199
California,Placer County,6,13,22554,10632,11922
California,Placer County,6,14,20295,9483,10812
California,Placer County,6,15,14930,6872,8058
California,Placer County,6,16,11002,5082,5920
California,Placer County,6,17,8064,3524,4540
California,Placer County,6,18,8131,2924,5207
California,Placer County,7,0,369326,180429,188897
California,Placer County,7,1,20061,10185,9876
California,Placer County,7,2,23706,12062,11644
California,Placer County,7,3,25396,13044,12352
California,Placer County,7,4,24190,12495,11695
California,Placer County,7,5,20530,10534,9996
California,Placer County,7,6,19190,9795,9395
California,Placer County,7,7,21810,10836,10974
California,Placer County,7,8,22495,11127,11368
California,Placer County,7,9,24668,12029,12639
California,Placer County,7,10,25432,12409,13023
California,Placer County,7,11,27631,13465,14166
California,Placer County,7,12,25719,12360,13359
California,Placer County,7,13,23226,10916,12310
California,Placer County,7,14,21284,9957,11327
California,Placer County,7,15,15765,7225,8540
California,Placer County,7,16,11454,5260,6194
California,Placer County,7,17,8257,3625,4632
California,Placer County,7,18,8512,3105,5407
California,Placer County,8,0,373058,182065,190993
California,Placer County,8,1,19969,10239,9730
California,Placer County,8,2,23559,11831,11728
California,Placer County,8,3,25499,13066,12433
California,Placer County,8,4,24074,12412,11662
California,Placer County,8,5,20547,10475,10072
California,Placer County,8,6,19291,9962,9329
California,Placer County,8,7,21729,10703,11026
California,Placer County,8,8,23220,11538,11682
California,Placer County,8,9,23970,11719,12251
California,Placer County,8,10,25797,12548,13249
California,Placer County,8,11,27259,13321,13938
California,Placer County,8,12,26182,12601,13581
California,Placer County,8,13,23712,11148,12564
California,Placer County,8,14,22229,10387,11842
California,Placer County,8,15,16708,7623,9085
California,Placer County,8,16,11912,5442,6470
California,Placer County,8,17,8594,3806,4788
California,Placer County,8,18,8807,3244,5563
California,Placer County,9,0,379288,184997,194291
California,Placer County,9,1,20263,10359,9904
California,Placer County,9,2,23689,11961,11728
California,Placer County,9,3,25680,13139,12541
California,Placer County,9,4,24198,12514,11684
California,Placer County,9,5,20210,10329,9881
California,Placer County,9,6,19993,10239,9754
California,Placer County,9,7,21825,10730,11095
California,Placer County,9,8,24246,12054,12192
California,Placer County,9,9,23730,11660,12070
California,Placer County,9,10,26444,12812,13632
California,Placer County,9,11,26780,13035,13745
California,Placer County,9,12,26786,12972,13814
California,Placer County,9,13,24296,11411,12885
California,Placer County,9,14,23302,10899,12403
California,Placer County,9,15,17457,7931,9526
California,Placer County,9,16,12519,5689,6830
California,Placer County,9,17,8732,3881,4851
California,Placer County,9,18,9138,3382,5756
California,Placer County,10,0,385565,188132,197433
California,Placer County,10,1,20648,10508,10140
California,Placer County,10,2,23704,11956,11748
California,Placer County,10,3,25959,13274,12685
California,Placer County,10,4,24304,12583,11721
California,Placer County,10,5,20459,10465,9994
California,Placer County,10,6,20475,10493,9982
California,Placer County,10,7,21818,10802,11016
California,Placer County,10,8,25104,12435,12669
California,Placer County,10,9,24182,11935,12247
California,Placer County,10,10,26502,12926,13576
California,Placer County,10,11,26432,12959,13473
California,Placer County,10,12,27108,13108,14000
California,Placer County,10,13,24974,11665,13309
California,Placer County,10,14,23029,10685,12344
California,Placer County,10,15,19288,8837,10451
California,Placer County,10,16,13223,6014,7209
California,Placer County,10,17,8947,3962,4985
California,Placer County,10,18,9409,3525,5884
California,Placer County,11,0,393149,192147,201002
California,Placer County,11,1,20976,10733,10243
California,Placer County,11,2,24188,12228,11960
California,Placer County,11,3,26259,13462,12797
California,Placer County,11,4,24494,12730,11764
California,Placer County,11,5,20413,10513,9900
California,Placer County,11,6,21095,10910,10185
California,Placer County,11,7,22052,10929,11123
California,Placer County,11,8,26176,12888,13288
California,Placer County,11,9,25042,12415,12627
California,Placer County,11,10,26751,13148,13603
California,Placer County,11,11,25954,12659,13295
California,Placer County,11,12,27395,13274,14121
California,Placer County,11,13,25448,11899,13549
California,Placer County,11,14,23366,10838,12528
California,Placer County,11,15,20322,9336,10986
California,Placer County,11,16,14158,6362,7796
California,Placer County,11,17,9335,4124,5211
California,Placer County,11,18,9725,3699,6026
California,Plumas County,1,0,20007,10003,10004
California,Plumas County,1,1,883,463,420
California,Plumas County,1,2,968,473,495
California,Plumas County,1,3,1022,536,486
California,Plumas County,1,4,1293,666,627
California,Plumas County,1,5,930,500,430
California,Plumas County,1,6,847,445,402
California,Plumas County,1,7,851,420,431
California,Plumas County,1,8,863,449,414
California,Plumas County,1,9,1045,509,536
California,Plumas County,1,10,1433,693,740
California,Plumas County,1,11,1793,838,955
California,Plumas County,1,12,1995,977,1018
California,Plumas County,1,13,1930,992,938
California,Plumas County,1,14,1467,759,708
California,Plumas County,1,15,1067,559,508
California,Plumas County,1,16,676,333,343
California,Plumas County,1,17,520,241,279
California,Plumas County,1,18,424,150,274
California,Plumas County,2,0,20007,10003,10004
California,Plumas County,2,1,883,463,420
California,Plumas County,2,2,968,473,495
California,Plumas County,2,3,1022,536,486
California,Plumas County,2,4,1293,666,627
California,Plumas County,2,5,930,500,430
California,Plumas County,2,6,847,445,402
California,Plumas County,2,7,851,420,431
California,Plumas County,2,8,863,449,414
California,Plumas County,2,9,1045,509,536
California,Plumas County,2,10,1433,693,740
California,Plumas County,2,11,1793,838,955
California,Plumas County,2,12,1995,977,1018
California,Plumas County,2,13,1930,992,938
California,Plumas County,2,14,1467,759,708
California,Plumas County,2,15,1067,559,508
California,Plumas County,2,16,676,333,343
California,Plumas County,2,17,520,241,279
California,Plumas County,2,18,424,150,274
California,Plumas County,3,0,19914,9946,9968
California,Plumas County,3,1,887,464,423
California,Plumas County,3,2,957,468,489
California,Plumas County,3,3,1011,528,483
California,Plumas County,3,4,1265,653,612
California,Plumas County,3,5,942,498,444
California,Plumas County,3,6,845,443,402
California,Plumas County,3,7,854,422,432
California,Plumas County,3,8,855,445,410
California,Plumas County,3,9,1024,499,525
California,Plumas County,3,10,1402,677,725
California,Plumas County,3,11,1783,835,948
California,Plumas County,3,12,1982,974,1008
California,Plumas County,3,13,1935,990,945
California,Plumas County,3,14,1478,770,708
California,Plumas County,3,15,1070,554,516
California,Plumas County,3,16,675,332,343
California,Plumas County,3,17,518,243,275
California,Plumas County,3,18,431,151,280
California,Plumas County,4,0,19715,9882,9833
California,Plumas County,4,1,917,494,423
California,Plumas County,4,2,944,460,484
California,Plumas County,4,3,971,509,462
California,Plumas County,4,4,1181,620,561
California,Plumas County,4,5,981,517,464
California,Plumas County,4,6,819,434,385
California,Plumas County,4,7,916,460,456
California,Plumas County,4,8,812,418,394
California,Plumas County,4,9,957,468,489
California,Plumas County,4,10,1267,620,647
California,Plumas County,4,11,1760,830,930
California,Plumas County,4,12,1926,929,997
California,Plumas County,4,13,1999,1019,980
California,Plumas County,4,14,1539,803,736
California,Plumas County,4,15,1090,558,532
California,Plumas County,4,16,685,345,340
California,Plumas County,4,17,509,252,257
California,Plumas County,4,18,442,146,296
California,Plumas County,5,0,19374,9686,9688
California,Plumas County,5,1,872,472,400
California,Plumas County,5,2,978,493,485
California,Plumas County,5,3,923,469,454
California,Plumas County,5,4,1097,580,517
California,Plumas County,5,5,952,495,457
California,Plumas County,5,6,798,415,383
California,Plumas County,5,7,910,457,453
California,Plumas County,5,8,825,422,403
California,Plumas County,5,9,917,451,466
California,Plumas County,5,10,1167,572,595
California,Plumas County,5,11,1603,742,861
California,Plumas County,5,12,1884,907,977
California,Plumas County,5,13,1958,990,968
California,Plumas County,5,14,1661,847,814
California,Plumas County,5,15,1141,589,552
California,Plumas County,5,16,728,385,343
California,Plumas County,5,17,496,237,259
California,Plumas County,5,18,464,163,301
California,Plumas County,6,0,18895,9447,9448
California,Plumas County,6,1,805,442,363
California,Plumas County,6,2,941,470,471
California,Plumas County,6,3,913,459,454
California,Plumas County,6,4,1044,564,480
California,Plumas County,6,5,932,484,448
California,Plumas County,6,6,764,383,381
California,Plumas County,6,7,873,452,421
California,Plumas County,6,8,835,421,414
California,Plumas County,6,9,863,437,426
California,Plumas County,6,10,1059,529,530
California,Plumas County,6,11,1519,714,805
California,Plumas County,6,12,1844,859,985
California,Plumas County,6,13,1917,976,941
California,Plumas County,6,14,1683,841,842
California,Plumas County,6,15,1204,637,567
California,Plumas County,6,16,783,404,379
California,Plumas County,6,17,465,216,249
California,Plumas County,6,18,451,159,292
California,Plumas County,7,0,18662,9340,9322
California,Plumas County,7,1,793,426,367
California,Plumas County,7,2,907,470,437
California,Plumas County,7,3,907,447,460
California,Plumas County,7,4,959,515,444
California,Plumas County,7,5,919,487,432
California,Plumas County,7,6,820,421,399
California,Plumas County,7,7,835,414,421
California,Plumas County,7,8,862,435,427
California,Plumas County,7,9,829,425,404
California,Plumas County,7,10,975,490,485
California,Plumas County,7,11,1435,687,748
California,Plumas County,7,12,1770,805,965
California,Plumas County,7,13,1944,990,954
California,Plumas County,7,14,1684,853,831
California,Plumas County,7,15,1262,665,597
California,Plumas County,7,16,832,427,405
California,Plumas County,7,17,460,209,251
California,Plumas County,7,18,469,174,295
California,Plumas County,8,0,18516,9256,9260
California,Plumas County,8,1,755,392,363
California,Plumas County,8,2,852,458,394
California,Plumas County,8,3,921,441,480
California,Plumas County,8,4,932,509,423
California,Plumas County,8,5,840,444,396
California,Plumas County,8,6,861,446,415
California,Plumas County,8,7,840,410,430
California,Plumas County,8,8,873,429,444
California,Plumas County,8,9,783,407,376
California,Plumas County,8,10,979,486,493
California,Plumas County,8,11,1333,646,687
California,Plumas County,8,12,1717,792,925
California,Plumas County,8,13,1949,966,983
California,Plumas County,8,14,1751,894,857
California,Plumas County,8,15,1293,672,621
California,Plumas County,8,16,866,449,417
California,Plumas County,8,17,488,224,264
California,Plumas County,8,18,483,191,292
California,Plumas County,9,0,18772,9385,9387
California,Plumas County,9,1,787,373,414
California,Plumas County,9,2,903,486,417
California,Plumas County,9,3,917,453,464
California,Plumas County,9,4,929,485,444
California,Plumas County,9,5,810,429,381
California,Plumas County,9,6,920,463,457
California,Plumas County,9,7,877,451,426
California,Plumas County,9,8,921,433,488
California,Plumas County,9,9,804,414,390
California,Plumas County,9,10,932,481,451
California,Plumas County,9,11,1239,600,639
California,Plumas County,9,12,1720,818,902
California,Plumas County,9,13,1946,949,997
California,Plumas County,9,14,1840,943,897
California,Plumas County,9,15,1331,711,620
California,Plumas County,9,16,883,449,434
California,Plumas County,9,17,518,235,283
California,Plumas County,9,18,495,212,283
California,Plumas County,10,0,18740,9342,9398
California,Plumas County,10,1,795,372,423
California,Plumas County,10,2,866,472,394
California,Plumas County,10,3,956,471,485
California,Plumas County,10,4,907,462,445
California,Plumas County,10,5,744,394,350
California,Plumas County,10,6,946,485,461
California,Plumas County,10,7,926,469,457
California,Plumas County,10,8,886,425,461
California,Plumas County,10,9,852,434,418
California,Plumas County,10,10,873,452,421
California,Plumas County,10,11,1180,566,614
California,Plumas County,10,12,1628,768,860
California,Plumas County,10,13,1952,937,1015
California,Plumas County,10,14,1840,943,897
California,Plumas County,10,15,1438,753,685
California,Plumas County,10,16,944,492,452
California,Plumas County,10,17,526,255,271
California,Plumas County,10,18,481,192,289
California,Plumas County,11,0,18804,9360,9444
California,Plumas County,11,1,861,408,453
California,Plumas County,11,2,829,448,381
California,Plumas County,11,3,945,462,483
California,Plumas County,11,4,926,485,441
California,Plumas County,11,5,725,378,347
California,Plumas County,11,6,915,470,445
California,Plumas County,11,7,966,474,492
California,Plumas County,11,8,941,469,472
California,Plumas County,11,9,859,439,420
California,Plumas County,11,10,872,447,425
California,Plumas County,11,11,1116,545,571
California,Plumas County,11,12,1587,742,845
California,Plumas County,11,13,1917,899,1018
California,Plumas County,11,14,1867,969,898
California,Plumas County,11,15,1482,752,730
California,Plumas County,11,16,984,531,453
California,Plumas County,11,17,548,265,283
California,Plumas County,11,18,464,177,287
California,Riverside County,1,0,2189641,1089576,1100065
California,Riverside County,1,1,162438,82754,79684
California,Riverside County,1,2,167065,85020,82045
California,Riverside County,1,3,177644,90683,86961
California,Riverside County,1,4,187125,96221,90904
California,Riverside County,1,5,154572,79533,75039
California,Riverside County,1,6,143992,72905,71087
California,Riverside County,1,7,138437,68750,69687
California,Riverside County,1,8,143926,71002,72924
California,Riverside County,1,9,149379,75432,73947
California,Riverside County,1,10,152722,77080,75642
California,Riverside County,1,11,140016,70586,69430
California,Riverside County,1,12,114765,55964,58801
California,Riverside County,1,13,98974,47377,51597
California,Riverside County,1,14,78495,36730,41765
California,Riverside County,1,15,62103,28958,33145
California,Riverside County,1,16,49003,22422,26581
California,Riverside County,1,17,36793,15918,20875
California,Riverside County,1,18,32192,12241,19951
California,Riverside County,2,0,2189765,1089614,1100151
California,Riverside County,2,1,162439,82754,79685
California,Riverside County,2,2,167067,85021,82046
California,Riverside County,2,3,177643,90683,86960
California,Riverside County,2,4,187124,96219,90905
California,Riverside County,2,5,154573,79534,75039
California,Riverside County,2,6,143993,72906,71087
California,Riverside County,2,7,138437,68750,69687
California,Riverside County,2,8,143928,71003,72925
California,Riverside County,2,9,149380,75433,73947
California,Riverside County,2,10,152723,77081,75642
California,Riverside County,2,11,140017,70587,69430
California,Riverside County,2,12,114771,55968,58803
California,Riverside County,2,13,98981,47381,51600
California,Riverside County,2,14,78499,36731,41768
California,Riverside County,2,15,62112,28962,33150
California,Riverside County,2,16,49022,22428,26594
California,Riverside County,2,17,36814,15923,20891
California,Riverside County,2,18,32242,12250,19992
California,Riverside County,3,0,2201652,1095307,1106345
California,Riverside County,3,1,162436,82825,79611
California,Riverside County,3,2,167372,85169,82203
California,Riverside County,3,3,177711,90628,87083
California,Riverside County,3,4,186541,95885,90656
California,Riverside County,3,5,157415,80887,76528
California,Riverside County,3,6,145442,73736,71706
California,Riverside County,3,7,139835,69485,70350
California,Riverside County,3,8,143939,70967,72972
California,Riverside County,3,9,149906,75595,74311
California,Riverside County,3,10,152844,77091,75753
California,Riverside County,3,11,141314,71197,70117
California,Riverside County,3,12,116216,56730,59486
California,Riverside County,3,13,100168,47922,52246
California,Riverside County,3,14,79170,37072,42098
California,Riverside County,3,15,62534,29142,33392
California,Riverside County,3,16,49133,22481,26652
California,Riverside County,3,17,37012,16093,20919
California,Riverside County,3,18,32664,12402,20262
California,Riverside County,4,0,2234301,1111654,1122647
California,Riverside County,4,1,161630,82714,78916
California,Riverside County,4,2,167872,85461,82411
California,Riverside County,4,3,177129,90131,86998
California,Riverside County,4,4,183506,94206,89300
California,Riverside County,4,5,165537,85011,80526
California,Riverside County,4,6,148379,75562,72817
California,Riverside County,4,7,144063,71769,72294
California,Riverside County,4,8,142338,69956,72382
California,Riverside County,4,9,151534,76058,75476
California,Riverside County,4,10,152068,76676,75392
California,Riverside County,4,11,145347,73212,72135
California,Riverside County,4,12,121356,59521,61835
California,Riverside County,4,13,105188,50274,54914
California,Riverside County,4,14,82233,38659,43574
California,Riverside County,4,15,64490,29908,34582
California,Riverside County,4,16,50056,22988,27068
California,Riverside County,4,17,37608,16596,21012
California,Riverside County,4,18,33967,12952,21015
California,Riverside County,5,0,2261967,1125700,1136267
California,Riverside County,5,1,159063,81313,77750
California,Riverside County,5,2,169874,86560,83314
California,Riverside County,5,3,175735,89276,86459
California,Riverside County,5,4,181406,92959,88447
California,Riverside County,5,5,170423,87355,83068
California,Riverside County,5,6,150514,77010,73504
California,Riverside County,5,7,147953,74211,73742
California,Riverside County,5,8,142522,70086,72436
California,Riverside County,5,9,152280,76001,76279
California,Riverside County,5,10,150903,76284,74619
California,Riverside County,5,11,147618,74315,73303
California,Riverside County,5,12,127047,62614,64433
California,Riverside County,5,13,105625,50465,55160
California,Riverside County,5,14,89079,42059,47020
California,Riverside County,5,15,67066,31166,35900
California,Riverside County,5,16,51273,23487,27786
California,Riverside County,5,17,38457,17169,21288
California,Riverside County,5,18,35129,13370,21759
California,Riverside County,6,0,2288043,1138637,1149406
California,Riverside County,6,1,156946,80297,76649
California,Riverside County,6,2,171327,87597,83730
California,Riverside County,6,3,175072,88930,86142
California,Riverside County,6,4,179774,92009,87765
California,Riverside County,6,5,172105,88202,83903
California,Riverside County,6,6,153482,78605,74877
California,Riverside County,6,7,152020,76300,75720
California,Riverside County,6,8,143348,70615,72733
California,Riverside County,6,9,151434,75098,76336
California,Riverside County,6,10,149797,75701,74096
California,Riverside County,6,11,149754,75262,74492
California,Riverside County,6,12,132150,65370,66780
California,Riverside County,6,13,107864,51608,56256
California,Riverside County,6,14,93167,44138,49029
California,Riverside County,6,15,71130,32927,38203
California,Riverside County,6,16,53162,24395,28767
California,Riverside County,6,17,39120,17554,21566
California,Riverside County,6,18,36391,14029,22362
California,Riverside County,7,0,2317955,1152601,1165354
California,Riverside County,7,1,157232,80218,77014
California,Riverside County,7,2,171190,87401,83789
California,Riverside County,7,3,174997,88939,86058
California,Riverside County,7,4,178395,90925,87470
California,Riverside County,7,5,172859,88504,84355
California,Riverside County,7,6,158332,81330,77002
California,Riverside County,7,7,155282,77946,77336
California,Riverside County,7,8,146014,72114,73900
California,Riverside County,7,9,149848,74094,75754
California,Riverside County,7,10,149380,75316,74064
California,Riverside County,7,11,151834,76148,75686
California,Riverside County,7,12,136112,67580,68532
California,Riverside County,7,13,111892,53559,58333
California,Riverside County,7,14,97444,46247,51197
California,Riverside County,7,15,74428,34347,40081
California,Riverside County,7,16,55302,25379,29923
California,Riverside County,7,17,39515,17783,21732
California,Riverside County,7,18,37899,14771,23128
California,Riverside County,8,0,2347921,1167617,1180304
California,Riverside County,8,1,157509,80368,77141
California,Riverside County,8,2,171216,87397,83819
California,Riverside County,8,3,174173,88630,85543
California,Riverside County,8,4,178102,90878,87224
California,Riverside County,8,5,171707,87750,83957
California,Riverside County,8,6,163971,84249,79722
California,Riverside County,8,7,157298,79264,78034
California,Riverside County,8,8,149515,74267,75248
California,Riverside County,8,9,148168,72875,75293
California,Riverside County,8,10,150720,75787,74933
California,Riverside County,8,11,152175,76214,75961
California,Riverside County,8,12,140268,69841,70427
California,Riverside County,8,13,116580,56012,60568
California,Riverside County,8,14,101796,48197,53599
California,Riverside County,8,15,77885,36011,41874
California,Riverside County,8,16,57317,26251,31066
California,Riverside County,8,17,40256,18141,22115
California,Riverside County,8,18,39265,15485,23780
California,Riverside County,9,0,2382570,1185928,1196642
California,Riverside County,9,1,157889,80476,77413
California,Riverside County,9,2,171427,87660,83767
California,Riverside County,9,3,174923,89181,85742
California,Riverside County,9,4,177732,90362,87370
California,Riverside County,9,5,169702,86654,83048
California,Riverside County,9,6,170895,87883,83012
California,Riverside County,9,7,159453,81057,78396
California,Riverside County,9,8,154053,76732,77321
California,Riverside County,9,9,147517,72800,74717
California,Riverside County,9,10,152926,76649,76277
California,Riverside County,9,11,151597,76036,75561
California,Riverside County,9,12,144474,71996,72478
California,Riverside County,9,13,121490,58724,62766
California,Riverside County,9,14,106281,50274,56007
California,Riverside County,9,15,80985,37569,43416
California,Riverside County,9,16,59188,26978,32210
California,Riverside County,9,17,41450,18677,22773
California,Riverside County,9,18,40588,16220,24368
California,Riverside County,10,0,2417224,1203900,1213324
California,Riverside County,10,1,158607,80959,77648
California,Riverside County,10,2,170254,87271,82983
California,Riverside County,10,3,178139,90771,87368
California,Riverside County,10,4,177182,90048,87134
California,Riverside County,10,5,168508,85934,82574
California,Riverside County,10,6,175437,90156,85281
California,Riverside County,10,7,161456,82395,79061
California,Riverside County,10,8,158976,79644,79332
California,Riverside County,10,9,148790,73454,75336
California,Riverside County,10,10,154243,76957,77286
California,Riverside County,10,11,151303,76052,75251
California,Riverside County,10,12,146712,73126,73586
California,Riverside County,10,13,127331,61928,65403
California,Riverside County,10,14,106509,50290,56219
California,Riverside County,10,15,87730,40829,46901
California,Riverside County,10,16,61525,28010,33515
California,Riverside County,10,17,42635,19192,23443
California,Riverside County,10,18,41887,16884,25003
California,Riverside County,11,0,2450758,1221375,1229383
California,Riverside County,11,1,158812,81026,77786
California,Riverside County,11,2,169386,86662,82724
California,Riverside County,11,3,180282,92063,88219
California,Riverside County,11,4,177051,90054,86997
California,Riverside County,11,5,168029,85700,82329
California,Riverside County,11,6,177675,91628,86047
California,Riverside County,11,7,164772,84263,80509
California,Riverside County,11,8,164156,82382,81774
California,Riverside County,11,9,151127,74995,76132
California,Riverside County,11,10,154262,76574,77688
California,Riverside County,11,11,150972,76118,74854
California,Riverside County,11,12,148702,74074,74628
California,Riverside County,11,13,132410,64676,67734
California,Riverside County,11,14,109135,51537,57598
California,Riverside County,11,15,91537,42718,48819
California,Riverside County,11,16,65392,29671,35721
California,Riverside County,11,17,44102,19802,24300
California,Riverside County,11,18,42956,17432,25524
California,Sacramento County,1,0,1418788,694793,723995
California,Sacramento County,1,1,101063,51669,49394
California,Sacramento County,1,2,98112,50022,48090
California,Sacramento County,1,3,99820,51128,48692
California,Sacramento County,1,4,105680,54270,51410
California,Sacramento County,1,5,101908,51147,50761
California,Sacramento County,1,6,107922,53768,54154
California,Sacramento County,1,7,98724,49407,49317
California,Sacramento County,1,8,95195,47276,47919
California,Sacramento County,1,9,95640,47744,47896
California,Sacramento County,1,10,102072,50392,51680
California,Sacramento County,1,11,98464,47467,50997
California,Sacramento County,1,12,85332,40354,44978
California,Sacramento County,1,13,70305,33113,37192
California,Sacramento County,1,14,47404,21567,25837
California,Sacramento County,1,15,35891,15718,20173
California,Sacramento County,1,16,29328,12821,16507
California,Sacramento County,1,17,22865,9060,13805
California,Sacramento County,1,18,23063,7870,15193
California,Sacramento County,2,0,1418735,694763,723972
California,Sacramento County,2,1,101062,51668,49394
California,Sacramento County,2,2,98108,50019,48089
California,Sacramento County,2,3,99811,51125,48686
California,Sacramento County,2,4,105673,54264,51409
California,Sacramento County,2,5,101906,51145,50761
California,Sacramento County,2,6,107921,53767,54154
California,Sacramento County,2,7,98723,49407,49316
California,Sacramento County,2,8,95191,47274,47917
California,Sacramento County,2,9,95635,47743,47892
California,Sacramento County,2,10,102066,50387,51679
California,Sacramento County,2,11,98459,47463,50996
California,Sacramento County,2,12,85332,40354,44978
California,Sacramento County,2,13,70302,33112,37190
California,Sacramento County,2,14,47402,21566,25836
California,Sacramento County,2,15,35891,15718,20173
California,Sacramento County,2,16,29328,12821,16507
California,Sacramento County,2,17,22864,9060,13804
California,Sacramento County,2,18,23061,7870,15191
California,Sacramento County,3,0,1421414,695984,725430
California,Sacramento County,3,1,100987,51636,49351
California,Sacramento County,3,2,98291,50152,48139
California,Sacramento County,3,3,99594,51000,48594
California,Sacramento County,3,4,104616,53796,50820
California,Sacramento County,3,5,102673,51472,51201
California,Sacramento County,3,6,108169,53841,54328
California,Sacramento County,3,7,99308,49680,49628
California,Sacramento County,3,8,94842,47106,47736
California,Sacramento County,3,9,95828,47764,48064
California,Sacramento County,3,10,101578,50171,51407
California,Sacramento County,3,11,98968,47726,51242
California,Sacramento County,3,12,85933,40640,45293
California,Sacramento County,3,13,71213,33528,37685
California,Sacramento County,3,14,47871,21804,26067
California,Sacramento County,3,15,36092,15826,20266
California,Sacramento County,3,16,29280,12770,16510
California,Sacramento County,3,17,22932,9135,13797
California,Sacramento County,3,18,23239,7937,15302
California,Sacramento County,4,0,1433739,701723,732016
California,Sacramento County,4,1,100556,51458,49098
California,Sacramento County,4,2,99211,50593,48618
California,Sacramento County,4,3,98849,50533,48316
California,Sacramento County,4,4,100905,52131,48774
California,Sacramento County,4,5,105862,53015,52847
California,Sacramento County,4,6,109165,54417,54748
California,Sacramento County,4,7,101612,50740,50872
California,Sacramento County,4,8,93329,46446,46883
California,Sacramento County,4,9,96956,48099,48857
California,Sacramento County,4,10,99151,48974,50177
California,Sacramento County,4,11,100722,48623,52099
California,Sacramento County,4,12,88441,41872,46569
California,Sacramento County,4,13,75158,35293,39865
California,Sacramento County,4,14,50007,22898,27109
California,Sacramento County,4,15,37047,16240,20807
California,Sacramento County,4,16,29491,12714,16777
California,Sacramento County,4,17,23151,9428,13723
California,Sacramento County,4,18,24126,8249,15877
California,Sacramento County,5,0,1445078,706969,738109
California,Sacramento County,5,1,99461,51038,48423
California,Sacramento County,5,2,100557,51224,49333
California,Sacramento County,5,3,98348,50258,48090
California,Sacramento County,5,4,98415,50791,47624
California,Sacramento County,5,5,106820,53794,53026
California,Sacramento County,5,6,109924,54818,55106
California,Sacramento County,5,7,104129,51922,52207
California,Sacramento County,5,8,93352,46357,46995
California,Sacramento County,5,9,96787,47836,48951
California,Sacramento County,5,10,97145,47861,49284
California,Sacramento County,5,11,101243,49037,52206
California,Sacramento County,5,12,91275,43292,47983
California,Sacramento County,5,13,75945,35549,40396
California,Sacramento County,5,14,55450,25545,29905
California,Sacramento County,5,15,38325,16766,21559
California,Sacramento County,5,16,29983,12802,17181
California,Sacramento County,5,17,23284,9644,13640
California,Sacramento County,5,18,24635,8435,16200
California,Sacramento County,6,0,1457750,712229,745521
California,Sacramento County,6,1,98654,50459,48195
California,Sacramento County,6,2,101935,52123,49812
California,Sacramento County,6,3,98260,50004,48256
California,Sacramento County,6,4,96830,49976,46854
California,Sacramento County,6,5,106106,53253,52853
California,Sacramento County,6,6,111449,55590,55859
California,Sacramento County,6,7,106718,53117,53601
California,Sacramento County,6,8,93989,46618,47371
California,Sacramento County,6,9,96431,47451,48980
California,Sacramento County,6,10,95555,47149,48406
California,Sacramento County,6,11,101532,49265,52267
California,Sacramento County,6,12,93226,44299,48927
California,Sacramento County,6,13,77862,36274,41588
California,Sacramento County,6,14,59371,27397,31974
California,Sacramento County,6,15,40592,17792,22800
California,Sacramento County,6,16,30400,12936,17464
California,Sacramento County,6,17,23577,9862,13715
California,Sacramento County,6,18,25263,8664,16599
California,Sacramento County,7,0,1475618,720947,754671
California,Sacramento County,7,1,99280,50759,48521
California,Sacramento County,7,2,102185,52248,49937
California,Sacramento County,7,3,99085,50354,48731
California,Sacramento County,7,4,95459,48996,46463
California,Sacramento County,7,5,104982,52955,52027
California,Sacramento County,7,6,114594,57242,57352
California,Sacramento County,7,7,109278,54468,54810
California,Sacramento County,7,8,96364,47924,48440
California,Sacramento County,7,9,95764,46997,48767
California,Sacramento County,7,10,94747,46859,47888
California,Sacramento County,7,11,101973,49548,52425
California,Sacramento County,7,12,94919,45178,49741
California,Sacramento County,7,13,79993,37239,42754
California,Sacramento County,7,14,63624,29250,34374
California,Sacramento County,7,15,42632,18742,23890
California,Sacramento County,7,16,31307,13335,17972
California,Sacramento County,7,17,23456,9810,13646
California,Sacramento County,7,18,25976,9043,16933
California,Sacramento County,8,0,1494294,729966,764328
California,Sacramento County,8,1,99745,50829,48916
California,Sacramento County,8,2,102124,52378,49746
California,Sacramento County,8,3,99974,50687,49287
California,Sacramento County,8,4,94916,48742,46174
California,Sacramento County,8,5,102339,51654,50685
California,Sacramento County,8,6,118101,58954,59147
California,Sacramento County,8,7,111787,55720,56067
California,Sacramento County,8,8,99464,49638,49826
California,Sacramento County,8,9,94445,46231,48214
California,Sacramento County,8,10,95517,47215,48302
California,Sacramento County,8,11,101100,49141,51959
California,Sacramento County,8,12,97114,46399,50715
California,Sacramento County,8,13,82996,38494,44502
California,Sacramento County,8,14,67676,31196,36480
California,Sacramento County,8,15,44826,19774,25052
California,Sacramento County,8,16,32078,13701,18377
California,Sacramento County,8,17,23673,9863,13810
California,Sacramento County,8,18,26419,9350,17069
California,Sacramento County,9,0,1511510,738362,773148
California,Sacramento County,9,1,99421,50488,48933
California,Sacramento County,9,2,102439,52486,49953
California,Sacramento County,9,3,101212,51412,49800
California,Sacramento County,9,4,94761,48626,46135
California,Sacramento County,9,5,99670,50512,49158
California,Sacramento County,9,6,121572,60803,60769
California,Sacramento County,9,7,113951,56731,57220
California,Sacramento County,9,8,102862,51293,51569
California,Sacramento County,9,9,93706,45952,47754
California,Sacramento County,9,10,96744,47704,49040
California,Sacramento County,9,11,98766,48079,50687
California,Sacramento County,9,12,98993,47291,51702
California,Sacramento County,9,13,85267,39696,45571
California,Sacramento County,9,14,71292,32748,38544
California,Sacramento County,9,15,46926,20835,26091
California,Sacramento County,9,16,33072,14103,18969
California,Sacramento County,9,17,23969,9877,14092
California,Sacramento County,9,18,26887,9726,17161
California,Sacramento County,10,0,1527718,746443,781275
California,Sacramento County,10,1,99412,50523,48889
California,Sacramento County,10,2,101725,52150,49575
California,Sacramento County,10,3,102839,52180,50659
California,Sacramento County,10,4,94623,48562,46061
California,Sacramento County,10,5,97486,49481,48005
California,Sacramento County,10,6,124043,62093,61950
California,Sacramento County,10,7,115943,57814,58129
California,Sacramento County,10,8,106692,53354,53338
California,Sacramento County,10,9,94136,46198,47938
California,Sacramento County,10,10,97417,47899,49518
California,Sacramento County,10,11,96857,47077,49780
California,Sacramento County,10,12,99295,47714,51581
California,Sacramento County,10,13,87624,40793,46831
California,Sacramento County,10,14,71888,32932,38956
California,Sacramento County,10,15,51785,23105,28680
California,Sacramento County,10,16,34278,14579,19699
California,Sacramento County,10,17,24324,9966,14358
California,Sacramento County,10,18,27351,10023,17328
California,Sacramento County,11,0,1540975,752972,788003
California,Sacramento County,11,1,98953,50249,48704
California,Sacramento County,11,2,101004,51722,49282
California,Sacramento County,11,3,103841,53066,50775
California,Sacramento County,11,4,94932,48626,46306
California,Sacramento County,11,5,96256,48746,47510
California,Sacramento County,11,6,124267,62171,62096
California,Sacramento County,11,7,118321,59268,59053
California,Sacramento County,11,8,109932,55001,54931
California,Sacramento County,11,9,95293,46802,48491
California,Sacramento County,11,10,97069,47435,49634
California,Sacramento County,11,11,95032,46388,48644
California,Sacramento County,11,12,99229,47681,51548
California,Sacramento County,11,13,89245,41673,47572
California,Sacramento County,11,14,73425,33492,39933
California,Sacramento County,11,15,55300,24776,30524
California,Sacramento County,11,16,36364,15491,20873
California,Sacramento County,11,17,24651,10135,14516
California,Sacramento County,11,18,27861,10250,17611
California,San Benito County,1,0,55269,27629,27640
California,San Benito County,1,1,4092,2068,2024
California,San Benito County,1,2,4326,2202,2124
California,San Benito County,1,3,4709,2462,2247
California,San Benito County,1,4,4534,2346,2188
California,San Benito County,1,5,3507,1804,1703
California,San Benito County,1,6,3409,1718,1691
California,San Benito County,1,7,3522,1745,1777
California,San Benito County,1,8,3585,1775,1810
California,San Benito County,1,9,4036,1981,2055
California,San Benito County,1,10,4279,2141,2138
California,San Benito County,1,11,3970,1969,2001
California,San Benito County,1,12,3367,1669,1698
California,San Benito County,1,13,2573,1295,1278
California,San Benito County,1,14,1810,877,933
California,San Benito County,1,15,1168,588,580
California,San Benito County,1,16,935,432,503
California,San Benito County,1,17,749,287,462
California,San Benito County,1,18,698,270,428
California,San Benito County,2,0,55265,27627,27638
California,San Benito County,2,1,4092,2068,2024
California,San Benito County,2,2,4325,2201,2124
California,San Benito County,2,3,4709,2462,2247
California,San Benito County,2,4,4533,2346,2187
California,San Benito County,2,5,3507,1804,1703
California,San Benito County,2,6,3409,1718,1691
California,San Benito County,2,7,3520,1744,1776
California,San Benito County,2,8,3585,1775,1810
California,San Benito County,2,9,4036,1981,2055
California,San Benito County,2,10,4279,2141,2138
California,San Benito County,2,11,3970,1969,2001
California,San Benito County,2,12,3367,1669,1698
California,San Benito County,2,13,2573,1295,1278
California,San Benito County,2,14,1810,877,933
California,San Benito County,2,15,1168,588,580
California,San Benito County,2,16,935,432,503
California,San Benito County,2,17,749,287,462
California,San Benito County,2,18,698,270,428
California,San Benito County,3,0,55517,27765,27752
California,San Benito County,3,1,4090,2076,2014
California,San Benito County,3,2,4338,2199,2139
California,San Benito County,3,3,4691,2457,2234
California,San Benito County,3,4,4546,2342,2204
California,San Benito County,3,5,3534,1829,1705
California,San Benito County,3,6,3467,1752,1715
California,San Benito County,3,7,3545,1756,1789
California,San Benito County,3,8,3572,1769,1803
California,San Benito County,3,9,4033,1977,2056
California,San Benito County,3,10,4269,2135,2134
California,San Benito County,3,11,3991,1983,2008
California,San Benito County,3,12,3391,1677,1714
California,San Benito County,3,13,2622,1323,1299
California,San Benito County,3,14,1828,885,943
California,San Benito County,3,15,1200,603,597
California,San Benito County,3,16,928,432,496
California,San Benito County,3,17,762,295,467
California,San Benito County,3,18,710,275,435
California,San Benito County,4,0,55982,27970,28012
California,San Benito County,4,1,4049,2053,1996
California,San Benito County,4,2,4328,2185,2143
California,San Benito County,4,3,4639,2427,2212
California,San Benito County,4,4,4581,2333,2248
California,San Benito County,4,5,3628,1906,1722
California,San Benito County,4,6,3487,1768,1719
California,San Benito County,4,7,3575,1767,1808
California,San Benito County,4,8,3451,1719,1732
California,San Benito County,4,9,4017,1960,2057
California,San Benito County,4,10,4231,2098,2133
California,San Benito County,4,11,4060,2031,2029
California,San Benito County,4,12,3508,1744,1764
California,San Benito County,4,13,2808,1406,1402
California,San Benito County,4,14,1889,897,992
California,San Benito County,4,15,1285,639,646
California,San Benito County,4,16,909,442,467
California,San Benito County,4,17,790,311,479
California,San Benito County,4,18,747,284,463
California,San Benito County,5,0,56614,28250,28364
California,San Benito County,5,1,3997,2029,1968
California,San Benito County,5,2,4363,2178,2185
California,San Benito County,5,3,4608,2418,2190
California,San Benito County,5,4,4556,2282,2274
California,San Benito County,5,5,3748,1975,1773
California,San Benito County,5,6,3616,1867,1749
California,San Benito County,5,7,3646,1812,1834
California,San Benito County,5,8,3462,1717,1745
California,San Benito County,5,9,3886,1920,1966
California,San Benito County,5,10,4160,2043,2117
California,San Benito County,5,11,4091,2048,2043
California,San Benito County,5,12,3637,1808,1829
California,San Benito County,5,13,2907,1421,1486
California,San Benito County,5,14,2030,970,1060
California,San Benito County,5,15,1367,670,697
California,San Benito County,5,16,950,480,470
California,San Benito County,5,17,795,313,482
California,San Benito County,5,18,795,299,496
California,San Benito County,6,0,57267,28566,28701
California,San Benito County,6,1,3944,2028,1916
California,San Benito County,6,2,4388,2178,2210
California,San Benito County,6,3,4533,2369,2164
California,San Benito County,6,4,4517,2282,2235
California,San Benito County,6,5,3939,2036,1903
California,San Benito County,6,6,3636,1888,1748
California,San Benito County,6,7,3717,1856,1861
California,San Benito County,6,8,3590,1787,1803
California,San Benito County,6,9,3806,1898,1908
California,San Benito County,6,10,4042,1980,2062
California,San Benito County,6,11,4136,2061,2075
California,San Benito County,6,12,3716,1852,1864
California,San Benito County,6,13,3030,1478,1552
California,San Benito County,6,14,2191,1069,1122
California,San Benito County,6,15,1487,710,777
California,San Benito County,6,16,971,476,495
California,San Benito County,6,17,785,321,464
California,San Benito County,6,18,839,297,542
California,San Benito County,7,0,57867,28932,28935
California,San Benito County,7,1,3944,2012,1932
California,San Benito County,7,2,4371,2168,2203
California,San Benito County,7,3,4481,2309,2172
California,San Benito County,7,4,4472,2309,2163
California,San Benito County,7,5,4003,2050,1953
California,San Benito County,7,6,3648,1891,1757
California,San Benito County,7,7,3877,1995,1882
California,San Benito County,7,8,3685,1833,1852
California,San Benito County,7,9,3699,1853,1846
California,San Benito County,7,10,3998,1962,2036
California,San Benito County,7,11,4183,2065,2118
California,San Benito County,7,12,3720,1870,1850
California,San Benito County,7,13,3162,1558,1604
California,San Benito County,7,14,2325,1160,1165
California,San Benito County,7,15,1598,746,852
California,San Benito County,7,16,1008,498,510
California,San Benito County,7,17,834,354,480
California,San Benito County,7,18,859,299,560
California,San Benito County,8,0,58243,29113,29130
California,San Benito County,8,1,3878,1961,1917
California,San Benito County,8,2,4317,2153,2164
California,San Benito County,8,3,4459,2255,2204
California,San Benito County,8,4,4435,2311,2124
California,San Benito County,8,5,3991,2063,1928
California,San Benito County,8,6,3736,1909,1827
California,San Benito County,8,7,3921,2022,1899
California,San Benito County,8,8,3722,1853,1869
California,San Benito County,8,9,3686,1888,1798
California,San Benito County,8,10,3934,1904,2030
California,San Benito County,8,11,4146,2059,2087
California,San Benito County,8,12,3806,1904,1902
California,San Benito County,8,13,3235,1617,1618
California,San Benito County,8,14,2494,1229,1265
California,San Benito County,8,15,1686,783,903
California,San Benito County,8,16,1074,517,557
California,San Benito County,8,17,811,366,445
California,San Benito County,8,18,912,319,593
California,San Benito County,9,0,59235,29684,29551
California,San Benito County,9,1,3910,1963,1947
California,San Benito County,9,2,4288,2167,2121
California,San Benito County,9,3,4478,2274,2204
California,San Benito County,9,4,4455,2303,2152
California,San Benito County,9,5,4052,2054,1998
California,San Benito County,9,6,3818,2016,1802
California,San Benito County,9,7,4084,2127,1957
California,San Benito County,9,8,3833,1907,1926
California,San Benito County,9,9,3672,1900,1772
California,San Benito County,9,10,3938,1916,2022
California,San Benito County,9,11,4180,2075,2105
California,San Benito County,9,12,3893,1961,1932
California,San Benito County,9,13,3324,1675,1649
California,San Benito County,9,14,2647,1300,1347
California,San Benito County,9,15,1781,816,965
California,San Benito County,9,16,1156,540,616
California,San Benito County,9,17,775,357,418
California,San Benito County,9,18,951,333,618
California,San Benito County,10,0,60199,30155,30044
California,San Benito County,10,1,3955,1967,1988
California,San Benito County,10,2,4267,2150,2117
California,San Benito County,10,3,4573,2289,2284
California,San Benito County,10,4,4413,2300,2113
California,San Benito County,10,5,4067,2057,2010
California,San Benito County,10,6,3962,2065,1897
California,San Benito County,10,7,4184,2202,1982
California,San Benito County,10,8,4009,2026,1983
California,San Benito County,10,9,3761,1939,1822
California,San Benito County,10,10,3902,1930,1972
California,San Benito County,10,11,4070,1987,2083
California,San Benito County,10,12,4008,2019,1989
California,San Benito County,10,13,3428,1748,1680
California,San Benito County,10,14,2696,1287,1409
California,San Benito County,10,15,1895,892,1003
California,San Benito County,10,16,1251,584,667
California,San Benito County,10,17,793,368,425
California,San Benito County,10,18,965,345,620
California,San Benito County,11,0,61537,30843,30694
California,San Benito County,11,1,4072,2027,2045
California,San Benito County,11,2,4310,2210,2100
California,San Benito County,11,3,4707,2313,2394
California,San Benito County,11,4,4418,2288,2130
California,San Benito County,11,5,4084,2058,2026
California,San Benito County,11,6,4143,2160,1983
California,San Benito County,11,7,4281,2236,2045
California,San Benito County,11,8,4182,2160,2022
California,San Benito County,11,9,3954,2047,1907
California,San Benito County,11,10,3885,1933,1952
California,San Benito County,11,11,4046,2006,2040
California,San Benito County,11,12,4064,2031,2033
California,San Benito County,11,13,3454,1726,1728
California,San Benito County,11,14,2767,1326,1441
California,San Benito County,11,15,2006,976,1030
California,San Benito County,11,16,1343,612,731
California,San Benito County,11,17,845,372,473
California,San Benito County,11,18,976,362,614
California,San Bernardino County,1,0,2035210,1011507,1023703
California,San Bernardino County,1,1,158790,81204,77586
California,San Bernardino County,1,2,157368,80826,76542
California,San Bernardino County,1,3,168792,86488,82304
California,San Bernardino County,1,4,179627,92559,87068
California,San Bernardino County,1,5,159908,82686,77222
California,San Bernardino County,1,6,146477,74035,72442
California,San Bernardino County,1,7,135614,67251,68363
California,San Bernardino County,1,8,135711,66568,69143
California,San Bernardino County,1,9,137238,68259,68979
California,San Bernardino County,1,10,142691,70145,72546
California,San Bernardino County,1,11,134603,65998,68605
California,San Bernardino County,1,12,110620,53760,56860
California,San Bernardino County,1,13,86423,42112,44311
California,San Bernardino County,1,14,60089,28481,31608
California,San Bernardino County,1,15,43406,19885,23521
California,San Bernardino County,1,16,33065,14482,18583
California,San Bernardino County,1,17,23914,9643,14271
California,San Bernardino County,1,18,20874,7125,13749
California,San Bernardino County,2,0,2035201,1011504,1023697
California,San Bernardino County,2,1,158789,81204,77585
California,San Bernardino County,2,2,157365,80825,76540
California,San Bernardino County,2,3,168792,86487,82305
California,San Bernardino County,2,4,179627,92559,87068
California,San Bernardino County,2,5,159908,82686,77222
California,San Bernardino County,2,6,146477,74035,72442
California,San Bernardino County,2,7,135614,67251,68363
California,San Bernardino County,2,8,135709,66567,69142
California,San Bernardino County,2,9,137241,68262,68979
California,San Bernardino County,2,10,142690,70144,72546
California,San Bernardino County,2,11,134606,66000,68606
California,San Bernardino County,2,12,110615,53757,56858
California,San Bernardino County,2,13,86422,42111,44311
California,San Bernardino County,2,14,60088,28481,31607
California,San Bernardino County,2,15,43406,19885,23521
California,San Bernardino County,2,16,33065,14482,18583
California,San Bernardino County,2,17,23914,9643,14271
California,San Bernardino County,2,18,20873,7125,13748
California,San Bernardino County,3,0,2040910,1014412,1026498
California,San Bernardino County,3,1,158521,81088,77433
California,San Bernardino County,3,2,157502,80853,76649
California,San Bernardino County,3,3,168281,86266,82015
California,San Bernardino County,3,4,178635,92102,86533
California,San Bernardino County,3,5,161709,83539,78170
California,San Bernardino County,3,6,147260,74475,72785
California,San Bernardino County,3,7,136591,67832,68759
California,San Bernardino County,3,8,135458,66467,68991
California,San Bernardino County,3,9,137529,68310,69219
California,San Bernardino County,3,10,142389,70049,72340
California,San Bernardino County,3,11,135218,66319,68899
California,San Bernardino County,3,12,111629,54230,57399
California,San Bernardino County,3,13,87579,42636,44943
California,San Bernardino County,3,14,60690,28781,31909
California,San Bernardino County,3,15,43717,20062,23655
California,San Bernardino County,3,16,33093,14485,18608
California,San Bernardino County,3,17,24028,9721,14307
California,San Bernardino County,3,18,21081,7197,13884
California,San Bernardino County,4,0,2061040,1024361,1036679
California,San Bernardino County,4,1,158433,80976,77457
California,San Bernardino County,4,2,158274,81055,77219
California,San Bernardino County,4,3,166022,85121,80901
California,San Bernardino County,4,4,175049,90295,84754
California,San Bernardino County,4,5,167973,86666,81307
California,San Bernardino County,4,6,149723,75946,73777
California,San Bernardino County,4,7,139759,69854,69905
California,San Bernardino County,4,8,133760,65769,67991
California,San Bernardino County,4,9,138464,68460,70004
California,San Bernardino County,4,10,140169,69053,71116
California,San Bernardino County,4,11,137056,67222,69834
California,San Bernardino County,4,12,115392,55781,59611
California,San Bernardino County,4,13,92404,44928,47476
California,San Bernardino County,4,14,63350,30196,33154
California,San Bernardino County,4,15,45144,20778,24366
California,San Bernardino County,4,16,33686,14707,18979
California,San Bernardino County,4,17,24534,10092,14442
California,San Bernardino County,4,18,21848,7462,14386
California,San Bernardino County,5,0,2074195,1032013,1042182
California,San Bernardino County,5,1,156089,79854,76235
California,San Bernardino County,5,2,159594,81706,77888
California,San Bernardino County,5,3,162932,83572,79360
California,San Bernardino County,5,4,171167,88284,82883
California,San Bernardino County,5,5,172795,89633,83162
California,San Bernardino County,5,6,151668,77402,74266
California,San Bernardino County,5,7,142475,71575,70900
California,San Bernardino County,5,8,133566,65772,67794
California,San Bernardino County,5,9,137766,68080,69686
California,San Bernardino County,5,10,137126,67719,69407
California,San Bernardino County,5,11,137666,67428,70238
California,San Bernardino County,5,12,119558,57761,61797
California,San Bernardino County,5,13,93612,45260,48352
California,San Bernardino County,5,14,68960,33064,35896
California,San Bernardino County,5,15,47179,21699,25480
California,San Bernardino County,5,16,34412,15045,19367
California,San Bernardino County,5,17,24904,10341,14563
California,San Bernardino County,5,18,22726,7818,14908
California,San Bernardino County,6,0,2083871,1036232,1047639
California,San Bernardino County,6,1,153677,78199,75478
California,San Bernardino County,6,2,160332,82217,78115
California,San Bernardino County,6,3,160909,82493,78416
California,San Bernardino County,6,4,167336,86214,81122
California,San Bernardino County,6,5,174372,90708,83664
California,San Bernardino County,6,6,153774,78509,75265
California,San Bernardino County,6,7,144726,72769,71957
California,San Bernardino County,6,8,133798,66020,67778
California,San Bernardino County,6,9,136583,67204,69379
California,San Bernardino County,6,10,134937,66685,68252
California,San Bernardino County,6,11,137474,67319,70155
California,San Bernardino County,6,12,122753,59377,63376
California,San Bernardino County,6,13,96378,46410,49968
California,San Bernardino County,6,14,72612,34650,37962
California,San Bernardino County,6,15,50044,23097,26947
California,San Bernardino County,6,16,35471,15626,19845
California,San Bernardino County,6,17,25147,10499,14648
California,San Bernardino County,6,18,23548,8236,15312
California,San Bernardino County,7,0,2100776,1045359,1055417
California,San Bernardino County,7,1,153795,78316,75479
California,San Bernardino County,7,2,160255,82116,78139
California,San Bernardino County,7,3,159798,81918,77880
California,San Bernardino County,7,4,163627,84328,79299
California,San Bernardino County,7,5,175231,91478,83753
California,San Bernardino County,7,6,158477,80854,77623
California,San Bernardino County,7,7,147473,74495,72978
California,San Bernardino County,7,8,134697,66871,67826
California,San Bernardino County,7,9,135317,66398,68919
California,San Bernardino County,7,10,133604,66294,67310
California,San Bernardino County,7,11,137696,67457,70239
California,San Bernardino County,7,12,125083,60619,64464
California,San Bernardino County,7,13,100214,48007,52207
California,San Bernardino County,7,14,76373,36340,40033
California,San Bernardino County,7,15,52716,24386,28330
California,San Bernardino County,7,16,36514,16207,20307
California,San Bernardino County,7,17,25471,10614,14857
California,San Bernardino County,7,18,24435,8661,15774
California,San Bernardino County,8,0,2117311,1053658,1063653
California,San Bernardino County,8,1,154723,78901,75822
California,San Bernardino County,8,2,159648,81631,78017
California,San Bernardino County,8,3,158781,81255,77526
California,San Bernardino County,8,4,161530,83397,78133
California,San Bernardino County,8,5,172468,89899,82569
California,San Bernardino County,8,6,163801,83823,79978
California,San Bernardino County,8,7,148598,75243,73355
California,San Bernardino County,8,8,137194,68333,68861
California,San Bernardino County,8,9,133526,65479,68047
California,San Bernardino County,8,10,133709,66359,67350
California,San Bernardino County,8,11,136335,66718,69617
California,San Bernardino County,8,12,127751,62018,65733
California,San Bernardino County,8,13,104250,49912,54338
California,San Bernardino County,8,14,80742,38444,42298
California,San Bernardino County,8,15,55499,25728,29771
California,San Bernardino County,8,16,37626,16730,20896
California,San Bernardino County,8,17,25825,10766,15059
California,San Bernardino County,8,18,25305,9022,16283
California,San Bernardino County,9,0,2134174,1061810,1072364
California,San Bernardino County,9,1,154422,78882,75540
California,San Bernardino County,9,2,159850,81559,78291
California,San Bernardino County,9,3,159432,81605,77827
California,San Bernardino County,9,4,159908,82670,77238
California,San Bernardino County,9,5,168789,87950,80839
California,San Bernardino County,9,6,169329,86538,82791
California,San Bernardino County,9,7,150323,76263,74060
California,San Bernardino County,9,8,139789,69738,70051
California,San Bernardino County,9,9,132368,65110,67258
California,San Bernardino County,9,10,134649,66439,68210
California,San Bernardino County,9,11,134031,65655,68376
California,San Bernardino County,9,12,129749,63064,66685
California,San Bernardino County,9,13,107708,51406,56302
California,San Bernardino County,9,14,84971,40380,44591
California,San Bernardino County,9,15,57612,26755,30857
California,San Bernardino County,9,16,38942,17392,21550
California,San Bernardino County,9,17,26326,10999,15327
California,San Bernardino County,9,18,25976,9405,16571
California,San Bernardino County,10,0,2153203,1071508,1081695
California,San Bernardino County,10,1,154900,79029,75871
California,San Bernardino County,10,2,158681,80873,77808
California,San Bernardino County,10,3,161330,82479,78851
California,San Bernardino County,10,4,157765,81503,76262
California,San Bernardino County,10,5,166549,86831,79718
California,San Bernardino County,10,6,173887,89081,84806
California,San Bernardino County,10,7,152342,77547,74795
California,San Bernardino County,10,8,143347,71833,71514
California,San Bernardino County,10,9,132929,65590,67339
California,San Bernardino County,10,10,134793,66366,68427
California,San Bernardino County,10,11,132013,64908,67105
California,San Bernardino County,10,12,130693,63382,67311
California,San Bernardino County,10,13,111829,53401,58428
California,San Bernardino County,10,14,85945,40551,45394
California,San Bernardino County,10,15,62174,29026,33148
California,San Bernardino County,10,16,40557,18119,22438
California,San Bernardino County,10,17,26897,11260,15637
California,San Bernardino County,10,18,26572,9729,16843
California,San Bernardino County,11,0,2171603,1080950,1090653
California,San Bernardino County,11,1,155258,79286,75972
California,San Bernardino County,11,2,158113,80411,77702
California,San Bernardino County,11,3,162767,83503,79264
California,San Bernardino County,11,4,156631,81058,75573
California,San Bernardino County,11,5,163711,84941,78770
California,San Bernardino County,11,6,176422,90599,85823
California,San Bernardino County,11,7,155753,79561,76192
California,San Bernardino County,11,8,146687,73654,73033
California,San Bernardino County,11,9,133631,66174,67457
California,San Bernardino County,11,10,134369,65859,68510
California,San Bernardino County,11,11,130878,64458,66420
California,San Bernardino County,11,12,131373,63739,67634
California,San Bernardino County,11,13,114649,54863,59786
California,San Bernardino County,11,14,88483,41645,46838
California,San Bernardino County,11,15,65177,30420,34757
California,San Bernardino County,11,16,42891,19099,23792
California,San Bernardino County,11,17,27697,11733,15964
California,San Bernardino County,11,18,27113,9947,17166
California,San Diego County,1,0,3095313,1553679,1541634
California,San Diego County,1,1,203423,103833,99590
California,San Diego County,1,2,194029,99321,94708
California,San Diego County,1,3,198716,101903,96813
California,San Diego County,1,4,225095,118308,106787
California,San Diego County,1,5,270750,148641,122109
California,San Diego County,1,6,250737,131078,119659
California,San Diego County,1,7,220185,112648,107537
California,San Diego County,1,8,211012,106391,104621
California,San Diego County,1,9,209551,105283,104268
California,San Diego County,1,10,219795,110118,109677
California,San Diego County,1,11,210979,104346,106633
California,San Diego County,1,12,180305,87501,92804
California,San Diego County,1,13,149311,71683,77628
California,San Diego County,1,14,103241,48409,54832
California,San Diego County,1,15,77313,34739,42574
California,San Diego County,1,16,64347,28190,36157
California,San Diego County,1,17,52564,21706,30858
California,San Diego County,1,18,53960,19581,34379
California,San Diego County,2,0,3095349,1553693,1541656
California,San Diego County,2,1,203425,103833,99592
California,San Diego County,2,2,194032,99321,94711
California,San Diego County,2,3,198718,101905,96813
California,San Diego County,2,4,225099,118310,106789
California,San Diego County,2,5,270753,148642,122111
California,San Diego County,2,6,250739,131079,119660
California,San Diego County,2,7,220189,112649,107540
California,San Diego County,2,8,211013,106392,104621
California,San Diego County,2,9,209552,105283,104269
California,San Diego County,2,10,219798,110120,109678
California,San Diego County,2,11,210982,104346,106636
California,San Diego County,2,12,180306,87501,92805
California,San Diego County,2,13,149314,71684,77630
California,San Diego County,2,14,103243,48411,54832
California,San Diego County,2,15,77314,34740,42574
California,San Diego County,2,16,64347,28190,36157
California,San Diego County,2,17,52564,21706,30858
California,San Diego County,2,18,53961,19581,34380
California,San Diego County,3,0,3103306,1557312,1545994
California,San Diego County,3,1,204069,104107,99962
California,San Diego County,3,2,194238,99408,94830
California,San Diego County,3,3,198047,101514,96533
California,San Diego County,3,4,224333,117977,106356
California,San Diego County,3,5,271333,148512,122821
California,San Diego County,3,6,251684,131605,120079
California,San Diego County,3,7,222028,113674,108354
California,San Diego County,3,8,210550,106181,104369
California,San Diego County,3,9,210133,105543,104590
California,San Diego County,3,10,219010,109714,109296
California,San Diego County,3,11,211747,104765,106982
California,San Diego County,3,12,181793,88249,93544
California,San Diego County,3,13,150957,72457,78500
California,San Diego County,3,14,104422,49016,55406
California,San Diego County,3,15,77760,34956,42804
California,San Diego County,3,16,64161,28077,36084
California,San Diego County,3,17,52654,21838,30816
California,San Diego County,3,18,54387,19719,34668
California,San Diego County,4,0,3137372,1573536,1563836
California,San Diego County,4,1,207511,105745,101766
California,San Diego County,4,2,196071,100310,95761
California,San Diego County,4,3,196571,100671,95900
California,San Diego County,4,4,219445,115715,103730
California,San Diego County,4,5,274462,149375,125087
California,San Diego County,4,6,256209,134088,122121
California,San Diego County,4,7,229140,117393,111747
California,San Diego County,4,8,207672,104837,102835
California,San Diego County,4,9,212711,106569,106142
California,San Diego County,4,10,214932,107534,107398
California,San Diego County,4,11,214490,106313,108177
California,San Diego County,4,12,187463,90969,96494
California,San Diego County,4,13,158188,75875,82313
California,San Diego County,4,14,109474,51504,57970
California,San Diego County,4,15,79992,36050,43942
California,San Diego County,4,16,64340,28090,36250
California,San Diego County,4,17,52684,22137,30547
California,San Diego County,4,18,56017,20361,35656
California,San Diego County,5,0,3175201,1594714,1580487
California,San Diego County,5,1,208641,106634,102007
California,San Diego County,5,2,198875,101547,97328
California,San Diego County,5,3,194953,99699,95254
California,San Diego County,5,4,217102,114318,102784
California,San Diego County,5,5,276197,151030,125167
California,San Diego County,5,6,260931,137261,123670
California,San Diego County,5,7,236469,121478,114991
California,San Diego County,5,8,209180,105832,103348
California,San Diego County,5,9,213617,107177,106440
California,San Diego County,5,10,211453,105746,105707
California,San Diego County,5,11,215647,107172,108475
California,San Diego County,5,12,193856,94089,99767
California,San Diego County,5,13,159442,76559,82883
California,San Diego County,5,14,120526,56830,63696
California,San Diego County,5,15,83170,37693,45477
California,San Diego County,5,16,64897,28335,36562
California,San Diego County,5,17,52737,22359,30378
California,San Diego County,5,18,57508,20955,36553
California,San Diego County,6,0,3211248,1612223,1599025
California,San Diego County,6,1,210345,107558,102787
California,San Diego County,6,2,201018,102580,98438
California,San Diego County,6,3,194314,99300,95014
California,San Diego County,6,4,214226,112018,102208
California,San Diego County,6,5,273212,149638,123574
California,San Diego County,6,6,267682,140709,126973
California,San Diego County,6,7,244018,125787,118231
California,San Diego County,6,8,212307,107601,104706
California,San Diego County,6,9,213029,106585,106444
California,San Diego County,6,10,208984,104515,104469
California,San Diego County,6,11,216519,107577,108942
California,San Diego County,6,12,198657,96768,101889
California,San Diego County,6,13,163357,78434,84923
California,San Diego County,6,14,127867,60200,67667
California,San Diego County,6,15,88397,40284,48113
California,San Diego County,6,16,66096,28969,37127
California,San Diego County,6,17,52653,22357,30296
California,San Diego County,6,18,58567,21343,37224
California,San Diego County,7,0,3250993,1634368,1616625
California,San Diego County,7,1,213159,109137,104022
California,San Diego County,7,2,200857,102403,98454
California,San Diego County,7,3,194175,99127,95048
California,San Diego County,7,4,212113,110959,101154
California,San Diego County,7,5,272111,151134,120977
California,San Diego County,7,6,276058,144805,131253
California,San Diego County,7,7,250088,129181,120907
California,San Diego County,7,8,216318,110031,106287
California,San Diego County,7,9,211766,106097,105669
California,San Diego County,7,10,207075,103416,103659
California,San Diego County,7,11,217232,108006,109226
California,San Diego County,7,12,201759,98443,103316
California,San Diego County,7,13,168937,81068,87869
California,San Diego County,7,14,135965,64131,71834
California,San Diego County,7,15,92774,42462,50312
California,San Diego County,7,16,68013,29813,38200
California,San Diego County,7,17,52627,22252,30375
California,San Diego County,7,18,59966,21903,38063
California,San Diego County,8,0,3284061,1653076,1630985
California,San Diego County,8,1,214696,110105,104591
California,San Diego County,8,2,199973,101925,98048
California,San Diego County,8,3,193947,99066,94881
California,San Diego County,8,4,211381,110507,100874
California,San Diego County,8,5,268080,150299,117781
California,San Diego County,8,6,282676,148019,134657
California,San Diego County,8,7,253523,131321,122202
California,San Diego County,8,8,221952,113310,108642
California,San Diego County,8,9,209137,104921,104216
California,San Diego County,8,10,208267,103877,104390
California,San Diego County,8,11,215418,107145,108273
California,San Diego County,8,12,205373,100759,104614
California,San Diego County,8,13,174500,83626,90874
California,San Diego County,8,14,143424,67752,75672
California,San Diego County,8,15,97775,44884,52891
California,San Diego County,8,16,69648,30523,39125
California,San Diego County,8,17,52639,22172,30467
California,San Diego County,8,18,61652,22865,38787
California,San Diego County,9,0,3310280,1666334,1643946
California,San Diego County,9,1,213166,109513,103653
California,San Diego County,9,2,200760,102166,98594
California,San Diego County,9,3,194605,99481,95124
California,San Diego County,9,4,209629,109458,100171
California,San Diego County,9,5,262849,147354,115495
California,San Diego County,9,6,287565,150504,137061
California,San Diego County,9,7,257219,133751,123468
California,San Diego County,9,8,228596,116841,111755
California,San Diego County,9,9,206603,103764,102839
California,San Diego County,9,10,210780,104988,105792
California,San Diego County,9,11,211110,104924,106186
California,San Diego County,9,12,207732,102271,105461
California,San Diego County,9,13,179808,86044,93764
California,San Diego County,9,14,150198,70936,79262
California,San Diego County,9,15,102517,47192,55325
California,San Diego County,9,16,71545,31446,40099
California,San Diego County,9,17,52838,22275,30563
California,San Diego County,9,18,62760,23426,39334
California,San Diego County,10,0,3325468,1673435,1652033
California,San Diego County,10,1,210535,107916,102619
California,San Diego County,10,2,200720,102471,98249
California,San Diego County,10,3,196416,100060,96356
California,San Diego County,10,4,207259,108217,99042
California,San Diego County,10,5,255725,142739,112986
California,San Diego County,10,6,288355,151232,137123
California,San Diego County,10,7,260495,135731,124764
California,San Diego County,10,8,234140,120047,114093
California,San Diego County,10,9,207063,104080,102983
California,San Diego County,10,10,210789,105125,105664
California,San Diego County,10,11,207267,102965,104302
California,San Diego County,10,12,208016,102503,105513
California,San Diego County,10,13,184526,88326,96200
California,San Diego County,10,14,150617,71017,79600
California,San Diego County,10,15,112272,51792,60480
California,San Diego County,10,16,74421,32980,41441
California,San Diego County,10,17,53320,22444,30876
California,San Diego County,10,18,63532,23790,39742
California,San Diego County,11,0,3343364,1682449,1660915
California,San Diego County,11,1,208270,106687,101583
California,San Diego County,11,2,200824,102660,98164
California,San Diego County,11,3,197110,100490,96620
California,San Diego County,11,4,207127,107972,99155
California,San Diego County,11,5,251805,139929,111876
California,San Diego County,11,6,286427,150570,135857
California,San Diego County,11,7,264493,137876,126617
California,San Diego County,11,8,240211,123702,116509
California,San Diego County,11,9,208530,104956,103574
California,San Diego County,11,10,209193,104208,104985
California,San Diego County,11,11,203950,101423,102527
California,San Diego County,11,12,208106,102542,105564
California,San Diego County,11,13,187864,90315,97549
California,San Diego County,11,14,153360,72182,81178
California,San Diego County,11,15,118628,54728,63900
California,San Diego County,11,16,79028,35286,43742
California,San Diego County,11,17,54224,22956,31268
California,San Diego County,11,18,64214,23967,40247
California,San Francisco County,1,0,805235,408462,396773
California,San Francisco County,1,1,35203,17963,17240
California,San Francisco County,1,2,28462,14466,13996
California,San Francisco County,1,3,26299,13467,12832
California,San Francisco County,1,4,34606,16888,17718
California,San Francisco County,1,5,60618,29269,31349
California,San Francisco County,1,6,88156,44178,43978
California,San Francisco County,1,7,79964,41351,38613
California,San Francisco County,1,8,70813,38264,32549
California,San Francisco County,1,9,62869,34906,27963
California,San Francisco County,1,10,57577,31783,25794
California,San Francisco County,1,11,54230,28957,25273
California,San Francisco County,1,12,51708,26777,24931
California,San Francisco County,1,13,44888,22455,22433
California,San Francisco County,1,14,29780,14318,15462
California,San Francisco County,1,15,24542,11274,13268
California,San Francisco County,1,16,20839,9294,11545
California,San Francisco County,1,17,17190,6878,10312
California,San Francisco County,1,18,17491,5974,11517
California,San Francisco County,2,0,805184,408436,396748
California,San Francisco County,2,1,35198,17958,17240
California,San Francisco County,2,2,28462,14466,13996
California,San Francisco County,2,3,26301,13468,12833
California,San Francisco County,2,4,34603,16888,17715
California,San Francisco County,2,5,60614,29267,31347
California,San Francisco County,2,6,88148,44176,43972
California,San Francisco County,2,7,79959,41347,38612
California,San Francisco County,2,8,70808,38260,32548
California,San Francisco County,2,9,62865,34903,27962
California,San Francisco County,2,10,57579,31783,25796
California,San Francisco County,2,11,54226,28956,25270
California,San Francisco County,2,12,51707,26776,24931
California,San Francisco County,2,13,44887,22456,22431
California,San Francisco County,2,14,29779,14319,15460
California,San Francisco County,2,15,24536,11272,13264
California,San Francisco County,2,16,20833,9291,11542
California,San Francisco County,2,17,17189,6877,10312
California,San Francisco County,2,18,17490,5973,11517
California,San Francisco County,3,0,805550,408614,396936
California,San Francisco County,3,1,35391,18100,17291
California,San Francisco County,3,2,28501,14439,14062
California,San Francisco County,3,3,26306,13468,12838
California,San Francisco County,3,4,33986,16623,17363
California,San Francisco County,3,5,59806,28904,30902
California,San Francisco County,3,6,88151,44117,44034
California,San Francisco County,3,7,80367,41522,38845
California,San Francisco County,3,8,70445,37985,32460
California,San Francisco County,3,9,63202,35031,28171
California,San Francisco County,3,10,57699,31874,25825
California,San Francisco County,3,11,54219,29030,25189
California,San Francisco County,3,12,51723,26755,24968
California,San Francisco County,3,13,45440,22755,22685
California,San Francisco County,3,14,30039,14453,15586
California,San Francisco County,3,15,24630,11323,13307
California,San Francisco County,3,16,20761,9267,11494
California,San Francisco County,3,17,17232,6940,10292
California,San Francisco County,3,18,17652,6028,11624
California,San Francisco County,4,0,815677,413943,401734
California,San Francisco County,4,1,36583,18785,17798
California,San Francisco County,4,2,29026,14632,14394
California,San Francisco County,4,3,26645,13501,13144
California,San Francisco County,4,4,32136,15790,16346
California,San Francisco County,4,5,57492,27885,29607
California,San Francisco County,4,6,91213,45803,45410
California,San Francisco County,4,7,83316,43047,40269
California,San Francisco County,4,8,69499,37174,32325
California,San Francisco County,4,9,65005,35785,29220
California,San Francisco County,4,10,58211,32208,26003
California,San Francisco County,4,11,54166,29232,24934
California,San Francisco County,4,12,52274,26995,25279
California,San Francisco County,4,13,47871,23941,23930
California,San Francisco County,4,14,31163,15068,16095
California,San Francisco County,4,15,24818,11457,13361
California,San Francisco County,4,16,20756,9297,11459
California,San Francisco County,4,17,17327,7102,10225
California,San Francisco County,4,18,18176,6241,11935
California,San Francisco County,5,0,829027,421328,407699
California,San Francisco County,5,1,37595,19296,18299
California,San Francisco County,5,2,29965,15221,14744
California,San Francisco County,5,3,26730,13476,13254
California,San Francisco County,5,4,31324,15315,16009
California,San Francisco County,5,5,55556,26998,28558
California,San Francisco County,5,6,93962,47575,46387
California,San Francisco County,5,7,87068,45085,41983
California,San Francisco County,5,8,70394,37448,32946
California,San Francisco County,5,9,66002,36194,29808
California,San Francisco County,5,10,58584,32521,26063
California,San Francisco County,5,11,54410,29344,25066
California,San Francisco County,5,12,52937,27534,25403
California,San Francisco County,5,13,48434,24233,24201
California,San Francisco County,5,14,34059,16506,17553
California,San Francisco County,5,15,25037,11551,13486
California,San Francisco County,5,16,20899,9373,11526
California,San Francisco County,5,17,17173,7095,10078
California,San Francisco County,5,18,18898,6563,12335
California,San Francisco County,6,0,839841,427534,412307
California,San Francisco County,6,1,38493,19756,18737
California,San Francisco County,6,2,30564,15520,15044
California,San Francisco County,6,3,27229,13769,13460
California,San Francisco County,6,4,30761,15030,15731
California,San Francisco County,6,5,53165,25851,27314
California,San Francisco County,6,6,96676,49158,47518
California,San Francisco County,6,7,90766,47334,43432
California,San Francisco County,6,8,70617,37502,33115
California,San Francisco County,6,9,65925,35906,30019
California,San Francisco County,6,10,58675,32515,26160
California,San Francisco County,6,11,54988,29782,25206
California,San Francisco County,6,12,53254,27803,25451
California,San Francisco County,6,13,48901,24493,24408
California,San Francisco County,6,14,36577,17773,18804
California,San Francisco County,6,15,25453,11841,13612
California,San Francisco County,6,16,21113,9424,11689
California,San Francisco County,6,17,17062,7176,9886
California,San Francisco County,6,18,19622,6901,12721
California,San Francisco County,7,0,851116,433925,417191
California,San Francisco County,7,1,39032,20073,18959
California,San Francisco County,7,2,30980,15771,15209
California,San Francisco County,7,3,27885,14209,13676
California,San Francisco County,7,4,30482,14839,15643
California,San Francisco County,7,5,51541,25164,26377
California,San Francisco County,7,6,99586,50968,48618
California,San Francisco County,7,7,94399,49393,45006
California,San Francisco County,7,8,71160,37676,33484
California,San Francisco County,7,9,65157,35338,29819
California,San Francisco County,7,10,59057,32549,26508
California,San Francisco County,7,11,55693,30268,25425
California,San Francisco County,7,12,53022,27736,25286
California,San Francisco County,7,13,49295,24771,24524
California,San Francisco County,7,14,39118,19046,20072
California,San Francisco County,7,15,26032,12137,13895
California,San Francisco County,7,16,21284,9500,11784
California,San Francisco County,7,17,17094,7272,9822
California,San Francisco County,7,18,20299,7215,13084
California,San Francisco County,8,0,863836,440738,423098
California,San Francisco County,8,1,40091,20688,19403
California,San Francisco County,8,2,31079,15836,15243
California,San Francisco County,8,3,28327,14314,14013
California,San Francisco County,8,4,30185,14761,15424
California,San Francisco County,8,5,50639,24888,25751
California,San Francisco County,8,6,102497,52728,49769
California,San Francisco County,8,7,97870,51167,46703
California,San Francisco County,8,8,72686,38345,34341
California,San Francisco County,8,9,63791,34350,29441
California,San Francisco County,8,10,60313,33143,27170
California,San Francisco County,8,11,56049,30557,25492
California,San Francisco County,8,12,52957,27836,25121
California,San Francisco County,8,13,49122,24734,24388
California,San Francisco County,8,14,41801,20354,21447
California,San Francisco County,8,15,26902,12608,14294
California,San Francisco County,8,16,21560,9619,11941
California,San Francisco County,8,17,17002,7257,9745
California,San Francisco County,8,18,20965,7553,13412
California,San Francisco County,9,0,872795,445043,427752
California,San Francisco County,9,1,40018,20502,19516
California,San Francisco County,9,2,31776,16280,15496
California,San Francisco County,9,3,28737,14476,14261
California,San Francisco County,9,4,30296,14738,15558
California,San Francisco County,9,5,49459,24414,25045
California,San Francisco County,9,6,104728,53832,50896
California,San Francisco County,9,7,100807,52628,48179
California,San Francisco County,9,8,74212,39293,34919
California,San Francisco County,9,9,62194,33211,28983
California,San Francisco County,9,10,60915,33180,27735
California,San Francisco County,9,11,56031,30623,25408
California,San Francisco County,9,12,52574,27813,24761
California,San Francisco County,9,13,49325,24880,24445
California,San Francisco County,9,14,43611,21219,22392
California,San Francisco County,9,15,27808,13093,14715
California,San Francisco County,9,16,21811,9775,12036
California,San Francisco County,9,17,17011,7308,9703
California,San Francisco County,9,18,21482,7778,13704
California,San Francisco County,10,0,879166,448448,430718
California,San Francisco County,10,1,39972,20461,19511
California,San Francisco County,10,2,31999,16488,15511
California,San Francisco County,10,3,29443,14883,14560
California,San Francisco County,10,4,30463,14794,15669
California,San Francisco County,10,5,48634,23852,24782
California,San Francisco County,10,6,104999,54140,50859
California,San Francisco County,10,7,102800,53848,48952
California,San Francisco County,10,8,76324,40525,35799
California,San Francisco County,10,9,61362,32522,28840
California,San Francisco County,10,10,60909,33100,27809
California,San Francisco County,10,11,55603,30362,25241
California,San Francisco County,10,12,52196,27551,24645
California,San Francisco County,10,13,49359,24963,24396
California,San Francisco County,10,14,43985,21387,22598
California,San Francisco County,10,15,30320,14374,15946
California,San Francisco County,10,16,21813,9772,12041
California,San Francisco County,10,17,17275,7437,9838
California,San Francisco County,10,18,21710,7989,13721
California,San Francisco County,11,0,883305,450363,432942
California,San Francisco County,11,1,39722,20351,19371
California,San Francisco County,11,2,32285,16613,15672
California,San Francisco County,11,3,29737,15071,14666
California,San Francisco County,11,4,30923,14992,15931
California,San Francisco County,11,5,48005,23467,24538
California,San Francisco County,11,6,103432,53343,50089
California,San Francisco County,11,7,104864,54932,49932
California,San Francisco County,11,8,78518,41778,36740
California,San Francisco County,11,9,60818,32203,28615
California,San Francisco County,11,10,60003,32347,27656
California,San Francisco County,11,11,55093,30032,25061
California,San Francisco County,11,12,52302,27598,24704
California,San Francisco County,11,13,49354,25075,24279
California,San Francisco County,11,14,44340,21542,22798
California,San Francisco County,11,15,32506,15371,17135
California,San Francisco County,11,16,22094,9989,12105
California,San Francisco County,11,17,17480,7484,9996
California,San Francisco County,11,18,21829,8175,13654
California,San Joaquin County,1,0,685306,341230,344076
California,San Joaquin County,1,1,54228,27820,26408
California,San Joaquin County,1,2,54810,27980,26830
California,San Joaquin County,1,3,56165,28769,27396
California,San Joaquin County,1,4,58382,30397,27985
California,San Joaquin County,1,5,48451,25280,23171
California,San Joaquin County,1,6,46230,23660,22570
California,San Joaquin County,1,7,44585,22160,22425
California,San Joaquin County,1,8,44909,22159,22750
California,San Joaquin County,1,9,45829,23110,22719
California,San Joaquin County,1,10,47474,23753,23721
California,San Joaquin County,1,11,44365,22143,22222
California,San Joaquin County,1,12,37649,18270,19379
California,San Joaquin County,1,13,31048,15023,16025
California,San Joaquin County,1,14,22389,10432,11957
California,San Joaquin County,1,15,16141,7361,8780
California,San Joaquin County,1,16,12575,5435,7140
California,San Joaquin County,1,17,10134,4051,6083
California,San Joaquin County,1,18,9942,3427,6515
California,San Joaquin County,2,0,685306,341231,344075
California,San Joaquin County,2,1,54228,27820,26408
California,San Joaquin County,2,2,54810,27980,26830
California,San Joaquin County,2,3,56165,28769,27396
California,San Joaquin County,2,4,58382,30397,27985
California,San Joaquin County,2,5,48451,25280,23171
California,San Joaquin County,2,6,46230,23660,22570
California,San Joaquin County,2,7,44585,22160,22425
California,San Joaquin County,2,8,44909,22159,22750
California,San Joaquin County,2,9,45829,23110,22719
California,San Joaquin County,2,10,47474,23753,23721
California,San Joaquin County,2,11,44365,22143,22222
California,San Joaquin County,2,12,37651,18272,19379
California,San Joaquin County,2,13,31048,15023,16025
California,San Joaquin County,2,14,22387,10431,11956
California,San Joaquin County,2,15,16141,7361,8780
California,San Joaquin County,2,16,12575,5435,7140
California,San Joaquin County,2,17,10134,4051,6083
California,San Joaquin County,2,18,9942,3427,6515
California,San Joaquin County,3,0,687156,342081,345075
California,San Joaquin County,3,1,54168,27758,26410
California,San Joaquin County,3,2,54842,27994,26848
California,San Joaquin County,3,3,56153,28774,27379
California,San Joaquin County,3,4,58003,30201,27802
California,San Joaquin County,3,5,49035,25556,23479
California,San Joaquin County,3,6,46309,23692,22617
California,San Joaquin County,3,7,44814,22285,22529
California,San Joaquin County,3,8,44843,22121,22722
California,San Joaquin County,3,9,45917,23106,22811
California,San Joaquin County,3,10,47392,23722,23670
California,San Joaquin County,3,11,44652,22293,22359
California,San Joaquin County,3,12,37960,18438,19522
California,San Joaquin County,3,13,31429,15169,16260
California,San Joaquin County,3,14,22584,10556,12028
California,San Joaquin County,3,15,16289,7425,8864
California,San Joaquin County,3,16,12594,5454,7140
California,San Joaquin County,3,17,10138,4062,6076
California,San Joaquin County,3,18,10034,3475,6559
California,San Joaquin County,4,0,694388,345482,348906
California,San Joaquin County,4,1,53814,27458,26356
California,San Joaquin County,4,2,55131,28178,26953
California,San Joaquin County,4,3,56132,28812,27320
California,San Joaquin County,4,4,56714,29451,27263
California,San Joaquin County,4,5,51042,26505,24537
California,San Joaquin County,4,6,46801,24080,22721
California,San Joaquin County,4,7,45640,22688,22952
California,San Joaquin County,4,8,44346,21909,22437
California,San Joaquin County,4,9,46282,23047,23235
California,San Joaquin County,4,10,46892,23583,23309
California,San Joaquin County,4,11,45478,22698,22780
California,San Joaquin County,4,12,39126,19114,20012
California,San Joaquin County,4,13,33108,15812,17296
California,San Joaquin County,4,14,23512,11102,12410
California,San Joaquin County,4,15,16942,7711,9231
California,San Joaquin County,4,16,12836,5580,7256
California,San Joaquin County,4,17,10098,4073,6025
California,San Joaquin County,4,18,10494,3681,6813
California,San Joaquin County,5,0,699782,347905,351877
California,San Joaquin County,5,1,53150,27239,25911
California,San Joaquin County,5,2,55753,28435,27318
California,San Joaquin County,5,3,55887,28767,27120
California,San Joaquin County,5,4,55749,28914,26835
California,San Joaquin County,5,5,52236,26971,25265
California,San Joaquin County,5,6,46972,24028,22944
California,San Joaquin County,5,7,46631,23205,23426
California,San Joaquin County,5,8,44043,21794,22249
California,San Joaquin County,5,9,46251,22930,23321
California,San Joaquin County,5,10,46221,23351,22870
California,San Joaquin County,5,11,45871,22685,23186
California,San Joaquin County,5,12,40364,19865,20499
California,San Joaquin County,5,13,33381,15904,17477
California,San Joaquin County,5,14,25694,12138,13556
California,San Joaquin County,5,15,17774,8096,9678
California,San Joaquin County,5,16,13073,5727,7346
California,San Joaquin County,5,17,9915,4043,5872
California,San Joaquin County,5,18,10817,3813,7004
California,San Joaquin County,6,0,702387,348721,353666
California,San Joaquin County,6,1,52426,27005,25421
California,San Joaquin County,6,2,56030,28555,27475
California,San Joaquin County,6,3,55442,28443,26999
California,San Joaquin County,6,4,54914,28329,26585
California,San Joaquin County,6,5,52240,26842,25398
California,San Joaquin County,6,6,47020,23963,23057
California,San Joaquin County,6,7,46987,23493,23494
California,San Joaquin County,6,8,44176,21776,22400
California,San Joaquin County,6,9,45922,22594,23328
California,San Joaquin County,6,10,45447,22984,22463
California,San Joaquin County,6,11,46073,22814,23259
California,San Joaquin County,6,12,41330,20380,20950
California,San Joaquin County,6,13,34061,16266,17795
California,San Joaquin County,6,14,27016,12771,14245
California,San Joaquin County,6,15,18843,8584,10259
California,San Joaquin County,6,16,13407,5908,7499
California,San Joaquin County,6,17,9983,4118,5865
California,San Joaquin County,6,18,11070,3896,7174
California,San Joaquin County,7,0,711771,353890,357881
California,San Joaquin County,7,1,52468,26926,25542
California,San Joaquin County,7,2,56357,28869,27488
California,San Joaquin County,7,3,55895,28527,27368
California,San Joaquin County,7,4,54449,28080,26369
California,San Joaquin County,7,5,52701,27134,25567
California,San Joaquin County,7,6,48333,24761,23572
California,San Joaquin County,7,7,48195,24299,23896
California,San Joaquin County,7,8,45439,22576,22863
California,San Joaquin County,7,9,45613,22487,23126
California,San Joaquin County,7,10,45438,22916,22522
California,San Joaquin County,7,11,46415,23096,23319
California,San Joaquin County,7,12,42168,20866,21302
California,San Joaquin County,7,13,35135,16857,18278
California,San Joaquin County,7,14,28351,13334,15017
California,San Joaquin County,7,15,19904,9026,10878
California,San Joaquin County,7,16,13771,6087,7684
California,San Joaquin County,7,17,9973,4119,5854
California,San Joaquin County,7,18,11166,3930,7236
California,San Joaquin County,8,0,721929,359454,362475
California,San Joaquin County,8,1,52391,26935,25456
California,San Joaquin County,8,2,56885,29197,27688
California,San Joaquin County,8,3,56446,28791,27655
California,San Joaquin County,8,4,54689,28248,26441
California,San Joaquin County,8,5,52125,26890,25235
California,San Joaquin County,8,6,50350,25907,24443
California,San Joaquin County,8,7,48858,24720,24138
California,San Joaquin County,8,8,46814,23237,23577
California,San Joaquin County,8,9,45628,22594,23034
California,San Joaquin County,8,10,45684,23020,22664
California,San Joaquin County,8,11,46328,23139,23189
California,San Joaquin County,8,12,43235,21438,21797
California,San Joaquin County,8,13,36273,17421,18852
California,San Joaquin County,8,14,29876,14041,15835
California,San Joaquin County,8,15,20750,9453,11297
California,San Joaquin County,8,16,14178,6267,7911
California,San Joaquin County,8,17,10100,4183,5917
California,San Joaquin County,8,18,11319,3973,7346
California,San Joaquin County,9,0,732185,364978,367207
California,San Joaquin County,9,1,52409,27032,25377
California,San Joaquin County,9,2,57240,29254,27986
California,San Joaquin County,9,3,57130,29235,27895
California,San Joaquin County,9,4,55080,28488,26592
California,San Joaquin County,9,5,51591,26603,24988
California,San Joaquin County,9,6,52312,27068,25244
California,San Joaquin County,9,7,49513,25083,24430
California,San Joaquin County,9,8,48387,24131,24256
California,San Joaquin County,9,9,45390,22604,22786
California,San Joaquin County,9,10,46254,23197,23057
California,San Joaquin County,9,11,46058,23113,22945
California,San Joaquin County,9,12,43996,21773,22223
California,San Joaquin County,9,13,37437,18024,19413
California,San Joaquin County,9,14,31213,14605,16608
California,San Joaquin County,9,15,21608,9940,11668
California,San Joaquin County,9,16,14902,6552,8350
California,San Joaquin County,9,17,10178,4206,5972
California,San Joaquin County,9,18,11487,4070,7417
California,San Joaquin County,10,0,742516,370105,372411
California,San Joaquin County,10,1,53020,27334,25686
California,San Joaquin County,10,2,57144,29205,27939
California,San Joaquin County,10,3,58408,29830,28578
California,San Joaquin County,10,4,55322,28679,26643
California,San Joaquin County,10,5,50901,26247,24654
California,San Joaquin County,10,6,53980,27827,26153
California,San Joaquin County,10,7,50027,25288,24739
California,San Joaquin County,10,8,50077,25146,24931
California,San Joaquin County,10,9,45783,22774,23009
California,San Joaquin County,10,10,46616,23385,23231
California,San Joaquin County,10,11,45486,22920,22566
California,San Joaquin County,10,12,44581,21861,22720
California,San Joaquin County,10,13,38749,18836,19913
California,San Joaquin County,10,14,31231,14571,16660
California,San Joaquin County,10,15,23593,10876,12717
California,San Joaquin County,10,16,15694,6928,8766
California,San Joaquin County,10,17,10376,4318,6058
California,San Joaquin County,10,18,11528,4080,7448
California,San Joaquin County,11,0,752660,375136,377524
California,San Joaquin County,11,1,53303,27380,25923
California,San Joaquin County,11,2,57056,29226,27830
California,San Joaquin County,11,3,59320,30387,28933
California,San Joaquin County,11,4,55652,28759,26893
California,San Joaquin County,11,5,50968,26184,24784
California,San Joaquin County,11,6,54998,28342,26656
California,San Joaquin County,11,7,50850,25739,25111
California,San Joaquin County,11,8,51350,25947,25403
California,San Joaquin County,11,9,46585,23239,23346
California,San Joaquin County,11,10,46854,23269,23585
California,San Joaquin County,11,11,45209,22859,22350
California,San Joaquin County,11,12,44905,22044,22861
California,San Joaquin County,11,13,39694,19313,20381
California,San Joaquin County,11,14,32035,15002,17033
California,San Joaquin County,11,15,24778,11394,13384
California,San Joaquin County,11,16,16685,7383,9302
California,San Joaquin County,11,17,10690,4507,6183
California,San Joaquin County,11,18,11728,4162,7566
California,San Luis Obispo County,1,0,269637,137999,131638
California,San Luis Obispo County,1,1,13343,6829,6514
California,San Luis Obispo County,1,2,13773,6945,6828
California,San Luis Obispo County,1,3,14201,7259,6942
California,San Luis Obispo County,1,4,21727,11465,10262
California,San Luis Obispo County,1,5,27342,15455,11887
California,San Luis Obispo County,1,6,17368,9510,7858
California,San Luis Obispo County,1,7,14740,8029,6711
California,San Luis Obispo County,1,8,14140,7568,6572
California,San Luis Obispo County,1,9,15612,8398,7214
California,San Luis Obispo County,1,10,18583,9571,9012
California,San Luis Obispo County,1,11,20670,10169,10501
California,San Luis Obispo County,1,12,20045,9885,10160
California,San Luis Obispo County,1,13,17071,8543,8528
California,San Luis Obispo County,1,14,12364,5923,6441
California,San Luis Obispo County,1,15,8823,4131,4692
California,San Luis Obispo County,1,16,7334,3346,3988
California,San Luis Obispo County,1,17,6197,2647,3550
California,San Luis Obispo County,1,18,6304,2326,3978
California,San Luis Obispo County,2,0,269597,137979,131618
California,San Luis Obispo County,2,1,13341,6827,6514
California,San Luis Obispo County,2,2,13768,6943,6825
California,San Luis Obispo County,2,3,14198,7258,6940
California,San Luis Obispo County,2,4,21721,11463,10258
California,San Luis Obispo County,2,5,27337,15450,11887
California,San Luis Obispo County,2,6,17366,9509,7857
California,San Luis Obispo County,2,7,14741,8030,6711
California,San Luis Obispo County,2,8,14137,7567,6570
California,San Luis Obispo County,2,9,15612,8398,7214
California,San Luis Obispo County,2,10,18575,9567,9008
California,San Luis Obispo County,2,11,20669,10169,10500
California,San Luis Obispo County,2,12,20045,9886,10159
California,San Luis Obispo County,2,13,17071,8543,8528
California,San Luis Obispo County,2,14,12359,5920,6439
California,San Luis Obispo County,2,15,8824,4131,4693
California,San Luis Obispo County,2,16,7333,3346,3987
California,San Luis Obispo County,2,17,6195,2645,3550
California,San Luis Obispo County,2,18,6305,2327,3978
California,San Luis Obispo County,3,0,269805,137913,131892
California,San Luis Obispo County,3,1,13394,6838,6556
California,San Luis Obispo County,3,2,13766,6961,6805
California,San Luis Obispo County,3,3,14180,7242,6938
California,San Luis Obispo County,3,4,21936,11507,10429
California,San Luis Obispo County,3,5,27727,15622,12105
California,San Luis Obispo County,3,6,17149,9384,7765
California,San Luis Obispo County,3,7,14815,8058,6757
California,San Luis Obispo County,3,8,14018,7505,6513
California,San Luis Obispo County,3,9,15529,8337,7192
California,San Luis Obispo County,3,10,18302,9435,8867
California,San Luis Obispo County,3,11,20464,10059,10405
California,San Luis Obispo County,3,12,20046,9853,10193
California,San Luis Obispo County,3,13,17222,8614,8608
California,San Luis Obispo County,3,14,12475,5980,6495
California,San Luis Obispo County,3,15,8921,4191,4730
California,San Luis Obispo County,3,16,7310,3336,3974
California,San Luis Obispo County,3,17,6197,2643,3554
California,San Luis Obispo County,3,18,6354,2348,4006
California,San Luis Obispo County,4,0,271050,138461,132589
California,San Luis Obispo County,4,1,13453,6918,6535
California,San Luis Obispo County,4,2,13820,7021,6799
California,San Luis Obispo County,4,3,14100,7190,6910
California,San Luis Obispo County,4,4,22055,11470,10585
California,San Luis Obispo County,4,5,28489,16059,12430
California,San Luis Obispo County,4,6,16382,8925,7457
California,San Luis Obispo County,4,7,15284,8225,7059
California,San Luis Obispo County,4,8,13794,7425,6369
California,San Luis Obispo County,4,9,15514,8303,7211
California,San Luis Obispo County,4,10,17315,8988,8327
California,San Luis Obispo County,4,11,20006,9875,10131
California,San Luis Obispo County,4,12,20272,9853,10419
California,San Luis Obispo County,4,13,18267,9115,9152
California,San Luis Obispo County,4,14,12982,6261,6721
California,San Luis Obispo County,4,15,9319,4420,4899
California,San Luis Obispo County,4,16,7373,3364,4009
California,San Luis Obispo County,4,17,6119,2623,3496
California,San Luis Obispo County,4,18,6506,2426,4080
California,San Luis Obispo County,5,0,274184,140063,134121
California,San Luis Obispo County,5,1,13413,6871,6542
California,San Luis Obispo County,5,2,14116,7195,6921
California,San Luis Obispo County,5,3,14012,7112,6900
California,San Luis Obispo County,5,4,22203,11480,10723
California,San Luis Obispo County,5,5,29990,16994,12996
California,San Luis Obispo County,5,6,15729,8510,7219
California,San Luis Obispo County,5,7,15858,8551,7307
California,San Luis Obispo County,5,8,14025,7561,6464
California,San Luis Obispo County,5,9,15386,8240,7146
California,San Luis Obispo County,5,10,16639,8711,7928
California,San Luis Obispo County,5,11,19557,9745,9812
California,San Luis Obispo County,5,12,20340,9758,10582
California,San Luis Obispo County,5,13,18513,9164,9349
California,San Luis Obispo County,5,14,14324,6974,7350
California,San Luis Obispo County,5,15,9850,4681,5169
California,San Luis Obispo County,5,16,7493,3385,4108
California,San Luis Obispo County,5,17,6059,2635,3424
California,San Luis Obispo County,5,18,6677,2496,4181
California,San Luis Obispo County,6,0,275751,140460,135291
California,San Luis Obispo County,6,1,13501,6957,6544
California,San Luis Obispo County,6,2,14195,7192,7003
California,San Luis Obispo County,6,3,13954,7071,6883
California,San Luis Obispo County,6,4,21811,11242,10569
California,San Luis Obispo County,6,5,30410,17131,13279
California,San Luis Obispo County,6,6,15436,8373,7063
California,San Luis Obispo County,6,7,16334,8691,7643
California,San Luis Obispo County,6,8,14307,7726,6581
California,San Luis Obispo County,6,9,15156,8067,7089
California,San Luis Obispo County,6,10,15975,8364,7611
California,San Luis Obispo County,6,11,19003,9500,9503
California,San Luis Obispo County,6,12,20247,9651,10596
California,San Luis Obispo County,6,13,19009,9281,9728
California,San Luis Obispo County,6,14,15251,7481,7770
California,San Luis Obispo County,6,15,10715,5104,5611
California,San Luis Obispo County,6,16,7665,3441,4224
California,San Luis Obispo County,6,17,5984,2644,3340
California,San Luis Obispo County,6,18,6798,2544,4254
California,San Luis Obispo County,7,0,278296,141441,136855
California,San Luis Obispo County,7,1,13630,6915,6715
California,San Luis Obispo County,7,2,14122,7193,6929
California,San Luis Obispo County,7,3,14002,7114,6888
California,San Luis Obispo County,7,4,21867,11262,10605
California,San Luis Obispo County,7,5,30790,17179,13611
California,San Luis Obispo County,7,6,15705,8571,7134
California,San Luis Obispo County,7,7,16759,8871,7888
California,San Luis Obispo County,7,8,14715,7914,6801
California,San Luis Obispo County,7,9,14733,7862,6871
California,San Luis Obispo County,7,10,15481,8169,7312
California,San Luis Obispo County,7,11,18509,9231,9278
California,San Luis Obispo County,7,12,19972,9473,10499
California,San Luis Obispo County,7,13,19443,9430,10013
California,San Luis Obispo County,7,14,16341,8012,8329
California,San Luis Obispo County,7,15,11436,5419,6017
California,San Luis Obispo County,7,16,7879,3586,4293
California,San Luis Obispo County,7,17,5979,2669,3310
California,San Luis Obispo County,7,18,6933,2571,4362
California,San Luis Obispo County,8,0,280171,142058,138113
California,San Luis Obispo County,8,1,13565,6979,6586
California,San Luis Obispo County,8,2,14303,7366,6937
California,San Luis Obispo County,8,3,14131,7115,7016
California,San Luis Obispo County,8,4,21596,11067,10529
California,San Luis Obispo County,8,5,30794,17077,13717
California,San Luis Obispo County,8,6,15827,8719,7108
California,San Luis Obispo County,8,7,16749,8737,8012
California,San Luis Obispo County,8,8,15260,8141,7119
California,San Luis Obispo County,8,9,14320,7590,6730
California,San Luis Obispo County,8,10,15492,8156,7336
California,San Luis Obispo County,8,11,17773,8877,8896
California,San Luis Obispo County,8,12,19877,9398,10479
California,San Luis Obispo County,8,13,19819,9508,10311
California,San Luis Obispo County,8,14,17460,8532,8928
California,San Luis Obispo County,8,15,12130,5791,6339
California,San Luis Obispo County,8,16,8094,3710,4384
California,San Luis Obispo County,8,17,5985,2663,3322
California,San Luis Obispo County,8,18,6996,2632,4364
California,San Luis Obispo County,9,0,281958,143015,138943
California,San Luis Obispo County,9,1,13494,6923,6571
California,San Luis Obispo County,9,2,14233,7369,6864
California,San Luis Obispo County,9,3,14255,7244,7011
California,San Luis Obispo County,9,4,21596,11115,10481
California,San Luis Obispo County,9,5,30754,16990,13764
California,San Luis Obispo County,9,6,16244,8935,7309
California,San Luis Obispo County,9,7,16505,8667,7838
California,San Luis Obispo County,9,8,15815,8375,7440
California,San Luis Obispo County,9,9,14193,7547,6646
California,San Luis Obispo County,9,10,15476,8098,7378
California,San Luis Obispo County,9,11,17000,8512,8488
California,San Luis Obispo County,9,12,19585,9333,10252
California,San Luis Obispo County,9,13,20069,9490,10579
California,San Luis Obispo County,9,14,18547,9065,9482
California,San Luis Obispo County,9,15,12588,6028,6560
California,San Luis Obispo County,9,16,8478,3927,4551
California,San Luis Obispo County,9,17,6082,2717,3365
California,San Luis Obispo County,9,18,7044,2680,4364
California,San Luis Obispo County,10,0,282838,143497,139341
California,San Luis Obispo County,10,1,13309,6844,6465
California,San Luis Obispo County,10,2,14029,7235,6794
California,San Luis Obispo County,10,3,14402,7367,7035
California,San Luis Obispo County,10,4,21170,10866,10304
California,San Luis Obispo County,10,5,30369,16662,13707
California,San Luis Obispo County,10,6,16568,9124,7444
California,San Luis Obispo County,10,7,16257,8514,7743
California,San Luis Obispo County,10,8,16412,8744,7668
California,San Luis Obispo County,10,9,14292,7621,6671
California,San Luis Obispo County,10,10,15351,8068,7283
California,San Luis Obispo County,10,11,16417,8285,8132
California,San Luis Obispo County,10,12,19189,9246,9943
California,San Luis Obispo County,10,13,20259,9430,10829
California,San Luis Obispo County,10,14,18663,9110,9553
California,San Luis Obispo County,10,15,13908,6685,7223
California,San Luis Obispo County,10,16,8976,4210,4766
California,San Luis Obispo County,10,17,6172,2732,3440
California,San Luis Obispo County,10,18,7095,2754,4341
California,San Luis Obispo County,11,0,284010,144092,139918
California,San Luis Obispo County,11,1,13125,6737,6388
California,San Luis Obispo County,11,2,13922,7206,6716
California,San Luis Obispo County,11,3,14433,7333,7100
California,San Luis Obispo County,11,4,21498,11055,10443
California,San Luis Obispo County,11,5,30190,16530,13660
California,San Luis Obispo County,11,6,16664,9128,7536
California,San Luis Obispo County,11,7,15927,8444,7483
California,San Luis Obispo County,11,8,16813,8866,7947
California,San Luis Obispo County,11,9,14605,7866,6739
California,San Luis Obispo County,11,10,15137,8004,7133
California,San Luis Obispo County,11,11,15702,7967,7735
California,San Luis Obispo County,11,12,18800,9085,9715
California,San Luis Obispo County,11,13,20154,9333,10821
California,San Luis Obispo County,11,14,19095,9170,9925
California,San Luis Obispo County,11,15,14797,7159,7638
California,San Luis Obispo County,11,16,9669,4574,5095
California,San Luis Obispo County,11,17,6318,2809,3509
California,San Luis Obispo County,11,18,7161,2826,4335
California,San Mateo County,1,0,718451,353168,365283
California,San Mateo County,1,1,46360,23652,22708
California,San Mateo County,1,2,44729,22820,21909
California,San Mateo County,1,3,42463,21750,20713
California,San Mateo County,1,4,41249,21346,19903
California,San Mateo County,1,5,40098,21328,18770
California,San Mateo County,1,6,48320,24734,23586
California,San Mateo County,1,7,51014,25735,25279
California,San Mateo County,1,8,53358,26799,26559
California,San Mateo County,1,9,54742,26912,27830
California,San Mateo County,1,10,56424,27732,28692
California,San Mateo County,1,11,54245,26604,27641
California,San Mateo County,1,12,47865,23192,24673
California,San Mateo County,1,13,41322,19651,21671
California,San Mateo County,1,14,28485,13045,15440
California,San Mateo County,1,15,21500,9647,11853
California,San Mateo County,1,16,16888,7340,9548
California,San Mateo County,1,17,14085,5643,8442
California,San Mateo County,1,18,15304,5238,10066
California,San Mateo County,2,0,718518,353204,365314
California,San Mateo County,2,1,46365,23657,22708
California,San Mateo County,2,2,44729,22820,21909
California,San Mateo County,2,3,42461,21749,20712
California,San Mateo County,2,4,41253,21347,19906
California,San Mateo County,2,5,40102,21331,18771
California,San Mateo County,2,6,48330,24737,23593
California,San Mateo County,2,7,51019,25739,25280
California,San Mateo County,2,8,53363,26803,26560
California,San Mateo County,2,9,54746,26915,27831
California,San Mateo County,2,10,56423,27732,28691
California,San Mateo County,2,11,54250,26606,27644
California,San Mateo County,2,12,47871,23196,24675
California,San Mateo County,2,13,41325,19651,21674
California,San Mateo County,2,14,28490,13046,15444
California,San Mateo County,2,15,21506,9649,11857
California,San Mateo County,2,16,16894,7343,9551
California,San Mateo County,2,17,14086,5644,8442
California,San Mateo County,2,18,15305,5239,10066
California,San Mateo County,3,0,719725,353710,366015
California,San Mateo County,3,1,46287,23625,22662
California,San Mateo County,3,2,44842,22874,21968
California,San Mateo County,3,3,42555,21788,20767
California,San Mateo County,3,4,41285,21345,19940
California,San Mateo County,3,5,40037,21298,18739
California,San Mateo County,3,6,48332,24728,23604
California,San Mateo County,3,7,51077,25740,25337
California,San Mateo County,3,8,53133,26656,26477
California,San Mateo County,3,9,54805,26967,27838
California,San Mateo County,3,10,56249,27647,28602
California,San Mateo County,3,11,54452,26724,27728
California,San Mateo County,3,12,48102,23284,24818
California,San Mateo County,3,13,41743,19861,21882
California,San Mateo County,3,14,28744,13149,15595
California,San Mateo County,3,15,21693,9757,11936
California,San Mateo County,3,16,16837,7309,9528
California,San Mateo County,3,17,14130,5676,8454
California,San Mateo County,3,18,15422,5282,10140
California,San Mateo County,4,0,728404,357808,370596
California,San Mateo County,4,1,46312,23595,22717
California,San Mateo County,4,2,45618,23289,22329
California,San Mateo County,4,3,42913,22017,20896
California,San Mateo County,4,4,41185,21145,20040
California,San Mateo County,4,5,40209,21299,18910
California,San Mateo County,4,6,48747,25003,23744
California,San Mateo County,4,7,52070,26146,25924
California,San Mateo County,4,8,52517,26252,26265
California,San Mateo County,4,9,55587,27492,28095
California,San Mateo County,4,10,55729,27471,28258
California,San Mateo County,4,11,54957,27010,27947
California,San Mateo County,4,12,49302,23793,25509
California,San Mateo County,4,13,43634,20773,22861
California,San Mateo County,4,14,29993,13720,16273
California,San Mateo County,4,15,22466,10130,12336
California,San Mateo County,4,16,16972,7396,9576
California,San Mateo County,4,17,14265,5827,8438
California,San Mateo County,4,18,15928,5450,10478
California,San Mateo County,5,0,739427,363277,376150
California,San Mateo County,5,1,46357,23556,22801
California,San Mateo County,5,2,46455,23645,22810
California,San Mateo County,5,3,43477,22300,21177
California,San Mateo County,5,4,41006,20960,20046
California,San Mateo County,5,5,40866,21373,19493
California,San Mateo County,5,6,49497,25550,23947
California,San Mateo County,5,7,53670,27077,26593
California,San Mateo County,5,8,52811,26364,26447
California,San Mateo County,5,9,56278,27845,28433
California,San Mateo County,5,10,55311,27392,27919
California,San Mateo County,5,11,55439,27144,28295
California,San Mateo County,5,12,50815,24619,26196
California,San Mateo County,5,13,43621,20818,22803
California,San Mateo County,5,14,32755,15073,17682
California,San Mateo County,5,15,23204,10424,12780
California,San Mateo County,5,16,17348,7629,9719
California,San Mateo County,5,17,14153,5897,8256
California,San Mateo County,5,18,16364,5611,10753
California,San Mateo County,6,0,749013,368379,380634
California,San Mateo County,6,1,46191,23421,22770
California,San Mateo County,6,2,46675,23883,22792
California,San Mateo County,6,3,44070,22508,21562
California,San Mateo County,6,4,40820,20884,19936
California,San Mateo County,6,5,41871,21794,20077
California,San Mateo County,6,6,49896,25954,23942
California,San Mateo County,6,7,55585,28052,27533
California,San Mateo County,6,8,53546,26898,26648
California,San Mateo County,6,9,56313,27980,28333
California,San Mateo County,6,10,54673,27080,27593
California,San Mateo County,6,11,55860,27304,28556
California,San Mateo County,6,12,51649,25085,26564
California,San Mateo County,6,13,44404,21208,23196
California,San Mateo County,6,14,34495,15928,18567
California,San Mateo County,6,15,24248,10772,13476
California,San Mateo County,6,16,17856,7878,9978
California,San Mateo County,6,17,14153,5972,8181
California,San Mateo County,6,18,16708,5778,10930
California,San Mateo County,7,0,757670,372791,384879
California,San Mateo County,7,1,46040,23457,22583
California,San Mateo County,7,2,46455,23711,22744
California,San Mateo County,7,3,44696,22821,21875
California,San Mateo County,7,4,40572,20789,19783
California,San Mateo County,7,5,42778,22134,20644
California,San Mateo County,7,6,50947,26666,24281
California,San Mateo County,7,7,56746,28736,28010
California,San Mateo County,7,8,54598,27238,27360
California,San Mateo County,7,9,55696,27899,27797
California,San Mateo County,7,10,54321,26791,27530
California,San Mateo County,7,11,56047,27339,28708
California,San Mateo County,7,12,52474,25518,26956
California,San Mateo County,7,13,44915,21553,23362
California,San Mateo County,7,14,36295,16794,19501
California,San Mateo County,7,15,25267,11246,14021
California,San Mateo County,7,16,18488,8091,10397
California,San Mateo County,7,17,14224,5994,8230
California,San Mateo County,7,18,17111,6014,11097
California,San Mateo County,8,0,765447,376987,388460
California,San Mateo County,8,1,45809,23381,22428
California,San Mateo County,8,2,46277,23640,22637
California,San Mateo County,8,3,44924,22783,22141
California,San Mateo County,8,4,40771,21004,19767
California,San Mateo County,8,5,42750,21964,20786
California,San Mateo County,8,6,52255,27506,24749
California,San Mateo County,8,7,57744,29267,28477
California,San Mateo County,8,8,56004,28027,27977
California,San Mateo County,8,9,54635,27493,27142
California,San Mateo County,8,10,54700,26909,27791
California,San Mateo County,8,11,55881,27302,28579
California,San Mateo County,8,12,52996,25911,27085
California,San Mateo County,8,13,45734,21930,23804
California,San Mateo County,8,14,38031,17746,20285
California,San Mateo County,8,15,26124,11630,14494
California,San Mateo County,8,16,19236,8330,10906
California,San Mateo County,8,17,14064,5899,8165
California,San Mateo County,8,18,17512,6265,11247
California,San Mateo County,9,0,768204,378962,389242
California,San Mateo County,9,1,44704,22985,21719
California,San Mateo County,9,2,45585,23286,22299
California,San Mateo County,9,3,45055,22807,22248
California,San Mateo County,9,4,40894,21100,19794
California,San Mateo County,9,5,42400,21680,20720
California,San Mateo County,9,6,54391,28819,25572
California,San Mateo County,9,7,58269,29704,28565
California,San Mateo County,9,8,56428,28201,28227
California,San Mateo County,9,9,53365,26846,26519
California,San Mateo County,9,10,55011,27241,27770
California,San Mateo County,9,11,54639,26726,27913
California,San Mateo County,9,12,53045,25982,27063
California,San Mateo County,9,13,46335,22182,24153
California,San Mateo County,9,14,39290,18351,20939
California,San Mateo County,9,15,27007,12027,14980
California,San Mateo County,9,16,19788,8592,11196
California,San Mateo County,9,17,14128,5955,8173
California,San Mateo County,9,18,17870,6478,11392
California,San Mateo County,10,0,768808,379464,389344
California,San Mateo County,10,1,43981,22634,21347
California,San Mateo County,10,2,44650,22908,21742
California,San Mateo County,10,3,44874,22781,22093
California,San Mateo County,10,4,40883,21045,19838
California,San Mateo County,10,5,41658,21209,20449
California,San Mateo County,10,6,55648,29347,26301
California,San Mateo County,10,7,58992,30211,28781
California,San Mateo County,10,8,56593,28355,28238
California,San Mateo County,10,9,52878,26647,26231
California,San Mateo County,10,10,54658,27115,27543
California,San Mateo County,10,11,53345,26164,27181
California,San Mateo County,10,12,52749,25772,26977
California,San Mateo County,10,13,46894,22466,24428
California,San Mateo County,10,14,39179,18292,20887
California,San Mateo County,10,15,29057,13050,16007
California,San Mateo County,10,16,20434,8836,11598
California,San Mateo County,10,17,14340,6119,8221
California,San Mateo County,10,18,17995,6513,11482
California,San Mateo County,11,0,769545,380308,389237
California,San Mateo County,11,1,43545,22435,21110
California,San Mateo County,11,2,43638,22315,21323
California,San Mateo County,11,3,44727,22752,21975
California,San Mateo County,11,4,41205,21174,20031
California,San Mateo County,11,5,41216,21168,20048
California,San Mateo County,11,6,56080,29534,26546
California,San Mateo County,11,7,59278,30693,28585
California,San Mateo County,11,8,57307,28773,28534
California,San Mateo County,11,9,52742,26595,26147
California,San Mateo County,11,10,54138,26907,27231
California,San Mateo County,11,11,52048,25484,26564
California,San Mateo County,11,12,52514,25602,26912
California,San Mateo County,11,13,47186,22678,24508
California,San Mateo County,11,14,39394,18443,20951
California,San Mateo County,11,15,30376,13682,16694
California,San Mateo County,11,16,21233,9159,12074
California,San Mateo County,11,17,14753,6307,8446
California,San Mateo County,11,18,18165,6607,11558
California,Santa Barbara County,1,0,423895,212786,211109
California,Santa Barbara County,1,1,27350,13873,13477
California,Santa Barbara County,1,2,26303,13397,12906
California,Santa Barbara County,1,3,26626,13717,12909
California,Santa Barbara County,1,4,38009,19284,18725
California,Santa Barbara County,1,5,43026,22782,20244
California,Santa Barbara County,1,6,31100,16572,14528
California,Santa Barbara County,1,7,26592,14006,12586
California,Santa Barbara County,1,8,25092,13105,11987
California,Santa Barbara County,1,9,25386,12935,12451
California,Santa Barbara County,1,10,27577,13807,13770
California,Santa Barbara County,1,11,27421,13618,13803
California,Santa Barbara County,1,12,24418,11960,12458
California,Santa Barbara County,1,13,20597,10055,10542
California,Santa Barbara County,1,14,15014,7040,7974
California,Santa Barbara County,1,15,11762,5400,6362
California,Santa Barbara County,1,16,10052,4518,5534
California,Santa Barbara County,1,17,8480,3478,5002
California,Santa Barbara County,1,18,9090,3239,5851
California,Santa Barbara County,2,0,423947,212812,211135
California,Santa Barbara County,2,1,27353,13875,13478
California,Santa Barbara County,2,2,26309,13400,12909
California,Santa Barbara County,2,3,26629,13718,12911
California,Santa Barbara County,2,4,38015,19286,18729
California,Santa Barbara County,2,5,43031,22787,20244
California,Santa Barbara County,2,6,31102,16573,14529
California,Santa Barbara County,2,7,26593,14006,12587
California,Santa Barbara County,2,8,25096,13107,11989
California,Santa Barbara County,2,9,25387,12935,12452
California,Santa Barbara County,2,10,27585,13811,13774
California,Santa Barbara County,2,11,27422,13618,13804
California,Santa Barbara County,2,12,24420,11960,12460
California,Santa Barbara County,2,13,20597,10055,10542
California,Santa Barbara County,2,14,15020,7043,7977
California,Santa Barbara County,2,15,11763,5401,6362
California,Santa Barbara County,2,16,10053,4518,5535
California,Santa Barbara County,2,17,8482,3480,5002
California,Santa Barbara County,2,18,9090,3239,5851
California,Santa Barbara County,3,0,424235,212791,211444
California,Santa Barbara County,3,1,27531,13978,13553
California,Santa Barbara County,3,2,26330,13383,12947
California,Santa Barbara County,3,3,26548,13660,12888
California,Santa Barbara County,3,4,37855,19169,18686
California,Santa Barbara County,3,5,43544,22987,20557
California,Santa Barbara County,3,6,30885,16483,14402
California,Santa Barbara County,3,7,26649,14044,12605
California,Santa Barbara County,3,8,24953,12999,11954
California,Santa Barbara County,3,9,25286,12887,12399
California,Santa Barbara County,3,10,27358,13674,13684
California,Santa Barbara County,3,11,27409,13596,13813
California,Santa Barbara County,3,12,24558,12033,12525
California,Santa Barbara County,3,13,20752,10124,10628
California,Santa Barbara County,3,14,15132,7110,8022
California,Santa Barbara County,3,15,11801,5424,6377
California,Santa Barbara County,3,16,10021,4491,5530
California,Santa Barbara County,3,17,8473,3492,4981
California,Santa Barbara County,3,18,9150,3257,5893
California,Santa Barbara County,4,0,425481,213069,212412
California,Santa Barbara County,4,1,27831,14175,13656
California,Santa Barbara County,4,2,26505,13361,13144
California,Santa Barbara County,4,3,26195,13444,12751
California,Santa Barbara County,4,4,37107,18731,18376
California,Santa Barbara County,4,5,45670,23886,21784
California,Santa Barbara County,4,6,29776,15971,13805
California,Santa Barbara County,4,7,26948,14224,12724
California,Santa Barbara County,4,8,24292,12592,11700
California,Santa Barbara County,4,9,25129,12847,12282
California,Santa Barbara County,4,10,26487,13220,13267
California,Santa Barbara County,4,11,27401,13552,13849
California,Santa Barbara County,4,12,25020,12273,12747
California,Santa Barbara County,4,13,21663,10541,11122
California,Santa Barbara County,4,14,15569,7385,8184
California,Santa Barbara County,4,15,12073,5571,6502
California,Santa Barbara County,4,16,9964,4404,5560
California,Santa Barbara County,4,17,8450,3545,4905
California,Santa Barbara County,4,18,9401,3347,6054
California,Santa Barbara County,5,0,429825,215520,214305
California,Santa Barbara County,5,1,27970,14225,13745
California,Santa Barbara County,5,2,27108,13674,13434
California,Santa Barbara County,5,3,25899,13265,12634
California,Santa Barbara County,5,4,36588,18456,18132
California,Santa Barbara County,5,5,48071,25089,22982
California,Santa Barbara County,5,6,28904,15586,13318
California,Santa Barbara County,5,7,27895,14751,13144
California,Santa Barbara County,5,8,24338,12639,11699
California,Santa Barbara County,5,9,25101,12930,12171
California,Santa Barbara County,5,10,25745,12921,12824
California,Santa Barbara County,5,11,27437,13586,13851
California,Santa Barbara County,5,12,25561,12565,12996
California,Santa Barbara County,5,13,21763,10472,11291
California,Santa Barbara County,5,14,16969,8159,8810
California,Santa Barbara County,5,15,12400,5698,6702
California,Santa Barbara County,5,16,9940,4402,5538
California,Santa Barbara County,5,17,8478,3603,4875
California,Santa Barbara County,5,18,9658,3499,6159
California,Santa Barbara County,6,0,434823,218000,216823
California,Santa Barbara County,6,1,28203,14395,13808
California,Santa Barbara County,6,2,27699,13941,13758
California,Santa Barbara County,6,3,25942,13276,12666
California,Santa Barbara County,6,4,36405,18286,18119
California,Santa Barbara County,6,5,50148,26138,24010
California,Santa Barbara County,6,6,28697,15391,13306
California,Santa Barbara County,6,7,28511,15122,13389
California,Santa Barbara County,6,8,24694,12857,11837
California,Santa Barbara County,6,9,24893,12801,12092
California,Santa Barbara County,6,10,24994,12617,12377
California,Santa Barbara County,6,11,27246,13439,13807
California,Santa Barbara County,6,12,25792,12730,13062
California,Santa Barbara County,6,13,22400,10761,11639
California,Santa Barbara County,6,14,17821,8572,9249
California,Santa Barbara County,6,15,12981,5966,7015
California,Santa Barbara County,6,16,10149,4491,5658
California,Santa Barbara County,6,17,8419,3630,4789
California,Santa Barbara County,6,18,9829,3587,6242
California,Santa Barbara County,7,0,439358,220244,219114
California,Santa Barbara County,7,1,28605,14675,13930
California,Santa Barbara County,7,2,27856,14062,13794
California,Santa Barbara County,7,3,26043,13209,12834
California,Santa Barbara County,7,4,36328,18163,18165
California,Santa Barbara County,7,5,51000,26508,24492
California,Santa Barbara County,7,6,29004,15650,13354
California,Santa Barbara County,7,7,28955,15337,13618
California,Santa Barbara County,7,8,25096,13122,11974
California,Santa Barbara County,7,9,24646,12653,11993
California,Santa Barbara County,7,10,24595,12450,12145
California,Santa Barbara County,7,11,27159,13381,13778
California,Santa Barbara County,7,12,26145,12889,13256
California,Santa Barbara County,7,13,22843,11019,11824
California,Santa Barbara County,7,14,18739,9005,9734
California,Santa Barbara County,7,15,13552,6192,7360
California,Santa Barbara County,7,16,10381,4640,5741
California,Santa Barbara County,7,17,8393,3631,4762
California,Santa Barbara County,7,18,10018,3658,6360
California,Santa Barbara County,8,0,442522,221798,220724
California,Santa Barbara County,8,1,28939,14881,14058
California,Santa Barbara County,8,2,27869,14047,13822
California,Santa Barbara County,8,3,26311,13303,13008
California,Santa Barbara County,8,4,36232,18050,18182
California,Santa Barbara County,8,5,51376,26569,24807
California,Santa Barbara County,8,6,29736,16074,13662
California,Santa Barbara County,8,7,28561,15149,13412
California,Santa Barbara County,8,8,25589,13332,12257
California,Santa Barbara County,8,9,24288,12524,11764
California,Santa Barbara County,8,10,24537,12434,12103
California,Santa Barbara County,8,11,26347,13062,13285
California,Santa Barbara County,8,12,26374,12973,13401
California,Santa Barbara County,8,13,23374,11272,12102
California,Santa Barbara County,8,14,19678,9513,10165
California,Santa Barbara County,8,15,14092,6461,7631
California,Santa Barbara County,8,16,10642,4768,5874
California,Santa Barbara County,8,17,8311,3619,4692
California,Santa Barbara County,8,18,10266,3767,6499
California,Santa Barbara County,9,0,444675,222696,221979
California,Santa Barbara County,9,1,28629,14787,13842
California,Santa Barbara County,9,2,28120,14180,13940
California,Santa Barbara County,9,3,26573,13430,13143
California,Santa Barbara County,9,4,36255,17977,18278
California,Santa Barbara County,9,5,50922,26309,24613
California,Santa Barbara County,9,6,31115,16666,14449
California,Santa Barbara County,9,7,28192,14999,13193
California,Santa Barbara County,9,8,26009,13569,12440
California,Santa Barbara County,9,9,23742,12173,11569
California,Santa Barbara County,9,10,24636,12505,12131
California,Santa Barbara County,9,11,25587,12714,12873
California,Santa Barbara County,9,12,26435,12968,13467
California,Santa Barbara County,9,13,23817,11492,12325
California,Santa Barbara County,9,14,20547,9848,10699
California,Santa Barbara County,9,15,14563,6798,7765
California,Santa Barbara County,9,16,10828,4841,5987
California,Santa Barbara County,9,17,8339,3587,4752
California,Santa Barbara County,9,18,10366,3853,6513
California,Santa Barbara County,10,0,445606,223077,222529
California,Santa Barbara County,10,1,28074,14461,13613
California,Santa Barbara County,10,2,28074,14244,13830
California,Santa Barbara County,10,3,26995,13644,13351
California,Santa Barbara County,10,4,36188,17827,18361
California,Santa Barbara County,10,5,50390,25921,24469
California,Santa Barbara County,10,6,32378,17353,15025
California,Santa Barbara County,10,7,27208,14543,12665
California,Santa Barbara County,10,8,26512,13886,12626
California,Santa Barbara County,10,9,23589,12063,11526
California,Santa Barbara County,10,10,24433,12451,11982
California,Santa Barbara County,10,11,24693,12287,12406
California,Santa Barbara County,10,12,26330,12839,13491
California,Santa Barbara County,10,13,24265,11777,12488
California,Santa Barbara County,10,14,20614,9789,10825
California,Santa Barbara County,10,15,15925,7483,8442
California,Santa Barbara County,10,16,11136,4999,6137
California,Santa Barbara County,10,17,8329,3545,4784
California,Santa Barbara County,10,18,10473,3965,6508
California,Santa Barbara County,11,0,446527,223377,223150
California,Santa Barbara County,11,1,27676,14224,13452
California,Santa Barbara County,11,2,27964,14257,13707
California,Santa Barbara County,11,3,27372,13780,13592
California,Santa Barbara County,11,4,36429,17966,18463
California,Santa Barbara County,11,5,49772,25528,24244
California,Santa Barbara County,11,6,32738,17548,15190
California,Santa Barbara County,11,7,26859,14230,12629
California,Santa Barbara County,11,8,26877,14105,12772
California,Santa Barbara County,11,9,23768,12202,11566
California,Santa Barbara County,11,10,23979,12184,11795
California,Santa Barbara County,11,11,24006,12012,11994
California,Santa Barbara County,11,12,26168,12735,13433
California,Santa Barbara County,11,13,24454,11929,12525
California,Santa Barbara County,11,14,21083,9957,11126
California,Santa Barbara County,11,15,16637,7834,8803
California,Santa Barbara County,11,16,11726,5250,6476
California,Santa Barbara County,11,17,8429,3575,4854
California,Santa Barbara County,11,18,10590,4061,6529
California,Santa Clara County,1,0,1781642,893851,887791
California,Santa Clara County,1,1,124464,63660,60804
California,Santa Clara County,1,2,121928,62320,59608
California,Santa Clara County,1,3,113570,58180,55390
California,Santa Clara County,1,4,114544,59564,54980
California,Santa Clara County,1,5,113117,60070,53047
California,Santa Clara County,1,6,133544,68924,64620
California,Santa Clara County,1,7,136022,69295,66727
California,Santa Clara County,1,8,140750,71298,69452
California,Santa Clara County,1,9,137619,69926,67693
California,Santa Clara County,1,10,138118,70721,67397
California,Santa Clara County,1,11,125476,63598,61878
California,Santa Clara County,1,12,102413,50394,52019
California,Santa Clara County,1,13,83133,39897,43236
California,Santa Clara County,1,14,60577,28245,32332
California,Santa Clara County,1,15,45944,20889,25055
California,Santa Clara County,1,16,35666,15797,19869
California,Santa Clara County,1,17,27282,11270,16012
California,Santa Clara County,1,18,27475,9803,17672
California,Santa Clara County,2,0,1781672,893862,887810
California,Santa Clara County,2,1,124467,63661,60806
California,Santa Clara County,2,2,121931,62323,59608
California,Santa Clara County,2,3,113571,58180,55391
California,Santa Clara County,2,4,114545,59564,54981
California,Santa Clara County,2,5,113120,60070,53050
California,Santa Clara County,2,6,133545,68923,64622
California,Santa Clara County,2,7,136025,69295,66730
California,Santa Clara County,2,8,140750,71299,69451
California,Santa Clara County,2,9,137619,69926,67693
California,Santa Clara County,2,10,138121,70723,67398
California,Santa Clara County,2,11,125486,63603,61883
California,Santa Clara County,2,12,102414,50394,52020
California,Santa Clara County,2,13,83135,39897,43238
California,Santa Clara County,2,14,60576,28245,32331
California,Santa Clara County,2,15,45944,20889,25055
California,Santa Clara County,2,16,35666,15797,19869
California,Santa Clara County,2,17,27282,11270,16012
California,Santa Clara County,2,18,27475,9803,17672
California,Santa Clara County,3,0,1786079,895880,890199
California,Santa Clara County,3,1,124319,63593,60726
California,Santa Clara County,3,2,122186,62423,59763
California,Santa Clara County,3,3,114040,58390,55650
California,Santa Clara County,3,4,114334,59367,54967
California,Santa Clara County,3,5,113093,59945,53148
California,Santa Clara County,3,6,133592,69083,64509
California,Santa Clara County,3,7,136028,69216,66812
California,Santa Clara County,3,8,140531,71211,69320
California,Santa Clara County,3,9,137977,70051,67926
California,Santa Clara County,3,10,137976,70653,67323
California,Santa Clara County,3,11,126231,63992,62239
California,Santa Clara County,3,12,103325,50898,52427
California,Santa Clara County,3,13,83992,40256,43736
California,Santa Clara County,3,14,61169,28598,32571
California,Santa Clara County,3,15,46283,21021,25262
California,Santa Clara County,3,16,35729,15838,19891
California,Santa Clara County,3,17,27433,11383,16050
California,Santa Clara County,3,18,27841,9962,17879
California,Santa Clara County,4,0,1812166,909284,902882
California,Santa Clara County,4,1,124117,63665,60452
California,Santa Clara County,4,2,123726,63136,60590
California,Santa Clara County,4,3,116018,59380,56638
California,Santa Clara County,4,4,113716,58739,54977
California,Santa Clara County,4,5,114727,60640,54087
California,Santa Clara County,4,6,135098,70400,64698
California,Santa Clara County,4,7,137989,70181,67808
California,Santa Clara County,4,8,139772,71091,68681
California,Santa Clara County,4,9,140078,70854,69224
California,Santa Clara County,4,10,137249,70295,66954
California,Santa Clara County,4,11,129216,65592,63624
California,Santa Clara County,4,12,107376,53158,54218
California,Santa Clara County,4,13,87906,42054,45852
California,Santa Clara County,4,14,63657,29897,33760
California,Santa Clara County,4,15,47863,21645,26218
California,Santa Clara County,4,16,36457,16234,20223
California,Santa Clara County,4,17,27930,11771,16159
California,Santa Clara County,4,18,29271,10552,18719
California,Santa Clara County,5,0,1838370,923363,915007
California,Santa Clara County,5,1,122555,62698,59857
California,Santa Clara County,5,2,125713,64284,61429
California,Santa Clara County,5,3,117144,59977,57167
California,Santa Clara County,5,4,113563,58444,55119
California,Santa Clara County,5,5,116913,61808,55105
California,Santa Clara County,5,6,136690,71867,64823
California,Santa Clara County,5,7,140816,71785,69031
California,Santa Clara County,5,8,139688,71414,68274
California,Santa Clara County,5,9,142313,71915,70398
California,Santa Clara County,5,10,136150,69528,66622
California,Santa Clara County,5,11,131465,66891,64574
California,Santa Clara County,5,12,111721,55502,56219
California,Santa Clara County,5,13,88738,42575,46163
California,Santa Clara County,5,14,68434,32142,36292
California,Santa Clara County,5,15,49903,22629,27274
California,Santa Clara County,5,16,37567,16739,20828
California,Santa Clara County,5,17,28469,12086,16383
California,Santa Clara County,5,18,30528,11079,19449
California,Santa Clara County,6,0,1867302,938553,928749
California,Santa Clara County,6,1,121853,62439,59414
California,Santa Clara County,6,2,127068,64984,62084
California,Santa Clara County,6,3,119299,61067,58232
California,Santa Clara County,6,4,113260,58104,55156
California,Santa Clara County,6,5,119599,63275,56324
California,Santa Clara County,6,6,138653,73209,65444
California,Santa Clara County,6,7,144819,74500,70319
California,Santa Clara County,6,8,139945,71390,68555
California,Santa Clara County,6,9,143216,72425,70791
California,Santa Clara County,6,10,135702,69068,66634
California,Santa Clara County,6,11,133649,67890,65759
California,Santa Clara County,6,12,115539,57760,57779
California,Santa Clara County,6,13,91246,43817,47429
California,Santa Clara County,6,14,71386,33513,37873
California,Santa Clara County,6,15,52339,23827,28512
California,Santa Clara County,6,16,38936,17321,21615
California,Santa Clara County,6,17,29109,12454,16655
California,Santa Clara County,6,18,31684,11510,20174
California,Santa Clara County,7,0,1892984,953039,939945
California,Santa Clara County,7,1,121006,62064,58942
California,Santa Clara County,7,2,126435,64766,61669
California,Santa Clara County,7,3,121195,61983,59212
California,Santa Clara County,7,4,113098,58068,55030
California,Santa Clara County,7,5,122239,64767,57472
California,Santa Clara County,7,6,142165,75406,66759
California,Santa Clara County,7,7,148961,77184,71777
California,Santa Clara County,7,8,140398,71891,68507
California,Santa Clara County,7,9,142371,71967,70404
California,Santa Clara County,7,10,135678,68788,66890
California,Santa Clara County,7,11,135237,68853,66384
California,Santa Clara County,7,12,118336,59498,58838
California,Santa Clara County,7,13,94158,45298,48860
California,Santa Clara County,7,14,74441,34905,39536
California,Santa Clara County,7,15,54374,24771,29603
California,Santa Clara County,7,16,40615,18108,22507
California,Santa Clara County,7,17,29581,12749,16832
California,Santa Clara County,7,18,32696,11973,20723
California,Santa Clara County,8,0,1917481,966931,950550
California,Santa Clara County,8,1,120809,61961,58848
California,Santa Clara County,8,2,125161,64123,61038
California,Santa Clara County,8,3,122117,62480,59637
California,Santa Clara County,8,4,113453,58230,55223
California,Santa Clara County,8,5,123222,65153,58069
California,Santa Clara County,8,6,147432,78755,68677
California,Santa Clara County,8,7,152705,79574,73131
California,Santa Clara County,8,8,141684,72886,68798
California,Santa Clara County,8,9,140697,71072,69625
California,Santa Clara County,8,10,136967,69331,67636
California,Santa Clara County,8,11,134791,68855,65936
California,Santa Clara County,8,12,121357,61102,60255
California,Santa Clara County,8,13,97057,46944,50113
California,Santa Clara County,8,14,77706,36450,41256
California,Santa Clara County,8,15,56501,25808,30693
California,Santa Clara County,8,16,41912,18704,23208
California,Santa Clara County,8,17,30057,12890,17167
California,Santa Clara County,8,18,33853,12613,21240
California,Santa Clara County,9,0,1929581,974089,955492
California,Santa Clara County,9,1,119115,60979,58136
California,Santa Clara County,9,2,122840,62938,59902
California,Santa Clara County,9,3,122338,62569,59769
California,Santa Clara County,9,4,114123,58610,55513
California,Santa Clara County,9,5,122097,64378,57719
California,Santa Clara County,9,6,152110,81687,70423
California,Santa Clara County,9,7,155201,81678,73523
California,Santa Clara County,9,8,142467,73299,69168
California,Santa Clara County,9,9,138432,70168,68264
California,Santa Clara County,9,10,137646,69417,68229
California,Santa Clara County,9,11,133189,68056,65133
California,Santa Clara County,9,12,123018,62077,60941
California,Santa Clara County,9,13,99623,48405,51218
California,Santa Clara County,9,14,80519,37731,42788
California,Santa Clara County,9,15,58203,26690,31513
California,Santa Clara County,9,16,43011,19051,23960
California,Santa Clara County,9,17,30706,13247,17459
California,Santa Clara County,9,18,34943,13109,21834
California,Santa Clara County,10,0,1933383,977614,955769
California,Santa Clara County,10,1,117433,60234,57199
California,Santa Clara County,10,2,119444,61123,58321
California,Santa Clara County,10,3,122511,62802,59709
California,Santa Clara County,10,4,114184,58666,55518
California,Santa Clara County,10,5,120686,63719,56967
California,Santa Clara County,10,6,155564,83925,71639
California,Santa Clara County,10,7,155373,82515,72858
California,Santa Clara County,10,8,143327,74033,69294
California,Santa Clara County,10,9,136099,69005,67094
California,Santa Clara County,10,10,137887,69531,68356
California,Santa Clara County,10,11,130734,66559,64175
California,Santa Clara County,10,12,123504,62492,61012
California,Santa Clara County,10,13,102356,49988,52368
California,Santa Clara County,10,14,80620,37911,42709
California,Santa Clara County,10,15,61843,28294,33549
California,Santa Clara County,10,16,44457,19728,24729
California,Santa Clara County,10,17,31482,13564,17918
California,Santa Clara County,10,18,35879,13525,22354
California,Santa Clara County,11,0,1937570,980868,956702
California,Santa Clara County,11,1,115074,58864,56210
California,Santa Clara County,11,2,116531,59573,56958
California,Santa Clara County,11,3,122117,62772,59345
California,Santa Clara County,11,4,115018,59005,56013
California,Santa Clara County,11,5,119735,63125,56610
California,Santa Clara County,11,6,158337,85728,72609
California,Santa Clara County,11,7,156679,83676,73003
California,Santa Clara County,11,8,145506,75710,69796
California,Santa Clara County,11,9,133920,68043,65877
California,Santa Clara County,11,10,136243,68590,67653
California,Santa Clara County,11,11,128707,65406,63301
California,Santa Clara County,11,12,124070,62679,61391
California,Santa Clara County,11,13,104502,51434,53068
California,Santa Clara County,11,14,82155,38757,43398
California,Santa Clara County,11,15,63652,29067,34585
California,Santa Clara County,11,16,46268,20624,25644
California,Santa Clara County,11,17,32401,13921,18480
California,Santa Clara County,11,18,36655,13894,22761
California,Santa Cruz County,1,0,262382,130913,131469
California,Santa Cruz County,1,1,15045,7744,7301
California,Santa Cruz County,1,2,15071,7700,7371
California,Santa Cruz County,1,3,15347,7916,7431
California,Santa Cruz County,1,4,21834,10966,10868
California,Santa Cruz County,1,5,24391,12735,11656
California,Santa Cruz County,1,6,17597,9155,8442
California,Santa Cruz County,1,7,16152,8228,7924
California,Santa Cruz County,1,8,15918,8161,7757
California,Santa Cruz County,1,9,17157,8598,8559
California,Santa Cruz County,1,10,18712,9244,9468
California,Santa Cruz County,1,11,20065,9840,10225
California,Santa Cruz County,1,12,19781,9800,9981
California,Santa Cruz County,1,13,16154,8155,7999
California,Santa Cruz County,1,14,9699,4713,4986
California,Santa Cruz County,1,15,6175,2882,3293
California,Santa Cruz County,1,16,4591,1933,2658
California,Santa Cruz County,1,17,4077,1586,2491
California,Santa Cruz County,1,18,4616,1557,3059
California,Santa Cruz County,2,0,262356,130903,131453
California,Santa Cruz County,2,1,15041,7743,7298
California,Santa Cruz County,2,2,15067,7698,7369
California,Santa Cruz County,2,3,15345,7915,7430
California,Santa Cruz County,2,4,21833,10966,10867
California,Santa Cruz County,2,5,24389,12734,11655
California,Santa Cruz County,2,6,17596,9155,8441
California,Santa Cruz County,2,7,16151,8229,7922
California,Santa Cruz County,2,8,15918,8161,7757
California,Santa Cruz County,2,9,17156,8597,8559
California,Santa Cruz County,2,10,18710,9242,9468
California,Santa Cruz County,2,11,20059,9837,10222
California,Santa Cruz County,2,12,19780,9800,9980
California,Santa Cruz County,2,13,16152,8155,7997
California,Santa Cruz County,2,14,9700,4713,4987
California,Santa Cruz County,2,15,6175,2882,3293
California,Santa Cruz County,2,16,4591,1933,2658
California,Santa Cruz County,2,17,4077,1586,2491
California,Santa Cruz County,2,18,4616,1557,3059
California,Santa Cruz County,3,0,263167,131215,131952
California,Santa Cruz County,3,1,15141,7794,7347
California,Santa Cruz County,3,2,15046,7691,7355
California,Santa Cruz County,3,3,15305,7887,7418
California,Santa Cruz County,3,4,22235,11113,11122
California,Santa Cruz County,3,5,24821,12916,11905
California,Santa Cruz County,3,6,17369,9049,8320
California,Santa Cruz County,3,7,16194,8241,7953
California,Santa Cruz County,3,8,15828,8119,7709
California,Santa Cruz County,3,9,17119,8580,8539
California,Santa Cruz County,3,10,18547,9180,9367
California,Santa Cruz County,3,11,19958,9782,10176
California,Santa Cruz County,3,12,19814,9792,10022
California,Santa Cruz County,3,13,16385,8287,8098
California,Santa Cruz County,3,14,9874,4789,5085
California,Santa Cruz County,3,15,6215,2896,3319
California,Santa Cruz County,3,16,4625,1954,2671
California,Santa Cruz County,3,17,4050,1577,2473
California,Santa Cruz County,3,18,4641,1568,3073
California,Santa Cruz County,4,0,264882,131867,133015
California,Santa Cruz County,4,1,15255,7815,7440
California,Santa Cruz County,4,2,15081,7669,7412
California,Santa Cruz County,4,3,15197,7864,7333
California,Santa Cruz County,4,4,22428,11121,11307
California,Santa Cruz County,4,5,26048,13531,12517
California,Santa Cruz County,4,6,16622,8729,7893
California,Santa Cruz County,4,7,16303,8184,8119
California,Santa Cruz County,4,8,15444,7883,7561
California,Santa Cruz County,4,9,17087,8598,8489
California,Santa Cruz County,4,10,17896,8867,9029
California,Santa Cruz County,4,11,19649,9632,10017
California,Santa Cruz County,4,12,19868,9750,10118
California,Santa Cruz County,4,13,17434,8814,8620
California,Santa Cruz County,4,14,10591,5123,5468
California,Santa Cruz County,4,15,6526,3058,3468
California,Santa Cruz County,4,16,4776,2069,2707
California,Santa Cruz County,4,17,3981,1552,2429
California,Santa Cruz County,4,18,4696,1608,3088
California,Santa Cruz County,5,0,266416,132499,133917
California,Santa Cruz County,5,1,15225,7734,7491
California,Santa Cruz County,5,2,15206,7739,7467
California,Santa Cruz County,5,3,15004,7795,7209
California,Santa Cruz County,5,4,22299,10950,11349
California,Santa Cruz County,5,5,27134,13986,13148
California,Santa Cruz County,5,6,15875,8356,7519
California,Santa Cruz County,5,7,16322,8261,8061
California,Santa Cruz County,5,8,15504,7839,7665
California,Santa Cruz County,5,9,16867,8562,8305
California,Santa Cruz County,5,10,17476,8636,8840
California,Santa Cruz County,5,11,19209,9500,9709
California,Santa Cruz County,5,12,19903,9654,10249
California,Santa Cruz County,5,13,17642,8888,8754
California,Santa Cruz County,5,14,12036,5899,6137
California,Santa Cruz County,5,15,7087,3337,3750
California,Santa Cruz County,5,16,4853,2147,2706
California,Santa Cruz County,5,17,3945,1568,2377
California,Santa Cruz County,5,18,4829,1648,3181
California,Santa Cruz County,6,0,268940,133646,135294
California,Santa Cruz County,6,1,15111,7714,7397
California,Santa Cruz County,6,2,15367,7855,7512
California,Santa Cruz County,6,3,14865,7630,7235
California,Santa Cruz County,6,4,22365,10997,11368
California,Santa Cruz County,6,5,28136,14402,13734
California,Santa Cruz County,6,6,15689,8228,7461
California,Santa Cruz County,6,7,16424,8355,8069
California,Santa Cruz County,6,8,15714,7941,7773
California,Santa Cruz County,6,9,16589,8388,8201
California,Santa Cruz County,6,10,17174,8507,8667
California,Santa Cruz County,6,11,18856,9343,9513
California,Santa Cruz County,6,12,19712,9534,10178
California,Santa Cruz County,6,13,18212,9151,9061
California,Santa Cruz County,6,14,13047,6404,6643
California,Santa Cruz County,6,15,7832,3692,4140
California,Santa Cruz County,6,16,5002,2280,2722
California,Santa Cruz County,6,17,3924,1561,2363
California,Santa Cruz County,6,18,4921,1664,3257
California,Santa Cruz County,7,0,271035,134576,136459
California,Santa Cruz County,7,1,15018,7668,7350
California,Santa Cruz County,7,2,15136,7718,7418
California,Santa Cruz County,7,3,14997,7707,7290
California,Santa Cruz County,7,4,22198,10887,11311
California,Santa Cruz County,7,5,28368,14487,13881
California,Santa Cruz County,7,6,16160,8520,7640
California,Santa Cruz County,7,7,16456,8349,8107
California,Santa Cruz County,7,8,15863,7953,7910
California,Santa Cruz County,7,9,16250,8275,7975
California,Santa Cruz County,7,10,16956,8416,8540
California,Santa Cruz County,7,11,18699,9236,9463
California,Santa Cruz County,7,12,19510,9470,10040
California,Santa Cruz County,7,13,18616,9200,9416
California,Santa Cruz County,7,14,14154,7020,7134
California,Santa Cruz County,7,15,8485,4027,4458
California,Santa Cruz County,7,16,5286,2418,2868
California,Santa Cruz County,7,17,3876,1549,2327
California,Santa Cruz County,7,18,5007,1676,3331
California,Santa Cruz County,8,0,273730,135879,137851
California,Santa Cruz County,8,1,14982,7717,7265
California,Santa Cruz County,8,2,15046,7695,7351
California,Santa Cruz County,8,3,15045,7634,7411
California,Santa Cruz County,8,4,22410,11044,11366
California,Santa Cruz County,8,5,28583,14350,14233
California,Santa Cruz County,8,6,16688,8875,7813
California,Santa Cruz County,8,7,16254,8203,8051
California,Santa Cruz County,8,8,16107,8119,7988
California,Santa Cruz County,8,9,15827,7988,7839
California,Santa Cruz County,8,10,17146,8605,8541
California,Santa Cruz County,8,11,18413,9081,9332
California,Santa Cruz County,8,12,19348,9436,9912
California,Santa Cruz County,8,13,18904,9298,9606
California,Santa Cruz County,8,14,15232,7594,7638
California,Santa Cruz County,8,15,9154,4326,4828
California,Santa Cruz County,8,16,5614,2593,3021
California,Santa Cruz County,8,17,3880,1569,2311
California,Santa Cruz County,8,18,5097,1752,3345
California,Santa Cruz County,9,0,274702,136272,138430
California,Santa Cruz County,9,1,14623,7538,7085
California,Santa Cruz County,9,2,15044,7690,7354
California,Santa Cruz County,9,3,15065,7584,7481
California,Santa Cruz County,9,4,22390,11044,11346
California,Santa Cruz County,9,5,28357,14189,14168
California,Santa Cruz County,9,6,17313,9169,8144
California,Santa Cruz County,9,7,15960,8140,7820
California,Santa Cruz County,9,8,16325,8176,8149
California,Santa Cruz County,9,9,15562,7816,7746
California,Santa Cruz County,9,10,17267,8728,8539
California,Santa Cruz County,9,11,17756,8773,8983
California,Santa Cruz County,9,12,19049,9300,9749
California,Santa Cruz County,9,13,18907,9251,9656
California,Santa Cruz County,9,14,16320,8143,8177
California,Santa Cruz County,9,15,9829,4637,5192
California,Santa Cruz County,9,16,5844,2665,3179
California,Santa Cruz County,9,17,4035,1697,2338
California,Santa Cruz County,9,18,5056,1732,3324
California,Santa Cruz County,10,0,275105,136333,138772
California,Santa Cruz County,10,1,14296,7364,6932
California,Santa Cruz County,10,2,14855,7525,7330
California,Santa Cruz County,10,3,15182,7688,7494
California,Santa Cruz County,10,4,22512,11142,11370
California,Santa Cruz County,10,5,27971,13873,14098
California,Santa Cruz County,10,6,17731,9443,8288
California,Santa Cruz County,10,7,15586,7976,7610
California,Santa Cruz County,10,8,16416,8235,8181
California,Santa Cruz County,10,9,15683,7807,7876
California,Santa Cruz County,10,10,17025,8627,8398
California,Santa Cruz County,10,11,17267,8563,8704
California,Santa Cruz County,10,12,18637,9110,9527
California,Santa Cruz County,10,13,18822,9101,9721
California,Santa Cruz County,10,14,16462,8185,8277
California,Santa Cruz County,10,15,11172,5333,5839
California,Santa Cruz County,10,16,6343,2897,3446
California,Santa Cruz County,10,17,4090,1740,2350
California,Santa Cruz County,10,18,5055,1724,3331
California,Santa Cruz County,11,0,274255,135725,138530
California,Santa Cruz County,11,1,13937,7169,6768
California,Santa Cruz County,11,2,14702,7463,7239
California,Santa Cruz County,11,3,15128,7717,7411
California,Santa Cruz County,11,4,22426,11019,11407
California,Santa Cruz County,11,5,27512,13650,13862
California,Santa Cruz County,11,6,17879,9412,8467
California,Santa Cruz County,11,7,15417,7913,7504
California,Santa Cruz County,11,8,16273,8162,8111
California,Santa Cruz County,11,9,15690,7812,7878
California,Santa Cruz County,11,10,16602,8389,8213
California,Santa Cruz County,11,11,16934,8429,8505
California,Santa Cruz County,11,12,18152,8852,9300
California,Santa Cruz County,11,13,18476,8934,9542
California,Santa Cruz County,11,14,16821,8300,8521
California,Santa Cruz County,11,15,12056,5775,6281
California,Santa Cruz County,11,16,6945,3165,3780
California,Santa Cruz County,11,17,4196,1831,2365
California,Santa Cruz County,11,18,5109,1733,3376
California,Shasta County,1,0,177223,87130,90093
California,Shasta County,1,1,10268,5307,4961
California,Shasta County,1,2,10537,5375,5162
California,Shasta County,1,3,11394,5967,5427
California,Shasta County,1,4,12439,6403,6036
California,Shasta County,1,5,11003,5667,5336
California,Shasta County,1,6,10526,5303,5223
California,Shasta County,1,7,9431,4788,4643
California,Shasta County,1,8,9198,4528,4670
California,Shasta County,1,9,10369,5106,5263
California,Shasta County,1,10,12895,6175,6720
California,Shasta County,1,11,13690,6627,7063
California,Shasta County,1,12,13367,6434,6933
California,Shasta County,1,13,12139,5929,6210
California,Shasta County,1,14,9576,4619,4957
California,Shasta County,1,15,6975,3332,3643
California,Shasta County,1,16,5333,2433,2900
California,Shasta County,1,17,4113,1719,2394
California,Shasta County,1,18,3970,1418,2552
California,Shasta County,2,0,177221,87129,90092
California,Shasta County,2,1,10268,5307,4961
California,Shasta County,2,2,10537,5375,5162
California,Shasta County,2,3,11394,5967,5427
California,Shasta County,2,4,12439,6403,6036
California,Shasta County,2,5,11003,5667,5336
California,Shasta County,2,6,10526,5303,5223
California,Shasta County,2,7,9431,4788,4643
California,Shasta County,2,8,9198,4528,4670
California,Shasta County,2,9,10369,5106,5263
California,Shasta County,2,10,12895,6175,6720
California,Shasta County,2,11,13690,6627,7063
California,Shasta County,2,12,13367,6434,6933
California,Shasta County,2,13,12138,5929,6209
California,Shasta County,2,14,9575,4618,4957
California,Shasta County,2,15,6975,3332,3643
California,Shasta County,2,16,5333,2433,2900
California,Shasta County,2,17,4113,1719,2394
California,Shasta County,2,18,3970,1418,2552
California,Shasta County,3,0,177277,87142,90135
California,Shasta County,3,1,10280,5299,4981
California,Shasta County,3,2,10519,5362,5157
California,Shasta County,3,3,11326,5932,5394
California,Shasta County,3,4,12260,6328,5932
California,Shasta County,3,5,11131,5721,5410
California,Shasta County,3,6,10566,5334,5232
California,Shasta County,3,7,9527,4831,4696
California,Shasta County,3,8,9117,4498,4619
California,Shasta County,3,9,10364,5092,5272
California,Shasta County,3,10,12780,6122,6658
California,Shasta County,3,11,13658,6610,7048
California,Shasta County,3,12,13410,6448,6962
California,Shasta County,3,13,12258,5980,6278
California,Shasta County,3,14,9604,4641,4963
California,Shasta County,3,15,7058,3379,3679
California,Shasta County,3,16,5321,2428,2893
California,Shasta County,3,17,4110,1722,2388
California,Shasta County,3,18,3988,1415,2573
California,Shasta County,4,0,177572,87209,90363
California,Shasta County,4,1,10300,5256,5044
California,Shasta County,4,2,10533,5363,5170
California,Shasta County,4,3,11155,5832,5323
California,Shasta County,4,4,11644,6048,5596
California,Shasta County,4,5,11603,5915,5688
California,Shasta County,4,6,10667,5449,5218
California,Shasta County,4,7,9864,4958,4906
California,Shasta County,4,8,8838,4410,4428
California,Shasta County,4,9,10307,5050,5257
California,Shasta County,4,10,12128,5805,6323
California,Shasta County,4,11,13548,6509,7039
California,Shasta County,4,12,13554,6523,7031
California,Shasta County,4,13,12821,6219,6602
California,Shasta County,4,14,9760,4738,5022
California,Shasta County,4,15,7322,3513,3809
California,Shasta County,4,16,5372,2464,2908
California,Shasta County,4,17,4100,1739,2361
California,Shasta County,4,18,4056,1418,2638
California,Shasta County,5,0,177868,87297,90571
California,Shasta County,5,1,10369,5297,5072
California,Shasta County,5,2,10459,5279,5180
California,Shasta County,5,3,11082,5829,5253
California,Shasta County,5,4,11282,5877,5405
California,Shasta County,5,5,11631,5924,5707
California,Shasta County,5,6,10837,5487,5350
California,Shasta County,5,7,10189,5107,5082
California,Shasta County,5,8,8827,4416,4411
California,Shasta County,5,9,10057,4929,5128
California,Shasta County,5,10,11456,5463,5993
California,Shasta County,5,11,13520,6545,6975
California,Shasta County,5,12,13626,6540,7086
California,Shasta County,5,13,12622,6072,6550
California,Shasta County,5,14,10472,5054,5418
California,Shasta County,5,15,7636,3681,3955
California,Shasta County,5,16,5516,2546,2970
California,Shasta County,5,17,4145,1771,2374
California,Shasta County,5,18,4142,1480,2662
California,Shasta County,6,0,178401,87537,90864
California,Shasta County,6,1,10400,5331,5069
California,Shasta County,6,2,10589,5362,5227
California,Shasta County,6,3,11076,5749,5327
California,Shasta County,6,4,11012,5756,5256
California,Shasta County,6,5,11470,5900,5570
California,Shasta County,6,6,11026,5609,5417
California,Shasta County,6,7,10600,5280,5320
California,Shasta County,6,8,9012,4474,4538
California,Shasta County,6,9,9800,4842,4958
California,Shasta County,6,10,10933,5258,5675
California,Shasta County,6,11,13290,6406,6884
California,Shasta County,6,12,13542,6457,7085
California,Shasta County,6,13,12719,6087,6632
California,Shasta County,6,14,10855,5225,5630
California,Shasta County,6,15,8149,3914,4235
California,Shasta County,6,16,5631,2585,3046
California,Shasta County,6,17,4189,1822,2367
California,Shasta County,6,18,4108,1480,2628
California,Shasta County,7,0,178905,87833,91072
California,Shasta County,7,1,10532,5354,5178
California,Shasta County,7,2,10570,5379,5191
California,Shasta County,7,3,10936,5638,5298
California,Shasta County,7,4,10885,5713,5172
California,Shasta County,7,5,11199,5774,5425
California,Shasta County,7,6,11294,5734,5560
California,Shasta County,7,7,10836,5387,5449
California,Shasta County,7,8,9275,4648,4627
California,Shasta County,7,9,9624,4699,4925
California,Shasta County,7,10,10489,5149,5340
California,Shasta County,7,11,13108,6323,6785
California,Shasta County,7,12,13370,6371,6999
California,Shasta County,7,13,12963,6192,6771
California,Shasta County,7,14,11187,5372,5815
California,Shasta County,7,15,8440,4017,4423
California,Shasta County,7,16,5860,2698,3162
California,Shasta County,7,17,4161,1848,2313
California,Shasta County,7,18,4176,1537,2639
California,Shasta County,8,0,178361,87574,90787
California,Shasta County,8,1,10550,5423,5127
California,Shasta County,8,2,10478,5326,5152
California,Shasta County,8,3,10727,5473,5254
California,Shasta County,8,4,10677,5612,5065
California,Shasta County,8,5,10683,5448,5235
California,Shasta County,8,6,11513,5890,5623
California,Shasta County,8,7,10913,5419,5494
California,Shasta County,8,8,9600,4845,4755
California,Shasta County,8,9,9160,4501,4659
California,Shasta County,8,10,10302,5041,5261
California,Shasta County,8,11,12520,6004,6516
California,Shasta County,8,12,13432,6442,6990
California,Shasta County,8,13,13058,6184,6874
California,Shasta County,8,14,11609,5576,6033
California,Shasta County,8,15,8724,4160,4564
California,Shasta County,8,16,6051,2826,3225
California,Shasta County,8,17,4027,1767,2260
California,Shasta County,8,18,4337,1637,2700
California,Shasta County,9,0,178581,87683,90898
California,Shasta County,9,1,10581,5487,5094
California,Shasta County,9,2,10577,5356,5221
California,Shasta County,9,3,10676,5440,5236
California,Shasta County,9,4,10568,5509,5059
California,Shasta County,9,5,10282,5314,4968
California,Shasta County,9,6,11737,5973,5764
California,Shasta County,9,7,11052,5525,5527
California,Shasta County,9,8,10078,5044,5034
California,Shasta County,9,9,8837,4408,4429
California,Shasta County,9,10,10223,4969,5254
California,Shasta County,9,11,11833,5655,6178
California,Shasta County,9,12,13286,6335,6951
California,Shasta County,9,13,13200,6295,6905
California,Shasta County,9,14,12124,5793,6331
California,Shasta County,9,15,8875,4243,4632
California,Shasta County,9,16,6239,2916,3323
California,Shasta County,9,17,4071,1805,2266
California,Shasta County,9,18,4342,1616,2726
California,Shasta County,10,0,179539,88157,91382
California,Shasta County,10,1,10584,5423,5161
California,Shasta County,10,2,10756,5500,5256
California,Shasta County,10,3,10705,5420,5285
California,Shasta County,10,4,10447,5457,4990
California,Shasta County,10,5,10069,5220,4849
California,Shasta County,10,6,11883,6036,5847
California,Shasta County,10,7,11207,5593,5614
California,Shasta County,10,8,10457,5249,5208
California,Shasta County,10,9,8925,4470,4455
California,Shasta County,10,10,10099,4919,5180
California,Shasta County,10,11,11268,5322,5946
California,Shasta County,10,12,13370,6462,6908
California,Shasta County,10,13,13216,6290,6926
California,Shasta County,10,14,12016,5714,6302
California,Shasta County,10,15,9518,4523,4995
California,Shasta County,10,16,6479,3062,3417
California,Shasta County,10,17,4228,1872,2356
California,Shasta County,10,18,4312,1625,2687
California,Shasta County,11,0,180040,88367,91673
California,Shasta County,11,1,10597,5448,5149
California,Shasta County,11,2,10609,5435,5174
California,Shasta County,11,3,10762,5427,5335
California,Shasta County,11,4,10412,5430,4982
California,Shasta County,11,5,9876,5114,4762
California,Shasta County,11,6,11797,5978,5819
California,Shasta County,11,7,11365,5722,5643
California,Shasta County,11,8,10922,5433,5489
California,Shasta County,11,9,9144,4611,4533
California,Shasta County,11,10,9846,4818,5028
California,Shasta County,11,11,10772,5111,5661
California,Shasta County,11,12,13143,6357,6786
California,Shasta County,11,13,13242,6237,7005
California,Shasta County,11,14,12087,5739,6348
California,Shasta County,11,15,9929,4715,5214
California,Shasta County,11,16,6888,3245,3643
California,Shasta County,11,17,4365,1928,2437
California,Shasta County,11,18,4284,1619,2665
California,Sierra County,1,0,3240,1646,1594
California,Sierra County,1,1,147,69,78
California,Sierra County,1,2,131,69,62
California,Sierra County,1,3,156,92,64
California,Sierra County,1,4,170,91,79
California,Sierra County,1,5,118,64,54
California,Sierra County,1,6,126,66,60
California,Sierra County,1,7,117,58,59
California,Sierra County,1,8,151,75,76
California,Sierra County,1,9,184,91,93
California,Sierra County,1,10,259,128,131
California,Sierra County,1,11,312,155,157
California,Sierra County,1,12,347,171,176
California,Sierra County,1,13,346,177,169
California,Sierra County,1,14,230,126,104
California,Sierra County,1,15,166,76,90
California,Sierra County,1,16,139,70,69
California,Sierra County,1,17,68,33,35
California,Sierra County,1,18,73,35,38
California,Sierra County,2,0,3240,1646,1594
California,Sierra County,2,1,147,69,78
California,Sierra County,2,2,131,69,62
California,Sierra County,2,3,156,92,64
California,Sierra County,2,4,170,91,79
California,Sierra County,2,5,118,64,54
California,Sierra County,2,6,126,66,60
California,Sierra County,2,7,117,58,59
California,Sierra County,2,8,151,75,76
California,Sierra County,2,9,184,91,93
California,Sierra County,2,10,259,128,131
California,Sierra County,2,11,312,155,157
California,Sierra County,2,12,347,171,176
California,Sierra County,2,13,346,177,169
California,Sierra County,2,14,230,126,104
California,Sierra County,2,15,166,76,90
California,Sierra County,2,16,139,70,69
California,Sierra County,2,17,68,33,35
California,Sierra County,2,18,73,35,38
California,Sierra County,3,0,3221,1634,1587
California,Sierra County,3,1,146,69,77
California,Sierra County,3,2,129,67,62
California,Sierra County,3,3,156,92,64
California,Sierra County,3,4,170,91,79
California,Sierra County,3,5,124,67,57
California,Sierra County,3,6,124,64,60
California,Sierra County,3,7,117,58,59
California,Sierra County,3,8,150,74,76
California,Sierra County,3,9,182,90,92
California,Sierra County,3,10,256,126,130
California,Sierra County,3,11,305,153,152
California,Sierra County,3,12,343,166,177
California,Sierra County,3,13,343,178,165
California,Sierra County,3,14,231,124,107
California,Sierra County,3,15,167,78,89
California,Sierra County,3,16,136,71,65
California,Sierra County,3,17,70,33,37
California,Sierra County,3,18,72,33,39
California,Sierra County,4,0,3099,1563,1536
California,Sierra County,4,1,127,59,68
California,Sierra County,4,2,127,65,62
California,Sierra County,4,3,142,75,67
California,Sierra County,4,4,177,97,80
California,Sierra County,4,5,106,63,43
California,Sierra County,4,6,115,59,56
California,Sierra County,4,7,127,59,68
California,Sierra County,4,8,134,63,71
California,Sierra County,4,9,170,87,83
California,Sierra County,4,10,223,106,117
California,Sierra County,4,11,298,151,147
California,Sierra County,4,12,316,148,168
California,Sierra County,4,13,353,188,165
California,Sierra County,4,14,235,121,114
California,Sierra County,4,15,178,91,87
California,Sierra County,4,16,127,63,64
California,Sierra County,4,17,83,39,44
California,Sierra County,4,18,61,29,32
California,Sierra County,5,0,3067,1544,1523
California,Sierra County,5,1,134,57,77
California,Sierra County,5,2,123,60,63
California,Sierra County,5,3,142,77,65
California,Sierra County,5,4,165,92,73
California,Sierra County,5,5,106,65,41
California,Sierra County,5,6,107,53,54
California,Sierra County,5,7,133,60,73
California,Sierra County,5,8,128,55,73
California,Sierra County,5,9,163,85,78
California,Sierra County,5,10,201,98,103
California,Sierra County,5,11,291,147,144
California,Sierra County,5,12,299,141,158
California,Sierra County,5,13,350,185,165
California,Sierra County,5,14,263,139,124
California,Sierra County,5,15,181,95,86
California,Sierra County,5,16,126,60,66
California,Sierra County,5,17,93,47,46
California,Sierra County,5,18,62,28,34
California,Sierra County,6,0,3029,1518,1511
California,Sierra County,6,1,121,59,62
California,Sierra County,6,2,130,57,73
California,Sierra County,6,3,146,76,70
California,Sierra County,6,4,155,88,67
California,Sierra County,6,5,106,68,38
California,Sierra County,6,6,104,48,56
California,Sierra County,6,7,134,67,67
California,Sierra County,6,8,125,56,69
California,Sierra County,6,9,154,73,81
California,Sierra County,6,10,176,87,89
California,Sierra County,6,11,273,142,131
California,Sierra County,6,12,287,127,160
California,Sierra County,6,13,357,183,174
California,Sierra County,6,14,279,148,131
California,Sierra County,6,15,194,99,95
California,Sierra County,6,16,124,58,66
California,Sierra County,6,17,99,51,48
California,Sierra County,6,18,65,31,34
California,Sierra County,7,0,2980,1499,1481
California,Sierra County,7,1,107,51,56
California,Sierra County,7,2,143,70,73
California,Sierra County,7,3,135,72,63
California,Sierra County,7,4,146,83,63
California,Sierra County,7,5,121,73,48
California,Sierra County,7,6,85,46,39
California,Sierra County,7,7,129,60,69
California,Sierra County,7,8,128,66,62
California,Sierra County,7,9,139,61,78
California,Sierra County,7,10,166,79,87
California,Sierra County,7,11,257,128,129
California,Sierra County,7,12,281,129,152
California,Sierra County,7,13,336,173,163
California,Sierra County,7,14,308,164,144
California,Sierra County,7,15,197,99,98
California,Sierra County,7,16,127,63,64
California,Sierra County,7,17,107,50,57
California,Sierra County,7,18,68,32,36
California,Sierra County,8,0,2996,1521,1475
California,Sierra County,8,1,102,48,54
California,Sierra County,8,2,148,71,77
California,Sierra County,8,3,143,80,63
California,Sierra County,8,4,135,77,58
California,Sierra County,8,5,130,75,55
California,Sierra County,8,6,100,62,38
California,Sierra County,8,7,114,51,63
California,Sierra County,8,8,135,71,64
California,Sierra County,8,9,144,67,77
California,Sierra County,8,10,164,77,87
California,Sierra County,8,11,230,111,119
California,Sierra County,8,12,297,147,150
California,Sierra County,8,13,305,161,144
California,Sierra County,8,14,330,174,156
California,Sierra County,8,15,202,101,101
California,Sierra County,8,16,131,62,69
California,Sierra County,8,17,110,53,57
California,Sierra County,8,18,76,33,43
California,Sierra County,9,0,2957,1494,1463
California,Sierra County,9,1,108,55,53
California,Sierra County,9,2,133,64,69
California,Sierra County,9,3,134,72,62
California,Sierra County,9,4,123,70,53
California,Sierra County,9,5,129,74,55
California,Sierra County,9,6,105,62,43
California,Sierra County,9,7,101,48,53
California,Sierra County,9,8,139,72,67
California,Sierra County,9,9,143,67,76
California,Sierra County,9,10,153,76,77
California,Sierra County,9,11,214,98,116
California,Sierra County,9,12,304,155,149
California,Sierra County,9,13,292,148,144
California,Sierra County,9,14,340,180,160
California,Sierra County,9,15,207,99,108
California,Sierra County,9,16,148,78,70
California,Sierra County,9,17,102,43,59
California,Sierra County,9,18,82,33,49
California,Sierra County,10,0,3009,1518,1491
California,Sierra County,10,1,137,69,68
California,Sierra County,10,2,126,64,62
California,Sierra County,10,3,136,67,69
California,Sierra County,10,4,120,68,52
California,Sierra County,10,5,140,77,63
California,Sierra County,10,6,101,62,39
California,Sierra County,10,7,119,58,61
California,Sierra County,10,8,124,64,60
California,Sierra County,10,9,155,72,83
California,Sierra County,10,10,160,79,81
California,Sierra County,10,11,195,94,101
California,Sierra County,10,12,303,155,148
California,Sierra County,10,13,282,146,136
California,Sierra County,10,14,337,174,163
California,Sierra County,10,15,230,110,120
California,Sierra County,10,16,156,84,72
California,Sierra County,10,17,99,37,62
California,Sierra County,10,18,89,38,51
California,Sierra County,11,0,2987,1511,1476
California,Sierra County,11,1,139,67,72
California,Sierra County,11,2,133,73,60
California,Sierra County,11,3,130,60,70
California,Sierra County,11,4,115,68,47
California,Sierra County,11,5,110,67,43
California,Sierra County,11,6,128,78,50
California,Sierra County,11,7,119,53,66
California,Sierra County,11,8,143,76,67
California,Sierra County,11,9,145,71,74
California,Sierra County,11,10,152,69,83
California,Sierra County,11,11,169,84,85
California,Sierra County,11,12,279,149,130
California,Sierra County,11,13,280,132,148
California,Sierra County,11,14,347,178,169
California,Sierra County,11,15,239,115,124
California,Sierra County,11,16,174,93,81
California,Sierra County,11,17,100,39,61
California,Sierra County,11,18,85,39,46
California,Siskiyou County,1,0,44900,22395,22505
California,Siskiyou County,1,1,2473,1291,1182
California,Siskiyou County,1,2,2410,1204,1206
California,Siskiyou County,1,3,2726,1408,1318
California,Siskiyou County,1,4,2757,1496,1261
California,Siskiyou County,1,5,2178,1151,1027
California,Siskiyou County,1,6,2274,1173,1101
California,Siskiyou County,1,7,2003,1028,975
California,Siskiyou County,1,8,2139,1093,1046
California,Siskiyou County,1,9,2397,1192,1205
California,Siskiyou County,1,10,3088,1501,1587
California,Siskiyou County,1,11,3822,1793,2029
California,Siskiyou County,1,12,4029,1948,2081
California,Siskiyou County,1,13,3822,1942,1880
California,Siskiyou County,1,14,2930,1505,1425
California,Siskiyou County,1,15,2011,996,1015
California,Siskiyou County,1,16,1510,719,791
California,Siskiyou County,1,17,1179,515,664
California,Siskiyou County,1,18,1152,440,712
California,Siskiyou County,2,0,44900,22395,22505
California,Siskiyou County,2,1,2473,1291,1182
California,Siskiyou County,2,2,2410,1204,1206
California,Siskiyou County,2,3,2726,1408,1318
California,Siskiyou County,2,4,2757,1496,1261
California,Siskiyou County,2,5,2178,1151,1027
California,Siskiyou County,2,6,2274,1173,1101
California,Siskiyou County,2,7,2003,1028,975
California,Siskiyou County,2,8,2139,1093,1046
California,Siskiyou County,2,9,2397,1192,1205
California,Siskiyou County,2,10,3088,1501,1587
California,Siskiyou County,2,11,3822,1793,2029
California,Siskiyou County,2,12,4029,1948,2081
California,Siskiyou County,2,13,3822,1942,1880
California,Siskiyou County,2,14,2930,1505,1425
California,Siskiyou County,2,15,2011,996,1015
California,Siskiyou County,2,16,1510,719,791
California,Siskiyou County,2,17,1179,515,664
California,Siskiyou County,2,18,1152,440,712
California,Siskiyou County,3,0,44938,22443,22495
California,Siskiyou County,3,1,2460,1284,1176
California,Siskiyou County,3,2,2417,1216,1201
California,Siskiyou County,3,3,2715,1398,1317
California,Siskiyou County,3,4,2749,1505,1244
California,Siskiyou County,3,5,2214,1170,1044
California,Siskiyou County,3,6,2300,1192,1108
California,Siskiyou County,3,7,2025,1042,983
California,Siskiyou County,3,8,2123,1086,1037
California,Siskiyou County,3,9,2398,1193,1205
California,Siskiyou County,3,10,3044,1487,1557
California,Siskiyou County,3,11,3793,1772,2021
California,Siskiyou County,3,12,4031,1947,2084
California,Siskiyou County,3,13,3861,1957,1904
California,Siskiyou County,3,14,2948,1511,1437
California,Siskiyou County,3,15,2017,1007,1010
California,Siskiyou County,3,16,1508,718,790
California,Siskiyou County,3,17,1180,515,665
California,Siskiyou County,3,18,1155,443,712
California,Siskiyou County,4,0,44610,22210,22400
California,Siskiyou County,4,1,2385,1222,1163
California,Siskiyou County,4,2,2426,1217,1209
California,Siskiyou County,4,3,2645,1321,1324
California,Siskiyou County,4,4,2687,1487,1200
California,Siskiyou County,4,5,2265,1184,1081
California,Siskiyou County,4,6,2249,1159,1090
California,Siskiyou County,4,7,2095,1091,1004
California,Siskiyou County,4,8,2032,1051,981
California,Siskiyou County,4,9,2397,1196,1201
California,Siskiyou County,4,10,2794,1380,1414
California,Siskiyou County,4,11,3630,1687,1943
California,Siskiyou County,4,12,4063,1965,2098
California,Siskiyou County,4,13,4037,2001,2036
California,Siskiyou County,4,14,3001,1533,1468
California,Siskiyou County,4,15,2064,1042,1022
California,Siskiyou County,4,16,1530,736,794
California,Siskiyou County,4,17,1168,512,656
California,Siskiyou County,4,18,1142,426,716
California,Siskiyou County,5,0,44073,21895,22178
California,Siskiyou County,5,1,2367,1194,1173
California,Siskiyou County,5,2,2465,1263,1202
California,Siskiyou County,5,3,2552,1235,1317
California,Siskiyou County,5,4,2616,1440,1176
California,Siskiyou County,5,5,2209,1156,1053
California,Siskiyou County,5,6,2192,1130,1062
California,Siskiyou County,5,7,2169,1121,1048
California,Siskiyou County,5,8,1956,1013,943
California,Siskiyou County,5,9,2359,1223,1136
California,Siskiyou County,5,10,2588,1250,1338
California,Siskiyou County,5,11,3370,1579,1791
California,Siskiyou County,5,12,4034,1922,2112
California,Siskiyou County,5,13,3944,1932,2012
California,Siskiyou County,5,14,3245,1656,1589
California,Siskiyou County,5,15,2154,1097,1057
California,Siskiyou County,5,16,1546,750,796
California,Siskiyou County,5,17,1146,520,626
California,Siskiyou County,5,18,1161,414,747
California,Siskiyou County,6,0,43532,21646,21886
California,Siskiyou County,6,1,2352,1161,1191
California,Siskiyou County,6,2,2449,1262,1187
California,Siskiyou County,6,3,2494,1232,1262
California,Siskiyou County,6,4,2545,1369,1176
California,Siskiyou County,6,5,2172,1163,1009
California,Siskiyou County,6,6,2134,1108,1026
California,Siskiyou County,6,7,2177,1126,1051
California,Siskiyou County,6,8,1939,992,947
California,Siskiyou County,6,9,2296,1185,1111
California,Siskiyou County,6,10,2381,1144,1237
California,Siskiyou County,6,11,3195,1512,1683
California,Siskiyou County,6,12,3915,1879,2036
California,Siskiyou County,6,13,3936,1920,2016
California,Siskiyou County,6,14,3381,1691,1690
California,Siskiyou County,6,15,2312,1201,1111
California,Siskiyou County,6,16,1567,766,801
California,Siskiyou County,6,17,1128,507,621
California,Siskiyou County,6,18,1159,428,731
California,Siskiyou County,7,0,43379,21589,21790
California,Siskiyou County,7,1,2330,1146,1184
California,Siskiyou County,7,2,2452,1268,1184
California,Siskiyou County,7,3,2417,1205,1212
California,Siskiyou County,7,4,2489,1310,1179
California,Siskiyou County,7,5,2174,1169,1005
California,Siskiyou County,7,6,2152,1135,1017
California,Siskiyou County,7,7,2263,1151,1112
California,Siskiyou County,7,8,1983,1024,959
California,Siskiyou County,7,9,2186,1124,1062
California,Siskiyou County,7,10,2294,1106,1188
California,Siskiyou County,7,11,3098,1504,1594
California,Siskiyou County,7,12,3769,1789,1980
California,Siskiyou County,7,13,3941,1884,2057
California,Siskiyou County,7,14,3492,1759,1733
California,Siskiyou County,7,15,2488,1287,1201
California,Siskiyou County,7,16,1574,772,802
California,Siskiyou County,7,17,1105,510,595
California,Siskiyou County,7,18,1172,446,726
California,Siskiyou County,8,0,43336,21584,21752
California,Siskiyou County,8,1,2304,1132,1172
California,Siskiyou County,8,2,2486,1296,1190
California,Siskiyou County,8,3,2364,1196,1168
California,Siskiyou County,8,4,2498,1304,1194
California,Siskiyou County,8,5,2094,1106,988
California,Siskiyou County,8,6,2134,1129,1005
California,Siskiyou County,8,7,2301,1168,1133
California,Siskiyou County,8,8,2086,1074,1012
California,Siskiyou County,8,9,2108,1090,1018
California,Siskiyou County,8,10,2337,1128,1209
California,Siskiyou County,8,11,2890,1410,1480
California,Siskiyou County,8,12,3670,1698,1972
California,Siskiyou County,8,13,3908,1872,2036
California,Siskiyou County,8,14,3634,1870,1764
California,Siskiyou County,8,15,2604,1311,1293
California,Siskiyou County,8,16,1630,820,810
California,Siskiyou County,8,17,1102,506,596
California,Siskiyou County,8,18,1186,474,712
California,Siskiyou County,9,0,43479,21651,21828
California,Siskiyou County,9,1,2294,1175,1119
California,Siskiyou County,9,2,2528,1303,1225
California,Siskiyou County,9,3,2393,1220,1173
California,Siskiyou County,9,4,2475,1283,1192
California,Siskiyou County,9,5,2089,1138,951
California,Siskiyou County,9,6,2191,1139,1052
California,Siskiyou County,9,7,2294,1166,1128
California,Siskiyou County,9,8,2172,1112,1060
California,Siskiyou County,9,9,2028,1048,980
California,Siskiyou County,9,10,2387,1169,1218
California,Siskiyou County,9,11,2639,1292,1347
California,Siskiyou County,9,12,3575,1634,1941
California,Siskiyou County,9,13,3919,1868,2051
California,Siskiyou County,9,14,3804,1904,1900
California,Siskiyou County,9,15,2694,1351,1343
California,Siskiyou County,9,16,1692,866,826
California,Siskiyou County,9,17,1132,527,605
California,Siskiyou County,9,18,1173,456,717
California,Siskiyou County,10,0,43784,21785,21999
California,Siskiyou County,10,1,2277,1163,1114
California,Siskiyou County,10,2,2575,1313,1262
California,Siskiyou County,10,3,2493,1287,1206
California,Siskiyou County,10,4,2413,1237,1176
California,Siskiyou County,10,5,2107,1148,959
California,Siskiyou County,10,6,2268,1185,1083
California,Siskiyou County,10,7,2291,1158,1133
California,Siskiyou County,10,8,2280,1153,1127
California,Siskiyou County,10,9,2039,1059,980
California,Siskiyou County,10,10,2376,1199,1177
California,Siskiyou County,10,11,2515,1191,1324
California,Siskiyou County,10,12,3359,1570,1789
California,Siskiyou County,10,13,3951,1844,2107
California,Siskiyou County,10,14,3788,1882,1906
California,Siskiyou County,10,15,2936,1474,1462
California,Siskiyou County,10,16,1810,935,875
California,Siskiyou County,10,17,1152,532,620
California,Siskiyou County,10,18,1154,455,699
California,Siskiyou County,11,0,43724,21731,21993
California,Siskiyou County,11,1,2268,1161,1107
California,Siskiyou County,11,2,2513,1218,1295
California,Siskiyou County,11,3,2598,1370,1228
California,Siskiyou County,11,4,2355,1236,1119
California,Siskiyou County,11,5,1994,1062,932
California,Siskiyou County,11,6,2273,1196,1077
California,Siskiyou County,11,7,2270,1167,1103
California,Siskiyou County,11,8,2383,1183,1200
California,Siskiyou County,11,9,2029,1042,987
California,Siskiyou County,11,10,2342,1194,1148
California,Siskiyou County,11,11,2388,1131,1257
California,Siskiyou County,11,12,3235,1513,1722
California,Siskiyou County,11,13,3916,1849,2067
California,Siskiyou County,11,14,3809,1873,1936
California,Siskiyou County,11,15,3077,1530,1547
California,Siskiyou County,11,16,1966,1026,940
California,Siskiyou County,11,17,1158,535,623
California,Siskiyou County,11,18,1150,445,705
California,Solano County,1,0,413344,206195,207149
California,Solano County,1,1,26852,13819,13033
California,Solano County,1,2,27311,13951,13360
California,Solano County,1,3,28575,14652,13923
California,Solano County,1,4,30484,15711,14773
California,Solano County,1,5,28761,15140,13621
California,Solano County,1,6,28596,14825,13771
California,Solano County,1,7,26318,13399,12919
California,Solano County,1,8,26355,13182,13173
California,Solano County,1,9,28068,14220,13848
California,Solano County,1,10,31946,16021,15925
California,Solano County,1,11,32004,15814,16190
California,Solano County,1,12,28009,13630,14379
California,Solano County,1,13,23218,11373,11845
California,Solano County,1,14,15031,7119,7912
California,Solano County,1,15,10966,4989,5977
California,Solano County,1,16,8584,3804,4780
California,Solano County,1,17,6254,2431,3823
California,Solano County,1,18,6012,2115,3897
California,Solano County,2,0,413298,206169,207129
California,Solano County,2,1,26846,13814,13032
California,Solano County,2,2,27310,13951,13359
California,Solano County,2,3,28573,14651,13922
California,Solano County,2,4,30481,15709,14772
California,Solano County,2,5,28752,15135,13617
California,Solano County,2,6,28593,14824,13769
California,Solano County,2,7,26315,13397,12918
California,Solano County,2,8,26352,13180,13172
California,Solano County,2,9,28065,14218,13847
California,Solano County,2,10,31942,16020,15922
California,Solano County,2,11,32001,15812,16189
California,Solano County,2,12,28006,13629,14377
California,Solano County,2,13,23218,11373,11845
California,Solano County,2,14,15030,7119,7911
California,Solano County,2,15,10965,4988,5977
California,Solano County,2,16,8584,3804,4780
California,Solano County,2,17,6254,2431,3823
California,Solano County,2,18,6011,2114,3897
California,Solano County,3,0,413944,206406,207538
California,Solano County,3,1,26748,13766,12982
California,Solano County,3,2,27200,13877,13323
California,Solano County,3,3,28508,14593,13915
California,Solano County,3,4,30262,15630,14632
California,Solano County,3,5,29127,15299,13828
California,Solano County,3,6,28666,14857,13809
California,Solano County,3,7,26473,13486,12987
California,Solano County,3,8,26127,13069,13058
California,Solano County,3,9,28014,14184,13830
California,Solano County,3,10,31812,15950,15862
California,Solano County,3,11,31995,15810,16185
California,Solano County,3,12,28243,13715,14528
California,Solano County,3,13,23488,11494,11994
California,Solano County,3,14,15281,7236,8045
California,Solano County,3,15,11042,5036,6006
California,Solano County,3,16,8604,3814,4790
California,Solano County,3,17,6314,2467,3847
California,Solano County,3,18,6040,2123,3917
California,Solano County,4,0,416305,207627,208678
California,Solano County,4,1,26599,13669,12930
California,Solano County,4,2,27055,13856,13199
California,Solano County,4,3,28238,14390,13848
California,Solano County,4,4,29209,15132,14077
California,Solano County,4,5,30225,15993,14232
California,Solano County,4,6,29054,15017,14037
California,Solano County,4,7,27100,13851,13249
California,Solano County,4,8,25265,12675,12590
California,Solano County,4,9,27814,14069,13745
California,Solano County,4,10,30937,15521,15416
California,Solano County,4,11,31959,15845,16114
California,Solano County,4,12,29022,14038,14984
California,Solano County,4,13,24615,12011,12604
California,Solano County,4,14,16365,7728,8637
California,Solano County,4,15,11394,5244,6150
California,Solano County,4,16,8752,3846,4906
California,Solano County,4,17,6510,2604,3906
California,Solano County,4,18,6192,2138,4054
California,Solano County,5,0,419699,209005,210694
California,Solano County,5,1,26318,13461,12857
California,Solano County,5,2,27033,13944,13089
California,Solano County,5,3,27872,14119,13753
California,Solano County,5,4,28451,14765,13686
California,Solano County,5,5,31162,16406,14756
California,Solano County,5,6,29489,15328,14161
California,Solano County,5,7,27903,14292,13611
California,Solano County,5,8,25193,12707,12486
California,Solano County,5,9,27514,13812,13702
California,Solano County,5,10,30018,15053,14965
California,Solano County,5,11,31920,15789,16131
California,Solano County,5,12,29781,14332,15449
California,Solano County,5,13,24794,12090,12704
California,Solano County,5,14,18389,8651,9738
California,Solano County,5,15,11975,5482,6493
California,Solano County,5,16,8913,3913,5000
California,Solano County,5,17,6554,2659,3895
California,Solano County,5,18,6420,2202,4218
California,Solano County,6,0,423749,210769,212980
California,Solano County,6,1,26231,13364,12867
California,Solano County,6,2,27324,14101,13223
California,Solano County,6,3,27603,13977,13626
California,Solano County,6,4,27934,14524,13410
California,Solano County,6,5,31425,16649,14776
California,Solano County,6,6,30321,15695,14626
California,Solano County,6,7,28606,14671,13935
California,Solano County,6,8,25490,12817,12673
California,Solano County,6,9,26990,13511,13479
California,Solano County,6,10,28974,14527,14447
California,Solano County,6,11,32010,15826,16184
California,Solano County,6,12,30054,14499,15555
California,Solano County,6,13,25554,12342,13212
California,Solano County,6,14,19824,9357,10467
California,Solano County,6,15,12759,5802,6957
California,Solano County,6,16,9181,4034,5147
California,Solano County,6,17,6750,2781,3969
California,Solano County,6,18,6719,2292,4427
California,Solano County,7,0,429155,213272,215883
California,Solano County,7,1,26386,13369,13017
California,Solano County,7,2,27568,14223,13345
California,Solano County,7,3,27506,13997,13509
California,Solano County,7,4,27406,14236,13170
California,Solano County,7,5,31371,16693,14678
California,Solano County,7,6,31216,16143,15073
California,Solano County,7,7,29564,15194,14370
California,Solano County,7,8,25997,13026,12971
California,Solano County,7,9,26743,13403,13340
California,Solano County,7,10,28122,14116,14006
California,Solano County,7,11,31952,15723,16229
California,Solano County,7,12,30703,14853,15850
California,Solano County,7,13,26258,12535,13723
California,Solano County,7,14,21226,10017,11209
California,Solano County,7,15,13620,6228,7392
California,Solano County,7,16,9558,4202,5356
California,Solano County,7,17,6943,2887,4056
California,Solano County,7,18,7016,2427,4589
California,Solano County,8,0,433708,215375,218333
California,Solano County,8,1,26727,13559,13168
California,Solano County,8,2,27512,14176,13336
California,Solano County,8,3,27513,14088,13425
California,Solano County,8,4,27145,14078,13067
California,Solano County,8,5,30485,16228,14257
California,Solano County,8,6,32059,16563,15496
California,Solano County,8,7,30271,15479,14792
California,Solano County,8,8,27148,13631,13517
California,Solano County,8,9,26060,12979,13081
California,Solano County,8,10,27783,13973,13810
California,Solano County,8,11,31251,15414,15837
California,Solano County,8,12,31116,15051,16065
California,Solano County,8,13,27184,12915,14269
California,Solano County,8,14,22608,10709,11899
California,Solano County,8,15,14492,6584,7908
California,Solano County,8,16,9924,4411,5513
California,Solano County,8,17,7069,2968,4101
California,Solano County,8,18,7361,2569,4792
California,Solano County,9,0,439300,218299,221001
California,Solano County,9,1,26948,13823,13125
California,Solano County,9,2,27581,14064,13517
California,Solano County,9,3,27644,14223,13421
California,Solano County,9,4,26951,13878,13073
California,Solano County,9,5,29787,15957,13830
California,Solano County,9,6,33079,17119,15960
California,Solano County,9,7,31353,16020,15333
California,Solano County,9,8,28086,14219,13867
California,Solano County,9,9,25525,12831,12694
California,Solano County,9,10,27982,14027,13955
California,Solano County,9,11,30538,15054,15484
California,Solano County,9,12,31379,15190,16189
California,Solano County,9,13,28045,13246,14799
California,Solano County,9,14,23660,11251,12409
California,Solano County,9,15,15634,7127,8507
California,Solano County,9,16,10317,4553,5764
California,Solano County,9,17,7204,3040,4164
California,Solano County,9,18,7587,2677,4910
California,Solano County,10,0,443877,220801,223076
California,Solano County,10,1,26997,13869,13128
California,Solano County,10,2,27543,14021,13522
California,Solano County,10,3,27667,14286,13381
California,Solano County,10,4,26800,13720,13080
California,Solano County,10,5,29217,15638,13579
California,Solano County,10,6,33759,17607,16152
California,Solano County,10,7,31690,16231,15459
California,Solano County,10,8,29323,14938,14385
California,Solano County,10,9,25717,13036,12681
California,Solano County,10,10,27859,13936,13923
California,Solano County,10,11,29784,14761,15023
California,Solano County,10,12,31319,15189,16130
California,Solano County,10,13,28889,13581,15308
California,Solano County,10,14,23796,11295,12501
California,Solano County,10,15,17477,8032,9445
California,Solano County,10,16,10876,4767,6109
California,Solano County,10,17,7413,3103,4310
California,Solano County,10,18,7751,2791,4960
California,Solano County,11,0,446610,221997,224613
California,Solano County,11,1,26952,13871,13081
California,Solano County,11,2,27392,13952,13440
California,Solano County,11,3,27730,14336,13394
California,Solano County,11,4,26630,13743,12887
California,Solano County,11,5,28735,15305,13430
California,Solano County,11,6,33838,17668,16170
California,Solano County,11,7,31955,16305,15650
California,Solano County,11,8,30167,15423,14744
California,Solano County,11,9,26300,13248,13052
California,Solano County,11,10,27388,13783,13605
California,Solano County,11,11,28824,14259,14565
California,Solano County,11,12,31182,15219,15963
California,Solano County,11,13,29087,13604,15483
California,Solano County,11,14,24462,11515,12947
California,Solano County,11,15,18669,8550,10119
California,Solano County,11,16,11674,5075,6599
California,Solano County,11,17,7634,3198,4436
California,Solano County,11,18,7991,2943,5048
California,Sonoma County,1,0,483878,237902,245976
California,Sonoma County,1,1,28199,14419,13780
California,Sonoma County,1,2,29263,14967,14296
California,Sonoma County,1,3,29724,15176,14548
California,Sonoma County,1,4,33298,17210,16088
California,Sonoma County,1,5,32068,16797,15271
California,Sonoma County,1,6,31730,16536,15194
California,Sonoma County,1,7,29567,15252,14315
California,Sonoma County,1,8,28968,14601,14367
California,Sonoma County,1,9,31635,15937,15698
California,Sonoma County,1,10,36096,17391,18705
California,Sonoma County,1,11,37422,18095,19327
California,Sonoma County,1,12,36355,17311,19044
California,Sonoma County,1,13,32189,15323,16866
California,Sonoma County,1,14,21407,10122,11285
California,Sonoma County,1,15,14137,6470,7667
California,Sonoma County,1,16,10975,4780,6195
California,Sonoma County,1,17,9639,3805,5834
California,Sonoma County,1,18,11206,3710,7496
California,Sonoma County,2,0,483868,237896,245972
California,Sonoma County,2,1,28199,14419,13780
California,Sonoma County,2,2,29263,14967,14296
California,Sonoma County,2,3,29724,15176,14548
California,Sonoma County,2,4,33298,17210,16088
California,Sonoma County,2,5,32067,16796,15271
California,Sonoma County,2,6,31730,16536,15194
California,Sonoma County,2,7,29566,15251,14315
California,Sonoma County,2,8,28968,14601,14367
California,Sonoma County,2,9,31635,15937,15698
California,Sonoma County,2,10,36095,17391,18704
California,Sonoma County,2,11,37420,18093,19327
California,Sonoma County,2,12,36355,17311,19044
California,Sonoma County,2,13,32189,15323,16866
California,Sonoma County,2,14,21407,10122,11285
California,Sonoma County,2,15,14135,6470,7665
California,Sonoma County,2,16,10973,4779,6194
California,Sonoma County,2,17,9639,3805,5834
California,Sonoma County,2,18,11205,3709,7496
California,Sonoma County,3,0,484776,238226,246550
California,Sonoma County,3,1,28212,14446,13766
California,Sonoma County,3,2,29206,14927,14279
California,Sonoma County,3,3,29689,15160,14529
California,Sonoma County,3,4,33109,17018,16091
California,Sonoma County,3,5,32269,16856,15413
California,Sonoma County,3,6,31762,16561,15201
California,Sonoma County,3,7,29777,15326,14451
California,Sonoma County,3,8,28831,14557,14274
California,Sonoma County,3,9,31657,15922,15735
California,Sonoma County,3,10,35875,17329,18546
California,Sonoma County,3,11,37453,18084,19369
California,Sonoma County,3,12,36448,17343,19105
California,Sonoma County,3,13,32593,15534,17059
California,Sonoma County,3,14,21746,10273,11473
California,Sonoma County,3,15,14307,6560,7747
California,Sonoma County,3,16,10979,4790,6189
California,Sonoma County,3,17,9634,3820,5814
California,Sonoma County,3,18,11229,3720,7509
California,Sonoma County,4,0,487423,239152,248271
California,Sonoma County,4,1,27846,14200,13646
California,Sonoma County,4,2,29265,14937,14328
California,Sonoma County,4,3,29555,15081,14474
California,Sonoma County,4,4,32114,16334,15780
California,Sonoma County,4,5,32656,16998,15658
California,Sonoma County,4,6,31688,16585,15103
California,Sonoma County,4,7,30534,15549,14985
California,Sonoma County,4,8,28231,14380,13851
California,Sonoma County,4,9,31640,15846,15794
California,Sonoma County,4,10,34809,16929,17880
California,Sonoma County,4,11,37499,18076,19423
California,Sonoma County,4,12,36756,17477,19279
California,Sonoma County,4,13,34555,16447,18108
California,Sonoma County,4,14,23156,10931,12225
California,Sonoma County,4,15,15129,6946,8183
California,Sonoma County,4,16,11030,4831,6199
California,Sonoma County,4,17,9482,3783,5699
California,Sonoma County,4,18,11478,3822,7656
California,Sonoma County,5,0,490071,240247,249824
California,Sonoma County,5,1,27088,13798,13290
California,Sonoma County,5,2,29312,14988,14324
California,Sonoma County,5,3,29279,14956,14323
California,Sonoma County,5,4,31608,15927,15681
California,Sonoma County,5,5,33017,17156,15861
California,Sonoma County,5,6,31504,16430,15074
California,Sonoma County,5,7,31206,15898,15308
California,Sonoma County,5,8,28366,14465,13901
California,Sonoma County,5,9,31486,15681,15805
California,Sonoma County,5,10,33800,16605,17195
California,Sonoma County,5,11,37125,17844,19281
California,Sonoma County,5,12,37017,17685,19332
California,Sonoma County,5,13,34518,16273,18245
California,Sonoma County,5,14,26085,12364,13721
California,Sonoma County,5,15,16278,7466,8812
California,Sonoma County,5,16,11265,4968,6297
California,Sonoma County,5,17,9429,3837,5592
California,Sonoma County,5,18,11688,3906,7782
California,Sonoma County,6,0,494243,242258,251985
California,Sonoma County,6,1,26902,13710,13192
California,Sonoma County,6,2,29202,14958,14244
California,Sonoma County,6,3,29271,14960,14311
California,Sonoma County,6,4,30962,15497,15465
California,Sonoma County,6,5,32842,17093,15749
California,Sonoma County,6,6,31683,16448,15235
California,Sonoma County,6,7,32168,16410,15758
California,Sonoma County,6,8,28943,14708,14235
California,Sonoma County,6,9,31058,15494,15564
California,Sonoma County,6,10,32886,16289,16597
California,Sonoma County,6,11,36982,17745,19237
California,Sonoma County,6,12,37310,17851,19459
California,Sonoma County,6,13,35155,16534,18621
California,Sonoma County,6,14,28144,13357,14787
California,Sonoma County,6,15,17794,8199,9595
California,Sonoma County,6,16,11871,5258,6613
California,Sonoma County,6,17,9208,3757,5451
California,Sonoma County,6,18,11862,3990,7872
California,Sonoma County,7,0,498803,244258,254545
California,Sonoma County,7,1,26628,13557,13071
California,Sonoma County,7,2,28943,14749,14194
California,Sonoma County,7,3,29335,15095,14240
California,Sonoma County,7,4,30608,15248,15360
California,Sonoma County,7,5,32242,16801,15441
California,Sonoma County,7,6,32265,16756,15509
California,Sonoma County,7,7,32910,16636,16274
California,Sonoma County,7,8,29946,15232,14714
California,Sonoma County,7,9,30481,15223,15258
California,Sonoma County,7,10,32311,16101,16210
California,Sonoma County,7,11,36843,17622,19221
California,Sonoma County,7,12,37330,17828,19502
California,Sonoma County,7,13,35877,16850,19027
California,Sonoma County,7,14,30181,14181,16000
California,Sonoma County,7,15,19347,8987,10360
California,Sonoma County,7,16,12526,5586,6940
California,Sonoma County,7,17,9125,3771,5354
California,Sonoma County,7,18,11905,4035,7870
California,Sonoma County,8,0,501346,245206,256140
California,Sonoma County,8,1,26175,13217,12958
California,Sonoma County,8,2,28780,14727,14053
California,Sonoma County,8,3,29369,15045,14324
California,Sonoma County,8,4,30230,15106,15124
California,Sonoma County,8,5,30986,16003,14983
California,Sonoma County,8,6,32890,17121,15769
California,Sonoma County,8,7,32821,16678,16143
California,Sonoma County,8,8,31098,15704,15394
California,Sonoma County,8,9,29756,14930,14826
California,Sonoma County,8,10,32159,16045,16114
California,Sonoma County,8,11,36169,17309,18860
California,Sonoma County,8,12,37223,17754,19469
California,Sonoma County,8,13,36230,17021,19209
California,Sonoma County,8,14,32078,15023,17055
California,Sonoma County,8,15,20949,9709,11240
California,Sonoma County,8,16,13126,5832,7294
California,Sonoma County,8,17,9191,3839,5352
California,Sonoma County,8,18,12116,4143,7973
California,Sonoma County,9,0,503249,246014,257235
California,Sonoma County,9,1,25678,12949,12729
California,Sonoma County,9,2,28473,14622,13851
California,Sonoma County,9,3,29214,14969,14245
California,Sonoma County,9,4,30006,14994,15012
California,Sonoma County,9,5,30151,15333,14818
California,Sonoma County,9,6,33254,17307,15947
California,Sonoma County,9,7,32768,16718,16050
California,Sonoma County,9,8,32040,16137,15903
California,Sonoma County,9,9,29290,14798,14492
California,Sonoma County,9,10,32191,16006,16185
California,Sonoma County,9,11,35044,16899,18145
California,Sonoma County,9,12,37238,17786,19452
California,Sonoma County,9,13,36496,17067,19429
California,Sonoma County,9,14,33783,15834,17949
California,Sonoma County,9,15,22277,10299,11978
California,Sonoma County,9,16,13891,6178,7713
California,Sonoma County,9,17,9322,3919,5403
California,Sonoma County,9,18,12133,4199,7934
California,Sonoma County,10,0,503246,246037,257209
California,Sonoma County,10,1,25381,12888,12493
California,Sonoma County,10,2,27711,14136,13575
California,Sonoma County,10,3,29089,14890,14199
California,Sonoma County,10,4,29819,14974,14845
California,Sonoma County,10,5,29353,14907,14446
California,Sonoma County,10,6,33018,17246,15772
California,Sonoma County,10,7,32585,16708,15877
California,Sonoma County,10,8,32526,16326,16200
California,Sonoma County,10,9,29438,14849,14589
California,Sonoma County,10,10,31933,15856,16077
California,Sonoma County,10,11,33872,16503,17369
California,Sonoma County,10,12,36914,17595,19319
California,Sonoma County,10,13,36587,17094,19493
California,Sonoma County,10,14,33612,15588,18024
California,Sonoma County,10,15,24938,11586,13352
California,Sonoma County,10,16,14750,6590,8160
California,Sonoma County,10,17,9564,4031,5533
California,Sonoma County,10,18,12156,4270,7886
California,Sonoma County,11,0,499942,244124,255818
California,Sonoma County,11,1,24820,12582,12238
California,Sonoma County,11,2,27021,13766,13255
California,Sonoma County,11,3,28764,14684,14080
California,Sonoma County,11,4,29764,14924,14840
California,Sonoma County,11,5,28106,14178,13928
California,Sonoma County,11,6,32557,16935,15622
California,Sonoma County,11,7,31914,16415,15499
California,Sonoma County,11,8,32834,16462,16372
California,Sonoma County,11,9,29577,14931,14646
California,Sonoma County,11,10,31134,15410,15724
California,Sonoma County,11,11,32550,15994,16556
California,Sonoma County,11,12,36135,17227,18908
California,Sonoma County,11,13,36052,16929,19123
California,Sonoma County,11,14,33834,15581,18253
California,Sonoma County,11,15,26685,12422,14263
California,Sonoma County,11,16,16032,7150,8882
California,Sonoma County,11,17,10055,4255,5800
California,Sonoma County,11,18,12108,4279,7829
California,Stanislaus County,1,0,514453,254489,259964
California,Stanislaus County,1,1,39779,20327,19452
California,Stanislaus County,1,2,40013,20402,19611
California,Stanislaus County,1,3,41276,21399,19877
California,Stanislaus County,1,4,42807,22193,20614
California,Stanislaus County,1,5,37119,18792,18327
California,Stanislaus County,1,6,36474,18326,18148
California,Stanislaus County,1,7,33720,16883,16837
California,Stanislaus County,1,8,33125,16465,16660
California,Stanislaus County,1,9,33601,16678,16923
California,Stanislaus County,1,10,35785,17703,18082
California,Stanislaus County,1,11,33773,16605,17168
California,Stanislaus County,1,12,28545,13854,14691
California,Stanislaus County,1,13,23605,11236,12369
California,Stanislaus County,1,14,16929,7868,9061
California,Stanislaus County,1,15,12708,5756,6952
California,Stanislaus County,1,16,9963,4308,5655
California,Stanislaus County,1,17,7822,3112,4710
California,Stanislaus County,1,18,7409,2582,4827
California,Stanislaus County,2,0,514451,254487,259964
California,Stanislaus County,2,1,39779,20327,19452
California,Stanislaus County,2,2,40013,20402,19611
California,Stanislaus County,2,3,41276,21399,19877
California,Stanislaus County,2,4,42807,22193,20614
California,Stanislaus County,2,5,37119,18792,18327
California,Stanislaus County,2,6,36474,18326,18148
California,Stanislaus County,2,7,33720,16883,16837
California,Stanislaus County,2,8,33125,16465,16660
California,Stanislaus County,2,9,33601,16678,16923
California,Stanislaus County,2,10,35785,17703,18082
California,Stanislaus County,2,11,33773,16605,17168
California,Stanislaus County,2,12,28543,13852,14691
California,Stanislaus County,2,13,23605,11236,12369
California,Stanislaus County,2,14,16929,7868,9061
California,Stanislaus County,2,15,12708,5756,6952
California,Stanislaus County,2,16,9963,4308,5655
California,Stanislaus County,2,17,7822,3112,4710
California,Stanislaus County,2,18,7409,2582,4827
California,Stanislaus County,3,0,515165,254812,260353
California,Stanislaus County,3,1,39729,20306,19423
California,Stanislaus County,3,2,40016,20413,19603
California,Stanislaus County,3,3,41109,21278,19831
California,Stanislaus County,3,4,42466,22057,20409
California,Stanislaus County,3,5,37528,18984,18544
California,Stanislaus County,3,6,36522,18361,18161
California,Stanislaus County,3,7,33868,16942,16926
California,Stanislaus County,3,8,33013,16407,16606
California,Stanislaus County,3,9,33618,16669,16949
California,Stanislaus County,3,10,35566,17576,17990
California,Stanislaus County,3,11,33962,16723,17239
California,Stanislaus County,3,12,28814,13987,14827
California,Stanislaus County,3,13,23851,11371,12480
California,Stanislaus County,3,14,17098,7949,9149
California,Stanislaus County,3,15,12749,5772,6977
California,Stanislaus County,3,16,9991,4316,5675
California,Stanislaus County,3,17,7810,3109,4701
California,Stanislaus County,3,18,7455,2592,4863
California,Stanislaus County,4,0,517614,255953,261661
California,Stanislaus County,4,1,39619,20254,19365
California,Stanislaus County,4,2,40041,20480,19561
California,Stanislaus County,4,3,40525,20812,19713
California,Stanislaus County,4,4,41311,21622,19689
California,Stanislaus County,4,5,38827,19509,19318
California,Stanislaus County,4,6,36455,18320,18135
California,Stanislaus County,4,7,34589,17368,17221
California,Stanislaus County,4,8,32338,16076,16262
California,Stanislaus County,4,9,33771,16723,17048
California,Stanislaus County,4,10,34494,16967,17527
California,Stanislaus County,4,11,34456,17005,17451
California,Stanislaus County,4,12,29768,14454,15314
California,Stanislaus County,4,13,24899,11915,12984
California,Stanislaus County,4,14,17878,8373,9505
California,Stanislaus County,4,15,12998,5869,7129
California,Stanislaus County,4,16,10213,4421,5792
California,Stanislaus County,4,17,7729,3101,4628
California,Stanislaus County,4,18,7703,2684,5019
California,Stanislaus County,5,0,520594,257331,263263
California,Stanislaus County,5,1,39343,20162,19181
California,Stanislaus County,5,2,40373,20583,19790
California,Stanislaus County,5,3,40234,20607,19627
California,Stanislaus County,5,4,40591,21142,19449
California,Stanislaus County,5,5,39293,19741,19552
California,Stanislaus County,5,6,36809,18533,18276
California,Stanislaus County,5,7,34992,17495,17497
California,Stanislaus County,5,8,32386,16142,16244
California,Stanislaus County,5,9,33688,16694,16994
California,Stanislaus County,5,10,33647,16543,17104
California,Stanislaus County,5,11,34571,17084,17487
California,Stanislaus County,5,12,30605,14899,15706
California,Stanislaus County,5,13,25043,12010,13033
California,Stanislaus County,5,14,19423,9143,10280
California,Stanislaus County,5,15,13591,6156,7435
California,Stanislaus County,5,16,10453,4525,5928
California,Stanislaus County,5,17,7677,3101,4576
California,Stanislaus County,5,18,7875,2771,5104
California,Stanislaus County,6,0,523722,258958,264764
California,Stanislaus County,6,1,38793,19819,18974
California,Stanislaus County,6,2,40567,20597,19970
California,Stanislaus County,6,3,40367,20730,19637
California,Stanislaus County,6,4,39994,20708,19286
California,Stanislaus County,6,5,39156,19876,19280
California,Stanislaus County,6,6,37149,18772,18377
California,Stanislaus County,6,7,35708,17939,17769
California,Stanislaus County,6,8,32808,16371,16437
California,Stanislaus County,6,9,33423,16596,16827
California,Stanislaus County,6,10,33076,16282,16794
California,Stanislaus County,6,11,34682,17103,17579
California,Stanislaus County,6,12,31031,15083,15948
California,Stanislaus County,6,13,25695,12347,13348
California,Stanislaus County,6,14,20413,9596,10817
California,Stanislaus County,6,15,14363,6525,7838
California,Stanislaus County,6,16,10700,4604,6096
California,Stanislaus County,6,17,7748,3186,4562
California,Stanislaus County,6,18,8049,2824,5225
California,Stanislaus County,7,0,528346,261312,267034
California,Stanislaus County,7,1,38992,19904,19088
California,Stanislaus County,7,2,40936,20792,20144
California,Stanislaus County,7,3,40389,20713,19676
California,Stanislaus County,7,4,39454,20354,19100
California,Stanislaus County,7,5,39154,20015,19139
California,Stanislaus County,7,6,37865,19087,18778
California,Stanislaus County,7,7,36361,18319,18042
California,Stanislaus County,7,8,33254,16656,16598
California,Stanislaus County,7,9,32941,16366,16575
California,Stanislaus County,7,10,32789,16196,16593
California,Stanislaus County,7,11,34779,17067,17712
California,Stanislaus County,7,12,31550,15323,16227
California,Stanislaus County,7,13,26429,12700,13729
California,Stanislaus County,7,14,21413,10080,11333
California,Stanislaus County,7,15,15019,6829,8190
California,Stanislaus County,7,16,10975,4783,6192
California,Stanislaus County,7,17,7857,3252,4605
California,Stanislaus County,7,18,8189,2876,5313
California,Stanislaus County,8,0,533534,264004,269530
California,Stanislaus County,8,1,39123,19953,19170
California,Stanislaus County,8,2,41300,20992,20308
California,Stanislaus County,8,3,40622,20788,19834
California,Stanislaus County,8,4,39274,20227,19047
California,Stanislaus County,8,5,38402,19667,18735
California,Stanislaus County,8,6,38969,19672,19297
California,Stanislaus County,8,7,36957,18667,18290
California,Stanislaus County,8,8,34114,17116,16998
California,Stanislaus County,8,9,32613,16276,16337
California,Stanislaus County,8,10,32856,16249,16607
California,Stanislaus County,8,11,34281,16767,17514
California,Stanislaus County,8,12,32247,15755,16492
California,Stanislaus County,8,13,27035,13044,13991
California,Stanislaus County,8,14,22371,10402,11969
California,Stanislaus County,8,15,15755,7203,8552
California,Stanislaus County,8,16,11183,4901,6282
California,Stanislaus County,8,17,8036,3326,4710
California,Stanislaus County,8,18,8396,2999,5397
California,Stanislaus County,9,0,539542,266836,272706
California,Stanislaus County,9,1,39416,20048,19368
California,Stanislaus County,9,2,41711,21134,20577
California,Stanislaus County,9,3,41312,21196,20116
California,Stanislaus County,9,4,39180,20154,19026
California,Stanislaus County,9,5,37409,19220,18189
California,Stanislaus County,9,6,40668,20480,20188
California,Stanislaus County,9,7,37572,19008,18564
California,Stanislaus County,9,8,35052,17515,17537
California,Stanislaus County,9,9,32367,16161,16206
California,Stanislaus County,9,10,33171,16390,16781
California,Stanislaus County,9,11,33493,16384,17109
California,Stanislaus County,9,12,32734,15970,16764
California,Stanislaus County,9,13,27875,13413,14462
California,Stanislaus County,9,14,23175,10826,12349
California,Stanislaus County,9,15,16409,7531,8878
California,Stanislaus County,9,16,11341,4986,6355
California,Stanislaus County,9,17,8210,3373,4837
California,Stanislaus County,9,18,8447,3047,5400
California,Stanislaus County,10,0,545267,269866,275401
California,Stanislaus County,10,1,39721,20332,19389
California,Stanislaus County,10,2,41645,21075,20570
California,Stanislaus County,10,3,42115,21409,20706
California,Stanislaus County,10,4,39219,20231,18988
California,Stanislaus County,10,5,37309,19152,18157
California,Stanislaus County,10,6,41117,20701,20416
California,Stanislaus County,10,7,38045,19388,18657
California,Stanislaus County,10,8,35851,17913,17938
California,Stanislaus County,10,9,32658,16379,16279
California,Stanislaus County,10,10,33276,16425,16851
California,Stanislaus County,10,11,32923,16162,16761
California,Stanislaus County,10,12,32986,16117,16869
California,Stanislaus County,10,13,28618,13800,14818
California,Stanislaus County,10,14,23317,10839,12478
California,Stanislaus County,10,15,17763,8169,9594
California,Stanislaus County,10,16,11764,5190,6574
California,Stanislaus County,10,17,8421,3467,4954
California,Stanislaus County,10,18,8519,3117,5402
California,Stanislaus County,11,0,549815,272316,277499
California,Stanislaus County,11,1,39758,20338,19420
California,Stanislaus County,11,2,41581,21069,20512
California,Stanislaus County,11,3,42621,21632,20989
California,Stanislaus County,11,4,39385,20324,19061
California,Stanislaus County,11,5,36896,18851,18045
California,Stanislaus County,11,6,41085,20769,20316
California,Stanislaus County,11,7,38591,19648,18943
California,Stanislaus County,11,8,36614,18462,18152
California,Stanislaus County,11,9,33193,16664,16529
California,Stanislaus County,11,10,33115,16425,16690
California,Stanislaus County,11,11,32368,15917,16451
California,Stanislaus County,11,12,33128,16173,16955
California,Stanislaus County,11,13,29161,14062,15099
California,Stanislaus County,11,14,23831,11075,12756
California,Stanislaus County,11,15,18614,8543,10071
California,Stanislaus County,11,16,12471,5521,6950
California,Stanislaus County,11,17,8608,3546,5062
California,Stanislaus County,11,18,8795,3297,5498
California,Sutter County,1,0,94737,47001,47736
California,Sutter County,1,1,7153,3621,3532
California,Sutter County,1,2,7292,3763,3529
California,Sutter County,1,3,7146,3615,3531
California,Sutter County,1,4,7377,3916,3461
California,Sutter County,1,5,6286,3307,2979
California,Sutter County,1,6,6528,3218,3310
California,Sutter County,1,7,6138,3116,3022
California,Sutter County,1,8,5879,2950,2929
California,Sutter County,1,9,6101,3002,3099
California,Sutter County,1,10,6548,3273,3275
California,Sutter County,1,11,6194,3054,3140
California,Sutter County,1,12,5412,2659,2753
California,Sutter County,1,13,4693,2254,2439
California,Sutter County,1,14,3612,1654,1958
California,Sutter County,1,15,2878,1345,1533
California,Sutter County,1,16,2346,1089,1257
California,Sutter County,1,17,1633,660,973
California,Sutter County,1,18,1521,505,1016
California,Sutter County,2,0,94756,47011,47745
California,Sutter County,2,1,7153,3621,3532
California,Sutter County,2,2,7292,3763,3529
California,Sutter County,2,3,7148,3615,3533
California,Sutter County,2,4,7378,3916,3462
California,Sutter County,2,5,6287,3307,2980
California,Sutter County,2,6,6528,3218,3310
California,Sutter County,2,7,6138,3116,3022
California,Sutter County,2,8,5880,2951,2929
California,Sutter County,2,9,6102,3002,3100
California,Sutter County,2,10,6550,3275,3275
California,Sutter County,2,11,6196,3055,3141
California,Sutter County,2,12,5414,2661,2753
California,Sutter County,2,13,4696,2256,2440
California,Sutter County,2,14,3615,1655,1960
California,Sutter County,2,15,2879,1346,1533
California,Sutter County,2,16,2346,1089,1257
California,Sutter County,2,17,1633,660,973
California,Sutter County,2,18,1521,505,1016
California,Sutter County,3,0,94753,47019,47734
California,Sutter County,3,1,7123,3610,3513
California,Sutter County,3,2,7264,3738,3526
California,Sutter County,3,3,7163,3625,3538
California,Sutter County,3,4,7285,3865,3420
California,Sutter County,3,5,6355,3331,3024
California,Sutter County,3,6,6530,3241,3289
California,Sutter County,3,7,6138,3117,3021
California,Sutter County,3,8,5856,2921,2935
California,Sutter County,3,9,6071,2992,3079
California,Sutter County,3,10,6537,3274,3263
California,Sutter County,3,11,6224,3070,3154
California,Sutter County,3,12,5430,2669,2761
California,Sutter County,3,13,4737,2281,2456
California,Sutter County,3,14,3635,1659,1976
California,Sutter County,3,15,2878,1347,1531
California,Sutter County,3,16,2354,1096,1258
California,Sutter County,3,17,1649,678,971
California,Sutter County,3,18,1524,505,1019
California,Sutter County,4,0,94485,46873,47612
California,Sutter County,4,1,6919,3540,3379
California,Sutter County,4,2,7245,3717,3528
California,Sutter County,4,3,7047,3558,3489
California,Sutter County,4,4,6994,3707,3287
California,Sutter County,4,5,6616,3418,3198
California,Sutter County,4,6,6538,3267,3271
California,Sutter County,4,7,6120,3115,3005
California,Sutter County,4,8,5672,2770,2902
California,Sutter County,4,9,5945,2960,2985
California,Sutter County,4,10,6434,3251,3183
California,Sutter County,4,11,6270,3087,3183
California,Sutter County,4,12,5536,2701,2835
California,Sutter County,4,13,4885,2376,2509
California,Sutter County,4,14,3707,1673,2034
California,Sutter County,4,15,2886,1343,1543
California,Sutter County,4,16,2389,1111,1278
California,Sutter County,4,17,1720,757,963
California,Sutter County,4,18,1562,522,1040
California,Sutter County,5,0,94210,46816,47394
California,Sutter County,5,1,6709,3437,3272
California,Sutter County,5,2,7279,3743,3536
California,Sutter County,5,3,7085,3591,3494
California,Sutter County,5,4,6732,3535,3197
California,Sutter County,5,5,6713,3483,3230
California,Sutter County,5,6,6463,3302,3161
California,Sutter County,5,7,6064,3021,3043
California,Sutter County,5,8,5640,2801,2839
California,Sutter County,5,9,5854,2916,2938
California,Sutter County,5,10,6150,3094,3056
California,Sutter County,5,11,6303,3112,3191
California,Sutter County,5,12,5695,2761,2934
California,Sutter County,5,13,4807,2364,2443
California,Sutter County,5,14,3915,1795,2120
California,Sutter County,5,15,2970,1389,1581
California,Sutter County,5,16,2436,1085,1351
California,Sutter County,5,17,1763,806,957
California,Sutter County,5,18,1632,581,1051
California,Sutter County,6,0,94545,47010,47535
California,Sutter County,6,1,6560,3361,3199
California,Sutter County,6,2,7243,3748,3495
California,Sutter County,6,3,7055,3573,3482
California,Sutter County,6,4,6632,3452,3180
California,Sutter County,6,5,6734,3486,3248
California,Sutter County,6,6,6533,3334,3199
California,Sutter County,6,7,6081,3046,3035
California,Sutter County,6,8,5654,2830,2824
California,Sutter County,6,9,5862,2912,2950
California,Sutter County,6,10,5991,2988,3003
California,Sutter County,6,11,6365,3145,3220
California,Sutter County,6,12,5843,2882,2961
California,Sutter County,6,13,4785,2334,2451
California,Sutter County,6,14,4101,1930,2171
California,Sutter County,6,15,3101,1417,1684
California,Sutter County,6,16,2475,1124,1351
California,Sutter County,6,17,1844,838,1006
California,Sutter County,6,18,1686,610,1076
California,Sutter County,7,0,94830,47102,47728
California,Sutter County,7,1,6491,3392,3099
California,Sutter County,7,2,7185,3670,3515
California,Sutter County,7,3,7168,3674,3494
California,Sutter County,7,4,6574,3377,3197
California,Sutter County,7,5,6619,3429,3190
California,Sutter County,7,6,6533,3342,3191
California,Sutter County,7,7,6236,3061,3175
California,Sutter County,7,8,5690,2881,2809
California,Sutter County,7,9,5743,2871,2872
California,Sutter County,7,10,5779,2843,2936
California,Sutter County,7,11,6337,3136,3201
California,Sutter County,7,12,5945,2912,3033
California,Sutter County,7,13,4919,2393,2526
California,Sutter County,7,14,4269,2028,2241
California,Sutter County,7,15,3217,1455,1762
California,Sutter County,7,16,2476,1121,1355
California,Sutter County,7,17,1906,876,1030
California,Sutter County,7,18,1743,641,1102
California,Sutter County,8,0,95388,47344,48044
California,Sutter County,8,1,6549,3386,3163
California,Sutter County,8,2,7066,3626,3440
California,Sutter County,8,3,7192,3729,3463
California,Sutter County,8,4,6533,3342,3191
California,Sutter County,8,5,6527,3404,3123
California,Sutter County,8,6,6670,3357,3313
California,Sutter County,8,7,6234,3069,3165
California,Sutter County,8,8,5850,2965,2885
California,Sutter County,8,9,5615,2779,2836
California,Sutter County,8,10,5759,2832,2927
California,Sutter County,8,11,6244,3097,3147
California,Sutter County,8,12,5992,2940,3052
California,Sutter County,8,13,5142,2502,2640
California,Sutter County,8,14,4399,2132,2267
California,Sutter County,8,15,3327,1476,1851
California,Sutter County,8,16,2495,1119,1376
California,Sutter County,8,17,1977,914,1063
California,Sutter County,8,18,1817,675,1142
California,Sutter County,9,0,95898,47703,48195
California,Sutter County,9,1,6628,3407,3221
California,Sutter County,9,2,7117,3651,3466
California,Sutter County,9,3,7205,3733,3472
California,Sutter County,9,4,6567,3372,3195
California,Sutter County,9,5,6274,3327,2947
California,Sutter County,9,6,6921,3526,3395
California,Sutter County,9,7,6274,3118,3156
California,Sutter County,9,8,5940,2995,2945
California,Sutter County,9,9,5584,2736,2848
California,Sutter County,9,10,5659,2807,2852
California,Sutter County,9,11,6124,3079,3045
California,Sutter County,9,12,6006,2922,3084
California,Sutter County,9,13,5289,2567,2722
California,Sutter County,9,14,4462,2165,2297
California,Sutter County,9,15,3414,1497,1917
California,Sutter County,9,16,2523,1147,1376
California,Sutter County,9,17,1967,900,1067
California,Sutter County,9,18,1944,754,1190
California,Sutter County,10,0,96438,47995,48443
California,Sutter County,10,1,6693,3489,3204
California,Sutter County,10,2,6962,3594,3368
California,Sutter County,10,3,7297,3766,3531
California,Sutter County,10,4,6533,3341,3192
California,Sutter County,10,5,6136,3198,2938
California,Sutter County,10,6,7155,3689,3466
California,Sutter County,10,7,6365,3215,3150
California,Sutter County,10,8,6042,3010,3032
California,Sutter County,10,9,5553,2743,2810
California,Sutter County,10,10,5673,2808,2865
California,Sutter County,10,11,5927,2954,2973
California,Sutter County,10,12,6077,2934,3143
California,Sutter County,10,13,5479,2673,2806
California,Sutter County,10,14,4385,2122,2263
California,Sutter County,10,15,3577,1621,1956
California,Sutter County,10,16,2649,1192,1457
California,Sutter County,10,17,1995,884,1111
California,Sutter County,10,18,1940,762,1178
California,Sutter County,11,0,96807,48222,48585
California,Sutter County,11,1,6735,3516,3219
California,Sutter County,11,2,6752,3492,3260
California,Sutter County,11,3,7286,3755,3531
California,Sutter County,11,4,6573,3377,3196
California,Sutter County,11,5,6059,3160,2899
California,Sutter County,11,6,7158,3666,3492
California,Sutter County,11,7,6554,3346,3208
California,Sutter County,11,8,6087,3016,3071
California,Sutter County,11,9,5602,2803,2799
California,Sutter County,11,10,5630,2778,2852
California,Sutter County,11,11,5816,2880,2936
California,Sutter County,11,12,6037,2932,3105
California,Sutter County,11,13,5616,2740,2876
California,Sutter County,11,14,4396,2111,2285
California,Sutter County,11,15,3747,1769,1978
California,Sutter County,11,16,2766,1191,1575
California,Sutter County,11,17,2021,932,1089
California,Sutter County,11,18,1972,758,1214
California,Tehama County,1,0,63463,31610,31853
California,Tehama County,1,1,4409,2263,2146
California,Tehama County,1,2,4326,2217,2109
California,Tehama County,1,3,4431,2242,2189
California,Tehama County,1,4,4654,2429,2225
California,Tehama County,1,5,3656,1841,1815
California,Tehama County,1,6,3652,1922,1730
California,Tehama County,1,7,3436,1779,1657
California,Tehama County,1,8,3551,1792,1759
California,Tehama County,1,9,3765,1888,1877
California,Tehama County,1,10,4641,2270,2371
California,Tehama County,1,11,4613,2268,2345
California,Tehama County,1,12,4197,2023,2174
California,Tehama County,1,13,4061,2023,2038
California,Tehama County,1,14,3224,1514,1710
California,Tehama County,1,15,2496,1197,1299
California,Tehama County,1,16,1899,923,976
California,Tehama County,1,17,1273,577,696
California,Tehama County,1,18,1179,442,737
California,Tehama County,2,0,63440,31600,31840
California,Tehama County,2,1,4407,2262,2145
California,Tehama County,2,2,4323,2216,2107
California,Tehama County,2,3,4430,2242,2188
California,Tehama County,2,4,4654,2429,2225
California,Tehama County,2,5,3655,1841,1814
California,Tehama County,2,6,3650,1920,1730
California,Tehama County,2,7,3431,1778,1653
California,Tehama County,2,8,3551,1792,1759
California,Tehama County,2,9,3765,1888,1877
California,Tehama County,2,10,4640,2269,2371
California,Tehama County,2,11,4612,2268,2344
California,Tehama County,2,12,4196,2022,2174
California,Tehama County,2,13,4059,2022,2037
California,Tehama County,2,14,3224,1514,1710
California,Tehama County,2,15,2494,1196,1298
California,Tehama County,2,16,1897,922,975
California,Tehama County,2,17,1273,577,696
California,Tehama County,2,18,1179,442,737
California,Tehama County,3,0,63565,31643,31922
California,Tehama County,3,1,4384,2247,2137
California,Tehama County,3,2,4322,2222,2100
California,Tehama County,3,3,4433,2234,2199
California,Tehama County,3,4,4642,2413,2229
California,Tehama County,3,5,3689,1861,1828
California,Tehama County,3,6,3652,1908,1744
California,Tehama County,3,7,3464,1794,1670
California,Tehama County,3,8,3548,1793,1755
California,Tehama County,3,9,3752,1886,1866
California,Tehama County,3,10,4613,2254,2359
California,Tehama County,3,11,4638,2286,2352
California,Tehama County,3,12,4207,2019,2188
California,Tehama County,3,13,4101,2044,2057
California,Tehama County,3,14,3228,1520,1708
California,Tehama County,3,15,2512,1204,1308
California,Tehama County,3,16,1899,925,974
California,Tehama County,3,17,1295,587,708
California,Tehama County,3,18,1186,446,740
California,Tehama County,4,0,63336,31562,31774
California,Tehama County,4,1,4206,2168,2038
California,Tehama County,4,2,4272,2230,2042
California,Tehama County,4,3,4363,2198,2165
California,Tehama County,4,4,4519,2338,2181
California,Tehama County,4,5,3717,1920,1797
California,Tehama County,4,6,3620,1867,1753
California,Tehama County,4,7,3566,1835,1731
California,Tehama County,4,8,3445,1765,1680
California,Tehama County,4,9,3666,1828,1838
California,Tehama County,4,10,4398,2171,2227
California,Tehama County,4,11,4709,2332,2377
California,Tehama County,4,12,4246,2003,2243
California,Tehama County,4,13,4289,2139,2150
California,Tehama County,4,14,3241,1528,1713
California,Tehama County,4,15,2600,1257,1343
California,Tehama County,4,16,1942,936,1006
California,Tehama County,4,17,1345,603,742
California,Tehama County,4,18,1192,444,748
California,Tehama County,5,0,63227,31516,31711
California,Tehama County,5,1,3991,2084,1907
California,Tehama County,5,2,4361,2264,2097
California,Tehama County,5,3,4295,2190,2105
California,Tehama County,5,4,4301,2198,2103
California,Tehama County,5,5,3734,1933,1801
California,Tehama County,5,6,3687,1904,1783
California,Tehama County,5,7,3522,1806,1716
California,Tehama County,5,8,3445,1792,1653
California,Tehama County,5,9,3641,1806,1835
California,Tehama County,5,10,4174,2066,2108
California,Tehama County,5,11,4736,2325,2411
California,Tehama County,5,12,4333,2070,2263
California,Tehama County,5,13,4205,2069,2136
California,Tehama County,5,14,3537,1703,1834
California,Tehama County,5,15,2688,1294,1394
California,Tehama County,5,16,1963,923,1040
California,Tehama County,5,17,1363,618,745
California,Tehama County,5,18,1251,471,780
California,Tehama County,6,0,62898,31312,31586
California,Tehama County,6,1,3883,2003,1880
California,Tehama County,6,2,4324,2202,2122
California,Tehama County,6,3,4176,2145,2031
California,Tehama County,6,4,4186,2138,2048
California,Tehama County,6,5,3840,1982,1858
California,Tehama County,6,6,3637,1858,1779
California,Tehama County,6,7,3534,1813,1721
California,Tehama County,6,8,3383,1780,1603
California,Tehama County,6,9,3577,1781,1796
California,Tehama County,6,10,3919,1944,1975
California,Tehama County,6,11,4819,2366,2453
California,Tehama County,6,12,4393,2125,2268
California,Tehama County,6,13,4115,1989,2126
California,Tehama County,6,14,3685,1791,1894
California,Tehama County,6,15,2811,1349,1462
California,Tehama County,6,16,2023,933,1090
California,Tehama County,6,17,1340,636,704
California,Tehama County,6,18,1253,477,776
California,Tehama County,7,0,62788,31193,31595
California,Tehama County,7,1,3901,1996,1905
California,Tehama County,7,2,4322,2206,2116
California,Tehama County,7,3,4160,2145,2015
California,Tehama County,7,4,4100,2111,1989
California,Tehama County,7,5,3867,2025,1842
California,Tehama County,7,6,3575,1779,1796
California,Tehama County,7,7,3569,1845,1724
California,Tehama County,7,8,3387,1750,1637
California,Tehama County,7,9,3507,1760,1747
California,Tehama County,7,10,3745,1855,1890
California,Tehama County,7,11,4790,2320,2470
California,Tehama County,7,12,4430,2164,2266
California,Tehama County,7,13,4091,1951,2140
California,Tehama County,7,14,3792,1864,1928
California,Tehama County,7,15,2864,1337,1527
California,Tehama County,7,16,2080,965,1115
California,Tehama County,7,17,1368,652,716
California,Tehama County,7,18,1240,468,772
California,Tehama County,8,0,63090,31365,31725
California,Tehama County,8,1,3925,1986,1939
California,Tehama County,8,2,4370,2263,2107
California,Tehama County,8,3,4237,2211,2026
California,Tehama County,8,4,3975,2019,1956
California,Tehama County,8,5,3818,1974,1844
California,Tehama County,8,6,3705,1851,1854
California,Tehama County,8,7,3593,1853,1740
California,Tehama County,8,8,3470,1788,1682
California,Tehama County,8,9,3461,1758,1703
California,Tehama County,8,10,3633,1811,1822
California,Tehama County,8,11,4548,2185,2363
California,Tehama County,8,12,4622,2260,2362
California,Tehama County,8,13,4132,1971,2161
California,Tehama County,8,14,3885,1929,1956
California,Tehama County,8,15,2864,1316,1548
California,Tehama County,8,16,2132,1025,1107
California,Tehama County,8,17,1426,674,752
California,Tehama County,8,18,1294,491,803
California,Tehama County,9,0,63352,31461,31891
California,Tehama County,9,1,4021,2003,2018
California,Tehama County,9,2,4343,2255,2088
California,Tehama County,9,3,4278,2225,2053
California,Tehama County,9,4,3952,2015,1937
California,Tehama County,9,5,3599,1891,1708
California,Tehama County,9,6,3858,1941,1917
California,Tehama County,9,7,3647,1878,1769
California,Tehama County,9,8,3549,1794,1755
California,Tehama County,9,9,3395,1743,1652
California,Tehama County,9,10,3604,1789,1815
California,Tehama County,9,11,4388,2119,2269
California,Tehama County,9,12,4677,2294,2383
California,Tehama County,9,13,4116,1940,2176
California,Tehama County,9,14,4080,1996,2084
California,Tehama County,9,15,2843,1327,1516
California,Tehama County,9,16,2198,1035,1163
California,Tehama County,9,17,1463,692,771
California,Tehama County,9,18,1341,524,817
California,Tehama County,10,0,63718,31590,32128
California,Tehama County,10,1,4129,2059,2070
California,Tehama County,10,2,4228,2191,2037
California,Tehama County,10,3,4394,2260,2134
California,Tehama County,10,4,3955,2016,1939
California,Tehama County,10,5,3599,1881,1718
California,Tehama County,10,6,3885,1978,1907
California,Tehama County,10,7,3701,1892,1809
California,Tehama County,10,8,3543,1776,1767
California,Tehama County,10,9,3430,1782,1648
California,Tehama County,10,10,3543,1744,1799
California,Tehama County,10,11,4189,2052,2137
California,Tehama County,10,12,4740,2260,2480
California,Tehama County,10,13,4234,2032,2202
California,Tehama County,10,14,3940,1910,2030
California,Tehama County,10,15,3080,1459,1621
California,Tehama County,10,16,2310,1083,1227
California,Tehama County,10,17,1453,676,777
California,Tehama County,10,18,1365,539,826
California,Tehama County,11,0,63916,31743,32173
California,Tehama County,11,1,4119,2083,2036
California,Tehama County,11,2,4201,2165,2036
California,Tehama County,11,3,4488,2298,2190
California,Tehama County,11,4,3922,2011,1911
California,Tehama County,11,5,3501,1834,1667
California,Tehama County,11,6,4027,2071,1956
California,Tehama County,11,7,3693,1880,1813
California,Tehama County,11,8,3639,1863,1776
California,Tehama County,11,9,3418,1740,1678
California,Tehama County,11,10,3548,1796,1752
California,Tehama County,11,11,3932,1924,2008
California,Tehama County,11,12,4790,2255,2535
California,Tehama County,11,13,4249,2060,2189
California,Tehama County,11,14,3866,1832,2034
California,Tehama County,11,15,3222,1548,1674
California,Tehama County,11,16,2397,1127,1270
California,Tehama County,11,17,1521,696,825
California,Tehama County,11,18,1383,560,823
California,Trinity County,1,0,13786,7113,6673
California,Trinity County,1,1,618,333,285
California,Trinity County,1,2,640,333,307
California,Trinity County,1,3,744,353,391
California,Trinity County,1,4,789,404,385
California,Trinity County,1,5,544,304,240
California,Trinity County,1,6,641,360,281
California,Trinity County,1,7,630,333,297
California,Trinity County,1,8,664,345,319
California,Trinity County,1,9,724,373,351
California,Trinity County,1,10,1072,527,545
California,Trinity County,1,11,1254,613,641
California,Trinity County,1,12,1401,721,680
California,Trinity County,1,13,1296,687,609
California,Trinity County,1,14,1003,547,456
California,Trinity County,1,15,671,365,306
California,Trinity County,1,16,505,243,262
California,Trinity County,1,17,332,170,162
California,Trinity County,1,18,258,102,156
California,Trinity County,2,0,13784,7112,6672
California,Trinity County,2,1,618,333,285
California,Trinity County,2,2,640,333,307
California,Trinity County,2,3,744,353,391
California,Trinity County,2,4,789,404,385
California,Trinity County,2,5,544,304,240
California,Trinity County,2,6,641,360,281
California,Trinity County,2,7,630,333,297
California,Trinity County,2,8,664,345,319
California,Trinity County,2,9,724,373,351
California,Trinity County,2,10,1072,527,545
California,Trinity County,2,11,1254,613,641
California,Trinity County,2,12,1399,720,679
California,Trinity County,2,13,1296,687,609
California,Trinity County,2,14,1003,547,456
California,Trinity County,2,15,671,365,306
California,Trinity County,2,16,505,243,262
California,Trinity County,2,17,332,170,162
California,Trinity County,2,18,258,102,156
California,Trinity County,3,0,13754,7088,6666
California,Trinity County,3,1,608,322,286
California,Trinity County,3,2,652,342,310
California,Trinity County,3,3,730,346,384
California,Trinity County,3,4,784,401,383
California,Trinity County,3,5,548,308,240
California,Trinity County,3,6,638,357,281
California,Trinity County,3,7,631,334,297
California,Trinity County,3,8,663,340,323
California,Trinity County,3,9,723,374,349
California,Trinity County,3,10,1054,519,535
California,Trinity County,3,11,1251,605,646
California,Trinity County,3,12,1396,717,679
California,Trinity County,3,13,1308,689,619
California,Trinity County,3,14,997,550,447
California,Trinity County,3,15,676,369,307
California,Trinity County,3,16,503,242,261
California,Trinity County,3,17,336,171,165
California,Trinity County,3,18,256,102,154
California,Trinity County,4,0,13681,7049,6632
California,Trinity County,4,1,597,308,289
California,Trinity County,4,2,688,371,317
California,Trinity County,4,3,670,316,354
California,Trinity County,4,4,776,405,371
California,Trinity County,4,5,541,301,240
California,Trinity County,4,6,617,332,285
California,Trinity County,4,7,641,337,304
California,Trinity County,4,8,651,338,313
California,Trinity County,4,9,727,393,334
California,Trinity County,4,10,959,470,489
California,Trinity County,4,11,1244,600,644
California,Trinity County,4,12,1388,709,679
California,Trinity County,4,13,1354,700,654
California,Trinity County,4,14,1001,553,448
California,Trinity County,4,15,718,388,330
California,Trinity County,4,16,506,249,257
California,Trinity County,4,17,331,160,171
California,Trinity County,4,18,272,119,153
California,Trinity County,5,0,13486,6931,6555
California,Trinity County,5,1,578,283,295
California,Trinity County,5,2,653,367,286
California,Trinity County,5,3,621,293,328
California,Trinity County,5,4,739,380,359
California,Trinity County,5,5,551,317,234
California,Trinity County,5,6,566,305,261
California,Trinity County,5,7,663,347,316
California,Trinity County,5,8,643,324,319
California,Trinity County,5,9,704,376,328
California,Trinity County,5,10,882,448,434
California,Trinity County,5,11,1191,575,616
California,Trinity County,5,12,1385,695,690
California,Trinity County,5,13,1344,689,655
California,Trinity County,5,14,1084,592,492
California,Trinity County,5,15,742,392,350
California,Trinity County,5,16,520,268,252
California,Trinity County,5,17,337,160,177
California,Trinity County,5,18,283,120,163
California,Trinity County,6,0,13427,6881,6546
California,Trinity County,6,1,603,302,301
California,Trinity County,6,2,650,351,299
California,Trinity County,6,3,609,299,310
California,Trinity County,6,4,707,354,353
California,Trinity County,6,5,578,325,253
California,Trinity County,6,6,552,288,264
California,Trinity County,6,7,665,350,315
California,Trinity County,6,8,635,317,318
California,Trinity County,6,9,686,373,313
California,Trinity County,6,10,786,406,380
California,Trinity County,6,11,1136,551,585
California,Trinity County,6,12,1366,648,718
California,Trinity County,6,13,1346,701,645
California,Trinity County,6,14,1141,616,525
California,Trinity County,6,15,797,430,367
California,Trinity County,6,16,516,273,243
California,Trinity County,6,17,355,168,187
California,Trinity County,6,18,299,129,170
California,Trinity County,7,0,13123,6698,6425
California,Trinity County,7,1,581,288,293
California,Trinity County,7,2,607,311,296
California,Trinity County,7,3,603,320,283
California,Trinity County,7,4,674,324,350
California,Trinity County,7,5,579,300,279
California,Trinity County,7,6,526,279,247
California,Trinity County,7,7,664,361,303
California,Trinity County,7,8,613,301,312
California,Trinity County,7,9,644,337,307
California,Trinity County,7,10,722,383,339
California,Trinity County,7,11,1075,532,543
California,Trinity County,7,12,1288,605,683
California,Trinity County,7,13,1372,708,664
California,Trinity County,7,14,1161,618,543
California,Trinity County,7,15,826,442,384
California,Trinity County,7,16,519,289,230
California,Trinity County,7,17,374,167,207
California,Trinity County,7,18,295,133,162
California,Trinity County,8,0,13094,6741,6353
California,Trinity County,8,1,588,319,269
California,Trinity County,8,2,605,302,303
California,Trinity County,8,3,628,345,283
California,Trinity County,8,4,633,306,327
California,Trinity County,8,5,570,308,262
California,Trinity County,8,6,500,258,242
California,Trinity County,8,7,696,384,312
California,Trinity County,8,8,654,326,328
California,Trinity County,8,9,649,333,316
California,Trinity County,8,10,689,371,318
California,Trinity County,8,11,1020,499,521
California,Trinity County,8,12,1197,571,626
California,Trinity County,8,13,1407,712,695
California,Trinity County,8,14,1188,626,562
California,Trinity County,8,15,851,474,377
California,Trinity County,8,16,524,289,235
California,Trinity County,8,17,384,178,206
California,Trinity County,8,18,311,140,171
California,Trinity County,9,0,12830,6592,6238
California,Trinity County,9,1,565,312,253
California,Trinity County,9,2,565,285,280
California,Trinity County,9,3,653,365,288
California,Trinity County,9,4,585,290,295
California,Trinity County,9,5,563,296,267
California,Trinity County,9,6,506,254,252
California,Trinity County,9,7,630,330,300
California,Trinity County,9,8,655,333,322
California,Trinity County,9,9,660,341,319
California,Trinity County,9,10,670,356,314
California,Trinity County,9,11,931,457,474
California,Trinity County,9,12,1160,561,599
California,Trinity County,9,13,1375,679,696
California,Trinity County,9,14,1235,639,596
California,Trinity County,9,15,823,463,360
California,Trinity County,9,16,564,297,267
California,Trinity County,9,17,371,181,190
California,Trinity County,9,18,319,153,166
California,Trinity County,10,0,12726,6558,6168
California,Trinity County,10,1,548,303,245
California,Trinity County,10,2,589,300,289
California,Trinity County,10,3,650,359,291
California,Trinity County,10,4,584,299,285
California,Trinity County,10,5,525,272,253
California,Trinity County,10,6,511,274,237
California,Trinity County,10,7,602,314,288
California,Trinity County,10,8,682,345,337
California,Trinity County,10,9,648,329,319
California,Trinity County,10,10,662,347,315
California,Trinity County,10,11,885,447,438
California,Trinity County,10,12,1111,545,566
California,Trinity County,10,13,1367,676,691
California,Trinity County,10,14,1214,630,584
California,Trinity County,10,15,895,497,398
California,Trinity County,10,16,570,288,282
California,Trinity County,10,17,376,193,183
California,Trinity County,10,18,307,140,167
California,Trinity County,11,0,12535,6442,6093
California,Trinity County,11,1,544,296,248
California,Trinity County,11,2,580,300,280
California,Trinity County,11,3,651,361,290
California,Trinity County,11,4,561,289,272
California,Trinity County,11,5,498,261,237
California,Trinity County,11,6,543,272,271
California,Trinity County,11,7,586,303,283
California,Trinity County,11,8,668,340,328
California,Trinity County,11,9,644,317,327
California,Trinity County,11,10,663,359,304
California,Trinity County,11,11,810,416,394
California,Trinity County,11,12,1076,532,544
California,Trinity County,11,13,1291,623,668
California,Trinity County,11,14,1236,644,592
California,Trinity County,11,15,916,500,416
California,Trinity County,11,16,604,306,298
California,Trinity County,11,17,374,189,185
California,Trinity County,11,18,290,134,156
California,Tulare County,1,0,442179,221442,220737
California,Tulare County,1,1,41074,21004,20070
California,Tulare County,1,2,39950,20388,19562
California,Tulare County,1,3,38926,19801,19125
California,Tulare County,1,4,39043,20239,18804
California,Tulare County,1,5,32457,16866,15591
California,Tulare County,1,6,32256,16425,15831
California,Tulare County,1,7,29603,15023,14580
California,Tulare County,1,8,27770,14032,13738
California,Tulare County,1,9,26915,13552,13363
California,Tulare County,1,10,27039,13423,13616
California,Tulare County,1,11,25312,12615,12697
California,Tulare County,1,12,21657,10583,11074
California,Tulare County,1,13,18398,8971,9427
California,Tulare County,1,14,13103,6280,6823
California,Tulare County,1,15,9843,4549,5294
California,Tulare County,1,16,7682,3345,4337
California,Tulare County,1,17,5792,2392,3400
California,Tulare County,1,18,5359,1954,3405
California,Tulare County,2,0,442181,221442,220739
California,Tulare County,2,1,41075,21004,20071
California,Tulare County,2,2,39950,20388,19562
California,Tulare County,2,3,38926,19801,19125
California,Tulare County,2,4,39040,20236,18804
California,Tulare County,2,5,32457,16866,15591
California,Tulare County,2,6,32256,16425,15831
California,Tulare County,2,7,29605,15024,14581
California,Tulare County,2,8,27767,14031,13736
California,Tulare County,2,9,26917,13553,13364
California,Tulare County,2,10,27042,13425,13617
California,Tulare County,2,11,25312,12615,12697
California,Tulare County,2,12,21657,10583,11074
California,Tulare County,2,13,18398,8971,9427
California,Tulare County,2,14,13103,6280,6823
California,Tulare County,2,15,9843,4549,5294
California,Tulare County,2,16,7682,3345,4337
California,Tulare County,2,17,5792,2392,3400
California,Tulare County,2,18,5359,1954,3405
California,Tulare County,3,0,442994,221805,221189
California,Tulare County,3,1,40985,20968,20017
California,Tulare County,3,2,40012,20418,19594
California,Tulare County,3,3,38944,19791,19153
California,Tulare County,3,4,38813,20106,18707
California,Tulare County,3,5,32715,16996,15719
California,Tulare County,3,6,32226,16363,15863
California,Tulare County,3,7,29805,15143,14662
California,Tulare County,3,8,27742,13997,13745
California,Tulare County,3,9,26986,13600,13386
California,Tulare County,3,10,27016,13419,13597
California,Tulare County,3,11,25382,12651,12731
California,Tulare County,3,12,21804,10682,11122
California,Tulare County,3,13,18541,9018,9523
California,Tulare County,3,14,13241,6341,6900
California,Tulare County,3,15,9880,4580,5300
California,Tulare County,3,16,7687,3353,4334
California,Tulare County,3,17,5821,2413,3408
California,Tulare County,3,18,5394,1966,3428
California,Tulare County,4,0,446864,223729,223135
California,Tulare County,4,1,41126,21016,20110
California,Tulare County,4,2,40367,20625,19742
California,Tulare County,4,3,39054,19844,19210
California,Tulare County,4,4,38208,19721,18487
California,Tulare County,4,5,33783,17559,16224
California,Tulare County,4,6,32103,16201,15902
California,Tulare County,4,7,30499,15544,14955
California,Tulare County,4,8,27699,13929,13770
California,Tulare County,4,9,27318,13772,13546
California,Tulare County,4,10,26706,13340,13366
California,Tulare County,4,11,25650,12785,12865
California,Tulare County,4,12,22356,11013,11343
California,Tulare County,4,13,19086,9240,9846
California,Tulare County,4,14,13783,6612,7171
California,Tulare County,4,15,10125,4754,5371
California,Tulare County,4,16,7664,3327,4337
California,Tulare County,4,17,5821,2431,3390
California,Tulare County,4,18,5516,2016,3500
California,Tulare County,5,0,449975,225154,224821
California,Tulare County,5,1,40903,20965,19938
California,Tulare County,5,2,40862,20897,19965
California,Tulare County,5,3,39057,19769,19288
California,Tulare County,5,4,37635,19390,18245
California,Tulare County,5,5,34603,17878,16725
California,Tulare County,5,6,31881,16138,15743
California,Tulare County,5,7,31205,15871,15334
California,Tulare County,5,8,27820,14023,13797
California,Tulare County,5,9,27303,13762,13541
California,Tulare County,5,10,26275,13178,13097
California,Tulare County,5,11,25787,12832,12955
California,Tulare County,5,12,23027,11299,11728
California,Tulare County,5,13,19081,9279,9802
California,Tulare County,5,14,14724,7055,7669
California,Tulare County,5,15,10546,4945,5601
California,Tulare County,5,16,7762,3397,4365
California,Tulare County,5,17,5818,2421,3397
California,Tulare County,5,18,5686,2055,3631
California,Tulare County,6,0,452769,226504,226265
California,Tulare County,6,1,40344,20711,19633
California,Tulare County,6,2,41283,21162,20121
California,Tulare County,6,3,39230,19891,19339
California,Tulare County,6,4,36976,18937,18039
California,Tulare County,6,5,35159,18022,17137
California,Tulare County,6,6,31871,16202,15669
California,Tulare County,6,7,31632,16112,15520
California,Tulare County,6,8,28228,14141,14087
California,Tulare County,6,9,27265,13850,13415
California,Tulare County,6,10,26236,13155,13081
California,Tulare County,6,11,25765,12815,12950
California,Tulare County,6,12,23450,11506,11944
California,Tulare County,6,13,19433,9447,9986
California,Tulare County,6,14,15369,7393,7976
California,Tulare County,6,15,10990,5137,5853
California,Tulare County,6,16,7991,3527,4464
California,Tulare County,6,17,5754,2422,3332
California,Tulare County,6,18,5793,2074,3719
California,Tulare County,7,0,455602,227813,227789
California,Tulare County,7,1,40013,20537,19476
California,Tulare County,7,2,41454,21172,20282
California,Tulare County,7,3,39499,20119,19380
California,Tulare County,7,4,36746,18736,18010
California,Tulare County,7,5,35231,18064,17167
California,Tulare County,7,6,32166,16428,15738
California,Tulare County,7,7,31926,16186,15740
California,Tulare County,7,8,28639,14342,14297
California,Tulare County,7,9,27078,13733,13345
California,Tulare County,7,10,26024,13063,12961
California,Tulare County,7,11,25787,12808,12979
California,Tulare County,7,12,23755,11682,12073
California,Tulare County,7,13,19852,9539,10313
California,Tulare County,7,14,16126,7847,8279
California,Tulare County,7,15,11355,5328,6027
California,Tulare County,7,16,8260,3635,4625
California,Tulare County,7,17,5803,2458,3345
California,Tulare County,7,18,5888,2136,3752
California,Tulare County,8,0,457803,228837,228966
California,Tulare County,8,1,39330,20127,19203
California,Tulare County,8,2,41408,21184,20224
California,Tulare County,8,3,39746,20255,19491
California,Tulare County,8,4,36819,18835,17984
California,Tulare County,8,5,34717,17724,16993
California,Tulare County,8,6,32571,16621,15950
California,Tulare County,8,7,32022,16135,15887
California,Tulare County,8,8,29188,14756,14432
California,Tulare County,8,9,26983,13599,13384
California,Tulare County,8,10,25978,13099,12879
California,Tulare County,8,11,25726,12772,12954
California,Tulare County,8,12,24117,11856,12261
California,Tulare County,8,13,20227,9787,10440
California,Tulare County,8,14,16760,8074,8686
California,Tulare County,8,15,11803,5504,6299
California,Tulare County,8,16,8499,3820,4679
California,Tulare County,8,17,5848,2453,3395
California,Tulare County,8,18,6061,2236,3825
California,Tulare County,9,0,460023,230024,229999
California,Tulare County,9,1,38615,19803,18812
California,Tulare County,9,2,41535,21239,20296
California,Tulare County,9,3,39840,20352,19488
California,Tulare County,9,4,37036,18968,18068
California,Tulare County,9,5,33905,17271,16634
California,Tulare County,9,6,33428,17128,16300
California,Tulare County,9,7,31693,15950,15743
California,Tulare County,9,8,30029,15171,14858
California,Tulare County,9,9,26849,13481,13368
California,Tulare County,9,10,26167,13195,12972
California,Tulare County,9,11,25443,12700,12743
California,Tulare County,9,12,24328,11940,12388
California,Tulare County,9,13,20779,10087,10692
California,Tulare County,9,14,17370,8303,9067
California,Tulare County,9,15,12254,5707,6547
California,Tulare County,9,16,8673,3931,4742
California,Tulare County,9,17,5921,2482,3439
California,Tulare County,9,18,6158,2316,3842
California,Tulare County,10,0,463097,231719,231378
California,Tulare County,10,1,37625,19366,18259
California,Tulare County,10,2,41495,21216,20279
California,Tulare County,10,3,40705,20756,19949
California,Tulare County,10,4,37108,18990,18118
California,Tulare County,10,5,33591,17110,16481
California,Tulare County,10,6,33942,17394,16548
California,Tulare County,10,7,31601,15990,15611
California,Tulare County,10,8,30764,15587,15177
California,Tulare County,10,9,27139,13629,13510
California,Tulare County,10,10,26393,13289,13104
California,Tulare County,10,11,25135,12558,12577
California,Tulare County,10,12,24475,12045,12430
California,Tulare County,10,13,21443,10352,11091
California,Tulare County,10,14,17239,8274,8965
California,Tulare County,10,15,13196,6190,7006
California,Tulare County,10,16,8968,4048,4920
California,Tulare County,10,17,6002,2528,3474
California,Tulare County,10,18,6276,2397,3879
California,Tulare County,11,0,465861,233078,232783
California,Tulare County,11,1,36884,18926,17958
California,Tulare County,11,2,41224,21151,20073
California,Tulare County,11,3,41247,21034,20213
California,Tulare County,11,4,37368,19153,18215
California,Tulare County,11,5,33169,16761,16408
California,Tulare County,11,6,34574,17689,16885
California,Tulare County,11,7,31580,16042,15538
California,Tulare County,11,8,31327,15960,15367
California,Tulare County,11,9,27668,13799,13869
California,Tulare County,11,10,26182,13252,12930
California,Tulare County,11,11,25063,12486,12577
California,Tulare County,11,12,24549,12106,12443
California,Tulare County,11,13,21734,10510,11224
California,Tulare County,11,14,17643,8429,9214
California,Tulare County,11,15,13787,6501,7286
California,Tulare County,11,16,9333,4182,5151
California,Tulare County,11,17,6176,2629,3547
California,Tulare County,11,18,6353,2468,3885
California,Tuolumne County,1,0,55365,29245,26120
California,Tuolumne County,1,1,2328,1195,1133
California,Tuolumne County,1,2,2501,1300,1201
California,Tuolumne County,1,3,2920,1505,1415
California,Tuolumne County,1,4,3210,1724,1486
California,Tuolumne County,1,5,2951,1689,1262
California,Tuolumne County,1,6,3185,1994,1191
California,Tuolumne County,1,7,2892,1758,1134
California,Tuolumne County,1,8,2780,1668,1112
California,Tuolumne County,1,9,3238,1873,1365
California,Tuolumne County,1,10,3912,2096,1816
California,Tuolumne County,1,11,4685,2377,2308
California,Tuolumne County,1,12,4887,2450,2437
California,Tuolumne County,1,13,4582,2322,2260
California,Tuolumne County,1,14,3487,1735,1752
California,Tuolumne County,1,15,2700,1310,1390
California,Tuolumne County,1,16,2055,997,1058
California,Tuolumne County,1,17,1577,687,890
California,Tuolumne County,1,18,1475,565,910
California,Tuolumne County,2,0,55368,29247,26121
California,Tuolumne County,2,1,2328,1195,1133
California,Tuolumne County,2,2,2502,1301,1201
California,Tuolumne County,2,3,2920,1505,1415
California,Tuolumne County,2,4,3210,1724,1486
California,Tuolumne County,2,5,2951,1689,1262
California,Tuolumne County,2,6,3185,1994,1191
California,Tuolumne County,2,7,2893,1759,1134
California,Tuolumne County,2,8,2780,1668,1112
California,Tuolumne County,2,9,3239,1873,1366
California,Tuolumne County,2,10,3912,2096,1816
California,Tuolumne County,2,11,4685,2377,2308
California,Tuolumne County,2,12,4887,2450,2437
California,Tuolumne County,2,13,4582,2322,2260
California,Tuolumne County,2,14,3487,1735,1752
California,Tuolumne County,2,15,2700,1310,1390
California,Tuolumne County,2,16,2055,997,1058
California,Tuolumne County,2,17,1577,687,890
California,Tuolumne County,2,18,1475,565,910
California,Tuolumne County,3,0,55191,29125,26066
California,Tuolumne County,3,1,2326,1185,1141
California,Tuolumne County,3,2,2498,1293,1205
California,Tuolumne County,3,3,2887,1487,1400
California,Tuolumne County,3,4,3163,1692,1471
California,Tuolumne County,3,5,2969,1708,1261
California,Tuolumne County,3,6,3179,1982,1197
California,Tuolumne County,3,7,2898,1753,1145
California,Tuolumne County,3,8,2732,1638,1094
California,Tuolumne County,3,9,3224,1871,1353
California,Tuolumne County,3,10,3847,2067,1780
California,Tuolumne County,3,11,4629,2350,2279
California,Tuolumne County,3,12,4885,2435,2450
California,Tuolumne County,3,13,4596,2331,2265
California,Tuolumne County,3,14,3526,1756,1770
California,Tuolumne County,3,15,2720,1325,1395
California,Tuolumne County,3,16,2057,991,1066
California,Tuolumne County,3,17,1577,689,888
California,Tuolumne County,3,18,1478,572,906
California,Tuolumne County,4,0,54825,28832,25993
California,Tuolumne County,4,1,2280,1157,1123
California,Tuolumne County,4,2,2483,1275,1208
California,Tuolumne County,4,3,2762,1428,1334
California,Tuolumne County,4,4,3016,1595,1421
California,Tuolumne County,4,5,3051,1762,1289
California,Tuolumne County,4,6,3167,1935,1232
California,Tuolumne County,4,7,3022,1816,1206
California,Tuolumne County,4,8,2597,1546,1051
California,Tuolumne County,4,9,3183,1849,1334
California,Tuolumne County,4,10,3596,1962,1634
California,Tuolumne County,4,11,4469,2278,2191
California,Tuolumne County,4,12,4871,2388,2483
California,Tuolumne County,4,13,4747,2402,2345
California,Tuolumne County,4,14,3677,1835,1842
California,Tuolumne County,4,15,2792,1359,1433
California,Tuolumne County,4,16,2041,976,1065
California,Tuolumne County,4,17,1564,684,880
California,Tuolumne County,4,18,1507,585,922
California,Tuolumne County,5,0,54218,28425,25793
California,Tuolumne County,5,1,2277,1143,1134
California,Tuolumne County,5,2,2506,1301,1205
California,Tuolumne County,5,3,2633,1359,1274
California,Tuolumne County,5,4,2922,1540,1382
California,Tuolumne County,5,5,3115,1805,1310
California,Tuolumne County,5,6,3104,1871,1233
California,Tuolumne County,5,7,3017,1804,1213
California,Tuolumne County,5,8,2568,1518,1050
California,Tuolumne County,5,9,3072,1773,1299
California,Tuolumne County,5,10,3358,1844,1514
California,Tuolumne County,5,11,4224,2152,2072
California,Tuolumne County,5,12,4779,2311,2468
California,Tuolumne County,5,13,4638,2356,2282
California,Tuolumne County,5,14,3985,1971,2014
California,Tuolumne County,5,15,2872,1400,1472
California,Tuolumne County,5,16,2069,1000,1069
California,Tuolumne County,5,17,1540,693,847
California,Tuolumne County,5,18,1539,584,955
California,Tuolumne County,6,0,54000,28187,25813
California,Tuolumne County,6,1,2324,1171,1153
California,Tuolumne County,6,2,2487,1275,1212
California,Tuolumne County,6,3,2553,1346,1207
California,Tuolumne County,6,4,2834,1477,1357
California,Tuolumne County,6,5,3124,1779,1345
California,Tuolumne County,6,6,2974,1784,1190
California,Tuolumne County,6,7,3115,1835,1280
California,Tuolumne County,6,8,2592,1504,1088
California,Tuolumne County,6,9,2956,1692,1264
California,Tuolumne County,6,10,3199,1779,1420
California,Tuolumne County,6,11,4042,2022,2020
California,Tuolumne County,6,12,4710,2290,2420
California,Tuolumne County,6,13,4737,2370,2367
California,Tuolumne County,6,14,4132,2052,2080
California,Tuolumne County,6,15,2980,1458,1522
California,Tuolumne County,6,16,2140,1028,1112
California,Tuolumne County,6,17,1561,741,820
California,Tuolumne County,6,18,1540,584,956
California,Tuolumne County,7,0,53828,28097,25731
California,Tuolumne County,7,1,2354,1189,1165
California,Tuolumne County,7,2,2455,1272,1183
California,Tuolumne County,7,3,2528,1336,1192
California,Tuolumne County,7,4,2751,1453,1298
California,Tuolumne County,7,5,3003,1738,1265
California,Tuolumne County,7,6,3064,1810,1254
California,Tuolumne County,7,7,3124,1838,1286
California,Tuolumne County,7,8,2732,1578,1154
California,Tuolumne County,7,9,2851,1657,1194
California,Tuolumne County,7,10,3103,1689,1414
California,Tuolumne County,7,11,3835,1928,1907
California,Tuolumne County,7,12,4612,2271,2341
California,Tuolumne County,7,13,4763,2335,2428
California,Tuolumne County,7,14,4257,2125,2132
California,Tuolumne County,7,15,3099,1493,1606
California,Tuolumne County,7,16,2212,1068,1144
California,Tuolumne County,7,17,1533,712,821
California,Tuolumne County,7,18,1552,605,947
California,Tuolumne County,8,0,53550,27826,25724
California,Tuolumne County,8,1,2415,1237,1178
California,Tuolumne County,8,2,2401,1249,1152
California,Tuolumne County,8,3,2496,1289,1207
California,Tuolumne County,8,4,2647,1405,1242
California,Tuolumne County,8,5,2933,1657,1276
California,Tuolumne County,8,6,3113,1826,1287
California,Tuolumne County,8,7,3114,1828,1286
California,Tuolumne County,8,8,2765,1557,1208
California,Tuolumne County,8,9,2744,1580,1164
California,Tuolumne County,8,10,2995,1644,1351
California,Tuolumne County,8,11,3656,1830,1826
California,Tuolumne County,8,12,4480,2206,2274
California,Tuolumne County,8,13,4843,2369,2474
California,Tuolumne County,8,14,4380,2194,2186
California,Tuolumne County,8,15,3220,1561,1659
California,Tuolumne County,8,16,2322,1114,1208
California,Tuolumne County,8,17,1513,681,832
California,Tuolumne County,8,18,1513,599,914
California,Tuolumne County,9,0,53704,27864,25840
California,Tuolumne County,9,1,2395,1184,1211
California,Tuolumne County,9,2,2448,1275,1173
California,Tuolumne County,9,3,2531,1312,1219
California,Tuolumne County,9,4,2572,1360,1212
California,Tuolumne County,9,5,2857,1613,1244
California,Tuolumne County,9,6,3230,1914,1316
California,Tuolumne County,9,7,3099,1776,1323
California,Tuolumne County,9,8,2905,1654,1251
California,Tuolumne County,9,9,2671,1551,1120
California,Tuolumne County,9,10,3022,1658,1364
California,Tuolumne County,9,11,3496,1768,1728
California,Tuolumne County,9,12,4341,2133,2208
California,Tuolumne County,9,13,4884,2359,2525
California,Tuolumne County,9,14,4527,2267,2260
California,Tuolumne County,9,15,3336,1643,1693
California,Tuolumne County,9,16,2392,1140,1252
California,Tuolumne County,9,17,1524,694,830
California,Tuolumne County,9,18,1474,563,911
California,Tuolumne County,10,0,54039,28028,26011
California,Tuolumne County,10,1,2358,1138,1220
California,Tuolumne County,10,2,2504,1291,1213
California,Tuolumne County,10,3,2606,1384,1222
California,Tuolumne County,10,4,2521,1333,1188
California,Tuolumne County,10,5,2737,1547,1190
California,Tuolumne County,10,6,3355,1974,1381
California,Tuolumne County,10,7,3134,1799,1335
California,Tuolumne County,10,8,3042,1744,1298
California,Tuolumne County,10,9,2720,1573,1147
California,Tuolumne County,10,10,2959,1623,1336
California,Tuolumne County,10,11,3353,1731,1622
California,Tuolumne County,10,12,4176,2039,2137
California,Tuolumne County,10,13,4815,2281,2534
California,Tuolumne County,10,14,4526,2285,2241
California,Tuolumne County,10,15,3687,1785,1902
California,Tuolumne County,10,16,2444,1173,1271
California,Tuolumne County,10,17,1580,742,838
California,Tuolumne County,10,18,1522,586,936
California,Tuolumne County,11,0,54539,28296,26243
California,Tuolumne County,11,1,2393,1188,1205
California,Tuolumne County,11,2,2558,1297,1261
California,Tuolumne County,11,3,2657,1401,1256
California,Tuolumne County,11,4,2496,1309,1187
California,Tuolumne County,11,5,2679,1534,1145
California,Tuolumne County,11,6,3376,1959,1417
California,Tuolumne County,11,7,3142,1810,1332
California,Tuolumne County,11,8,3207,1817,1390
California,Tuolumne County,11,9,2825,1628,1197
California,Tuolumne County,11,10,2906,1603,1303
California,Tuolumne County,11,11,3184,1673,1511
California,Tuolumne County,11,12,4052,1941,2111
California,Tuolumne County,11,13,4785,2315,2470
California,Tuolumne County,11,14,4617,2287,2330
California,Tuolumne County,11,15,3850,1892,1958
California,Tuolumne County,11,16,2556,1227,1329
California,Tuolumne County,11,17,1673,786,887
California,Tuolumne County,11,18,1583,629,954
California,Ventura County,1,0,823318,408969,414349
California,Ventura County,1,1,55336,28201,27135
California,Ventura County,1,2,56970,28896,28074
California,Ventura County,1,3,60390,31030,29360
California,Ventura County,1,4,64407,33362,31045
California,Ventura County,1,5,56183,29798,26385
California,Ventura County,1,6,54253,28199,26054
California,Ventura County,1,7,51207,25967,25240
California,Ventura County,1,8,53448,26440,27008
California,Ventura County,1,9,57635,28773,28862
California,Ventura County,1,10,62731,30836,31895
California,Ventura County,1,11,60973,29911,31062
California,Ventura County,1,12,51164,24996,26168
California,Ventura County,1,13,42312,20493,21819
California,Ventura County,1,14,29834,14162,15672
California,Ventura County,1,15,21562,9808,11754
California,Ventura County,1,16,17443,7765,9678
California,Ventura County,1,17,13427,5477,7950
California,Ventura County,1,18,14043,4855,9188
California,Ventura County,2,0,823393,409041,414352
California,Ventura County,2,1,55337,28201,27136
California,Ventura County,2,2,56970,28896,28074
California,Ventura County,2,3,60389,31029,29360
California,Ventura County,2,4,64404,33362,31042
California,Ventura County,2,5,56198,29807,26391
California,Ventura County,2,6,54269,28211,26058
California,Ventura County,2,7,51214,25973,25241
California,Ventura County,2,8,53461,26451,27010
California,Ventura County,2,9,57648,28785,28863
California,Ventura County,2,10,62737,30840,31897
California,Ventura County,2,11,60978,29916,31062
California,Ventura County,2,12,51170,25005,26165
California,Ventura County,2,13,42320,20501,21819
California,Ventura County,2,14,29826,14160,15666
California,Ventura County,2,15,21561,9807,11754
California,Ventura County,2,16,17443,7765,9678
California,Ventura County,2,17,13426,5477,7949
California,Ventura County,2,18,14042,4855,9187
California,Ventura County,3,0,825130,409801,415329
California,Ventura County,3,1,55397,28238,27159
California,Ventura County,3,2,56991,28935,28056
California,Ventura County,3,3,60154,30862,29292
California,Ventura County,3,4,64084,33147,30937
California,Ventura County,3,5,56599,29960,26639
California,Ventura County,3,6,54432,28288,26144
California,Ventura County,3,7,51563,26195,25368
California,Ventura County,3,8,53135,26254,26881
California,Ventura County,3,9,57676,28821,28855
California,Ventura County,3,10,62500,30738,31762
California,Ventura County,3,11,61175,29997,31178
California,Ventura County,3,12,51620,25228,26392
California,Ventura County,3,13,42763,20701,22062
California,Ventura County,3,14,30166,14335,15831
California,Ventura County,3,15,21747,9908,11839
California,Ventura County,3,16,17478,7780,9698
California,Ventura County,3,17,13482,5517,7965
California,Ventura County,3,18,14168,4897,9271
California,Ventura County,4,0,830196,411900,418296
California,Ventura County,4,1,55091,28019,27072
California,Ventura County,4,2,57291,29145,28146
California,Ventura County,4,3,59212,30208,29004
California,Ventura County,4,4,62714,32327,30387
California,Ventura County,4,5,58143,30560,27583
California,Ventura County,4,6,54679,28439,26240
California,Ventura County,4,7,52400,26732,25668
California,Ventura County,4,8,51559,25440,26119
California,Ventura County,4,9,57734,28871,28863
California,Ventura County,4,10,60987,30032,30955
California,Ventura County,4,11,62044,30397,31647
California,Ventura County,4,12,53256,25997,27259
California,Ventura County,4,13,44774,21660,23114
California,Ventura County,4,14,31570,15020,16550
California,Ventura County,4,15,22649,10391,12258
California,Ventura County,4,16,17733,7869,9864
California,Ventura County,4,17,13622,5635,7987
California,Ventura County,4,18,14738,5158,9580
California,Ventura County,5,0,833801,413244,420557
California,Ventura County,5,1,54509,27708,26801
California,Ventura County,5,2,57509,29242,28267
California,Ventura County,5,3,58322,29687,28635
California,Ventura County,5,4,61349,31563,29786
California,Ventura County,5,5,59534,30833,28701
California,Ventura County,5,6,54522,28467,26055
California,Ventura County,5,7,52909,27056,25853
California,Ventura County,5,8,51212,25310,25902
California,Ventura County,5,9,56973,28394,28579
California,Ventura County,5,10,59649,29457,30192
California,Ventura County,5,11,62070,30402,31668
California,Ventura County,5,12,55059,26977,28082
California,Ventura County,5,13,44680,21470,23210
California,Ventura County,5,14,34549,16498,18051
California,Ventura County,5,15,23908,11089,12819
California,Ventura County,5,16,17980,7894,10086
California,Ventura County,5,17,13891,5854,8037
California,Ventura County,5,18,15176,5343,9833
California,Ventura County,6,0,838601,415251,423350
California,Ventura County,6,1,53788,27369,26419
California,Ventura County,6,2,57482,29237,28245
California,Ventura County,6,3,57995,29425,28570
California,Ventura County,6,4,60231,30871,29360
California,Ventura County,6,5,60747,31386,29361
California,Ventura County,6,6,54563,28489,26074
California,Ventura County,6,7,53719,27505,26214
California,Ventura County,6,8,50997,25230,25767
California,Ventura County,6,9,56223,27875,28348
California,Ventura County,6,10,58462,28893,29569
California,Ventura County,6,11,61972,30310,31662
California,Ventura County,6,12,56618,27850,28768
California,Ventura County,6,13,45817,21932,23885
California,Ventura County,6,14,36304,17380,18924
California,Ventura County,6,15,25550,11826,13724
California,Ventura County,6,16,18461,8118,10343
California,Ventura County,6,17,14125,6013,8112
California,Ventura County,6,18,15547,5542,10005
California,Ventura County,7,0,842946,417070,425876
California,Ventura County,7,1,53371,27242,26129
California,Ventura County,7,2,56905,28846,28059
California,Ventura County,7,3,57734,29195,28539
California,Ventura County,7,4,59227,30392,28835
California,Ventura County,7,5,61289,31463,29826
California,Ventura County,7,6,55307,28809,26498
California,Ventura County,7,7,54134,27775,26359
California,Ventura County,7,8,51539,25523,26016
California,Ventura County,7,9,54790,27149,27641
California,Ventura County,7,10,57355,28379,28976
California,Ventura County,7,11,61920,30354,31566
California,Ventura County,7,12,57699,28288,29411
California,Ventura County,7,13,47263,22679,24584
California,Ventura County,7,14,38226,18235,19991
California,Ventura County,7,15,26963,12514,14449
California,Ventura County,7,16,19015,8364,10651
California,Ventura County,7,17,14326,6158,8168
California,Ventura County,7,18,15883,5705,10178
California,Ventura County,8,0,846922,419232,427690
California,Ventura County,8,1,52897,27037,25860
California,Ventura County,8,2,56186,28447,27739
California,Ventura County,8,3,57288,28972,28316
California,Ventura County,8,4,58404,29920,28484
California,Ventura County,8,5,60728,31176,29552
California,Ventura County,8,6,56721,29573,27148
California,Ventura County,8,7,54211,27897,26314
California,Ventura County,8,8,52393,26198,26195
California,Ventura County,8,9,53232,26173,27059
California,Ventura County,8,10,57188,28426,28762
California,Ventura County,8,11,60976,29936,31040
California,Ventura County,8,12,58642,28692,29950
California,Ventura County,8,13,48918,23559,25359
California,Ventura County,8,14,40225,19190,21035
California,Ventura County,8,15,28349,13138,15211
California,Ventura County,8,16,19680,8674,11006
California,Ventura County,8,17,14595,6283,8312
California,Ventura County,8,18,16289,5941,10348
California,Ventura County,9,0,848921,420357,428564
California,Ventura County,9,1,51765,26497,25268
California,Ventura County,9,2,55462,28179,27283
California,Ventura County,9,3,57272,29047,28225
California,Ventura County,9,4,57555,29405,28150
California,Ventura County,9,5,59369,30417,28952
California,Ventura County,9,6,58087,30332,27755
California,Ventura County,9,7,54373,28015,26358
California,Ventura County,9,8,53080,26731,26349
California,Ventura County,9,9,51877,25473,26404
California,Ventura County,9,10,57197,28304,28893
California,Ventura County,9,11,59414,29305,30109
California,Ventura County,9,12,59499,29046,30453
California,Ventura County,9,13,50326,24282,26044
California,Ventura County,9,14,42039,19978,22061
California,Ventura County,9,15,29506,13727,15779
California,Ventura County,9,16,20531,9083,11448
California,Ventura County,9,17,14912,6394,8518
California,Ventura County,9,18,16657,6142,10515
California,Ventura County,10,0,850802,421179,429623
California,Ventura County,10,1,50920,26014,24906
California,Ventura County,10,2,54555,27649,26906
California,Ventura County,10,3,57062,28985,28077
California,Ventura County,10,4,57004,29022,27982
California,Ventura County,10,5,58166,29725,28441
California,Ventura County,10,6,59129,30726,28403
California,Ventura County,10,7,54621,28217,26404
California,Ventura County,10,8,53762,27263,26499
California,Ventura County,10,9,51612,25417,26195
California,Ventura County,10,10,56568,27923,28645
California,Ventura County,10,11,58066,28680,29386
California,Ventura County,10,12,59599,29108,30491
California,Ventura County,10,13,51897,25227,26670
California,Ventura County,10,14,41896,19774,22122
California,Ventura County,10,15,32102,14997,17105
California,Ventura County,10,16,21569,9643,11926
California,Ventura County,10,17,15142,6403,8739
California,Ventura County,10,18,17132,6406,10726
California,Ventura County,11,0,850967,421319,429648
California,Ventura County,11,1,49784,25540,24244
California,Ventura County,11,2,53892,27241,26651
California,Ventura County,11,3,56724,28883,27841
California,Ventura County,11,4,56319,28668,27651
California,Ventura County,11,5,57063,29151,27912
California,Ventura County,11,6,59641,30885,28756
California,Ventura County,11,7,54671,28321,26350
California,Ventura County,11,8,54473,27652,26821
California,Ventura County,11,9,51403,25291,26112
California,Ventura County,11,10,55609,27407,28202
California,Ventura County,11,11,56766,28106,28660
California,Ventura County,11,12,59144,28890,30254
California,Ventura County,11,13,53091,25969,27122
California,Ventura County,11,14,42601,20055,22546
California,Ventura County,11,15,33666,15813,17853
California,Ventura County,11,16,23039,10285,12754
California,Ventura County,11,17,15483,6569,8914
California,Ventura County,11,18,17598,6593,11005
California,Yolo County,1,0,200849,97935,102914
California,Yolo County,1,1,12577,6429,6148
California,Yolo County,1,2,12235,6195,6040
California,Yolo County,1,3,12693,6545,6148
California,Yolo County,1,4,19318,9330,9988
California,Yolo County,1,5,27185,13212,13973
California,Yolo County,1,6,15141,7577,7564
California,Yolo County,1,7,13027,6523,6504
California,Yolo County,1,8,11827,5918,5909
California,Yolo County,1,9,12086,5936,6150
California,Yolo County,1,10,12524,6056,6468
California,Yolo County,1,11,12306,5897,6409
California,Yolo County,1,12,11193,5408,5785
California,Yolo County,1,13,8966,4310,4656
California,Yolo County,1,14,6163,2892,3271
California,Yolo County,1,15,4407,1988,2419
California,Yolo County,1,16,3485,1559,1926
California,Yolo County,1,17,2742,1127,1615
California,Yolo County,1,18,2974,1033,1941
California,Yolo County,2,0,200855,97939,102916
California,Yolo County,2,1,12578,6430,6148
California,Yolo County,2,2,12235,6195,6040
California,Yolo County,2,3,12695,6547,6148
California,Yolo County,2,4,19318,9330,9988
California,Yolo County,2,5,27185,13212,13973
California,Yolo County,2,6,15141,7577,7564
California,Yolo County,2,7,13029,6524,6505
California,Yolo County,2,8,11827,5918,5909
California,Yolo County,2,9,12086,5936,6150
California,Yolo County,2,10,12525,6056,6469
California,Yolo County,2,11,12306,5897,6409
California,Yolo County,2,12,11193,5408,5785
California,Yolo County,2,13,8966,4310,4656
California,Yolo County,2,14,6163,2892,3271
California,Yolo County,2,15,4407,1988,2419
California,Yolo County,2,16,3485,1559,1926
California,Yolo County,2,17,2742,1127,1615
California,Yolo County,2,18,2974,1033,1941
California,Yolo County,3,0,201083,98004,103079
California,Yolo County,3,1,12512,6399,6113
California,Yolo County,3,2,12256,6195,6061
California,Yolo County,3,3,12644,6523,6121
California,Yolo County,3,4,19148,9238,9910
California,Yolo County,3,5,27684,13415,14269
California,Yolo County,3,6,14973,7509,7464
California,Yolo County,3,7,13050,6537,6513
California,Yolo County,3,8,11799,5893,5906
California,Yolo County,3,9,12019,5908,6111
California,Yolo County,3,10,12456,6031,6425
California,Yolo County,3,11,12325,5911,6414
California,Yolo County,3,12,11217,5404,5813
California,Yolo County,3,13,9066,4359,4707
California,Yolo County,3,14,6210,2910,3300
California,Yolo County,3,15,4489,2041,2448
California,Yolo County,3,16,3486,1544,1942
California,Yolo County,3,17,2755,1136,1619
California,Yolo County,3,18,2994,1051,1943
California,Yolo County,4,0,201959,98353,103606
California,Yolo County,4,1,12361,6315,6046
California,Yolo County,4,2,12390,6254,6136
California,Yolo County,4,3,12481,6428,6053
California,Yolo County,4,4,18702,8988,9714
California,Yolo County,4,5,29108,13950,15158
California,Yolo County,4,6,14273,7300,6973
California,Yolo County,4,7,13259,6624,6635
California,Yolo County,4,8,11694,5838,5856
California,Yolo County,4,9,11903,5853,6050
California,Yolo County,4,10,12242,5955,6287
California,Yolo County,4,11,12365,5974,6391
California,Yolo County,4,12,11259,5399,5860
California,Yolo County,4,13,9464,4525,4939
California,Yolo County,4,14,6430,3002,3428
California,Yolo County,4,15,4672,2167,2505
California,Yolo County,4,16,3508,1518,1990
California,Yolo County,4,17,2789,1183,1606
California,Yolo County,4,18,3059,1080,1979
California,Yolo County,5,0,204623,99629,104994
California,Yolo County,5,1,12145,6207,5938
California,Yolo County,5,2,12761,6483,6278
California,Yolo County,5,3,12372,6322,6050
California,Yolo County,5,4,19398,9254,10144
California,Yolo County,5,5,30080,14363,15717
California,Yolo County,5,6,13776,7102,6674
California,Yolo County,5,7,13652,6823,6829
California,Yolo County,5,8,11746,5896,5850
California,Yolo County,5,9,11948,5869,6079
California,Yolo County,5,10,11959,5853,6106
California,Yolo County,5,11,12319,5979,6340
California,Yolo County,5,12,11497,5520,5977
California,Yolo County,5,13,9441,4496,4945
California,Yolo County,5,14,7037,3283,3754
California,Yolo County,5,15,4899,2298,2601
California,Yolo County,5,16,3583,1545,2038
California,Yolo County,5,17,2849,1214,1635
California,Yolo County,5,18,3161,1122,2039
California,Yolo County,6,0,206368,100632,105736
California,Yolo County,6,1,12253,6271,5982
California,Yolo County,6,2,12700,6446,6254
California,Yolo County,6,3,12324,6286,6038
California,Yolo County,6,4,19444,9252,10192
California,Yolo County,6,5,30295,14571,15724
California,Yolo County,6,6,13962,7224,6738
California,Yolo County,6,7,13854,6972,6882
California,Yolo County,6,8,11931,5966,5965
California,Yolo County,6,9,11821,5856,5965
California,Yolo County,6,10,11832,5814,6018
California,Yolo County,6,11,12163,5884,6279
California,Yolo County,6,12,11616,5550,6066
California,Yolo County,6,13,9657,4598,5059
California,Yolo County,6,14,7473,3486,3987
California,Yolo County,6,15,5249,2476,2773
California,Yolo County,6,16,3686,1595,2091
California,Yolo County,6,17,2872,1231,1641
California,Yolo County,6,18,3236,1154,2082
California,Yolo County,7,0,208518,101686,106832
California,Yolo County,7,1,12356,6355,6001
California,Yolo County,7,2,12800,6517,6283
California,Yolo County,7,3,12523,6319,6204
California,Yolo County,7,4,18817,9005,9812
California,Yolo County,7,5,30217,14491,15726
California,Yolo County,7,6,14535,7518,7017
California,Yolo County,7,7,13946,6983,6963
California,Yolo County,7,8,12347,6164,6183
California,Yolo County,7,9,11741,5816,5925
California,Yolo County,7,10,11829,5833,5996
California,Yolo County,7,11,12180,5894,6286
California,Yolo County,7,12,11653,5564,6089
California,Yolo County,7,13,10068,4806,5262
California,Yolo County,7,14,7897,3691,4206
California,Yolo County,7,15,5520,2596,2924
California,Yolo County,7,16,3880,1689,2191
California,Yolo County,7,17,2865,1236,1629
California,Yolo County,7,18,3344,1209,2135
California,Yolo County,8,0,212053,103311,108742
California,Yolo County,8,1,12433,6357,6076
California,Yolo County,8,2,12949,6584,6365
California,Yolo County,8,3,12535,6363,6172
California,Yolo County,8,4,19420,9275,10145
California,Yolo County,8,5,30414,14552,15862
California,Yolo County,8,6,15315,7894,7421
California,Yolo County,8,7,13755,6861,6894
California,Yolo County,8,8,12852,6400,6452
California,Yolo County,8,9,11647,5841,5806
California,Yolo County,8,10,11919,5826,6093
California,Yolo County,8,11,12124,5903,6221
California,Yolo County,8,12,11809,5638,6171
California,Yolo County,8,13,10330,4893,5437
California,Yolo County,8,14,8359,3944,4415
California,Yolo County,8,15,5809,2668,3141
California,Yolo County,8,16,4029,1800,2229
California,Yolo County,8,17,2899,1249,1650
California,Yolo County,8,18,3455,1263,2192
California,Yolo County,9,0,215530,104778,110752
California,Yolo County,9,1,12442,6311,6131
California,Yolo County,9,2,12926,6594,6332
California,Yolo County,9,3,12879,6502,6377
California,Yolo County,9,4,20499,9706,10793
California,Yolo County,9,5,30491,14516,15975
California,Yolo County,9,6,16042,8200,7842
California,Yolo County,9,7,13589,6887,6702
California,Yolo County,9,8,13380,6631,6749
California,Yolo County,9,9,11677,5809,5868
California,Yolo County,9,10,11864,5803,6061
California,Yolo County,9,11,11867,5798,6069
California,Yolo County,9,12,11858,5685,6173
California,Yolo County,9,13,10531,4963,5568
California,Yolo County,9,14,8806,4128,4678
California,Yolo County,9,15,6016,2752,3264
California,Yolo County,9,16,4149,1912,2237
California,Yolo County,9,17,2978,1258,1720
California,Yolo County,9,18,3536,1323,2213
California,Yolo County,10,0,218376,105884,112492
California,Yolo County,10,1,12455,6286,6169
California,Yolo County,10,2,12778,6466,6312
California,Yolo County,10,3,13135,6673,6462
California,Yolo County,10,4,21069,9915,11154
California,Yolo County,10,5,30802,14508,16294
California,Yolo County,10,6,16399,8378,8021
California,Yolo County,10,7,13554,6911,6643
California,Yolo County,10,8,13578,6698,6880
California,Yolo County,10,9,11906,5958,5948
California,Yolo County,10,10,11852,5737,6115
California,Yolo County,10,11,11709,5751,5958
California,Yolo County,10,12,11922,5747,6175
California,Yolo County,10,13,10728,5070,5658
California,Yolo County,10,14,8870,4116,4754
California,Yolo County,10,15,6576,3015,3561
California,Yolo County,10,16,4370,2016,2354
California,Yolo County,10,17,3045,1293,1752
California,Yolo County,10,18,3628,1346,2282
California,Yolo County,11,0,220408,106746,113662
California,Yolo County,11,1,12414,6267,6147
California,Yolo County,11,2,12852,6496,6356
California,Yolo County,11,3,13174,6695,6479
California,Yolo County,11,4,21335,9983,11352
California,Yolo County,11,5,30835,14509,16326
California,Yolo County,11,6,16479,8304,8175
California,Yolo County,11,7,13600,6960,6640
California,Yolo County,11,8,13905,6889,7016
California,Yolo County,11,9,12121,6092,6029
California,Yolo County,11,10,11799,5755,6044
California,Yolo County,11,11,11621,5720,5901
California,Yolo County,11,12,11811,5684,6127
California,Yolo County,11,13,10927,5144,5783
California,Yolo County,11,14,9021,4167,4854
California,Yolo County,11,15,6965,3199,3766
California,Yolo County,11,16,4711,2171,2540
California,Yolo County,11,17,3150,1333,1817
California,Yolo County,11,18,3688,1378,2310
California,Yuba County,1,0,72155,36352,35803
California,Yuba County,1,1,6217,3216,3001
California,Yuba County,1,2,5872,3086,2786
California,Yuba County,1,3,5547,2823,2724
California,Yuba County,1,4,5466,2820,2646
California,Yuba County,1,5,5395,2780,2615
California,Yuba County,1,6,5380,2704,2676
California,Yuba County,1,7,5033,2543,2490
California,Yuba County,1,8,4389,2202,2187
California,Yuba County,1,9,4486,2303,2183
California,Yuba County,1,10,4770,2432,2338
California,Yuba County,1,11,4778,2350,2428
California,Yuba County,1,12,4120,2069,2051
California,Yuba County,1,13,3447,1695,1752
California,Yuba County,1,14,2349,1118,1231
California,Yuba County,1,15,1832,848,984
California,Yuba County,1,16,1366,695,671
California,Yuba County,1,17,945,364,581
California,Yuba County,1,18,763,304,459
California,Yuba County,2,0,72146,36349,35797
California,Yuba County,2,1,6217,3216,3001
California,Yuba County,2,2,5872,3086,2786
California,Yuba County,2,3,5545,2823,2722
California,Yuba County,2,4,5465,2820,2645
California,Yuba County,2,5,5394,2780,2614
California,Yuba County,2,6,5380,2704,2676
California,Yuba County,2,7,5033,2543,2490
California,Yuba County,2,8,4389,2202,2187
California,Yuba County,2,9,4486,2303,2183
California,Yuba County,2,10,4769,2431,2338
California,Yuba County,2,11,4774,2348,2426
California,Yuba County,2,12,4120,2069,2051
California,Yuba County,2,13,3447,1695,1752
California,Yuba County,2,14,2349,1118,1231
California,Yuba County,2,15,1832,848,984
California,Yuba County,2,16,1366,695,671
California,Yuba County,2,17,945,364,581
California,Yuba County,2,18,763,304,459
California,Yuba County,3,0,72350,36456,35894
California,Yuba County,3,1,6192,3201,2991
California,Yuba County,3,2,5883,3079,2804
California,Yuba County,3,3,5538,2833,2705
California,Yuba County,3,4,5428,2807,2621
California,Yuba County,3,5,5435,2806,2629
California,Yuba County,3,6,5423,2725,2698
California,Yuba County,3,7,5055,2560,2495
California,Yuba County,3,8,4399,2208,2191
California,Yuba County,3,9,4470,2294,2176
California,Yuba County,3,10,4757,2429,2328
California,Yuba County,3,11,4791,2354,2437
California,Yuba County,3,12,4164,2085,2079
California,Yuba County,3,13,3510,1731,1779
California,Yuba County,3,14,2361,1117,1244
California,Yuba County,3,15,1848,857,991
California,Yuba County,3,16,1364,689,675
California,Yuba County,3,17,959,378,581
California,Yuba County,3,18,773,303,470
California,Yuba County,4,0,72492,36531,35961
California,Yuba County,4,1,6126,3192,2934
California,Yuba County,4,2,5917,3050,2867
California,Yuba County,4,3,5525,2894,2631
California,Yuba County,4,4,5265,2698,2567
California,Yuba County,4,5,5513,2841,2672
California,Yuba County,4,6,5525,2801,2724
California,Yuba County,4,7,5150,2570,2580
California,Yuba County,4,8,4318,2181,2137
California,Yuba County,4,9,4330,2222,2108
California,Yuba County,4,10,4581,2341,2240
California,Yuba County,4,11,4784,2333,2451
California,Yuba County,4,12,4311,2139,2172
California,Yuba County,4,13,3713,1847,1866
California,Yuba County,4,14,2401,1133,1268
California,Yuba County,4,15,1897,900,997
California,Yuba County,4,16,1372,668,704
California,Yuba County,4,17,962,408,554
California,Yuba County,4,18,802,313,489
California,Yuba County,5,0,72792,36745,36047
California,Yuba County,5,1,6160,3181,2979
California,Yuba County,5,2,5904,3048,2856
California,Yuba County,5,3,5467,2830,2637
California,Yuba County,5,4,5133,2661,2472
California,Yuba County,5,5,5692,2996,2696
California,Yuba County,5,6,5724,2932,2792
California,Yuba County,5,7,5162,2559,2603
California,Yuba County,5,8,4348,2197,2151
California,Yuba County,5,9,4247,2186,2061
California,Yuba County,5,10,4375,2213,2162
California,Yuba County,5,11,4715,2299,2416
California,Yuba County,5,12,4431,2197,2234
California,Yuba County,5,13,3676,1837,1839
California,Yuba County,5,14,2659,1266,1393
California,Yuba County,5,15,1932,944,988
California,Yuba County,5,16,1381,656,725
California,Yuba County,5,17,930,411,519
California,Yuba County,5,18,856,332,524
California,Yuba County,6,0,73114,36918,36196
California,Yuba County,6,1,6131,3151,2980
California,Yuba County,6,2,5900,3021,2879
California,Yuba County,6,3,5411,2833,2578
California,Yuba County,6,4,5063,2596,2467
California,Yuba County,6,5,5732,3082,2650
California,Yuba County,6,6,5829,2968,2861
California,Yuba County,6,7,5313,2646,2667
California,Yuba County,6,8,4453,2238,2215
California,Yuba County,6,9,4224,2128,2096
California,Yuba County,6,10,4216,2174,2042
California,Yuba County,6,11,4635,2266,2369
California,Yuba County,6,12,4458,2178,2280
California,Yuba County,6,13,3710,1881,1829
California,Yuba County,6,14,2845,1365,1480
California,Yuba County,6,15,2017,991,1026
California,Yuba County,6,16,1407,639,768
California,Yuba County,6,17,929,429,500
California,Yuba County,6,18,841,332,509
California,Yuba County,7,0,73562,37253,36309
California,Yuba County,7,1,6104,3092,3012
California,Yuba County,7,2,5927,3047,2880
California,Yuba County,7,3,5369,2824,2545
California,Yuba County,7,4,4964,2549,2415
California,Yuba County,7,5,5809,3201,2608
California,Yuba County,7,6,6014,3048,2966
California,Yuba County,7,7,5374,2711,2663
California,Yuba County,7,8,4581,2336,2245
California,Yuba County,7,9,4084,2062,2022
California,Yuba County,7,10,4123,2088,2035
California,Yuba County,7,11,4559,2266,2293
California,Yuba County,7,12,4454,2198,2256
California,Yuba County,7,13,3857,1942,1915
California,Yuba County,7,14,3033,1461,1572
California,Yuba County,7,15,2087,1005,1082
California,Yuba County,7,16,1434,659,775
California,Yuba County,7,17,942,444,498
California,Yuba County,7,18,847,320,527
California,Yuba County,8,0,74083,37513,36570
California,Yuba County,8,1,6111,3100,3011
California,Yuba County,8,2,5910,3019,2891
California,Yuba County,8,3,5452,2825,2627
California,Yuba County,8,4,4890,2562,2328
California,Yuba County,8,5,5728,3158,2570
California,Yuba County,8,6,6029,3090,2939
California,Yuba County,8,7,5462,2777,2685
California,Yuba County,8,8,4772,2425,2347
California,Yuba County,8,9,4088,2043,2045
California,Yuba County,8,10,4034,2028,2006
California,Yuba County,8,11,4429,2245,2184
California,Yuba County,8,12,4461,2166,2295
California,Yuba County,8,13,4005,1996,2009
California,Yuba County,8,14,3257,1604,1653
California,Yuba County,8,15,2139,998,1141
California,Yuba County,8,16,1499,704,795
California,Yuba County,8,17,957,455,502
California,Yuba County,8,18,860,318,542
California,Yuba County,9,0,75002,37985,37017
California,Yuba County,9,1,6022,3067,2955
California,Yuba County,9,2,5876,2991,2885
California,Yuba County,9,3,5553,2862,2691
California,Yuba County,9,4,4967,2663,2304
California,Yuba County,9,5,5749,3175,2574
California,Yuba County,9,6,6056,3103,2953
California,Yuba County,9,7,5644,2874,2770
California,Yuba County,9,8,4922,2501,2421
California,Yuba County,9,9,4112,2054,2058
California,Yuba County,9,10,4101,2023,2078
California,Yuba County,9,11,4313,2198,2115
California,Yuba County,9,12,4466,2193,2273
California,Yuba County,9,13,4121,2023,2098
California,Yuba County,9,14,3503,1728,1775
California,Yuba County,9,15,2155,1002,1153
California,Yuba County,9,16,1552,728,824
California,Yuba County,9,17,1015,476,539
California,Yuba County,9,18,875,324,551
California,Yuba County,10,0,76775,38876,37899
California,Yuba County,10,1,6134,3149,2985
California,Yuba County,10,2,6094,3071,3023
California,Yuba County,10,3,5738,2988,2750
California,Yuba County,10,4,5055,2688,2367
California,Yuba County,10,5,5642,3150,2492
California,Yuba County,10,6,6206,3146,3060
California,Yuba County,10,7,5879,2997,2882
California,Yuba County,10,8,5210,2606,2604
California,Yuba County,10,9,4197,2140,2057
California,Yuba County,10,10,4110,2033,2077
California,Yuba County,10,11,4256,2159,2097
California,Yuba County,10,12,4539,2210,2329
California,Yuba County,10,13,4193,2067,2126
California,Yuba County,10,14,3523,1733,1790
California,Yuba County,10,15,2417,1110,1307
California,Yuba County,10,16,1636,795,841
California,Yuba County,10,17,1032,468,564
California,Yuba County,10,18,914,366,548
California,Yuba County,11,0,78041,39503,38538
California,Yuba County,11,1,6187,3207,2980
California,Yuba County,11,2,6242,3146,3096
California,Yuba County,11,3,5894,3037,2857
California,Yuba County,11,4,5091,2705,2386
California,Yuba County,11,5,5510,3054,2456
California,Yuba County,11,6,6254,3206,3048
California,Yuba County,11,7,6024,3045,2979
California,Yuba County,11,8,5403,2703,2700
California,Yuba County,11,9,4388,2228,2160
California,Yuba County,11,10,4070,1972,2098
California,Yuba County,11,11,4187,2177,2010
California,Yuba County,11,12,4584,2252,2332
California,Yuba County,11,13,4252,2064,2188
California,Yuba County,11,14,3580,1766,1814
California,Yuba County,11,15,2628,1221,1407
California,Yuba County,11,16,1706,846,860
California,Yuba County,11,17,1086,470,616
California,Yuba County,11,18,955,404,551
